"","date","modality","year","week","weekend","has_sled","user.count","rating_above","rating_near","rating_below","swe","change_swe","snow_depth","change_depth","air_temp","snow_density","lag1snow","lag2snow","lag3snow","lag4snow","past2snow","past3snow","past4snow","past5snow"
"1",2017-12-22,"Hybrid","w1718","Fri","weekday","sled",0,"2","2","1",2,0,11,3,17,18.2,0,0,0,0,3,3,3,3
"2",2017-12-22,"Mechanized","w1718","Fri","weekday","no_sled",2,"2","2","1",2,0,11,3,17,18.2,0,0,0,0,3,3,3,3
"3",2017-12-22,"Motorized","w1718","Fri","weekday","sled",1,"2","2","1",2,0,11,3,17,18.2,0,0,0,0,3,3,3,3
"4",2017-12-22,"Non.motorized","w1718","Fri","weekday","no_sled",28,"2","2","1",2,0,11,3,17,18.2,0,0,0,0,3,3,3,3
"5",2017-12-23,"Hybrid","w1718","Sat","weekend","sled",0,"2","1","1",2.1,0.1,10,-1,21,21,3,0,0,0,2,2,2,2
"6",2017-12-23,"Mechanized","w1718","Sat","weekend","no_sled",2,"2","1","1",2.1,0.1,10,-1,21,21,3,0,0,0,2,2,2,2
"7",2017-12-23,"Motorized","w1718","Sat","weekend","sled",4,"2","1","1",2.1,0.1,10,-1,21,21,3,0,0,0,2,2,2,2
"8",2017-12-23,"Non.motorized","w1718","Sat","weekend","no_sled",16,"2","1","1",2.1,0.1,10,-1,21,21,3,0,0,0,2,2,2,2
"9",2017-12-24,"Hybrid","w1718","Sun","weekend","sled",6,"1","1","1",2.4,0.3,14,4,19,17.1,-1,3,0,0,3,6,6,6
"10",2017-12-24,"Mechanized","w1718","Sun","weekend","no_sled",4,"1","1","1",2.4,0.3,14,4,19,17.1,-1,3,0,0,3,6,6,6
"11",2017-12-24,"Motorized","w1718","Sun","weekend","sled",12,"1","1","1",2.4,0.3,14,4,19,17.1,-1,3,0,0,3,6,6,6
"12",2017-12-24,"Non.motorized","w1718","Sun","weekend","no_sled",52,"1","1","1",2.4,0.3,14,4,19,17.1,-1,3,0,0,3,6,6,6
"13",2017-12-25,"Hybrid","w1718","Mon","weekday","sled",3,"2","1","1",2.6,0.2,14,0,25,18.6,4,-1,3,0,4,3,6,6
"14",2017-12-25,"Mechanized","w1718","Mon","weekday","no_sled",5,"2","1","1",2.6,0.2,14,0,25,18.6,4,-1,3,0,4,3,6,6
"15",2017-12-25,"Motorized","w1718","Mon","weekday","sled",10,"2","1","1",2.6,0.2,14,0,25,18.6,4,-1,3,0,4,3,6,6
"16",2017-12-25,"Non.motorized","w1718","Mon","weekday","no_sled",128,"2","1","1",2.6,0.2,14,0,25,18.6,4,-1,3,0,4,3,6,6
"17",2017-12-26,"Hybrid","w1718","Tue","weekday","sled",8,"1","1","1",3.1,0.5,20,6,25,15.5,0,4,-1,3,6,10,9,12
"18",2017-12-26,"Mechanized","w1718","Tue","weekday","no_sled",4,"1","1","1",3.1,0.5,20,6,25,15.5,0,4,-1,3,6,10,9,12
"19",2017-12-26,"Motorized","w1718","Tue","weekday","sled",17,"1","1","1",3.1,0.5,20,6,25,15.5,0,4,-1,3,6,10,9,12
"20",2017-12-26,"Non.motorized","w1718","Tue","weekday","no_sled",187,"1","1","1",3.1,0.5,20,6,25,15.5,0,4,-1,3,6,10,9,12
"21",2017-12-27,"Hybrid","w1718","Wed","weekday","sled",90,"1","1","1",3.1,0,18,-2,27,17.2,6,0,4,-1,4,4,8,7
"22",2017-12-27,"Mechanized","w1718","Wed","weekday","no_sled",2,"1","1","1",3.1,0,18,-2,27,17.2,6,0,4,-1,4,4,8,7
"23",2017-12-27,"Motorized","w1718","Wed","weekday","sled",96,"1","1","1",3.1,0,18,-2,27,17.2,6,0,4,-1,4,4,8,7
"24",2017-12-27,"Non.motorized","w1718","Wed","weekday","no_sled",258,"1","1","1",3.1,0,18,-2,27,17.2,6,0,4,-1,4,4,8,7
"25",2017-12-28,"Hybrid","w1718","Thu","weekday","sled",2,"1","1","1",3.2,0.1,17,-1,31,18.8,-2,6,0,4,-3,3,3,7
"26",2017-12-28,"Mechanized","w1718","Thu","weekday","no_sled",22,"1","1","1",3.2,0.1,17,-1,31,18.8,-2,6,0,4,-3,3,3,7
"27",2017-12-28,"Motorized","w1718","Thu","weekday","sled",9,"1","1","1",3.2,0.1,17,-1,31,18.8,-2,6,0,4,-3,3,3,7
"28",2017-12-28,"Non.motorized","w1718","Thu","weekday","no_sled",254,"1","1","1",3.2,0.1,17,-1,31,18.8,-2,6,0,4,-3,3,3,7
"29",2017-12-29,"Hybrid","w1718","Fri","weekday","sled",10,"1","1","1",3.2,0,17,0,36,18.8,-1,-2,6,0,-1,-3,3,3
"30",2017-12-29,"Mechanized","w1718","Fri","weekday","no_sled",9,"1","1","1",3.2,0,17,0,36,18.8,-1,-2,6,0,-1,-3,3,3
"31",2017-12-29,"Motorized","w1718","Fri","weekday","sled",16,"1","1","1",3.2,0,17,0,36,18.8,-1,-2,6,0,-1,-3,3,3
"32",2017-12-29,"Non.motorized","w1718","Fri","weekday","no_sled",227,"1","1","1",3.2,0,17,0,36,18.8,-1,-2,6,0,-1,-3,3,3
"33",2017-12-30,"Hybrid","w1718","Sat","weekend","sled",9,"1","1","1",3.2,0,15,-2,37,21.3,0,-1,-2,6,-2,-3,-5,1
"34",2017-12-30,"Mechanized","w1718","Sat","weekend","no_sled",19,"1","1","1",3.2,0,15,-2,37,21.3,0,-1,-2,6,-2,-3,-5,1
"35",2017-12-30,"Motorized","w1718","Sat","weekend","sled",17,"1","1","1",3.2,0,15,-2,37,21.3,0,-1,-2,6,-2,-3,-5,1
"36",2017-12-30,"Non.motorized","w1718","Sat","weekend","no_sled",367,"1","1","1",3.2,0,15,-2,37,21.3,0,-1,-2,6,-2,-3,-5,1
"37",2017-12-31,"Hybrid","w1718","Sun","weekend","sled",6,"1","1","1",3.2,0,15,0,31,21.3,-2,0,-1,-2,-2,-2,-3,-5
"38",2017-12-31,"Mechanized","w1718","Sun","weekend","no_sled",9,"1","1","1",3.2,0,15,0,31,21.3,-2,0,-1,-2,-2,-2,-3,-5
"39",2017-12-31,"Motorized","w1718","Sun","weekend","sled",30,"1","1","1",3.2,0,15,0,31,21.3,-2,0,-1,-2,-2,-2,-3,-5
"40",2017-12-31,"Non.motorized","w1718","Sun","weekend","no_sled",326,"1","1","1",3.2,0,15,0,31,21.3,-2,0,-1,-2,-2,-2,-3,-5
"41",2018-01-01,"Hybrid","w1718","Mon","weekday","sled",18,"1","1","1",3.2,0,15,0,27,21.3,0,-2,0,-1,0,-2,-2,-3
"42",2018-01-01,"Mechanized","w1718","Mon","weekday","no_sled",12,"1","1","1",3.2,0,15,0,27,21.3,0,-2,0,-1,0,-2,-2,-3
"43",2018-01-01,"Motorized","w1718","Mon","weekday","sled",42,"1","1","1",3.2,0,15,0,27,21.3,0,-2,0,-1,0,-2,-2,-3
"44",2018-01-01,"Non.motorized","w1718","Mon","weekday","no_sled",273,"1","1","1",3.2,0,15,0,27,21.3,0,-2,0,-1,0,-2,-2,-3
"45",2018-01-02,"Hybrid","w1718","Tue","weekday","sled",11,"1","1","1",3.2,0,15,0,22,21.3,0,0,-2,0,0,0,-2,-2
"46",2018-01-02,"Mechanized","w1718","Tue","weekday","no_sled",4,"1","1","1",3.2,0,15,0,22,21.3,0,0,-2,0,0,0,-2,-2
"47",2018-01-02,"Motorized","w1718","Tue","weekday","sled",18,"1","1","1",3.2,0,15,0,22,21.3,0,0,-2,0,0,0,-2,-2
"48",2018-01-02,"Non.motorized","w1718","Tue","weekday","no_sled",77,"1","1","1",3.2,0,15,0,22,21.3,0,0,-2,0,0,0,-2,-2
"49",2018-01-03,"Hybrid","w1718","Wed","weekday","sled",4,"1","1","1",3.2,0,15,0,27,21.3,0,0,0,-2,0,0,0,-2
"50",2018-01-03,"Mechanized","w1718","Wed","weekday","no_sled",4,"1","1","1",3.2,0,15,0,27,21.3,0,0,0,-2,0,0,0,-2
"51",2018-01-03,"Motorized","w1718","Wed","weekday","sled",14,"1","1","1",3.2,0,15,0,27,21.3,0,0,0,-2,0,0,0,-2
"52",2018-01-03,"Non.motorized","w1718","Wed","weekday","no_sled",50,"1","1","1",3.2,0,15,0,27,21.3,0,0,0,-2,0,0,0,-2
"53",2018-01-04,"Hybrid","w1718","Thu","weekday","sled",4,"1","1","1",3.2,0,15,0,29,21.3,0,0,0,0,0,0,0,0
"54",2018-01-04,"Mechanized","w1718","Thu","weekday","no_sled",5,"1","1","1",3.2,0,15,0,29,21.3,0,0,0,0,0,0,0,0
"55",2018-01-04,"Motorized","w1718","Thu","weekday","sled",17,"1","1","1",3.2,0,15,0,29,21.3,0,0,0,0,0,0,0,0
"56",2018-01-04,"Non.motorized","w1718","Thu","weekday","no_sled",34,"1","1","1",3.2,0,15,0,29,21.3,0,0,0,0,0,0,0,0
"57",2018-01-05,"Hybrid","w1718","Fri","weekday","sled",2,"1","1","1",3.2,0,14,-1,32,22.9,0,0,0,0,-1,-1,-1,-1
"58",2018-01-05,"Mechanized","w1718","Fri","weekday","no_sled",3,"1","1","1",3.2,0,14,-1,32,22.9,0,0,0,0,-1,-1,-1,-1
"59",2018-01-05,"Motorized","w1718","Fri","weekday","sled",18,"1","1","1",3.2,0,14,-1,32,22.9,0,0,0,0,-1,-1,-1,-1
"60",2018-01-05,"Non.motorized","w1718","Fri","weekday","no_sled",39,"1","1","1",3.2,0,14,-1,32,22.9,0,0,0,0,-1,-1,-1,-1
"61",2018-01-06,"Hybrid","w1718","Sat","weekend","sled",6,"1","1","1",3.2,0,14,0,30,22.9,-1,0,0,0,-1,-1,-1,-1
"62",2018-01-06,"Mechanized","w1718","Sat","weekend","no_sled",7,"1","1","1",3.2,0,14,0,30,22.9,-1,0,0,0,-1,-1,-1,-1
"63",2018-01-06,"Motorized","w1718","Sat","weekend","sled",24,"1","1","1",3.2,0,14,0,30,22.9,-1,0,0,0,-1,-1,-1,-1
"64",2018-01-06,"Non.motorized","w1718","Sat","weekend","no_sled",36,"1","1","1",3.2,0,14,0,30,22.9,-1,0,0,0,-1,-1,-1,-1
"65",2018-01-07,"Hybrid","w1718","Sun","weekend","sled",2,"2","2","2",3.5,0.3,18,4,25,19.4,0,-1,0,0,4,3,3,3
"66",2018-01-07,"Mechanized","w1718","Sun","weekend","no_sled",0,"2","2","2",3.5,0.3,18,4,25,19.4,0,-1,0,0,4,3,3,3
"67",2018-01-07,"Motorized","w1718","Sun","weekend","sled",8,"2","2","2",3.5,0.3,18,4,25,19.4,0,-1,0,0,4,3,3,3
"68",2018-01-07,"Non.motorized","w1718","Sun","weekend","no_sled",76,"2","2","2",3.5,0.3,18,4,25,19.4,0,-1,0,0,4,3,3,3
"69",2018-01-08,"Hybrid","w1718","Mon","weekday","sled",4,"2","2","1",3.7,0.2,20,2,29,18.5,4,0,-1,0,6,6,5,5
"70",2018-01-08,"Mechanized","w1718","Mon","weekday","no_sled",1,"2","2","1",3.7,0.2,20,2,29,18.5,4,0,-1,0,6,6,5,5
"71",2018-01-08,"Motorized","w1718","Mon","weekday","sled",4,"2","2","1",3.7,0.2,20,2,29,18.5,4,0,-1,0,6,6,5,5
"72",2018-01-08,"Non.motorized","w1718","Mon","weekday","no_sled",51,"2","2","1",3.7,0.2,20,2,29,18.5,4,0,-1,0,6,6,5,5
"73",2018-01-09,"Hybrid","w1718","Tue","weekday","sled",1,"2","2","1",3.8,0.1,21,1,34,18.1,2,4,0,-1,3,7,7,6
"74",2018-01-09,"Mechanized","w1718","Tue","weekday","no_sled",0,"2","2","1",3.8,0.1,21,1,34,18.1,2,4,0,-1,3,7,7,6
"75",2018-01-09,"Motorized","w1718","Tue","weekday","sled",4,"2","2","1",3.8,0.1,21,1,34,18.1,2,4,0,-1,3,7,7,6
"76",2018-01-09,"Non.motorized","w1718","Tue","weekday","no_sled",65,"2","2","1",3.8,0.1,21,1,34,18.1,2,4,0,-1,3,7,7,6
"77",2018-01-10,"Hybrid","w1718","Wed","weekday","sled",0,"3","3","3",4,0.2,21,0,28,19,1,2,4,0,1,3,7,7
"78",2018-01-10,"Mechanized","w1718","Wed","weekday","no_sled",0,"3","3","3",4,0.2,21,0,28,19,1,2,4,0,1,3,7,7
"79",2018-01-10,"Motorized","w1718","Wed","weekday","sled",0,"3","3","3",4,0.2,21,0,28,19,1,2,4,0,1,3,7,7
"80",2018-01-10,"Non.motorized","w1718","Wed","weekday","no_sled",94,"3","3","3",4,0.2,21,0,28,19,1,2,4,0,1,3,7,7
"81",2018-01-11,"Hybrid","w1718","Thu","weekday","sled",8,"3","3","3",4.1,0.1,26,5,17,15.8,0,1,2,4,5,6,8,12
"82",2018-01-11,"Mechanized","w1718","Thu","weekday","no_sled",1,"3","3","3",4.1,0.1,26,5,17,15.8,0,1,2,4,5,6,8,12
"83",2018-01-11,"Motorized","w1718","Thu","weekday","sled",9,"3","3","3",4.1,0.1,26,5,17,15.8,0,1,2,4,5,6,8,12
"84",2018-01-11,"Non.motorized","w1718","Thu","weekday","no_sled",76,"3","3","3",4.1,0.1,26,5,17,15.8,0,1,2,4,5,6,8,12
"85",2018-01-12,"Hybrid","w1718","Fri","weekday","sled",3,"3","3","3",4.3,0.2,24,-2,22,17.9,5,0,1,2,3,3,4,6
"86",2018-01-12,"Mechanized","w1718","Fri","weekday","no_sled",0,"3","3","3",4.3,0.2,24,-2,22,17.9,5,0,1,2,3,3,4,6
"87",2018-01-12,"Motorized","w1718","Fri","weekday","sled",4,"3","3","3",4.3,0.2,24,-2,22,17.9,5,0,1,2,3,3,4,6
"88",2018-01-12,"Non.motorized","w1718","Fri","weekday","no_sled",46,"3","3","3",4.3,0.2,24,-2,22,17.9,5,0,1,2,3,3,4,6
"89",2018-01-13,"Hybrid","w1718","Sat","weekend","sled",18,"3","3","3",4.4,0.1,24,0,24,18.3,-2,5,0,1,-2,3,3,4
"90",2018-01-13,"Mechanized","w1718","Sat","weekend","no_sled",2,"3","3","3",4.4,0.1,24,0,24,18.3,-2,5,0,1,-2,3,3,4
"91",2018-01-13,"Motorized","w1718","Sat","weekend","sled",26,"3","3","3",4.4,0.1,24,0,24,18.3,-2,5,0,1,-2,3,3,4
"92",2018-01-13,"Non.motorized","w1718","Sat","weekend","no_sled",203,"3","3","3",4.4,0.1,24,0,24,18.3,-2,5,0,1,-2,3,3,4
"93",2018-01-14,"Hybrid","w1718","Sun","weekend","sled",23,"3","3","2",4.4,0,24,0,27,18.3,0,-2,5,0,0,-2,3,3
"94",2018-01-14,"Mechanized","w1718","Sun","weekend","no_sled",2,"3","3","2",4.4,0,24,0,27,18.3,0,-2,5,0,0,-2,3,3
"95",2018-01-14,"Motorized","w1718","Sun","weekend","sled",38,"3","3","2",4.4,0,24,0,27,18.3,0,-2,5,0,0,-2,3,3
"96",2018-01-14,"Non.motorized","w1718","Sun","weekend","no_sled",270,"3","3","2",4.4,0,24,0,27,18.3,0,-2,5,0,0,-2,3,3
"97",2018-01-15,"Hybrid","w1718","Mon","weekday","sled",11,"3","3","2",4.4,0,23,-1,27,19.1,0,0,-2,5,-1,-1,-3,2
"98",2018-01-15,"Mechanized","w1718","Mon","weekday","no_sled",0,"3","3","2",4.4,0,23,-1,27,19.1,0,0,-2,5,-1,-1,-3,2
"99",2018-01-15,"Motorized","w1718","Mon","weekday","sled",12,"3","3","2",4.4,0,23,-1,27,19.1,0,0,-2,5,-1,-1,-3,2
"100",2018-01-15,"Non.motorized","w1718","Mon","weekday","no_sled",168,"3","3","2",4.4,0,23,-1,27,19.1,0,0,-2,5,-1,-1,-3,2
"101",2018-01-16,"Hybrid","w1718","Tue","weekday","sled",13,"3","3","2",4.4,0,22,-1,20,20,-1,0,0,-2,-2,-2,-2,-4
"102",2018-01-16,"Mechanized","w1718","Tue","weekday","no_sled",3,"3","3","2",4.4,0,22,-1,20,20,-1,0,0,-2,-2,-2,-2,-4
"103",2018-01-16,"Motorized","w1718","Tue","weekday","sled",15,"3","3","2",4.4,0,22,-1,20,20,-1,0,0,-2,-2,-2,-2,-4
"104",2018-01-16,"Non.motorized","w1718","Tue","weekday","no_sled",68,"3","3","2",4.4,0,22,-1,20,20,-1,0,0,-2,-2,-2,-2,-4
"105",2018-01-17,"Hybrid","w1718","Wed","weekday","sled",5,"2","2","2",4.4,0,22,0,24,20,-1,-1,0,0,-1,-2,-2,-2
"106",2018-01-17,"Mechanized","w1718","Wed","weekday","no_sled",0,"2","2","2",4.4,0,22,0,24,20,-1,-1,0,0,-1,-2,-2,-2
"107",2018-01-17,"Motorized","w1718","Wed","weekday","sled",9,"2","2","2",4.4,0,22,0,24,20,-1,-1,0,0,-1,-2,-2,-2
"108",2018-01-17,"Non.motorized","w1718","Wed","weekday","no_sled",101,"2","2","2",4.4,0,22,0,24,20,-1,-1,0,0,-1,-2,-2,-2
"109",2018-01-18,"Hybrid","w1718","Thu","weekday","sled",2,"2","2","2",4.4,0,21,-1,29,21,0,-1,-1,0,-1,-2,-3,-3
"110",2018-01-18,"Mechanized","w1718","Thu","weekday","no_sled",2,"2","2","2",4.4,0,21,-1,29,21,0,-1,-1,0,-1,-2,-3,-3
"111",2018-01-18,"Motorized","w1718","Thu","weekday","sled",2,"2","2","2",4.4,0,21,-1,29,21,0,-1,-1,0,-1,-2,-3,-3
"112",2018-01-18,"Non.motorized","w1718","Thu","weekday","no_sled",127,"2","2","2",4.4,0,21,-1,29,21,0,-1,-1,0,-1,-2,-3,-3
"113",2018-01-19,"Hybrid","w1718","Fri","weekday","sled",7,"2","2","2",4.5,0.1,21,0,34,21.4,-1,0,-1,-1,-1,-1,-2,-3
"114",2018-01-19,"Mechanized","w1718","Fri","weekday","no_sled",2,"2","2","2",4.5,0.1,21,0,34,21.4,-1,0,-1,-1,-1,-1,-2,-3
"115",2018-01-19,"Motorized","w1718","Fri","weekday","sled",11,"2","2","2",4.5,0.1,21,0,34,21.4,-1,0,-1,-1,-1,-1,-2,-3
"116",2018-01-19,"Non.motorized","w1718","Fri","weekday","no_sled",160,"2","2","2",4.5,0.1,21,0,34,21.4,-1,0,-1,-1,-1,-1,-2,-3
"117",2018-01-20,"Hybrid","w1718","Sat","weekend","sled",19,"2","2","2",4.5,0,21,0,32,21.4,0,-1,0,-1,0,-1,-1,-2
"118",2018-01-20,"Mechanized","w1718","Sat","weekend","no_sled",7,"2","2","2",4.5,0,21,0,32,21.4,0,-1,0,-1,0,-1,-1,-2
"119",2018-01-20,"Motorized","w1718","Sat","weekend","sled",23,"2","2","2",4.5,0,21,0,32,21.4,0,-1,0,-1,0,-1,-1,-2
"120",2018-01-20,"Non.motorized","w1718","Sat","weekend","no_sled",212,"2","2","2",4.5,0,21,0,32,21.4,0,-1,0,-1,0,-1,-1,-2
"121",2018-01-21,"Hybrid","w1718","Sun","weekend","sled",0,"3","3","3",4.6,0.1,23,2,15,20,0,0,-1,0,2,2,1,1
"122",2018-01-21,"Mechanized","w1718","Sun","weekend","no_sled",2,"3","3","3",4.6,0.1,23,2,15,20,0,0,-1,0,2,2,1,1
"123",2018-01-21,"Motorized","w1718","Sun","weekend","sled",1,"3","3","3",4.6,0.1,23,2,15,20,0,0,-1,0,2,2,1,1
"124",2018-01-21,"Non.motorized","w1718","Sun","weekend","no_sled",27,"3","3","3",4.6,0.1,23,2,15,20,0,0,-1,0,2,2,1,1
"125",2018-01-22,"Hybrid","w1718","Mon","weekday","sled",8,"3","3","3",4.6,0,21,-2,12,21.9,2,0,0,-1,0,0,0,-1
"126",2018-01-22,"Mechanized","w1718","Mon","weekday","no_sled",1,"3","3","3",4.6,0,21,-2,12,21.9,2,0,0,-1,0,0,0,-1
"127",2018-01-22,"Motorized","w1718","Mon","weekday","sled",13,"3","3","3",4.6,0,21,-2,12,21.9,2,0,0,-1,0,0,0,-1
"128",2018-01-22,"Non.motorized","w1718","Mon","weekday","no_sled",112,"3","3","3",4.6,0,21,-2,12,21.9,2,0,0,-1,0,0,0,-1
"129",2018-01-23,"Hybrid","w1718","Tue","weekday","sled",13,"3","3","3",4.6,0,22,1,16,20.9,-2,2,0,0,-1,1,1,1
"130",2018-01-23,"Mechanized","w1718","Tue","weekday","no_sled",3,"3","3","3",4.6,0,22,1,16,20.9,-2,2,0,0,-1,1,1,1
"131",2018-01-23,"Motorized","w1718","Tue","weekday","sled",19,"3","3","3",4.6,0,22,1,16,20.9,-2,2,0,0,-1,1,1,1
"132",2018-01-23,"Non.motorized","w1718","Tue","weekday","no_sled",86,"3","3","3",4.6,0,22,1,16,20.9,-2,2,0,0,-1,1,1,1
"133",2018-01-24,"Hybrid","w1718","Wed","weekday","sled",9,"2","2","2",4.6,0,22,0,22,20.9,1,-2,2,0,1,-1,1,1
"134",2018-01-24,"Mechanized","w1718","Wed","weekday","no_sled",1,"2","2","2",4.6,0,22,0,22,20.9,1,-2,2,0,1,-1,1,1
"135",2018-01-24,"Motorized","w1718","Wed","weekday","sled",11,"2","2","2",4.6,0,22,0,22,20.9,1,-2,2,0,1,-1,1,1
"136",2018-01-24,"Non.motorized","w1718","Wed","weekday","no_sled",111,"2","2","2",4.6,0,22,0,22,20.9,1,-2,2,0,1,-1,1,1
"137",2018-01-25,"Hybrid","w1718","Thu","weekday","sled",17,"2","2","2",4.6,0,22,0,28,20.9,0,1,-2,2,0,1,-1,1
"138",2018-01-25,"Mechanized","w1718","Thu","weekday","no_sled",11,"2","2","2",4.6,0,22,0,28,20.9,0,1,-2,2,0,1,-1,1
"139",2018-01-25,"Motorized","w1718","Thu","weekday","sled",23,"2","2","2",4.6,0,22,0,28,20.9,0,1,-2,2,0,1,-1,1
"140",2018-01-25,"Non.motorized","w1718","Thu","weekday","no_sled",131,"2","2","2",4.6,0,22,0,28,20.9,0,1,-2,2,0,1,-1,1
"141",2018-01-26,"Hybrid","w1718","Fri","weekday","sled",2,"2","2","2",4.7,0.1,22,0,15,21.4,0,0,1,-2,0,0,1,-1
"142",2018-01-26,"Mechanized","w1718","Fri","weekday","no_sled",12,"2","2","2",4.7,0.1,22,0,15,21.4,0,0,1,-2,0,0,1,-1
"143",2018-01-26,"Motorized","w1718","Fri","weekday","sled",6,"2","2","2",4.7,0.1,22,0,15,21.4,0,0,1,-2,0,0,1,-1
"144",2018-01-26,"Non.motorized","w1718","Fri","weekday","no_sled",58,"2","2","2",4.7,0.1,22,0,15,21.4,0,0,1,-2,0,0,1,-1
"145",2018-01-27,"Hybrid","w1718","Sat","weekend","sled",26,"2","2","2",4.7,0,23,1,16,20.4,0,0,0,1,1,1,1,2
"146",2018-01-27,"Mechanized","w1718","Sat","weekend","no_sled",4,"2","2","2",4.7,0,23,1,16,20.4,0,0,0,1,1,1,1,2
"147",2018-01-27,"Motorized","w1718","Sat","weekend","sled",28,"2","2","2",4.7,0,23,1,16,20.4,0,0,0,1,1,1,1,2
"148",2018-01-27,"Non.motorized","w1718","Sat","weekend","no_sled",601,"2","2","2",4.7,0,23,1,16,20.4,0,0,0,1,1,1,1,2
"149",2018-01-28,"Hybrid","w1718","Sun","weekend","sled",29,"2","2","2",4.7,0,23,0,25,20.4,1,0,0,0,1,1,1,1
"150",2018-01-28,"Mechanized","w1718","Sun","weekend","no_sled",16,"2","2","2",4.7,0,23,0,25,20.4,1,0,0,0,1,1,1,1
"151",2018-01-28,"Motorized","w1718","Sun","weekend","sled",35,"2","2","2",4.7,0,23,0,25,20.4,1,0,0,0,1,1,1,1
"152",2018-01-28,"Non.motorized","w1718","Sun","weekend","no_sled",269,"2","2","2",4.7,0,23,0,25,20.4,1,0,0,0,1,1,1,1
"153",2018-01-29,"Hybrid","w1718","Mon","weekday","sled",11,"2","2","2",4.8,0.1,22,-1,30,21.8,0,1,0,0,-1,0,0,0
"154",2018-01-29,"Mechanized","w1718","Mon","weekday","no_sled",2,"2","2","2",4.8,0.1,22,-1,30,21.8,0,1,0,0,-1,0,0,0
"155",2018-01-29,"Motorized","w1718","Mon","weekday","sled",12,"2","2","2",4.8,0.1,22,-1,30,21.8,0,1,0,0,-1,0,0,0
"156",2018-01-29,"Non.motorized","w1718","Mon","weekday","no_sled",114,"2","2","2",4.8,0.1,22,-1,30,21.8,0,1,0,0,-1,0,0,0
"157",2018-01-30,"Hybrid","w1718","Tue","weekday","sled",9,"2","2","2",4.8,0,22,0,34,21.8,-1,0,1,0,-1,-1,0,0
"158",2018-01-30,"Mechanized","w1718","Tue","weekday","no_sled",3,"2","2","2",4.8,0,22,0,34,21.8,-1,0,1,0,-1,-1,0,0
"159",2018-01-30,"Motorized","w1718","Tue","weekday","sled",16,"2","2","2",4.8,0,22,0,34,21.8,-1,0,1,0,-1,-1,0,0
"160",2018-01-30,"Non.motorized","w1718","Tue","weekday","no_sled",108,"2","2","2",4.8,0,22,0,34,21.8,-1,0,1,0,-1,-1,0,0
"161",2018-01-31,"Hybrid","w1718","Wed","weekday","sled",4,"2","2","2",4.8,0,22,0,34,21.8,0,-1,0,1,0,-1,-1,0
"162",2018-01-31,"Mechanized","w1718","Wed","weekday","no_sled",4,"2","2","2",4.8,0,22,0,34,21.8,0,-1,0,1,0,-1,-1,0
"163",2018-01-31,"Motorized","w1718","Wed","weekday","sled",7,"2","2","2",4.8,0,22,0,34,21.8,0,-1,0,1,0,-1,-1,0
"164",2018-01-31,"Non.motorized","w1718","Wed","weekday","no_sled",96,"2","2","2",4.8,0,22,0,34,21.8,0,-1,0,1,0,-1,-1,0
"165",2018-02-01,"Hybrid","w1718","Thu","weekday","sled",8,"2","2","2",4.9,0.1,21,-1,32,23.3,0,0,-1,0,-1,-1,-2,-2
"166",2018-02-01,"Mechanized","w1718","Thu","weekday","no_sled",6,"2","2","2",4.9,0.1,21,-1,32,23.3,0,0,-1,0,-1,-1,-2,-2
"167",2018-02-01,"Motorized","w1718","Thu","weekday","sled",12,"2","2","2",4.9,0.1,21,-1,32,23.3,0,0,-1,0,-1,-1,-2,-2
"168",2018-02-01,"Non.motorized","w1718","Thu","weekday","no_sled",118,"2","2","2",4.9,0.1,21,-1,32,23.3,0,0,-1,0,-1,-1,-2,-2
"169",2018-02-02,"Hybrid","w1718","Fri","weekday","sled",12,"2","2","2",4.9,0,20,-1,33,24.5,-1,0,0,-1,-2,-2,-2,-3
"170",2018-02-02,"Mechanized","w1718","Fri","weekday","no_sled",13,"2","2","2",4.9,0,20,-1,33,24.5,-1,0,0,-1,-2,-2,-2,-3
"171",2018-02-02,"Motorized","w1718","Fri","weekday","sled",12,"2","2","2",4.9,0,20,-1,33,24.5,-1,0,0,-1,-2,-2,-2,-3
"172",2018-02-02,"Non.motorized","w1718","Fri","weekday","no_sled",168,"2","2","2",4.9,0,20,-1,33,24.5,-1,0,0,-1,-2,-2,-2,-3
"173",2018-02-03,"Hybrid","w1718","Sat","weekend","sled",6,"2","2","2",4.9,0,21,1,32,23.3,-1,-1,0,0,0,-1,-1,-1
"174",2018-02-03,"Mechanized","w1718","Sat","weekend","no_sled",5,"2","2","2",4.9,0,21,1,32,23.3,-1,-1,0,0,0,-1,-1,-1
"175",2018-02-03,"Motorized","w1718","Sat","weekend","sled",17,"2","2","2",4.9,0,21,1,32,23.3,-1,-1,0,0,0,-1,-1,-1
"176",2018-02-03,"Non.motorized","w1718","Sat","weekend","no_sled",317,"2","2","2",4.9,0,21,1,32,23.3,-1,-1,0,0,0,-1,-1,-1
"177",2018-02-04,"Hybrid","w1718","Sun","weekend","sled",16,"2","2","2",4.9,0,19,-2,32,25.8,1,-1,-1,0,-1,-2,-3,-3
"178",2018-02-04,"Mechanized","w1718","Sun","weekend","no_sled",16,"2","2","2",4.9,0,19,-2,32,25.8,1,-1,-1,0,-1,-2,-3,-3
"179",2018-02-04,"Motorized","w1718","Sun","weekend","sled",25,"2","2","2",4.9,0,19,-2,32,25.8,1,-1,-1,0,-1,-2,-3,-3
"180",2018-02-04,"Non.motorized","w1718","Sun","weekend","no_sled",325,"2","2","2",4.9,0,19,-2,32,25.8,1,-1,-1,0,-1,-2,-3,-3
"181",2018-02-05,"Hybrid","w1718","Mon","weekday","sled",4,"2","2","2",5,0.1,18,-1,29,27.8,-2,1,-1,-1,-3,-2,-3,-4
"182",2018-02-05,"Mechanized","w1718","Mon","weekday","no_sled",1,"2","2","2",5,0.1,18,-1,29,27.8,-2,1,-1,-1,-3,-2,-3,-4
"183",2018-02-05,"Motorized","w1718","Mon","weekday","sled",7,"2","2","2",5,0.1,18,-1,29,27.8,-2,1,-1,-1,-3,-2,-3,-4
"184",2018-02-05,"Non.motorized","w1718","Mon","weekday","no_sled",105,"2","2","2",5,0.1,18,-1,29,27.8,-2,1,-1,-1,-3,-2,-3,-4
"185",2018-02-06,"Hybrid","w1718","Tue","weekday","sled",12,"2","2","2",5.2,0.2,23,5,22,22.6,-1,-2,1,-1,4,2,3,2
"186",2018-02-06,"Mechanized","w1718","Tue","weekday","no_sled",0,"2","2","2",5.2,0.2,23,5,22,22.6,-1,-2,1,-1,4,2,3,2
"187",2018-02-06,"Motorized","w1718","Tue","weekday","sled",15,"2","2","2",5.2,0.2,23,5,22,22.6,-1,-2,1,-1,4,2,3,2
"188",2018-02-06,"Non.motorized","w1718","Tue","weekday","no_sled",99,"2","2","2",5.2,0.2,23,5,22,22.6,-1,-2,1,-1,4,2,3,2
"189",2018-02-07,"Hybrid","w1718","Wed","weekday","sled",14,"2","2","2",5.2,0,23,0,24,22.6,5,-1,-2,1,5,4,2,3
"190",2018-02-07,"Mechanized","w1718","Wed","weekday","no_sled",8,"2","2","2",5.2,0,23,0,24,22.6,5,-1,-2,1,5,4,2,3
"191",2018-02-07,"Motorized","w1718","Wed","weekday","sled",19,"2","2","2",5.2,0,23,0,24,22.6,5,-1,-2,1,5,4,2,3
"192",2018-02-07,"Non.motorized","w1718","Wed","weekday","no_sled",199,"2","2","2",5.2,0,23,0,24,22.6,5,-1,-2,1,5,4,2,3
"193",2018-02-08,"Hybrid","w1718","Thu","weekday","sled",11,"2","2","1",5.3,0.1,25,2,28,21.2,0,5,-1,-2,2,7,6,4
"194",2018-02-08,"Mechanized","w1718","Thu","weekday","no_sled",10,"2","2","1",5.3,0.1,25,2,28,21.2,0,5,-1,-2,2,7,6,4
"195",2018-02-08,"Motorized","w1718","Thu","weekday","sled",15,"2","2","1",5.3,0.1,25,2,28,21.2,0,5,-1,-2,2,7,6,4
"196",2018-02-08,"Non.motorized","w1718","Thu","weekday","no_sled",190,"2","2","1",5.3,0.1,25,2,28,21.2,0,5,-1,-2,2,7,6,4
"197",2018-02-09,"Hybrid","w1718","Fri","weekday","sled",7,"2","2","1",5.3,0,24,-1,33,22.1,2,0,5,-1,1,1,6,5
"198",2018-02-09,"Mechanized","w1718","Fri","weekday","no_sled",15,"2","2","1",5.3,0,24,-1,33,22.1,2,0,5,-1,1,1,6,5
"199",2018-02-09,"Motorized","w1718","Fri","weekday","sled",39,"2","2","1",5.3,0,24,-1,33,22.1,2,0,5,-1,1,1,6,5
"200",2018-02-09,"Non.motorized","w1718","Fri","weekday","no_sled",199,"2","2","1",5.3,0,24,-1,33,22.1,2,0,5,-1,1,1,6,5
"201",2018-02-10,"Hybrid","w1718","Sat","weekend","sled",6,"3","3","2",5.3,0,24,0,24,22.1,-1,2,0,5,-1,1,1,6
"202",2018-02-10,"Mechanized","w1718","Sat","weekend","no_sled",8,"3","3","2",5.3,0,24,0,24,22.1,-1,2,0,5,-1,1,1,6
"203",2018-02-10,"Motorized","w1718","Sat","weekend","sled",23,"3","3","2",5.3,0,24,0,24,22.1,-1,2,0,5,-1,1,1,6
"204",2018-02-10,"Non.motorized","w1718","Sat","weekend","no_sled",85,"3","3","2",5.3,0,24,0,24,22.1,-1,2,0,5,-1,1,1,6
"205",2018-02-11,"Hybrid","w1718","Sun","weekend","sled",33,"3","3","2",5.6,0.3,27,3,13,20.7,0,-1,2,0,3,2,4,4
"206",2018-02-11,"Mechanized","w1718","Sun","weekend","no_sled",3,"3","3","2",5.6,0.3,27,3,13,20.7,0,-1,2,0,3,2,4,4
"207",2018-02-11,"Motorized","w1718","Sun","weekend","sled",149,"3","3","2",5.6,0.3,27,3,13,20.7,0,-1,2,0,3,2,4,4
"208",2018-02-11,"Non.motorized","w1718","Sun","weekend","no_sled",224,"3","3","2",5.6,0.3,27,3,13,20.7,0,-1,2,0,3,2,4,4
"209",2018-02-12,"Hybrid","w1718","Mon","weekday","sled",15,"3","3","3",5.7,0.1,27,0,23,21.1,3,0,-1,2,3,3,2,4
"210",2018-02-12,"Mechanized","w1718","Mon","weekday","no_sled",0,"3","3","3",5.7,0.1,27,0,23,21.1,3,0,-1,2,3,3,2,4
"211",2018-02-12,"Motorized","w1718","Mon","weekday","sled",38,"3","3","3",5.7,0.1,27,0,23,21.1,3,0,-1,2,3,3,2,4
"212",2018-02-12,"Non.motorized","w1718","Mon","weekday","no_sled",114,"3","3","3",5.7,0.1,27,0,23,21.1,3,0,-1,2,3,3,2,4
"213",2018-02-13,"Hybrid","w1718","Tue","weekday","sled",8,"3","3","3",6.1,0.4,29,2,28,21,0,3,0,-1,2,5,5,4
"214",2018-02-13,"Mechanized","w1718","Tue","weekday","no_sled",5,"3","3","3",6.1,0.4,29,2,28,21,0,3,0,-1,2,5,5,4
"215",2018-02-13,"Motorized","w1718","Tue","weekday","sled",45,"3","3","3",6.1,0.4,29,2,28,21,0,3,0,-1,2,5,5,4
"216",2018-02-13,"Non.motorized","w1718","Tue","weekday","no_sled",91,"3","3","3",6.1,0.4,29,2,28,21,0,3,0,-1,2,5,5,4
"217",2018-02-14,"Hybrid","w1718","Wed","weekday","sled",4,"3","3","3",6.2,0.1,30,1,30,20.7,2,0,3,0,3,3,6,6
"218",2018-02-14,"Mechanized","w1718","Wed","weekday","no_sled",4,"3","3","3",6.2,0.1,30,1,30,20.7,2,0,3,0,3,3,6,6
"219",2018-02-14,"Motorized","w1718","Wed","weekday","sled",89,"3","3","3",6.2,0.1,30,1,30,20.7,2,0,3,0,3,3,6,6
"220",2018-02-14,"Non.motorized","w1718","Wed","weekday","no_sled",138,"3","3","3",6.2,0.1,30,1,30,20.7,2,0,3,0,3,3,6,6
"221",2018-02-15,"Hybrid","w1718","Thu","weekday","sled",13,"3","3","3",6.3,0.1,28,-2,24,22.5,1,2,0,3,-1,1,1,4
"222",2018-02-15,"Mechanized","w1718","Thu","weekday","no_sled",0,"3","3","3",6.3,0.1,28,-2,24,22.5,1,2,0,3,-1,1,1,4
"223",2018-02-15,"Motorized","w1718","Thu","weekday","sled",56,"3","3","3",6.3,0.1,28,-2,24,22.5,1,2,0,3,-1,1,1,4
"224",2018-02-15,"Non.motorized","w1718","Thu","weekday","no_sled",85,"3","3","3",6.3,0.1,28,-2,24,22.5,1,2,0,3,-1,1,1,4
"225",2018-02-16,"Hybrid","w1718","Fri","weekday","sled",15,"3","3","3",6.7,0.4,32,4,18,20.9,-2,1,2,0,2,3,5,5
"226",2018-02-16,"Mechanized","w1718","Fri","weekday","no_sled",1,"3","3","3",6.7,0.4,32,4,18,20.9,-2,1,2,0,2,3,5,5
"227",2018-02-16,"Motorized","w1718","Fri","weekday","sled",136,"3","3","3",6.7,0.4,32,4,18,20.9,-2,1,2,0,2,3,5,5
"228",2018-02-16,"Non.motorized","w1718","Fri","weekday","no_sled",162,"3","3","3",6.7,0.4,32,4,18,20.9,-2,1,2,0,2,3,5,5
"229",2018-02-17,"Hybrid","w1718","Sat","weekend","sled",21,"3","3","2",6.7,0,32,0,25,20.9,4,-2,1,2,4,2,3,5
"230",2018-02-17,"Mechanized","w1718","Sat","weekend","no_sled",19,"3","3","2",6.7,0,32,0,25,20.9,4,-2,1,2,4,2,3,5
"231",2018-02-17,"Motorized","w1718","Sat","weekend","sled",222,"3","3","2",6.7,0,32,0,25,20.9,4,-2,1,2,4,2,3,5
"232",2018-02-17,"Non.motorized","w1718","Sat","weekend","no_sled",557,"3","3","2",6.7,0,32,0,25,20.9,4,-2,1,2,4,2,3,5
"233",2018-02-18,"Hybrid","w1718","Sun","weekend","sled",28,"2","2","2",6.7,0,31,-1,32,21.6,0,4,-2,1,-1,3,1,2
"234",2018-02-18,"Mechanized","w1718","Sun","weekend","no_sled",20,"2","2","2",6.7,0,31,-1,32,21.6,0,4,-2,1,-1,3,1,2
"235",2018-02-18,"Motorized","w1718","Sun","weekend","sled",182,"2","2","2",6.7,0,31,-1,32,21.6,0,4,-2,1,-1,3,1,2
"236",2018-02-18,"Non.motorized","w1718","Sun","weekend","no_sled",514,"2","2","2",6.7,0,31,-1,32,21.6,0,4,-2,1,-1,3,1,2
"237",2018-02-19,"Hybrid","w1718","Mon","weekday","sled",18,"2","2","2",6.8,0.1,29,-2,24,23.4,-1,0,4,-2,-3,-3,1,-1
"238",2018-02-19,"Hybrid","w1718","Mon","weekday","sled",18,"3","3","3",6.8,0.1,29,-2,24,23.4,-1,0,4,-2,-3,-3,1,-1
"239",2018-02-19,"Mechanized","w1718","Mon","weekday","no_sled",1,"2","2","2",6.8,0.1,29,-2,24,23.4,-1,0,4,-2,-3,-3,1,-1
"240",2018-02-19,"Mechanized","w1718","Mon","weekday","no_sled",1,"3","3","3",6.8,0.1,29,-2,24,23.4,-1,0,4,-2,-3,-3,1,-1
"241",2018-02-19,"Motorized","w1718","Mon","weekday","sled",68,"2","2","2",6.8,0.1,29,-2,24,23.4,-1,0,4,-2,-3,-3,1,-1
"242",2018-02-19,"Motorized","w1718","Mon","weekday","sled",68,"3","3","3",6.8,0.1,29,-2,24,23.4,-1,0,4,-2,-3,-3,1,-1
"243",2018-02-19,"Non.motorized","w1718","Mon","weekday","no_sled",130,"2","2","2",6.8,0.1,29,-2,24,23.4,-1,0,4,-2,-3,-3,1,-1
"244",2018-02-19,"Non.motorized","w1718","Mon","weekday","no_sled",130,"3","3","3",6.8,0.1,29,-2,24,23.4,-1,0,4,-2,-3,-3,1,-1
"245",2018-02-20,"Hybrid","w1718","Tue","weekday","sled",2,"3","3","3",6.8,0,31,2,8,21.9,-2,-1,0,4,0,-1,-1,3
"246",2018-02-20,"Mechanized","w1718","Tue","weekday","no_sled",0,"3","3","3",6.8,0,31,2,8,21.9,-2,-1,0,4,0,-1,-1,3
"247",2018-02-20,"Motorized","w1718","Tue","weekday","sled",40,"3","3","3",6.8,0,31,2,8,21.9,-2,-1,0,4,0,-1,-1,3
"248",2018-02-20,"Non.motorized","w1718","Tue","weekday","no_sled",83,"3","3","3",6.8,0,31,2,8,21.9,-2,-1,0,4,0,-1,-1,3
"249",2018-02-21,"Hybrid","w1718","Wed","weekday","sled",7,"3","3","3",6.8,0,31,0,11,21.9,2,-2,-1,0,2,0,-1,-1
"250",2018-02-21,"Mechanized","w1718","Wed","weekday","no_sled",1,"3","3","3",6.8,0,31,0,11,21.9,2,-2,-1,0,2,0,-1,-1
"251",2018-02-21,"Motorized","w1718","Wed","weekday","sled",70,"3","3","3",6.8,0,31,0,11,21.9,2,-2,-1,0,2,0,-1,-1
"252",2018-02-21,"Non.motorized","w1718","Wed","weekday","no_sled",141,"3","3","3",6.8,0,31,0,11,21.9,2,-2,-1,0,2,0,-1,-1
"253",2018-02-22,"Hybrid","w1718","Thu","weekday","sled",3,"3","3","2",6.8,0,30,-1,16,22.7,0,2,-2,-1,-1,1,-1,-2
"254",2018-02-22,"Mechanized","w1718","Thu","weekday","no_sled",1,"3","3","2",6.8,0,30,-1,16,22.7,0,2,-2,-1,-1,1,-1,-2
"255",2018-02-22,"Motorized","w1718","Thu","weekday","sled",52,"3","3","2",6.8,0,30,-1,16,22.7,0,2,-2,-1,-1,1,-1,-2
"256",2018-02-22,"Non.motorized","w1718","Thu","weekday","no_sled",100,"3","3","2",6.8,0,30,-1,16,22.7,0,2,-2,-1,-1,1,-1,-2
"257",2018-02-23,"Hybrid","w1718","Fri","weekday","sled",10,"3","3","2",6.9,0.1,30,0,15,23,-1,0,2,-2,-1,-1,1,-1
"258",2018-02-23,"Mechanized","w1718","Fri","weekday","no_sled",2,"3","3","2",6.9,0.1,30,0,15,23,-1,0,2,-2,-1,-1,1,-1
"259",2018-02-23,"Motorized","w1718","Fri","weekday","sled",79,"3","3","2",6.9,0.1,30,0,15,23,-1,0,2,-2,-1,-1,1,-1
"260",2018-02-23,"Non.motorized","w1718","Fri","weekday","no_sled",166,"3","3","2",6.9,0.1,30,0,15,23,-1,0,2,-2,-1,-1,1,-1
"261",2018-02-24,"Hybrid","w1718","Sat","weekend","sled",16,"3","3","2",6.9,0,31,1,10,22.3,0,-1,0,2,1,0,0,2
"262",2018-02-24,"Mechanized","w1718","Sat","weekend","no_sled",6,"3","3","2",6.9,0,31,1,10,22.3,0,-1,0,2,1,0,0,2
"263",2018-02-24,"Motorized","w1718","Sat","weekend","sled",110,"3","3","2",6.9,0,31,1,10,22.3,0,-1,0,2,1,0,0,2
"264",2018-02-24,"Non.motorized","w1718","Sat","weekend","no_sled",184,"3","3","2",6.9,0,31,1,10,22.3,0,-1,0,2,1,0,0,2
"265",2018-02-25,"Hybrid","w1718","Sun","weekend","sled",18,"3","3","2",7.1,0.2,32,1,11,22.2,1,0,-1,0,2,2,1,1
"266",2018-02-25,"Mechanized","w1718","Sun","weekend","no_sled",16,"3","3","2",7.1,0.2,32,1,11,22.2,1,0,-1,0,2,2,1,1
"267",2018-02-25,"Motorized","w1718","Sun","weekend","sled",77,"3","3","2",7.1,0.2,32,1,11,22.2,1,0,-1,0,2,2,1,1
"268",2018-02-25,"Non.motorized","w1718","Sun","weekend","no_sled",163,"3","3","2",7.1,0.2,32,1,11,22.2,1,0,-1,0,2,2,1,1
"269",2018-02-26,"Hybrid","w1718","Mon","weekday","sled",14,"2","2","2",7.1,0,32,0,20,22.2,1,1,0,-1,1,2,2,1
"270",2018-02-26,"Mechanized","w1718","Mon","weekday","no_sled",9,"2","2","2",7.1,0,32,0,20,22.2,1,1,0,-1,1,2,2,1
"271",2018-02-26,"Motorized","w1718","Mon","weekday","sled",123,"2","2","2",7.1,0,32,0,20,22.2,1,1,0,-1,1,2,2,1
"272",2018-02-26,"Non.motorized","w1718","Mon","weekday","no_sled",153,"2","2","2",7.1,0,32,0,20,22.2,1,1,0,-1,1,2,2,1
"273",2018-02-27,"Hybrid","w1718","Tue","weekday","sled",7,"2","2","2",7.2,0.1,32,0,26,22.5,0,1,1,0,0,1,2,2
"274",2018-02-27,"Mechanized","w1718","Tue","weekday","no_sled",6,"2","2","2",7.2,0.1,32,0,26,22.5,0,1,1,0,0,1,2,2
"275",2018-02-27,"Motorized","w1718","Tue","weekday","sled",98,"2","2","2",7.2,0.1,32,0,26,22.5,0,1,1,0,0,1,2,2
"276",2018-02-27,"Non.motorized","w1718","Tue","weekday","no_sled",163,"2","2","2",7.2,0.1,32,0,26,22.5,0,1,1,0,0,1,2,2
"277",2018-02-28,"Hybrid","w1718","Wed","weekday","sled",5,"2","2","2",7.2,0,31,-1,23,23.2,0,0,1,1,-1,-1,0,1
"278",2018-02-28,"Mechanized","w1718","Wed","weekday","no_sled",3,"2","2","2",7.2,0,31,-1,23,23.2,0,0,1,1,-1,-1,0,1
"279",2018-02-28,"Motorized","w1718","Wed","weekday","sled",95,"2","2","2",7.2,0,31,-1,23,23.2,0,0,1,1,-1,-1,0,1
"280",2018-02-28,"Non.motorized","w1718","Wed","weekday","no_sled",125,"2","2","2",7.2,0,31,-1,23,23.2,0,0,1,1,-1,-1,0,1
"281",2018-03-01,"Hybrid","w1718","Thu","weekday","sled",12,"2","2","2",7.2,0,31,0,24,23.2,-1,0,0,1,-1,-1,-1,0
"282",2018-03-01,"Mechanized","w1718","Thu","weekday","no_sled",26,"2","2","2",7.2,0,31,0,24,23.2,-1,0,0,1,-1,-1,-1,0
"283",2018-03-01,"Motorized","w1718","Thu","weekday","sled",58,"2","2","2",7.2,0,31,0,24,23.2,-1,0,0,1,-1,-1,-1,0
"284",2018-03-01,"Non.motorized","w1718","Thu","weekday","no_sled",136,"2","2","2",7.2,0,31,0,24,23.2,-1,0,0,1,-1,-1,-1,0
"285",2018-03-02,"Hybrid","w1718","Fri","weekday","sled",16,"2","2","1",7.2,0,31,0,30,23.2,0,-1,0,0,0,-1,-1,-1
"286",2018-03-02,"Mechanized","w1718","Fri","weekday","no_sled",7,"2","2","1",7.2,0,31,0,30,23.2,0,-1,0,0,0,-1,-1,-1
"287",2018-03-02,"Motorized","w1718","Fri","weekday","sled",95,"2","2","1",7.2,0,31,0,30,23.2,0,-1,0,0,0,-1,-1,-1
"288",2018-03-02,"Non.motorized","w1718","Fri","weekday","no_sled",198,"2","2","1",7.2,0,31,0,30,23.2,0,-1,0,0,0,-1,-1,-1
"289",2018-03-03,"Hybrid","w1718","Sat","weekend","sled",39,"2","2","1",7.3,0.1,30,-1,34,24.3,0,0,-1,0,-1,-1,-2,-2
"290",2018-03-03,"Mechanized","w1718","Sat","weekend","no_sled",11,"2","2","1",7.3,0.1,30,-1,34,24.3,0,0,-1,0,-1,-1,-2,-2
"291",2018-03-03,"Motorized","w1718","Sat","weekend","sled",147,"2","2","1",7.3,0.1,30,-1,34,24.3,0,0,-1,0,-1,-1,-2,-2
"292",2018-03-03,"Non.motorized","w1718","Sat","weekend","no_sled",468,"2","2","1",7.3,0.1,30,-1,34,24.3,0,0,-1,0,-1,-1,-2,-2
"293",2018-03-04,"Hybrid","w1718","Sun","weekend","sled",22,"2","2","1",7.3,0,29,-1,24,25.2,-1,0,0,-1,-2,-2,-2,-3
"294",2018-03-04,"Mechanized","w1718","Sun","weekend","no_sled",9,"2","2","1",7.3,0,29,-1,24,25.2,-1,0,0,-1,-2,-2,-2,-3
"295",2018-03-04,"Motorized","w1718","Sun","weekend","sled",81,"2","2","1",7.3,0,29,-1,24,25.2,-1,0,0,-1,-2,-2,-2,-3
"296",2018-03-04,"Non.motorized","w1718","Sun","weekend","no_sled",224,"2","2","1",7.3,0,29,-1,24,25.2,-1,0,0,-1,-2,-2,-2,-3
"297",2018-03-05,"Hybrid","w1718","Mon","weekday","sled",3,"2","2","1",7.3,0,31,2,13,23.5,-1,-1,0,0,1,0,0,0
"298",2018-03-05,"Mechanized","w1718","Mon","weekday","no_sled",3,"2","2","1",7.3,0,31,2,13,23.5,-1,-1,0,0,1,0,0,0
"299",2018-03-05,"Motorized","w1718","Mon","weekday","sled",76,"2","2","1",7.3,0,31,2,13,23.5,-1,-1,0,0,1,0,0,0
"300",2018-03-05,"Non.motorized","w1718","Mon","weekday","no_sled",69,"2","2","1",7.3,0,31,2,13,23.5,-1,-1,0,0,1,0,0,0
"301",2018-03-06,"Hybrid","w1718","Tue","weekday","sled",16,"2","2","1",7.3,0,31,0,19,23.5,2,-1,-1,0,2,1,0,0
"302",2018-03-06,"Mechanized","w1718","Tue","weekday","no_sled",1,"2","2","1",7.3,0,31,0,19,23.5,2,-1,-1,0,2,1,0,0
"303",2018-03-06,"Motorized","w1718","Tue","weekday","sled",96,"2","2","1",7.3,0,31,0,19,23.5,2,-1,-1,0,2,1,0,0
"304",2018-03-06,"Non.motorized","w1718","Tue","weekday","no_sled",105,"2","2","1",7.3,0,31,0,19,23.5,2,-1,-1,0,2,1,0,0
"305",2018-03-07,"Hybrid","w1718","Wed","weekday","sled",17,"2","2","1",7.4,0.1,31,0,27,23.9,0,2,-1,-1,0,2,1,0
"306",2018-03-07,"Mechanized","w1718","Wed","weekday","no_sled",5,"2","2","1",7.4,0.1,31,0,27,23.9,0,2,-1,-1,0,2,1,0
"307",2018-03-07,"Motorized","w1718","Wed","weekday","sled",63,"2","2","1",7.4,0.1,31,0,27,23.9,0,2,-1,-1,0,2,1,0
"308",2018-03-07,"Non.motorized","w1718","Wed","weekday","no_sled",128,"2","2","1",7.4,0.1,31,0,27,23.9,0,2,-1,-1,0,2,1,0
"309",2018-03-08,"Hybrid","w1718","Thu","weekday","sled",24,"2","2","1",7.4,0,30,-1,33,24.7,0,0,2,-1,-1,-1,1,0
"310",2018-03-08,"Mechanized","w1718","Thu","weekday","no_sled",2,"2","2","1",7.4,0,30,-1,33,24.7,0,0,2,-1,-1,-1,1,0
"311",2018-03-08,"Motorized","w1718","Thu","weekday","sled",104,"2","2","1",7.4,0,30,-1,33,24.7,0,0,2,-1,-1,-1,1,0
"312",2018-03-08,"Non.motorized","w1718","Thu","weekday","no_sled",97,"2","2","1",7.4,0,30,-1,33,24.7,0,0,2,-1,-1,-1,1,0
"313",2018-03-09,"Hybrid","w1718","Fri","weekday","sled",12,"2","2","1",7.4,0,30,0,34,24.7,-1,0,0,2,-1,-1,-1,1
"314",2018-03-09,"Mechanized","w1718","Fri","weekday","no_sled",5,"2","2","1",7.4,0,30,0,34,24.7,-1,0,0,2,-1,-1,-1,1
"315",2018-03-09,"Motorized","w1718","Fri","weekday","sled",126,"2","2","1",7.4,0,30,0,34,24.7,-1,0,0,2,-1,-1,-1,1
"316",2018-03-09,"Non.motorized","w1718","Fri","weekday","no_sled",157,"2","2","1",7.4,0,30,0,34,24.7,-1,0,0,2,-1,-1,-1,1
"317",2018-03-10,"Hybrid","w1718","Sat","weekend","sled",19,"1","1","1",7.4,0,30,0,31,24.7,0,-1,0,0,0,-1,-1,-1
"318",2018-03-10,"Mechanized","w1718","Sat","weekend","no_sled",11,"1","1","1",7.4,0,30,0,31,24.7,0,-1,0,0,0,-1,-1,-1
"319",2018-03-10,"Motorized","w1718","Sat","weekend","sled",157,"1","1","1",7.4,0,30,0,31,24.7,0,-1,0,0,0,-1,-1,-1
"320",2018-03-10,"Non.motorized","w1718","Sat","weekend","no_sled",281,"1","1","1",7.4,0,30,0,31,24.7,0,-1,0,0,0,-1,-1,-1
"321",2018-03-11,"Hybrid","w1718","Sun","weekend","sled",30,"1","1","1",7.4,0,29,-1,31,25.5,0,0,-1,0,-1,-1,-2,-2
"322",2018-03-11,"Mechanized","w1718","Sun","weekend","no_sled",14,"1","1","1",7.4,0,29,-1,31,25.5,0,0,-1,0,-1,-1,-2,-2
"323",2018-03-11,"Motorized","w1718","Sun","weekend","sled",209,"1","1","1",7.4,0,29,-1,31,25.5,0,0,-1,0,-1,-1,-2,-2
"324",2018-03-11,"Non.motorized","w1718","Sun","weekend","no_sled",291,"1","1","1",7.4,0,29,-1,31,25.5,0,0,-1,0,-1,-1,-2,-2
"325",2018-03-12,"Hybrid","w1718","Mon","weekday","sled",15,"1","1","1",7.4,0,29,0,33,25.5,-1,0,0,-1,-1,-1,-1,-2
"326",2018-03-12,"Mechanized","w1718","Mon","weekday","no_sled",4,"1","1","1",7.4,0,29,0,33,25.5,-1,0,0,-1,-1,-1,-1,-2
"327",2018-03-12,"Motorized","w1718","Mon","weekday","sled",121,"1","1","1",7.4,0,29,0,33,25.5,-1,0,0,-1,-1,-1,-1,-2
"328",2018-03-12,"Non.motorized","w1718","Mon","weekday","no_sled",151,"1","1","1",7.4,0,29,0,33,25.5,-1,0,0,-1,-1,-1,-1,-2
"329",2018-03-13,"Hybrid","w1718","Tue","weekday","sled",14,"1","1","1",7.4,0,29,0,34,25.5,0,-1,0,0,0,-1,-1,-1
"330",2018-03-13,"Mechanized","w1718","Tue","weekday","no_sled",13,"1","1","1",7.4,0,29,0,34,25.5,0,-1,0,0,0,-1,-1,-1
"331",2018-03-13,"Motorized","w1718","Tue","weekday","sled",196,"1","1","1",7.4,0,29,0,34,25.5,0,-1,0,0,0,-1,-1,-1
"332",2018-03-13,"Non.motorized","w1718","Tue","weekday","no_sled",192,"1","1","1",7.4,0,29,0,34,25.5,0,-1,0,0,0,-1,-1,-1
"333",2018-03-14,"Hybrid","w1718","Wed","weekday","sled",13,"1","2","2",7.4,0,29,0,39,25.5,0,0,-1,0,0,0,-1,-1
"334",2018-03-14,"Mechanized","w1718","Wed","weekday","no_sled",10,"1","2","2",7.4,0,29,0,39,25.5,0,0,-1,0,0,0,-1,-1
"335",2018-03-14,"Motorized","w1718","Wed","weekday","sled",162,"1","2","2",7.4,0,29,0,39,25.5,0,0,-1,0,0,0,-1,-1
"336",2018-03-14,"Non.motorized","w1718","Wed","weekday","no_sled",161,"1","2","2",7.4,0,29,0,39,25.5,0,0,-1,0,0,0,-1,-1
"337",2018-03-15,"Hybrid","w1718","Thu","weekday","sled",12,"2","2","2",7.5,0.1,28,-1,31,26.8,0,0,0,-1,-1,-1,-1,-2
"338",2018-03-15,"Mechanized","w1718","Thu","weekday","no_sled",2,"2","2","2",7.5,0.1,28,-1,31,26.8,0,0,0,-1,-1,-1,-1,-2
"339",2018-03-15,"Motorized","w1718","Thu","weekday","sled",177,"2","2","2",7.5,0.1,28,-1,31,26.8,0,0,0,-1,-1,-1,-1,-2
"340",2018-03-15,"Non.motorized","w1718","Thu","weekday","no_sled",96,"2","2","2",7.5,0.1,28,-1,31,26.8,0,0,0,-1,-1,-1,-1,-2
"341",2018-03-16,"Hybrid","w1718","Fri","weekday","sled",29,"2","2","2",7.7,0.2,29,1,25,26.6,-1,0,0,0,0,0,0,0
"342",2018-03-16,"Mechanized","w1718","Fri","weekday","no_sled",3,"2","2","2",7.7,0.2,29,1,25,26.6,-1,0,0,0,0,0,0,0
"343",2018-03-16,"Motorized","w1718","Fri","weekday","sled",140,"2","2","2",7.7,0.2,29,1,25,26.6,-1,0,0,0,0,0,0,0
"344",2018-03-16,"Non.motorized","w1718","Fri","weekday","no_sled",158,"2","2","2",7.7,0.2,29,1,25,26.6,-1,0,0,0,0,0,0,0
"345",2018-03-17,"Hybrid","w1718","Sat","weekend","sled",36,"2","2","2",7.8,0.1,32,3,29,24.4,1,-1,0,0,4,3,3,3
"346",2018-03-17,"Mechanized","w1718","Sat","weekend","no_sled",9,"2","2","2",7.8,0.1,32,3,29,24.4,1,-1,0,0,4,3,3,3
"347",2018-03-17,"Motorized","w1718","Sat","weekend","sled",173,"2","2","2",7.8,0.1,32,3,29,24.4,1,-1,0,0,4,3,3,3
"348",2018-03-17,"Non.motorized","w1718","Sat","weekend","no_sled",278,"2","2","2",7.8,0.1,32,3,29,24.4,1,-1,0,0,4,3,3,3
"349",2018-03-18,"Hybrid","w1718","Sun","weekend","sled",30,"2","2","2",7.9,0.1,31,-1,24,25.5,3,1,-1,0,2,3,2,2
"350",2018-03-18,"Mechanized","w1718","Sun","weekend","no_sled",6,"2","2","2",7.9,0.1,31,-1,24,25.5,3,1,-1,0,2,3,2,2
"351",2018-03-18,"Motorized","w1718","Sun","weekend","sled",125,"2","2","2",7.9,0.1,31,-1,24,25.5,3,1,-1,0,2,3,2,2
"352",2018-03-18,"Non.motorized","w1718","Sun","weekend","no_sled",132,"2","2","2",7.9,0.1,31,-1,24,25.5,3,1,-1,0,2,3,2,2
"353",2018-03-19,"Hybrid","w1718","Mon","weekday","sled",22,"2","2","1",8,0.1,32,1,19,25,-1,3,1,-1,0,3,4,3
"354",2018-03-19,"Mechanized","w1718","Mon","weekday","no_sled",1,"2","2","1",8,0.1,32,1,19,25,-1,3,1,-1,0,3,4,3
"355",2018-03-19,"Motorized","w1718","Mon","weekday","sled",89,"2","2","1",8,0.1,32,1,19,25,-1,3,1,-1,0,3,4,3
"356",2018-03-19,"Non.motorized","w1718","Mon","weekday","no_sled",140,"2","2","1",8,0.1,32,1,19,25,-1,3,1,-1,0,3,4,3
"357",2018-03-20,"Hybrid","w1718","Tue","weekday","sled",21,"2","2","1",8,0,30,-2,24,26.7,1,-1,3,1,-1,-2,1,2
"358",2018-03-20,"Mechanized","w1718","Tue","weekday","no_sled",2,"2","2","1",8,0,30,-2,24,26.7,1,-1,3,1,-1,-2,1,2
"359",2018-03-20,"Motorized","w1718","Tue","weekday","sled",116,"2","2","1",8,0,30,-2,24,26.7,1,-1,3,1,-1,-2,1,2
"360",2018-03-20,"Non.motorized","w1718","Tue","weekday","no_sled",142,"2","2","1",8,0,30,-2,24,26.7,1,-1,3,1,-1,-2,1,2
"361",2018-03-21,"Hybrid","w1718","Wed","weekday","sled",16,"1","1","1",8.1,0.1,32,2,30,25.3,-2,1,-1,3,0,1,0,3
"362",2018-03-21,"Mechanized","w1718","Wed","weekday","no_sled",5,"1","1","1",8.1,0.1,32,2,30,25.3,-2,1,-1,3,0,1,0,3
"363",2018-03-21,"Motorized","w1718","Wed","weekday","sled",109,"1","1","1",8.1,0.1,32,2,30,25.3,-2,1,-1,3,0,1,0,3
"364",2018-03-21,"Non.motorized","w1718","Wed","weekday","no_sled",387,"1","1","1",8.1,0.1,32,2,30,25.3,-2,1,-1,3,0,1,0,3
"365",2018-03-22,"Hybrid","w1718","Thu","weekday","sled",14,"1","1","1",8.1,0,30,-2,36,27,2,-2,1,-1,0,-2,-1,-2
"366",2018-03-22,"Mechanized","w1718","Thu","weekday","no_sled",1,"1","1","1",8.1,0,30,-2,36,27,2,-2,1,-1,0,-2,-1,-2
"367",2018-03-22,"Motorized","w1718","Thu","weekday","sled",84,"1","1","1",8.1,0,30,-2,36,27,2,-2,1,-1,0,-2,-1,-2
"368",2018-03-22,"Non.motorized","w1718","Thu","weekday","no_sled",162,"1","1","1",8.1,0,30,-2,36,27,2,-2,1,-1,0,-2,-1,-2
"369",2018-03-23,"Hybrid","w1718","Fri","weekday","sled",3,"2","2","3",8.2,0.1,29,-1,34,28.3,-2,2,-2,1,-3,-1,-3,-2
"370",2018-03-23,"Mechanized","w1718","Fri","weekday","no_sled",0,"2","2","3",8.2,0.1,29,-1,34,28.3,-2,2,-2,1,-3,-1,-3,-2
"371",2018-03-23,"Motorized","w1718","Fri","weekday","sled",36,"2","2","3",8.2,0.1,29,-1,34,28.3,-2,2,-2,1,-3,-1,-3,-2
"372",2018-03-23,"Non.motorized","w1718","Fri","weekday","no_sled",43,"2","2","3",8.2,0.1,29,-1,34,28.3,-2,2,-2,1,-3,-1,-3,-2
"373",2018-03-24,"Hybrid","w1718","Sat","weekend","sled",9,"2","2","1",8.9,0.7,34,5,32,26.2,-1,-2,2,-2,4,2,4,2
"374",2018-03-24,"Mechanized","w1718","Sat","weekend","no_sled",14,"2","2","1",8.9,0.7,34,5,32,26.2,-1,-2,2,-2,4,2,4,2
"375",2018-03-24,"Motorized","w1718","Sat","weekend","sled",103,"2","2","1",8.9,0.7,34,5,32,26.2,-1,-2,2,-2,4,2,4,2
"376",2018-03-24,"Non.motorized","w1718","Sat","weekend","no_sled",186,"2","2","1",8.9,0.7,34,5,32,26.2,-1,-2,2,-2,4,2,4,2
"377",2018-03-25,"Hybrid","w1718","Sun","weekend","sled",28,"2","2","1",8.9,0,35,1,35,25.4,5,-1,-2,2,6,5,3,5
"378",2018-03-25,"Mechanized","w1718","Sun","weekend","no_sled",3,"2","2","1",8.9,0,35,1,35,25.4,5,-1,-2,2,6,5,3,5
"379",2018-03-25,"Motorized","w1718","Sun","weekend","sled",122,"2","2","1",8.9,0,35,1,35,25.4,5,-1,-2,2,6,5,3,5
"380",2018-03-25,"Non.motorized","w1718","Sun","weekend","no_sled",228,"2","2","1",8.9,0,35,1,35,25.4,5,-1,-2,2,6,5,3,5
"381",2018-03-26,"Hybrid","w1718","Mon","weekday","sled",15,"1","1","1",8.9,0,34,-1,31,26.2,1,5,-1,-2,0,5,4,2
"382",2018-03-26,"Hybrid","w1718","Mon","weekday","sled",15,"2","1","1",8.9,0,34,-1,31,26.2,1,5,-1,-2,0,5,4,2
"383",2018-03-26,"Mechanized","w1718","Mon","weekday","no_sled",9,"1","1","1",8.9,0,34,-1,31,26.2,1,5,-1,-2,0,5,4,2
"384",2018-03-26,"Mechanized","w1718","Mon","weekday","no_sled",9,"2","1","1",8.9,0,34,-1,31,26.2,1,5,-1,-2,0,5,4,2
"385",2018-03-26,"Motorized","w1718","Mon","weekday","sled",91,"1","1","1",8.9,0,34,-1,31,26.2,1,5,-1,-2,0,5,4,2
"386",2018-03-26,"Motorized","w1718","Mon","weekday","sled",91,"2","1","1",8.9,0,34,-1,31,26.2,1,5,-1,-2,0,5,4,2
"387",2018-03-26,"Non.motorized","w1718","Mon","weekday","no_sled",178,"1","1","1",8.9,0,34,-1,31,26.2,1,5,-1,-2,0,5,4,2
"388",2018-03-26,"Non.motorized","w1718","Mon","weekday","no_sled",178,"2","1","1",8.9,0,34,-1,31,26.2,1,5,-1,-2,0,5,4,2
"389",2018-03-27,"Hybrid","w1718","Tue","weekday","sled",11,"1","1","1",8.9,0,33,-1,29,27,-1,1,5,-1,-2,-1,4,3
"390",2018-03-27,"Mechanized","w1718","Tue","weekday","no_sled",5,"1","1","1",8.9,0,33,-1,29,27,-1,1,5,-1,-2,-1,4,3
"391",2018-03-27,"Motorized","w1718","Tue","weekday","sled",75,"1","1","1",8.9,0,33,-1,29,27,-1,1,5,-1,-2,-1,4,3
"392",2018-03-27,"Non.motorized","w1718","Tue","weekday","no_sled",116,"1","1","1",8.9,0,33,-1,29,27,-1,1,5,-1,-2,-1,4,3
"393",2018-03-28,"Hybrid","w1718","Wed","weekday","sled",11,"1","1","1",8.9,0,33,0,27,27,-1,-1,1,5,-1,-2,-1,4
"394",2018-03-28,"Mechanized","w1718","Wed","weekday","no_sled",0,"1","1","1",8.9,0,33,0,27,27,-1,-1,1,5,-1,-2,-1,4
"395",2018-03-28,"Motorized","w1718","Wed","weekday","sled",67,"1","1","1",8.9,0,33,0,27,27,-1,-1,1,5,-1,-2,-1,4
"396",2018-03-28,"Non.motorized","w1718","Wed","weekday","no_sled",119,"1","1","1",8.9,0,33,0,27,27,-1,-1,1,5,-1,-2,-1,4
"397",2018-03-29,"Hybrid","w1718","Thu","weekday","sled",17,"1","1","1",8.9,0,33,0,27,27,0,-1,-1,1,0,-1,-2,-1
"398",2018-03-29,"Mechanized","w1718","Thu","weekday","no_sled",10,"1","1","1",8.9,0,33,0,27,27,0,-1,-1,1,0,-1,-2,-1
"399",2018-03-29,"Motorized","w1718","Thu","weekday","sled",82,"1","1","1",8.9,0,33,0,27,27,0,-1,-1,1,0,-1,-2,-1
"400",2018-03-29,"Non.motorized","w1718","Thu","weekday","no_sled",139,"1","1","1",8.9,0,33,0,27,27,0,-1,-1,1,0,-1,-2,-1
"401",2018-03-30,"Hybrid","w1718","Fri","weekday","sled",21,"1","1","1",8.9,0,32,-1,33,27.8,0,0,-1,-1,-1,-1,-2,-3
"402",2018-03-30,"Mechanized","w1718","Fri","weekday","no_sled",3,"1","1","1",8.9,0,32,-1,33,27.8,0,0,-1,-1,-1,-1,-2,-3
"403",2018-03-30,"Motorized","w1718","Fri","weekday","sled",106,"1","1","1",8.9,0,32,-1,33,27.8,0,0,-1,-1,-1,-1,-2,-3
"404",2018-03-30,"Non.motorized","w1718","Fri","weekday","no_sled",175,"1","1","1",8.9,0,32,-1,33,27.8,0,0,-1,-1,-1,-1,-2,-3
"405",2018-03-31,"Hybrid","w1718","Sat","weekend","sled",23,"1","1","1",8.9,0,32,0,39,27.8,-1,0,0,-1,-1,-1,-1,-2
"406",2018-03-31,"Mechanized","w1718","Sat","weekend","no_sled",1,"1","1","1",8.9,0,32,0,39,27.8,-1,0,0,-1,-1,-1,-1,-2
"407",2018-03-31,"Motorized","w1718","Sat","weekend","sled",92,"1","1","1",8.9,0,32,0,39,27.8,-1,0,0,-1,-1,-1,-1,-2
"408",2018-03-31,"Non.motorized","w1718","Sat","weekend","no_sled",209,"1","1","1",8.9,0,32,0,39,27.8,-1,0,0,-1,-1,-1,-1,-2
"409",2018-04-01,"Hybrid","w1718","Sun","weekend","sled",23,"1","1","1",8.8,-0.1,30,-2,41,29.3,0,-1,0,0,-2,-3,-3,-3
"410",2018-04-01,"Mechanized","w1718","Sun","weekend","no_sled",1,"1","1","1",8.8,-0.1,30,-2,41,29.3,0,-1,0,0,-2,-3,-3,-3
"411",2018-04-01,"Motorized","w1718","Sun","weekend","sled",65,"1","1","1",8.8,-0.1,30,-2,41,29.3,0,-1,0,0,-2,-3,-3,-3
"412",2018-04-01,"Non.motorized","w1718","Sun","weekend","no_sled",105,"1","1","1",8.8,-0.1,30,-2,41,29.3,0,-1,0,0,-2,-3,-3,-3
"413",2018-04-02,"Hybrid","w1718","Mon","weekday","sled",9,"1","1","1",8.7,-0.1,29,-1,39,30,-2,0,-1,0,-3,-3,-4,-4
"414",2018-04-02,"Mechanized","w1718","Mon","weekday","no_sled",0,"1","1","1",8.7,-0.1,29,-1,39,30,-2,0,-1,0,-3,-3,-4,-4
"415",2018-04-02,"Motorized","w1718","Mon","weekday","sled",50,"1","1","1",8.7,-0.1,29,-1,39,30,-2,0,-1,0,-3,-3,-4,-4
"416",2018-04-02,"Non.motorized","w1718","Mon","weekday","no_sled",52,"1","1","1",8.7,-0.1,29,-1,39,30,-2,0,-1,0,-3,-3,-4,-4
"417",2018-04-03,"Hybrid","w1718","Tue","weekday","sled",9,"1","1","1",8.8,0.1,30,1,27,29.3,-1,-2,0,-1,0,-2,-2,-3
"418",2018-04-03,"Mechanized","w1718","Tue","weekday","no_sled",0,"1","1","1",8.8,0.1,30,1,27,29.3,-1,-2,0,-1,0,-2,-2,-3
"419",2018-04-03,"Motorized","w1718","Tue","weekday","sled",61,"1","1","1",8.8,0.1,30,1,27,29.3,-1,-2,0,-1,0,-2,-2,-3
"420",2018-04-03,"Non.motorized","w1718","Tue","weekday","no_sled",41,"1","1","1",8.8,0.1,30,1,27,29.3,-1,-2,0,-1,0,-2,-2,-3
"421",2018-04-04,"Hybrid","w1718","Wed","weekday","sled",7,"1","2","2",8.9,0.1,28,-2,33,31.8,1,-1,-2,0,-1,-2,-4,-4
"422",2018-04-04,"Mechanized","w1718","Wed","weekday","no_sled",1,"1","2","2",8.9,0.1,28,-2,33,31.8,1,-1,-2,0,-1,-2,-4,-4
"423",2018-04-04,"Motorized","w1718","Wed","weekday","sled",68,"1","2","2",8.9,0.1,28,-2,33,31.8,1,-1,-2,0,-1,-2,-4,-4
"424",2018-04-04,"Non.motorized","w1718","Wed","weekday","no_sled",73,"1","2","2",8.9,0.1,28,-2,33,31.8,1,-1,-2,0,-1,-2,-4,-4
"425",2018-04-05,"Hybrid","w1718","Thu","weekday","sled",14,"1","2","2",8.9,0,27,-1,35,33,-2,1,-1,-2,-3,-2,-3,-5
"426",2018-04-05,"Mechanized","w1718","Thu","weekday","no_sled",1,"1","2","2",8.9,0,27,-1,35,33,-2,1,-1,-2,-3,-2,-3,-5
"427",2018-04-05,"Motorized","w1718","Thu","weekday","sled",68,"1","2","2",8.9,0,27,-1,35,33,-2,1,-1,-2,-3,-2,-3,-5
"428",2018-04-05,"Non.motorized","w1718","Thu","weekday","no_sled",52,"1","2","2",8.9,0,27,-1,35,33,-2,1,-1,-2,-3,-2,-3,-5
"429",2018-04-06,"Hybrid","w1718","Fri","weekday","sled",8,"1","2","2",8.9,0,25,-2,35,35.6,-1,-2,1,-1,-3,-5,-4,-5
"430",2018-04-06,"Mechanized","w1718","Fri","weekday","no_sled",0,"1","2","2",8.9,0,25,-2,35,35.6,-1,-2,1,-1,-3,-5,-4,-5
"431",2018-04-06,"Motorized","w1718","Fri","weekday","sled",91,"1","2","2",8.9,0,25,-2,35,35.6,-1,-2,1,-1,-3,-5,-4,-5
"432",2018-04-06,"Non.motorized","w1718","Fri","weekday","no_sled",30,"1","2","2",8.9,0,25,-2,35,35.6,-1,-2,1,-1,-3,-5,-4,-5
"433",2018-04-07,"Hybrid","w1718","Sat","weekend","sled",10,"2","2","2",9.2,0.3,31,6,37,29.7,-2,-1,-2,1,4,3,1,2
"434",2018-04-07,"Mechanized","w1718","Sat","weekend","no_sled",0,"2","2","2",9.2,0.3,31,6,37,29.7,-2,-1,-2,1,4,3,1,2
"435",2018-04-07,"Motorized","w1718","Sat","weekend","sled",58,"2","2","2",9.2,0.3,31,6,37,29.7,-2,-1,-2,1,4,3,1,2
"436",2018-04-07,"Non.motorized","w1718","Sat","weekend","no_sled",69,"2","2","2",9.2,0.3,31,6,37,29.7,-2,-1,-2,1,4,3,1,2
"437",2018-04-08,"Hybrid","w1718","Sun","weekend","sled",1,"3","3","3",10,0.8,33,2,33,30.3,6,-2,-1,-2,8,6,5,3
"438",2018-04-08,"Mechanized","w1718","Sun","weekend","no_sled",2,"3","3","3",10,0.8,33,2,33,30.3,6,-2,-1,-2,8,6,5,3
"439",2018-04-08,"Motorized","w1718","Sun","weekend","sled",46,"3","3","3",10,0.8,33,2,33,30.3,6,-2,-1,-2,8,6,5,3
"440",2018-04-08,"Non.motorized","w1718","Sun","weekend","no_sled",27,"3","3","3",10,0.8,33,2,33,30.3,6,-2,-1,-2,8,6,5,3
"441",2018-04-09,"Hybrid","w1718","Mon","weekday","sled",3,"1","1","1",10.1,0.1,33,0,31,30.6,2,6,-2,-1,2,8,6,5
"442",2018-04-09,"Mechanized","w1718","Mon","weekday","no_sled",0,"1","1","1",10.1,0.1,33,0,31,30.6,2,6,-2,-1,2,8,6,5
"443",2018-04-09,"Motorized","w1718","Mon","weekday","sled",12,"1","1","1",10.1,0.1,33,0,31,30.6,2,6,-2,-1,2,8,6,5
"444",2018-04-09,"Non.motorized","w1718","Mon","weekday","no_sled",42,"1","1","1",10.1,0.1,33,0,31,30.6,2,6,-2,-1,2,8,6,5
"445",2018-04-10,"Hybrid","w1718","Tue","weekday","sled",8,"1","1","1",10.1,0,31,-2,38,32.6,0,2,6,-2,-2,0,6,4
"446",2018-04-10,"Mechanized","w1718","Tue","weekday","no_sled",0,"1","1","1",10.1,0,31,-2,38,32.6,0,2,6,-2,-2,0,6,4
"447",2018-04-10,"Motorized","w1718","Tue","weekday","sled",11,"1","1","1",10.1,0,31,-2,38,32.6,0,2,6,-2,-2,0,6,4
"448",2018-04-10,"Non.motorized","w1718","Tue","weekday","no_sled",42,"1","1","1",10.1,0,31,-2,38,32.6,0,2,6,-2,-2,0,6,4
"449",2018-04-11,"Hybrid","w1718","Wed","weekday","sled",7,"2","2","2",9.9,-0.2,29,-2,45,34.1,-2,0,2,6,-4,-4,-2,4
"450",2018-04-11,"Mechanized","w1718","Wed","weekday","no_sled",0,"2","2","2",9.9,-0.2,29,-2,45,34.1,-2,0,2,6,-4,-4,-2,4
"451",2018-04-11,"Motorized","w1718","Wed","weekday","sled",9,"2","2","2",9.9,-0.2,29,-2,45,34.1,-2,0,2,6,-4,-4,-2,4
"452",2018-04-11,"Non.motorized","w1718","Wed","weekday","no_sled",30,"2","2","2",9.9,-0.2,29,-2,45,34.1,-2,0,2,6,-4,-4,-2,4
"453",2018-04-12,"Hybrid","w1718","Thu","weekday","sled",3,"1","2","2",9.5,-0.4,28,-1,40,33.9,-2,-2,0,2,-3,-5,-5,-3
"454",2018-04-12,"Mechanized","w1718","Thu","weekday","no_sled",0,"1","2","2",9.5,-0.4,28,-1,40,33.9,-2,-2,0,2,-3,-5,-5,-3
"455",2018-04-12,"Motorized","w1718","Thu","weekday","sled",5,"1","2","2",9.5,-0.4,28,-1,40,33.9,-2,-2,0,2,-3,-5,-5,-3
"456",2018-04-12,"Non.motorized","w1718","Thu","weekday","no_sled",18,"1","2","2",9.5,-0.4,28,-1,40,33.9,-2,-2,0,2,-3,-5,-5,-3
"457",2018-04-13,"Hybrid","w1718","Fri","weekday","sled",0,"2","2","1",9.4,-0.1,26,-2,23,36.2,-1,-2,-2,0,-3,-5,-7,-7
"458",2018-04-13,"Mechanized","w1718","Fri","weekday","no_sled",1,"2","2","1",9.4,-0.1,26,-2,23,36.2,-1,-2,-2,0,-3,-5,-7,-7
"459",2018-04-13,"Motorized","w1718","Fri","weekday","sled",9,"2","2","1",9.4,-0.1,26,-2,23,36.2,-1,-2,-2,0,-3,-5,-7,-7
"460",2018-04-13,"Non.motorized","w1718","Fri","weekday","no_sled",29,"2","2","1",9.4,-0.1,26,-2,23,36.2,-1,-2,-2,0,-3,-5,-7,-7
"461",2018-04-14,"Hybrid","w1718","Sat","weekend","sled",6,"2","2","1",9.4,0,28,2,28,33.6,-2,-1,-2,-2,0,-1,-3,-5
"462",2018-04-14,"Mechanized","w1718","Sat","weekend","no_sled",0,"2","2","1",9.4,0,28,2,28,33.6,-2,-1,-2,-2,0,-1,-3,-5
"463",2018-04-14,"Motorized","w1718","Sat","weekend","sled",15,"2","2","1",9.4,0,28,2,28,33.6,-2,-1,-2,-2,0,-1,-3,-5
"464",2018-04-14,"Non.motorized","w1718","Sat","weekend","no_sled",53,"2","2","1",9.4,0,28,2,28,33.6,-2,-1,-2,-2,0,-1,-3,-5
"465",2018-04-15,"Hybrid","w1718","Sun","weekend","sled",3,"2","2","1",9.2,-0.2,27,-1,37,34.1,2,-2,-1,-2,1,-1,-2,-4
"466",2018-04-15,"Mechanized","w1718","Sun","weekend","no_sled",2,"2","2","1",9.2,-0.2,27,-1,37,34.1,2,-2,-1,-2,1,-1,-2,-4
"467",2018-04-15,"Motorized","w1718","Sun","weekend","sled",11,"2","2","1",9.2,-0.2,27,-1,37,34.1,2,-2,-1,-2,1,-1,-2,-4
"468",2018-04-15,"Non.motorized","w1718","Sun","weekend","no_sled",47,"2","2","1",9.2,-0.2,27,-1,37,34.1,2,-2,-1,-2,1,-1,-2,-4
"469",2018-04-16,"Hybrid","w1718","Mon","weekday","sled",2,NA,NA,NA,8.9,-0.3,24,-3,43,37.1,-1,2,-2,-1,-4,-2,-4,-5
"470",2018-04-16,"Mechanized","w1718","Mon","weekday","no_sled",0,NA,NA,NA,8.9,-0.3,24,-3,43,37.1,-1,2,-2,-1,-4,-2,-4,-5
"471",2018-04-16,"Motorized","w1718","Mon","weekday","sled",4,NA,NA,NA,8.9,-0.3,24,-3,43,37.1,-1,2,-2,-1,-4,-2,-4,-5
"472",2018-04-16,"Non.motorized","w1718","Mon","weekday","no_sled",8,NA,NA,NA,8.9,-0.3,24,-3,43,37.1,-1,2,-2,-1,-4,-2,-4,-5
"473",2018-12-01,"Hybrid","w1819","Sat","weekend","sled",0,"3","3","2",3.3,0.2,19,1,16,17.4,0,0,0,0,1,1,1,1
"474",2018-12-01,"Mechanized","w1819","Sat","weekend","no_sled",1,"3","3","2",3.3,0.2,19,1,16,17.4,0,0,0,0,1,1,1,1
"475",2018-12-01,"Motorized","w1819","Sat","weekend","sled",4,"3","3","2",3.3,0.2,19,1,16,17.4,0,0,0,0,1,1,1,1
"476",2018-12-01,"Non.motorized","w1819","Sat","weekend","no_sled",129,"3","3","2",3.3,0.2,19,1,16,17.4,0,0,0,0,1,1,1,1
"477",2018-12-02,"Hybrid","w1819","Sun","weekend","sled",2,"3","3","3",3.3,0,20,1,14,16.5,1,0,0,0,2,2,2,2
"478",2018-12-02,"Mechanized","w1819","Sun","weekend","no_sled",0,"3","3","3",3.3,0,20,1,14,16.5,1,0,0,0,2,2,2,2
"479",2018-12-02,"Motorized","w1819","Sun","weekend","sled",6,"3","3","3",3.3,0,20,1,14,16.5,1,0,0,0,2,2,2,2
"480",2018-12-02,"Non.motorized","w1819","Sun","weekend","no_sled",58,"3","3","3",3.3,0,20,1,14,16.5,1,0,0,0,2,2,2,2
"481",2018-12-03,"Hybrid","w1819","Mon","weekday","sled",2,"3","3","2",3.4,0.1,19,-1,13,17.9,1,1,0,0,0,1,1,1
"482",2018-12-03,"Mechanized","w1819","Mon","weekday","no_sled",0,"3","3","2",3.4,0.1,19,-1,13,17.9,1,1,0,0,0,1,1,1
"483",2018-12-03,"Motorized","w1819","Mon","weekday","sled",3,"3","3","2",3.4,0.1,19,-1,13,17.9,1,1,0,0,0,1,1,1
"484",2018-12-03,"Non.motorized","w1819","Mon","weekday","no_sled",18,"3","3","2",3.4,0.1,19,-1,13,17.9,1,1,0,0,0,1,1,1
"485",2018-12-04,"Hybrid","w1819","Tue","weekday","sled",2,"3","3","2",3.5,0.1,20,1,8,17.5,-1,1,1,0,0,1,2,2
"486",2018-12-04,"Mechanized","w1819","Tue","weekday","no_sled",1,"3","3","2",3.5,0.1,20,1,8,17.5,-1,1,1,0,0,1,2,2
"487",2018-12-04,"Motorized","w1819","Tue","weekday","sled",7,"3","3","2",3.5,0.1,20,1,8,17.5,-1,1,1,0,0,1,2,2
"488",2018-12-04,"Non.motorized","w1819","Tue","weekday","no_sled",24,"3","3","2",3.5,0.1,20,1,8,17.5,-1,1,1,0,0,1,2,2
"489",2018-12-05,"Hybrid","w1819","Wed","weekday","sled",10,"3","3","2",3.5,0,19,-1,21,18.4,1,-1,1,1,0,-1,0,1
"490",2018-12-05,"Mechanized","w1819","Wed","weekday","no_sled",1,"3","3","2",3.5,0,19,-1,21,18.4,1,-1,1,1,0,-1,0,1
"491",2018-12-05,"Motorized","w1819","Wed","weekday","sled",15,"3","3","2",3.5,0,19,-1,21,18.4,1,-1,1,1,0,-1,0,1
"492",2018-12-05,"Non.motorized","w1819","Wed","weekday","no_sled",56,"3","3","2",3.5,0,19,-1,21,18.4,1,-1,1,1,0,-1,0,1
"493",2018-12-06,"Hybrid","w1819","Thu","weekday","sled",10,"2","2","2",3.7,0.2,18,-1,25,20.6,-1,1,-1,1,-2,-1,-2,-1
"494",2018-12-06,"Mechanized","w1819","Thu","weekday","no_sled",0,"2","2","2",3.7,0.2,18,-1,25,20.6,-1,1,-1,1,-2,-1,-2,-1
"495",2018-12-06,"Motorized","w1819","Thu","weekday","sled",21,"2","2","2",3.7,0.2,18,-1,25,20.6,-1,1,-1,1,-2,-1,-2,-1
"496",2018-12-06,"Non.motorized","w1819","Thu","weekday","no_sled",41,"2","2","2",3.7,0.2,18,-1,25,20.6,-1,1,-1,1,-2,-1,-2,-1
"497",2018-12-07,"Hybrid","w1819","Fri","weekday","sled",16,"2","2","2",3.8,0.1,21,3,23,18.1,-1,-1,1,-1,2,1,2,1
"498",2018-12-07,"Mechanized","w1819","Fri","weekday","no_sled",4,"2","2","2",3.8,0.1,21,3,23,18.1,-1,-1,1,-1,2,1,2,1
"499",2018-12-07,"Motorized","w1819","Fri","weekday","sled",32,"2","2","2",3.8,0.1,21,3,23,18.1,-1,-1,1,-1,2,1,2,1
"500",2018-12-07,"Non.motorized","w1819","Fri","weekday","no_sled",60,"2","2","2",3.8,0.1,21,3,23,18.1,-1,-1,1,-1,2,1,2,1
"501",2018-12-08,"Hybrid","w1819","Sat","weekend","sled",22,"2","2","2",3.8,0,20,-1,23,19,3,-1,-1,1,2,1,0,1
"502",2018-12-08,"Mechanized","w1819","Sat","weekend","no_sled",8,"2","2","2",3.8,0,20,-1,23,19,3,-1,-1,1,2,1,0,1
"503",2018-12-08,"Motorized","w1819","Sat","weekend","sled",72,"2","2","2",3.8,0,20,-1,23,19,3,-1,-1,1,2,1,0,1
"504",2018-12-08,"Non.motorized","w1819","Sat","weekend","no_sled",151,"2","2","2",3.8,0,20,-1,23,19,3,-1,-1,1,2,1,0,1
"505",2018-12-09,"Hybrid","w1819","Sun","weekend","sled",19,"2","2","2",3.8,0,20,0,19,19,-1,3,-1,-1,-1,2,1,0
"506",2018-12-09,"Mechanized","w1819","Sun","weekend","no_sled",10,"2","2","2",3.8,0,20,0,19,19,-1,3,-1,-1,-1,2,1,0
"507",2018-12-09,"Motorized","w1819","Sun","weekend","sled",55,"2","2","2",3.8,0,20,0,19,19,-1,3,-1,-1,-1,2,1,0
"508",2018-12-09,"Non.motorized","w1819","Sun","weekend","no_sled",192,"2","2","2",3.8,0,20,0,19,19,-1,3,-1,-1,-1,2,1,0
"509",2018-12-10,"Hybrid","w1819","Mon","weekday","sled",12,"2","2","2",3.8,0,20,0,21,19,0,-1,3,-1,0,-1,2,1
"510",2018-12-10,"Mechanized","w1819","Mon","weekday","no_sled",2,"2","2","2",3.8,0,20,0,21,19,0,-1,3,-1,0,-1,2,1
"511",2018-12-10,"Motorized","w1819","Mon","weekday","sled",42,"2","2","2",3.8,0,20,0,21,19,0,-1,3,-1,0,-1,2,1
"512",2018-12-10,"Non.motorized","w1819","Mon","weekday","no_sled",50,"2","2","2",3.8,0,20,0,21,19,0,-1,3,-1,0,-1,2,1
"513",2018-12-11,"Hybrid","w1819","Tue","weekday","sled",9,"2","2","2",3.9,0.1,19,-1,27,20.5,0,0,-1,3,-1,-1,-2,1
"514",2018-12-11,"Mechanized","w1819","Tue","weekday","no_sled",1,"2","2","2",3.9,0.1,19,-1,27,20.5,0,0,-1,3,-1,-1,-2,1
"515",2018-12-11,"Motorized","w1819","Tue","weekday","sled",26,"2","2","2",3.9,0.1,19,-1,27,20.5,0,0,-1,3,-1,-1,-2,1
"516",2018-12-11,"Non.motorized","w1819","Tue","weekday","no_sled",64,"2","2","2",3.9,0.1,19,-1,27,20.5,0,0,-1,3,-1,-1,-2,1
"517",2018-12-12,"Hybrid","w1819","Wed","weekday","sled",4,"2","2","1",3.9,0,19,0,21,20.5,-1,0,0,-1,-1,-1,-1,-2
"518",2018-12-12,"Mechanized","w1819","Wed","weekday","no_sled",2,"2","2","1",3.9,0,19,0,21,20.5,-1,0,0,-1,-1,-1,-1,-2
"519",2018-12-12,"Motorized","w1819","Wed","weekday","sled",12,"2","2","1",3.9,0,19,0,21,20.5,-1,0,0,-1,-1,-1,-1,-2
"520",2018-12-12,"Non.motorized","w1819","Wed","weekday","no_sled",54,"2","2","1",3.9,0,19,0,21,20.5,-1,0,0,-1,-1,-1,-1,-2
"521",2018-12-13,"Hybrid","w1819","Thu","weekday","sled",1,"3","3","2",4,0.1,21,2,15,19,0,-1,0,0,2,1,1,1
"522",2018-12-13,"Mechanized","w1819","Thu","weekday","no_sled",2,"3","3","2",4,0.1,21,2,15,19,0,-1,0,0,2,1,1,1
"523",2018-12-13,"Motorized","w1819","Thu","weekday","sled",21,"3","3","2",4,0.1,21,2,15,19,0,-1,0,0,2,1,1,1
"524",2018-12-13,"Non.motorized","w1819","Thu","weekday","no_sled",37,"3","3","2",4,0.1,21,2,15,19,0,-1,0,0,2,1,1,1
"525",2018-12-14,"Hybrid","w1819","Fri","weekday","sled",9,"3","3","2",4,0,20,-1,24,20,2,0,-1,0,1,1,0,0
"526",2018-12-14,"Mechanized","w1819","Fri","weekday","no_sled",0,"3","3","2",4,0,20,-1,24,20,2,0,-1,0,1,1,0,0
"527",2018-12-14,"Motorized","w1819","Fri","weekday","sled",35,"3","3","2",4,0,20,-1,24,20,2,0,-1,0,1,1,0,0
"528",2018-12-14,"Non.motorized","w1819","Fri","weekday","no_sled",51,"3","3","2",4,0,20,-1,24,20,2,0,-1,0,1,1,0,0
"529",2018-12-15,"Hybrid","w1819","Sat","weekend","sled",9,"2","2","2",4,0,20,0,29,20,-1,2,0,-1,-1,1,1,0
"530",2018-12-15,"Mechanized","w1819","Sat","weekend","no_sled",8,"2","2","2",4,0,20,0,29,20,-1,2,0,-1,-1,1,1,0
"531",2018-12-15,"Motorized","w1819","Sat","weekend","sled",44,"2","2","2",4,0,20,0,29,20,-1,2,0,-1,-1,1,1,0
"532",2018-12-15,"Non.motorized","w1819","Sat","weekend","no_sled",158,"2","2","2",4,0,20,0,29,20,-1,2,0,-1,-1,1,1,0
"533",2018-12-16,"Hybrid","w1819","Sun","weekend","sled",26,"2","2","2",4.1,0.1,19,-1,28,21.6,0,-1,2,0,-1,-2,0,0
"534",2018-12-16,"Mechanized","w1819","Sun","weekend","no_sled",9,"2","2","2",4.1,0.1,19,-1,28,21.6,0,-1,2,0,-1,-2,0,0
"535",2018-12-16,"Motorized","w1819","Sun","weekend","sled",59,"2","2","2",4.1,0.1,19,-1,28,21.6,0,-1,2,0,-1,-2,0,0
"536",2018-12-16,"Non.motorized","w1819","Sun","weekend","no_sled",194,"2","2","2",4.1,0.1,19,-1,28,21.6,0,-1,2,0,-1,-2,0,0
"537",2018-12-17,"Hybrid","w1819","Mon","weekday","sled",8,"2","2","2",4.1,0,19,0,29,21.6,-1,0,-1,2,-1,-1,-2,0
"538",2018-12-17,"Mechanized","w1819","Mon","weekday","no_sled",7,"2","2","2",4.1,0,19,0,29,21.6,-1,0,-1,2,-1,-1,-2,0
"539",2018-12-17,"Motorized","w1819","Mon","weekday","sled",32,"2","2","2",4.1,0,19,0,29,21.6,-1,0,-1,2,-1,-1,-2,0
"540",2018-12-17,"Non.motorized","w1819","Mon","weekday","no_sled",49,"2","2","2",4.1,0,19,0,29,21.6,-1,0,-1,2,-1,-1,-2,0
"541",2018-12-18,"Hybrid","w1819","Tue","weekday","sled",13,"2","2","2",4.1,0,19,0,27,21.6,0,-1,0,-1,0,-1,-1,-2
"542",2018-12-18,"Mechanized","w1819","Tue","weekday","no_sled",2,"2","2","2",4.1,0,19,0,27,21.6,0,-1,0,-1,0,-1,-1,-2
"543",2018-12-18,"Motorized","w1819","Tue","weekday","sled",38,"2","2","2",4.1,0,19,0,27,21.6,0,-1,0,-1,0,-1,-1,-2
"544",2018-12-18,"Non.motorized","w1819","Tue","weekday","no_sled",62,"2","2","2",4.1,0,19,0,27,21.6,0,-1,0,-1,0,-1,-1,-2
"545",2018-12-19,"Hybrid","w1819","Wed","weekday","sled",4,"2","2","2",4.1,0,19,0,24,21.6,0,0,-1,0,0,0,-1,-1
"546",2018-12-19,"Mechanized","w1819","Wed","weekday","no_sled",0,"2","2","2",4.1,0,19,0,24,21.6,0,0,-1,0,0,0,-1,-1
"547",2018-12-19,"Motorized","w1819","Wed","weekday","sled",17,"2","2","2",4.1,0,19,0,24,21.6,0,0,-1,0,0,0,-1,-1
"548",2018-12-19,"Non.motorized","w1819","Wed","weekday","no_sled",70,"2","2","2",4.1,0,19,0,24,21.6,0,0,-1,0,0,0,-1,-1
"549",2018-12-20,"Hybrid","w1819","Thu","weekday","sled",16,"2","2","1",4.1,0,20,1,25,20.5,0,0,0,-1,1,1,1,0
"550",2018-12-20,"Mechanized","w1819","Thu","weekday","no_sled",4,"2","2","1",4.1,0,20,1,25,20.5,0,0,0,-1,1,1,1,0
"551",2018-12-20,"Motorized","w1819","Thu","weekday","sled",33,"2","2","1",4.1,0,20,1,25,20.5,0,0,0,-1,1,1,1,0
"552",2018-12-20,"Non.motorized","w1819","Thu","weekday","no_sled",101,"2","2","1",4.1,0,20,1,25,20.5,0,0,0,-1,1,1,1,0
"553",2018-12-21,"Hybrid","w1819","Fri","weekday","sled",6,"2","2","1",4.1,0,19,-1,28,21.6,1,0,0,0,0,0,0,0
"554",2018-12-21,"Mechanized","w1819","Fri","weekday","no_sled",7,"2","2","1",4.1,0,19,-1,28,21.6,1,0,0,0,0,0,0,0
"555",2018-12-21,"Motorized","w1819","Fri","weekday","sled",38,"2","2","1",4.1,0,19,-1,28,21.6,1,0,0,0,0,0,0,0
"556",2018-12-21,"Non.motorized","w1819","Fri","weekday","no_sled",105,"2","2","1",4.1,0,19,-1,28,21.6,1,0,0,0,0,0,0,0
"557",2018-12-22,"Hybrid","w1819","Sat","weekend","sled",10,"2","2","1",4.2,0.1,19,0,20,22.1,-1,1,0,0,-1,0,0,0
"558",2018-12-22,"Mechanized","w1819","Sat","weekend","no_sled",1,"2","2","1",4.2,0.1,19,0,20,22.1,-1,1,0,0,-1,0,0,0
"559",2018-12-22,"Motorized","w1819","Sat","weekend","sled",36,"2","2","1",4.2,0.1,19,0,20,22.1,-1,1,0,0,-1,0,0,0
"560",2018-12-22,"Non.motorized","w1819","Sat","weekend","no_sled",143,"2","2","1",4.2,0.1,19,0,20,22.1,-1,1,0,0,-1,0,0,0
"561",2018-12-23,"Hybrid","w1819","Sun","weekend","sled",19,"2","2","1",4.2,0,21,2,19,20,0,-1,1,0,2,1,2,2
"562",2018-12-23,"Mechanized","w1819","Sun","weekend","no_sled",8,"2","2","1",4.2,0,21,2,19,20,0,-1,1,0,2,1,2,2
"563",2018-12-23,"Motorized","w1819","Sun","weekend","sled",79,"2","2","1",4.2,0,21,2,19,20,0,-1,1,0,2,1,2,2
"564",2018-12-23,"Non.motorized","w1819","Sun","weekend","no_sled",251,"2","2","1",4.2,0,21,2,19,20,0,-1,1,0,2,1,2,2
"565",2018-12-24,"Hybrid","w1819","Mon","weekday","sled",15,"2","2","2",4.3,0.1,20,-1,21,21.5,2,0,-1,1,1,1,0,1
"566",2018-12-24,"Mechanized","w1819","Mon","weekday","no_sled",2,"2","2","2",4.3,0.1,20,-1,21,21.5,2,0,-1,1,1,1,0,1
"567",2018-12-24,"Motorized","w1819","Mon","weekday","sled",41,"2","2","2",4.3,0.1,20,-1,21,21.5,2,0,-1,1,1,1,0,1
"568",2018-12-24,"Non.motorized","w1819","Mon","weekday","no_sled",89,"2","2","2",4.3,0.1,20,-1,21,21.5,2,0,-1,1,1,1,0,1
"569",2018-12-25,"Hybrid","w1819","Tue","weekday","sled",22,"2","2","2",4.7,0.4,25,5,25,18.8,-1,2,0,-1,4,6,6,5
"570",2018-12-25,"Mechanized","w1819","Tue","weekday","no_sled",0,"2","2","2",4.7,0.4,25,5,25,18.8,-1,2,0,-1,4,6,6,5
"571",2018-12-25,"Motorized","w1819","Tue","weekday","sled",106,"2","2","2",4.7,0.4,25,5,25,18.8,-1,2,0,-1,4,6,6,5
"572",2018-12-25,"Non.motorized","w1819","Tue","weekday","no_sled",172,"2","2","2",4.7,0.4,25,5,25,18.8,-1,2,0,-1,4,6,6,5
"573",2018-12-26,"Hybrid","w1819","Wed","weekday","sled",19,"3","3","3",4.7,0,23,-2,24,20.4,5,-1,2,0,3,2,4,4
"574",2018-12-26,"Mechanized","w1819","Wed","weekday","no_sled",2,"3","3","3",4.7,0,23,-2,24,20.4,5,-1,2,0,3,2,4,4
"575",2018-12-26,"Motorized","w1819","Wed","weekday","sled",125,"3","3","3",4.7,0,23,-2,24,20.4,5,-1,2,0,3,2,4,4
"576",2018-12-26,"Non.motorized","w1819","Wed","weekday","no_sled",136,"3","3","3",4.7,0,23,-2,24,20.4,5,-1,2,0,3,2,4,4
"577",2018-12-27,"Hybrid","w1819","Thu","weekday","sled",11,"3","3","2",4.7,0,24,1,12,19.6,-2,5,-1,2,-1,4,3,5
"578",2018-12-27,"Mechanized","w1819","Thu","weekday","no_sled",1,"3","3","2",4.7,0,24,1,12,19.6,-2,5,-1,2,-1,4,3,5
"579",2018-12-27,"Motorized","w1819","Thu","weekday","sled",67,"3","3","2",4.7,0,24,1,12,19.6,-2,5,-1,2,-1,4,3,5
"580",2018-12-27,"Non.motorized","w1819","Thu","weekday","no_sled",133,"3","3","2",4.7,0,24,1,12,19.6,-2,5,-1,2,-1,4,3,5
"581",2018-12-28,"Hybrid","w1819","Fri","weekday","sled",13,"3","3","2",4.7,0,24,0,12,19.6,1,-2,5,-1,1,-1,4,3
"582",2018-12-28,"Mechanized","w1819","Fri","weekday","no_sled",4,"3","3","2",4.7,0,24,0,12,19.6,1,-2,5,-1,1,-1,4,3
"583",2018-12-28,"Motorized","w1819","Fri","weekday","sled",89,"3","3","2",4.7,0,24,0,12,19.6,1,-2,5,-1,1,-1,4,3
"584",2018-12-28,"Non.motorized","w1819","Fri","weekday","no_sled",156,"3","3","2",4.7,0,24,0,12,19.6,1,-2,5,-1,1,-1,4,3
"585",2018-12-29,"Hybrid","w1819","Sat","weekend","sled",17,"3","3","2",4.7,0,24,0,8,19.6,0,1,-2,5,0,1,-1,4
"586",2018-12-29,"Mechanized","w1819","Sat","weekend","no_sled",11,"3","3","2",4.7,0,24,0,8,19.6,0,1,-2,5,0,1,-1,4
"587",2018-12-29,"Motorized","w1819","Sat","weekend","sled",264,"3","3","2",4.7,0,24,0,8,19.6,0,1,-2,5,0,1,-1,4
"588",2018-12-29,"Non.motorized","w1819","Sat","weekend","no_sled",331,"3","3","2",4.7,0,24,0,8,19.6,0,1,-2,5,0,1,-1,4
"589",2018-12-30,"Hybrid","w1819","Sun","weekend","sled",25,"3","3","2",4.7,0,24,0,16,19.6,0,0,1,-2,0,0,1,-1
"590",2018-12-30,"Mechanized","w1819","Sun","weekend","no_sled",16,"3","3","2",4.7,0,24,0,16,19.6,0,0,1,-2,0,0,1,-1
"591",2018-12-30,"Motorized","w1819","Sun","weekend","sled",238,"3","3","2",4.7,0,24,0,16,19.6,0,0,1,-2,0,0,1,-1
"592",2018-12-30,"Non.motorized","w1819","Sun","weekend","no_sled",289,"3","3","2",4.7,0,24,0,16,19.6,0,0,1,-2,0,0,1,-1
"593",2018-12-31,"Hybrid","w1819","Mon","weekday","sled",8,"3","3","3",4.9,0.2,23,-1,14,21.3,0,0,0,1,-1,-1,-1,0
"594",2018-12-31,"Mechanized","w1819","Mon","weekday","no_sled",0,"3","3","3",4.9,0.2,23,-1,14,21.3,0,0,0,1,-1,-1,-1,0
"595",2018-12-31,"Motorized","w1819","Mon","weekday","sled",63,"3","3","3",4.9,0.2,23,-1,14,21.3,0,0,0,1,-1,-1,-1,0
"596",2018-12-31,"Non.motorized","w1819","Mon","weekday","no_sled",129,"3","3","3",4.9,0.2,23,-1,14,21.3,0,0,0,1,-1,-1,-1,0
"597",2019-01-01,"Hybrid","w1819","Tue","weekday","sled",23,"3","3","3",5.1,0.2,29,6,11,17.6,-1,0,0,0,5,5,5,5
"598",2019-01-01,"Mechanized","w1819","Tue","weekday","no_sled",7,"3","3","3",5.1,0.2,29,6,11,17.6,-1,0,0,0,5,5,5,5
"599",2019-01-01,"Motorized","w1819","Tue","weekday","sled",113,"3","3","3",5.1,0.2,29,6,11,17.6,-1,0,0,0,5,5,5,5
"600",2019-01-01,"Non.motorized","w1819","Tue","weekday","no_sled",152,"3","3","3",5.1,0.2,29,6,11,17.6,-1,0,0,0,5,5,5,5
"601",2019-01-02,"Hybrid","w1819","Wed","weekday","sled",4,"3","3","2",5.1,0,28,-1,10,18.2,6,-1,0,0,5,4,4,4
"602",2019-01-02,"Mechanized","w1819","Wed","weekday","no_sled",1,"3","3","2",5.1,0,28,-1,10,18.2,6,-1,0,0,5,4,4,4
"603",2019-01-02,"Motorized","w1819","Wed","weekday","sled",125,"3","3","2",5.1,0,28,-1,10,18.2,6,-1,0,0,5,4,4,4
"604",2019-01-02,"Non.motorized","w1819","Wed","weekday","no_sled",117,"3","3","2",5.1,0,28,-1,10,18.2,6,-1,0,0,5,4,4,4
"605",2019-01-03,"Hybrid","w1819","Thu","weekday","sled",9,"3","3","2",5.1,0,27,-1,22,18.9,-1,6,-1,0,-2,4,3,3
"606",2019-01-03,"Mechanized","w1819","Thu","weekday","no_sled",2,"3","3","2",5.1,0,27,-1,22,18.9,-1,6,-1,0,-2,4,3,3
"607",2019-01-03,"Motorized","w1819","Thu","weekday","sled",184,"3","3","2",5.1,0,27,-1,22,18.9,-1,6,-1,0,-2,4,3,3
"608",2019-01-03,"Non.motorized","w1819","Thu","weekday","no_sled",225,"3","3","2",5.1,0,27,-1,22,18.9,-1,6,-1,0,-2,4,3,3
"609",2019-01-04,"Hybrid","w1819","Fri","weekday","sled",20,"3","3","2",5.3,0.2,26,-1,29,20.4,-1,-1,6,-1,-2,-3,3,2
"610",2019-01-04,"Mechanized","w1819","Fri","weekday","no_sled",19,"3","3","2",5.3,0.2,26,-1,29,20.4,-1,-1,6,-1,-2,-3,3,2
"611",2019-01-04,"Motorized","w1819","Fri","weekday","sled",176,"3","3","2",5.3,0.2,26,-1,29,20.4,-1,-1,6,-1,-2,-3,3,2
"612",2019-01-04,"Non.motorized","w1819","Fri","weekday","no_sled",186,"3","3","2",5.3,0.2,26,-1,29,20.4,-1,-1,6,-1,-2,-3,3,2
"613",2019-01-05,"Hybrid","w1819","Sat","weekend","sled",22,"2","2","2",5.3,0,25,-1,30,21.2,-1,-1,-1,6,-2,-3,-4,2
"614",2019-01-05,"Mechanized","w1819","Sat","weekend","no_sled",15,"2","2","2",5.3,0,25,-1,30,21.2,-1,-1,-1,6,-2,-3,-4,2
"615",2019-01-05,"Motorized","w1819","Sat","weekend","sled",123,"2","2","2",5.3,0,25,-1,30,21.2,-1,-1,-1,6,-2,-3,-4,2
"616",2019-01-05,"Non.motorized","w1819","Sat","weekend","no_sled",240,"2","2","2",5.3,0,25,-1,30,21.2,-1,-1,-1,6,-2,-3,-4,2
"617",2019-01-06,"Hybrid","w1819","Sun","weekend","sled",8,"3","3","3",5.3,0,25,0,26,21.2,-1,-1,-1,-1,-1,-2,-3,-4
"618",2019-01-06,"Mechanized","w1819","Sun","weekend","no_sled",0,"3","3","3",5.3,0,25,0,26,21.2,-1,-1,-1,-1,-1,-2,-3,-4
"619",2019-01-06,"Motorized","w1819","Sun","weekend","sled",13,"3","3","3",5.3,0,25,0,26,21.2,-1,-1,-1,-1,-1,-2,-3,-4
"620",2019-01-06,"Non.motorized","w1819","Sun","weekend","no_sled",120,"3","3","3",5.3,0,25,0,26,21.2,-1,-1,-1,-1,-1,-2,-3,-4
"621",2019-01-07,"Hybrid","w1819","Mon","weekday","sled",7,"3","3","3",5.8,0.5,32,7,21,18.1,0,-1,-1,-1,7,6,5,4
"622",2019-01-07,"Mechanized","w1819","Mon","weekday","no_sled",0,"3","3","3",5.8,0.5,32,7,21,18.1,0,-1,-1,-1,7,6,5,4
"623",2019-01-07,"Motorized","w1819","Mon","weekday","sled",9,"3","3","3",5.8,0.5,32,7,21,18.1,0,-1,-1,-1,7,6,5,4
"624",2019-01-07,"Non.motorized","w1819","Mon","weekday","no_sled",17,"3","3","3",5.8,0.5,32,7,21,18.1,0,-1,-1,-1,7,6,5,4
"625",2019-01-08,"Hybrid","w1819","Tue","weekday","sled",9,"3","3","3",5.9,0.1,32,0,24,18.4,7,0,-1,-1,7,7,6,5
"626",2019-01-08,"Mechanized","w1819","Tue","weekday","no_sled",1,"3","3","3",5.9,0.1,32,0,24,18.4,7,0,-1,-1,7,7,6,5
"627",2019-01-08,"Motorized","w1819","Tue","weekday","sled",59,"3","3","3",5.9,0.1,32,0,24,18.4,7,0,-1,-1,7,7,6,5
"628",2019-01-08,"Non.motorized","w1819","Tue","weekday","no_sled",105,"3","3","3",5.9,0.1,32,0,24,18.4,7,0,-1,-1,7,7,6,5
"629",2019-01-09,"Hybrid","w1819","Wed","weekday","sled",16,"3","3","3",6,0.1,30,-2,29,20,0,7,0,-1,-2,5,5,4
"630",2019-01-09,"Mechanized","w1819","Wed","weekday","no_sled",4,"3","3","3",6,0.1,30,-2,29,20,0,7,0,-1,-2,5,5,4
"631",2019-01-09,"Motorized","w1819","Wed","weekday","sled",69,"3","3","3",6,0.1,30,-2,29,20,0,7,0,-1,-2,5,5,4
"632",2019-01-09,"Non.motorized","w1819","Wed","weekday","no_sled",134,"3","3","3",6,0.1,30,-2,29,20,0,7,0,-1,-2,5,5,4
"633",2019-01-10,"Hybrid","w1819","Thu","weekday","sled",11,"3","3","3",6,0,29,-1,29,20.7,-2,0,7,0,-3,-3,4,4
"634",2019-01-10,"Mechanized","w1819","Thu","weekday","no_sled",14,"3","3","3",6,0,29,-1,29,20.7,-2,0,7,0,-3,-3,4,4
"635",2019-01-10,"Motorized","w1819","Thu","weekday","sled",84,"3","3","3",6,0,29,-1,29,20.7,-2,0,7,0,-3,-3,4,4
"636",2019-01-10,"Non.motorized","w1819","Thu","weekday","no_sled",163,"3","3","3",6,0,29,-1,29,20.7,-2,0,7,0,-3,-3,4,4
"637",2019-01-11,"Hybrid","w1819","Fri","weekday","sled",16,"2","2","2",6.1,0.1,29,0,25,21,-1,-2,0,7,-1,-3,-3,4
"638",2019-01-11,"Mechanized","w1819","Fri","weekday","no_sled",5,"2","2","2",6.1,0.1,29,0,25,21,-1,-2,0,7,-1,-3,-3,4
"639",2019-01-11,"Motorized","w1819","Fri","weekday","sled",64,"2","2","2",6.1,0.1,29,0,25,21,-1,-2,0,7,-1,-3,-3,4
"640",2019-01-11,"Non.motorized","w1819","Fri","weekday","no_sled",149,"2","2","2",6.1,0.1,29,0,25,21,-1,-2,0,7,-1,-3,-3,4
"641",2019-01-12,"Hybrid","w1819","Sat","weekend","sled",16,"3","3","2",6.1,0,28,-1,21,21.8,0,-1,-2,0,-1,-2,-4,-4
"642",2019-01-12,"Mechanized","w1819","Sat","weekend","no_sled",8,"3","3","2",6.1,0,28,-1,21,21.8,0,-1,-2,0,-1,-2,-4,-4
"643",2019-01-12,"Motorized","w1819","Sat","weekend","sled",51,"3","3","2",6.1,0,28,-1,21,21.8,0,-1,-2,0,-1,-2,-4,-4
"644",2019-01-12,"Non.motorized","w1819","Sat","weekend","no_sled",209,"3","3","2",6.1,0,28,-1,21,21.8,0,-1,-2,0,-1,-2,-4,-4
"645",2019-01-13,"Hybrid","w1819","Sun","weekend","sled",15,"2","2","2",6.2,0.1,30,2,18,20.7,-1,0,-1,-2,1,1,0,-2
"646",2019-01-13,"Mechanized","w1819","Sun","weekend","no_sled",5,"2","2","2",6.2,0.1,30,2,18,20.7,-1,0,-1,-2,1,1,0,-2
"647",2019-01-13,"Motorized","w1819","Sun","weekend","sled",62,"2","2","2",6.2,0.1,30,2,18,20.7,-1,0,-1,-2,1,1,0,-2
"648",2019-01-13,"Non.motorized","w1819","Sun","weekend","no_sled",208,"2","2","2",6.2,0.1,30,2,18,20.7,-1,0,-1,-2,1,1,0,-2
"649",2019-01-14,"Hybrid","w1819","Mon","weekday","sled",12,"2","2","2",6.2,0,30,0,18,20.7,2,-1,0,-1,2,1,1,0
"650",2019-01-14,"Mechanized","w1819","Mon","weekday","no_sled",1,"2","2","2",6.2,0,30,0,18,20.7,2,-1,0,-1,2,1,1,0
"651",2019-01-14,"Motorized","w1819","Mon","weekday","sled",49,"2","2","2",6.2,0,30,0,18,20.7,2,-1,0,-1,2,1,1,0
"652",2019-01-14,"Non.motorized","w1819","Mon","weekday","no_sled",100,"2","2","2",6.2,0,30,0,18,20.7,2,-1,0,-1,2,1,1,0
"653",2019-01-15,"Hybrid","w1819","Tue","weekday","sled",11,"2","2","2",6.2,0,29,-1,24,21.4,0,2,-1,0,-1,1,0,0
"654",2019-01-15,"Mechanized","w1819","Tue","weekday","no_sled",2,"2","2","2",6.2,0,29,-1,24,21.4,0,2,-1,0,-1,1,0,0
"655",2019-01-15,"Motorized","w1819","Tue","weekday","sled",61,"2","2","2",6.2,0,29,-1,24,21.4,0,2,-1,0,-1,1,0,0
"656",2019-01-15,"Non.motorized","w1819","Tue","weekday","no_sled",128,"2","2","2",6.2,0,29,-1,24,21.4,0,2,-1,0,-1,1,0,0
"657",2019-01-16,"Hybrid","w1819","Wed","weekday","sled",0,"4","4","3",6.3,0.1,29,0,26,21.7,-1,0,2,-1,-1,-1,1,0
"658",2019-01-16,"Mechanized","w1819","Wed","weekday","no_sled",0,"4","4","3",6.3,0.1,29,0,26,21.7,-1,0,2,-1,-1,-1,1,0
"659",2019-01-16,"Motorized","w1819","Wed","weekday","sled",2,"4","4","3",6.3,0.1,29,0,26,21.7,-1,0,2,-1,-1,-1,1,0
"660",2019-01-16,"Non.motorized","w1819","Wed","weekday","no_sled",35,"4","4","3",6.3,0.1,29,0,26,21.7,-1,0,2,-1,-1,-1,1,0
"661",2019-01-17,"Hybrid","w1819","Thu","weekday","sled",8,"3","3","2",7,0.7,38,9,28,18.4,0,-1,0,2,9,8,8,10
"662",2019-01-17,"Mechanized","w1819","Thu","weekday","no_sled",0,"3","3","2",7,0.7,38,9,28,18.4,0,-1,0,2,9,8,8,10
"663",2019-01-17,"Motorized","w1819","Thu","weekday","sled",23,"3","3","2",7,0.7,38,9,28,18.4,0,-1,0,2,9,8,8,10
"664",2019-01-17,"Non.motorized","w1819","Thu","weekday","no_sled",63,"3","3","2",7,0.7,38,9,28,18.4,0,-1,0,2,9,8,8,10
"665",2019-01-18,"Hybrid","w1819","Fri","weekday","sled",1,"4","4","4",7.5,0.5,41,3,22,18.3,9,0,-1,0,12,12,11,11
"666",2019-01-18,"Mechanized","w1819","Fri","weekday","no_sled",0,"4","4","4",7.5,0.5,41,3,22,18.3,9,0,-1,0,12,12,11,11
"667",2019-01-18,"Motorized","w1819","Fri","weekday","sled",9,"4","4","4",7.5,0.5,41,3,22,18.3,9,0,-1,0,12,12,11,11
"668",2019-01-18,"Non.motorized","w1819","Fri","weekday","no_sled",24,"4","4","4",7.5,0.5,41,3,22,18.3,9,0,-1,0,12,12,11,11
"669",2019-01-19,"Hybrid","w1819","Sat","weekend","sled",6,"3","3","3",7.8,0.3,43,2,20,18.1,3,9,0,-1,5,14,14,13
"670",2019-01-19,"Mechanized","w1819","Sat","weekend","no_sled",0,"3","3","3",7.8,0.3,43,2,20,18.1,3,9,0,-1,5,14,14,13
"671",2019-01-19,"Motorized","w1819","Sat","weekend","sled",83,"3","3","3",7.8,0.3,43,2,20,18.1,3,9,0,-1,5,14,14,13
"672",2019-01-19,"Non.motorized","w1819","Sat","weekend","no_sled",119,"3","3","3",7.8,0.3,43,2,20,18.1,3,9,0,-1,5,14,14,13
"673",2019-01-20,"Hybrid","w1819","Sun","weekend","sled",8,"3","3","3",7.9,0.1,41,-2,27,19.3,2,3,9,0,0,3,12,12
"674",2019-01-20,"Mechanized","w1819","Sun","weekend","no_sled",3,"3","3","3",7.9,0.1,41,-2,27,19.3,2,3,9,0,0,3,12,12
"675",2019-01-20,"Motorized","w1819","Sun","weekend","sled",110,"3","3","3",7.9,0.1,41,-2,27,19.3,2,3,9,0,0,3,12,12
"676",2019-01-20,"Non.motorized","w1819","Sun","weekend","no_sled",142,"3","3","3",7.9,0.1,41,-2,27,19.3,2,3,9,0,0,3,12,12
"677",2019-01-21,"Hybrid","w1819","Mon","weekday","sled",0,"3","3","3",7.9,0,39,-2,23,20.3,-2,2,3,9,-4,-2,1,10
"678",2019-01-21,"Mechanized","w1819","Mon","weekday","no_sled",0,"3","3","3",7.9,0,39,-2,23,20.3,-2,2,3,9,-4,-2,1,10
"679",2019-01-21,"Motorized","w1819","Mon","weekday","sled",15,"3","3","3",7.9,0,39,-2,23,20.3,-2,2,3,9,-4,-2,1,10
"680",2019-01-21,"Non.motorized","w1819","Mon","weekday","no_sled",2,"3","3","3",7.9,0,39,-2,23,20.3,-2,2,3,9,-4,-2,1,10
"681",2019-01-22,"Hybrid","w1819","Tue","weekday","sled",0,"3","3","3",8,0.1,41,2,12,19.5,-2,-2,2,3,0,-2,0,3
"682",2019-01-22,"Mechanized","w1819","Tue","weekday","no_sled",1,"3","3","3",8,0.1,41,2,12,19.5,-2,-2,2,3,0,-2,0,3
"683",2019-01-22,"Motorized","w1819","Tue","weekday","sled",12,"3","3","3",8,0.1,41,2,12,19.5,-2,-2,2,3,0,-2,0,3
"684",2019-01-22,"Non.motorized","w1819","Tue","weekday","no_sled",109,"3","3","3",8,0.1,41,2,12,19.5,-2,-2,2,3,0,-2,0,3
"685",2019-01-23,"Hybrid","w1819","Wed","weekday","sled",0,"3","3","2",8,0,40,-1,14,20,2,-2,-2,2,1,-1,-3,-1
"686",2019-01-23,"Mechanized","w1819","Wed","weekday","no_sled",3,"3","3","2",8,0,40,-1,14,20,2,-2,-2,2,1,-1,-3,-1
"687",2019-01-23,"Motorized","w1819","Wed","weekday","sled",10,"3","3","2",8,0,40,-1,14,20,2,-2,-2,2,1,-1,-3,-1
"688",2019-01-23,"Non.motorized","w1819","Wed","weekday","no_sled",83,"3","3","2",8,0,40,-1,14,20,2,-2,-2,2,1,-1,-3,-1
"689",2019-01-24,"Hybrid","w1819","Thu","weekday","sled",0,"3","3","2",8.2,0.2,40,0,17,20.5,-1,2,-2,-2,-1,1,-1,-3
"690",2019-01-24,"Mechanized","w1819","Thu","weekday","no_sled",13,"3","3","2",8.2,0.2,40,0,17,20.5,-1,2,-2,-2,-1,1,-1,-3
"691",2019-01-24,"Motorized","w1819","Thu","weekday","sled",3,"3","3","2",8.2,0.2,40,0,17,20.5,-1,2,-2,-2,-1,1,-1,-3
"692",2019-01-24,"Non.motorized","w1819","Thu","weekday","no_sled",61,"3","3","2",8.2,0.2,40,0,17,20.5,-1,2,-2,-2,-1,1,-1,-3
"693",2019-01-25,"Hybrid","w1819","Fri","weekday","sled",0,"3","3","2",8.3,0.1,40,0,15,20.8,0,-1,2,-2,0,-1,1,-1
"694",2019-01-25,"Mechanized","w1819","Fri","weekday","no_sled",56,"3","3","2",8.3,0.1,40,0,15,20.8,0,-1,2,-2,0,-1,1,-1
"695",2019-01-25,"Motorized","w1819","Fri","weekday","sled",18,"3","3","2",8.3,0.1,40,0,15,20.8,0,-1,2,-2,0,-1,1,-1
"696",2019-01-25,"Non.motorized","w1819","Fri","weekday","no_sled",159,"3","3","2",8.3,0.1,40,0,15,20.8,0,-1,2,-2,0,-1,1,-1
"697",2019-01-26,"Hybrid","w1819","Sat","weekend","sled",13,"3","3","2",8.3,0,39,-1,19,21.3,0,0,-1,2,-1,-1,-2,0
"698",2019-01-26,"Mechanized","w1819","Sat","weekend","no_sled",14,"3","3","2",8.3,0,39,-1,19,21.3,0,0,-1,2,-1,-1,-2,0
"699",2019-01-26,"Motorized","w1819","Sat","weekend","sled",27,"3","3","2",8.3,0,39,-1,19,21.3,0,0,-1,2,-1,-1,-2,0
"700",2019-01-26,"Non.motorized","w1819","Sat","weekend","no_sled",324,"3","3","2",8.3,0,39,-1,19,21.3,0,0,-1,2,-1,-1,-2,0
"701",2019-01-27,"Hybrid","w1819","Sun","weekend","sled",5,"3","3","2",8.3,0,38,-1,24,21.8,-1,0,0,-1,-2,-2,-2,-3
"702",2019-01-27,"Mechanized","w1819","Sun","weekend","no_sled",9,"3","3","2",8.3,0,38,-1,24,21.8,-1,0,0,-1,-2,-2,-2,-3
"703",2019-01-27,"Motorized","w1819","Sun","weekend","sled",9,"3","3","2",8.3,0,38,-1,24,21.8,-1,0,0,-1,-2,-2,-2,-3
"704",2019-01-27,"Non.motorized","w1819","Sun","weekend","no_sled",204,"3","3","2",8.3,0,38,-1,24,21.8,-1,0,0,-1,-2,-2,-2,-3
"705",2019-01-28,"Hybrid","w1819","Mon","weekday","sled",1,"2","2","2",8.3,0,38,0,17,21.8,-1,-1,0,0,-1,-2,-2,-2
"706",2019-01-28,"Mechanized","w1819","Mon","weekday","no_sled",0,"2","2","2",8.3,0,38,0,17,21.8,-1,-1,0,0,-1,-2,-2,-2
"707",2019-01-28,"Motorized","w1819","Mon","weekday","sled",5,"2","2","2",8.3,0,38,0,17,21.8,-1,-1,0,0,-1,-2,-2,-2
"708",2019-01-28,"Non.motorized","w1819","Mon","weekday","no_sled",31,"2","2","2",8.3,0,38,0,17,21.8,-1,-1,0,0,-1,-2,-2,-2
"709",2019-01-29,"Hybrid","w1819","Tue","weekday","sled",0,"2","2","2",8.3,0,38,0,16,21.8,0,-1,-1,0,0,-1,-2,-2
"710",2019-01-29,"Mechanized","w1819","Tue","weekday","no_sled",2,"2","2","2",8.3,0,38,0,16,21.8,0,-1,-1,0,0,-1,-2,-2
"711",2019-01-29,"Motorized","w1819","Tue","weekday","sled",82,"2","2","2",8.3,0,38,0,16,21.8,0,-1,-1,0,0,-1,-2,-2
"712",2019-01-29,"Non.motorized","w1819","Tue","weekday","no_sled",51,"2","2","2",8.3,0,38,0,16,21.8,0,-1,-1,0,0,-1,-2,-2
"713",2019-01-30,"Hybrid","w1819","Wed","weekday","sled",12,"2","2","1",8.3,0,37,-1,20,22.4,0,0,-1,-1,-1,-1,-2,-3
"714",2019-01-30,"Mechanized","w1819","Wed","weekday","no_sled",1,"2","2","1",8.3,0,37,-1,20,22.4,0,0,-1,-1,-1,-1,-2,-3
"715",2019-01-30,"Motorized","w1819","Wed","weekday","sled",79,"2","2","1",8.3,0,37,-1,20,22.4,0,0,-1,-1,-1,-1,-2,-3
"716",2019-01-30,"Non.motorized","w1819","Wed","weekday","no_sled",56,"2","2","1",8.3,0,37,-1,20,22.4,0,0,-1,-1,-1,-1,-2,-3
"717",2019-01-31,"Hybrid","w1819","Thu","weekday","sled",20,"2","2","1",8.3,0,36,-1,24,23.1,-1,0,0,-1,-2,-2,-2,-3
"718",2019-01-31,"Mechanized","w1819","Thu","weekday","no_sled",1,"2","2","1",8.3,0,36,-1,24,23.1,-1,0,0,-1,-2,-2,-2,-3
"719",2019-01-31,"Motorized","w1819","Thu","weekday","sled",92,"2","2","1",8.3,0,36,-1,24,23.1,-1,0,0,-1,-2,-2,-2,-3
"720",2019-01-31,"Non.motorized","w1819","Thu","weekday","no_sled",61,"2","2","1",8.3,0,36,-1,24,23.1,-1,0,0,-1,-2,-2,-2,-3
"721",2019-02-01,"Hybrid","w1819","Fri","weekday","sled",8,"2","2","1",8.3,0,36,0,25,23.1,-1,-1,0,0,-1,-2,-2,-2
"722",2019-02-01,"Mechanized","w1819","Fri","weekday","no_sled",5,"2","2","1",8.3,0,36,0,25,23.1,-1,-1,0,0,-1,-2,-2,-2
"723",2019-02-01,"Motorized","w1819","Fri","weekday","sled",101,"2","2","1",8.3,0,36,0,25,23.1,-1,-1,0,0,-1,-2,-2,-2
"724",2019-02-01,"Non.motorized","w1819","Fri","weekday","no_sled",113,"2","2","1",8.3,0,36,0,25,23.1,-1,-1,0,0,-1,-2,-2,-2
"725",2019-02-02,"Hybrid","w1819","Sat","weekend","sled",21,"2","2","1",8.3,0,36,0,26,23.1,0,-1,-1,0,0,-1,-2,-2
"726",2019-02-02,"Mechanized","w1819","Sat","weekend","no_sled",20,"2","2","1",8.3,0,36,0,26,23.1,0,-1,-1,0,0,-1,-2,-2
"727",2019-02-02,"Motorized","w1819","Sat","weekend","sled",132,"2","2","1",8.3,0,36,0,26,23.1,0,-1,-1,0,0,-1,-2,-2
"728",2019-02-02,"Non.motorized","w1819","Sat","weekend","no_sled",319,"2","2","1",8.3,0,36,0,26,23.1,0,-1,-1,0,0,-1,-2,-2
"729",2019-02-03,"Hybrid","w1819","Sun","weekend","sled",7,"3","3","2",8.4,0.1,36,0,28,23.3,0,0,-1,-1,0,0,-1,-2
"730",2019-02-03,"Mechanized","w1819","Sun","weekend","no_sled",4,"3","3","2",8.4,0.1,36,0,28,23.3,0,0,-1,-1,0,0,-1,-2
"731",2019-02-03,"Motorized","w1819","Sun","weekend","sled",71,"3","3","2",8.4,0.1,36,0,28,23.3,0,0,-1,-1,0,0,-1,-2
"732",2019-02-03,"Non.motorized","w1819","Sun","weekend","no_sled",126,"3","3","2",8.4,0.1,36,0,28,23.3,0,0,-1,-1,0,0,-1,-2
"733",2019-02-04,"Hybrid","w1819","Mon","weekday","sled",14,"3","3","2",8.8,0.4,39,3,28,22.6,0,0,0,-1,3,3,3,2
"734",2019-02-04,"Mechanized","w1819","Mon","weekday","no_sled",1,"3","3","2",8.8,0.4,39,3,28,22.6,0,0,0,-1,3,3,3,2
"735",2019-02-04,"Motorized","w1819","Mon","weekday","sled",84,"3","3","2",8.8,0.4,39,3,28,22.6,0,0,0,-1,3,3,3,2
"736",2019-02-04,"Non.motorized","w1819","Mon","weekday","no_sled",104,"3","3","2",8.8,0.4,39,3,28,22.6,0,0,0,-1,3,3,3,2
"737",2019-02-05,"Hybrid","w1819","Tue","weekday","sled",10,"3","2","2",9,0.2,40,1,26,22.5,3,0,0,0,4,4,4,4
"738",2019-02-05,"Mechanized","w1819","Tue","weekday","no_sled",1,"3","2","2",9,0.2,40,1,26,22.5,3,0,0,0,4,4,4,4
"739",2019-02-05,"Motorized","w1819","Tue","weekday","sled",57,"3","2","2",9,0.2,40,1,26,22.5,3,0,0,0,4,4,4,4
"740",2019-02-05,"Non.motorized","w1819","Tue","weekday","no_sled",93,"3","2","2",9,0.2,40,1,26,22.5,3,0,0,0,4,4,4,4
"741",2019-02-06,"Hybrid","w1819","Wed","weekday","sled",3,"4","4","3",9,0,40,0,16,22.5,1,3,0,0,1,4,4,4
"742",2019-02-06,"Mechanized","w1819","Wed","weekday","no_sled",0,"4","4","3",9,0,40,0,16,22.5,1,3,0,0,1,4,4,4
"743",2019-02-06,"Motorized","w1819","Wed","weekday","sled",6,"4","4","3",9,0,40,0,16,22.5,1,3,0,0,1,4,4,4
"744",2019-02-06,"Non.motorized","w1819","Wed","weekday","no_sled",51,"4","4","3",9,0,40,0,16,22.5,1,3,0,0,1,4,4,4
"745",2019-02-07,"Hybrid","w1819","Thu","weekday","sled",5,"3","3","2",9.2,0.2,43,3,4,21.4,0,1,3,0,3,4,7,7
"746",2019-02-07,"Mechanized","w1819","Thu","weekday","no_sled",0,"3","3","2",9.2,0.2,43,3,4,21.4,0,1,3,0,3,4,7,7
"747",2019-02-07,"Motorized","w1819","Thu","weekday","sled",30,"3","3","2",9.2,0.2,43,3,4,21.4,0,1,3,0,3,4,7,7
"748",2019-02-07,"Non.motorized","w1819","Thu","weekday","no_sled",65,"3","3","2",9.2,0.2,43,3,4,21.4,0,1,3,0,3,4,7,7
"749",2019-02-08,"Hybrid","w1819","Fri","weekday","sled",9,"3","2","2",9.2,0,42,-1,10,21.9,3,0,1,3,2,2,3,6
"750",2019-02-08,"Mechanized","w1819","Fri","weekday","no_sled",0,"3","2","2",9.2,0,42,-1,10,21.9,3,0,1,3,2,2,3,6
"751",2019-02-08,"Motorized","w1819","Fri","weekday","sled",64,"3","2","2",9.2,0,42,-1,10,21.9,3,0,1,3,2,2,3,6
"752",2019-02-08,"Non.motorized","w1819","Fri","weekday","no_sled",125,"3","2","2",9.2,0,42,-1,10,21.9,3,0,1,3,2,2,3,6
"753",2019-02-09,"Hybrid","w1819","Sat","weekend","sled",10,"3","2","2",9.2,0,41,-1,20,22.4,-1,3,0,1,-2,1,1,2
"754",2019-02-09,"Mechanized","w1819","Sat","weekend","no_sled",5,"3","2","2",9.2,0,41,-1,20,22.4,-1,3,0,1,-2,1,1,2
"755",2019-02-09,"Motorized","w1819","Sat","weekend","sled",17,"3","2","2",9.2,0,41,-1,20,22.4,-1,3,0,1,-2,1,1,2
"756",2019-02-09,"Non.motorized","w1819","Sat","weekend","no_sled",242,"3","2","2",9.2,0,41,-1,20,22.4,-1,3,0,1,-2,1,1,2
"757",2019-02-10,"Hybrid","w1819","Sun","weekend","sled",17,"2","2","2",9.3,0.1,40,-1,20,23.2,-1,-1,3,0,-2,-3,0,0
"758",2019-02-10,"Mechanized","w1819","Sun","weekend","no_sled",7,"2","2","2",9.3,0.1,40,-1,20,23.2,-1,-1,3,0,-2,-3,0,0
"759",2019-02-10,"Motorized","w1819","Sun","weekend","sled",19,"2","2","2",9.3,0.1,40,-1,20,23.2,-1,-1,3,0,-2,-3,0,0
"760",2019-02-10,"Non.motorized","w1819","Sun","weekend","no_sled",223,"2","2","2",9.3,0.1,40,-1,20,23.2,-1,-1,3,0,-2,-3,0,0
"761",2019-02-11,"Hybrid","w1819","Mon","weekday","sled",1,"2","2","1",9.3,0,40,0,15,23.2,-1,-1,-1,3,-1,-2,-3,0
"762",2019-02-11,"Mechanized","w1819","Mon","weekday","no_sled",2,"2","2","1",9.3,0,40,0,15,23.2,-1,-1,-1,3,-1,-2,-3,0
"763",2019-02-11,"Motorized","w1819","Mon","weekday","sled",11,"2","2","1",9.3,0,40,0,15,23.2,-1,-1,-1,3,-1,-2,-3,0
"764",2019-02-11,"Non.motorized","w1819","Mon","weekday","no_sled",87,"2","2","1",9.3,0,40,0,15,23.2,-1,-1,-1,3,-1,-2,-3,0
"765",2019-02-12,"Hybrid","w1819","Tue","weekday","sled",0,"2","2","1",9.3,0,40,0,18,23.2,0,-1,-1,-1,0,-1,-2,-3
"766",2019-02-12,"Mechanized","w1819","Tue","weekday","no_sled",5,"2","2","1",9.3,0,40,0,18,23.2,0,-1,-1,-1,0,-1,-2,-3
"767",2019-02-12,"Motorized","w1819","Tue","weekday","sled",34,"2","2","1",9.3,0,40,0,18,23.2,0,-1,-1,-1,0,-1,-2,-3
"768",2019-02-12,"Non.motorized","w1819","Tue","weekday","no_sled",128,"2","2","1",9.3,0,40,0,18,23.2,0,-1,-1,-1,0,-1,-2,-3
"769",2019-02-13,"Hybrid","w1819","Wed","weekday","sled",0,"2","2","1",9.4,0.1,40,0,26,23.5,0,0,-1,-1,0,0,-1,-2
"770",2019-02-13,"Mechanized","w1819","Wed","weekday","no_sled",7,"2","2","1",9.4,0.1,40,0,26,23.5,0,0,-1,-1,0,0,-1,-2
"771",2019-02-13,"Motorized","w1819","Wed","weekday","sled",55,"2","2","1",9.4,0.1,40,0,26,23.5,0,0,-1,-1,0,0,-1,-2
"772",2019-02-13,"Non.motorized","w1819","Wed","weekday","no_sled",94,"2","2","1",9.4,0.1,40,0,26,23.5,0,0,-1,-1,0,0,-1,-2
"773",2019-02-14,"Hybrid","w1819","Thu","weekday","sled",0,"3","2","2",9.7,0.3,41,1,29,23.7,0,0,0,-1,1,1,1,0
"774",2019-02-14,"Mechanized","w1819","Thu","weekday","no_sled",4,"3","2","2",9.7,0.3,41,1,29,23.7,0,0,0,-1,1,1,1,0
"775",2019-02-14,"Motorized","w1819","Thu","weekday","sled",22,"3","2","2",9.7,0.3,41,1,29,23.7,0,0,0,-1,1,1,1,0
"776",2019-02-14,"Non.motorized","w1819","Thu","weekday","no_sled",60,"3","2","2",9.7,0.3,41,1,29,23.7,0,0,0,-1,1,1,1,0
"777",2019-02-15,"Hybrid","w1819","Fri","weekday","sled",0,"4","4","3",10.8,1.1,51,10,27,21.2,1,0,0,0,11,11,11,11
"778",2019-02-15,"Mechanized","w1819","Fri","weekday","no_sled",0,"4","4","3",10.8,1.1,51,10,27,21.2,1,0,0,0,11,11,11,11
"779",2019-02-15,"Motorized","w1819","Fri","weekday","sled",46,"4","4","3",10.8,1.1,51,10,27,21.2,1,0,0,0,11,11,11,11
"780",2019-02-15,"Non.motorized","w1819","Fri","weekday","no_sled",80,"4","4","3",10.8,1.1,51,10,27,21.2,1,0,0,0,11,11,11,11
"781",2019-02-16,"Hybrid","w1819","Sat","weekend","sled",0,"3","3","3",11.1,0.3,52,1,14,21.3,10,1,0,0,11,12,12,12
"782",2019-02-16,"Mechanized","w1819","Sat","weekend","no_sled",0,"3","3","3",11.1,0.3,52,1,14,21.3,10,1,0,0,11,12,12,12
"783",2019-02-16,"Motorized","w1819","Sat","weekend","sled",0,"3","3","3",11.1,0.3,52,1,14,21.3,10,1,0,0,11,12,12,12
"784",2019-02-16,"Non.motorized","w1819","Sat","weekend","no_sled",3,"3","3","3",11.1,0.3,52,1,14,21.3,10,1,0,0,11,12,12,12
"785",2019-02-17,"Hybrid","w1819","Sun","weekend","sled",5,"3","3","3",11.3,0.2,55,3,10,20.5,1,10,1,0,4,14,15,15
"786",2019-02-17,"Mechanized","w1819","Sun","weekend","no_sled",3,"3","3","3",11.3,0.2,55,3,10,20.5,1,10,1,0,4,14,15,15
"787",2019-02-17,"Motorized","w1819","Sun","weekend","sled",123,"3","3","3",11.3,0.2,55,3,10,20.5,1,10,1,0,4,14,15,15
"788",2019-02-17,"Non.motorized","w1819","Sun","weekend","no_sled",73,"3","3","3",11.3,0.2,55,3,10,20.5,1,10,1,0,4,14,15,15
"789",2019-02-18,"Hybrid","w1819","Mon","weekday","sled",5,"3","3","2",11.4,0.1,53,-2,13,21.5,3,1,10,1,1,2,12,13
"790",2019-02-18,"Mechanized","w1819","Mon","weekday","no_sled",0,"3","3","2",11.4,0.1,53,-2,13,21.5,3,1,10,1,1,2,12,13
"791",2019-02-18,"Motorized","w1819","Mon","weekday","sled",80,"3","3","2",11.4,0.1,53,-2,13,21.5,3,1,10,1,1,2,12,13
"792",2019-02-18,"Non.motorized","w1819","Mon","weekday","no_sled",37,"3","3","2",11.4,0.1,53,-2,13,21.5,3,1,10,1,1,2,12,13
"793",2019-02-19,"Hybrid","w1819","Tue","weekday","sled",0,"3","3","2",11.5,0.1,53,0,11,21.7,-2,3,1,10,-2,1,2,12
"794",2019-02-19,"Mechanized","w1819","Tue","weekday","no_sled",0,"3","3","2",11.5,0.1,53,0,11,21.7,-2,3,1,10,-2,1,2,12
"795",2019-02-19,"Motorized","w1819","Tue","weekday","sled",1,"3","3","2",11.5,0.1,53,0,11,21.7,-2,3,1,10,-2,1,2,12
"796",2019-02-19,"Non.motorized","w1819","Tue","weekday","no_sled",13,"3","3","2",11.5,0.1,53,0,11,21.7,-2,3,1,10,-2,1,2,12
"797",2019-02-20,"Hybrid","w1819","Wed","weekday","sled",0,"3","3","2",11.6,0.1,53,0,7,21.9,0,-2,3,1,0,-2,1,2
"798",2019-02-20,"Mechanized","w1819","Wed","weekday","no_sled",0,"3","3","2",11.6,0.1,53,0,7,21.9,0,-2,3,1,0,-2,1,2
"799",2019-02-20,"Motorized","w1819","Wed","weekday","sled",0,"3","3","2",11.6,0.1,53,0,7,21.9,0,-2,3,1,0,-2,1,2
"800",2019-02-20,"Non.motorized","w1819","Wed","weekday","no_sled",15,"3","3","2",11.6,0.1,53,0,7,21.9,0,-2,3,1,0,-2,1,2
"801",2019-02-21,"Hybrid","w1819","Thu","weekday","sled",0,"3","3","3",11.6,0,52,-1,15,22.3,0,0,-2,3,-1,-1,-3,0
"802",2019-02-21,"Mechanized","w1819","Thu","weekday","no_sled",0,"3","3","3",11.6,0,52,-1,15,22.3,0,0,-2,3,-1,-1,-3,0
"803",2019-02-21,"Motorized","w1819","Thu","weekday","sled",0,"3","3","3",11.6,0,52,-1,15,22.3,0,0,-2,3,-1,-1,-3,0
"804",2019-02-21,"Non.motorized","w1819","Thu","weekday","no_sled",24,"3","3","3",11.6,0,52,-1,15,22.3,0,0,-2,3,-1,-1,-3,0
"805",2019-02-22,"Hybrid","w1819","Fri","weekday","sled",5,"3","3","3",11.8,0.2,52,0,20,22.7,-1,0,0,-2,-1,-1,-1,-3
"806",2019-02-22,"Mechanized","w1819","Fri","weekday","no_sled",0,"3","3","3",11.8,0.2,52,0,20,22.7,-1,0,0,-2,-1,-1,-1,-3
"807",2019-02-22,"Motorized","w1819","Fri","weekday","sled",5,"3","3","3",11.8,0.2,52,0,20,22.7,-1,0,0,-2,-1,-1,-1,-3
"808",2019-02-22,"Non.motorized","w1819","Fri","weekday","no_sled",50,"3","3","3",11.8,0.2,52,0,20,22.7,-1,0,0,-2,-1,-1,-1,-3
"809",2019-02-23,"Hybrid","w1819","Sat","weekend","sled",19,"3","3","3",12.1,0.3,53,1,13,22.8,0,-1,0,0,1,0,0,0
"810",2019-02-23,"Mechanized","w1819","Sat","weekend","no_sled",4,"3","3","3",12.1,0.3,53,1,13,22.8,0,-1,0,0,1,0,0,0
"811",2019-02-23,"Motorized","w1819","Sat","weekend","sled",100,"3","3","3",12.1,0.3,53,1,13,22.8,0,-1,0,0,1,0,0,0
"812",2019-02-23,"Non.motorized","w1819","Sat","weekend","no_sled",445,"3","3","3",12.1,0.3,53,1,13,22.8,0,-1,0,0,1,0,0,0
"813",2019-02-24,"Hybrid","w1819","Sun","weekend","sled",9,"3","3","2",12.1,0,52,-1,14,23.3,1,0,-1,0,0,0,-1,-1
"814",2019-02-24,"Mechanized","w1819","Sun","weekend","no_sled",2,"3","3","2",12.1,0,52,-1,14,23.3,1,0,-1,0,0,0,-1,-1
"815",2019-02-24,"Motorized","w1819","Sun","weekend","sled",25,"3","3","2",12.1,0,52,-1,14,23.3,1,0,-1,0,0,0,-1,-1
"816",2019-02-24,"Non.motorized","w1819","Sun","weekend","no_sled",230,"3","3","2",12.1,0,52,-1,14,23.3,1,0,-1,0,0,0,-1,-1
"817",2019-02-25,"Hybrid","w1819","Mon","weekday","sled",2,"3","3","2",12.1,0,51,-1,22,23.7,-1,1,0,-1,-2,-1,-1,-2
"818",2019-02-25,"Mechanized","w1819","Mon","weekday","no_sled",7,"3","3","2",12.1,0,51,-1,22,23.7,-1,1,0,-1,-2,-1,-1,-2
"819",2019-02-25,"Motorized","w1819","Mon","weekday","sled",35,"3","3","2",12.1,0,51,-1,22,23.7,-1,1,0,-1,-2,-1,-1,-2
"820",2019-02-25,"Non.motorized","w1819","Mon","weekday","no_sled",127,"3","3","2",12.1,0,51,-1,22,23.7,-1,1,0,-1,-2,-1,-1,-2
"821",2019-02-26,"Hybrid","w1819","Tue","weekday","sled",18,"2","2","2",12.1,0,50,-1,27,24.2,-1,-1,1,0,-2,-3,-2,-2
"822",2019-02-26,"Mechanized","w1819","Tue","weekday","no_sled",4,"2","2","2",12.1,0,50,-1,27,24.2,-1,-1,1,0,-2,-3,-2,-2
"823",2019-02-26,"Motorized","w1819","Tue","weekday","sled",94,"2","2","2",12.1,0,50,-1,27,24.2,-1,-1,1,0,-2,-3,-2,-2
"824",2019-02-26,"Non.motorized","w1819","Tue","weekday","no_sled",178,"2","2","2",12.1,0,50,-1,27,24.2,-1,-1,1,0,-2,-3,-2,-2
"825",2019-02-27,"Hybrid","w1819","Wed","weekday","sled",9,"2","2","2",12.1,0,50,0,30,24.2,-1,-1,-1,1,-1,-2,-3,-2
"826",2019-02-27,"Mechanized","w1819","Wed","weekday","no_sled",16,"2","2","2",12.1,0,50,0,30,24.2,-1,-1,-1,1,-1,-2,-3,-2
"827",2019-02-27,"Motorized","w1819","Wed","weekday","sled",116,"2","2","2",12.1,0,50,0,30,24.2,-1,-1,-1,1,-1,-2,-3,-2
"828",2019-02-27,"Non.motorized","w1819","Wed","weekday","no_sled",176,"2","2","2",12.1,0,50,0,30,24.2,-1,-1,-1,1,-1,-2,-3,-2
"829",2019-02-28,"Hybrid","w1819","Thu","weekday","sled",10,"2","2","2",12.2,0.1,49,-1,30,24.9,0,-1,-1,-1,-1,-2,-3,-4
"830",2019-02-28,"Mechanized","w1819","Thu","weekday","no_sled",2,"2","2","2",12.2,0.1,49,-1,30,24.9,0,-1,-1,-1,-1,-2,-3,-4
"831",2019-02-28,"Motorized","w1819","Thu","weekday","sled",66,"2","2","2",12.2,0.1,49,-1,30,24.9,0,-1,-1,-1,-1,-2,-3,-4
"832",2019-02-28,"Non.motorized","w1819","Thu","weekday","no_sled",167,"2","2","2",12.2,0.1,49,-1,30,24.9,0,-1,-1,-1,-1,-2,-3,-4
"833",2019-03-01,"Hybrid","w1819","Fri","weekday","sled",1,"2","2","1",12.3,0.1,49,0,29,25.1,-1,0,-1,-1,-1,-1,-2,-3
"834",2019-03-01,"Mechanized","w1819","Fri","weekday","no_sled",1,"2","2","1",12.3,0.1,49,0,29,25.1,-1,0,-1,-1,-1,-1,-2,-3
"835",2019-03-01,"Motorized","w1819","Fri","weekday","sled",37,"2","2","1",12.3,0.1,49,0,29,25.1,-1,0,-1,-1,-1,-1,-2,-3
"836",2019-03-01,"Non.motorized","w1819","Fri","weekday","no_sled",59,"2","2","1",12.3,0.1,49,0,29,25.1,-1,0,-1,-1,-1,-1,-2,-3
"837",2019-03-02,"Hybrid","w1819","Sat","weekend","sled",4,"3","3","2",13,0.7,58,9,30,22.4,0,-1,0,-1,9,8,8,7
"838",2019-03-02,"Mechanized","w1819","Sat","weekend","no_sled",0,"3","3","2",13,0.7,58,9,30,22.4,0,-1,0,-1,9,8,8,7
"839",2019-03-02,"Motorized","w1819","Sat","weekend","sled",120,"3","3","2",13,0.7,58,9,30,22.4,0,-1,0,-1,9,8,8,7
"840",2019-03-02,"Non.motorized","w1819","Sat","weekend","no_sled",111,"3","3","2",13,0.7,58,9,30,22.4,0,-1,0,-1,9,8,8,7
"841",2019-03-03,"Hybrid","w1819","Sun","weekend","sled",0,"3","3","3",13.7,0.7,64,6,27,21.4,9,0,-1,0,15,15,14,14
"842",2019-03-03,"Mechanized","w1819","Sun","weekend","no_sled",0,"3","3","3",13.7,0.7,64,6,27,21.4,9,0,-1,0,15,15,14,14
"843",2019-03-03,"Motorized","w1819","Sun","weekend","sled",49,"3","3","3",13.7,0.7,64,6,27,21.4,9,0,-1,0,15,15,14,14
"844",2019-03-03,"Non.motorized","w1819","Sun","weekend","no_sled",22,"3","3","3",13.7,0.7,64,6,27,21.4,9,0,-1,0,15,15,14,14
"845",2019-03-04,"Hybrid","w1819","Mon","weekday","sled",0,"3","3","3",14.4,0.7,66,2,23,21.8,6,9,0,-1,8,17,17,16
"846",2019-03-04,"Mechanized","w1819","Mon","weekday","no_sled",0,"3","3","3",14.4,0.7,66,2,23,21.8,6,9,0,-1,8,17,17,16
"847",2019-03-04,"Motorized","w1819","Mon","weekday","sled",31,"3","3","3",14.4,0.7,66,2,23,21.8,6,9,0,-1,8,17,17,16
"848",2019-03-04,"Non.motorized","w1819","Mon","weekday","no_sled",42,"3","3","3",14.4,0.7,66,2,23,21.8,6,9,0,-1,8,17,17,16
"849",2019-03-05,"Hybrid","w1819","Tue","weekday","sled",13,"3","3","3",14.4,0,64,-2,24,22.5,2,6,9,0,0,6,15,15
"850",2019-03-05,"Mechanized","w1819","Tue","weekday","no_sled",1,"3","3","3",14.4,0,64,-2,24,22.5,2,6,9,0,0,6,15,15
"851",2019-03-05,"Motorized","w1819","Tue","weekday","sled",113,"3","3","3",14.4,0,64,-2,24,22.5,2,6,9,0,0,6,15,15
"852",2019-03-05,"Non.motorized","w1819","Tue","weekday","no_sled",87,"3","3","3",14.4,0,64,-2,24,22.5,2,6,9,0,0,6,15,15
"853",2019-03-06,"Hybrid","w1819","Wed","weekday","sled",5,"3","3","2",14.5,0.1,62,-2,31,23.4,-2,2,6,9,-4,-2,4,13
"854",2019-03-06,"Hybrid","w1819","Wed","weekday","sled",5,"4","4","3",14.5,0.1,62,-2,31,23.4,-2,2,6,9,-4,-2,4,13
"855",2019-03-06,"Mechanized","w1819","Wed","weekday","no_sled",0,"3","3","2",14.5,0.1,62,-2,31,23.4,-2,2,6,9,-4,-2,4,13
"856",2019-03-06,"Mechanized","w1819","Wed","weekday","no_sled",0,"4","4","3",14.5,0.1,62,-2,31,23.4,-2,2,6,9,-4,-2,4,13
"857",2019-03-06,"Motorized","w1819","Wed","weekday","sled",82,"3","3","2",14.5,0.1,62,-2,31,23.4,-2,2,6,9,-4,-2,4,13
"858",2019-03-06,"Motorized","w1819","Wed","weekday","sled",82,"4","4","3",14.5,0.1,62,-2,31,23.4,-2,2,6,9,-4,-2,4,13
"859",2019-03-06,"Non.motorized","w1819","Wed","weekday","no_sled",36,"3","3","2",14.5,0.1,62,-2,31,23.4,-2,2,6,9,-4,-2,4,13
"860",2019-03-06,"Non.motorized","w1819","Wed","weekday","no_sled",36,"4","4","3",14.5,0.1,62,-2,31,23.4,-2,2,6,9,-4,-2,4,13
"861",2019-03-07,"Hybrid","w1819","Thu","weekday","sled",0,"4","4","3",16.2,1.7,71,9,30,22.8,-2,-2,2,6,7,5,7,13
"862",2019-03-07,"Mechanized","w1819","Thu","weekday","no_sled",0,"4","4","3",16.2,1.7,71,9,30,22.8,-2,-2,2,6,7,5,7,13
"863",2019-03-07,"Motorized","w1819","Thu","weekday","sled",0,"4","4","3",16.2,1.7,71,9,30,22.8,-2,-2,2,6,7,5,7,13
"864",2019-03-07,"Non.motorized","w1819","Thu","weekday","no_sled",9,"4","4","3",16.2,1.7,71,9,30,22.8,-2,-2,2,6,7,5,7,13
"865",2019-03-08,"Hybrid","w1819","Fri","weekday","sled",1,"3","3","3",16.6,0.4,71,0,27,23.4,9,-2,-2,2,9,7,5,7
"866",2019-03-08,"Mechanized","w1819","Fri","weekday","no_sled",0,"3","3","3",16.6,0.4,71,0,27,23.4,9,-2,-2,2,9,7,5,7
"867",2019-03-08,"Motorized","w1819","Fri","weekday","sled",13,"3","3","3",16.6,0.4,71,0,27,23.4,9,-2,-2,2,9,7,5,7
"868",2019-03-08,"Non.motorized","w1819","Fri","weekday","no_sled",33,"3","3","3",16.6,0.4,71,0,27,23.4,9,-2,-2,2,9,7,5,7
"869",2019-03-09,"Hybrid","w1819","Sat","weekend","sled",0,"4","4","3",17.2,0.6,76,5,22,22.6,0,9,-2,-2,5,14,12,10
"870",2019-03-09,"Mechanized","w1819","Sat","weekend","no_sled",0,"4","4","3",17.2,0.6,76,5,22,22.6,0,9,-2,-2,5,14,12,10
"871",2019-03-09,"Motorized","w1819","Sat","weekend","sled",35,"4","4","3",17.2,0.6,76,5,22,22.6,0,9,-2,-2,5,14,12,10
"872",2019-03-09,"Non.motorized","w1819","Sat","weekend","no_sled",61,"4","4","3",17.2,0.6,76,5,22,22.6,0,9,-2,-2,5,14,12,10
"873",2019-03-10,"Hybrid","w1819","Sun","weekend","sled",8,"3","3","3",17.3,0.1,73,-3,25,23.7,5,0,9,-2,2,2,11,9
"874",2019-03-10,"Mechanized","w1819","Sun","weekend","no_sled",0,"3","3","3",17.3,0.1,73,-3,25,23.7,5,0,9,-2,2,2,11,9
"875",2019-03-10,"Motorized","w1819","Sun","weekend","sled",77,"3","3","3",17.3,0.1,73,-3,25,23.7,5,0,9,-2,2,2,11,9
"876",2019-03-10,"Non.motorized","w1819","Sun","weekend","no_sled",130,"3","3","3",17.3,0.1,73,-3,25,23.7,5,0,9,-2,2,2,11,9
"877",2019-03-11,"Hybrid","w1819","Mon","weekday","sled",1,"3","3","2",17.3,0,71,-2,29,24.4,-3,5,0,9,-5,0,0,9
"878",2019-03-11,"Mechanized","w1819","Mon","weekday","no_sled",1,"3","3","2",17.3,0,71,-2,29,24.4,-3,5,0,9,-5,0,0,9
"879",2019-03-11,"Motorized","w1819","Mon","weekday","sled",91,"3","3","2",17.3,0,71,-2,29,24.4,-3,5,0,9,-5,0,0,9
"880",2019-03-11,"Non.motorized","w1819","Mon","weekday","no_sled",74,"3","3","2",17.3,0,71,-2,29,24.4,-3,5,0,9,-5,0,0,9
"881",2019-03-12,"Hybrid","w1819","Tue","weekday","sled",1,"3","3","3",17.4,0.1,70,-1,32,24.9,-2,-3,5,0,-3,-6,-1,-1
"882",2019-03-12,"Hybrid","w1819","Tue","weekday","sled",1,"4","4","4",17.4,0.1,70,-1,32,24.9,-2,-3,5,0,-3,-6,-1,-1
"883",2019-03-12,"Mechanized","w1819","Tue","weekday","no_sled",2,"3","3","3",17.4,0.1,70,-1,32,24.9,-2,-3,5,0,-3,-6,-1,-1
"884",2019-03-12,"Mechanized","w1819","Tue","weekday","no_sled",2,"4","4","4",17.4,0.1,70,-1,32,24.9,-2,-3,5,0,-3,-6,-1,-1
"885",2019-03-12,"Motorized","w1819","Tue","weekday","sled",75,"3","3","3",17.4,0.1,70,-1,32,24.9,-2,-3,5,0,-3,-6,-1,-1
"886",2019-03-12,"Motorized","w1819","Tue","weekday","sled",75,"4","4","4",17.4,0.1,70,-1,32,24.9,-2,-3,5,0,-3,-6,-1,-1
"887",2019-03-12,"Non.motorized","w1819","Tue","weekday","no_sled",70,"3","3","3",17.4,0.1,70,-1,32,24.9,-2,-3,5,0,-3,-6,-1,-1
"888",2019-03-12,"Non.motorized","w1819","Tue","weekday","no_sled",70,"4","4","4",17.4,0.1,70,-1,32,24.9,-2,-3,5,0,-3,-6,-1,-1
"889",2019-03-13,"Hybrid","w1819","Wed","weekday","sled",0,"4","4","3",18.1,0.7,74,4,24,24.5,-1,-2,-3,5,3,1,-2,3
"890",2019-03-13,"Mechanized","w1819","Wed","weekday","no_sled",0,"4","4","3",18.1,0.7,74,4,24,24.5,-1,-2,-3,5,3,1,-2,3
"891",2019-03-13,"Motorized","w1819","Wed","weekday","sled",0,"4","4","3",18.1,0.7,74,4,24,24.5,-1,-2,-3,5,3,1,-2,3
"892",2019-03-13,"Non.motorized","w1819","Wed","weekday","no_sled",22,"4","4","3",18.1,0.7,74,4,24,24.5,-1,-2,-3,5,3,1,-2,3
"893",2019-03-14,"Hybrid","w1819","Thu","weekday","sled",0,"4","4","3",18.1,0,74,0,17,24.5,4,-1,-2,-3,4,3,1,-2
"894",2019-03-14,"Mechanized","w1819","Thu","weekday","no_sled",0,"4","4","3",18.1,0,74,0,17,24.5,4,-1,-2,-3,4,3,1,-2
"895",2019-03-14,"Motorized","w1819","Thu","weekday","sled",7,"4","4","3",18.1,0,74,0,17,24.5,4,-1,-2,-3,4,3,1,-2
"896",2019-03-14,"Non.motorized","w1819","Thu","weekday","no_sled",48,"4","4","3",18.1,0,74,0,17,24.5,4,-1,-2,-3,4,3,1,-2
"897",2019-03-15,"Hybrid","w1819","Fri","weekday","sled",1,"3","3","2",18.1,0,72,-2,18,25.1,0,4,-1,-2,-2,2,1,-1
"898",2019-03-15,"Mechanized","w1819","Fri","weekday","no_sled",1,"3","3","2",18.1,0,72,-2,18,25.1,0,4,-1,-2,-2,2,1,-1
"899",2019-03-15,"Motorized","w1819","Fri","weekday","sled",52,"3","3","2",18.1,0,72,-2,18,25.1,0,4,-1,-2,-2,2,1,-1
"900",2019-03-15,"Non.motorized","w1819","Fri","weekday","no_sled",114,"3","3","2",18.1,0,72,-2,18,25.1,0,4,-1,-2,-2,2,1,-1
"901",2019-03-16,"Hybrid","w1819","Sat","weekend","sled",0,"3","3","2",18.2,0.1,70,-2,26,26,-2,0,4,-1,-4,-4,0,-1
"902",2019-03-16,"Mechanized","w1819","Sat","weekend","no_sled",2,"3","3","2",18.2,0.1,70,-2,26,26,-2,0,4,-1,-4,-4,0,-1
"903",2019-03-16,"Motorized","w1819","Sat","weekend","sled",144,"3","3","2",18.2,0.1,70,-2,26,26,-2,0,4,-1,-4,-4,0,-1
"904",2019-03-16,"Non.motorized","w1819","Sat","weekend","no_sled",270,"3","3","2",18.2,0.1,70,-2,26,26,-2,0,4,-1,-4,-4,0,-1
"905",2019-03-17,"Hybrid","w1819","Sun","weekend","sled",0,"3","3","2",18.2,0,69,-1,28,26.4,-2,-2,0,4,-3,-5,-5,-1
"906",2019-03-17,"Mechanized","w1819","Sun","weekend","no_sled",15,"3","3","2",18.2,0,69,-1,28,26.4,-2,-2,0,4,-3,-5,-5,-1
"907",2019-03-17,"Motorized","w1819","Sun","weekend","sled",140,"3","3","2",18.2,0,69,-1,28,26.4,-2,-2,0,4,-3,-5,-5,-1
"908",2019-03-17,"Non.motorized","w1819","Sun","weekend","no_sled",253,"3","3","2",18.2,0,69,-1,28,26.4,-2,-2,0,4,-3,-5,-5,-1
"909",2019-03-18,"Hybrid","w1819","Mon","weekday","sled",2,"2","2","2",18.3,0.1,68,-1,29,26.9,-1,-2,-2,0,-2,-4,-6,-6
"910",2019-03-18,"Mechanized","w1819","Mon","weekday","no_sled",0,"2","2","2",18.3,0.1,68,-1,29,26.9,-1,-2,-2,0,-2,-4,-6,-6
"911",2019-03-18,"Motorized","w1819","Mon","weekday","sled",104,"2","2","2",18.3,0.1,68,-1,29,26.9,-1,-2,-2,0,-2,-4,-6,-6
"912",2019-03-18,"Non.motorized","w1819","Mon","weekday","no_sled",120,"2","2","2",18.3,0.1,68,-1,29,26.9,-1,-2,-2,0,-2,-4,-6,-6
"913",2019-03-19,"Hybrid","w1819","Tue","weekday","sled",2,"2","2","2",18.3,0,67,-1,28,27.3,-1,-1,-2,-2,-2,-3,-5,-7
"914",2019-03-19,"Mechanized","w1819","Tue","weekday","no_sled",4,"2","2","2",18.3,0,67,-1,28,27.3,-1,-1,-2,-2,-2,-3,-5,-7
"915",2019-03-19,"Motorized","w1819","Tue","weekday","sled",145,"2","2","2",18.3,0,67,-1,28,27.3,-1,-1,-2,-2,-2,-3,-5,-7
"916",2019-03-19,"Non.motorized","w1819","Tue","weekday","no_sled",71,"2","2","2",18.3,0,67,-1,28,27.3,-1,-1,-2,-2,-2,-3,-5,-7
"917",2019-03-20,"Hybrid","w1819","Wed","weekday","sled",2,"2","2","2",18.3,0,66,-1,30,27.7,-1,-1,-1,-2,-2,-3,-4,-6
"918",2019-03-20,"Mechanized","w1819","Wed","weekday","no_sled",6,"2","2","2",18.3,0,66,-1,30,27.7,-1,-1,-1,-2,-2,-3,-4,-6
"919",2019-03-20,"Motorized","w1819","Wed","weekday","sled",197,"2","2","2",18.3,0,66,-1,30,27.7,-1,-1,-1,-2,-2,-3,-4,-6
"920",2019-03-20,"Non.motorized","w1819","Wed","weekday","no_sled",100,"2","2","2",18.3,0,66,-1,30,27.7,-1,-1,-1,-2,-2,-3,-4,-6
"921",2019-03-21,"Hybrid","w1819","Thu","weekday","sled",7,"2","2","2",18.4,0.1,65,-1,33,28.3,-1,-1,-1,-1,-2,-3,-4,-5
"922",2019-03-21,"Mechanized","w1819","Thu","weekday","no_sled",2,"2","2","2",18.4,0.1,65,-1,33,28.3,-1,-1,-1,-1,-2,-3,-4,-5
"923",2019-03-21,"Motorized","w1819","Thu","weekday","sled",173,"2","2","2",18.4,0.1,65,-1,33,28.3,-1,-1,-1,-1,-2,-3,-4,-5
"924",2019-03-21,"Non.motorized","w1819","Thu","weekday","no_sled",99,"2","2","2",18.4,0.1,65,-1,33,28.3,-1,-1,-1,-1,-2,-3,-4,-5
"925",2019-03-22,"Hybrid","w1819","Fri","weekday","sled",10,"3","3","2",18.4,0,64,-1,28,28.8,-1,-1,-1,-1,-2,-3,-4,-5
"926",2019-03-22,"Mechanized","w1819","Fri","weekday","no_sled",2,"3","3","2",18.4,0,64,-1,28,28.8,-1,-1,-1,-1,-2,-3,-4,-5
"927",2019-03-22,"Motorized","w1819","Fri","weekday","sled",53,"3","3","2",18.4,0,64,-1,28,28.8,-1,-1,-1,-1,-2,-3,-4,-5
"928",2019-03-22,"Non.motorized","w1819","Fri","weekday","no_sled",86,"3","3","2",18.4,0,64,-1,28,28.8,-1,-1,-1,-1,-2,-3,-4,-5
"929",2019-03-23,"Hybrid","w1819","Sat","weekend","sled",20,"2","2","1",18.4,0,65,1,28,28.3,-1,-1,-1,-1,0,-1,-2,-3
"930",2019-03-23,"Mechanized","w1819","Sat","weekend","no_sled",2,"2","2","1",18.4,0,65,1,28,28.3,-1,-1,-1,-1,0,-1,-2,-3
"931",2019-03-23,"Motorized","w1819","Sat","weekend","sled",141,"2","2","1",18.4,0,65,1,28,28.3,-1,-1,-1,-1,0,-1,-2,-3
"932",2019-03-23,"Non.motorized","w1819","Sat","weekend","no_sled",181,"2","2","1",18.4,0,65,1,28,28.3,-1,-1,-1,-1,0,-1,-2,-3
"933",2019-03-24,"Hybrid","w1819","Sun","weekend","sled",14,"2","2","1",18.4,0,64,-1,29,28.8,1,-1,-1,-1,0,-1,-2,-3
"934",2019-03-24,"Mechanized","w1819","Sun","weekend","no_sled",9,"2","2","1",18.4,0,64,-1,29,28.8,1,-1,-1,-1,0,-1,-2,-3
"935",2019-03-24,"Motorized","w1819","Sun","weekend","sled",71,"2","2","1",18.4,0,64,-1,29,28.8,1,-1,-1,-1,0,-1,-2,-3
"936",2019-03-24,"Non.motorized","w1819","Sun","weekend","no_sled",113,"2","2","1",18.4,0,64,-1,29,28.8,1,-1,-1,-1,0,-1,-2,-3
"937",2019-03-25,"Hybrid","w1819","Mon","weekday","sled",24,"2","2","2",18.6,0.2,64,0,31,29.1,-1,1,-1,-1,-1,0,-1,-2
"938",2019-03-25,"Mechanized","w1819","Mon","weekday","no_sled",2,"2","2","2",18.6,0.2,64,0,31,29.1,-1,1,-1,-1,-1,0,-1,-2
"939",2019-03-25,"Motorized","w1819","Mon","weekday","sled",125,"2","2","2",18.6,0.2,64,0,31,29.1,-1,1,-1,-1,-1,0,-1,-2
"940",2019-03-25,"Non.motorized","w1819","Mon","weekday","no_sled",87,"2","2","2",18.6,0.2,64,0,31,29.1,-1,1,-1,-1,-1,0,-1,-2
"941",2019-03-26,"Hybrid","w1819","Tue","weekday","sled",0,"2","2","2",18.9,0.3,63,-1,36,30,0,-1,1,-1,-1,-2,-1,-2
"942",2019-03-26,"Mechanized","w1819","Tue","weekday","no_sled",0,"2","2","2",18.9,0.3,63,-1,36,30,0,-1,1,-1,-1,-2,-1,-2
"943",2019-03-26,"Motorized","w1819","Tue","weekday","sled",80,"2","2","2",18.9,0.3,63,-1,36,30,0,-1,1,-1,-1,-2,-1,-2
"944",2019-03-26,"Non.motorized","w1819","Tue","weekday","no_sled",169,"2","2","2",18.9,0.3,63,-1,36,30,0,-1,1,-1,-1,-2,-1,-2
"945",2019-03-27,"Hybrid","w1819","Wed","weekday","sled",0,"1","2","2",18.9,0,62,-1,42,30.5,-1,0,-1,1,-2,-2,-3,-2
"946",2019-03-27,"Mechanized","w1819","Wed","weekday","no_sled",10,"1","2","2",18.9,0,62,-1,42,30.5,-1,0,-1,1,-2,-2,-3,-2
"947",2019-03-27,"Motorized","w1819","Wed","weekday","sled",93,"1","2","2",18.9,0,62,-1,42,30.5,-1,0,-1,1,-2,-2,-3,-2
"948",2019-03-27,"Non.motorized","w1819","Wed","weekday","no_sled",160,"1","2","2",18.9,0,62,-1,42,30.5,-1,0,-1,1,-2,-2,-3,-2
"949",2019-03-28,"Hybrid","w1819","Thu","weekday","sled",2,"1","2","2",18.9,0,60,-2,40,31.5,-1,-1,0,-1,-3,-4,-4,-5
"950",2019-03-28,"Mechanized","w1819","Thu","weekday","no_sled",2,"1","2","2",18.9,0,60,-2,40,31.5,-1,-1,0,-1,-3,-4,-4,-5
"951",2019-03-28,"Motorized","w1819","Thu","weekday","sled",103,"1","2","2",18.9,0,60,-2,40,31.5,-1,-1,0,-1,-3,-4,-4,-5
"952",2019-03-28,"Non.motorized","w1819","Thu","weekday","no_sled",123,"1","2","2",18.9,0,60,-2,40,31.5,-1,-1,0,-1,-3,-4,-4,-5
"953",2019-03-29,"Hybrid","w1819","Fri","weekday","sled",2,"1","1","1",19,0.1,58,-2,26,32.8,-2,-1,-1,0,-4,-5,-6,-6
"954",2019-03-29,"Mechanized","w1819","Fri","weekday","no_sled",2,"1","1","1",19,0.1,58,-2,26,32.8,-2,-1,-1,0,-4,-5,-6,-6
"955",2019-03-29,"Motorized","w1819","Fri","weekday","sled",28,"1","1","1",19,0.1,58,-2,26,32.8,-2,-1,-1,0,-4,-5,-6,-6
"956",2019-03-29,"Non.motorized","w1819","Fri","weekday","no_sled",124,"1","1","1",19,0.1,58,-2,26,32.8,-2,-1,-1,0,-4,-5,-6,-6
"957",2019-03-30,"Hybrid","w1819","Sat","weekend","sled",20,"1","1","1",19.1,0.1,61,3,24,31.3,-2,-2,-1,-1,1,-1,-2,-3
"958",2019-03-30,"Mechanized","w1819","Sat","weekend","no_sled",5,"1","1","1",19.1,0.1,61,3,24,31.3,-2,-2,-1,-1,1,-1,-2,-3
"959",2019-03-30,"Motorized","w1819","Sat","weekend","sled",107,"1","1","1",19.1,0.1,61,3,24,31.3,-2,-2,-1,-1,1,-1,-2,-3
"960",2019-03-30,"Non.motorized","w1819","Sat","weekend","no_sled",275,"1","1","1",19.1,0.1,61,3,24,31.3,-2,-2,-1,-1,1,-1,-2,-3
"961",2019-03-31,"Hybrid","w1819","Sun","weekend","sled",20,"1","1","1",19.1,0,59,-2,24,32.4,3,-2,-2,-1,1,-1,-3,-4
"962",2019-03-31,"Mechanized","w1819","Sun","weekend","no_sled",10,"1","1","1",19.1,0,59,-2,24,32.4,3,-2,-2,-1,1,-1,-3,-4
"963",2019-03-31,"Motorized","w1819","Sun","weekend","sled",107,"1","1","1",19.1,0,59,-2,24,32.4,3,-2,-2,-1,1,-1,-3,-4
"964",2019-03-31,"Non.motorized","w1819","Sun","weekend","no_sled",116,"1","1","1",19.1,0,59,-2,24,32.4,3,-2,-2,-1,1,-1,-3,-4
"965",2019-04-01,"Hybrid","w1819","Mon","weekday","sled",30,"2","1","1",19.1,0,58,-1,29,32.9,-2,3,-2,-2,-3,0,-2,-4
"966",2019-04-01,"Mechanized","w1819","Mon","weekday","no_sled",4,"2","1","1",19.1,0,58,-1,29,32.9,-2,3,-2,-2,-3,0,-2,-4
"967",2019-04-01,"Motorized","w1819","Mon","weekday","sled",86,"2","1","1",19.1,0,58,-1,29,32.9,-2,3,-2,-2,-3,0,-2,-4
"968",2019-04-01,"Non.motorized","w1819","Mon","weekday","no_sled",81,"2","1","1",19.1,0,58,-1,29,32.9,-2,3,-2,-2,-3,0,-2,-4
"969",2019-04-02,"Hybrid","w1819","Tue","weekday","sled",13,"1","1","1",19.1,0,58,0,33,32.9,-1,-2,3,-2,-1,-3,0,-2
"970",2019-04-02,"Mechanized","w1819","Tue","weekday","no_sled",1,"1","1","1",19.1,0,58,0,33,32.9,-1,-2,3,-2,-1,-3,0,-2
"971",2019-04-02,"Motorized","w1819","Tue","weekday","sled",47,"1","1","1",19.1,0,58,0,33,32.9,-1,-2,3,-2,-1,-3,0,-2
"972",2019-04-02,"Non.motorized","w1819","Tue","weekday","no_sled",60,"1","1","1",19.1,0,58,0,33,32.9,-1,-2,3,-2,-1,-3,0,-2
"973",2019-04-03,"Hybrid","w1819","Wed","weekday","sled",22,"2","1","1",19.2,0.1,58,0,31,33.1,0,-1,-2,3,0,-1,-3,0
"974",2019-04-03,"Mechanized","w1819","Wed","weekday","no_sled",0,"2","1","1",19.2,0.1,58,0,31,33.1,0,-1,-2,3,0,-1,-3,0
"975",2019-04-03,"Motorized","w1819","Wed","weekday","sled",53,"2","1","1",19.2,0.1,58,0,31,33.1,0,-1,-2,3,0,-1,-3,0
"976",2019-04-03,"Non.motorized","w1819","Wed","weekday","no_sled",58,"2","1","1",19.2,0.1,58,0,31,33.1,0,-1,-2,3,0,-1,-3,0
"977",2019-04-04,"Hybrid","w1819","Thu","weekday","sled",13,"2","1","1",19.4,0.2,59,1,35,32.9,0,0,-1,-2,1,1,0,-2
"978",2019-04-04,"Mechanized","w1819","Thu","weekday","no_sled",0,"2","1","1",19.4,0.2,59,1,35,32.9,0,0,-1,-2,1,1,0,-2
"979",2019-04-04,"Motorized","w1819","Thu","weekday","sled",54,"2","1","1",19.4,0.2,59,1,35,32.9,0,0,-1,-2,1,1,0,-2
"980",2019-04-04,"Non.motorized","w1819","Thu","weekday","no_sled",96,"2","1","1",19.4,0.2,59,1,35,32.9,0,0,-1,-2,1,1,0,-2
"981",2019-04-05,"Hybrid","w1819","Fri","weekday","sled",10,"1","1","1",19.4,0,57,-2,38,34,1,0,0,-1,-1,-1,-1,-2
"982",2019-04-05,"Mechanized","w1819","Fri","weekday","no_sled",5,"1","1","1",19.4,0,57,-2,38,34,1,0,0,-1,-1,-1,-1,-2
"983",2019-04-05,"Motorized","w1819","Fri","weekday","sled",53,"1","1","1",19.4,0,57,-2,38,34,1,0,0,-1,-1,-1,-1,-2
"984",2019-04-05,"Non.motorized","w1819","Fri","weekday","no_sled",74,"1","1","1",19.4,0,57,-2,38,34,1,0,0,-1,-1,-1,-1,-2
"985",2019-04-06,"Hybrid","w1819","Sat","weekend","sled",21,"1","1","1",19.3,-0.1,57,0,35,33.9,-2,1,0,0,-2,-1,-1,-1
"986",2019-04-06,"Mechanized","w1819","Sat","weekend","no_sled",4,"1","1","1",19.3,-0.1,57,0,35,33.9,-2,1,0,0,-2,-1,-1,-1
"987",2019-04-06,"Motorized","w1819","Sat","weekend","sled",71,"1","1","1",19.3,-0.1,57,0,35,33.9,-2,1,0,0,-2,-1,-1,-1
"988",2019-04-06,"Non.motorized","w1819","Sat","weekend","no_sled",93,"1","1","1",19.3,-0.1,57,0,35,33.9,-2,1,0,0,-2,-1,-1,-1
"989",2019-04-07,"Hybrid","w1819","Sun","weekend","sled",8,"1","1","1",19.1,-0.2,57,0,37,33.5,0,-2,1,0,0,-2,-1,-1
"990",2019-04-07,"Mechanized","w1819","Sun","weekend","no_sled",4,"1","1","1",19.1,-0.2,57,0,37,33.5,0,-2,1,0,0,-2,-1,-1
"991",2019-04-07,"Motorized","w1819","Sun","weekend","sled",52,"1","1","1",19.1,-0.2,57,0,37,33.5,0,-2,1,0,0,-2,-1,-1
"992",2019-04-07,"Non.motorized","w1819","Sun","weekend","no_sled",84,"1","1","1",19.1,-0.2,57,0,37,33.5,0,-2,1,0,0,-2,-1,-1
"993",2019-04-08,"Hybrid","w1819","Mon","weekday","sled",17,"1","2","2",19.3,0.2,54,-3,41,35.7,0,0,-2,1,-3,-3,-5,-4
"994",2019-04-08,"Mechanized","w1819","Mon","weekday","no_sled",3,"1","2","2",19.3,0.2,54,-3,41,35.7,0,0,-2,1,-3,-3,-5,-4
"995",2019-04-08,"Motorized","w1819","Mon","weekday","sled",51,"1","2","2",19.3,0.2,54,-3,41,35.7,0,0,-2,1,-3,-3,-5,-4
"996",2019-04-08,"Non.motorized","w1819","Mon","weekday","no_sled",70,"1","2","2",19.3,0.2,54,-3,41,35.7,0,0,-2,1,-3,-3,-5,-4
"997",2019-04-09,"Hybrid","w1819","Tue","weekday","sled",8,"1","2","2",19.3,0,53,-1,43,36.4,-3,0,0,-2,-4,-4,-4,-6
"998",2019-04-09,"Mechanized","w1819","Tue","weekday","no_sled",1,"1","2","2",19.3,0,53,-1,43,36.4,-3,0,0,-2,-4,-4,-4,-6
"999",2019-04-09,"Motorized","w1819","Tue","weekday","sled",46,"1","2","2",19.3,0,53,-1,43,36.4,-3,0,0,-2,-4,-4,-4,-6
"1000",2019-04-09,"Non.motorized","w1819","Tue","weekday","no_sled",26,"1","2","2",19.3,0,53,-1,43,36.4,-3,0,0,-2,-4,-4,-4,-6
"1001",2019-04-10,"Hybrid","w1819","Wed","weekday","sled",4,"2","2","1",19,-0.3,51,-2,30,37.3,-1,-3,0,0,-3,-6,-6,-6
"1002",2019-04-10,"Mechanized","w1819","Wed","weekday","no_sled",0,"2","2","1",19,-0.3,51,-2,30,37.3,-1,-3,0,0,-3,-6,-6,-6
"1003",2019-04-10,"Motorized","w1819","Wed","weekday","sled",15,"2","2","1",19,-0.3,51,-2,30,37.3,-1,-3,0,0,-3,-6,-6,-6
"1004",2019-04-10,"Non.motorized","w1819","Wed","weekday","no_sled",38,"2","2","1",19,-0.3,51,-2,30,37.3,-1,-3,0,0,-3,-6,-6,-6
"1005",2019-04-11,"Hybrid","w1819","Thu","weekday","sled",2,"3","3","2",18.9,-0.1,53,2,20,35.7,-2,-1,-3,0,0,-1,-4,-4
"1006",2019-04-11,"Mechanized","w1819","Thu","weekday","no_sled",0,"3","3","2",18.9,-0.1,53,2,20,35.7,-2,-1,-3,0,0,-1,-4,-4
"1007",2019-04-11,"Motorized","w1819","Thu","weekday","sled",7,"3","3","2",18.9,-0.1,53,2,20,35.7,-2,-1,-3,0,0,-1,-4,-4
"1008",2019-04-11,"Non.motorized","w1819","Thu","weekday","no_sled",39,"3","3","2",18.9,-0.1,53,2,20,35.7,-2,-1,-3,0,0,-1,-4,-4
"1009",2019-04-12,"Hybrid","w1819","Fri","weekday","sled",8,"2","2","1",18.7,-0.2,53,0,24,35.3,2,-2,-1,-3,2,0,-1,-4
"1010",2019-04-12,"Mechanized","w1819","Fri","weekday","no_sled",2,"2","2","1",18.7,-0.2,53,0,24,35.3,2,-2,-1,-3,2,0,-1,-4
"1011",2019-04-12,"Motorized","w1819","Fri","weekday","sled",44,"2","2","1",18.7,-0.2,53,0,24,35.3,2,-2,-1,-3,2,0,-1,-4
"1012",2019-04-12,"Non.motorized","w1819","Fri","weekday","no_sled",94,"2","2","1",18.7,-0.2,53,0,24,35.3,2,-2,-1,-3,2,0,-1,-4
"1013",2019-04-13,"Hybrid","w1819","Sat","weekend","sled",38,"1","1","1",18.8,0.1,52,-1,27,36.2,0,2,-2,-1,-1,1,-1,-2
"1014",2019-04-13,"Mechanized","w1819","Sat","weekend","no_sled",5,"1","1","1",18.8,0.1,52,-1,27,36.2,0,2,-2,-1,-1,1,-1,-2
"1015",2019-04-13,"Motorized","w1819","Sat","weekend","sled",77,"1","1","1",18.8,0.1,52,-1,27,36.2,0,2,-2,-1,-1,1,-1,-2
"1016",2019-04-13,"Non.motorized","w1819","Sat","weekend","no_sled",89,"1","1","1",18.8,0.1,52,-1,27,36.2,0,2,-2,-1,-1,1,-1,-2
"1017",2019-04-14,"Hybrid","w1819","Sun","weekend","sled",24,"1","1","1",18.7,-0.1,51,-1,35,36.7,-1,0,2,-2,-2,-2,0,-2
"1018",2019-04-14,"Mechanized","w1819","Sun","weekend","no_sled",2,"1","1","1",18.7,-0.1,51,-1,35,36.7,-1,0,2,-2,-2,-2,0,-2
"1019",2019-04-14,"Motorized","w1819","Sun","weekend","sled",58,"1","1","1",18.7,-0.1,51,-1,35,36.7,-1,0,2,-2,-2,-2,0,-2
"1020",2019-04-14,"Non.motorized","w1819","Sun","weekend","no_sled",52,"1","1","1",18.7,-0.1,51,-1,35,36.7,-1,0,2,-2,-2,-2,0,-2
"1021",2019-04-15,"Hybrid","w1819","Mon","weekday","sled",9,NA,NA,NA,18.6,-0.1,50,-1,41,37.2,-1,-1,0,2,-2,-3,-3,-1
"1022",2019-04-15,"Mechanized","w1819","Mon","weekday","no_sled",0,NA,NA,NA,18.6,-0.1,50,-1,41,37.2,-1,-1,0,2,-2,-3,-3,-1
"1023",2019-04-15,"Motorized","w1819","Mon","weekday","sled",21,NA,NA,NA,18.6,-0.1,50,-1,41,37.2,-1,-1,0,2,-2,-3,-3,-1
"1024",2019-04-15,"Non.motorized","w1819","Mon","weekday","no_sled",31,NA,NA,NA,18.6,-0.1,50,-1,41,37.2,-1,-1,0,2,-2,-3,-3,-1
"1025",2019-12-06,"Hybrid","w1920","Fri","weekday","sled",0,"2","2","1",2.9,0.4,19,5,24,15.3,0,0,0,0,5,5,5,5
"1026",2019-12-06,"Mechanized","w1920","Fri","weekday","no_sled",6,"2","2","1",2.9,0.4,19,5,24,15.3,0,0,0,0,5,5,5,5
"1027",2019-12-06,"Motorized","w1920","Fri","weekday","sled",19,"2","2","1",2.9,0.4,19,5,24,15.3,0,0,0,0,5,5,5,5
"1028",2019-12-06,"Non.motorized","w1920","Fri","weekday","no_sled",42,"2","2","1",2.9,0.4,19,5,24,15.3,0,0,0,0,5,5,5,5
"1029",2019-12-07,"Hybrid","w1920","Sat","weekend","sled",0,"2","2","1",3,0.1,18,-1,29,16.7,5,0,0,0,4,4,4,4
"1030",2019-12-07,"Mechanized","w1920","Sat","weekend","no_sled",3,"2","2","1",3,0.1,18,-1,29,16.7,5,0,0,0,4,4,4,4
"1031",2019-12-07,"Motorized","w1920","Sat","weekend","sled",64,"2","2","1",3,0.1,18,-1,29,16.7,5,0,0,0,4,4,4,4
"1032",2019-12-07,"Non.motorized","w1920","Sat","weekend","no_sled",115,"2","2","1",3,0.1,18,-1,29,16.7,5,0,0,0,4,4,4,4
"1033",2019-12-08,"Hybrid","w1920","Sun","weekend","sled",0,"2","2","1",3,0,17,-1,28,17.6,-1,5,0,0,-2,3,3,3
"1034",2019-12-08,"Mechanized","w1920","Sun","weekend","no_sled",4,"2","2","1",3,0,17,-1,28,17.6,-1,5,0,0,-2,3,3,3
"1035",2019-12-08,"Motorized","w1920","Sun","weekend","sled",27,"2","2","1",3,0,17,-1,28,17.6,-1,5,0,0,-2,3,3,3
"1036",2019-12-08,"Non.motorized","w1920","Sun","weekend","no_sled",99,"2","2","1",3,0,17,-1,28,17.6,-1,5,0,0,-2,3,3,3
"1037",2019-12-09,"Hybrid","w1920","Mon","weekday","sled",0,"3","3","2",3.4,0.4,22,5,21,15.5,-1,-1,5,0,4,3,8,8
"1038",2019-12-09,"Mechanized","w1920","Mon","weekday","no_sled",0,"3","3","2",3.4,0.4,22,5,21,15.5,-1,-1,5,0,4,3,8,8
"1039",2019-12-09,"Motorized","w1920","Mon","weekday","sled",52,"3","3","2",3.4,0.4,22,5,21,15.5,-1,-1,5,0,4,3,8,8
"1040",2019-12-09,"Non.motorized","w1920","Mon","weekday","no_sled",37,"3","3","2",3.4,0.4,22,5,21,15.5,-1,-1,5,0,4,3,8,8
"1041",2019-12-10,"Hybrid","w1920","Tue","weekday","sled",1,"2","2","2",3.4,0,21,-1,19,16.2,5,-1,-1,5,4,3,2,7
"1042",2019-12-10,"Mechanized","w1920","Tue","weekday","no_sled",1,"2","2","2",3.4,0,21,-1,19,16.2,5,-1,-1,5,4,3,2,7
"1043",2019-12-10,"Motorized","w1920","Tue","weekday","sled",46,"2","2","2",3.4,0,21,-1,19,16.2,5,-1,-1,5,4,3,2,7
"1044",2019-12-10,"Non.motorized","w1920","Tue","weekday","no_sled",65,"2","2","2",3.4,0,21,-1,19,16.2,5,-1,-1,5,4,3,2,7
"1045",2019-12-11,"Hybrid","w1920","Wed","weekday","sled",0,"2","2","2",3.4,0,20,-1,22,17,-1,5,-1,-1,-2,3,2,1
"1046",2019-12-11,"Mechanized","w1920","Wed","weekday","no_sled",1,"2","2","2",3.4,0,20,-1,22,17,-1,5,-1,-1,-2,3,2,1
"1047",2019-12-11,"Motorized","w1920","Wed","weekday","sled",50,"2","2","2",3.4,0,20,-1,22,17,-1,5,-1,-1,-2,3,2,1
"1048",2019-12-11,"Non.motorized","w1920","Wed","weekday","no_sled",56,"2","2","2",3.4,0,20,-1,22,17,-1,5,-1,-1,-2,3,2,1
"1049",2019-12-12,"Hybrid","w1920","Thu","weekday","sled",0,"2","2","2",3.4,0,19,-1,25,17.9,-1,-1,5,-1,-2,-3,2,1
"1050",2019-12-12,"Mechanized","w1920","Thu","weekday","no_sled",0,"2","2","2",3.4,0,19,-1,25,17.9,-1,-1,5,-1,-2,-3,2,1
"1051",2019-12-12,"Motorized","w1920","Thu","weekday","sled",36,"2","2","2",3.4,0,19,-1,25,17.9,-1,-1,5,-1,-2,-3,2,1
"1052",2019-12-12,"Non.motorized","w1920","Thu","weekday","no_sled",49,"2","2","2",3.4,0,19,-1,25,17.9,-1,-1,5,-1,-2,-3,2,1
"1053",2019-12-13,"Hybrid","w1920","Fri","weekday","sled",1,"2","2","2",3.8,0.4,21,2,24,18.1,-1,-1,-1,5,1,0,-1,4
"1054",2019-12-13,"Mechanized","w1920","Fri","weekday","no_sled",0,"2","2","2",3.8,0.4,21,2,24,18.1,-1,-1,-1,5,1,0,-1,4
"1055",2019-12-13,"Motorized","w1920","Fri","weekday","sled",40,"2","2","2",3.8,0.4,21,2,24,18.1,-1,-1,-1,5,1,0,-1,4
"1056",2019-12-13,"Non.motorized","w1920","Fri","weekday","no_sled",33,"2","2","2",3.8,0.4,21,2,24,18.1,-1,-1,-1,5,1,0,-1,4
"1057",2019-12-14,"Hybrid","w1920","Sat","weekend","sled",2,"3","3","3",4.2,0.4,27,6,25,15.6,2,-1,-1,-1,8,7,6,5
"1058",2019-12-14,"Mechanized","w1920","Sat","weekend","no_sled",3,"3","3","3",4.2,0.4,27,6,25,15.6,2,-1,-1,-1,8,7,6,5
"1059",2019-12-14,"Motorized","w1920","Sat","weekend","sled",35,"3","3","3",4.2,0.4,27,6,25,15.6,2,-1,-1,-1,8,7,6,5
"1060",2019-12-14,"Non.motorized","w1920","Sat","weekend","no_sled",41,"3","3","3",4.2,0.4,27,6,25,15.6,2,-1,-1,-1,8,7,6,5
"1061",2019-12-15,"Hybrid","w1920","Sun","weekend","sled",0,"3","3","2",4.8,0.6,31,4,17,15.5,6,2,-1,-1,10,12,11,10
"1062",2019-12-15,"Mechanized","w1920","Sun","weekend","no_sled",1,"3","3","2",4.8,0.6,31,4,17,15.5,6,2,-1,-1,10,12,11,10
"1063",2019-12-15,"Motorized","w1920","Sun","weekend","sled",77,"3","3","2",4.8,0.6,31,4,17,15.5,6,2,-1,-1,10,12,11,10
"1064",2019-12-15,"Non.motorized","w1920","Sun","weekend","no_sled",93,"3","3","2",4.8,0.6,31,4,17,15.5,6,2,-1,-1,10,12,11,10
"1065",2019-12-16,"Hybrid","w1920","Mon","weekday","sled",1,"3","3","2",4.8,0,29,-2,6,16.6,4,6,2,-1,2,8,10,9
"1066",2019-12-16,"Mechanized","w1920","Mon","weekday","no_sled",2,"3","3","2",4.8,0,29,-2,6,16.6,4,6,2,-1,2,8,10,9
"1067",2019-12-16,"Motorized","w1920","Mon","weekday","sled",80,"3","3","2",4.8,0,29,-2,6,16.6,4,6,2,-1,2,8,10,9
"1068",2019-12-16,"Non.motorized","w1920","Mon","weekday","no_sled",39,"3","3","2",4.8,0,29,-2,6,16.6,4,6,2,-1,2,8,10,9
"1069",2019-12-17,"Hybrid","w1920","Tue","weekday","sled",0,"2","2","1",4.8,0,27,-2,8,17.8,-2,4,6,2,-4,0,6,8
"1070",2019-12-17,"Mechanized","w1920","Tue","weekday","no_sled",4,"2","2","1",4.8,0,27,-2,8,17.8,-2,4,6,2,-4,0,6,8
"1071",2019-12-17,"Motorized","w1920","Tue","weekday","sled",39,"2","2","1",4.8,0,27,-2,8,17.8,-2,4,6,2,-4,0,6,8
"1072",2019-12-17,"Non.motorized","w1920","Tue","weekday","no_sled",24,"2","2","1",4.8,0,27,-2,8,17.8,-2,4,6,2,-4,0,6,8
"1073",2019-12-18,"Hybrid","w1920","Wed","weekday","sled",0,"2","2","1",4.8,0,26,-1,20,18.5,-2,-2,4,6,-3,-5,-1,5
"1074",2019-12-18,"Mechanized","w1920","Wed","weekday","no_sled",6,"2","2","1",4.8,0,26,-1,20,18.5,-2,-2,4,6,-3,-5,-1,5
"1075",2019-12-18,"Motorized","w1920","Wed","weekday","sled",64,"2","2","1",4.8,0,26,-1,20,18.5,-2,-2,4,6,-3,-5,-1,5
"1076",2019-12-18,"Non.motorized","w1920","Wed","weekday","no_sled",44,"2","2","1",4.8,0,26,-1,20,18.5,-2,-2,4,6,-3,-5,-1,5
"1077",2019-12-19,"Hybrid","w1920","Thu","weekday","sled",1,"2","2","1",4.9,0.1,25,-1,21,19.6,-1,-2,-2,4,-2,-4,-6,-2
"1078",2019-12-19,"Mechanized","w1920","Thu","weekday","no_sled",1,"2","2","1",4.9,0.1,25,-1,21,19.6,-1,-2,-2,4,-2,-4,-6,-2
"1079",2019-12-19,"Motorized","w1920","Thu","weekday","sled",64,"2","2","1",4.9,0.1,25,-1,21,19.6,-1,-2,-2,4,-2,-4,-6,-2
"1080",2019-12-19,"Non.motorized","w1920","Thu","weekday","no_sled",50,"2","2","1",4.9,0.1,25,-1,21,19.6,-1,-2,-2,4,-2,-4,-6,-2
"1081",2019-12-20,"Hybrid","w1920","Fri","weekday","sled",0,"2","2","1",4.9,0,24,-1,21,20.4,-1,-1,-2,-2,-2,-3,-5,-7
"1082",2019-12-20,"Mechanized","w1920","Fri","weekday","no_sled",1,"2","2","1",4.9,0,24,-1,21,20.4,-1,-1,-2,-2,-2,-3,-5,-7
"1083",2019-12-20,"Motorized","w1920","Fri","weekday","sled",75,"2","2","1",4.9,0,24,-1,21,20.4,-1,-1,-2,-2,-2,-3,-5,-7
"1084",2019-12-20,"Non.motorized","w1920","Fri","weekday","no_sled",51,"2","2","1",4.9,0,24,-1,21,20.4,-1,-1,-2,-2,-2,-3,-5,-7
"1085",2019-12-21,"Hybrid","w1920","Sat","weekend","sled",0,"2","2","1",4.9,0,24,0,27,20.4,-1,-1,-1,-2,-1,-2,-3,-5
"1086",2019-12-21,"Mechanized","w1920","Sat","weekend","no_sled",6,"2","2","1",4.9,0,24,0,27,20.4,-1,-1,-1,-2,-1,-2,-3,-5
"1087",2019-12-21,"Motorized","w1920","Sat","weekend","sled",114,"2","2","1",4.9,0,24,0,27,20.4,-1,-1,-1,-2,-1,-2,-3,-5
"1088",2019-12-21,"Non.motorized","w1920","Sat","weekend","no_sled",107,"2","2","1",4.9,0,24,0,27,20.4,-1,-1,-1,-2,-1,-2,-3,-5
"1089",2019-12-22,"Hybrid","w1920","Sun","weekend","sled",0,"2","2","1",5,0.1,23,-1,31,21.7,0,-1,-1,-1,-1,-2,-3,-4
"1090",2019-12-22,"Mechanized","w1920","Sun","weekend","no_sled",6,"2","2","1",5,0.1,23,-1,31,21.7,0,-1,-1,-1,-1,-2,-3,-4
"1091",2019-12-22,"Motorized","w1920","Sun","weekend","sled",41,"2","2","1",5,0.1,23,-1,31,21.7,0,-1,-1,-1,-1,-2,-3,-4
"1092",2019-12-22,"Non.motorized","w1920","Sun","weekend","no_sled",122,"2","2","1",5,0.1,23,-1,31,21.7,0,-1,-1,-1,-1,-2,-3,-4
"1093",2019-12-23,"Hybrid","w1920","Mon","weekday","sled",0,"2","1","1",5,0,23,0,34,21.7,-1,0,-1,-1,-1,-1,-2,-3
"1094",2019-12-23,"Mechanized","w1920","Mon","weekday","no_sled",3,"2","1","1",5,0,23,0,34,21.7,-1,0,-1,-1,-1,-1,-2,-3
"1095",2019-12-23,"Motorized","w1920","Mon","weekday","sled",128,"2","1","1",5,0,23,0,34,21.7,-1,0,-1,-1,-1,-1,-2,-3
"1096",2019-12-23,"Non.motorized","w1920","Mon","weekday","no_sled",88,"2","1","1",5,0,23,0,34,21.7,-1,0,-1,-1,-1,-1,-2,-3
"1097",2019-12-24,"Hybrid","w1920","Tue","weekday","sled",1,"2","1","1",5,0,22,-1,30,22.7,0,-1,0,-1,-1,-2,-2,-3
"1098",2019-12-24,"Mechanized","w1920","Tue","weekday","no_sled",10,"2","1","1",5,0,22,-1,30,22.7,0,-1,0,-1,-1,-2,-2,-3
"1099",2019-12-24,"Motorized","w1920","Tue","weekday","sled",154,"2","1","1",5,0,22,-1,30,22.7,0,-1,0,-1,-1,-2,-2,-3
"1100",2019-12-24,"Non.motorized","w1920","Tue","weekday","no_sled",103,"2","1","1",5,0,22,-1,30,22.7,0,-1,0,-1,-1,-2,-2,-3
"1101",2019-12-25,"Hybrid","w1920","Wed","weekday","sled",2,"2","2","2",5,0,23,1,22,21.7,-1,0,-1,0,0,0,-1,-1
"1102",2019-12-25,"Mechanized","w1920","Wed","weekday","no_sled",6,"2","2","2",5,0,23,1,22,21.7,-1,0,-1,0,0,0,-1,-1
"1103",2019-12-25,"Motorized","w1920","Wed","weekday","sled",163,"2","2","2",5,0,23,1,22,21.7,-1,0,-1,0,0,0,-1,-1
"1104",2019-12-25,"Non.motorized","w1920","Wed","weekday","no_sled",126,"2","2","2",5,0,23,1,22,21.7,-1,0,-1,0,0,0,-1,-1
"1105",2019-12-26,"Hybrid","w1920","Thu","weekday","sled",1,"2","2","1",5,0,23,0,17,21.7,1,-1,0,-1,1,0,0,-1
"1106",2019-12-26,"Mechanized","w1920","Thu","weekday","no_sled",5,"2","2","1",5,0,23,0,17,21.7,1,-1,0,-1,1,0,0,-1
"1107",2019-12-26,"Motorized","w1920","Thu","weekday","sled",225,"2","2","1",5,0,23,0,17,21.7,1,-1,0,-1,1,0,0,-1
"1108",2019-12-26,"Non.motorized","w1920","Thu","weekday","no_sled",137,"2","2","1",5,0,23,0,17,21.7,1,-1,0,-1,1,0,0,-1
"1109",2019-12-27,"Hybrid","w1920","Fri","weekday","sled",0,"3","3","2",5.1,0.1,24,1,22,21.2,0,1,-1,0,1,2,1,1
"1110",2019-12-27,"Mechanized","w1920","Fri","weekday","no_sled",3,"3","3","2",5.1,0.1,24,1,22,21.2,0,1,-1,0,1,2,1,1
"1111",2019-12-27,"Motorized","w1920","Fri","weekday","sled",169,"3","3","2",5.1,0.1,24,1,22,21.2,0,1,-1,0,1,2,1,1
"1112",2019-12-27,"Non.motorized","w1920","Fri","weekday","no_sled",114,"3","3","2",5.1,0.1,24,1,22,21.2,0,1,-1,0,1,2,1,1
"1113",2019-12-28,"Hybrid","w1920","Sat","weekend","sled",0,"3","3","2",5.6,0.5,30,6,16,18.7,1,0,1,-1,7,7,8,7
"1114",2019-12-28,"Mechanized","w1920","Sat","weekend","no_sled",2,"3","3","2",5.6,0.5,30,6,16,18.7,1,0,1,-1,7,7,8,7
"1115",2019-12-28,"Motorized","w1920","Sat","weekend","sled",167,"3","3","2",5.6,0.5,30,6,16,18.7,1,0,1,-1,7,7,8,7
"1116",2019-12-28,"Non.motorized","w1920","Sat","weekend","no_sled",147,"3","3","2",5.6,0.5,30,6,16,18.7,1,0,1,-1,7,7,8,7
"1117",2019-12-29,"Hybrid","w1920","Sun","weekend","sled",0,"3","3","2",5.6,0,29,-1,3,19.3,6,1,0,1,5,6,6,7
"1118",2019-12-29,"Mechanized","w1920","Sun","weekend","no_sled",1,"3","3","2",5.6,0,29,-1,3,19.3,6,1,0,1,5,6,6,7
"1119",2019-12-29,"Motorized","w1920","Sun","weekend","sled",168,"3","3","2",5.6,0,29,-1,3,19.3,6,1,0,1,5,6,6,7
"1120",2019-12-29,"Non.motorized","w1920","Sun","weekend","no_sled",148,"3","3","2",5.6,0,29,-1,3,19.3,6,1,0,1,5,6,6,7
"1121",2019-12-30,"Hybrid","w1920","Mon","weekday","sled",0,"3","3","2",5.6,0,28,-1,3,20,-1,6,1,0,-2,4,5,5
"1122",2019-12-30,"Mechanized","w1920","Mon","weekday","no_sled",5,"3","3","2",5.6,0,28,-1,3,20,-1,6,1,0,-2,4,5,5
"1123",2019-12-30,"Motorized","w1920","Mon","weekday","sled",164,"3","3","2",5.6,0,28,-1,3,20,-1,6,1,0,-2,4,5,5
"1124",2019-12-30,"Non.motorized","w1920","Mon","weekday","no_sled",93,"3","3","2",5.6,0,28,-1,3,20,-1,6,1,0,-2,4,5,5
"1125",2019-12-31,"Hybrid","w1920","Tue","weekday","sled",0,"2","2","1",5.6,0,28,0,13,20,-1,-1,6,1,-1,-2,4,5
"1126",2019-12-31,"Mechanized","w1920","Tue","weekday","no_sled",7,"2","2","1",5.6,0,28,0,13,20,-1,-1,6,1,-1,-2,4,5
"1127",2019-12-31,"Motorized","w1920","Tue","weekday","sled",180,"2","2","1",5.6,0,28,0,13,20,-1,-1,6,1,-1,-2,4,5
"1128",2019-12-31,"Non.motorized","w1920","Tue","weekday","no_sled",79,"2","2","1",5.6,0,28,0,13,20,-1,-1,6,1,-1,-2,4,5
"1129",2020-01-01,"Hybrid","w1920","Wed","weekday","sled",0,"2","1","1",5.6,0,27,-1,21,20.7,0,-1,-1,6,-1,-2,-3,3
"1130",2020-01-01,"Mechanized","w1920","Wed","weekday","no_sled",3,"2","1","1",5.6,0,27,-1,21,20.7,0,-1,-1,6,-1,-2,-3,3
"1131",2020-01-01,"Motorized","w1920","Wed","weekday","sled",96,"2","1","1",5.6,0,27,-1,21,20.7,0,-1,-1,6,-1,-2,-3,3
"1132",2020-01-01,"Non.motorized","w1920","Wed","weekday","no_sled",118,"2","1","1",5.6,0,27,-1,21,20.7,0,-1,-1,6,-1,-2,-3,3
"1133",2020-01-02,"Hybrid","w1920","Thu","weekday","sled",0,"3","3","2",5.9,0.3,29,2,16,20.3,-1,0,-1,-1,1,1,0,-1
"1134",2020-01-02,"Mechanized","w1920","Thu","weekday","no_sled",2,"3","3","2",5.9,0.3,29,2,16,20.3,-1,0,-1,-1,1,1,0,-1
"1135",2020-01-02,"Motorized","w1920","Thu","weekday","sled",130,"3","3","2",5.9,0.3,29,2,16,20.3,-1,0,-1,-1,1,1,0,-1
"1136",2020-01-02,"Non.motorized","w1920","Thu","weekday","no_sled",74,"3","3","2",5.9,0.3,29,2,16,20.3,-1,0,-1,-1,1,1,0,-1
"1137",2020-01-03,"Hybrid","w1920","Fri","weekday","sled",0,"3","2","1",5.9,0,31,2,19,19,2,-1,0,-1,4,3,3,2
"1138",2020-01-03,"Mechanized","w1920","Fri","weekday","no_sled",6,"3","2","1",5.9,0,31,2,19,19,2,-1,0,-1,4,3,3,2
"1139",2020-01-03,"Motorized","w1920","Fri","weekday","sled",143,"3","2","1",5.9,0,31,2,19,19,2,-1,0,-1,4,3,3,2
"1140",2020-01-03,"Non.motorized","w1920","Fri","weekday","no_sled",110,"3","2","1",5.9,0,31,2,19,19,2,-1,0,-1,4,3,3,2
"1141",2020-01-04,"Hybrid","w1920","Sat","weekend","sled",0,"2","2","1",5.9,0,30,-1,26,19.7,2,2,-1,0,1,3,2,2
"1142",2020-01-04,"Mechanized","w1920","Sat","weekend","no_sled",11,"2","2","1",5.9,0,30,-1,26,19.7,2,2,-1,0,1,3,2,2
"1143",2020-01-04,"Motorized","w1920","Sat","weekend","sled",92,"2","2","1",5.9,0,30,-1,26,19.7,2,2,-1,0,1,3,2,2
"1144",2020-01-04,"Non.motorized","w1920","Sat","weekend","no_sled",101,"2","2","1",5.9,0,30,-1,26,19.7,2,2,-1,0,1,3,2,2
"1145",2020-01-05,"Hybrid","w1920","Sun","weekend","sled",0,"2","2","1",5.9,0,28,-2,23,21.1,-1,2,2,-1,-3,-1,1,0
"1146",2020-01-05,"Mechanized","w1920","Sun","weekend","no_sled",6,"2","2","1",5.9,0,28,-2,23,21.1,-1,2,2,-1,-3,-1,1,0
"1147",2020-01-05,"Motorized","w1920","Sun","weekend","sled",25,"2","2","1",5.9,0,28,-2,23,21.1,-1,2,2,-1,-3,-1,1,0
"1148",2020-01-05,"Non.motorized","w1920","Sun","weekend","no_sled",71,"2","2","1",5.9,0,28,-2,23,21.1,-1,2,2,-1,-3,-1,1,0
"1149",2020-01-06,"Hybrid","w1920","Mon","weekday","sled",0,"2","2","1",5.9,0,28,0,15,21.1,-2,-1,2,2,-2,-3,-1,1
"1150",2020-01-06,"Mechanized","w1920","Mon","weekday","no_sled",4,"2","2","1",5.9,0,28,0,15,21.1,-2,-1,2,2,-2,-3,-1,1
"1151",2020-01-06,"Motorized","w1920","Mon","weekday","sled",6,"2","2","1",5.9,0,28,0,15,21.1,-2,-1,2,2,-2,-3,-1,1
"1152",2020-01-06,"Non.motorized","w1920","Mon","weekday","no_sled",50,"2","2","1",5.9,0,28,0,15,21.1,-2,-1,2,2,-2,-3,-1,1
"1153",2020-01-07,"Hybrid","w1920","Tue","weekday","sled",0,"2","1","1",5.9,0,28,0,22,21.1,0,-2,-1,2,0,-2,-3,-1
"1154",2020-01-07,"Mechanized","w1920","Tue","weekday","no_sled",8,"2","1","1",5.9,0,28,0,22,21.1,0,-2,-1,2,0,-2,-3,-1
"1155",2020-01-07,"Motorized","w1920","Tue","weekday","sled",3,"2","1","1",5.9,0,28,0,22,21.1,0,-2,-1,2,0,-2,-3,-1
"1156",2020-01-07,"Non.motorized","w1920","Tue","weekday","no_sled",35,"2","1","1",5.9,0,28,0,22,21.1,0,-2,-1,2,0,-2,-3,-1
"1157",2020-01-08,"Hybrid","w1920","Wed","weekday","sled",0,"2","1","1",6,0.1,28,0,23,21.4,0,0,-2,-1,0,0,-2,-3
"1158",2020-01-08,"Mechanized","w1920","Wed","weekday","no_sled",1,"2","1","1",6,0.1,28,0,23,21.4,0,0,-2,-1,0,0,-2,-3
"1159",2020-01-08,"Motorized","w1920","Wed","weekday","sled",0,"2","1","1",6,0.1,28,0,23,21.4,0,0,-2,-1,0,0,-2,-3
"1160",2020-01-08,"Non.motorized","w1920","Wed","weekday","no_sled",48,"2","1","1",6,0.1,28,0,23,21.4,0,0,-2,-1,0,0,-2,-3
"1161",2020-01-09,"Hybrid","w1920","Thu","weekday","sled",0,"2","1","1",6,0,27,-1,17,22.2,0,0,0,-2,-1,-1,-1,-3
"1162",2020-01-09,"Mechanized","w1920","Thu","weekday","no_sled",1,"2","1","1",6,0,27,-1,17,22.2,0,0,0,-2,-1,-1,-1,-3
"1163",2020-01-09,"Motorized","w1920","Thu","weekday","sled",1,"2","1","1",6,0,27,-1,17,22.2,0,0,0,-2,-1,-1,-1,-3
"1164",2020-01-09,"Non.motorized","w1920","Thu","weekday","no_sled",39,"2","1","1",6,0,27,-1,17,22.2,0,0,0,-2,-1,-1,-1,-3
"1165",2020-01-10,"Hybrid","w1920","Fri","weekday","sled",0,"2","1","1",6,0,29,2,11,20.7,-1,0,0,0,1,1,1,1
"1166",2020-01-10,"Mechanized","w1920","Fri","weekday","no_sled",4,"2","1","1",6,0,29,2,11,20.7,-1,0,0,0,1,1,1,1
"1167",2020-01-10,"Motorized","w1920","Fri","weekday","sled",5,"2","1","1",6,0,29,2,11,20.7,-1,0,0,0,1,1,1,1
"1168",2020-01-10,"Non.motorized","w1920","Fri","weekday","no_sled",54,"2","1","1",6,0,29,2,11,20.7,-1,0,0,0,1,1,1,1
"1169",2020-01-11,"Hybrid","w1920","Sat","weekend","sled",0,"2","1","1",6,0,29,0,12,20.7,2,-1,0,0,2,1,1,1
"1170",2020-01-11,"Mechanized","w1920","Sat","weekend","no_sled",3,"2","1","1",6,0,29,0,12,20.7,2,-1,0,0,2,1,1,1
"1171",2020-01-11,"Motorized","w1920","Sat","weekend","sled",24,"2","1","1",6,0,29,0,12,20.7,2,-1,0,0,2,1,1,1
"1172",2020-01-11,"Non.motorized","w1920","Sat","weekend","no_sled",69,"2","1","1",6,0,29,0,12,20.7,2,-1,0,0,2,1,1,1
"1173",2020-01-12,"Hybrid","w1920","Sun","weekend","sled",0,"2","1","1",6.1,0.1,29,0,13,21,0,2,-1,0,0,2,1,1
"1174",2020-01-12,"Mechanized","w1920","Sun","weekend","no_sled",2,"2","1","1",6.1,0.1,29,0,13,21,0,2,-1,0,0,2,1,1
"1175",2020-01-12,"Motorized","w1920","Sun","weekend","sled",74,"2","1","1",6.1,0.1,29,0,13,21,0,2,-1,0,0,2,1,1
"1176",2020-01-12,"Non.motorized","w1920","Sun","weekend","no_sled",165,"2","1","1",6.1,0.1,29,0,13,21,0,2,-1,0,0,2,1,1
"1177",2020-01-13,"Hybrid","w1920","Mon","weekday","sled",0,"2","2","1",6.2,0.1,29,0,16,21.4,0,0,2,-1,0,0,2,1
"1178",2020-01-13,"Mechanized","w1920","Mon","weekday","no_sled",0,"2","2","1",6.2,0.1,29,0,16,21.4,0,0,2,-1,0,0,2,1
"1179",2020-01-13,"Motorized","w1920","Mon","weekday","sled",39,"2","2","1",6.2,0.1,29,0,16,21.4,0,0,2,-1,0,0,2,1
"1180",2020-01-13,"Non.motorized","w1920","Mon","weekday","no_sled",12,"2","2","1",6.2,0.1,29,0,16,21.4,0,0,2,-1,0,0,2,1
"1181",2020-01-14,"Hybrid","w1920","Tue","weekday","sled",0,"3","2","1",6.6,0.4,34,5,23,19.4,0,0,0,2,5,5,5,7
"1182",2020-01-14,"Mechanized","w1920","Tue","weekday","no_sled",0,"3","2","1",6.6,0.4,34,5,23,19.4,0,0,0,2,5,5,5,7
"1183",2020-01-14,"Motorized","w1920","Tue","weekday","sled",44,"3","2","1",6.6,0.4,34,5,23,19.4,0,0,0,2,5,5,5,7
"1184",2020-01-14,"Non.motorized","w1920","Tue","weekday","no_sled",100,"3","2","1",6.6,0.4,34,5,23,19.4,0,0,0,2,5,5,5,7
"1185",2020-01-15,"Hybrid","w1920","Wed","weekday","sled",0,"3","2","1",6.7,0.1,32,-2,23,20.9,5,0,0,0,3,3,3,3
"1186",2020-01-15,"Mechanized","w1920","Wed","weekday","no_sled",1,"3","2","1",6.7,0.1,32,-2,23,20.9,5,0,0,0,3,3,3,3
"1187",2020-01-15,"Motorized","w1920","Wed","weekday","sled",37,"3","2","1",6.7,0.1,32,-2,23,20.9,5,0,0,0,3,3,3,3
"1188",2020-01-15,"Non.motorized","w1920","Wed","weekday","no_sled",94,"3","2","1",6.7,0.1,32,-2,23,20.9,5,0,0,0,3,3,3,3
"1189",2020-01-16,"Hybrid","w1920","Thu","weekday","sled",0,"2","2","1",6.7,0,31,-1,28,21.6,-2,5,0,0,-3,2,2,2
"1190",2020-01-16,"Mechanized","w1920","Thu","weekday","no_sled",4,"2","2","1",6.7,0,31,-1,28,21.6,-2,5,0,0,-3,2,2,2
"1191",2020-01-16,"Motorized","w1920","Thu","weekday","sled",49,"2","2","1",6.7,0,31,-1,28,21.6,-2,5,0,0,-3,2,2,2
"1192",2020-01-16,"Non.motorized","w1920","Thu","weekday","no_sled",65,"2","2","1",6.7,0,31,-1,28,21.6,-2,5,0,0,-3,2,2,2
"1193",2020-01-17,"Hybrid","w1920","Fri","weekday","sled",0,"2","2","1",6.8,0.1,29,-2,19,23.4,-1,-2,5,0,-3,-5,0,0
"1194",2020-01-17,"Mechanized","w1920","Fri","weekday","no_sled",0,"2","2","1",6.8,0.1,29,-2,19,23.4,-1,-2,5,0,-3,-5,0,0
"1195",2020-01-17,"Motorized","w1920","Fri","weekday","sled",6,"2","2","1",6.8,0.1,29,-2,19,23.4,-1,-2,5,0,-3,-5,0,0
"1196",2020-01-17,"Non.motorized","w1920","Fri","weekday","no_sled",34,"2","2","1",6.8,0.1,29,-2,19,23.4,-1,-2,5,0,-3,-5,0,0
"1197",2020-01-18,"Hybrid","w1920","Sat","weekend","sled",0,"2","2","2",7,0.2,34,5,16,20.6,-2,-1,-2,5,3,2,0,5
"1198",2020-01-18,"Mechanized","w1920","Sat","weekend","no_sled",1,"2","2","2",7,0.2,34,5,16,20.6,-2,-1,-2,5,3,2,0,5
"1199",2020-01-18,"Motorized","w1920","Sat","weekend","sled",30,"2","2","2",7,0.2,34,5,16,20.6,-2,-1,-2,5,3,2,0,5
"1200",2020-01-18,"Non.motorized","w1920","Sat","weekend","no_sled",124,"2","2","2",7,0.2,34,5,16,20.6,-2,-1,-2,5,3,2,0,5
"1201",2020-01-19,"Hybrid","w1920","Sun","weekend","sled",0,"2","2","1",7,0,33,-1,21,21.2,5,-2,-1,-2,4,2,1,-1
"1202",2020-01-19,"Mechanized","w1920","Sun","weekend","no_sled",6,"2","2","1",7,0,33,-1,21,21.2,5,-2,-1,-2,4,2,1,-1
"1203",2020-01-19,"Motorized","w1920","Sun","weekend","sled",70,"2","2","1",7,0,33,-1,21,21.2,5,-2,-1,-2,4,2,1,-1
"1204",2020-01-19,"Non.motorized","w1920","Sun","weekend","no_sled",133,"2","2","1",7,0,33,-1,21,21.2,5,-2,-1,-2,4,2,1,-1
"1205",2020-01-20,"Hybrid","w1920","Mon","weekday","sled",0,"2","2","1",7.1,0.1,32,-1,25,22.2,-1,5,-2,-1,-2,3,1,0
"1206",2020-01-20,"Mechanized","w1920","Mon","weekday","no_sled",2,"2","2","1",7.1,0.1,32,-1,25,22.2,-1,5,-2,-1,-2,3,1,0
"1207",2020-01-20,"Motorized","w1920","Mon","weekday","sled",56,"2","2","1",7.1,0.1,32,-1,25,22.2,-1,5,-2,-1,-2,3,1,0
"1208",2020-01-20,"Non.motorized","w1920","Mon","weekday","no_sled",72,"2","2","1",7.1,0.1,32,-1,25,22.2,-1,5,-2,-1,-2,3,1,0
"1209",2020-01-21,"Hybrid","w1920","Tue","weekday","sled",0,"2","2","1",7.1,0,31,-1,28,22.9,-1,-1,5,-2,-2,-3,2,0
"1210",2020-01-21,"Mechanized","w1920","Tue","weekday","no_sled",1,"2","2","1",7.1,0,31,-1,28,22.9,-1,-1,5,-2,-2,-3,2,0
"1211",2020-01-21,"Motorized","w1920","Tue","weekday","sled",33,"2","2","1",7.1,0,31,-1,28,22.9,-1,-1,5,-2,-2,-3,2,0
"1212",2020-01-21,"Non.motorized","w1920","Tue","weekday","no_sled",46,"2","2","1",7.1,0,31,-1,28,22.9,-1,-1,5,-2,-2,-3,2,0
"1213",2020-01-22,"Hybrid","w1920","Wed","weekday","sled",0,"2","2","2",7.3,0.2,32,1,25,22.8,-1,-1,-1,5,0,-1,-2,3
"1214",2020-01-22,"Mechanized","w1920","Wed","weekday","no_sled",1,"2","2","2",7.3,0.2,32,1,25,22.8,-1,-1,-1,5,0,-1,-2,3
"1215",2020-01-22,"Motorized","w1920","Wed","weekday","sled",51,"2","2","2",7.3,0.2,32,1,25,22.8,-1,-1,-1,5,0,-1,-2,3
"1216",2020-01-22,"Non.motorized","w1920","Wed","weekday","no_sled",67,"2","2","2",7.3,0.2,32,1,25,22.8,-1,-1,-1,5,0,-1,-2,3
"1217",2020-01-23,"Hybrid","w1920","Thu","weekday","sled",0,"3","2","2",7.3,0,34,2,23,21.5,1,-1,-1,-1,3,2,1,0
"1218",2020-01-23,"Mechanized","w1920","Thu","weekday","no_sled",3,"3","2","2",7.3,0,34,2,23,21.5,1,-1,-1,-1,3,2,1,0
"1219",2020-01-23,"Motorized","w1920","Thu","weekday","sled",43,"3","2","2",7.3,0,34,2,23,21.5,1,-1,-1,-1,3,2,1,0
"1220",2020-01-23,"Non.motorized","w1920","Thu","weekday","no_sled",64,"3","2","2",7.3,0,34,2,23,21.5,1,-1,-1,-1,3,2,1,0
"1221",2020-01-24,"Hybrid","w1920","Fri","weekday","sled",0,"2","2","1",7.3,0,33,-1,23,22.1,2,1,-1,-1,1,2,1,0
"1222",2020-01-24,"Mechanized","w1920","Fri","weekday","no_sled",9,"2","2","1",7.3,0,33,-1,23,22.1,2,1,-1,-1,1,2,1,0
"1223",2020-01-24,"Motorized","w1920","Fri","weekday","sled",56,"2","2","1",7.3,0,33,-1,23,22.1,2,1,-1,-1,1,2,1,0
"1224",2020-01-24,"Non.motorized","w1920","Fri","weekday","no_sled",117,"2","2","1",7.3,0,33,-1,23,22.1,2,1,-1,-1,1,2,1,0
"1225",2020-01-25,"Hybrid","w1920","Sat","weekend","sled",0,"2","2","1",7.4,0.1,32,-1,25,23.1,-1,2,1,-1,-2,0,1,0
"1226",2020-01-25,"Mechanized","w1920","Sat","weekend","no_sled",6,"2","2","1",7.4,0.1,32,-1,25,23.1,-1,2,1,-1,-2,0,1,0
"1227",2020-01-25,"Motorized","w1920","Sat","weekend","sled",93,"2","2","1",7.4,0.1,32,-1,25,23.1,-1,2,1,-1,-2,0,1,0
"1228",2020-01-25,"Non.motorized","w1920","Sat","weekend","no_sled",163,"2","2","1",7.4,0.1,32,-1,25,23.1,-1,2,1,-1,-2,0,1,0
"1229",2020-01-26,"Hybrid","w1920","Sun","weekend","sled",0,"2","1","1",7.4,0,32,0,28,23.1,-1,-1,2,1,-1,-2,0,1
"1230",2020-01-26,"Mechanized","w1920","Sun","weekend","no_sled",4,"2","1","1",7.4,0,32,0,28,23.1,-1,-1,2,1,-1,-2,0,1
"1231",2020-01-26,"Motorized","w1920","Sun","weekend","sled",76,"2","1","1",7.4,0,32,0,28,23.1,-1,-1,2,1,-1,-2,0,1
"1232",2020-01-26,"Non.motorized","w1920","Sun","weekend","no_sled",160,"2","1","1",7.4,0,32,0,28,23.1,-1,-1,2,1,-1,-2,0,1
"1233",2020-01-27,"Hybrid","w1920","Mon","weekday","sled",0,"2","1","1",7.4,0,32,0,24,23.1,0,-1,-1,2,0,-1,-2,0
"1234",2020-01-27,"Mechanized","w1920","Mon","weekday","no_sled",1,"2","1","1",7.4,0,32,0,24,23.1,0,-1,-1,2,0,-1,-2,0
"1235",2020-01-27,"Motorized","w1920","Mon","weekday","sled",33,"2","1","1",7.4,0,32,0,24,23.1,0,-1,-1,2,0,-1,-2,0
"1236",2020-01-27,"Non.motorized","w1920","Mon","weekday","no_sled",57,"2","1","1",7.4,0,32,0,24,23.1,0,-1,-1,2,0,-1,-2,0
"1237",2020-01-28,"Hybrid","w1920","Tue","weekday","sled",0,"3","2","2",7.4,0,32,0,19,23.1,0,0,-1,-1,0,0,-1,-2
"1238",2020-01-28,"Mechanized","w1920","Tue","weekday","no_sled",3,"3","2","2",7.4,0,32,0,19,23.1,0,0,-1,-1,0,0,-1,-2
"1239",2020-01-28,"Motorized","w1920","Tue","weekday","sled",59,"3","2","2",7.4,0,32,0,19,23.1,0,0,-1,-1,0,0,-1,-2
"1240",2020-01-28,"Non.motorized","w1920","Tue","weekday","no_sled",99,"3","2","2",7.4,0,32,0,19,23.1,0,0,-1,-1,0,0,-1,-2
"1241",2020-01-29,"Hybrid","w1920","Wed","weekday","sled",0,"2","2","1",7.4,0,31,-1,20,23.9,0,0,0,-1,-1,-1,-1,-2
"1242",2020-01-29,"Mechanized","w1920","Wed","weekday","no_sled",4,"2","2","1",7.4,0,31,-1,20,23.9,0,0,0,-1,-1,-1,-1,-2
"1243",2020-01-29,"Motorized","w1920","Wed","weekday","sled",62,"2","2","1",7.4,0,31,-1,20,23.9,0,0,0,-1,-1,-1,-1,-2
"1244",2020-01-29,"Non.motorized","w1920","Wed","weekday","no_sled",66,"2","2","1",7.4,0,31,-1,20,23.9,0,0,0,-1,-1,-1,-1,-2
"1245",2020-01-30,"Hybrid","w1920","Thu","weekday","sled",0,"2","2","1",7.4,0,31,0,17,23.9,-1,0,0,0,-1,-1,-1,-1
"1246",2020-01-30,"Mechanized","w1920","Thu","weekday","no_sled",11,"2","2","1",7.4,0,31,0,17,23.9,-1,0,0,0,-1,-1,-1,-1
"1247",2020-01-30,"Motorized","w1920","Thu","weekday","sled",87,"2","2","1",7.4,0,31,0,17,23.9,-1,0,0,0,-1,-1,-1,-1
"1248",2020-01-30,"Non.motorized","w1920","Thu","weekday","no_sled",77,"2","2","1",7.4,0,31,0,17,23.9,-1,0,0,0,-1,-1,-1,-1
"1249",2020-01-31,"Hybrid","w1920","Fri","weekday","sled",0,"2","1","1",7.4,0,31,0,20,23.9,0,-1,0,0,0,-1,-1,-1
"1250",2020-01-31,"Mechanized","w1920","Fri","weekday","no_sled",15,"2","1","1",7.4,0,31,0,20,23.9,0,-1,0,0,0,-1,-1,-1
"1251",2020-01-31,"Motorized","w1920","Fri","weekday","sled",60,"2","1","1",7.4,0,31,0,20,23.9,0,-1,0,0,0,-1,-1,-1
"1252",2020-01-31,"Non.motorized","w1920","Fri","weekday","no_sled",155,"2","1","1",7.4,0,31,0,20,23.9,0,-1,0,0,0,-1,-1,-1
"1253",2020-02-01,"Hybrid","w1920","Sat","weekend","sled",0,"2","1","1",7.4,0,31,0,28,23.9,0,0,-1,0,0,0,-1,-1
"1254",2020-02-01,"Mechanized","w1920","Sat","weekend","no_sled",24,"2","1","1",7.4,0,31,0,28,23.9,0,0,-1,0,0,0,-1,-1
"1255",2020-02-01,"Motorized","w1920","Sat","weekend","sled",128,"2","1","1",7.4,0,31,0,28,23.9,0,0,-1,0,0,0,-1,-1
"1256",2020-02-01,"Non.motorized","w1920","Sat","weekend","no_sled",299,"2","1","1",7.4,0,31,0,28,23.9,0,0,-1,0,0,0,-1,-1
"1257",2020-02-02,"Hybrid","w1920","Sun","weekend","sled",0,"1","1","1",7.4,0,31,0,33,23.9,0,0,0,-1,0,0,0,-1
"1258",2020-02-02,"Mechanized","w1920","Sun","weekend","no_sled",9,"1","1","1",7.4,0,31,0,33,23.9,0,0,0,-1,0,0,0,-1
"1259",2020-02-02,"Motorized","w1920","Sun","weekend","sled",104,"1","1","1",7.4,0,31,0,33,23.9,0,0,0,-1,0,0,0,-1
"1260",2020-02-02,"Non.motorized","w1920","Sun","weekend","no_sled",308,"1","1","1",7.4,0,31,0,33,23.9,0,0,0,-1,0,0,0,-1
"1261",2020-02-03,"Hybrid","w1920","Mon","weekday","sled",0,"2","2","1",7.4,0,31,0,24,23.9,0,0,0,0,0,0,0,0
"1262",2020-02-03,"Mechanized","w1920","Mon","weekday","no_sled",0,"2","2","1",7.4,0,31,0,24,23.9,0,0,0,0,0,0,0,0
"1263",2020-02-03,"Motorized","w1920","Mon","weekday","sled",55,"2","2","1",7.4,0,31,0,24,23.9,0,0,0,0,0,0,0,0
"1264",2020-02-03,"Non.motorized","w1920","Mon","weekday","no_sled",69,"2","2","1",7.4,0,31,0,24,23.9,0,0,0,0,0,0,0,0
"1265",2020-02-04,"Hybrid","w1920","Tue","weekday","sled",0,"2","2","2",7.4,0,33,2,5,22.4,0,0,0,0,2,2,2,2
"1266",2020-02-04,"Mechanized","w1920","Tue","weekday","no_sled",3,"2","2","2",7.4,0,33,2,5,22.4,0,0,0,0,2,2,2,2
"1267",2020-02-04,"Motorized","w1920","Tue","weekday","sled",42,"2","2","2",7.4,0,33,2,5,22.4,0,0,0,0,2,2,2,2
"1268",2020-02-04,"Non.motorized","w1920","Tue","weekday","no_sled",58,"2","2","2",7.4,0,33,2,5,22.4,0,0,0,0,2,2,2,2
"1269",2020-02-05,"Hybrid","w1920","Wed","weekday","sled",0,"2","2","1",7.4,0,33,0,2,22.4,2,0,0,0,2,2,2,2
"1270",2020-02-05,"Mechanized","w1920","Wed","weekday","no_sled",3,"2","2","1",7.4,0,33,0,2,22.4,2,0,0,0,2,2,2,2
"1271",2020-02-05,"Motorized","w1920","Wed","weekday","sled",54,"2","2","1",7.4,0,33,0,2,22.4,2,0,0,0,2,2,2,2
"1272",2020-02-05,"Non.motorized","w1920","Wed","weekday","no_sled",44,"2","2","1",7.4,0,33,0,2,22.4,2,0,0,0,2,2,2,2
"1273",2020-02-06,"Hybrid","w1920","Thu","weekday","sled",0,"2","2","1",7.5,0.1,32,-1,16,23.4,0,2,0,0,-1,1,1,1
"1274",2020-02-06,"Mechanized","w1920","Thu","weekday","no_sled",0,"2","2","1",7.5,0.1,32,-1,16,23.4,0,2,0,0,-1,1,1,1
"1275",2020-02-06,"Motorized","w1920","Thu","weekday","sled",46,"2","2","1",7.5,0.1,32,-1,16,23.4,0,2,0,0,-1,1,1,1
"1276",2020-02-06,"Non.motorized","w1920","Thu","weekday","no_sled",25,"2","2","1",7.5,0.1,32,-1,16,23.4,0,2,0,0,-1,1,1,1
"1277",2020-02-07,"Hybrid","w1920","Fri","weekday","sled",0,"3","3","3",7.9,0.4,37,5,26,21.4,-1,0,2,0,4,4,6,6
"1278",2020-02-07,"Mechanized","w1920","Fri","weekday","no_sled",0,"3","3","3",7.9,0.4,37,5,26,21.4,-1,0,2,0,4,4,6,6
"1279",2020-02-07,"Motorized","w1920","Fri","weekday","sled",3,"3","3","3",7.9,0.4,37,5,26,21.4,-1,0,2,0,4,4,6,6
"1280",2020-02-07,"Non.motorized","w1920","Fri","weekday","no_sled",9,"3","3","3",7.9,0.4,37,5,26,21.4,-1,0,2,0,4,4,6,6
"1281",2020-02-08,"Hybrid","w1920","Sat","weekend","sled",0,"3","3","2",8.3,0.4,39,2,30,21.3,5,-1,0,2,7,6,6,8
"1282",2020-02-08,"Mechanized","w1920","Sat","weekend","no_sled",2,"3","3","2",8.3,0.4,39,2,30,21.3,5,-1,0,2,7,6,6,8
"1283",2020-02-08,"Motorized","w1920","Sat","weekend","sled",24,"3","3","2",8.3,0.4,39,2,30,21.3,5,-1,0,2,7,6,6,8
"1284",2020-02-08,"Non.motorized","w1920","Sat","weekend","no_sled",93,"3","3","2",8.3,0.4,39,2,30,21.3,5,-1,0,2,7,6,6,8
"1285",2020-02-09,"Hybrid","w1920","Sun","weekend","sled",0,"3","2","2",8.4,0.1,38,-1,26,22.1,2,5,-1,0,1,6,5,5
"1286",2020-02-09,"Mechanized","w1920","Sun","weekend","no_sled",5,"3","2","2",8.4,0.1,38,-1,26,22.1,2,5,-1,0,1,6,5,5
"1287",2020-02-09,"Motorized","w1920","Sun","weekend","sled",72,"3","2","2",8.4,0.1,38,-1,26,22.1,2,5,-1,0,1,6,5,5
"1288",2020-02-09,"Non.motorized","w1920","Sun","weekend","no_sled",120,"3","2","2",8.4,0.1,38,-1,26,22.1,2,5,-1,0,1,6,5,5
"1289",2020-02-10,"Hybrid","w1920","Mon","weekday","sled",0,"2","2","1",8.4,0,38,0,22,22.1,-1,2,5,-1,-1,1,6,5
"1290",2020-02-10,"Mechanized","w1920","Mon","weekday","no_sled",2,"2","2","1",8.4,0,38,0,22,22.1,-1,2,5,-1,-1,1,6,5
"1291",2020-02-10,"Motorized","w1920","Mon","weekday","sled",30,"2","2","1",8.4,0,38,0,22,22.1,-1,2,5,-1,-1,1,6,5
"1292",2020-02-10,"Non.motorized","w1920","Mon","weekday","no_sled",85,"2","2","1",8.4,0,38,0,22,22.1,-1,2,5,-1,-1,1,6,5
"1293",2020-02-11,"Hybrid","w1920","Tue","weekday","sled",0,"2","2","2",8.5,0.1,40,2,16,21.2,0,-1,2,5,2,1,3,8
"1294",2020-02-11,"Mechanized","w1920","Tue","weekday","no_sled",2,"2","2","2",8.5,0.1,40,2,16,21.2,0,-1,2,5,2,1,3,8
"1295",2020-02-11,"Motorized","w1920","Tue","weekday","sled",58,"2","2","2",8.5,0.1,40,2,16,21.2,0,-1,2,5,2,1,3,8
"1296",2020-02-11,"Non.motorized","w1920","Tue","weekday","no_sled",63,"2","2","2",8.5,0.1,40,2,16,21.2,0,-1,2,5,2,1,3,8
"1297",2020-02-12,"Hybrid","w1920","Wed","weekday","sled",0,"2","2","2",8.5,0,39,-1,15,21.8,2,0,-1,2,1,1,0,2
"1298",2020-02-12,"Mechanized","w1920","Wed","weekday","no_sled",3,"2","2","2",8.5,0,39,-1,15,21.8,2,0,-1,2,1,1,0,2
"1299",2020-02-12,"Motorized","w1920","Wed","weekday","sled",36,"2","2","2",8.5,0,39,-1,15,21.8,2,0,-1,2,1,1,0,2
"1300",2020-02-12,"Non.motorized","w1920","Wed","weekday","no_sled",95,"2","2","2",8.5,0,39,-1,15,21.8,2,0,-1,2,1,1,0,2
"1301",2020-02-13,"Hybrid","w1920","Thu","weekday","sled",0,"2","2","1",8.5,0,39,0,18,21.8,-1,2,0,-1,-1,1,1,0
"1302",2020-02-13,"Mechanized","w1920","Thu","weekday","no_sled",0,"2","2","1",8.5,0,39,0,18,21.8,-1,2,0,-1,-1,1,1,0
"1303",2020-02-13,"Motorized","w1920","Thu","weekday","sled",44,"2","2","1",8.5,0,39,0,18,21.8,-1,2,0,-1,-1,1,1,0
"1304",2020-02-13,"Non.motorized","w1920","Thu","weekday","no_sled",77,"2","2","1",8.5,0,39,0,18,21.8,-1,2,0,-1,-1,1,1,0
"1305",2020-02-14,"Hybrid","w1920","Fri","weekday","sled",0,"2","1","1",8.6,0.1,38,-1,24,22.6,0,-1,2,0,-1,-2,0,0
"1306",2020-02-14,"Mechanized","w1920","Fri","weekday","no_sled",4,"2","1","1",8.6,0.1,38,-1,24,22.6,0,-1,2,0,-1,-2,0,0
"1307",2020-02-14,"Motorized","w1920","Fri","weekday","sled",49,"2","1","1",8.6,0.1,38,-1,24,22.6,0,-1,2,0,-1,-2,0,0
"1308",2020-02-14,"Non.motorized","w1920","Fri","weekday","no_sled",140,"2","1","1",8.6,0.1,38,-1,24,22.6,0,-1,2,0,-1,-2,0,0
"1309",2020-02-15,"Hybrid","w1920","Sat","weekend","sled",0,"1","1","1",8.6,0,38,0,26,22.6,-1,0,-1,2,-1,-1,-2,0
"1310",2020-02-15,"Mechanized","w1920","Sat","weekend","no_sled",16,"1","1","1",8.6,0,38,0,26,22.6,-1,0,-1,2,-1,-1,-2,0
"1311",2020-02-15,"Motorized","w1920","Sat","weekend","sled",65,"1","1","1",8.6,0,38,0,26,22.6,-1,0,-1,2,-1,-1,-2,0
"1312",2020-02-15,"Non.motorized","w1920","Sat","weekend","no_sled",269,"1","1","1",8.6,0,38,0,26,22.6,-1,0,-1,2,-1,-1,-2,0
"1313",2020-02-16,"Hybrid","w1920","Sun","weekend","sled",0,"1","1","1",8.8,0.2,37,-1,26,23.8,0,-1,0,-1,-1,-2,-2,-3
"1314",2020-02-16,"Mechanized","w1920","Sun","weekend","no_sled",2,"1","1","1",8.8,0.2,37,-1,26,23.8,0,-1,0,-1,-1,-2,-2,-3
"1315",2020-02-16,"Motorized","w1920","Sun","weekend","sled",59,"1","1","1",8.8,0.2,37,-1,26,23.8,0,-1,0,-1,-1,-2,-2,-3
"1316",2020-02-16,"Non.motorized","w1920","Sun","weekend","no_sled",173,"1","1","1",8.8,0.2,37,-1,26,23.8,0,-1,0,-1,-1,-2,-2,-3
"1317",2020-02-17,"Hybrid","w1920","Mon","weekday","sled",0,"2","1","1",9.2,0.4,43,6,25,21.4,-1,0,-1,0,5,5,4,4
"1318",2020-02-17,"Mechanized","w1920","Mon","weekday","no_sled",2,"2","1","1",9.2,0.4,43,6,25,21.4,-1,0,-1,0,5,5,4,4
"1319",2020-02-17,"Motorized","w1920","Mon","weekday","sled",17,"2","1","1",9.2,0.4,43,6,25,21.4,-1,0,-1,0,5,5,4,4
"1320",2020-02-17,"Non.motorized","w1920","Mon","weekday","no_sled",157,"2","1","1",9.2,0.4,43,6,25,21.4,-1,0,-1,0,5,5,4,4
"1321",2020-02-18,"Hybrid","w1920","Tue","weekday","sled",0,"1","1","1",9.3,0.1,42,-1,18,22.1,6,-1,0,-1,5,4,4,3
"1322",2020-02-18,"Mechanized","w1920","Tue","weekday","no_sled",0,"1","1","1",9.3,0.1,42,-1,18,22.1,6,-1,0,-1,5,4,4,3
"1323",2020-02-18,"Motorized","w1920","Tue","weekday","sled",32,"1","1","1",9.3,0.1,42,-1,18,22.1,6,-1,0,-1,5,4,4,3
"1324",2020-02-18,"Non.motorized","w1920","Tue","weekday","no_sled",138,"1","1","1",9.3,0.1,42,-1,18,22.1,6,-1,0,-1,5,4,4,3
"1325",2020-02-19,"Hybrid","w1920","Wed","weekday","sled",0,"1","1","1",9.3,0,41,-1,22,22.7,-1,6,-1,0,-2,4,3,3
"1326",2020-02-19,"Mechanized","w1920","Wed","weekday","no_sled",3,"1","1","1",9.3,0,41,-1,22,22.7,-1,6,-1,0,-2,4,3,3
"1327",2020-02-19,"Motorized","w1920","Wed","weekday","sled",47,"1","1","1",9.3,0,41,-1,22,22.7,-1,6,-1,0,-2,4,3,3
"1328",2020-02-19,"Non.motorized","w1920","Wed","weekday","no_sled",143,"1","1","1",9.3,0,41,-1,22,22.7,-1,6,-1,0,-2,4,3,3
"1329",2020-02-20,"Hybrid","w1920","Thu","weekday","sled",0,"1","1","1",9.3,0,41,0,18,22.7,-1,-1,6,-1,-1,-2,4,3
"1330",2020-02-20,"Mechanized","w1920","Thu","weekday","no_sled",2,"1","1","1",9.3,0,41,0,18,22.7,-1,-1,6,-1,-1,-2,4,3
"1331",2020-02-20,"Motorized","w1920","Thu","weekday","sled",55,"1","1","1",9.3,0,41,0,18,22.7,-1,-1,6,-1,-1,-2,4,3
"1332",2020-02-20,"Non.motorized","w1920","Thu","weekday","no_sled",150,"1","1","1",9.3,0,41,0,18,22.7,-1,-1,6,-1,-1,-2,4,3
"1333",2020-02-21,"Hybrid","w1920","Fri","weekday","sled",0,"1","1","1",9.3,0,40,-1,26,23.2,0,-1,-1,6,-1,-2,-3,3
"1334",2020-02-21,"Mechanized","w1920","Fri","weekday","no_sled",2,"1","1","1",9.3,0,40,-1,26,23.2,0,-1,-1,6,-1,-2,-3,3
"1335",2020-02-21,"Motorized","w1920","Fri","weekday","sled",102,"1","1","1",9.3,0,40,-1,26,23.2,0,-1,-1,6,-1,-2,-3,3
"1336",2020-02-21,"Non.motorized","w1920","Fri","weekday","no_sled",180,"1","1","1",9.3,0,40,-1,26,23.2,0,-1,-1,6,-1,-2,-3,3
"1337",2020-02-22,"Hybrid","w1920","Sat","weekend","sled",0,"1","1","1",9.4,0.1,39,-1,32,24.1,-1,0,-1,-1,-2,-2,-3,-4
"1338",2020-02-22,"Mechanized","w1920","Sat","weekend","no_sled",2,"1","1","1",9.4,0.1,39,-1,32,24.1,-1,0,-1,-1,-2,-2,-3,-4
"1339",2020-02-22,"Motorized","w1920","Sat","weekend","sled",105,"1","1","1",9.4,0.1,39,-1,32,24.1,-1,0,-1,-1,-2,-2,-3,-4
"1340",2020-02-22,"Non.motorized","w1920","Sat","weekend","no_sled",256,"1","1","1",9.4,0.1,39,-1,32,24.1,-1,0,-1,-1,-2,-2,-3,-4
"1341",2020-02-23,"Hybrid","w1920","Sun","weekend","sled",0,"2","2","2",9.5,0.1,40,1,27,23.8,-1,-1,0,-1,0,-1,-1,-2
"1342",2020-02-23,"Mechanized","w1920","Sun","weekend","no_sled",2,"2","2","2",9.5,0.1,40,1,27,23.8,-1,-1,0,-1,0,-1,-1,-2
"1343",2020-02-23,"Motorized","w1920","Sun","weekend","sled",29,"2","2","2",9.5,0.1,40,1,27,23.8,-1,-1,0,-1,0,-1,-1,-2
"1344",2020-02-23,"Non.motorized","w1920","Sun","weekend","no_sled",235,"2","2","2",9.5,0.1,40,1,27,23.8,-1,-1,0,-1,0,-1,-1,-2
"1345",2020-02-24,"Hybrid","w1920","Mon","weekday","sled",0,"3","3","2",9.8,0.3,43,3,17,22.8,1,-1,-1,0,4,3,2,2
"1346",2020-02-24,"Mechanized","w1920","Mon","weekday","no_sled",0,"3","3","2",9.8,0.3,43,3,17,22.8,1,-1,-1,0,4,3,2,2
"1347",2020-02-24,"Motorized","w1920","Mon","weekday","sled",17,"3","3","2",9.8,0.3,43,3,17,22.8,1,-1,-1,0,4,3,2,2
"1348",2020-02-24,"Non.motorized","w1920","Mon","weekday","no_sled",47,"3","3","2",9.8,0.3,43,3,17,22.8,1,-1,-1,0,4,3,2,2
"1349",2020-02-25,"Hybrid","w1920","Tue","weekday","sled",0,"2","2","1",9.8,0,43,0,8,22.8,3,1,-1,-1,3,4,3,2
"1350",2020-02-25,"Mechanized","w1920","Tue","weekday","no_sled",1,"2","2","1",9.8,0,43,0,8,22.8,3,1,-1,-1,3,4,3,2
"1351",2020-02-25,"Motorized","w1920","Tue","weekday","sled",43,"2","2","1",9.8,0,43,0,8,22.8,3,1,-1,-1,3,4,3,2
"1352",2020-02-25,"Non.motorized","w1920","Tue","weekday","no_sled",145,"2","2","1",9.8,0,43,0,8,22.8,3,1,-1,-1,3,4,3,2
"1353",2020-02-26,"Hybrid","w1920","Wed","weekday","sled",0,"2","2","1",9.8,0,42,-1,15,23.3,0,3,1,-1,-1,2,3,2
"1354",2020-02-26,"Mechanized","w1920","Wed","weekday","no_sled",0,"2","2","1",9.8,0,42,-1,15,23.3,0,3,1,-1,-1,2,3,2
"1355",2020-02-26,"Motorized","w1920","Wed","weekday","sled",54,"2","2","1",9.8,0,42,-1,15,23.3,0,3,1,-1,-1,2,3,2
"1356",2020-02-26,"Non.motorized","w1920","Wed","weekday","no_sled",99,"2","2","1",9.8,0,42,-1,15,23.3,0,3,1,-1,-1,2,3,2
"1357",2020-02-27,"Hybrid","w1920","Thu","weekday","sled",0,"2","2","1",9.9,0.1,41,-1,25,24.1,-1,0,3,1,-2,-2,1,2
"1358",2020-02-27,"Mechanized","w1920","Thu","weekday","no_sled",14,"2","2","1",9.9,0.1,41,-1,25,24.1,-1,0,3,1,-2,-2,1,2
"1359",2020-02-27,"Motorized","w1920","Thu","weekday","sled",75,"2","2","1",9.9,0.1,41,-1,25,24.1,-1,0,3,1,-2,-2,1,2
"1360",2020-02-27,"Non.motorized","w1920","Thu","weekday","no_sled",170,"2","2","1",9.9,0.1,41,-1,25,24.1,-1,0,3,1,-2,-2,1,2
"1361",2020-02-28,"Hybrid","w1920","Fri","weekday","sled",0,"2","1","1",9.9,0,41,0,28,24.1,-1,-1,0,3,-1,-2,-2,1
"1362",2020-02-28,"Mechanized","w1920","Fri","weekday","no_sled",5,"2","1","1",9.9,0,41,0,28,24.1,-1,-1,0,3,-1,-2,-2,1
"1363",2020-02-28,"Motorized","w1920","Fri","weekday","sled",103,"2","1","1",9.9,0,41,0,28,24.1,-1,-1,0,3,-1,-2,-2,1
"1364",2020-02-28,"Non.motorized","w1920","Fri","weekday","no_sled",178,"2","1","1",9.9,0,41,0,28,24.1,-1,-1,0,3,-1,-2,-2,1
"1365",2020-02-29,"Hybrid","w1920","Sat","weekend","sled",0,"1","1","1",9.9,0,40,-1,29,24.8,0,-1,-1,0,-1,-2,-3,-3
"1366",2020-02-29,"Mechanized","w1920","Sat","weekend","no_sled",11,"1","1","1",9.9,0,40,-1,29,24.8,0,-1,-1,0,-1,-2,-3,-3
"1367",2020-02-29,"Motorized","w1920","Sat","weekend","sled",161,"1","1","1",9.9,0,40,-1,29,24.8,0,-1,-1,0,-1,-2,-3,-3
"1368",2020-02-29,"Non.motorized","w1920","Sat","weekend","no_sled",325,"1","1","1",9.9,0,40,-1,29,24.8,0,-1,-1,0,-1,-2,-3,-3
"1369",2020-03-01,"Hybrid","w1920","Sun","weekend","sled",0,"1","1","1",10,0.1,40,0,28,25,-1,0,-1,-1,-1,-1,-2,-3
"1370",2020-03-01,"Mechanized","w1920","Sun","weekend","no_sled",10,"1","1","1",10,0.1,40,0,28,25,-1,0,-1,-1,-1,-1,-2,-3
"1371",2020-03-01,"Motorized","w1920","Sun","weekend","sled",97,"1","1","1",10,0.1,40,0,28,25,-1,0,-1,-1,-1,-1,-2,-3
"1372",2020-03-01,"Non.motorized","w1920","Sun","weekend","no_sled",195,"1","1","1",10,0.1,40,0,28,25,-1,0,-1,-1,-1,-1,-2,-3
"1373",2020-03-02,"Hybrid","w1920","Mon","weekday","sled",0,"2","2","1",10.4,0.4,45,5,25,23.1,0,-1,0,-1,5,4,4,3
"1374",2020-03-02,"Mechanized","w1920","Mon","weekday","no_sled",1,"2","2","1",10.4,0.4,45,5,25,23.1,0,-1,0,-1,5,4,4,3
"1375",2020-03-02,"Motorized","w1920","Mon","weekday","sled",66,"2","2","1",10.4,0.4,45,5,25,23.1,0,-1,0,-1,5,4,4,3
"1376",2020-03-02,"Non.motorized","w1920","Mon","weekday","no_sled",96,"2","2","1",10.4,0.4,45,5,25,23.1,0,-1,0,-1,5,4,4,3
"1377",2020-03-03,"Hybrid","w1920","Tue","weekday","sled",0,"2","1","1",10.9,0.5,50,5,25,21.8,5,0,-1,0,10,10,9,9
"1378",2020-03-03,"Mechanized","w1920","Tue","weekday","no_sled",8,"2","1","1",10.9,0.5,50,5,25,21.8,5,0,-1,0,10,10,9,9
"1379",2020-03-03,"Motorized","w1920","Tue","weekday","sled",26,"2","1","1",10.9,0.5,50,5,25,21.8,5,0,-1,0,10,10,9,9
"1380",2020-03-03,"Non.motorized","w1920","Tue","weekday","no_sled",75,"2","1","1",10.9,0.5,50,5,25,21.8,5,0,-1,0,10,10,9,9
"1381",2020-03-04,"Hybrid","w1920","Wed","weekday","sled",1,"2","1","1",10.9,0,48,-2,29,22.7,5,5,0,-1,3,8,8,7
"1382",2020-03-04,"Mechanized","w1920","Wed","weekday","no_sled",1,"2","1","1",10.9,0,48,-2,29,22.7,5,5,0,-1,3,8,8,7
"1383",2020-03-04,"Motorized","w1920","Wed","weekday","sled",22,"2","1","1",10.9,0,48,-2,29,22.7,5,5,0,-1,3,8,8,7
"1384",2020-03-04,"Non.motorized","w1920","Wed","weekday","no_sled",87,"2","1","1",10.9,0,48,-2,29,22.7,5,5,0,-1,3,8,8,7
"1385",2020-03-05,"Hybrid","w1920","Thu","weekday","sled",0,"2","1","1",10.9,0,46,-2,32,23.7,-2,5,5,0,-4,1,6,6
"1386",2020-03-05,"Mechanized","w1920","Thu","weekday","no_sled",2,"2","1","1",10.9,0,46,-2,32,23.7,-2,5,5,0,-4,1,6,6
"1387",2020-03-05,"Motorized","w1920","Thu","weekday","sled",68,"2","1","1",10.9,0,46,-2,32,23.7,-2,5,5,0,-4,1,6,6
"1388",2020-03-05,"Non.motorized","w1920","Thu","weekday","no_sled",106,"2","1","1",10.9,0,46,-2,32,23.7,-2,5,5,0,-4,1,6,6
"1389",2020-03-06,"Hybrid","w1920","Fri","weekday","sled",1,"1","1","1",10.9,0,45,-1,34,24.2,-2,-2,5,5,-3,-5,0,5
"1390",2020-03-06,"Mechanized","w1920","Fri","weekday","no_sled",1,"1","1","1",10.9,0,45,-1,34,24.2,-2,-2,5,5,-3,-5,0,5
"1391",2020-03-06,"Motorized","w1920","Fri","weekday","sled",93,"1","1","1",10.9,0,45,-1,34,24.2,-2,-2,5,5,-3,-5,0,5
"1392",2020-03-06,"Non.motorized","w1920","Fri","weekday","no_sled",126,"1","1","1",10.9,0,45,-1,34,24.2,-2,-2,5,5,-3,-5,0,5
"1393",2020-03-07,"Hybrid","w1920","Sat","weekend","sled",1,"1","1","2",10.9,0,44,-1,35,24.8,-1,-2,-2,5,-2,-4,-6,-1
"1394",2020-03-07,"Mechanized","w1920","Sat","weekend","no_sled",8,"1","1","2",10.9,0,44,-1,35,24.8,-1,-2,-2,5,-2,-4,-6,-1
"1395",2020-03-07,"Motorized","w1920","Sat","weekend","sled",100,"1","1","2",10.9,0,44,-1,35,24.8,-1,-2,-2,5,-2,-4,-6,-1
"1396",2020-03-07,"Non.motorized","w1920","Sat","weekend","no_sled",240,"1","1","2",10.9,0,44,-1,35,24.8,-1,-2,-2,5,-2,-4,-6,-1
"1397",2020-03-08,"Hybrid","w1920","Sun","weekend","sled",0,"1","1","1",11,0.1,43,-1,33,25.6,-1,-1,-2,-2,-2,-3,-5,-7
"1398",2020-03-08,"Mechanized","w1920","Sun","weekend","no_sled",2,"1","1","1",11,0.1,43,-1,33,25.6,-1,-1,-2,-2,-2,-3,-5,-7
"1399",2020-03-08,"Motorized","w1920","Sun","weekend","sled",82,"1","1","1",11,0.1,43,-1,33,25.6,-1,-1,-2,-2,-2,-3,-5,-7
"1400",2020-03-08,"Non.motorized","w1920","Sun","weekend","no_sled",181,"1","1","1",11,0.1,43,-1,33,25.6,-1,-1,-2,-2,-2,-3,-5,-7
"1401",2020-03-09,"Hybrid","w1920","Mon","weekday","sled",0,"1","1","1",11.1,0.1,42,-1,31,26.4,-1,-1,-1,-2,-2,-3,-4,-6
"1402",2020-03-09,"Mechanized","w1920","Mon","weekday","no_sled",5,"1","1","1",11.1,0.1,42,-1,31,26.4,-1,-1,-1,-2,-2,-3,-4,-6
"1403",2020-03-09,"Motorized","w1920","Mon","weekday","sled",51,"1","1","1",11.1,0.1,42,-1,31,26.4,-1,-1,-1,-2,-2,-3,-4,-6
"1404",2020-03-09,"Non.motorized","w1920","Mon","weekday","no_sled",83,"1","1","1",11.1,0.1,42,-1,31,26.4,-1,-1,-1,-2,-2,-3,-4,-6
"1405",2020-03-10,"Hybrid","w1920","Tue","weekday","sled",0,"1","1","2",11.2,0.1,44,2,31,25.5,-1,-1,-1,-1,1,0,-1,-2
"1406",2020-03-10,"Mechanized","w1920","Tue","weekday","no_sled",3,"1","1","2",11.2,0.1,44,2,31,25.5,-1,-1,-1,-1,1,0,-1,-2
"1407",2020-03-10,"Motorized","w1920","Tue","weekday","sled",113,"1","1","2",11.2,0.1,44,2,31,25.5,-1,-1,-1,-1,1,0,-1,-2
"1408",2020-03-10,"Non.motorized","w1920","Tue","weekday","no_sled",77,"1","1","2",11.2,0.1,44,2,31,25.5,-1,-1,-1,-1,1,0,-1,-2
"1409",2020-03-11,"Hybrid","w1920","Wed","weekday","sled",1,"2","2","1",11.2,0,44,0,32,25.5,2,-1,-1,-1,2,1,0,-1
"1410",2020-03-11,"Mechanized","w1920","Wed","weekday","no_sled",1,"2","2","1",11.2,0,44,0,32,25.5,2,-1,-1,-1,2,1,0,-1
"1411",2020-03-11,"Motorized","w1920","Wed","weekday","sled",141,"2","2","1",11.2,0,44,0,32,25.5,2,-1,-1,-1,2,1,0,-1
"1412",2020-03-11,"Non.motorized","w1920","Wed","weekday","no_sled",92,"2","2","1",11.2,0,44,0,32,25.5,2,-1,-1,-1,2,1,0,-1
"1413",2020-03-12,"Hybrid","w1920","Thu","weekday","sled",0,"2","2","2",11.4,0.2,42,-2,35,27.1,0,2,-1,-1,-2,0,-1,-2
"1414",2020-03-12,"Mechanized","w1920","Thu","weekday","no_sled",1,"2","2","2",11.4,0.2,42,-2,35,27.1,0,2,-1,-1,-2,0,-1,-2
"1415",2020-03-12,"Motorized","w1920","Thu","weekday","sled",130,"2","2","2",11.4,0.2,42,-2,35,27.1,0,2,-1,-1,-2,0,-1,-2
"1416",2020-03-12,"Non.motorized","w1920","Thu","weekday","no_sled",93,"2","2","2",11.4,0.2,42,-2,35,27.1,0,2,-1,-1,-2,0,-1,-2
"1417",2020-03-13,"Hybrid","w1920","Fri","weekday","sled",0,"3","3","2",11.5,0.1,44,2,31,26.1,-2,0,2,-1,0,0,2,1
"1418",2020-03-13,"Mechanized","w1920","Fri","weekday","no_sled",2,"3","3","2",11.5,0.1,44,2,31,26.1,-2,0,2,-1,0,0,2,1
"1419",2020-03-13,"Motorized","w1920","Fri","weekday","sled",78,"3","3","2",11.5,0.1,44,2,31,26.1,-2,0,2,-1,0,0,2,1
"1420",2020-03-13,"Non.motorized","w1920","Fri","weekday","no_sled",70,"3","3","2",11.5,0.1,44,2,31,26.1,-2,0,2,-1,0,0,2,1
"1421",2020-03-14,"Hybrid","w1920","Sat","weekend","sled",1,"3","3","3",11.7,0.2,44,0,31,26.6,2,-2,0,2,2,0,0,2
"1422",2020-03-14,"Mechanized","w1920","Sat","weekend","no_sled",6,"3","3","3",11.7,0.2,44,0,31,26.6,2,-2,0,2,2,0,0,2
"1423",2020-03-14,"Motorized","w1920","Sat","weekend","sled",47,"3","3","3",11.7,0.2,44,0,31,26.6,2,-2,0,2,2,0,0,2
"1424",2020-03-14,"Non.motorized","w1920","Sat","weekend","no_sled",198,"3","3","3",11.7,0.2,44,0,31,26.6,2,-2,0,2,2,0,0,2
"1425",2020-03-15,"Hybrid","w1920","Sun","weekend","sled",0,"2","2","2",11.7,0,45,1,33,26,0,2,-2,0,1,3,1,1
"1426",2020-03-15,"Mechanized","w1920","Sun","weekend","no_sled",8,"2","2","2",11.7,0,45,1,33,26,0,2,-2,0,1,3,1,1
"1427",2020-03-15,"Motorized","w1920","Sun","weekend","sled",114,"2","2","2",11.7,0,45,1,33,26,0,2,-2,0,1,3,1,1
"1428",2020-03-15,"Non.motorized","w1920","Sun","weekend","no_sled",342,"2","2","2",11.7,0,45,1,33,26,0,2,-2,0,1,3,1,1
"1429",2020-03-16,"Hybrid","w1920","Mon","weekday","sled",0,"2","2","2",11.7,0,45,0,35,26,1,0,2,-2,1,1,3,1
"1430",2020-03-16,"Mechanized","w1920","Mon","weekday","no_sled",4,"2","2","2",11.7,0,45,0,35,26,1,0,2,-2,1,1,3,1
"1431",2020-03-16,"Motorized","w1920","Mon","weekday","sled",208,"2","2","2",11.7,0,45,0,35,26,1,0,2,-2,1,1,3,1
"1432",2020-03-16,"Non.motorized","w1920","Mon","weekday","no_sled",208,"2","2","2",11.7,0,45,0,35,26,1,0,2,-2,1,1,3,1
"1433",2020-03-17,"Hybrid","w1920","Tue","weekday","sled",2,"2","2","2",11.7,0,44,-1,36,26.6,0,1,0,2,-1,0,0,2
"1434",2020-03-17,"Mechanized","w1920","Tue","weekday","no_sled",6,"2","2","2",11.7,0,44,-1,36,26.6,0,1,0,2,-1,0,0,2
"1435",2020-03-17,"Motorized","w1920","Tue","weekday","sled",185,"2","2","2",11.7,0,44,-1,36,26.6,0,1,0,2,-1,0,0,2
"1436",2020-03-17,"Non.motorized","w1920","Tue","weekday","no_sled",82,"2","2","2",11.7,0,44,-1,36,26.6,0,1,0,2,-1,0,0,2
"1437",2020-03-18,"Hybrid","w1920","Wed","weekday","sled",0,"2","2","2",11.7,0,43,-1,33,27.2,-1,0,1,0,-2,-2,-1,-1
"1438",2020-03-18,"Mechanized","w1920","Wed","weekday","no_sled",2,"2","2","2",11.7,0,43,-1,33,27.2,-1,0,1,0,-2,-2,-1,-1
"1439",2020-03-18,"Motorized","w1920","Wed","weekday","sled",66,"2","2","2",11.7,0,43,-1,33,27.2,-1,0,1,0,-2,-2,-1,-1
"1440",2020-03-18,"Non.motorized","w1920","Wed","weekday","no_sled",66,"2","2","2",11.7,0,43,-1,33,27.2,-1,0,1,0,-2,-2,-1,-1
"1441",2020-03-19,"Hybrid","w1920","Thu","weekday","sled",0,"3","3","3",11.8,0.1,43,0,27,27.4,-1,-1,0,1,-1,-2,-2,-1
"1442",2020-03-19,"Mechanized","w1920","Thu","weekday","no_sled",1,"3","3","3",11.8,0.1,43,0,27,27.4,-1,-1,0,1,-1,-2,-2,-1
"1443",2020-03-19,"Motorized","w1920","Thu","weekday","sled",58,"3","3","3",11.8,0.1,43,0,27,27.4,-1,-1,0,1,-1,-2,-2,-1
"1444",2020-03-19,"Non.motorized","w1920","Thu","weekday","no_sled",75,"3","3","3",11.8,0.1,43,0,27,27.4,-1,-1,0,1,-1,-2,-2,-1
"1445",2020-03-20,"Hybrid","w1920","Fri","weekday","sled",2,"3","3","2",12.7,0.9,52,9,26,24.4,0,-1,-1,0,9,8,7,7
"1446",2020-03-20,"Mechanized","w1920","Fri","weekday","no_sled",3,"3","3","2",12.7,0.9,52,9,26,24.4,0,-1,-1,0,9,8,7,7
"1447",2020-03-20,"Motorized","w1920","Fri","weekday","sled",69,"3","3","2",12.7,0.9,52,9,26,24.4,0,-1,-1,0,9,8,7,7
"1448",2020-03-20,"Non.motorized","w1920","Fri","weekday","no_sled",142,"3","3","2",12.7,0.9,52,9,26,24.4,0,-1,-1,0,9,8,7,7
"1449",2020-03-21,"Hybrid","w1920","Sat","weekend","sled",0,"3","3","2",12.8,0.1,54,2,26,23.7,9,0,-1,-1,11,11,10,9
"1450",2020-03-21,"Mechanized","w1920","Sat","weekend","no_sled",5,"3","3","2",12.8,0.1,54,2,26,23.7,9,0,-1,-1,11,11,10,9
"1451",2020-03-21,"Motorized","w1920","Sat","weekend","sled",68,"3","3","2",12.8,0.1,54,2,26,23.7,9,0,-1,-1,11,11,10,9
"1452",2020-03-21,"Non.motorized","w1920","Sat","weekend","no_sled",158,"3","3","2",12.8,0.1,54,2,26,23.7,9,0,-1,-1,11,11,10,9
"1453",2020-03-22,"Hybrid","w1920","Sun","weekend","sled",0,"2","2","2",13,0.2,53,-1,28,24.5,2,9,0,-1,1,10,10,9
"1454",2020-03-22,"Mechanized","w1920","Sun","weekend","no_sled",4,"2","2","2",13,0.2,53,-1,28,24.5,2,9,0,-1,1,10,10,9
"1455",2020-03-22,"Motorized","w1920","Sun","weekend","sled",63,"2","2","2",13,0.2,53,-1,28,24.5,2,9,0,-1,1,10,10,9
"1456",2020-03-22,"Non.motorized","w1920","Sun","weekend","no_sled",108,"2","2","2",13,0.2,53,-1,28,24.5,2,9,0,-1,1,10,10,9
"1457",2020-03-23,"Hybrid","w1920","Mon","weekday","sled",1,"2","2","2",13,0,53,0,28,24.5,-1,2,9,0,-1,1,10,10
"1458",2020-03-23,"Mechanized","w1920","Mon","weekday","no_sled",5,"2","2","2",13,0,53,0,28,24.5,-1,2,9,0,-1,1,10,10
"1459",2020-03-23,"Motorized","w1920","Mon","weekday","sled",54,"2","2","2",13,0,53,0,28,24.5,-1,2,9,0,-1,1,10,10
"1460",2020-03-23,"Non.motorized","w1920","Mon","weekday","no_sled",109,"2","2","2",13,0,53,0,28,24.5,-1,2,9,0,-1,1,10,10
"1461",2020-03-24,"Hybrid","w1920","Tue","weekday","sled",1,"2","2","2",13.2,0.2,53,0,32,24.9,0,-1,2,9,0,-1,1,10
"1462",2020-03-24,"Mechanized","w1920","Tue","weekday","no_sled",6,"2","2","2",13.2,0.2,53,0,32,24.9,0,-1,2,9,0,-1,1,10
"1463",2020-03-24,"Motorized","w1920","Tue","weekday","sled",74,"2","2","2",13.2,0.2,53,0,32,24.9,0,-1,2,9,0,-1,1,10
"1464",2020-03-24,"Non.motorized","w1920","Tue","weekday","no_sled",110,"2","2","2",13.2,0.2,53,0,32,24.9,0,-1,2,9,0,-1,1,10
"1465",2020-03-25,"Hybrid","w1920","Wed","weekday","sled",0,"2","2","2",13.3,0.1,51,-2,34,26.1,0,0,-1,2,-2,-2,-3,-1
"1466",2020-03-25,"Mechanized","w1920","Wed","weekday","no_sled",5,"2","2","2",13.3,0.1,51,-2,34,26.1,0,0,-1,2,-2,-2,-3,-1
"1467",2020-03-25,"Motorized","w1920","Wed","weekday","sled",81,"2","2","2",13.3,0.1,51,-2,34,26.1,0,0,-1,2,-2,-2,-3,-1
"1468",2020-03-25,"Non.motorized","w1920","Wed","weekday","no_sled",65,"2","2","2",13.3,0.1,51,-2,34,26.1,0,0,-1,2,-2,-2,-3,-1
"1469",2020-03-26,"Hybrid","w1920","Thu","weekday","sled",0,"2","2","2",13.3,0,50,-1,36,26.6,-2,0,0,-1,-3,-3,-3,-4
"1470",2020-03-26,"Hybrid","w1920","Thu","weekday","sled",0,"3","3","2",13.3,0,50,-1,36,26.6,-2,0,0,-1,-3,-3,-3,-4
"1471",2020-03-26,"Mechanized","w1920","Thu","weekday","no_sled",1,"2","2","2",13.3,0,50,-1,36,26.6,-2,0,0,-1,-3,-3,-3,-4
"1472",2020-03-26,"Mechanized","w1920","Thu","weekday","no_sled",1,"3","3","2",13.3,0,50,-1,36,26.6,-2,0,0,-1,-3,-3,-3,-4
"1473",2020-03-26,"Motorized","w1920","Thu","weekday","sled",107,"2","2","2",13.3,0,50,-1,36,26.6,-2,0,0,-1,-3,-3,-3,-4
"1474",2020-03-26,"Motorized","w1920","Thu","weekday","sled",107,"3","3","2",13.3,0,50,-1,36,26.6,-2,0,0,-1,-3,-3,-3,-4
"1475",2020-03-26,"Non.motorized","w1920","Thu","weekday","no_sled",82,"2","2","2",13.3,0,50,-1,36,26.6,-2,0,0,-1,-3,-3,-3,-4
"1476",2020-03-26,"Non.motorized","w1920","Thu","weekday","no_sled",82,"3","3","2",13.3,0,50,-1,36,26.6,-2,0,0,-1,-3,-3,-3,-4
"1477",2020-03-27,"Hybrid","w1920","Fri","weekday","sled",0,"3","3","2",13.3,0,50,0,23,26.6,-1,-2,0,0,-1,-3,-3,-3
"1478",2020-03-27,"Mechanized","w1920","Fri","weekday","no_sled",0,"3","3","2",13.3,0,50,0,23,26.6,-1,-2,0,0,-1,-3,-3,-3
"1479",2020-03-27,"Motorized","w1920","Fri","weekday","sled",57,"3","3","2",13.3,0,50,0,23,26.6,-1,-2,0,0,-1,-3,-3,-3
"1480",2020-03-27,"Non.motorized","w1920","Fri","weekday","no_sled",61,"3","3","2",13.3,0,50,0,23,26.6,-1,-2,0,0,-1,-3,-3,-3
"1481",2020-03-28,"Hybrid","w1920","Sat","weekend","sled",1,"3","3","3",13.3,0,50,0,18,26.6,0,-1,-2,0,0,-1,-3,-3
"1482",2020-03-28,"Mechanized","w1920","Sat","weekend","no_sled",4,"3","3","3",13.3,0,50,0,18,26.6,0,-1,-2,0,0,-1,-3,-3
"1483",2020-03-28,"Motorized","w1920","Sat","weekend","sled",56,"3","3","3",13.3,0,50,0,18,26.6,0,-1,-2,0,0,-1,-3,-3
"1484",2020-03-28,"Non.motorized","w1920","Sat","weekend","no_sled",90,"3","3","3",13.3,0,50,0,18,26.6,0,-1,-2,0,0,-1,-3,-3
"1485",2020-03-29,"Hybrid","w1920","Sun","weekend","sled",0,"2","2","2",13.3,0,49,-1,24,27.1,0,0,-1,-2,-1,-1,-2,-4
"1486",2020-03-29,"Mechanized","w1920","Sun","weekend","no_sled",1,"2","2","2",13.3,0,49,-1,24,27.1,0,0,-1,-2,-1,-1,-2,-4
"1487",2020-03-29,"Motorized","w1920","Sun","weekend","sled",31,"2","2","2",13.3,0,49,-1,24,27.1,0,0,-1,-2,-1,-1,-2,-4
"1488",2020-03-29,"Non.motorized","w1920","Sun","weekend","no_sled",83,"2","2","2",13.3,0,49,-1,24,27.1,0,0,-1,-2,-1,-1,-2,-4
"1489",2020-03-30,"Hybrid","w1920","Mon","weekday","sled",1,"2","2","2",13.4,0.1,49,0,29,27.3,-1,0,0,-1,-1,-1,-1,-2
"1490",2020-03-30,"Mechanized","w1920","Mon","weekday","no_sled",3,"2","2","2",13.4,0.1,49,0,29,27.3,-1,0,0,-1,-1,-1,-1,-2
"1491",2020-03-30,"Motorized","w1920","Mon","weekday","sled",64,"2","2","2",13.4,0.1,49,0,29,27.3,-1,0,0,-1,-1,-1,-1,-2
"1492",2020-03-30,"Non.motorized","w1920","Mon","weekday","no_sled",71,"2","2","2",13.4,0.1,49,0,29,27.3,-1,0,0,-1,-1,-1,-1,-2
"1493",2020-03-31,"Hybrid","w1920","Tue","weekday","sled",1,"2","2","2",13.6,0.2,51,2,35,26.7,0,-1,0,0,2,1,1,1
"1494",2020-03-31,"Mechanized","w1920","Tue","weekday","no_sled",1,"2","2","2",13.6,0.2,51,2,35,26.7,0,-1,0,0,2,1,1,1
"1495",2020-03-31,"Motorized","w1920","Tue","weekday","sled",41,"2","2","2",13.6,0.2,51,2,35,26.7,0,-1,0,0,2,1,1,1
"1496",2020-03-31,"Non.motorized","w1920","Tue","weekday","no_sled",52,"2","2","2",13.6,0.2,51,2,35,26.7,0,-1,0,0,2,1,1,1
"1497",2020-04-01,"Hybrid","w1920","Wed","weekday","sled",0,"2","2","2",13.6,0,47,-4,39,28.9,2,0,-1,0,-2,-2,-3,-3
"1498",2020-04-01,"Mechanized","w1920","Wed","weekday","no_sled",1,"2","2","2",13.6,0,47,-4,39,28.9,2,0,-1,0,-2,-2,-3,-3
"1499",2020-04-01,"Motorized","w1920","Wed","weekday","sled",40,"2","2","2",13.6,0,47,-4,39,28.9,2,0,-1,0,-2,-2,-3,-3
"1500",2020-04-01,"Non.motorized","w1920","Wed","weekday","no_sled",34,"2","2","2",13.6,0,47,-4,39,28.9,2,0,-1,0,-2,-2,-3,-3
"1501",2020-04-02,"Hybrid","w1920","Thu","weekday","sled",1,"2","2","2",13.6,0,46,-1,31,29.6,-4,2,0,-1,-5,-3,-3,-4
"1502",2020-04-02,"Mechanized","w1920","Thu","weekday","no_sled",1,"2","2","2",13.6,0,46,-1,31,29.6,-4,2,0,-1,-5,-3,-3,-4
"1503",2020-04-02,"Motorized","w1920","Thu","weekday","sled",43,"2","2","2",13.6,0,46,-1,31,29.6,-4,2,0,-1,-5,-3,-3,-4
"1504",2020-04-02,"Non.motorized","w1920","Thu","weekday","no_sled",65,"2","2","2",13.6,0,46,-1,31,29.6,-4,2,0,-1,-5,-3,-3,-4
"1505",2020-04-03,"Hybrid","w1920","Fri","weekday","sled",0,"2","2","2",13.6,0,46,0,28,29.6,-1,-4,2,0,-1,-5,-3,-3
"1506",2020-04-03,"Mechanized","w1920","Fri","weekday","no_sled",0,"2","2","2",13.6,0,46,0,28,29.6,-1,-4,2,0,-1,-5,-3,-3
"1507",2020-04-03,"Motorized","w1920","Fri","weekday","sled",18,"2","2","2",13.6,0,46,0,28,29.6,-1,-4,2,0,-1,-5,-3,-3
"1508",2020-04-03,"Non.motorized","w1920","Fri","weekday","no_sled",50,"2","2","2",13.6,0,46,0,28,29.6,-1,-4,2,0,-1,-5,-3,-3
"1509",2020-04-04,"Hybrid","w1920","Sat","weekend","sled",1,"2","2","2",13.6,0,45,-1,33,30.2,0,-1,-4,2,-1,-2,-6,-4
"1510",2020-04-04,"Mechanized","w1920","Sat","weekend","no_sled",0,"2","2","2",13.6,0,45,-1,33,30.2,0,-1,-4,2,-1,-2,-6,-4
"1511",2020-04-04,"Motorized","w1920","Sat","weekend","sled",31,"2","2","2",13.6,0,45,-1,33,30.2,0,-1,-4,2,-1,-2,-6,-4
"1512",2020-04-04,"Non.motorized","w1920","Sat","weekend","no_sled",59,"2","2","2",13.6,0,45,-1,33,30.2,0,-1,-4,2,-1,-2,-6,-4
"1513",2020-04-05,"Hybrid","w1920","Sun","weekend","sled",0,"2","2","3",13.6,0,45,0,38,30.2,-1,0,-1,-4,-1,-1,-2,-6
"1514",2020-04-05,"Mechanized","w1920","Sun","weekend","no_sled",2,"2","2","3",13.6,0,45,0,38,30.2,-1,0,-1,-4,-1,-1,-2,-6
"1515",2020-04-05,"Motorized","w1920","Sun","weekend","sled",28,"2","2","3",13.6,0,45,0,38,30.2,-1,0,-1,-4,-1,-1,-2,-6
"1516",2020-04-05,"Non.motorized","w1920","Sun","weekend","no_sled",68,"2","2","3",13.6,0,45,0,38,30.2,-1,0,-1,-4,-1,-1,-2,-6
"1517",2020-04-06,"Hybrid","w1920","Mon","weekday","sled",0,"2","2","3",13.6,0,44,-1,40,30.9,0,-1,0,-1,-1,-2,-2,-3
"1518",2020-04-06,"Mechanized","w1920","Mon","weekday","no_sled",3,"2","2","3",13.6,0,44,-1,40,30.9,0,-1,0,-1,-1,-2,-2,-3
"1519",2020-04-06,"Motorized","w1920","Mon","weekday","sled",22,"2","2","3",13.6,0,44,-1,40,30.9,0,-1,0,-1,-1,-2,-2,-3
"1520",2020-04-06,"Non.motorized","w1920","Mon","weekday","no_sled",75,"2","2","3",13.6,0,44,-1,40,30.9,0,-1,0,-1,-1,-2,-2,-3
"1521",2020-04-07,"Hybrid","w1920","Tue","weekday","sled",1,"2","2","3",13.4,-0.2,43,-1,39,31.2,-1,0,-1,0,-2,-2,-3,-3
"1522",2020-04-07,"Mechanized","w1920","Tue","weekday","no_sled",2,"2","2","3",13.4,-0.2,43,-1,39,31.2,-1,0,-1,0,-2,-2,-3,-3
"1523",2020-04-07,"Motorized","w1920","Tue","weekday","sled",22,"2","2","3",13.4,-0.2,43,-1,39,31.2,-1,0,-1,0,-2,-2,-3,-3
"1524",2020-04-07,"Non.motorized","w1920","Tue","weekday","no_sled",62,"2","2","3",13.4,-0.2,43,-1,39,31.2,-1,0,-1,0,-2,-2,-3,-3
"1525",2020-04-08,"Hybrid","w1920","Wed","weekday","sled",0,"2","3","3",13.3,-0.1,42,-1,40,31.7,-1,-1,0,-1,-2,-3,-3,-4
"1526",2020-04-08,"Mechanized","w1920","Wed","weekday","no_sled",1,"2","3","3",13.3,-0.1,42,-1,40,31.7,-1,-1,0,-1,-2,-3,-3,-4
"1527",2020-04-08,"Motorized","w1920","Wed","weekday","sled",36,"2","3","3",13.3,-0.1,42,-1,40,31.7,-1,-1,0,-1,-2,-3,-3,-4
"1528",2020-04-08,"Non.motorized","w1920","Wed","weekday","no_sled",39,"2","3","3",13.3,-0.1,42,-1,40,31.7,-1,-1,0,-1,-2,-3,-3,-4
"1529",2020-04-09,"Hybrid","w1920","Thu","weekday","sled",1,"2","3","3",13.1,-0.2,40,-2,42,32.8,-1,-1,-1,0,-3,-4,-5,-5
"1530",2020-04-09,"Mechanized","w1920","Thu","weekday","no_sled",2,"2","3","3",13.1,-0.2,40,-2,42,32.8,-1,-1,-1,0,-3,-4,-5,-5
"1531",2020-04-09,"Motorized","w1920","Thu","weekday","sled",23,"2","3","3",13.1,-0.2,40,-2,42,32.8,-1,-1,-1,0,-3,-4,-5,-5
"1532",2020-04-09,"Non.motorized","w1920","Thu","weekday","no_sled",27,"2","3","3",13.1,-0.2,40,-2,42,32.8,-1,-1,-1,0,-3,-4,-5,-5
"1533",2020-04-10,"Hybrid","w1920","Fri","weekday","sled",0,"3","3","3",12.9,-0.2,39,-1,38,33.1,-2,-1,-1,-1,-3,-4,-5,-6
"1534",2020-04-10,"Mechanized","w1920","Fri","weekday","no_sled",1,"3","3","3",12.9,-0.2,39,-1,38,33.1,-2,-1,-1,-1,-3,-4,-5,-6
"1535",2020-04-10,"Motorized","w1920","Fri","weekday","sled",15,"3","3","3",12.9,-0.2,39,-1,38,33.1,-2,-1,-1,-1,-3,-4,-5,-6
"1536",2020-04-10,"Non.motorized","w1920","Fri","weekday","no_sled",26,"3","3","3",12.9,-0.2,39,-1,38,33.1,-2,-1,-1,-1,-3,-4,-5,-6
"1537",2020-04-11,"Hybrid","w1920","Sat","weekend","sled",0,"2","3","3",12.9,0,39,0,36,33.1,-1,-2,-1,-1,-1,-3,-4,-5
"1538",2020-04-11,"Mechanized","w1920","Sat","weekend","no_sled",2,"2","3","3",12.9,0,39,0,36,33.1,-1,-2,-1,-1,-1,-3,-4,-5
"1539",2020-04-11,"Motorized","w1920","Sat","weekend","sled",55,"2","3","3",12.9,0,39,0,36,33.1,-1,-2,-1,-1,-1,-3,-4,-5
"1540",2020-04-11,"Non.motorized","w1920","Sat","weekend","no_sled",34,"2","3","3",12.9,0,39,0,36,33.1,-1,-2,-1,-1,-1,-3,-4,-5
"1541",2020-04-12,"Hybrid","w1920","Sun","weekend","sled",0,"2","2","2",12.8,-0.1,38,-1,29,33.7,0,-1,-2,-1,-1,-2,-4,-5
"1542",2020-04-12,"Mechanized","w1920","Sun","weekend","no_sled",1,"2","2","2",12.8,-0.1,38,-1,29,33.7,0,-1,-2,-1,-1,-2,-4,-5
"1543",2020-04-12,"Motorized","w1920","Sun","weekend","sled",34,"2","2","2",12.8,-0.1,38,-1,29,33.7,0,-1,-2,-1,-1,-2,-4,-5
"1544",2020-04-12,"Non.motorized","w1920","Sun","weekend","no_sled",35,"2","2","2",12.8,-0.1,38,-1,29,33.7,0,-1,-2,-1,-1,-2,-4,-5
"1545",2020-04-13,"Hybrid","w1920","Mon","weekday","sled",0,NA,NA,NA,12.9,0.1,39,1,20,33.1,-1,0,-1,-2,0,0,-1,-3
"1546",2020-04-13,"Mechanized","w1920","Mon","weekday","no_sled",0,NA,NA,NA,12.9,0.1,39,1,20,33.1,-1,0,-1,-2,0,0,-1,-3
"1547",2020-04-13,"Motorized","w1920","Mon","weekday","sled",33,NA,NA,NA,12.9,0.1,39,1,20,33.1,-1,0,-1,-2,0,0,-1,-3
"1548",2020-04-13,"Non.motorized","w1920","Mon","weekday","no_sled",17,NA,NA,NA,12.9,0.1,39,1,20,33.1,-1,0,-1,-2,0,0,-1,-3
"1549",2020-04-14,"Hybrid","w1920","Tue","weekday","sled",0,"2","2","2",13,0.1,39,0,18,33.3,1,-1,0,-1,1,0,0,-1
"1550",2020-04-14,"Mechanized","w1920","Tue","weekday","no_sled",0,"2","2","2",13,0.1,39,0,18,33.3,1,-1,0,-1,1,0,0,-1
"1551",2020-04-14,"Motorized","w1920","Tue","weekday","sled",34,"2","2","2",13,0.1,39,0,18,33.3,1,-1,0,-1,1,0,0,-1
"1552",2020-04-14,"Non.motorized","w1920","Tue","weekday","no_sled",20,"2","2","2",13,0.1,39,0,18,33.3,1,-1,0,-1,1,0,0,-1
"1553",2020-04-15,"Hybrid","w1920","Wed","weekday","sled",0,NA,NA,NA,13.2,0.2,39,0,28,33.8,0,1,-1,0,0,1,0,0
"1554",2020-04-15,"Mechanized","w1920","Wed","weekday","no_sled",0,NA,NA,NA,13.2,0.2,39,0,28,33.8,0,1,-1,0,0,1,0,0
"1555",2020-04-15,"Motorized","w1920","Wed","weekday","sled",28,NA,NA,NA,13.2,0.2,39,0,28,33.8,0,1,-1,0,0,1,0,0
"1556",2020-04-15,"Non.motorized","w1920","Wed","weekday","no_sled",25,NA,NA,NA,13.2,0.2,39,0,28,33.8,0,1,-1,0,0,1,0,0
