"","date","year","week","weekend","has_sled","user.count","rating_above","rating_near","rating_below","swe","change_swe","snow_depth","change_depth","air_temp","snow_density","lag1snow","lag2snow","lag3snow","lag4snow","past2snow","past3snow","past4snow","past5snow"
"1",2017-12-22,"w1718","Fri","weekday","no_sled",30,"2","2","1",2,0,11,3,17,18.2,0,0,0,0,3,3,3,3
"2",2017-12-22,"w1718","Fri","weekday","sled",1,"2","2","1",2,0,11,3,17,18.2,0,0,0,0,3,3,3,3
"3",2017-12-23,"w1718","Sat","weekend","no_sled",18,"2","1","1",2.1,0.1,10,-1,21,21,3,0,0,0,2,2,2,2
"4",2017-12-23,"w1718","Sat","weekend","sled",4,"2","1","1",2.1,0.1,10,-1,21,21,3,0,0,0,2,2,2,2
"5",2017-12-24,"w1718","Sun","weekend","no_sled",56,"1","1","1",2.4,0.3,14,4,19,17.1,-1,3,0,0,3,6,6,6
"6",2017-12-24,"w1718","Sun","weekend","sled",18,"1","1","1",2.4,0.3,14,4,19,17.1,-1,3,0,0,3,6,6,6
"7",2017-12-25,"w1718","Mon","weekday","no_sled",133,"2","1","1",2.6,0.2,14,0,25,18.6,4,-1,3,0,4,3,6,6
"8",2017-12-25,"w1718","Mon","weekday","sled",13,"2","1","1",2.6,0.2,14,0,25,18.6,4,-1,3,0,4,3,6,6
"9",2017-12-26,"w1718","Tue","weekday","no_sled",191,"1","1","1",3.1,0.5,20,6,25,15.5,0,4,-1,3,6,10,9,12
"10",2017-12-26,"w1718","Tue","weekday","sled",25,"1","1","1",3.1,0.5,20,6,25,15.5,0,4,-1,3,6,10,9,12
"11",2017-12-27,"w1718","Wed","weekday","no_sled",260,"1","1","1",3.1,0,18,-2,27,17.2,6,0,4,-1,4,4,8,7
"12",2017-12-27,"w1718","Wed","weekday","sled",186,"1","1","1",3.1,0,18,-2,27,17.2,6,0,4,-1,4,4,8,7
"13",2017-12-28,"w1718","Thu","weekday","no_sled",276,"1","1","1",3.2,0.1,17,-1,31,18.8,-2,6,0,4,-3,3,3,7
"14",2017-12-28,"w1718","Thu","weekday","sled",11,"1","1","1",3.2,0.1,17,-1,31,18.8,-2,6,0,4,-3,3,3,7
"15",2017-12-29,"w1718","Fri","weekday","no_sled",236,"1","1","1",3.2,0,17,0,36,18.8,-1,-2,6,0,-1,-3,3,3
"16",2017-12-29,"w1718","Fri","weekday","sled",26,"1","1","1",3.2,0,17,0,36,18.8,-1,-2,6,0,-1,-3,3,3
"17",2017-12-30,"w1718","Sat","weekend","no_sled",386,"1","1","1",3.2,0,15,-2,37,21.3,0,-1,-2,6,-2,-3,-5,1
"18",2017-12-30,"w1718","Sat","weekend","sled",26,"1","1","1",3.2,0,15,-2,37,21.3,0,-1,-2,6,-2,-3,-5,1
"19",2017-12-31,"w1718","Sun","weekend","no_sled",335,"1","1","1",3.2,0,15,0,31,21.3,-2,0,-1,-2,-2,-2,-3,-5
"20",2017-12-31,"w1718","Sun","weekend","sled",36,"1","1","1",3.2,0,15,0,31,21.3,-2,0,-1,-2,-2,-2,-3,-5
"21",2018-01-01,"w1718","Mon","weekday","no_sled",285,"1","1","1",3.2,0,15,0,27,21.3,0,-2,0,-1,0,-2,-2,-3
"22",2018-01-01,"w1718","Mon","weekday","sled",60,"1","1","1",3.2,0,15,0,27,21.3,0,-2,0,-1,0,-2,-2,-3
"23",2018-01-02,"w1718","Tue","weekday","no_sled",81,"1","1","1",3.2,0,15,0,22,21.3,0,0,-2,0,0,0,-2,-2
"24",2018-01-02,"w1718","Tue","weekday","sled",29,"1","1","1",3.2,0,15,0,22,21.3,0,0,-2,0,0,0,-2,-2
"25",2018-01-03,"w1718","Wed","weekday","no_sled",54,"1","1","1",3.2,0,15,0,27,21.3,0,0,0,-2,0,0,0,-2
"26",2018-01-03,"w1718","Wed","weekday","sled",18,"1","1","1",3.2,0,15,0,27,21.3,0,0,0,-2,0,0,0,-2
"27",2018-01-04,"w1718","Thu","weekday","no_sled",39,"1","1","1",3.2,0,15,0,29,21.3,0,0,0,0,0,0,0,0
"28",2018-01-04,"w1718","Thu","weekday","sled",21,"1","1","1",3.2,0,15,0,29,21.3,0,0,0,0,0,0,0,0
"29",2018-01-05,"w1718","Fri","weekday","no_sled",42,"1","1","1",3.2,0,14,-1,32,22.9,0,0,0,0,-1,-1,-1,-1
"30",2018-01-05,"w1718","Fri","weekday","sled",20,"1","1","1",3.2,0,14,-1,32,22.9,0,0,0,0,-1,-1,-1,-1
"31",2018-01-06,"w1718","Sat","weekend","no_sled",43,"1","1","1",3.2,0,14,0,30,22.9,-1,0,0,0,-1,-1,-1,-1
"32",2018-01-06,"w1718","Sat","weekend","sled",30,"1","1","1",3.2,0,14,0,30,22.9,-1,0,0,0,-1,-1,-1,-1
"33",2018-01-07,"w1718","Sun","weekend","no_sled",76,"2","2","2",3.5,0.3,18,4,25,19.4,0,-1,0,0,4,3,3,3
"34",2018-01-07,"w1718","Sun","weekend","sled",10,"2","2","2",3.5,0.3,18,4,25,19.4,0,-1,0,0,4,3,3,3
"35",2018-01-08,"w1718","Mon","weekday","no_sled",52,"2","2","1",3.7,0.2,20,2,29,18.5,4,0,-1,0,6,6,5,5
"36",2018-01-08,"w1718","Mon","weekday","sled",8,"2","2","1",3.7,0.2,20,2,29,18.5,4,0,-1,0,6,6,5,5
"37",2018-01-09,"w1718","Tue","weekday","no_sled",65,"2","2","1",3.8,0.1,21,1,34,18.1,2,4,0,-1,3,7,7,6
"38",2018-01-09,"w1718","Tue","weekday","sled",5,"2","2","1",3.8,0.1,21,1,34,18.1,2,4,0,-1,3,7,7,6
"39",2018-01-10,"w1718","Wed","weekday","no_sled",94,"3","3","3",4,0.2,21,0,28,19,1,2,4,0,1,3,7,7
"40",2018-01-10,"w1718","Wed","weekday","sled",0,"3","3","3",4,0.2,21,0,28,19,1,2,4,0,1,3,7,7
"41",2018-01-11,"w1718","Thu","weekday","no_sled",77,"3","3","3",4.1,0.1,26,5,17,15.8,0,1,2,4,5,6,8,12
"42",2018-01-11,"w1718","Thu","weekday","sled",17,"3","3","3",4.1,0.1,26,5,17,15.8,0,1,2,4,5,6,8,12
"43",2018-01-12,"w1718","Fri","weekday","no_sled",46,"3","3","3",4.3,0.2,24,-2,22,17.9,5,0,1,2,3,3,4,6
"44",2018-01-12,"w1718","Fri","weekday","sled",7,"3","3","3",4.3,0.2,24,-2,22,17.9,5,0,1,2,3,3,4,6
"45",2018-01-13,"w1718","Sat","weekend","no_sled",205,"3","3","3",4.4,0.1,24,0,24,18.3,-2,5,0,1,-2,3,3,4
"46",2018-01-13,"w1718","Sat","weekend","sled",44,"3","3","3",4.4,0.1,24,0,24,18.3,-2,5,0,1,-2,3,3,4
"47",2018-01-14,"w1718","Sun","weekend","no_sled",272,"3","3","2",4.4,0,24,0,27,18.3,0,-2,5,0,0,-2,3,3
"48",2018-01-14,"w1718","Sun","weekend","sled",61,"3","3","2",4.4,0,24,0,27,18.3,0,-2,5,0,0,-2,3,3
"49",2018-01-15,"w1718","Mon","weekday","no_sled",168,"3","3","2",4.4,0,23,-1,27,19.1,0,0,-2,5,-1,-1,-3,2
"50",2018-01-15,"w1718","Mon","weekday","sled",23,"3","3","2",4.4,0,23,-1,27,19.1,0,0,-2,5,-1,-1,-3,2
"51",2018-01-16,"w1718","Tue","weekday","no_sled",71,"3","3","2",4.4,0,22,-1,20,20,-1,0,0,-2,-2,-2,-2,-4
"52",2018-01-16,"w1718","Tue","weekday","sled",28,"3","3","2",4.4,0,22,-1,20,20,-1,0,0,-2,-2,-2,-2,-4
"53",2018-01-17,"w1718","Wed","weekday","no_sled",101,"2","2","2",4.4,0,22,0,24,20,-1,-1,0,0,-1,-2,-2,-2
"54",2018-01-17,"w1718","Wed","weekday","sled",14,"2","2","2",4.4,0,22,0,24,20,-1,-1,0,0,-1,-2,-2,-2
"55",2018-01-18,"w1718","Thu","weekday","no_sled",129,"2","2","2",4.4,0,21,-1,29,21,0,-1,-1,0,-1,-2,-3,-3
"56",2018-01-18,"w1718","Thu","weekday","sled",4,"2","2","2",4.4,0,21,-1,29,21,0,-1,-1,0,-1,-2,-3,-3
"57",2018-01-19,"w1718","Fri","weekday","no_sled",162,"2","2","2",4.5,0.1,21,0,34,21.4,-1,0,-1,-1,-1,-1,-2,-3
"58",2018-01-19,"w1718","Fri","weekday","sled",18,"2","2","2",4.5,0.1,21,0,34,21.4,-1,0,-1,-1,-1,-1,-2,-3
"59",2018-01-20,"w1718","Sat","weekend","no_sled",219,"2","2","2",4.5,0,21,0,32,21.4,0,-1,0,-1,0,-1,-1,-2
"60",2018-01-20,"w1718","Sat","weekend","sled",42,"2","2","2",4.5,0,21,0,32,21.4,0,-1,0,-1,0,-1,-1,-2
"61",2018-01-21,"w1718","Sun","weekend","no_sled",29,"3","3","3",4.6,0.1,23,2,15,20,0,0,-1,0,2,2,1,1
"62",2018-01-21,"w1718","Sun","weekend","sled",1,"3","3","3",4.6,0.1,23,2,15,20,0,0,-1,0,2,2,1,1
"63",2018-01-22,"w1718","Mon","weekday","no_sled",113,"3","3","3",4.6,0,21,-2,12,21.9,2,0,0,-1,0,0,0,-1
"64",2018-01-22,"w1718","Mon","weekday","sled",21,"3","3","3",4.6,0,21,-2,12,21.9,2,0,0,-1,0,0,0,-1
"65",2018-01-23,"w1718","Tue","weekday","no_sled",89,"3","3","3",4.6,0,22,1,16,20.9,-2,2,0,0,-1,1,1,1
"66",2018-01-23,"w1718","Tue","weekday","sled",32,"3","3","3",4.6,0,22,1,16,20.9,-2,2,0,0,-1,1,1,1
"67",2018-01-24,"w1718","Wed","weekday","no_sled",112,"2","2","2",4.6,0,22,0,22,20.9,1,-2,2,0,1,-1,1,1
"68",2018-01-24,"w1718","Wed","weekday","sled",20,"2","2","2",4.6,0,22,0,22,20.9,1,-2,2,0,1,-1,1,1
"69",2018-01-25,"w1718","Thu","weekday","no_sled",142,"2","2","2",4.6,0,22,0,28,20.9,0,1,-2,2,0,1,-1,1
"70",2018-01-25,"w1718","Thu","weekday","sled",40,"2","2","2",4.6,0,22,0,28,20.9,0,1,-2,2,0,1,-1,1
"71",2018-01-26,"w1718","Fri","weekday","no_sled",70,"2","2","2",4.7,0.1,22,0,15,21.4,0,0,1,-2,0,0,1,-1
"72",2018-01-26,"w1718","Fri","weekday","sled",8,"2","2","2",4.7,0.1,22,0,15,21.4,0,0,1,-2,0,0,1,-1
"73",2018-01-27,"w1718","Sat","weekend","no_sled",605,"2","2","2",4.7,0,23,1,16,20.4,0,0,0,1,1,1,1,2
"74",2018-01-27,"w1718","Sat","weekend","sled",54,"2","2","2",4.7,0,23,1,16,20.4,0,0,0,1,1,1,1,2
"75",2018-01-28,"w1718","Sun","weekend","no_sled",285,"2","2","2",4.7,0,23,0,25,20.4,1,0,0,0,1,1,1,1
"76",2018-01-28,"w1718","Sun","weekend","sled",64,"2","2","2",4.7,0,23,0,25,20.4,1,0,0,0,1,1,1,1
"77",2018-01-29,"w1718","Mon","weekday","no_sled",116,"2","2","2",4.8,0.1,22,-1,30,21.8,0,1,0,0,-1,0,0,0
"78",2018-01-29,"w1718","Mon","weekday","sled",23,"2","2","2",4.8,0.1,22,-1,30,21.8,0,1,0,0,-1,0,0,0
"79",2018-01-30,"w1718","Tue","weekday","no_sled",111,"2","2","2",4.8,0,22,0,34,21.8,-1,0,1,0,-1,-1,0,0
"80",2018-01-30,"w1718","Tue","weekday","sled",25,"2","2","2",4.8,0,22,0,34,21.8,-1,0,1,0,-1,-1,0,0
"81",2018-01-31,"w1718","Wed","weekday","no_sled",100,"2","2","2",4.8,0,22,0,34,21.8,0,-1,0,1,0,-1,-1,0
"82",2018-01-31,"w1718","Wed","weekday","sled",11,"2","2","2",4.8,0,22,0,34,21.8,0,-1,0,1,0,-1,-1,0
"83",2018-02-01,"w1718","Thu","weekday","no_sled",124,"2","2","2",4.9,0.1,21,-1,32,23.3,0,0,-1,0,-1,-1,-2,-2
"84",2018-02-01,"w1718","Thu","weekday","sled",20,"2","2","2",4.9,0.1,21,-1,32,23.3,0,0,-1,0,-1,-1,-2,-2
"85",2018-02-02,"w1718","Fri","weekday","no_sled",181,"2","2","2",4.9,0,20,-1,33,24.5,-1,0,0,-1,-2,-2,-2,-3
"86",2018-02-02,"w1718","Fri","weekday","sled",24,"2","2","2",4.9,0,20,-1,33,24.5,-1,0,0,-1,-2,-2,-2,-3
"87",2018-02-03,"w1718","Sat","weekend","no_sled",322,"2","2","2",4.9,0,21,1,32,23.3,-1,-1,0,0,0,-1,-1,-1
"88",2018-02-03,"w1718","Sat","weekend","sled",23,"2","2","2",4.9,0,21,1,32,23.3,-1,-1,0,0,0,-1,-1,-1
"89",2018-02-04,"w1718","Sun","weekend","no_sled",341,"2","2","2",4.9,0,19,-2,32,25.8,1,-1,-1,0,-1,-2,-3,-3
"90",2018-02-04,"w1718","Sun","weekend","sled",41,"2","2","2",4.9,0,19,-2,32,25.8,1,-1,-1,0,-1,-2,-3,-3
"91",2018-02-05,"w1718","Mon","weekday","no_sled",106,"2","2","2",5,0.1,18,-1,29,27.8,-2,1,-1,-1,-3,-2,-3,-4
"92",2018-02-05,"w1718","Mon","weekday","sled",11,"2","2","2",5,0.1,18,-1,29,27.8,-2,1,-1,-1,-3,-2,-3,-4
"93",2018-02-06,"w1718","Tue","weekday","no_sled",99,"2","2","2",5.2,0.2,23,5,22,22.6,-1,-2,1,-1,4,2,3,2
"94",2018-02-06,"w1718","Tue","weekday","sled",27,"2","2","2",5.2,0.2,23,5,22,22.6,-1,-2,1,-1,4,2,3,2
"95",2018-02-07,"w1718","Wed","weekday","no_sled",207,"2","2","2",5.2,0,23,0,24,22.6,5,-1,-2,1,5,4,2,3
"96",2018-02-07,"w1718","Wed","weekday","sled",33,"2","2","2",5.2,0,23,0,24,22.6,5,-1,-2,1,5,4,2,3
"97",2018-02-08,"w1718","Thu","weekday","no_sled",200,"2","2","1",5.3,0.1,25,2,28,21.2,0,5,-1,-2,2,7,6,4
"98",2018-02-08,"w1718","Thu","weekday","sled",26,"2","2","1",5.3,0.1,25,2,28,21.2,0,5,-1,-2,2,7,6,4
"99",2018-02-09,"w1718","Fri","weekday","no_sled",214,"2","2","1",5.3,0,24,-1,33,22.1,2,0,5,-1,1,1,6,5
"100",2018-02-09,"w1718","Fri","weekday","sled",46,"2","2","1",5.3,0,24,-1,33,22.1,2,0,5,-1,1,1,6,5
"101",2018-02-10,"w1718","Sat","weekend","no_sled",93,"3","3","2",5.3,0,24,0,24,22.1,-1,2,0,5,-1,1,1,6
"102",2018-02-10,"w1718","Sat","weekend","sled",29,"3","3","2",5.3,0,24,0,24,22.1,-1,2,0,5,-1,1,1,6
"103",2018-02-11,"w1718","Sun","weekend","no_sled",227,"3","3","2",5.6,0.3,27,3,13,20.7,0,-1,2,0,3,2,4,4
"104",2018-02-11,"w1718","Sun","weekend","sled",182,"3","3","2",5.6,0.3,27,3,13,20.7,0,-1,2,0,3,2,4,4
"105",2018-02-12,"w1718","Mon","weekday","no_sled",114,"3","3","3",5.7,0.1,27,0,23,21.1,3,0,-1,2,3,3,2,4
"106",2018-02-12,"w1718","Mon","weekday","sled",53,"3","3","3",5.7,0.1,27,0,23,21.1,3,0,-1,2,3,3,2,4
"107",2018-02-13,"w1718","Tue","weekday","no_sled",96,"3","3","3",6.1,0.4,29,2,28,21,0,3,0,-1,2,5,5,4
"108",2018-02-13,"w1718","Tue","weekday","sled",53,"3","3","3",6.1,0.4,29,2,28,21,0,3,0,-1,2,5,5,4
"109",2018-02-14,"w1718","Wed","weekday","no_sled",142,"3","3","3",6.2,0.1,30,1,30,20.7,2,0,3,0,3,3,6,6
"110",2018-02-14,"w1718","Wed","weekday","sled",93,"3","3","3",6.2,0.1,30,1,30,20.7,2,0,3,0,3,3,6,6
"111",2018-02-15,"w1718","Thu","weekday","no_sled",85,"3","3","3",6.3,0.1,28,-2,24,22.5,1,2,0,3,-1,1,1,4
"112",2018-02-15,"w1718","Thu","weekday","sled",69,"3","3","3",6.3,0.1,28,-2,24,22.5,1,2,0,3,-1,1,1,4
"113",2018-02-16,"w1718","Fri","weekday","no_sled",163,"3","3","3",6.7,0.4,32,4,18,20.9,-2,1,2,0,2,3,5,5
"114",2018-02-16,"w1718","Fri","weekday","sled",151,"3","3","3",6.7,0.4,32,4,18,20.9,-2,1,2,0,2,3,5,5
"115",2018-02-17,"w1718","Sat","weekend","no_sled",576,"3","3","2",6.7,0,32,0,25,20.9,4,-2,1,2,4,2,3,5
"116",2018-02-17,"w1718","Sat","weekend","sled",243,"3","3","2",6.7,0,32,0,25,20.9,4,-2,1,2,4,2,3,5
"117",2018-02-18,"w1718","Sun","weekend","no_sled",534,"2","2","2",6.7,0,31,-1,32,21.6,0,4,-2,1,-1,3,1,2
"118",2018-02-18,"w1718","Sun","weekend","sled",210,"2","2","2",6.7,0,31,-1,32,21.6,0,4,-2,1,-1,3,1,2
"119",2018-02-19,"w1718","Mon","weekday","no_sled",131,"2","2","2",6.8,0.1,29,-2,24,23.4,-1,0,4,-2,-3,-3,1,-1
"120",2018-02-19,"w1718","Mon","weekday","no_sled",131,"3","3","3",6.8,0.1,29,-2,24,23.4,-1,0,4,-2,-3,-3,1,-1
"121",2018-02-19,"w1718","Mon","weekday","sled",86,"2","2","2",6.8,0.1,29,-2,24,23.4,-1,0,4,-2,-3,-3,1,-1
"122",2018-02-19,"w1718","Mon","weekday","sled",86,"3","3","3",6.8,0.1,29,-2,24,23.4,-1,0,4,-2,-3,-3,1,-1
"123",2018-02-20,"w1718","Tue","weekday","no_sled",83,"3","3","3",6.8,0,31,2,8,21.9,-2,-1,0,4,0,-1,-1,3
"124",2018-02-20,"w1718","Tue","weekday","sled",42,"3","3","3",6.8,0,31,2,8,21.9,-2,-1,0,4,0,-1,-1,3
"125",2018-02-21,"w1718","Wed","weekday","no_sled",142,"3","3","3",6.8,0,31,0,11,21.9,2,-2,-1,0,2,0,-1,-1
"126",2018-02-21,"w1718","Wed","weekday","sled",77,"3","3","3",6.8,0,31,0,11,21.9,2,-2,-1,0,2,0,-1,-1
"127",2018-02-22,"w1718","Thu","weekday","no_sled",101,"3","3","2",6.8,0,30,-1,16,22.7,0,2,-2,-1,-1,1,-1,-2
"128",2018-02-22,"w1718","Thu","weekday","sled",55,"3","3","2",6.8,0,30,-1,16,22.7,0,2,-2,-1,-1,1,-1,-2
"129",2018-02-23,"w1718","Fri","weekday","no_sled",168,"3","3","2",6.9,0.1,30,0,15,23,-1,0,2,-2,-1,-1,1,-1
"130",2018-02-23,"w1718","Fri","weekday","sled",89,"3","3","2",6.9,0.1,30,0,15,23,-1,0,2,-2,-1,-1,1,-1
"131",2018-02-24,"w1718","Sat","weekend","no_sled",190,"3","3","2",6.9,0,31,1,10,22.3,0,-1,0,2,1,0,0,2
"132",2018-02-24,"w1718","Sat","weekend","sled",126,"3","3","2",6.9,0,31,1,10,22.3,0,-1,0,2,1,0,0,2
"133",2018-02-25,"w1718","Sun","weekend","no_sled",179,"3","3","2",7.1,0.2,32,1,11,22.2,1,0,-1,0,2,2,1,1
"134",2018-02-25,"w1718","Sun","weekend","sled",95,"3","3","2",7.1,0.2,32,1,11,22.2,1,0,-1,0,2,2,1,1
"135",2018-02-26,"w1718","Mon","weekday","no_sled",162,"2","2","2",7.1,0,32,0,20,22.2,1,1,0,-1,1,2,2,1
"136",2018-02-26,"w1718","Mon","weekday","sled",137,"2","2","2",7.1,0,32,0,20,22.2,1,1,0,-1,1,2,2,1
"137",2018-02-27,"w1718","Tue","weekday","no_sled",169,"2","2","2",7.2,0.1,32,0,26,22.5,0,1,1,0,0,1,2,2
"138",2018-02-27,"w1718","Tue","weekday","sled",105,"2","2","2",7.2,0.1,32,0,26,22.5,0,1,1,0,0,1,2,2
"139",2018-02-28,"w1718","Wed","weekday","no_sled",128,"2","2","2",7.2,0,31,-1,23,23.2,0,0,1,1,-1,-1,0,1
"140",2018-02-28,"w1718","Wed","weekday","sled",100,"2","2","2",7.2,0,31,-1,23,23.2,0,0,1,1,-1,-1,0,1
"141",2018-03-01,"w1718","Thu","weekday","no_sled",162,"2","2","2",7.2,0,31,0,24,23.2,-1,0,0,1,-1,-1,-1,0
"142",2018-03-01,"w1718","Thu","weekday","sled",70,"2","2","2",7.2,0,31,0,24,23.2,-1,0,0,1,-1,-1,-1,0
"143",2018-03-02,"w1718","Fri","weekday","no_sled",205,"2","2","1",7.2,0,31,0,30,23.2,0,-1,0,0,0,-1,-1,-1
"144",2018-03-02,"w1718","Fri","weekday","sled",111,"2","2","1",7.2,0,31,0,30,23.2,0,-1,0,0,0,-1,-1,-1
"145",2018-03-03,"w1718","Sat","weekend","no_sled",479,"2","2","1",7.3,0.1,30,-1,34,24.3,0,0,-1,0,-1,-1,-2,-2
"146",2018-03-03,"w1718","Sat","weekend","sled",186,"2","2","1",7.3,0.1,30,-1,34,24.3,0,0,-1,0,-1,-1,-2,-2
"147",2018-03-04,"w1718","Sun","weekend","no_sled",233,"2","2","1",7.3,0,29,-1,24,25.2,-1,0,0,-1,-2,-2,-2,-3
"148",2018-03-04,"w1718","Sun","weekend","sled",103,"2","2","1",7.3,0,29,-1,24,25.2,-1,0,0,-1,-2,-2,-2,-3
"149",2018-03-05,"w1718","Mon","weekday","no_sled",72,"2","2","1",7.3,0,31,2,13,23.5,-1,-1,0,0,1,0,0,0
"150",2018-03-05,"w1718","Mon","weekday","sled",79,"2","2","1",7.3,0,31,2,13,23.5,-1,-1,0,0,1,0,0,0
"151",2018-03-06,"w1718","Tue","weekday","no_sled",106,"2","2","1",7.3,0,31,0,19,23.5,2,-1,-1,0,2,1,0,0
"152",2018-03-06,"w1718","Tue","weekday","sled",112,"2","2","1",7.3,0,31,0,19,23.5,2,-1,-1,0,2,1,0,0
"153",2018-03-07,"w1718","Wed","weekday","no_sled",133,"2","2","1",7.4,0.1,31,0,27,23.9,0,2,-1,-1,0,2,1,0
"154",2018-03-07,"w1718","Wed","weekday","sled",80,"2","2","1",7.4,0.1,31,0,27,23.9,0,2,-1,-1,0,2,1,0
"155",2018-03-08,"w1718","Thu","weekday","no_sled",99,"2","2","1",7.4,0,30,-1,33,24.7,0,0,2,-1,-1,-1,1,0
"156",2018-03-08,"w1718","Thu","weekday","sled",128,"2","2","1",7.4,0,30,-1,33,24.7,0,0,2,-1,-1,-1,1,0
"157",2018-03-09,"w1718","Fri","weekday","no_sled",162,"2","2","1",7.4,0,30,0,34,24.7,-1,0,0,2,-1,-1,-1,1
"158",2018-03-09,"w1718","Fri","weekday","sled",138,"2","2","1",7.4,0,30,0,34,24.7,-1,0,0,2,-1,-1,-1,1
"159",2018-03-10,"w1718","Sat","weekend","no_sled",292,"1","1","1",7.4,0,30,0,31,24.7,0,-1,0,0,0,-1,-1,-1
"160",2018-03-10,"w1718","Sat","weekend","sled",176,"1","1","1",7.4,0,30,0,31,24.7,0,-1,0,0,0,-1,-1,-1
"161",2018-03-11,"w1718","Sun","weekend","no_sled",305,"1","1","1",7.4,0,29,-1,31,25.5,0,0,-1,0,-1,-1,-2,-2
"162",2018-03-11,"w1718","Sun","weekend","sled",239,"1","1","1",7.4,0,29,-1,31,25.5,0,0,-1,0,-1,-1,-2,-2
"163",2018-03-12,"w1718","Mon","weekday","no_sled",155,"1","1","1",7.4,0,29,0,33,25.5,-1,0,0,-1,-1,-1,-1,-2
"164",2018-03-12,"w1718","Mon","weekday","sled",136,"1","1","1",7.4,0,29,0,33,25.5,-1,0,0,-1,-1,-1,-1,-2
"165",2018-03-13,"w1718","Tue","weekday","no_sled",205,"1","1","1",7.4,0,29,0,34,25.5,0,-1,0,0,0,-1,-1,-1
"166",2018-03-13,"w1718","Tue","weekday","sled",210,"1","1","1",7.4,0,29,0,34,25.5,0,-1,0,0,0,-1,-1,-1
"167",2018-03-14,"w1718","Wed","weekday","no_sled",171,"1","2","2",7.4,0,29,0,39,25.5,0,0,-1,0,0,0,-1,-1
"168",2018-03-14,"w1718","Wed","weekday","sled",175,"1","2","2",7.4,0,29,0,39,25.5,0,0,-1,0,0,0,-1,-1
"169",2018-03-15,"w1718","Thu","weekday","no_sled",98,"2","2","2",7.5,0.1,28,-1,31,26.8,0,0,0,-1,-1,-1,-1,-2
"170",2018-03-15,"w1718","Thu","weekday","sled",189,"2","2","2",7.5,0.1,28,-1,31,26.8,0,0,0,-1,-1,-1,-1,-2
"171",2018-03-16,"w1718","Fri","weekday","no_sled",161,"2","2","2",7.7,0.2,29,1,25,26.6,-1,0,0,0,0,0,0,0
"172",2018-03-16,"w1718","Fri","weekday","sled",169,"2","2","2",7.7,0.2,29,1,25,26.6,-1,0,0,0,0,0,0,0
"173",2018-03-17,"w1718","Sat","weekend","no_sled",287,"2","2","2",7.8,0.1,32,3,29,24.4,1,-1,0,0,4,3,3,3
"174",2018-03-17,"w1718","Sat","weekend","sled",209,"2","2","2",7.8,0.1,32,3,29,24.4,1,-1,0,0,4,3,3,3
"175",2018-03-18,"w1718","Sun","weekend","no_sled",138,"2","2","2",7.9,0.1,31,-1,24,25.5,3,1,-1,0,2,3,2,2
"176",2018-03-18,"w1718","Sun","weekend","sled",155,"2","2","2",7.9,0.1,31,-1,24,25.5,3,1,-1,0,2,3,2,2
"177",2018-03-19,"w1718","Mon","weekday","no_sled",141,"2","2","1",8,0.1,32,1,19,25,-1,3,1,-1,0,3,4,3
"178",2018-03-19,"w1718","Mon","weekday","sled",111,"2","2","1",8,0.1,32,1,19,25,-1,3,1,-1,0,3,4,3
"179",2018-03-20,"w1718","Tue","weekday","no_sled",144,"2","2","1",8,0,30,-2,24,26.7,1,-1,3,1,-1,-2,1,2
"180",2018-03-20,"w1718","Tue","weekday","sled",137,"2","2","1",8,0,30,-2,24,26.7,1,-1,3,1,-1,-2,1,2
"181",2018-03-21,"w1718","Wed","weekday","no_sled",392,"1","1","1",8.1,0.1,32,2,30,25.3,-2,1,-1,3,0,1,0,3
"182",2018-03-21,"w1718","Wed","weekday","sled",125,"1","1","1",8.1,0.1,32,2,30,25.3,-2,1,-1,3,0,1,0,3
"183",2018-03-22,"w1718","Thu","weekday","no_sled",163,"1","1","1",8.1,0,30,-2,36,27,2,-2,1,-1,0,-2,-1,-2
"184",2018-03-22,"w1718","Thu","weekday","sled",98,"1","1","1",8.1,0,30,-2,36,27,2,-2,1,-1,0,-2,-1,-2
"185",2018-03-23,"w1718","Fri","weekday","no_sled",43,"2","2","3",8.2,0.1,29,-1,34,28.3,-2,2,-2,1,-3,-1,-3,-2
"186",2018-03-23,"w1718","Fri","weekday","sled",39,"2","2","3",8.2,0.1,29,-1,34,28.3,-2,2,-2,1,-3,-1,-3,-2
"187",2018-03-24,"w1718","Sat","weekend","no_sled",200,"2","2","1",8.9,0.7,34,5,32,26.2,-1,-2,2,-2,4,2,4,2
"188",2018-03-24,"w1718","Sat","weekend","sled",112,"2","2","1",8.9,0.7,34,5,32,26.2,-1,-2,2,-2,4,2,4,2
"189",2018-03-25,"w1718","Sun","weekend","no_sled",231,"2","2","1",8.9,0,35,1,35,25.4,5,-1,-2,2,6,5,3,5
"190",2018-03-25,"w1718","Sun","weekend","sled",150,"2","2","1",8.9,0,35,1,35,25.4,5,-1,-2,2,6,5,3,5
"191",2018-03-26,"w1718","Mon","weekday","no_sled",187,"1","1","1",8.9,0,34,-1,31,26.2,1,5,-1,-2,0,5,4,2
"192",2018-03-26,"w1718","Mon","weekday","no_sled",187,"2","1","1",8.9,0,34,-1,31,26.2,1,5,-1,-2,0,5,4,2
"193",2018-03-26,"w1718","Mon","weekday","sled",106,"1","1","1",8.9,0,34,-1,31,26.2,1,5,-1,-2,0,5,4,2
"194",2018-03-26,"w1718","Mon","weekday","sled",106,"2","1","1",8.9,0,34,-1,31,26.2,1,5,-1,-2,0,5,4,2
"195",2018-03-27,"w1718","Tue","weekday","no_sled",121,"1","1","1",8.9,0,33,-1,29,27,-1,1,5,-1,-2,-1,4,3
"196",2018-03-27,"w1718","Tue","weekday","sled",86,"1","1","1",8.9,0,33,-1,29,27,-1,1,5,-1,-2,-1,4,3
"197",2018-03-28,"w1718","Wed","weekday","no_sled",119,"1","1","1",8.9,0,33,0,27,27,-1,-1,1,5,-1,-2,-1,4
"198",2018-03-28,"w1718","Wed","weekday","sled",78,"1","1","1",8.9,0,33,0,27,27,-1,-1,1,5,-1,-2,-1,4
"199",2018-03-29,"w1718","Thu","weekday","no_sled",149,"1","1","1",8.9,0,33,0,27,27,0,-1,-1,1,0,-1,-2,-1
"200",2018-03-29,"w1718","Thu","weekday","sled",99,"1","1","1",8.9,0,33,0,27,27,0,-1,-1,1,0,-1,-2,-1
"201",2018-03-30,"w1718","Fri","weekday","no_sled",178,"1","1","1",8.9,0,32,-1,33,27.8,0,0,-1,-1,-1,-1,-2,-3
"202",2018-03-30,"w1718","Fri","weekday","sled",127,"1","1","1",8.9,0,32,-1,33,27.8,0,0,-1,-1,-1,-1,-2,-3
"203",2018-03-31,"w1718","Sat","weekend","no_sled",210,"1","1","1",8.9,0,32,0,39,27.8,-1,0,0,-1,-1,-1,-1,-2
"204",2018-03-31,"w1718","Sat","weekend","sled",115,"1","1","1",8.9,0,32,0,39,27.8,-1,0,0,-1,-1,-1,-1,-2
"205",2018-04-01,"w1718","Sun","weekend","no_sled",106,"1","1","1",8.8,-0.1,30,-2,41,29.3,0,-1,0,0,-2,-3,-3,-3
"206",2018-04-01,"w1718","Sun","weekend","sled",88,"1","1","1",8.8,-0.1,30,-2,41,29.3,0,-1,0,0,-2,-3,-3,-3
"207",2018-04-02,"w1718","Mon","weekday","no_sled",52,"1","1","1",8.7,-0.1,29,-1,39,30,-2,0,-1,0,-3,-3,-4,-4
"208",2018-04-02,"w1718","Mon","weekday","sled",59,"1","1","1",8.7,-0.1,29,-1,39,30,-2,0,-1,0,-3,-3,-4,-4
"209",2018-04-03,"w1718","Tue","weekday","no_sled",41,"1","1","1",8.8,0.1,30,1,27,29.3,-1,-2,0,-1,0,-2,-2,-3
"210",2018-04-03,"w1718","Tue","weekday","sled",70,"1","1","1",8.8,0.1,30,1,27,29.3,-1,-2,0,-1,0,-2,-2,-3
"211",2018-04-04,"w1718","Wed","weekday","no_sled",74,"1","2","2",8.9,0.1,28,-2,33,31.8,1,-1,-2,0,-1,-2,-4,-4
"212",2018-04-04,"w1718","Wed","weekday","sled",75,"1","2","2",8.9,0.1,28,-2,33,31.8,1,-1,-2,0,-1,-2,-4,-4
"213",2018-04-05,"w1718","Thu","weekday","no_sled",53,"1","2","2",8.9,0,27,-1,35,33,-2,1,-1,-2,-3,-2,-3,-5
"214",2018-04-05,"w1718","Thu","weekday","sled",82,"1","2","2",8.9,0,27,-1,35,33,-2,1,-1,-2,-3,-2,-3,-5
"215",2018-04-06,"w1718","Fri","weekday","no_sled",30,"1","2","2",8.9,0,25,-2,35,35.6,-1,-2,1,-1,-3,-5,-4,-5
"216",2018-04-06,"w1718","Fri","weekday","sled",99,"1","2","2",8.9,0,25,-2,35,35.6,-1,-2,1,-1,-3,-5,-4,-5
"217",2018-04-07,"w1718","Sat","weekend","no_sled",69,"2","2","2",9.2,0.3,31,6,37,29.7,-2,-1,-2,1,4,3,1,2
"218",2018-04-07,"w1718","Sat","weekend","sled",68,"2","2","2",9.2,0.3,31,6,37,29.7,-2,-1,-2,1,4,3,1,2
"219",2018-04-08,"w1718","Sun","weekend","no_sled",29,"3","3","3",10,0.8,33,2,33,30.3,6,-2,-1,-2,8,6,5,3
"220",2018-04-08,"w1718","Sun","weekend","sled",47,"3","3","3",10,0.8,33,2,33,30.3,6,-2,-1,-2,8,6,5,3
"221",2018-04-09,"w1718","Mon","weekday","no_sled",42,"1","1","1",10.1,0.1,33,0,31,30.6,2,6,-2,-1,2,8,6,5
"222",2018-04-09,"w1718","Mon","weekday","sled",15,"1","1","1",10.1,0.1,33,0,31,30.6,2,6,-2,-1,2,8,6,5
"223",2018-04-10,"w1718","Tue","weekday","no_sled",42,"1","1","1",10.1,0,31,-2,38,32.6,0,2,6,-2,-2,0,6,4
"224",2018-04-10,"w1718","Tue","weekday","sled",19,"1","1","1",10.1,0,31,-2,38,32.6,0,2,6,-2,-2,0,6,4
"225",2018-04-11,"w1718","Wed","weekday","no_sled",30,"2","2","2",9.9,-0.2,29,-2,45,34.1,-2,0,2,6,-4,-4,-2,4
"226",2018-04-11,"w1718","Wed","weekday","sled",16,"2","2","2",9.9,-0.2,29,-2,45,34.1,-2,0,2,6,-4,-4,-2,4
"227",2018-04-12,"w1718","Thu","weekday","no_sled",18,"1","2","2",9.5,-0.4,28,-1,40,33.9,-2,-2,0,2,-3,-5,-5,-3
"228",2018-04-12,"w1718","Thu","weekday","sled",8,"1","2","2",9.5,-0.4,28,-1,40,33.9,-2,-2,0,2,-3,-5,-5,-3
"229",2018-04-13,"w1718","Fri","weekday","no_sled",30,"2","2","1",9.4,-0.1,26,-2,23,36.2,-1,-2,-2,0,-3,-5,-7,-7
"230",2018-04-13,"w1718","Fri","weekday","sled",9,"2","2","1",9.4,-0.1,26,-2,23,36.2,-1,-2,-2,0,-3,-5,-7,-7
"231",2018-04-14,"w1718","Sat","weekend","no_sled",53,"2","2","1",9.4,0,28,2,28,33.6,-2,-1,-2,-2,0,-1,-3,-5
"232",2018-04-14,"w1718","Sat","weekend","sled",21,"2","2","1",9.4,0,28,2,28,33.6,-2,-1,-2,-2,0,-1,-3,-5
"233",2018-04-15,"w1718","Sun","weekend","no_sled",49,"2","2","1",9.2,-0.2,27,-1,37,34.1,2,-2,-1,-2,1,-1,-2,-4
"234",2018-04-15,"w1718","Sun","weekend","sled",14,"2","2","1",9.2,-0.2,27,-1,37,34.1,2,-2,-1,-2,1,-1,-2,-4
"235",2018-04-16,"w1718","Mon","weekday","no_sled",8,NA,NA,NA,8.9,-0.3,24,-3,43,37.1,-1,2,-2,-1,-4,-2,-4,-5
"236",2018-04-16,"w1718","Mon","weekday","sled",6,NA,NA,NA,8.9,-0.3,24,-3,43,37.1,-1,2,-2,-1,-4,-2,-4,-5
"237",2018-12-01,"w1819","Sat","weekend","no_sled",130,"3","3","2",3.3,0.2,19,1,16,17.4,0,0,0,0,1,1,1,1
"238",2018-12-01,"w1819","Sat","weekend","sled",4,"3","3","2",3.3,0.2,19,1,16,17.4,0,0,0,0,1,1,1,1
"239",2018-12-02,"w1819","Sun","weekend","no_sled",58,"3","3","3",3.3,0,20,1,14,16.5,1,0,0,0,2,2,2,2
"240",2018-12-02,"w1819","Sun","weekend","sled",8,"3","3","3",3.3,0,20,1,14,16.5,1,0,0,0,2,2,2,2
"241",2018-12-03,"w1819","Mon","weekday","no_sled",18,"3","3","2",3.4,0.1,19,-1,13,17.9,1,1,0,0,0,1,1,1
"242",2018-12-03,"w1819","Mon","weekday","sled",5,"3","3","2",3.4,0.1,19,-1,13,17.9,1,1,0,0,0,1,1,1
"243",2018-12-04,"w1819","Tue","weekday","no_sled",25,"3","3","2",3.5,0.1,20,1,8,17.5,-1,1,1,0,0,1,2,2
"244",2018-12-04,"w1819","Tue","weekday","sled",9,"3","3","2",3.5,0.1,20,1,8,17.5,-1,1,1,0,0,1,2,2
"245",2018-12-05,"w1819","Wed","weekday","no_sled",57,"3","3","2",3.5,0,19,-1,21,18.4,1,-1,1,1,0,-1,0,1
"246",2018-12-05,"w1819","Wed","weekday","sled",25,"3","3","2",3.5,0,19,-1,21,18.4,1,-1,1,1,0,-1,0,1
"247",2018-12-06,"w1819","Thu","weekday","no_sled",41,"2","2","2",3.7,0.2,18,-1,25,20.6,-1,1,-1,1,-2,-1,-2,-1
"248",2018-12-06,"w1819","Thu","weekday","sled",31,"2","2","2",3.7,0.2,18,-1,25,20.6,-1,1,-1,1,-2,-1,-2,-1
"249",2018-12-07,"w1819","Fri","weekday","no_sled",64,"2","2","2",3.8,0.1,21,3,23,18.1,-1,-1,1,-1,2,1,2,1
"250",2018-12-07,"w1819","Fri","weekday","sled",48,"2","2","2",3.8,0.1,21,3,23,18.1,-1,-1,1,-1,2,1,2,1
"251",2018-12-08,"w1819","Sat","weekend","no_sled",159,"2","2","2",3.8,0,20,-1,23,19,3,-1,-1,1,2,1,0,1
"252",2018-12-08,"w1819","Sat","weekend","sled",94,"2","2","2",3.8,0,20,-1,23,19,3,-1,-1,1,2,1,0,1
"253",2018-12-09,"w1819","Sun","weekend","no_sled",202,"2","2","2",3.8,0,20,0,19,19,-1,3,-1,-1,-1,2,1,0
"254",2018-12-09,"w1819","Sun","weekend","sled",74,"2","2","2",3.8,0,20,0,19,19,-1,3,-1,-1,-1,2,1,0
"255",2018-12-10,"w1819","Mon","weekday","no_sled",52,"2","2","2",3.8,0,20,0,21,19,0,-1,3,-1,0,-1,2,1
"256",2018-12-10,"w1819","Mon","weekday","sled",54,"2","2","2",3.8,0,20,0,21,19,0,-1,3,-1,0,-1,2,1
"257",2018-12-11,"w1819","Tue","weekday","no_sled",65,"2","2","2",3.9,0.1,19,-1,27,20.5,0,0,-1,3,-1,-1,-2,1
"258",2018-12-11,"w1819","Tue","weekday","sled",35,"2","2","2",3.9,0.1,19,-1,27,20.5,0,0,-1,3,-1,-1,-2,1
"259",2018-12-12,"w1819","Wed","weekday","no_sled",56,"2","2","1",3.9,0,19,0,21,20.5,-1,0,0,-1,-1,-1,-1,-2
"260",2018-12-12,"w1819","Wed","weekday","sled",16,"2","2","1",3.9,0,19,0,21,20.5,-1,0,0,-1,-1,-1,-1,-2
"261",2018-12-13,"w1819","Thu","weekday","no_sled",39,"3","3","2",4,0.1,21,2,15,19,0,-1,0,0,2,1,1,1
"262",2018-12-13,"w1819","Thu","weekday","sled",22,"3","3","2",4,0.1,21,2,15,19,0,-1,0,0,2,1,1,1
"263",2018-12-14,"w1819","Fri","weekday","no_sled",51,"3","3","2",4,0,20,-1,24,20,2,0,-1,0,1,1,0,0
"264",2018-12-14,"w1819","Fri","weekday","sled",44,"3","3","2",4,0,20,-1,24,20,2,0,-1,0,1,1,0,0
"265",2018-12-15,"w1819","Sat","weekend","no_sled",166,"2","2","2",4,0,20,0,29,20,-1,2,0,-1,-1,1,1,0
"266",2018-12-15,"w1819","Sat","weekend","sled",53,"2","2","2",4,0,20,0,29,20,-1,2,0,-1,-1,1,1,0
"267",2018-12-16,"w1819","Sun","weekend","no_sled",203,"2","2","2",4.1,0.1,19,-1,28,21.6,0,-1,2,0,-1,-2,0,0
"268",2018-12-16,"w1819","Sun","weekend","sled",85,"2","2","2",4.1,0.1,19,-1,28,21.6,0,-1,2,0,-1,-2,0,0
"269",2018-12-17,"w1819","Mon","weekday","no_sled",56,"2","2","2",4.1,0,19,0,29,21.6,-1,0,-1,2,-1,-1,-2,0
"270",2018-12-17,"w1819","Mon","weekday","sled",40,"2","2","2",4.1,0,19,0,29,21.6,-1,0,-1,2,-1,-1,-2,0
"271",2018-12-18,"w1819","Tue","weekday","no_sled",64,"2","2","2",4.1,0,19,0,27,21.6,0,-1,0,-1,0,-1,-1,-2
"272",2018-12-18,"w1819","Tue","weekday","sled",51,"2","2","2",4.1,0,19,0,27,21.6,0,-1,0,-1,0,-1,-1,-2
"273",2018-12-19,"w1819","Wed","weekday","no_sled",70,"2","2","2",4.1,0,19,0,24,21.6,0,0,-1,0,0,0,-1,-1
"274",2018-12-19,"w1819","Wed","weekday","sled",21,"2","2","2",4.1,0,19,0,24,21.6,0,0,-1,0,0,0,-1,-1
"275",2018-12-20,"w1819","Thu","weekday","no_sled",105,"2","2","1",4.1,0,20,1,25,20.5,0,0,0,-1,1,1,1,0
"276",2018-12-20,"w1819","Thu","weekday","sled",49,"2","2","1",4.1,0,20,1,25,20.5,0,0,0,-1,1,1,1,0
"277",2018-12-21,"w1819","Fri","weekday","no_sled",112,"2","2","1",4.1,0,19,-1,28,21.6,1,0,0,0,0,0,0,0
"278",2018-12-21,"w1819","Fri","weekday","sled",44,"2","2","1",4.1,0,19,-1,28,21.6,1,0,0,0,0,0,0,0
"279",2018-12-22,"w1819","Sat","weekend","no_sled",144,"2","2","1",4.2,0.1,19,0,20,22.1,-1,1,0,0,-1,0,0,0
"280",2018-12-22,"w1819","Sat","weekend","sled",46,"2","2","1",4.2,0.1,19,0,20,22.1,-1,1,0,0,-1,0,0,0
"281",2018-12-23,"w1819","Sun","weekend","no_sled",259,"2","2","1",4.2,0,21,2,19,20,0,-1,1,0,2,1,2,2
"282",2018-12-23,"w1819","Sun","weekend","sled",98,"2","2","1",4.2,0,21,2,19,20,0,-1,1,0,2,1,2,2
"283",2018-12-24,"w1819","Mon","weekday","no_sled",91,"2","2","2",4.3,0.1,20,-1,21,21.5,2,0,-1,1,1,1,0,1
"284",2018-12-24,"w1819","Mon","weekday","sled",56,"2","2","2",4.3,0.1,20,-1,21,21.5,2,0,-1,1,1,1,0,1
"285",2018-12-25,"w1819","Tue","weekday","no_sled",172,"2","2","2",4.7,0.4,25,5,25,18.8,-1,2,0,-1,4,6,6,5
"286",2018-12-25,"w1819","Tue","weekday","sled",128,"2","2","2",4.7,0.4,25,5,25,18.8,-1,2,0,-1,4,6,6,5
"287",2018-12-26,"w1819","Wed","weekday","no_sled",138,"3","3","3",4.7,0,23,-2,24,20.4,5,-1,2,0,3,2,4,4
"288",2018-12-26,"w1819","Wed","weekday","sled",144,"3","3","3",4.7,0,23,-2,24,20.4,5,-1,2,0,3,2,4,4
"289",2018-12-27,"w1819","Thu","weekday","no_sled",134,"3","3","2",4.7,0,24,1,12,19.6,-2,5,-1,2,-1,4,3,5
"290",2018-12-27,"w1819","Thu","weekday","sled",78,"3","3","2",4.7,0,24,1,12,19.6,-2,5,-1,2,-1,4,3,5
"291",2018-12-28,"w1819","Fri","weekday","no_sled",160,"3","3","2",4.7,0,24,0,12,19.6,1,-2,5,-1,1,-1,4,3
"292",2018-12-28,"w1819","Fri","weekday","sled",102,"3","3","2",4.7,0,24,0,12,19.6,1,-2,5,-1,1,-1,4,3
"293",2018-12-29,"w1819","Sat","weekend","no_sled",342,"3","3","2",4.7,0,24,0,8,19.6,0,1,-2,5,0,1,-1,4
"294",2018-12-29,"w1819","Sat","weekend","sled",281,"3","3","2",4.7,0,24,0,8,19.6,0,1,-2,5,0,1,-1,4
"295",2018-12-30,"w1819","Sun","weekend","no_sled",305,"3","3","2",4.7,0,24,0,16,19.6,0,0,1,-2,0,0,1,-1
"296",2018-12-30,"w1819","Sun","weekend","sled",263,"3","3","2",4.7,0,24,0,16,19.6,0,0,1,-2,0,0,1,-1
"297",2018-12-31,"w1819","Mon","weekday","no_sled",129,"3","3","3",4.9,0.2,23,-1,14,21.3,0,0,0,1,-1,-1,-1,0
"298",2018-12-31,"w1819","Mon","weekday","sled",71,"3","3","3",4.9,0.2,23,-1,14,21.3,0,0,0,1,-1,-1,-1,0
"299",2019-01-01,"w1819","Tue","weekday","no_sled",159,"3","3","3",5.1,0.2,29,6,11,17.6,-1,0,0,0,5,5,5,5
"300",2019-01-01,"w1819","Tue","weekday","sled",136,"3","3","3",5.1,0.2,29,6,11,17.6,-1,0,0,0,5,5,5,5
"301",2019-01-02,"w1819","Wed","weekday","no_sled",118,"3","3","2",5.1,0,28,-1,10,18.2,6,-1,0,0,5,4,4,4
"302",2019-01-02,"w1819","Wed","weekday","sled",129,"3","3","2",5.1,0,28,-1,10,18.2,6,-1,0,0,5,4,4,4
"303",2019-01-03,"w1819","Thu","weekday","no_sled",227,"3","3","2",5.1,0,27,-1,22,18.9,-1,6,-1,0,-2,4,3,3
"304",2019-01-03,"w1819","Thu","weekday","sled",193,"3","3","2",5.1,0,27,-1,22,18.9,-1,6,-1,0,-2,4,3,3
"305",2019-01-04,"w1819","Fri","weekday","no_sled",205,"3","3","2",5.3,0.2,26,-1,29,20.4,-1,-1,6,-1,-2,-3,3,2
"306",2019-01-04,"w1819","Fri","weekday","sled",196,"3","3","2",5.3,0.2,26,-1,29,20.4,-1,-1,6,-1,-2,-3,3,2
"307",2019-01-05,"w1819","Sat","weekend","no_sled",255,"2","2","2",5.3,0,25,-1,30,21.2,-1,-1,-1,6,-2,-3,-4,2
"308",2019-01-05,"w1819","Sat","weekend","sled",145,"2","2","2",5.3,0,25,-1,30,21.2,-1,-1,-1,6,-2,-3,-4,2
"309",2019-01-06,"w1819","Sun","weekend","no_sled",120,"3","3","3",5.3,0,25,0,26,21.2,-1,-1,-1,-1,-1,-2,-3,-4
"310",2019-01-06,"w1819","Sun","weekend","sled",21,"3","3","3",5.3,0,25,0,26,21.2,-1,-1,-1,-1,-1,-2,-3,-4
"311",2019-01-07,"w1819","Mon","weekday","no_sled",17,"3","3","3",5.8,0.5,32,7,21,18.1,0,-1,-1,-1,7,6,5,4
"312",2019-01-07,"w1819","Mon","weekday","sled",16,"3","3","3",5.8,0.5,32,7,21,18.1,0,-1,-1,-1,7,6,5,4
"313",2019-01-08,"w1819","Tue","weekday","no_sled",106,"3","3","3",5.9,0.1,32,0,24,18.4,7,0,-1,-1,7,7,6,5
"314",2019-01-08,"w1819","Tue","weekday","sled",68,"3","3","3",5.9,0.1,32,0,24,18.4,7,0,-1,-1,7,7,6,5
"315",2019-01-09,"w1819","Wed","weekday","no_sled",138,"3","3","3",6,0.1,30,-2,29,20,0,7,0,-1,-2,5,5,4
"316",2019-01-09,"w1819","Wed","weekday","sled",85,"3","3","3",6,0.1,30,-2,29,20,0,7,0,-1,-2,5,5,4
"317",2019-01-10,"w1819","Thu","weekday","no_sled",177,"3","3","3",6,0,29,-1,29,20.7,-2,0,7,0,-3,-3,4,4
"318",2019-01-10,"w1819","Thu","weekday","sled",95,"3","3","3",6,0,29,-1,29,20.7,-2,0,7,0,-3,-3,4,4
"319",2019-01-11,"w1819","Fri","weekday","no_sled",154,"2","2","2",6.1,0.1,29,0,25,21,-1,-2,0,7,-1,-3,-3,4
"320",2019-01-11,"w1819","Fri","weekday","sled",80,"2","2","2",6.1,0.1,29,0,25,21,-1,-2,0,7,-1,-3,-3,4
"321",2019-01-12,"w1819","Sat","weekend","no_sled",217,"3","3","2",6.1,0,28,-1,21,21.8,0,-1,-2,0,-1,-2,-4,-4
"322",2019-01-12,"w1819","Sat","weekend","sled",67,"3","3","2",6.1,0,28,-1,21,21.8,0,-1,-2,0,-1,-2,-4,-4
"323",2019-01-13,"w1819","Sun","weekend","no_sled",213,"2","2","2",6.2,0.1,30,2,18,20.7,-1,0,-1,-2,1,1,0,-2
"324",2019-01-13,"w1819","Sun","weekend","sled",77,"2","2","2",6.2,0.1,30,2,18,20.7,-1,0,-1,-2,1,1,0,-2
"325",2019-01-14,"w1819","Mon","weekday","no_sled",101,"2","2","2",6.2,0,30,0,18,20.7,2,-1,0,-1,2,1,1,0
"326",2019-01-14,"w1819","Mon","weekday","sled",61,"2","2","2",6.2,0,30,0,18,20.7,2,-1,0,-1,2,1,1,0
"327",2019-01-15,"w1819","Tue","weekday","no_sled",130,"2","2","2",6.2,0,29,-1,24,21.4,0,2,-1,0,-1,1,0,0
"328",2019-01-15,"w1819","Tue","weekday","sled",72,"2","2","2",6.2,0,29,-1,24,21.4,0,2,-1,0,-1,1,0,0
"329",2019-01-16,"w1819","Wed","weekday","no_sled",35,"4","4","3",6.3,0.1,29,0,26,21.7,-1,0,2,-1,-1,-1,1,0
"330",2019-01-16,"w1819","Wed","weekday","sled",2,"4","4","3",6.3,0.1,29,0,26,21.7,-1,0,2,-1,-1,-1,1,0
"331",2019-01-17,"w1819","Thu","weekday","no_sled",63,"3","3","2",7,0.7,38,9,28,18.4,0,-1,0,2,9,8,8,10
"332",2019-01-17,"w1819","Thu","weekday","sled",31,"3","3","2",7,0.7,38,9,28,18.4,0,-1,0,2,9,8,8,10
"333",2019-01-18,"w1819","Fri","weekday","no_sled",24,"4","4","4",7.5,0.5,41,3,22,18.3,9,0,-1,0,12,12,11,11
"334",2019-01-18,"w1819","Fri","weekday","sled",10,"4","4","4",7.5,0.5,41,3,22,18.3,9,0,-1,0,12,12,11,11
"335",2019-01-19,"w1819","Sat","weekend","no_sled",119,"3","3","3",7.8,0.3,43,2,20,18.1,3,9,0,-1,5,14,14,13
"336",2019-01-19,"w1819","Sat","weekend","sled",89,"3","3","3",7.8,0.3,43,2,20,18.1,3,9,0,-1,5,14,14,13
"337",2019-01-20,"w1819","Sun","weekend","no_sled",145,"3","3","3",7.9,0.1,41,-2,27,19.3,2,3,9,0,0,3,12,12
"338",2019-01-20,"w1819","Sun","weekend","sled",118,"3","3","3",7.9,0.1,41,-2,27,19.3,2,3,9,0,0,3,12,12
"339",2019-01-21,"w1819","Mon","weekday","no_sled",2,"3","3","3",7.9,0,39,-2,23,20.3,-2,2,3,9,-4,-2,1,10
"340",2019-01-21,"w1819","Mon","weekday","sled",15,"3","3","3",7.9,0,39,-2,23,20.3,-2,2,3,9,-4,-2,1,10
"341",2019-01-22,"w1819","Tue","weekday","no_sled",110,"3","3","3",8,0.1,41,2,12,19.5,-2,-2,2,3,0,-2,0,3
"342",2019-01-22,"w1819","Tue","weekday","sled",12,"3","3","3",8,0.1,41,2,12,19.5,-2,-2,2,3,0,-2,0,3
"343",2019-01-23,"w1819","Wed","weekday","no_sled",86,"3","3","2",8,0,40,-1,14,20,2,-2,-2,2,1,-1,-3,-1
"344",2019-01-23,"w1819","Wed","weekday","sled",10,"3","3","2",8,0,40,-1,14,20,2,-2,-2,2,1,-1,-3,-1
"345",2019-01-24,"w1819","Thu","weekday","no_sled",74,"3","3","2",8.2,0.2,40,0,17,20.5,-1,2,-2,-2,-1,1,-1,-3
"346",2019-01-24,"w1819","Thu","weekday","sled",3,"3","3","2",8.2,0.2,40,0,17,20.5,-1,2,-2,-2,-1,1,-1,-3
"347",2019-01-25,"w1819","Fri","weekday","no_sled",215,"3","3","2",8.3,0.1,40,0,15,20.8,0,-1,2,-2,0,-1,1,-1
"348",2019-01-25,"w1819","Fri","weekday","sled",18,"3","3","2",8.3,0.1,40,0,15,20.8,0,-1,2,-2,0,-1,1,-1
"349",2019-01-26,"w1819","Sat","weekend","no_sled",338,"3","3","2",8.3,0,39,-1,19,21.3,0,0,-1,2,-1,-1,-2,0
"350",2019-01-26,"w1819","Sat","weekend","sled",40,"3","3","2",8.3,0,39,-1,19,21.3,0,0,-1,2,-1,-1,-2,0
"351",2019-01-27,"w1819","Sun","weekend","no_sled",213,"3","3","2",8.3,0,38,-1,24,21.8,-1,0,0,-1,-2,-2,-2,-3
"352",2019-01-27,"w1819","Sun","weekend","sled",14,"3","3","2",8.3,0,38,-1,24,21.8,-1,0,0,-1,-2,-2,-2,-3
"353",2019-01-28,"w1819","Mon","weekday","no_sled",31,"2","2","2",8.3,0,38,0,17,21.8,-1,-1,0,0,-1,-2,-2,-2
"354",2019-01-28,"w1819","Mon","weekday","sled",6,"2","2","2",8.3,0,38,0,17,21.8,-1,-1,0,0,-1,-2,-2,-2
"355",2019-01-29,"w1819","Tue","weekday","no_sled",53,"2","2","2",8.3,0,38,0,16,21.8,0,-1,-1,0,0,-1,-2,-2
"356",2019-01-29,"w1819","Tue","weekday","sled",82,"2","2","2",8.3,0,38,0,16,21.8,0,-1,-1,0,0,-1,-2,-2
"357",2019-01-30,"w1819","Wed","weekday","no_sled",57,"2","2","1",8.3,0,37,-1,20,22.4,0,0,-1,-1,-1,-1,-2,-3
"358",2019-01-30,"w1819","Wed","weekday","sled",91,"2","2","1",8.3,0,37,-1,20,22.4,0,0,-1,-1,-1,-1,-2,-3
"359",2019-01-31,"w1819","Thu","weekday","no_sled",62,"2","2","1",8.3,0,36,-1,24,23.1,-1,0,0,-1,-2,-2,-2,-3
"360",2019-01-31,"w1819","Thu","weekday","sled",112,"2","2","1",8.3,0,36,-1,24,23.1,-1,0,0,-1,-2,-2,-2,-3
"361",2019-02-01,"w1819","Fri","weekday","no_sled",118,"2","2","1",8.3,0,36,0,25,23.1,-1,-1,0,0,-1,-2,-2,-2
"362",2019-02-01,"w1819","Fri","weekday","sled",109,"2","2","1",8.3,0,36,0,25,23.1,-1,-1,0,0,-1,-2,-2,-2
"363",2019-02-02,"w1819","Sat","weekend","no_sled",339,"2","2","1",8.3,0,36,0,26,23.1,0,-1,-1,0,0,-1,-2,-2
"364",2019-02-02,"w1819","Sat","weekend","sled",153,"2","2","1",8.3,0,36,0,26,23.1,0,-1,-1,0,0,-1,-2,-2
"365",2019-02-03,"w1819","Sun","weekend","no_sled",130,"3","3","2",8.4,0.1,36,0,28,23.3,0,0,-1,-1,0,0,-1,-2
"366",2019-02-03,"w1819","Sun","weekend","sled",78,"3","3","2",8.4,0.1,36,0,28,23.3,0,0,-1,-1,0,0,-1,-2
"367",2019-02-04,"w1819","Mon","weekday","no_sled",105,"3","3","2",8.8,0.4,39,3,28,22.6,0,0,0,-1,3,3,3,2
"368",2019-02-04,"w1819","Mon","weekday","sled",98,"3","3","2",8.8,0.4,39,3,28,22.6,0,0,0,-1,3,3,3,2
"369",2019-02-05,"w1819","Tue","weekday","no_sled",94,"3","2","2",9,0.2,40,1,26,22.5,3,0,0,0,4,4,4,4
"370",2019-02-05,"w1819","Tue","weekday","sled",67,"3","2","2",9,0.2,40,1,26,22.5,3,0,0,0,4,4,4,4
"371",2019-02-06,"w1819","Wed","weekday","no_sled",51,"4","4","3",9,0,40,0,16,22.5,1,3,0,0,1,4,4,4
"372",2019-02-06,"w1819","Wed","weekday","sled",9,"4","4","3",9,0,40,0,16,22.5,1,3,0,0,1,4,4,4
"373",2019-02-07,"w1819","Thu","weekday","no_sled",65,"3","3","2",9.2,0.2,43,3,4,21.4,0,1,3,0,3,4,7,7
"374",2019-02-07,"w1819","Thu","weekday","sled",35,"3","3","2",9.2,0.2,43,3,4,21.4,0,1,3,0,3,4,7,7
"375",2019-02-08,"w1819","Fri","weekday","no_sled",125,"3","2","2",9.2,0,42,-1,10,21.9,3,0,1,3,2,2,3,6
"376",2019-02-08,"w1819","Fri","weekday","sled",73,"3","2","2",9.2,0,42,-1,10,21.9,3,0,1,3,2,2,3,6
"377",2019-02-09,"w1819","Sat","weekend","no_sled",247,"3","2","2",9.2,0,41,-1,20,22.4,-1,3,0,1,-2,1,1,2
"378",2019-02-09,"w1819","Sat","weekend","sled",27,"3","2","2",9.2,0,41,-1,20,22.4,-1,3,0,1,-2,1,1,2
"379",2019-02-10,"w1819","Sun","weekend","no_sled",230,"2","2","2",9.3,0.1,40,-1,20,23.2,-1,-1,3,0,-2,-3,0,0
"380",2019-02-10,"w1819","Sun","weekend","sled",36,"2","2","2",9.3,0.1,40,-1,20,23.2,-1,-1,3,0,-2,-3,0,0
"381",2019-02-11,"w1819","Mon","weekday","no_sled",89,"2","2","1",9.3,0,40,0,15,23.2,-1,-1,-1,3,-1,-2,-3,0
"382",2019-02-11,"w1819","Mon","weekday","sled",12,"2","2","1",9.3,0,40,0,15,23.2,-1,-1,-1,3,-1,-2,-3,0
"383",2019-02-12,"w1819","Tue","weekday","no_sled",133,"2","2","1",9.3,0,40,0,18,23.2,0,-1,-1,-1,0,-1,-2,-3
"384",2019-02-12,"w1819","Tue","weekday","sled",34,"2","2","1",9.3,0,40,0,18,23.2,0,-1,-1,-1,0,-1,-2,-3
"385",2019-02-13,"w1819","Wed","weekday","no_sled",101,"2","2","1",9.4,0.1,40,0,26,23.5,0,0,-1,-1,0,0,-1,-2
"386",2019-02-13,"w1819","Wed","weekday","sled",55,"2","2","1",9.4,0.1,40,0,26,23.5,0,0,-1,-1,0,0,-1,-2
"387",2019-02-14,"w1819","Thu","weekday","no_sled",64,"3","2","2",9.7,0.3,41,1,29,23.7,0,0,0,-1,1,1,1,0
"388",2019-02-14,"w1819","Thu","weekday","sled",22,"3","2","2",9.7,0.3,41,1,29,23.7,0,0,0,-1,1,1,1,0
"389",2019-02-15,"w1819","Fri","weekday","no_sled",80,"4","4","3",10.8,1.1,51,10,27,21.2,1,0,0,0,11,11,11,11
"390",2019-02-15,"w1819","Fri","weekday","sled",46,"4","4","3",10.8,1.1,51,10,27,21.2,1,0,0,0,11,11,11,11
"391",2019-02-16,"w1819","Sat","weekend","no_sled",3,"3","3","3",11.1,0.3,52,1,14,21.3,10,1,0,0,11,12,12,12
"392",2019-02-16,"w1819","Sat","weekend","sled",0,"3","3","3",11.1,0.3,52,1,14,21.3,10,1,0,0,11,12,12,12
"393",2019-02-17,"w1819","Sun","weekend","no_sled",76,"3","3","3",11.3,0.2,55,3,10,20.5,1,10,1,0,4,14,15,15
"394",2019-02-17,"w1819","Sun","weekend","sled",128,"3","3","3",11.3,0.2,55,3,10,20.5,1,10,1,0,4,14,15,15
"395",2019-02-18,"w1819","Mon","weekday","no_sled",37,"3","3","2",11.4,0.1,53,-2,13,21.5,3,1,10,1,1,2,12,13
"396",2019-02-18,"w1819","Mon","weekday","sled",85,"3","3","2",11.4,0.1,53,-2,13,21.5,3,1,10,1,1,2,12,13
"397",2019-02-19,"w1819","Tue","weekday","no_sled",13,"3","3","2",11.5,0.1,53,0,11,21.7,-2,3,1,10,-2,1,2,12
"398",2019-02-19,"w1819","Tue","weekday","sled",1,"3","3","2",11.5,0.1,53,0,11,21.7,-2,3,1,10,-2,1,2,12
"399",2019-02-20,"w1819","Wed","weekday","no_sled",15,"3","3","2",11.6,0.1,53,0,7,21.9,0,-2,3,1,0,-2,1,2
"400",2019-02-20,"w1819","Wed","weekday","sled",0,"3","3","2",11.6,0.1,53,0,7,21.9,0,-2,3,1,0,-2,1,2
"401",2019-02-21,"w1819","Thu","weekday","no_sled",24,"3","3","3",11.6,0,52,-1,15,22.3,0,0,-2,3,-1,-1,-3,0
"402",2019-02-21,"w1819","Thu","weekday","sled",0,"3","3","3",11.6,0,52,-1,15,22.3,0,0,-2,3,-1,-1,-3,0
"403",2019-02-22,"w1819","Fri","weekday","no_sled",50,"3","3","3",11.8,0.2,52,0,20,22.7,-1,0,0,-2,-1,-1,-1,-3
"404",2019-02-22,"w1819","Fri","weekday","sled",10,"3","3","3",11.8,0.2,52,0,20,22.7,-1,0,0,-2,-1,-1,-1,-3
"405",2019-02-23,"w1819","Sat","weekend","no_sled",449,"3","3","3",12.1,0.3,53,1,13,22.8,0,-1,0,0,1,0,0,0
"406",2019-02-23,"w1819","Sat","weekend","sled",119,"3","3","3",12.1,0.3,53,1,13,22.8,0,-1,0,0,1,0,0,0
"407",2019-02-24,"w1819","Sun","weekend","no_sled",232,"3","3","2",12.1,0,52,-1,14,23.3,1,0,-1,0,0,0,-1,-1
"408",2019-02-24,"w1819","Sun","weekend","sled",34,"3","3","2",12.1,0,52,-1,14,23.3,1,0,-1,0,0,0,-1,-1
"409",2019-02-25,"w1819","Mon","weekday","no_sled",134,"3","3","2",12.1,0,51,-1,22,23.7,-1,1,0,-1,-2,-1,-1,-2
"410",2019-02-25,"w1819","Mon","weekday","sled",37,"3","3","2",12.1,0,51,-1,22,23.7,-1,1,0,-1,-2,-1,-1,-2
"411",2019-02-26,"w1819","Tue","weekday","no_sled",182,"2","2","2",12.1,0,50,-1,27,24.2,-1,-1,1,0,-2,-3,-2,-2
"412",2019-02-26,"w1819","Tue","weekday","sled",112,"2","2","2",12.1,0,50,-1,27,24.2,-1,-1,1,0,-2,-3,-2,-2
"413",2019-02-27,"w1819","Wed","weekday","no_sled",192,"2","2","2",12.1,0,50,0,30,24.2,-1,-1,-1,1,-1,-2,-3,-2
"414",2019-02-27,"w1819","Wed","weekday","sled",125,"2","2","2",12.1,0,50,0,30,24.2,-1,-1,-1,1,-1,-2,-3,-2
"415",2019-02-28,"w1819","Thu","weekday","no_sled",169,"2","2","2",12.2,0.1,49,-1,30,24.9,0,-1,-1,-1,-1,-2,-3,-4
"416",2019-02-28,"w1819","Thu","weekday","sled",76,"2","2","2",12.2,0.1,49,-1,30,24.9,0,-1,-1,-1,-1,-2,-3,-4
"417",2019-03-01,"w1819","Fri","weekday","no_sled",60,"2","2","1",12.3,0.1,49,0,29,25.1,-1,0,-1,-1,-1,-1,-2,-3
"418",2019-03-01,"w1819","Fri","weekday","sled",38,"2","2","1",12.3,0.1,49,0,29,25.1,-1,0,-1,-1,-1,-1,-2,-3
"419",2019-03-02,"w1819","Sat","weekend","no_sled",111,"3","3","2",13,0.7,58,9,30,22.4,0,-1,0,-1,9,8,8,7
"420",2019-03-02,"w1819","Sat","weekend","sled",124,"3","3","2",13,0.7,58,9,30,22.4,0,-1,0,-1,9,8,8,7
"421",2019-03-03,"w1819","Sun","weekend","no_sled",22,"3","3","3",13.7,0.7,64,6,27,21.4,9,0,-1,0,15,15,14,14
"422",2019-03-03,"w1819","Sun","weekend","sled",49,"3","3","3",13.7,0.7,64,6,27,21.4,9,0,-1,0,15,15,14,14
"423",2019-03-04,"w1819","Mon","weekday","no_sled",42,"3","3","3",14.4,0.7,66,2,23,21.8,6,9,0,-1,8,17,17,16
"424",2019-03-04,"w1819","Mon","weekday","sled",31,"3","3","3",14.4,0.7,66,2,23,21.8,6,9,0,-1,8,17,17,16
"425",2019-03-05,"w1819","Tue","weekday","no_sled",88,"3","3","3",14.4,0,64,-2,24,22.5,2,6,9,0,0,6,15,15
"426",2019-03-05,"w1819","Tue","weekday","sled",126,"3","3","3",14.4,0,64,-2,24,22.5,2,6,9,0,0,6,15,15
"427",2019-03-06,"w1819","Wed","weekday","no_sled",36,"3","3","2",14.5,0.1,62,-2,31,23.4,-2,2,6,9,-4,-2,4,13
"428",2019-03-06,"w1819","Wed","weekday","no_sled",36,"4","4","3",14.5,0.1,62,-2,31,23.4,-2,2,6,9,-4,-2,4,13
"429",2019-03-06,"w1819","Wed","weekday","sled",87,"3","3","2",14.5,0.1,62,-2,31,23.4,-2,2,6,9,-4,-2,4,13
"430",2019-03-06,"w1819","Wed","weekday","sled",87,"4","4","3",14.5,0.1,62,-2,31,23.4,-2,2,6,9,-4,-2,4,13
"431",2019-03-07,"w1819","Thu","weekday","no_sled",9,"4","4","3",16.2,1.7,71,9,30,22.8,-2,-2,2,6,7,5,7,13
"432",2019-03-07,"w1819","Thu","weekday","sled",0,"4","4","3",16.2,1.7,71,9,30,22.8,-2,-2,2,6,7,5,7,13
"433",2019-03-08,"w1819","Fri","weekday","no_sled",33,"3","3","3",16.6,0.4,71,0,27,23.4,9,-2,-2,2,9,7,5,7
"434",2019-03-08,"w1819","Fri","weekday","sled",14,"3","3","3",16.6,0.4,71,0,27,23.4,9,-2,-2,2,9,7,5,7
"435",2019-03-09,"w1819","Sat","weekend","no_sled",61,"4","4","3",17.2,0.6,76,5,22,22.6,0,9,-2,-2,5,14,12,10
"436",2019-03-09,"w1819","Sat","weekend","sled",35,"4","4","3",17.2,0.6,76,5,22,22.6,0,9,-2,-2,5,14,12,10
"437",2019-03-10,"w1819","Sun","weekend","no_sled",130,"3","3","3",17.3,0.1,73,-3,25,23.7,5,0,9,-2,2,2,11,9
"438",2019-03-10,"w1819","Sun","weekend","sled",85,"3","3","3",17.3,0.1,73,-3,25,23.7,5,0,9,-2,2,2,11,9
"439",2019-03-11,"w1819","Mon","weekday","no_sled",75,"3","3","2",17.3,0,71,-2,29,24.4,-3,5,0,9,-5,0,0,9
"440",2019-03-11,"w1819","Mon","weekday","sled",92,"3","3","2",17.3,0,71,-2,29,24.4,-3,5,0,9,-5,0,0,9
"441",2019-03-12,"w1819","Tue","weekday","no_sled",72,"3","3","3",17.4,0.1,70,-1,32,24.9,-2,-3,5,0,-3,-6,-1,-1
"442",2019-03-12,"w1819","Tue","weekday","no_sled",72,"4","4","4",17.4,0.1,70,-1,32,24.9,-2,-3,5,0,-3,-6,-1,-1
"443",2019-03-12,"w1819","Tue","weekday","sled",76,"3","3","3",17.4,0.1,70,-1,32,24.9,-2,-3,5,0,-3,-6,-1,-1
"444",2019-03-12,"w1819","Tue","weekday","sled",76,"4","4","4",17.4,0.1,70,-1,32,24.9,-2,-3,5,0,-3,-6,-1,-1
"445",2019-03-13,"w1819","Wed","weekday","no_sled",22,"4","4","3",18.1,0.7,74,4,24,24.5,-1,-2,-3,5,3,1,-2,3
"446",2019-03-13,"w1819","Wed","weekday","sled",0,"4","4","3",18.1,0.7,74,4,24,24.5,-1,-2,-3,5,3,1,-2,3
"447",2019-03-14,"w1819","Thu","weekday","no_sled",48,"4","4","3",18.1,0,74,0,17,24.5,4,-1,-2,-3,4,3,1,-2
"448",2019-03-14,"w1819","Thu","weekday","sled",7,"4","4","3",18.1,0,74,0,17,24.5,4,-1,-2,-3,4,3,1,-2
"449",2019-03-15,"w1819","Fri","weekday","no_sled",115,"3","3","2",18.1,0,72,-2,18,25.1,0,4,-1,-2,-2,2,1,-1
"450",2019-03-15,"w1819","Fri","weekday","sled",53,"3","3","2",18.1,0,72,-2,18,25.1,0,4,-1,-2,-2,2,1,-1
"451",2019-03-16,"w1819","Sat","weekend","no_sled",272,"3","3","2",18.2,0.1,70,-2,26,26,-2,0,4,-1,-4,-4,0,-1
"452",2019-03-16,"w1819","Sat","weekend","sled",144,"3","3","2",18.2,0.1,70,-2,26,26,-2,0,4,-1,-4,-4,0,-1
"453",2019-03-17,"w1819","Sun","weekend","no_sled",268,"3","3","2",18.2,0,69,-1,28,26.4,-2,-2,0,4,-3,-5,-5,-1
"454",2019-03-17,"w1819","Sun","weekend","sled",140,"3","3","2",18.2,0,69,-1,28,26.4,-2,-2,0,4,-3,-5,-5,-1
"455",2019-03-18,"w1819","Mon","weekday","no_sled",120,"2","2","2",18.3,0.1,68,-1,29,26.9,-1,-2,-2,0,-2,-4,-6,-6
"456",2019-03-18,"w1819","Mon","weekday","sled",106,"2","2","2",18.3,0.1,68,-1,29,26.9,-1,-2,-2,0,-2,-4,-6,-6
"457",2019-03-19,"w1819","Tue","weekday","no_sled",75,"2","2","2",18.3,0,67,-1,28,27.3,-1,-1,-2,-2,-2,-3,-5,-7
"458",2019-03-19,"w1819","Tue","weekday","sled",147,"2","2","2",18.3,0,67,-1,28,27.3,-1,-1,-2,-2,-2,-3,-5,-7
"459",2019-03-20,"w1819","Wed","weekday","no_sled",106,"2","2","2",18.3,0,66,-1,30,27.7,-1,-1,-1,-2,-2,-3,-4,-6
"460",2019-03-20,"w1819","Wed","weekday","sled",199,"2","2","2",18.3,0,66,-1,30,27.7,-1,-1,-1,-2,-2,-3,-4,-6
"461",2019-03-21,"w1819","Thu","weekday","no_sled",101,"2","2","2",18.4,0.1,65,-1,33,28.3,-1,-1,-1,-1,-2,-3,-4,-5
"462",2019-03-21,"w1819","Thu","weekday","sled",180,"2","2","2",18.4,0.1,65,-1,33,28.3,-1,-1,-1,-1,-2,-3,-4,-5
"463",2019-03-22,"w1819","Fri","weekday","no_sled",88,"3","3","2",18.4,0,64,-1,28,28.8,-1,-1,-1,-1,-2,-3,-4,-5
"464",2019-03-22,"w1819","Fri","weekday","sled",63,"3","3","2",18.4,0,64,-1,28,28.8,-1,-1,-1,-1,-2,-3,-4,-5
"465",2019-03-23,"w1819","Sat","weekend","no_sled",183,"2","2","1",18.4,0,65,1,28,28.3,-1,-1,-1,-1,0,-1,-2,-3
"466",2019-03-23,"w1819","Sat","weekend","sled",161,"2","2","1",18.4,0,65,1,28,28.3,-1,-1,-1,-1,0,-1,-2,-3
"467",2019-03-24,"w1819","Sun","weekend","no_sled",122,"2","2","1",18.4,0,64,-1,29,28.8,1,-1,-1,-1,0,-1,-2,-3
"468",2019-03-24,"w1819","Sun","weekend","sled",85,"2","2","1",18.4,0,64,-1,29,28.8,1,-1,-1,-1,0,-1,-2,-3
"469",2019-03-25,"w1819","Mon","weekday","no_sled",89,"2","2","2",18.6,0.2,64,0,31,29.1,-1,1,-1,-1,-1,0,-1,-2
"470",2019-03-25,"w1819","Mon","weekday","sled",149,"2","2","2",18.6,0.2,64,0,31,29.1,-1,1,-1,-1,-1,0,-1,-2
"471",2019-03-26,"w1819","Tue","weekday","no_sled",169,"2","2","2",18.9,0.3,63,-1,36,30,0,-1,1,-1,-1,-2,-1,-2
"472",2019-03-26,"w1819","Tue","weekday","sled",80,"2","2","2",18.9,0.3,63,-1,36,30,0,-1,1,-1,-1,-2,-1,-2
"473",2019-03-27,"w1819","Wed","weekday","no_sled",170,"1","2","2",18.9,0,62,-1,42,30.5,-1,0,-1,1,-2,-2,-3,-2
"474",2019-03-27,"w1819","Wed","weekday","sled",93,"1","2","2",18.9,0,62,-1,42,30.5,-1,0,-1,1,-2,-2,-3,-2
"475",2019-03-28,"w1819","Thu","weekday","no_sled",125,"1","2","2",18.9,0,60,-2,40,31.5,-1,-1,0,-1,-3,-4,-4,-5
"476",2019-03-28,"w1819","Thu","weekday","sled",105,"1","2","2",18.9,0,60,-2,40,31.5,-1,-1,0,-1,-3,-4,-4,-5
"477",2019-03-29,"w1819","Fri","weekday","no_sled",126,"1","1","1",19,0.1,58,-2,26,32.8,-2,-1,-1,0,-4,-5,-6,-6
"478",2019-03-29,"w1819","Fri","weekday","sled",30,"1","1","1",19,0.1,58,-2,26,32.8,-2,-1,-1,0,-4,-5,-6,-6
"479",2019-03-30,"w1819","Sat","weekend","no_sled",280,"1","1","1",19.1,0.1,61,3,24,31.3,-2,-2,-1,-1,1,-1,-2,-3
"480",2019-03-30,"w1819","Sat","weekend","sled",127,"1","1","1",19.1,0.1,61,3,24,31.3,-2,-2,-1,-1,1,-1,-2,-3
"481",2019-03-31,"w1819","Sun","weekend","no_sled",126,"1","1","1",19.1,0,59,-2,24,32.4,3,-2,-2,-1,1,-1,-3,-4
"482",2019-03-31,"w1819","Sun","weekend","sled",127,"1","1","1",19.1,0,59,-2,24,32.4,3,-2,-2,-1,1,-1,-3,-4
"483",2019-04-01,"w1819","Mon","weekday","no_sled",85,"2","1","1",19.1,0,58,-1,29,32.9,-2,3,-2,-2,-3,0,-2,-4
"484",2019-04-01,"w1819","Mon","weekday","sled",116,"2","1","1",19.1,0,58,-1,29,32.9,-2,3,-2,-2,-3,0,-2,-4
"485",2019-04-02,"w1819","Tue","weekday","no_sled",61,"1","1","1",19.1,0,58,0,33,32.9,-1,-2,3,-2,-1,-3,0,-2
"486",2019-04-02,"w1819","Tue","weekday","sled",60,"1","1","1",19.1,0,58,0,33,32.9,-1,-2,3,-2,-1,-3,0,-2
"487",2019-04-03,"w1819","Wed","weekday","no_sled",58,"2","1","1",19.2,0.1,58,0,31,33.1,0,-1,-2,3,0,-1,-3,0
"488",2019-04-03,"w1819","Wed","weekday","sled",75,"2","1","1",19.2,0.1,58,0,31,33.1,0,-1,-2,3,0,-1,-3,0
"489",2019-04-04,"w1819","Thu","weekday","no_sled",96,"2","1","1",19.4,0.2,59,1,35,32.9,0,0,-1,-2,1,1,0,-2
"490",2019-04-04,"w1819","Thu","weekday","sled",67,"2","1","1",19.4,0.2,59,1,35,32.9,0,0,-1,-2,1,1,0,-2
"491",2019-04-05,"w1819","Fri","weekday","no_sled",79,"1","1","1",19.4,0,57,-2,38,34,1,0,0,-1,-1,-1,-1,-2
"492",2019-04-05,"w1819","Fri","weekday","sled",63,"1","1","1",19.4,0,57,-2,38,34,1,0,0,-1,-1,-1,-1,-2
"493",2019-04-06,"w1819","Sat","weekend","no_sled",97,"1","1","1",19.3,-0.1,57,0,35,33.9,-2,1,0,0,-2,-1,-1,-1
"494",2019-04-06,"w1819","Sat","weekend","sled",92,"1","1","1",19.3,-0.1,57,0,35,33.9,-2,1,0,0,-2,-1,-1,-1
"495",2019-04-07,"w1819","Sun","weekend","no_sled",88,"1","1","1",19.1,-0.2,57,0,37,33.5,0,-2,1,0,0,-2,-1,-1
"496",2019-04-07,"w1819","Sun","weekend","sled",60,"1","1","1",19.1,-0.2,57,0,37,33.5,0,-2,1,0,0,-2,-1,-1
"497",2019-04-08,"w1819","Mon","weekday","no_sled",73,"1","2","2",19.3,0.2,54,-3,41,35.7,0,0,-2,1,-3,-3,-5,-4
"498",2019-04-08,"w1819","Mon","weekday","sled",68,"1","2","2",19.3,0.2,54,-3,41,35.7,0,0,-2,1,-3,-3,-5,-4
"499",2019-04-09,"w1819","Tue","weekday","no_sled",27,"1","2","2",19.3,0,53,-1,43,36.4,-3,0,0,-2,-4,-4,-4,-6
"500",2019-04-09,"w1819","Tue","weekday","sled",54,"1","2","2",19.3,0,53,-1,43,36.4,-3,0,0,-2,-4,-4,-4,-6
"501",2019-04-10,"w1819","Wed","weekday","no_sled",38,"2","2","1",19,-0.3,51,-2,30,37.3,-1,-3,0,0,-3,-6,-6,-6
"502",2019-04-10,"w1819","Wed","weekday","sled",19,"2","2","1",19,-0.3,51,-2,30,37.3,-1,-3,0,0,-3,-6,-6,-6
"503",2019-04-11,"w1819","Thu","weekday","no_sled",39,"3","3","2",18.9,-0.1,53,2,20,35.7,-2,-1,-3,0,0,-1,-4,-4
"504",2019-04-11,"w1819","Thu","weekday","sled",9,"3","3","2",18.9,-0.1,53,2,20,35.7,-2,-1,-3,0,0,-1,-4,-4
"505",2019-04-12,"w1819","Fri","weekday","no_sled",96,"2","2","1",18.7,-0.2,53,0,24,35.3,2,-2,-1,-3,2,0,-1,-4
"506",2019-04-12,"w1819","Fri","weekday","sled",52,"2","2","1",18.7,-0.2,53,0,24,35.3,2,-2,-1,-3,2,0,-1,-4
"507",2019-04-13,"w1819","Sat","weekend","no_sled",94,"1","1","1",18.8,0.1,52,-1,27,36.2,0,2,-2,-1,-1,1,-1,-2
"508",2019-04-13,"w1819","Sat","weekend","sled",115,"1","1","1",18.8,0.1,52,-1,27,36.2,0,2,-2,-1,-1,1,-1,-2
"509",2019-04-14,"w1819","Sun","weekend","no_sled",54,"1","1","1",18.7,-0.1,51,-1,35,36.7,-1,0,2,-2,-2,-2,0,-2
"510",2019-04-14,"w1819","Sun","weekend","sled",82,"1","1","1",18.7,-0.1,51,-1,35,36.7,-1,0,2,-2,-2,-2,0,-2
"511",2019-04-15,"w1819","Mon","weekday","no_sled",31,NA,NA,NA,18.6,-0.1,50,-1,41,37.2,-1,-1,0,2,-2,-3,-3,-1
"512",2019-04-15,"w1819","Mon","weekday","sled",30,NA,NA,NA,18.6,-0.1,50,-1,41,37.2,-1,-1,0,2,-2,-3,-3,-1
"513",2019-12-06,"w1920","Fri","weekday","no_sled",48,"2","2","1",2.9,0.4,19,5,24,15.3,0,0,0,0,5,5,5,5
"514",2019-12-06,"w1920","Fri","weekday","sled",19,"2","2","1",2.9,0.4,19,5,24,15.3,0,0,0,0,5,5,5,5
"515",2019-12-07,"w1920","Sat","weekend","no_sled",118,"2","2","1",3,0.1,18,-1,29,16.7,5,0,0,0,4,4,4,4
"516",2019-12-07,"w1920","Sat","weekend","sled",64,"2","2","1",3,0.1,18,-1,29,16.7,5,0,0,0,4,4,4,4
"517",2019-12-08,"w1920","Sun","weekend","no_sled",103,"2","2","1",3,0,17,-1,28,17.6,-1,5,0,0,-2,3,3,3
"518",2019-12-08,"w1920","Sun","weekend","sled",27,"2","2","1",3,0,17,-1,28,17.6,-1,5,0,0,-2,3,3,3
"519",2019-12-09,"w1920","Mon","weekday","no_sled",37,"3","3","2",3.4,0.4,22,5,21,15.5,-1,-1,5,0,4,3,8,8
"520",2019-12-09,"w1920","Mon","weekday","sled",52,"3","3","2",3.4,0.4,22,5,21,15.5,-1,-1,5,0,4,3,8,8
"521",2019-12-10,"w1920","Tue","weekday","no_sled",66,"2","2","2",3.4,0,21,-1,19,16.2,5,-1,-1,5,4,3,2,7
"522",2019-12-10,"w1920","Tue","weekday","sled",47,"2","2","2",3.4,0,21,-1,19,16.2,5,-1,-1,5,4,3,2,7
"523",2019-12-11,"w1920","Wed","weekday","no_sled",57,"2","2","2",3.4,0,20,-1,22,17,-1,5,-1,-1,-2,3,2,1
"524",2019-12-11,"w1920","Wed","weekday","sled",50,"2","2","2",3.4,0,20,-1,22,17,-1,5,-1,-1,-2,3,2,1
"525",2019-12-12,"w1920","Thu","weekday","no_sled",49,"2","2","2",3.4,0,19,-1,25,17.9,-1,-1,5,-1,-2,-3,2,1
"526",2019-12-12,"w1920","Thu","weekday","sled",36,"2","2","2",3.4,0,19,-1,25,17.9,-1,-1,5,-1,-2,-3,2,1
"527",2019-12-13,"w1920","Fri","weekday","no_sled",33,"2","2","2",3.8,0.4,21,2,24,18.1,-1,-1,-1,5,1,0,-1,4
"528",2019-12-13,"w1920","Fri","weekday","sled",41,"2","2","2",3.8,0.4,21,2,24,18.1,-1,-1,-1,5,1,0,-1,4
"529",2019-12-14,"w1920","Sat","weekend","no_sled",44,"3","3","3",4.2,0.4,27,6,25,15.6,2,-1,-1,-1,8,7,6,5
"530",2019-12-14,"w1920","Sat","weekend","sled",37,"3","3","3",4.2,0.4,27,6,25,15.6,2,-1,-1,-1,8,7,6,5
"531",2019-12-15,"w1920","Sun","weekend","no_sled",94,"3","3","2",4.8,0.6,31,4,17,15.5,6,2,-1,-1,10,12,11,10
"532",2019-12-15,"w1920","Sun","weekend","sled",77,"3","3","2",4.8,0.6,31,4,17,15.5,6,2,-1,-1,10,12,11,10
"533",2019-12-16,"w1920","Mon","weekday","no_sled",41,"3","3","2",4.8,0,29,-2,6,16.6,4,6,2,-1,2,8,10,9
"534",2019-12-16,"w1920","Mon","weekday","sled",81,"3","3","2",4.8,0,29,-2,6,16.6,4,6,2,-1,2,8,10,9
"535",2019-12-17,"w1920","Tue","weekday","no_sled",28,"2","2","1",4.8,0,27,-2,8,17.8,-2,4,6,2,-4,0,6,8
"536",2019-12-17,"w1920","Tue","weekday","sled",39,"2","2","1",4.8,0,27,-2,8,17.8,-2,4,6,2,-4,0,6,8
"537",2019-12-18,"w1920","Wed","weekday","no_sled",50,"2","2","1",4.8,0,26,-1,20,18.5,-2,-2,4,6,-3,-5,-1,5
"538",2019-12-18,"w1920","Wed","weekday","sled",64,"2","2","1",4.8,0,26,-1,20,18.5,-2,-2,4,6,-3,-5,-1,5
"539",2019-12-19,"w1920","Thu","weekday","no_sled",51,"2","2","1",4.9,0.1,25,-1,21,19.6,-1,-2,-2,4,-2,-4,-6,-2
"540",2019-12-19,"w1920","Thu","weekday","sled",65,"2","2","1",4.9,0.1,25,-1,21,19.6,-1,-2,-2,4,-2,-4,-6,-2
"541",2019-12-20,"w1920","Fri","weekday","no_sled",52,"2","2","1",4.9,0,24,-1,21,20.4,-1,-1,-2,-2,-2,-3,-5,-7
"542",2019-12-20,"w1920","Fri","weekday","sled",75,"2","2","1",4.9,0,24,-1,21,20.4,-1,-1,-2,-2,-2,-3,-5,-7
"543",2019-12-21,"w1920","Sat","weekend","no_sled",113,"2","2","1",4.9,0,24,0,27,20.4,-1,-1,-1,-2,-1,-2,-3,-5
"544",2019-12-21,"w1920","Sat","weekend","sled",114,"2","2","1",4.9,0,24,0,27,20.4,-1,-1,-1,-2,-1,-2,-3,-5
"545",2019-12-22,"w1920","Sun","weekend","no_sled",128,"2","2","1",5,0.1,23,-1,31,21.7,0,-1,-1,-1,-1,-2,-3,-4
"546",2019-12-22,"w1920","Sun","weekend","sled",41,"2","2","1",5,0.1,23,-1,31,21.7,0,-1,-1,-1,-1,-2,-3,-4
"547",2019-12-23,"w1920","Mon","weekday","no_sled",91,"2","1","1",5,0,23,0,34,21.7,-1,0,-1,-1,-1,-1,-2,-3
"548",2019-12-23,"w1920","Mon","weekday","sled",128,"2","1","1",5,0,23,0,34,21.7,-1,0,-1,-1,-1,-1,-2,-3
"549",2019-12-24,"w1920","Tue","weekday","no_sled",113,"2","1","1",5,0,22,-1,30,22.7,0,-1,0,-1,-1,-2,-2,-3
"550",2019-12-24,"w1920","Tue","weekday","sled",155,"2","1","1",5,0,22,-1,30,22.7,0,-1,0,-1,-1,-2,-2,-3
"551",2019-12-25,"w1920","Wed","weekday","no_sled",132,"2","2","2",5,0,23,1,22,21.7,-1,0,-1,0,0,0,-1,-1
"552",2019-12-25,"w1920","Wed","weekday","sled",165,"2","2","2",5,0,23,1,22,21.7,-1,0,-1,0,0,0,-1,-1
"553",2019-12-26,"w1920","Thu","weekday","no_sled",142,"2","2","1",5,0,23,0,17,21.7,1,-1,0,-1,1,0,0,-1
"554",2019-12-26,"w1920","Thu","weekday","sled",226,"2","2","1",5,0,23,0,17,21.7,1,-1,0,-1,1,0,0,-1
"555",2019-12-27,"w1920","Fri","weekday","no_sled",117,"3","3","2",5.1,0.1,24,1,22,21.2,0,1,-1,0,1,2,1,1
"556",2019-12-27,"w1920","Fri","weekday","sled",169,"3","3","2",5.1,0.1,24,1,22,21.2,0,1,-1,0,1,2,1,1
"557",2019-12-28,"w1920","Sat","weekend","no_sled",149,"3","3","2",5.6,0.5,30,6,16,18.7,1,0,1,-1,7,7,8,7
"558",2019-12-28,"w1920","Sat","weekend","sled",167,"3","3","2",5.6,0.5,30,6,16,18.7,1,0,1,-1,7,7,8,7
"559",2019-12-29,"w1920","Sun","weekend","no_sled",149,"3","3","2",5.6,0,29,-1,3,19.3,6,1,0,1,5,6,6,7
"560",2019-12-29,"w1920","Sun","weekend","sled",168,"3","3","2",5.6,0,29,-1,3,19.3,6,1,0,1,5,6,6,7
"561",2019-12-30,"w1920","Mon","weekday","no_sled",98,"3","3","2",5.6,0,28,-1,3,20,-1,6,1,0,-2,4,5,5
"562",2019-12-30,"w1920","Mon","weekday","sled",164,"3","3","2",5.6,0,28,-1,3,20,-1,6,1,0,-2,4,5,5
"563",2019-12-31,"w1920","Tue","weekday","no_sled",86,"2","2","1",5.6,0,28,0,13,20,-1,-1,6,1,-1,-2,4,5
"564",2019-12-31,"w1920","Tue","weekday","sled",180,"2","2","1",5.6,0,28,0,13,20,-1,-1,6,1,-1,-2,4,5
"565",2020-01-01,"w1920","Wed","weekday","no_sled",121,"2","1","1",5.6,0,27,-1,21,20.7,0,-1,-1,6,-1,-2,-3,3
"566",2020-01-01,"w1920","Wed","weekday","sled",96,"2","1","1",5.6,0,27,-1,21,20.7,0,-1,-1,6,-1,-2,-3,3
"567",2020-01-02,"w1920","Thu","weekday","no_sled",76,"3","3","2",5.9,0.3,29,2,16,20.3,-1,0,-1,-1,1,1,0,-1
"568",2020-01-02,"w1920","Thu","weekday","sled",130,"3","3","2",5.9,0.3,29,2,16,20.3,-1,0,-1,-1,1,1,0,-1
"569",2020-01-03,"w1920","Fri","weekday","no_sled",116,"3","2","1",5.9,0,31,2,19,19,2,-1,0,-1,4,3,3,2
"570",2020-01-03,"w1920","Fri","weekday","sled",143,"3","2","1",5.9,0,31,2,19,19,2,-1,0,-1,4,3,3,2
"571",2020-01-04,"w1920","Sat","weekend","no_sled",112,"2","2","1",5.9,0,30,-1,26,19.7,2,2,-1,0,1,3,2,2
"572",2020-01-04,"w1920","Sat","weekend","sled",92,"2","2","1",5.9,0,30,-1,26,19.7,2,2,-1,0,1,3,2,2
"573",2020-01-05,"w1920","Sun","weekend","no_sled",77,"2","2","1",5.9,0,28,-2,23,21.1,-1,2,2,-1,-3,-1,1,0
"574",2020-01-05,"w1920","Sun","weekend","sled",25,"2","2","1",5.9,0,28,-2,23,21.1,-1,2,2,-1,-3,-1,1,0
"575",2020-01-06,"w1920","Mon","weekday","no_sled",54,"2","2","1",5.9,0,28,0,15,21.1,-2,-1,2,2,-2,-3,-1,1
"576",2020-01-06,"w1920","Mon","weekday","sled",6,"2","2","1",5.9,0,28,0,15,21.1,-2,-1,2,2,-2,-3,-1,1
"577",2020-01-07,"w1920","Tue","weekday","no_sled",43,"2","1","1",5.9,0,28,0,22,21.1,0,-2,-1,2,0,-2,-3,-1
"578",2020-01-07,"w1920","Tue","weekday","sled",3,"2","1","1",5.9,0,28,0,22,21.1,0,-2,-1,2,0,-2,-3,-1
"579",2020-01-08,"w1920","Wed","weekday","no_sled",49,"2","1","1",6,0.1,28,0,23,21.4,0,0,-2,-1,0,0,-2,-3
"580",2020-01-08,"w1920","Wed","weekday","sled",0,"2","1","1",6,0.1,28,0,23,21.4,0,0,-2,-1,0,0,-2,-3
"581",2020-01-09,"w1920","Thu","weekday","no_sled",40,"2","1","1",6,0,27,-1,17,22.2,0,0,0,-2,-1,-1,-1,-3
"582",2020-01-09,"w1920","Thu","weekday","sled",1,"2","1","1",6,0,27,-1,17,22.2,0,0,0,-2,-1,-1,-1,-3
"583",2020-01-10,"w1920","Fri","weekday","no_sled",58,"2","1","1",6,0,29,2,11,20.7,-1,0,0,0,1,1,1,1
"584",2020-01-10,"w1920","Fri","weekday","sled",5,"2","1","1",6,0,29,2,11,20.7,-1,0,0,0,1,1,1,1
"585",2020-01-11,"w1920","Sat","weekend","no_sled",72,"2","1","1",6,0,29,0,12,20.7,2,-1,0,0,2,1,1,1
"586",2020-01-11,"w1920","Sat","weekend","sled",24,"2","1","1",6,0,29,0,12,20.7,2,-1,0,0,2,1,1,1
"587",2020-01-12,"w1920","Sun","weekend","no_sled",167,"2","1","1",6.1,0.1,29,0,13,21,0,2,-1,0,0,2,1,1
"588",2020-01-12,"w1920","Sun","weekend","sled",74,"2","1","1",6.1,0.1,29,0,13,21,0,2,-1,0,0,2,1,1
"589",2020-01-13,"w1920","Mon","weekday","no_sled",12,"2","2","1",6.2,0.1,29,0,16,21.4,0,0,2,-1,0,0,2,1
"590",2020-01-13,"w1920","Mon","weekday","sled",39,"2","2","1",6.2,0.1,29,0,16,21.4,0,0,2,-1,0,0,2,1
"591",2020-01-14,"w1920","Tue","weekday","no_sled",100,"3","2","1",6.6,0.4,34,5,23,19.4,0,0,0,2,5,5,5,7
"592",2020-01-14,"w1920","Tue","weekday","sled",44,"3","2","1",6.6,0.4,34,5,23,19.4,0,0,0,2,5,5,5,7
"593",2020-01-15,"w1920","Wed","weekday","no_sled",95,"3","2","1",6.7,0.1,32,-2,23,20.9,5,0,0,0,3,3,3,3
"594",2020-01-15,"w1920","Wed","weekday","sled",37,"3","2","1",6.7,0.1,32,-2,23,20.9,5,0,0,0,3,3,3,3
"595",2020-01-16,"w1920","Thu","weekday","no_sled",69,"2","2","1",6.7,0,31,-1,28,21.6,-2,5,0,0,-3,2,2,2
"596",2020-01-16,"w1920","Thu","weekday","sled",49,"2","2","1",6.7,0,31,-1,28,21.6,-2,5,0,0,-3,2,2,2
"597",2020-01-17,"w1920","Fri","weekday","no_sled",34,"2","2","1",6.8,0.1,29,-2,19,23.4,-1,-2,5,0,-3,-5,0,0
"598",2020-01-17,"w1920","Fri","weekday","sled",6,"2","2","1",6.8,0.1,29,-2,19,23.4,-1,-2,5,0,-3,-5,0,0
"599",2020-01-18,"w1920","Sat","weekend","no_sled",125,"2","2","2",7,0.2,34,5,16,20.6,-2,-1,-2,5,3,2,0,5
"600",2020-01-18,"w1920","Sat","weekend","sled",30,"2","2","2",7,0.2,34,5,16,20.6,-2,-1,-2,5,3,2,0,5
"601",2020-01-19,"w1920","Sun","weekend","no_sled",139,"2","2","1",7,0,33,-1,21,21.2,5,-2,-1,-2,4,2,1,-1
"602",2020-01-19,"w1920","Sun","weekend","sled",70,"2","2","1",7,0,33,-1,21,21.2,5,-2,-1,-2,4,2,1,-1
"603",2020-01-20,"w1920","Mon","weekday","no_sled",74,"2","2","1",7.1,0.1,32,-1,25,22.2,-1,5,-2,-1,-2,3,1,0
"604",2020-01-20,"w1920","Mon","weekday","sled",56,"2","2","1",7.1,0.1,32,-1,25,22.2,-1,5,-2,-1,-2,3,1,0
"605",2020-01-21,"w1920","Tue","weekday","no_sled",47,"2","2","1",7.1,0,31,-1,28,22.9,-1,-1,5,-2,-2,-3,2,0
"606",2020-01-21,"w1920","Tue","weekday","sled",33,"2","2","1",7.1,0,31,-1,28,22.9,-1,-1,5,-2,-2,-3,2,0
"607",2020-01-22,"w1920","Wed","weekday","no_sled",68,"2","2","2",7.3,0.2,32,1,25,22.8,-1,-1,-1,5,0,-1,-2,3
"608",2020-01-22,"w1920","Wed","weekday","sled",51,"2","2","2",7.3,0.2,32,1,25,22.8,-1,-1,-1,5,0,-1,-2,3
"609",2020-01-23,"w1920","Thu","weekday","no_sled",67,"3","2","2",7.3,0,34,2,23,21.5,1,-1,-1,-1,3,2,1,0
"610",2020-01-23,"w1920","Thu","weekday","sled",43,"3","2","2",7.3,0,34,2,23,21.5,1,-1,-1,-1,3,2,1,0
"611",2020-01-24,"w1920","Fri","weekday","no_sled",126,"2","2","1",7.3,0,33,-1,23,22.1,2,1,-1,-1,1,2,1,0
"612",2020-01-24,"w1920","Fri","weekday","sled",56,"2","2","1",7.3,0,33,-1,23,22.1,2,1,-1,-1,1,2,1,0
"613",2020-01-25,"w1920","Sat","weekend","no_sled",169,"2","2","1",7.4,0.1,32,-1,25,23.1,-1,2,1,-1,-2,0,1,0
"614",2020-01-25,"w1920","Sat","weekend","sled",93,"2","2","1",7.4,0.1,32,-1,25,23.1,-1,2,1,-1,-2,0,1,0
"615",2020-01-26,"w1920","Sun","weekend","no_sled",164,"2","1","1",7.4,0,32,0,28,23.1,-1,-1,2,1,-1,-2,0,1
"616",2020-01-26,"w1920","Sun","weekend","sled",76,"2","1","1",7.4,0,32,0,28,23.1,-1,-1,2,1,-1,-2,0,1
"617",2020-01-27,"w1920","Mon","weekday","no_sled",58,"2","1","1",7.4,0,32,0,24,23.1,0,-1,-1,2,0,-1,-2,0
"618",2020-01-27,"w1920","Mon","weekday","sled",33,"2","1","1",7.4,0,32,0,24,23.1,0,-1,-1,2,0,-1,-2,0
"619",2020-01-28,"w1920","Tue","weekday","no_sled",102,"3","2","2",7.4,0,32,0,19,23.1,0,0,-1,-1,0,0,-1,-2
"620",2020-01-28,"w1920","Tue","weekday","sled",59,"3","2","2",7.4,0,32,0,19,23.1,0,0,-1,-1,0,0,-1,-2
"621",2020-01-29,"w1920","Wed","weekday","no_sled",70,"2","2","1",7.4,0,31,-1,20,23.9,0,0,0,-1,-1,-1,-1,-2
"622",2020-01-29,"w1920","Wed","weekday","sled",62,"2","2","1",7.4,0,31,-1,20,23.9,0,0,0,-1,-1,-1,-1,-2
"623",2020-01-30,"w1920","Thu","weekday","no_sled",88,"2","2","1",7.4,0,31,0,17,23.9,-1,0,0,0,-1,-1,-1,-1
"624",2020-01-30,"w1920","Thu","weekday","sled",87,"2","2","1",7.4,0,31,0,17,23.9,-1,0,0,0,-1,-1,-1,-1
"625",2020-01-31,"w1920","Fri","weekday","no_sled",170,"2","1","1",7.4,0,31,0,20,23.9,0,-1,0,0,0,-1,-1,-1
"626",2020-01-31,"w1920","Fri","weekday","sled",60,"2","1","1",7.4,0,31,0,20,23.9,0,-1,0,0,0,-1,-1,-1
"627",2020-02-01,"w1920","Sat","weekend","no_sled",323,"2","1","1",7.4,0,31,0,28,23.9,0,0,-1,0,0,0,-1,-1
"628",2020-02-01,"w1920","Sat","weekend","sled",128,"2","1","1",7.4,0,31,0,28,23.9,0,0,-1,0,0,0,-1,-1
"629",2020-02-02,"w1920","Sun","weekend","no_sled",317,"1","1","1",7.4,0,31,0,33,23.9,0,0,0,-1,0,0,0,-1
"630",2020-02-02,"w1920","Sun","weekend","sled",104,"1","1","1",7.4,0,31,0,33,23.9,0,0,0,-1,0,0,0,-1
"631",2020-02-03,"w1920","Mon","weekday","no_sled",69,"2","2","1",7.4,0,31,0,24,23.9,0,0,0,0,0,0,0,0
"632",2020-02-03,"w1920","Mon","weekday","sled",55,"2","2","1",7.4,0,31,0,24,23.9,0,0,0,0,0,0,0,0
"633",2020-02-04,"w1920","Tue","weekday","no_sled",61,"2","2","2",7.4,0,33,2,5,22.4,0,0,0,0,2,2,2,2
"634",2020-02-04,"w1920","Tue","weekday","sled",42,"2","2","2",7.4,0,33,2,5,22.4,0,0,0,0,2,2,2,2
"635",2020-02-05,"w1920","Wed","weekday","no_sled",47,"2","2","1",7.4,0,33,0,2,22.4,2,0,0,0,2,2,2,2
"636",2020-02-05,"w1920","Wed","weekday","sled",54,"2","2","1",7.4,0,33,0,2,22.4,2,0,0,0,2,2,2,2
"637",2020-02-06,"w1920","Thu","weekday","no_sled",25,"2","2","1",7.5,0.1,32,-1,16,23.4,0,2,0,0,-1,1,1,1
"638",2020-02-06,"w1920","Thu","weekday","sled",46,"2","2","1",7.5,0.1,32,-1,16,23.4,0,2,0,0,-1,1,1,1
"639",2020-02-07,"w1920","Fri","weekday","no_sled",9,"3","3","3",7.9,0.4,37,5,26,21.4,-1,0,2,0,4,4,6,6
"640",2020-02-07,"w1920","Fri","weekday","sled",3,"3","3","3",7.9,0.4,37,5,26,21.4,-1,0,2,0,4,4,6,6
"641",2020-02-08,"w1920","Sat","weekend","no_sled",95,"3","3","2",8.3,0.4,39,2,30,21.3,5,-1,0,2,7,6,6,8
"642",2020-02-08,"w1920","Sat","weekend","sled",24,"3","3","2",8.3,0.4,39,2,30,21.3,5,-1,0,2,7,6,6,8
"643",2020-02-09,"w1920","Sun","weekend","no_sled",125,"3","2","2",8.4,0.1,38,-1,26,22.1,2,5,-1,0,1,6,5,5
"644",2020-02-09,"w1920","Sun","weekend","sled",72,"3","2","2",8.4,0.1,38,-1,26,22.1,2,5,-1,0,1,6,5,5
"645",2020-02-10,"w1920","Mon","weekday","no_sled",87,"2","2","1",8.4,0,38,0,22,22.1,-1,2,5,-1,-1,1,6,5
"646",2020-02-10,"w1920","Mon","weekday","sled",30,"2","2","1",8.4,0,38,0,22,22.1,-1,2,5,-1,-1,1,6,5
"647",2020-02-11,"w1920","Tue","weekday","no_sled",65,"2","2","2",8.5,0.1,40,2,16,21.2,0,-1,2,5,2,1,3,8
"648",2020-02-11,"w1920","Tue","weekday","sled",58,"2","2","2",8.5,0.1,40,2,16,21.2,0,-1,2,5,2,1,3,8
"649",2020-02-12,"w1920","Wed","weekday","no_sled",98,"2","2","2",8.5,0,39,-1,15,21.8,2,0,-1,2,1,1,0,2
"650",2020-02-12,"w1920","Wed","weekday","sled",36,"2","2","2",8.5,0,39,-1,15,21.8,2,0,-1,2,1,1,0,2
"651",2020-02-13,"w1920","Thu","weekday","no_sled",77,"2","2","1",8.5,0,39,0,18,21.8,-1,2,0,-1,-1,1,1,0
"652",2020-02-13,"w1920","Thu","weekday","sled",44,"2","2","1",8.5,0,39,0,18,21.8,-1,2,0,-1,-1,1,1,0
"653",2020-02-14,"w1920","Fri","weekday","no_sled",144,"2","1","1",8.6,0.1,38,-1,24,22.6,0,-1,2,0,-1,-2,0,0
"654",2020-02-14,"w1920","Fri","weekday","sled",49,"2","1","1",8.6,0.1,38,-1,24,22.6,0,-1,2,0,-1,-2,0,0
"655",2020-02-15,"w1920","Sat","weekend","no_sled",285,"1","1","1",8.6,0,38,0,26,22.6,-1,0,-1,2,-1,-1,-2,0
"656",2020-02-15,"w1920","Sat","weekend","sled",65,"1","1","1",8.6,0,38,0,26,22.6,-1,0,-1,2,-1,-1,-2,0
"657",2020-02-16,"w1920","Sun","weekend","no_sled",175,"1","1","1",8.8,0.2,37,-1,26,23.8,0,-1,0,-1,-1,-2,-2,-3
"658",2020-02-16,"w1920","Sun","weekend","sled",59,"1","1","1",8.8,0.2,37,-1,26,23.8,0,-1,0,-1,-1,-2,-2,-3
"659",2020-02-17,"w1920","Mon","weekday","no_sled",159,"2","1","1",9.2,0.4,43,6,25,21.4,-1,0,-1,0,5,5,4,4
"660",2020-02-17,"w1920","Mon","weekday","sled",17,"2","1","1",9.2,0.4,43,6,25,21.4,-1,0,-1,0,5,5,4,4
"661",2020-02-18,"w1920","Tue","weekday","no_sled",138,"1","1","1",9.3,0.1,42,-1,18,22.1,6,-1,0,-1,5,4,4,3
"662",2020-02-18,"w1920","Tue","weekday","sled",32,"1","1","1",9.3,0.1,42,-1,18,22.1,6,-1,0,-1,5,4,4,3
"663",2020-02-19,"w1920","Wed","weekday","no_sled",146,"1","1","1",9.3,0,41,-1,22,22.7,-1,6,-1,0,-2,4,3,3
"664",2020-02-19,"w1920","Wed","weekday","sled",47,"1","1","1",9.3,0,41,-1,22,22.7,-1,6,-1,0,-2,4,3,3
"665",2020-02-20,"w1920","Thu","weekday","no_sled",152,"1","1","1",9.3,0,41,0,18,22.7,-1,-1,6,-1,-1,-2,4,3
"666",2020-02-20,"w1920","Thu","weekday","sled",55,"1","1","1",9.3,0,41,0,18,22.7,-1,-1,6,-1,-1,-2,4,3
"667",2020-02-21,"w1920","Fri","weekday","no_sled",182,"1","1","1",9.3,0,40,-1,26,23.2,0,-1,-1,6,-1,-2,-3,3
"668",2020-02-21,"w1920","Fri","weekday","sled",102,"1","1","1",9.3,0,40,-1,26,23.2,0,-1,-1,6,-1,-2,-3,3
"669",2020-02-22,"w1920","Sat","weekend","no_sled",258,"1","1","1",9.4,0.1,39,-1,32,24.1,-1,0,-1,-1,-2,-2,-3,-4
"670",2020-02-22,"w1920","Sat","weekend","sled",105,"1","1","1",9.4,0.1,39,-1,32,24.1,-1,0,-1,-1,-2,-2,-3,-4
"671",2020-02-23,"w1920","Sun","weekend","no_sled",237,"2","2","2",9.5,0.1,40,1,27,23.8,-1,-1,0,-1,0,-1,-1,-2
"672",2020-02-23,"w1920","Sun","weekend","sled",29,"2","2","2",9.5,0.1,40,1,27,23.8,-1,-1,0,-1,0,-1,-1,-2
"673",2020-02-24,"w1920","Mon","weekday","no_sled",47,"3","3","2",9.8,0.3,43,3,17,22.8,1,-1,-1,0,4,3,2,2
"674",2020-02-24,"w1920","Mon","weekday","sled",17,"3","3","2",9.8,0.3,43,3,17,22.8,1,-1,-1,0,4,3,2,2
"675",2020-02-25,"w1920","Tue","weekday","no_sled",146,"2","2","1",9.8,0,43,0,8,22.8,3,1,-1,-1,3,4,3,2
"676",2020-02-25,"w1920","Tue","weekday","sled",43,"2","2","1",9.8,0,43,0,8,22.8,3,1,-1,-1,3,4,3,2
"677",2020-02-26,"w1920","Wed","weekday","no_sled",99,"2","2","1",9.8,0,42,-1,15,23.3,0,3,1,-1,-1,2,3,2
"678",2020-02-26,"w1920","Wed","weekday","sled",54,"2","2","1",9.8,0,42,-1,15,23.3,0,3,1,-1,-1,2,3,2
"679",2020-02-27,"w1920","Thu","weekday","no_sled",184,"2","2","1",9.9,0.1,41,-1,25,24.1,-1,0,3,1,-2,-2,1,2
"680",2020-02-27,"w1920","Thu","weekday","sled",75,"2","2","1",9.9,0.1,41,-1,25,24.1,-1,0,3,1,-2,-2,1,2
"681",2020-02-28,"w1920","Fri","weekday","no_sled",183,"2","1","1",9.9,0,41,0,28,24.1,-1,-1,0,3,-1,-2,-2,1
"682",2020-02-28,"w1920","Fri","weekday","sled",103,"2","1","1",9.9,0,41,0,28,24.1,-1,-1,0,3,-1,-2,-2,1
"683",2020-02-29,"w1920","Sat","weekend","no_sled",336,"1","1","1",9.9,0,40,-1,29,24.8,0,-1,-1,0,-1,-2,-3,-3
"684",2020-02-29,"w1920","Sat","weekend","sled",161,"1","1","1",9.9,0,40,-1,29,24.8,0,-1,-1,0,-1,-2,-3,-3
"685",2020-03-01,"w1920","Sun","weekend","no_sled",205,"1","1","1",10,0.1,40,0,28,25,-1,0,-1,-1,-1,-1,-2,-3
"686",2020-03-01,"w1920","Sun","weekend","sled",97,"1","1","1",10,0.1,40,0,28,25,-1,0,-1,-1,-1,-1,-2,-3
"687",2020-03-02,"w1920","Mon","weekday","no_sled",97,"2","2","1",10.4,0.4,45,5,25,23.1,0,-1,0,-1,5,4,4,3
"688",2020-03-02,"w1920","Mon","weekday","sled",66,"2","2","1",10.4,0.4,45,5,25,23.1,0,-1,0,-1,5,4,4,3
"689",2020-03-03,"w1920","Tue","weekday","no_sled",83,"2","1","1",10.9,0.5,50,5,25,21.8,5,0,-1,0,10,10,9,9
"690",2020-03-03,"w1920","Tue","weekday","sled",26,"2","1","1",10.9,0.5,50,5,25,21.8,5,0,-1,0,10,10,9,9
"691",2020-03-04,"w1920","Wed","weekday","no_sled",88,"2","1","1",10.9,0,48,-2,29,22.7,5,5,0,-1,3,8,8,7
"692",2020-03-04,"w1920","Wed","weekday","sled",23,"2","1","1",10.9,0,48,-2,29,22.7,5,5,0,-1,3,8,8,7
"693",2020-03-05,"w1920","Thu","weekday","no_sled",108,"2","1","1",10.9,0,46,-2,32,23.7,-2,5,5,0,-4,1,6,6
"694",2020-03-05,"w1920","Thu","weekday","sled",68,"2","1","1",10.9,0,46,-2,32,23.7,-2,5,5,0,-4,1,6,6
"695",2020-03-06,"w1920","Fri","weekday","no_sled",127,"1","1","1",10.9,0,45,-1,34,24.2,-2,-2,5,5,-3,-5,0,5
"696",2020-03-06,"w1920","Fri","weekday","sled",94,"1","1","1",10.9,0,45,-1,34,24.2,-2,-2,5,5,-3,-5,0,5
"697",2020-03-07,"w1920","Sat","weekend","no_sled",248,"1","1","2",10.9,0,44,-1,35,24.8,-1,-2,-2,5,-2,-4,-6,-1
"698",2020-03-07,"w1920","Sat","weekend","sled",101,"1","1","2",10.9,0,44,-1,35,24.8,-1,-2,-2,5,-2,-4,-6,-1
"699",2020-03-08,"w1920","Sun","weekend","no_sled",183,"1","1","1",11,0.1,43,-1,33,25.6,-1,-1,-2,-2,-2,-3,-5,-7
"700",2020-03-08,"w1920","Sun","weekend","sled",82,"1","1","1",11,0.1,43,-1,33,25.6,-1,-1,-2,-2,-2,-3,-5,-7
"701",2020-03-09,"w1920","Mon","weekday","no_sled",88,"1","1","1",11.1,0.1,42,-1,31,26.4,-1,-1,-1,-2,-2,-3,-4,-6
"702",2020-03-09,"w1920","Mon","weekday","sled",51,"1","1","1",11.1,0.1,42,-1,31,26.4,-1,-1,-1,-2,-2,-3,-4,-6
"703",2020-03-10,"w1920","Tue","weekday","no_sled",80,"1","1","2",11.2,0.1,44,2,31,25.5,-1,-1,-1,-1,1,0,-1,-2
"704",2020-03-10,"w1920","Tue","weekday","sled",113,"1","1","2",11.2,0.1,44,2,31,25.5,-1,-1,-1,-1,1,0,-1,-2
"705",2020-03-11,"w1920","Wed","weekday","no_sled",93,"2","2","1",11.2,0,44,0,32,25.5,2,-1,-1,-1,2,1,0,-1
"706",2020-03-11,"w1920","Wed","weekday","sled",142,"2","2","1",11.2,0,44,0,32,25.5,2,-1,-1,-1,2,1,0,-1
"707",2020-03-12,"w1920","Thu","weekday","no_sled",94,"2","2","2",11.4,0.2,42,-2,35,27.1,0,2,-1,-1,-2,0,-1,-2
"708",2020-03-12,"w1920","Thu","weekday","sled",130,"2","2","2",11.4,0.2,42,-2,35,27.1,0,2,-1,-1,-2,0,-1,-2
"709",2020-03-13,"w1920","Fri","weekday","no_sled",72,"3","3","2",11.5,0.1,44,2,31,26.1,-2,0,2,-1,0,0,2,1
"710",2020-03-13,"w1920","Fri","weekday","sled",78,"3","3","2",11.5,0.1,44,2,31,26.1,-2,0,2,-1,0,0,2,1
"711",2020-03-14,"w1920","Sat","weekend","no_sled",204,"3","3","3",11.7,0.2,44,0,31,26.6,2,-2,0,2,2,0,0,2
"712",2020-03-14,"w1920","Sat","weekend","sled",48,"3","3","3",11.7,0.2,44,0,31,26.6,2,-2,0,2,2,0,0,2
"713",2020-03-15,"w1920","Sun","weekend","no_sled",350,"2","2","2",11.7,0,45,1,33,26,0,2,-2,0,1,3,1,1
"714",2020-03-15,"w1920","Sun","weekend","sled",114,"2","2","2",11.7,0,45,1,33,26,0,2,-2,0,1,3,1,1
"715",2020-03-16,"w1920","Mon","weekday","no_sled",212,"2","2","2",11.7,0,45,0,35,26,1,0,2,-2,1,1,3,1
"716",2020-03-16,"w1920","Mon","weekday","sled",208,"2","2","2",11.7,0,45,0,35,26,1,0,2,-2,1,1,3,1
"717",2020-03-17,"w1920","Tue","weekday","no_sled",88,"2","2","2",11.7,0,44,-1,36,26.6,0,1,0,2,-1,0,0,2
"718",2020-03-17,"w1920","Tue","weekday","sled",187,"2","2","2",11.7,0,44,-1,36,26.6,0,1,0,2,-1,0,0,2
"719",2020-03-18,"w1920","Wed","weekday","no_sled",68,"2","2","2",11.7,0,43,-1,33,27.2,-1,0,1,0,-2,-2,-1,-1
"720",2020-03-18,"w1920","Wed","weekday","sled",66,"2","2","2",11.7,0,43,-1,33,27.2,-1,0,1,0,-2,-2,-1,-1
"721",2020-03-19,"w1920","Thu","weekday","no_sled",76,"3","3","3",11.8,0.1,43,0,27,27.4,-1,-1,0,1,-1,-2,-2,-1
"722",2020-03-19,"w1920","Thu","weekday","sled",58,"3","3","3",11.8,0.1,43,0,27,27.4,-1,-1,0,1,-1,-2,-2,-1
"723",2020-03-20,"w1920","Fri","weekday","no_sled",145,"3","3","2",12.7,0.9,52,9,26,24.4,0,-1,-1,0,9,8,7,7
"724",2020-03-20,"w1920","Fri","weekday","sled",71,"3","3","2",12.7,0.9,52,9,26,24.4,0,-1,-1,0,9,8,7,7
"725",2020-03-21,"w1920","Sat","weekend","no_sled",163,"3","3","2",12.8,0.1,54,2,26,23.7,9,0,-1,-1,11,11,10,9
"726",2020-03-21,"w1920","Sat","weekend","sled",68,"3","3","2",12.8,0.1,54,2,26,23.7,9,0,-1,-1,11,11,10,9
"727",2020-03-22,"w1920","Sun","weekend","no_sled",112,"2","2","2",13,0.2,53,-1,28,24.5,2,9,0,-1,1,10,10,9
"728",2020-03-22,"w1920","Sun","weekend","sled",63,"2","2","2",13,0.2,53,-1,28,24.5,2,9,0,-1,1,10,10,9
"729",2020-03-23,"w1920","Mon","weekday","no_sled",114,"2","2","2",13,0,53,0,28,24.5,-1,2,9,0,-1,1,10,10
"730",2020-03-23,"w1920","Mon","weekday","sled",55,"2","2","2",13,0,53,0,28,24.5,-1,2,9,0,-1,1,10,10
"731",2020-03-24,"w1920","Tue","weekday","no_sled",116,"2","2","2",13.2,0.2,53,0,32,24.9,0,-1,2,9,0,-1,1,10
"732",2020-03-24,"w1920","Tue","weekday","sled",75,"2","2","2",13.2,0.2,53,0,32,24.9,0,-1,2,9,0,-1,1,10
"733",2020-03-25,"w1920","Wed","weekday","no_sled",70,"2","2","2",13.3,0.1,51,-2,34,26.1,0,0,-1,2,-2,-2,-3,-1
"734",2020-03-25,"w1920","Wed","weekday","sled",81,"2","2","2",13.3,0.1,51,-2,34,26.1,0,0,-1,2,-2,-2,-3,-1
"735",2020-03-26,"w1920","Thu","weekday","no_sled",83,"2","2","2",13.3,0,50,-1,36,26.6,-2,0,0,-1,-3,-3,-3,-4
"736",2020-03-26,"w1920","Thu","weekday","no_sled",83,"3","3","2",13.3,0,50,-1,36,26.6,-2,0,0,-1,-3,-3,-3,-4
"737",2020-03-26,"w1920","Thu","weekday","sled",107,"2","2","2",13.3,0,50,-1,36,26.6,-2,0,0,-1,-3,-3,-3,-4
"738",2020-03-26,"w1920","Thu","weekday","sled",107,"3","3","2",13.3,0,50,-1,36,26.6,-2,0,0,-1,-3,-3,-3,-4
"739",2020-03-27,"w1920","Fri","weekday","no_sled",61,"3","3","2",13.3,0,50,0,23,26.6,-1,-2,0,0,-1,-3,-3,-3
"740",2020-03-27,"w1920","Fri","weekday","sled",57,"3","3","2",13.3,0,50,0,23,26.6,-1,-2,0,0,-1,-3,-3,-3
"741",2020-03-28,"w1920","Sat","weekend","no_sled",94,"3","3","3",13.3,0,50,0,18,26.6,0,-1,-2,0,0,-1,-3,-3
"742",2020-03-28,"w1920","Sat","weekend","sled",57,"3","3","3",13.3,0,50,0,18,26.6,0,-1,-2,0,0,-1,-3,-3
"743",2020-03-29,"w1920","Sun","weekend","no_sled",84,"2","2","2",13.3,0,49,-1,24,27.1,0,0,-1,-2,-1,-1,-2,-4
"744",2020-03-29,"w1920","Sun","weekend","sled",31,"2","2","2",13.3,0,49,-1,24,27.1,0,0,-1,-2,-1,-1,-2,-4
"745",2020-03-30,"w1920","Mon","weekday","no_sled",74,"2","2","2",13.4,0.1,49,0,29,27.3,-1,0,0,-1,-1,-1,-1,-2
"746",2020-03-30,"w1920","Mon","weekday","sled",65,"2","2","2",13.4,0.1,49,0,29,27.3,-1,0,0,-1,-1,-1,-1,-2
"747",2020-03-31,"w1920","Tue","weekday","no_sled",53,"2","2","2",13.6,0.2,51,2,35,26.7,0,-1,0,0,2,1,1,1
"748",2020-03-31,"w1920","Tue","weekday","sled",42,"2","2","2",13.6,0.2,51,2,35,26.7,0,-1,0,0,2,1,1,1
"749",2020-04-01,"w1920","Wed","weekday","no_sled",35,"2","2","2",13.6,0,47,-4,39,28.9,2,0,-1,0,-2,-2,-3,-3
"750",2020-04-01,"w1920","Wed","weekday","sled",40,"2","2","2",13.6,0,47,-4,39,28.9,2,0,-1,0,-2,-2,-3,-3
"751",2020-04-02,"w1920","Thu","weekday","no_sled",66,"2","2","2",13.6,0,46,-1,31,29.6,-4,2,0,-1,-5,-3,-3,-4
"752",2020-04-02,"w1920","Thu","weekday","sled",44,"2","2","2",13.6,0,46,-1,31,29.6,-4,2,0,-1,-5,-3,-3,-4
"753",2020-04-03,"w1920","Fri","weekday","no_sled",50,"2","2","2",13.6,0,46,0,28,29.6,-1,-4,2,0,-1,-5,-3,-3
"754",2020-04-03,"w1920","Fri","weekday","sled",18,"2","2","2",13.6,0,46,0,28,29.6,-1,-4,2,0,-1,-5,-3,-3
"755",2020-04-04,"w1920","Sat","weekend","no_sled",59,"2","2","2",13.6,0,45,-1,33,30.2,0,-1,-4,2,-1,-2,-6,-4
"756",2020-04-04,"w1920","Sat","weekend","sled",32,"2","2","2",13.6,0,45,-1,33,30.2,0,-1,-4,2,-1,-2,-6,-4
"757",2020-04-05,"w1920","Sun","weekend","no_sled",70,"2","2","3",13.6,0,45,0,38,30.2,-1,0,-1,-4,-1,-1,-2,-6
"758",2020-04-05,"w1920","Sun","weekend","sled",28,"2","2","3",13.6,0,45,0,38,30.2,-1,0,-1,-4,-1,-1,-2,-6
"759",2020-04-06,"w1920","Mon","weekday","no_sled",78,"2","2","3",13.6,0,44,-1,40,30.9,0,-1,0,-1,-1,-2,-2,-3
"760",2020-04-06,"w1920","Mon","weekday","sled",22,"2","2","3",13.6,0,44,-1,40,30.9,0,-1,0,-1,-1,-2,-2,-3
"761",2020-04-07,"w1920","Tue","weekday","no_sled",64,"2","2","3",13.4,-0.2,43,-1,39,31.2,-1,0,-1,0,-2,-2,-3,-3
"762",2020-04-07,"w1920","Tue","weekday","sled",23,"2","2","3",13.4,-0.2,43,-1,39,31.2,-1,0,-1,0,-2,-2,-3,-3
"763",2020-04-08,"w1920","Wed","weekday","no_sled",40,"2","3","3",13.3,-0.1,42,-1,40,31.7,-1,-1,0,-1,-2,-3,-3,-4
"764",2020-04-08,"w1920","Wed","weekday","sled",36,"2","3","3",13.3,-0.1,42,-1,40,31.7,-1,-1,0,-1,-2,-3,-3,-4
"765",2020-04-09,"w1920","Thu","weekday","no_sled",29,"2","3","3",13.1,-0.2,40,-2,42,32.8,-1,-1,-1,0,-3,-4,-5,-5
"766",2020-04-09,"w1920","Thu","weekday","sled",24,"2","3","3",13.1,-0.2,40,-2,42,32.8,-1,-1,-1,0,-3,-4,-5,-5
"767",2020-04-10,"w1920","Fri","weekday","no_sled",27,"3","3","3",12.9,-0.2,39,-1,38,33.1,-2,-1,-1,-1,-3,-4,-5,-6
"768",2020-04-10,"w1920","Fri","weekday","sled",15,"3","3","3",12.9,-0.2,39,-1,38,33.1,-2,-1,-1,-1,-3,-4,-5,-6
"769",2020-04-11,"w1920","Sat","weekend","no_sled",36,"2","3","3",12.9,0,39,0,36,33.1,-1,-2,-1,-1,-1,-3,-4,-5
"770",2020-04-11,"w1920","Sat","weekend","sled",55,"2","3","3",12.9,0,39,0,36,33.1,-1,-2,-1,-1,-1,-3,-4,-5
"771",2020-04-12,"w1920","Sun","weekend","no_sled",36,"2","2","2",12.8,-0.1,38,-1,29,33.7,0,-1,-2,-1,-1,-2,-4,-5
"772",2020-04-12,"w1920","Sun","weekend","sled",34,"2","2","2",12.8,-0.1,38,-1,29,33.7,0,-1,-2,-1,-1,-2,-4,-5
"773",2020-04-13,"w1920","Mon","weekday","no_sled",17,NA,NA,NA,12.9,0.1,39,1,20,33.1,-1,0,-1,-2,0,0,-1,-3
"774",2020-04-13,"w1920","Mon","weekday","sled",33,NA,NA,NA,12.9,0.1,39,1,20,33.1,-1,0,-1,-2,0,0,-1,-3
"775",2020-04-14,"w1920","Tue","weekday","no_sled",20,"2","2","2",13,0.1,39,0,18,33.3,1,-1,0,-1,1,0,0,-1
"776",2020-04-14,"w1920","Tue","weekday","sled",34,"2","2","2",13,0.1,39,0,18,33.3,1,-1,0,-1,1,0,0,-1
"777",2020-04-15,"w1920","Wed","weekday","no_sled",25,NA,NA,NA,13.2,0.2,39,0,28,33.8,0,1,-1,0,0,1,0,0
"778",2020-04-15,"w1920","Wed","weekday","sled",28,NA,NA,NA,13.2,0.2,39,0,28,33.8,0,1,-1,0,0,1,0,0
