"","date","Trailhead","year","modality","user.count","week","weekend","has_sled","Zone","rating_above","rating_near","rating_below","swe","change_swe","snow_depth","change_depth","air_temp","snow_density","lag1snow","lag2snow","lag3snow","lag4snow","past2snow","past3snow","past4snow","past5snow"
"1",2017-12-22,"Brush Creek Trailhead","w1718","Non.motorized",14,"Fri","weekday","no_sled","Brush/Cement","2","2","1",2,0,11,3,17,18.2,0,0,0,0,3,3,3,3
"2",2017-12-22,"Brush Creek Trailhead","w1718","Mechanized",1,"Fri","weekday","no_sled","Brush/Cement","2","2","1",2,0,11,3,17,18.2,0,0,0,0,3,3,3,3
"3",2017-12-22,"Brush Creek Trailhead","w1718","Motorized",0,"Fri","weekday","sled","Brush/Cement","2","2","1",2,0,11,3,17,18.2,0,0,0,0,3,3,3,3
"4",2017-12-22,"Brush Creek Trailhead","w1718","Hybrid",0,"Fri","weekday","sled","Brush/Cement","2","2","1",2,0,11,3,17,18.2,0,0,0,0,3,3,3,3
"5",2017-12-23,"Brush Creek Trailhead","w1718","Non.motorized",11,"Sat","weekend","no_sled","Brush/Cement","2","1","1",2.1,0.1,10,-1,21,21,3,0,0,0,2,2,2,2
"6",2017-12-23,"Brush Creek Trailhead","w1718","Mechanized",0,"Sat","weekend","no_sled","Brush/Cement","2","1","1",2.1,0.1,10,-1,21,21,3,0,0,0,2,2,2,2
"7",2017-12-23,"Brush Creek Trailhead","w1718","Motorized",0,"Sat","weekend","sled","Brush/Cement","2","1","1",2.1,0.1,10,-1,21,21,3,0,0,0,2,2,2,2
"8",2017-12-23,"Brush Creek Trailhead","w1718","Hybrid",0,"Sat","weekend","sled","Brush/Cement","2","1","1",2.1,0.1,10,-1,21,21,3,0,0,0,2,2,2,2
"9",2017-12-24,"Brush Creek Trailhead","w1718","Non.motorized",28,"Sun","weekend","no_sled","Brush/Cement","1","1","1",2.4,0.3,14,4,19,17.1,-1,3,0,0,3,6,6,6
"10",2017-12-24,"Brush Creek Trailhead","w1718","Mechanized",0,"Sun","weekend","no_sled","Brush/Cement","1","1","1",2.4,0.3,14,4,19,17.1,-1,3,0,0,3,6,6,6
"11",2017-12-24,"Brush Creek Trailhead","w1718","Motorized",0,"Sun","weekend","sled","Brush/Cement","1","1","1",2.4,0.3,14,4,19,17.1,-1,3,0,0,3,6,6,6
"12",2017-12-24,"Brush Creek Trailhead","w1718","Hybrid",0,"Sun","weekend","sled","Brush/Cement","1","1","1",2.4,0.3,14,4,19,17.1,-1,3,0,0,3,6,6,6
"13",2017-12-25,"Brush Creek Trailhead","w1718","Non.motorized",14,"Mon","weekday","no_sled","Brush/Cement","2","1","1",2.6,0.2,14,0,25,18.6,4,-1,3,0,4,3,6,6
"14",2017-12-25,"Brush Creek Trailhead","w1718","Mechanized",0,"Mon","weekday","no_sled","Brush/Cement","2","1","1",2.6,0.2,14,0,25,18.6,4,-1,3,0,4,3,6,6
"15",2017-12-25,"Brush Creek Trailhead","w1718","Motorized",0,"Mon","weekday","sled","Brush/Cement","2","1","1",2.6,0.2,14,0,25,18.6,4,-1,3,0,4,3,6,6
"16",2017-12-25,"Brush Creek Trailhead","w1718","Hybrid",0,"Mon","weekday","sled","Brush/Cement","2","1","1",2.6,0.2,14,0,25,18.6,4,-1,3,0,4,3,6,6
"17",2017-12-26,"Brush Creek Trailhead","w1718","Non.motorized",27,"Tue","weekday","no_sled","Brush/Cement","1","1","1",3.1,0.5,20,6,25,15.5,0,4,-1,3,6,10,9,12
"18",2017-12-26,"Brush Creek Trailhead","w1718","Mechanized",0,"Tue","weekday","no_sled","Brush/Cement","1","1","1",3.1,0.5,20,6,25,15.5,0,4,-1,3,6,10,9,12
"19",2017-12-26,"Brush Creek Trailhead","w1718","Motorized",0,"Tue","weekday","sled","Brush/Cement","1","1","1",3.1,0.5,20,6,25,15.5,0,4,-1,3,6,10,9,12
"20",2017-12-26,"Brush Creek Trailhead","w1718","Hybrid",0,"Tue","weekday","sled","Brush/Cement","1","1","1",3.1,0.5,20,6,25,15.5,0,4,-1,3,6,10,9,12
"21",2017-12-27,"Brush Creek Trailhead","w1718","Non.motorized",24,"Wed","weekday","no_sled","Brush/Cement","1","1","1",3.1,0,18,-2,27,17.2,6,0,4,-1,4,4,8,7
"22",2017-12-27,"Brush Creek Trailhead","w1718","Mechanized",0,"Wed","weekday","no_sled","Brush/Cement","1","1","1",3.1,0,18,-2,27,17.2,6,0,4,-1,4,4,8,7
"23",2017-12-27,"Brush Creek Trailhead","w1718","Motorized",0,"Wed","weekday","sled","Brush/Cement","1","1","1",3.1,0,18,-2,27,17.2,6,0,4,-1,4,4,8,7
"24",2017-12-27,"Brush Creek Trailhead","w1718","Hybrid",0,"Wed","weekday","sled","Brush/Cement","1","1","1",3.1,0,18,-2,27,17.2,6,0,4,-1,4,4,8,7
"25",2017-12-28,"Brush Creek Trailhead","w1718","Non.motorized",37,"Thu","weekday","no_sled","Brush/Cement","1","1","1",3.2,0.1,17,-1,31,18.8,-2,6,0,4,-3,3,3,7
"26",2017-12-28,"Brush Creek Trailhead","w1718","Mechanized",0,"Thu","weekday","no_sled","Brush/Cement","1","1","1",3.2,0.1,17,-1,31,18.8,-2,6,0,4,-3,3,3,7
"27",2017-12-28,"Brush Creek Trailhead","w1718","Motorized",0,"Thu","weekday","sled","Brush/Cement","1","1","1",3.2,0.1,17,-1,31,18.8,-2,6,0,4,-3,3,3,7
"28",2017-12-28,"Brush Creek Trailhead","w1718","Hybrid",0,"Thu","weekday","sled","Brush/Cement","1","1","1",3.2,0.1,17,-1,31,18.8,-2,6,0,4,-3,3,3,7
"29",2017-12-29,"Brush Creek Trailhead","w1718","Non.motorized",27,"Fri","weekday","no_sled","Brush/Cement","1","1","1",3.2,0,17,0,36,18.8,-1,-2,6,0,-1,-3,3,3
"30",2017-12-29,"Brush Creek Trailhead","w1718","Mechanized",0,"Fri","weekday","no_sled","Brush/Cement","1","1","1",3.2,0,17,0,36,18.8,-1,-2,6,0,-1,-3,3,3
"31",2017-12-29,"Brush Creek Trailhead","w1718","Motorized",0,"Fri","weekday","sled","Brush/Cement","1","1","1",3.2,0,17,0,36,18.8,-1,-2,6,0,-1,-3,3,3
"32",2017-12-29,"Brush Creek Trailhead","w1718","Hybrid",0,"Fri","weekday","sled","Brush/Cement","1","1","1",3.2,0,17,0,36,18.8,-1,-2,6,0,-1,-3,3,3
"33",2017-12-30,"Brush Creek Trailhead","w1718","Non.motorized",44,"Sat","weekend","no_sled","Brush/Cement","1","1","1",3.2,0,15,-2,37,21.3,0,-1,-2,6,-2,-3,-5,1
"34",2017-12-30,"Brush Creek Trailhead","w1718","Mechanized",0,"Sat","weekend","no_sled","Brush/Cement","1","1","1",3.2,0,15,-2,37,21.3,0,-1,-2,6,-2,-3,-5,1
"35",2017-12-30,"Brush Creek Trailhead","w1718","Motorized",0,"Sat","weekend","sled","Brush/Cement","1","1","1",3.2,0,15,-2,37,21.3,0,-1,-2,6,-2,-3,-5,1
"36",2017-12-30,"Brush Creek Trailhead","w1718","Hybrid",0,"Sat","weekend","sled","Brush/Cement","1","1","1",3.2,0,15,-2,37,21.3,0,-1,-2,6,-2,-3,-5,1
"37",2017-12-31,"Brush Creek Trailhead","w1718","Non.motorized",33,"Sun","weekend","no_sled","Brush/Cement","1","1","1",3.2,0,15,0,31,21.3,-2,0,-1,-2,-2,-2,-3,-5
"38",2017-12-31,"Brush Creek Trailhead","w1718","Mechanized",1,"Sun","weekend","no_sled","Brush/Cement","1","1","1",3.2,0,15,0,31,21.3,-2,0,-1,-2,-2,-2,-3,-5
"39",2017-12-31,"Brush Creek Trailhead","w1718","Motorized",0,"Sun","weekend","sled","Brush/Cement","1","1","1",3.2,0,15,0,31,21.3,-2,0,-1,-2,-2,-2,-3,-5
"40",2017-12-31,"Brush Creek Trailhead","w1718","Hybrid",0,"Sun","weekend","sled","Brush/Cement","1","1","1",3.2,0,15,0,31,21.3,-2,0,-1,-2,-2,-2,-3,-5
"41",2018-01-01,"Brush Creek Trailhead","w1718","Non.motorized",44,"Mon","weekday","no_sled","Brush/Cement","1","1","1",3.2,0,15,0,27,21.3,0,-2,0,-1,0,-2,-2,-3
"42",2018-01-01,"Brush Creek Trailhead","w1718","Mechanized",1,"Mon","weekday","no_sled","Brush/Cement","1","1","1",3.2,0,15,0,27,21.3,0,-2,0,-1,0,-2,-2,-3
"43",2018-01-01,"Brush Creek Trailhead","w1718","Motorized",0,"Mon","weekday","sled","Brush/Cement","1","1","1",3.2,0,15,0,27,21.3,0,-2,0,-1,0,-2,-2,-3
"44",2018-01-01,"Brush Creek Trailhead","w1718","Hybrid",0,"Mon","weekday","sled","Brush/Cement","1","1","1",3.2,0,15,0,27,21.3,0,-2,0,-1,0,-2,-2,-3
"45",2018-01-02,"Brush Creek Trailhead","w1718","Non.motorized",13,"Tue","weekday","no_sled","Brush/Cement","1","1","1",3.2,0,15,0,22,21.3,0,0,-2,0,0,0,-2,-2
"46",2018-01-02,"Brush Creek Trailhead","w1718","Mechanized",1,"Tue","weekday","no_sled","Brush/Cement","1","1","1",3.2,0,15,0,22,21.3,0,0,-2,0,0,0,-2,-2
"47",2018-01-02,"Brush Creek Trailhead","w1718","Motorized",0,"Tue","weekday","sled","Brush/Cement","1","1","1",3.2,0,15,0,22,21.3,0,0,-2,0,0,0,-2,-2
"48",2018-01-02,"Brush Creek Trailhead","w1718","Hybrid",0,"Tue","weekday","sled","Brush/Cement","1","1","1",3.2,0,15,0,22,21.3,0,0,-2,0,0,0,-2,-2
"49",2018-01-03,"Brush Creek Trailhead","w1718","Non.motorized",24,"Wed","weekday","no_sled","Brush/Cement","1","1","1",3.2,0,15,0,27,21.3,0,0,0,-2,0,0,0,-2
"50",2018-01-03,"Brush Creek Trailhead","w1718","Mechanized",0,"Wed","weekday","no_sled","Brush/Cement","1","1","1",3.2,0,15,0,27,21.3,0,0,0,-2,0,0,0,-2
"51",2018-01-03,"Brush Creek Trailhead","w1718","Motorized",0,"Wed","weekday","sled","Brush/Cement","1","1","1",3.2,0,15,0,27,21.3,0,0,0,-2,0,0,0,-2
"52",2018-01-03,"Brush Creek Trailhead","w1718","Hybrid",0,"Wed","weekday","sled","Brush/Cement","1","1","1",3.2,0,15,0,27,21.3,0,0,0,-2,0,0,0,-2
"53",2018-01-04,"Brush Creek Trailhead","w1718","Non.motorized",15,"Thu","weekday","no_sled","Brush/Cement","1","1","1",3.2,0,15,0,29,21.3,0,0,0,0,0,0,0,0
"54",2018-01-04,"Brush Creek Trailhead","w1718","Mechanized",0,"Thu","weekday","no_sled","Brush/Cement","1","1","1",3.2,0,15,0,29,21.3,0,0,0,0,0,0,0,0
"55",2018-01-04,"Brush Creek Trailhead","w1718","Motorized",0,"Thu","weekday","sled","Brush/Cement","1","1","1",3.2,0,15,0,29,21.3,0,0,0,0,0,0,0,0
"56",2018-01-04,"Brush Creek Trailhead","w1718","Hybrid",0,"Thu","weekday","sled","Brush/Cement","1","1","1",3.2,0,15,0,29,21.3,0,0,0,0,0,0,0,0
"57",2018-01-05,"Brush Creek Trailhead","w1718","Non.motorized",14,"Fri","weekday","no_sled","Brush/Cement","1","1","1",3.2,0,14,-1,32,22.9,0,0,0,0,-1,-1,-1,-1
"58",2018-01-05,"Brush Creek Trailhead","w1718","Mechanized",0,"Fri","weekday","no_sled","Brush/Cement","1","1","1",3.2,0,14,-1,32,22.9,0,0,0,0,-1,-1,-1,-1
"59",2018-01-05,"Brush Creek Trailhead","w1718","Motorized",0,"Fri","weekday","sled","Brush/Cement","1","1","1",3.2,0,14,-1,32,22.9,0,0,0,0,-1,-1,-1,-1
"60",2018-01-05,"Brush Creek Trailhead","w1718","Hybrid",0,"Fri","weekday","sled","Brush/Cement","1","1","1",3.2,0,14,-1,32,22.9,0,0,0,0,-1,-1,-1,-1
"61",2018-01-06,"Brush Creek Trailhead","w1718","Non.motorized",16,"Sat","weekend","no_sled","Brush/Cement","1","1","1",3.2,0,14,0,30,22.9,-1,0,0,0,-1,-1,-1,-1
"62",2018-01-06,"Brush Creek Trailhead","w1718","Mechanized",0,"Sat","weekend","no_sled","Brush/Cement","1","1","1",3.2,0,14,0,30,22.9,-1,0,0,0,-1,-1,-1,-1
"63",2018-01-06,"Brush Creek Trailhead","w1718","Motorized",0,"Sat","weekend","sled","Brush/Cement","1","1","1",3.2,0,14,0,30,22.9,-1,0,0,0,-1,-1,-1,-1
"64",2018-01-06,"Brush Creek Trailhead","w1718","Hybrid",0,"Sat","weekend","sled","Brush/Cement","1","1","1",3.2,0,14,0,30,22.9,-1,0,0,0,-1,-1,-1,-1
"65",2018-01-07,"Brush Creek Trailhead","w1718","Non.motorized",24,"Sun","weekend","no_sled","Brush/Cement","2","2","2",3.5,0.3,18,4,25,19.4,0,-1,0,0,4,3,3,3
"66",2018-01-07,"Brush Creek Trailhead","w1718","Mechanized",0,"Sun","weekend","no_sled","Brush/Cement","2","2","2",3.5,0.3,18,4,25,19.4,0,-1,0,0,4,3,3,3
"67",2018-01-07,"Brush Creek Trailhead","w1718","Motorized",0,"Sun","weekend","sled","Brush/Cement","2","2","2",3.5,0.3,18,4,25,19.4,0,-1,0,0,4,3,3,3
"68",2018-01-07,"Brush Creek Trailhead","w1718","Hybrid",0,"Sun","weekend","sled","Brush/Cement","2","2","2",3.5,0.3,18,4,25,19.4,0,-1,0,0,4,3,3,3
"69",2018-01-08,"Brush Creek Trailhead","w1718","Non.motorized",9,"Mon","weekday","no_sled","Brush/Cement","2","2","1",3.7,0.2,20,2,29,18.5,4,0,-1,0,6,6,5,5
"70",2018-01-08,"Brush Creek Trailhead","w1718","Mechanized",0,"Mon","weekday","no_sled","Brush/Cement","2","2","1",3.7,0.2,20,2,29,18.5,4,0,-1,0,6,6,5,5
"71",2018-01-08,"Brush Creek Trailhead","w1718","Motorized",0,"Mon","weekday","sled","Brush/Cement","2","2","1",3.7,0.2,20,2,29,18.5,4,0,-1,0,6,6,5,5
"72",2018-01-08,"Brush Creek Trailhead","w1718","Hybrid",0,"Mon","weekday","sled","Brush/Cement","2","2","1",3.7,0.2,20,2,29,18.5,4,0,-1,0,6,6,5,5
"73",2018-01-09,"Brush Creek Trailhead","w1718","Non.motorized",14,"Tue","weekday","no_sled","Brush/Cement","2","2","1",3.8,0.1,21,1,34,18.1,2,4,0,-1,3,7,7,6
"74",2018-01-09,"Brush Creek Trailhead","w1718","Mechanized",0,"Tue","weekday","no_sled","Brush/Cement","2","2","1",3.8,0.1,21,1,34,18.1,2,4,0,-1,3,7,7,6
"75",2018-01-09,"Brush Creek Trailhead","w1718","Motorized",0,"Tue","weekday","sled","Brush/Cement","2","2","1",3.8,0.1,21,1,34,18.1,2,4,0,-1,3,7,7,6
"76",2018-01-09,"Brush Creek Trailhead","w1718","Hybrid",0,"Tue","weekday","sled","Brush/Cement","2","2","1",3.8,0.1,21,1,34,18.1,2,4,0,-1,3,7,7,6
"77",2018-01-10,"Brush Creek Trailhead","w1718","Non.motorized",1,"Wed","weekday","no_sled","Brush/Cement","3","3","3",4,0.2,21,0,28,19,1,2,4,0,1,3,7,7
"78",2018-01-10,"Brush Creek Trailhead","w1718","Mechanized",0,"Wed","weekday","no_sled","Brush/Cement","3","3","3",4,0.2,21,0,28,19,1,2,4,0,1,3,7,7
"79",2018-01-10,"Brush Creek Trailhead","w1718","Motorized",0,"Wed","weekday","sled","Brush/Cement","3","3","3",4,0.2,21,0,28,19,1,2,4,0,1,3,7,7
"80",2018-01-10,"Brush Creek Trailhead","w1718","Hybrid",0,"Wed","weekday","sled","Brush/Cement","3","3","3",4,0.2,21,0,28,19,1,2,4,0,1,3,7,7
"81",2018-01-11,"Brush Creek Trailhead","w1718","Non.motorized",9,"Thu","weekday","no_sled","Brush/Cement","3","3","3",4.1,0.1,26,5,17,15.8,0,1,2,4,5,6,8,12
"82",2018-01-11,"Brush Creek Trailhead","w1718","Mechanized",0,"Thu","weekday","no_sled","Brush/Cement","3","3","3",4.1,0.1,26,5,17,15.8,0,1,2,4,5,6,8,12
"83",2018-01-11,"Brush Creek Trailhead","w1718","Motorized",0,"Thu","weekday","sled","Brush/Cement","3","3","3",4.1,0.1,26,5,17,15.8,0,1,2,4,5,6,8,12
"84",2018-01-11,"Brush Creek Trailhead","w1718","Hybrid",0,"Thu","weekday","sled","Brush/Cement","3","3","3",4.1,0.1,26,5,17,15.8,0,1,2,4,5,6,8,12
"85",2018-01-12,"Brush Creek Trailhead","w1718","Non.motorized",1,"Fri","weekday","no_sled","Brush/Cement","3","3","3",4.3,0.2,24,-2,22,17.9,5,0,1,2,3,3,4,6
"86",2018-01-12,"Brush Creek Trailhead","w1718","Mechanized",0,"Fri","weekday","no_sled","Brush/Cement","3","3","3",4.3,0.2,24,-2,22,17.9,5,0,1,2,3,3,4,6
"87",2018-01-12,"Brush Creek Trailhead","w1718","Motorized",0,"Fri","weekday","sled","Brush/Cement","3","3","3",4.3,0.2,24,-2,22,17.9,5,0,1,2,3,3,4,6
"88",2018-01-12,"Brush Creek Trailhead","w1718","Hybrid",0,"Fri","weekday","sled","Brush/Cement","3","3","3",4.3,0.2,24,-2,22,17.9,5,0,1,2,3,3,4,6
"89",2018-01-13,"Brush Creek Trailhead","w1718","Non.motorized",8,"Sat","weekend","no_sled","Brush/Cement","3","3","3",4.4,0.1,24,0,24,18.3,-2,5,0,1,-2,3,3,4
"90",2018-01-13,"Brush Creek Trailhead","w1718","Mechanized",0,"Sat","weekend","no_sled","Brush/Cement","3","3","3",4.4,0.1,24,0,24,18.3,-2,5,0,1,-2,3,3,4
"91",2018-01-13,"Brush Creek Trailhead","w1718","Motorized",0,"Sat","weekend","sled","Brush/Cement","3","3","3",4.4,0.1,24,0,24,18.3,-2,5,0,1,-2,3,3,4
"92",2018-01-13,"Brush Creek Trailhead","w1718","Hybrid",0,"Sat","weekend","sled","Brush/Cement","3","3","3",4.4,0.1,24,0,24,18.3,-2,5,0,1,-2,3,3,4
"93",2018-01-14,"Brush Creek Trailhead","w1718","Non.motorized",19,"Sun","weekend","no_sled","Brush/Cement","3","3","2",4.4,0,24,0,27,18.3,0,-2,5,0,0,-2,3,3
"94",2018-01-14,"Brush Creek Trailhead","w1718","Mechanized",0,"Sun","weekend","no_sled","Brush/Cement","3","3","2",4.4,0,24,0,27,18.3,0,-2,5,0,0,-2,3,3
"95",2018-01-14,"Brush Creek Trailhead","w1718","Motorized",0,"Sun","weekend","sled","Brush/Cement","3","3","2",4.4,0,24,0,27,18.3,0,-2,5,0,0,-2,3,3
"96",2018-01-14,"Brush Creek Trailhead","w1718","Hybrid",0,"Sun","weekend","sled","Brush/Cement","3","3","2",4.4,0,24,0,27,18.3,0,-2,5,0,0,-2,3,3
"97",2018-01-15,"Brush Creek Trailhead","w1718","Non.motorized",23,"Mon","weekday","no_sled","Brush/Cement","3","3","2",4.4,0,23,-1,27,19.1,0,0,-2,5,-1,-1,-3,2
"98",2018-01-15,"Brush Creek Trailhead","w1718","Mechanized",0,"Mon","weekday","no_sled","Brush/Cement","3","3","2",4.4,0,23,-1,27,19.1,0,0,-2,5,-1,-1,-3,2
"99",2018-01-15,"Brush Creek Trailhead","w1718","Motorized",0,"Mon","weekday","sled","Brush/Cement","3","3","2",4.4,0,23,-1,27,19.1,0,0,-2,5,-1,-1,-3,2
"100",2018-01-15,"Brush Creek Trailhead","w1718","Hybrid",0,"Mon","weekday","sled","Brush/Cement","3","3","2",4.4,0,23,-1,27,19.1,0,0,-2,5,-1,-1,-3,2
"101",2018-01-16,"Brush Creek Trailhead","w1718","Non.motorized",6,"Tue","weekday","no_sled","Brush/Cement","3","3","2",4.4,0,22,-1,20,20,-1,0,0,-2,-2,-2,-2,-4
"102",2018-01-16,"Brush Creek Trailhead","w1718","Mechanized",0,"Tue","weekday","no_sled","Brush/Cement","3","3","2",4.4,0,22,-1,20,20,-1,0,0,-2,-2,-2,-2,-4
"103",2018-01-16,"Brush Creek Trailhead","w1718","Motorized",0,"Tue","weekday","sled","Brush/Cement","3","3","2",4.4,0,22,-1,20,20,-1,0,0,-2,-2,-2,-2,-4
"104",2018-01-16,"Brush Creek Trailhead","w1718","Hybrid",0,"Tue","weekday","sled","Brush/Cement","3","3","2",4.4,0,22,-1,20,20,-1,0,0,-2,-2,-2,-2,-4
"105",2018-01-17,"Brush Creek Trailhead","w1718","Non.motorized",6,"Wed","weekday","no_sled","Brush/Cement","2","2","2",4.4,0,22,0,24,20,-1,-1,0,0,-1,-2,-2,-2
"106",2018-01-17,"Brush Creek Trailhead","w1718","Mechanized",0,"Wed","weekday","no_sled","Brush/Cement","2","2","2",4.4,0,22,0,24,20,-1,-1,0,0,-1,-2,-2,-2
"107",2018-01-17,"Brush Creek Trailhead","w1718","Motorized",0,"Wed","weekday","sled","Brush/Cement","2","2","2",4.4,0,22,0,24,20,-1,-1,0,0,-1,-2,-2,-2
"108",2018-01-17,"Brush Creek Trailhead","w1718","Hybrid",0,"Wed","weekday","sled","Brush/Cement","2","2","2",4.4,0,22,0,24,20,-1,-1,0,0,-1,-2,-2,-2
"109",2018-01-18,"Brush Creek Trailhead","w1718","Non.motorized",4,"Thu","weekday","no_sled","Brush/Cement","2","2","2",4.4,0,21,-1,29,21,0,-1,-1,0,-1,-2,-3,-3
"110",2018-01-18,"Brush Creek Trailhead","w1718","Mechanized",0,"Thu","weekday","no_sled","Brush/Cement","2","2","2",4.4,0,21,-1,29,21,0,-1,-1,0,-1,-2,-3,-3
"111",2018-01-18,"Brush Creek Trailhead","w1718","Motorized",0,"Thu","weekday","sled","Brush/Cement","2","2","2",4.4,0,21,-1,29,21,0,-1,-1,0,-1,-2,-3,-3
"112",2018-01-18,"Brush Creek Trailhead","w1718","Hybrid",0,"Thu","weekday","sled","Brush/Cement","2","2","2",4.4,0,21,-1,29,21,0,-1,-1,0,-1,-2,-3,-3
"113",2018-01-19,"Brush Creek Trailhead","w1718","Non.motorized",7,"Fri","weekday","no_sled","Brush/Cement","2","2","2",4.5,0.1,21,0,34,21.4,-1,0,-1,-1,-1,-1,-2,-3
"114",2018-01-19,"Brush Creek Trailhead","w1718","Mechanized",1,"Fri","weekday","no_sled","Brush/Cement","2","2","2",4.5,0.1,21,0,34,21.4,-1,0,-1,-1,-1,-1,-2,-3
"115",2018-01-19,"Brush Creek Trailhead","w1718","Motorized",0,"Fri","weekday","sled","Brush/Cement","2","2","2",4.5,0.1,21,0,34,21.4,-1,0,-1,-1,-1,-1,-2,-3
"116",2018-01-19,"Brush Creek Trailhead","w1718","Hybrid",0,"Fri","weekday","sled","Brush/Cement","2","2","2",4.5,0.1,21,0,34,21.4,-1,0,-1,-1,-1,-1,-2,-3
"117",2018-01-20,"Brush Creek Trailhead","w1718","Non.motorized",16,"Sat","weekend","no_sled","Brush/Cement","2","2","2",4.5,0,21,0,32,21.4,0,-1,0,-1,0,-1,-1,-2
"118",2018-01-20,"Brush Creek Trailhead","w1718","Mechanized",1,"Sat","weekend","no_sled","Brush/Cement","2","2","2",4.5,0,21,0,32,21.4,0,-1,0,-1,0,-1,-1,-2
"119",2018-01-20,"Brush Creek Trailhead","w1718","Motorized",0,"Sat","weekend","sled","Brush/Cement","2","2","2",4.5,0,21,0,32,21.4,0,-1,0,-1,0,-1,-1,-2
"120",2018-01-20,"Brush Creek Trailhead","w1718","Hybrid",0,"Sat","weekend","sled","Brush/Cement","2","2","2",4.5,0,21,0,32,21.4,0,-1,0,-1,0,-1,-1,-2
"121",2018-01-21,"Brush Creek Trailhead","w1718","Non.motorized",12,"Sun","weekend","no_sled","Brush/Cement","3","3","3",4.6,0.1,23,2,15,20,0,0,-1,0,2,2,1,1
"122",2018-01-21,"Brush Creek Trailhead","w1718","Mechanized",0,"Sun","weekend","no_sled","Brush/Cement","3","3","3",4.6,0.1,23,2,15,20,0,0,-1,0,2,2,1,1
"123",2018-01-21,"Brush Creek Trailhead","w1718","Motorized",0,"Sun","weekend","sled","Brush/Cement","3","3","3",4.6,0.1,23,2,15,20,0,0,-1,0,2,2,1,1
"124",2018-01-21,"Brush Creek Trailhead","w1718","Hybrid",0,"Sun","weekend","sled","Brush/Cement","3","3","3",4.6,0.1,23,2,15,20,0,0,-1,0,2,2,1,1
"125",2018-01-22,"Brush Creek Trailhead","w1718","Non.motorized",10,"Mon","weekday","no_sled","Brush/Cement","3","3","3",4.6,0,21,-2,12,21.9,2,0,0,-1,0,0,0,-1
"126",2018-01-22,"Brush Creek Trailhead","w1718","Mechanized",0,"Mon","weekday","no_sled","Brush/Cement","3","3","3",4.6,0,21,-2,12,21.9,2,0,0,-1,0,0,0,-1
"127",2018-01-22,"Brush Creek Trailhead","w1718","Motorized",0,"Mon","weekday","sled","Brush/Cement","3","3","3",4.6,0,21,-2,12,21.9,2,0,0,-1,0,0,0,-1
"128",2018-01-22,"Brush Creek Trailhead","w1718","Hybrid",0,"Mon","weekday","sled","Brush/Cement","3","3","3",4.6,0,21,-2,12,21.9,2,0,0,-1,0,0,0,-1
"129",2018-01-23,"Brush Creek Trailhead","w1718","Non.motorized",8,"Tue","weekday","no_sled","Brush/Cement","3","3","3",4.6,0,22,1,16,20.9,-2,2,0,0,-1,1,1,1
"130",2018-01-23,"Brush Creek Trailhead","w1718","Mechanized",0,"Tue","weekday","no_sled","Brush/Cement","3","3","3",4.6,0,22,1,16,20.9,-2,2,0,0,-1,1,1,1
"131",2018-01-23,"Brush Creek Trailhead","w1718","Motorized",0,"Tue","weekday","sled","Brush/Cement","3","3","3",4.6,0,22,1,16,20.9,-2,2,0,0,-1,1,1,1
"132",2018-01-23,"Brush Creek Trailhead","w1718","Hybrid",0,"Tue","weekday","sled","Brush/Cement","3","3","3",4.6,0,22,1,16,20.9,-2,2,0,0,-1,1,1,1
"133",2018-01-24,"Brush Creek Trailhead","w1718","Non.motorized",16,"Wed","weekday","no_sled","Brush/Cement","2","2","2",4.6,0,22,0,22,20.9,1,-2,2,0,1,-1,1,1
"134",2018-01-24,"Brush Creek Trailhead","w1718","Mechanized",0,"Wed","weekday","no_sled","Brush/Cement","2","2","2",4.6,0,22,0,22,20.9,1,-2,2,0,1,-1,1,1
"135",2018-01-24,"Brush Creek Trailhead","w1718","Motorized",0,"Wed","weekday","sled","Brush/Cement","2","2","2",4.6,0,22,0,22,20.9,1,-2,2,0,1,-1,1,1
"136",2018-01-24,"Brush Creek Trailhead","w1718","Hybrid",0,"Wed","weekday","sled","Brush/Cement","2","2","2",4.6,0,22,0,22,20.9,1,-2,2,0,1,-1,1,1
"137",2018-01-25,"Brush Creek Trailhead","w1718","Non.motorized",19,"Thu","weekday","no_sled","Brush/Cement","2","2","2",4.6,0,22,0,28,20.9,0,1,-2,2,0,1,-1,1
"138",2018-01-25,"Brush Creek Trailhead","w1718","Mechanized",0,"Thu","weekday","no_sled","Brush/Cement","2","2","2",4.6,0,22,0,28,20.9,0,1,-2,2,0,1,-1,1
"139",2018-01-25,"Brush Creek Trailhead","w1718","Motorized",0,"Thu","weekday","sled","Brush/Cement","2","2","2",4.6,0,22,0,28,20.9,0,1,-2,2,0,1,-1,1
"140",2018-01-25,"Brush Creek Trailhead","w1718","Hybrid",0,"Thu","weekday","sled","Brush/Cement","2","2","2",4.6,0,22,0,28,20.9,0,1,-2,2,0,1,-1,1
"141",2018-01-26,"Brush Creek Trailhead","w1718","Non.motorized",11,"Fri","weekday","no_sled","Brush/Cement","2","2","2",4.7,0.1,22,0,15,21.4,0,0,1,-2,0,0,1,-1
"142",2018-01-26,"Brush Creek Trailhead","w1718","Mechanized",3,"Fri","weekday","no_sled","Brush/Cement","2","2","2",4.7,0.1,22,0,15,21.4,0,0,1,-2,0,0,1,-1
"143",2018-01-26,"Brush Creek Trailhead","w1718","Motorized",0,"Fri","weekday","sled","Brush/Cement","2","2","2",4.7,0.1,22,0,15,21.4,0,0,1,-2,0,0,1,-1
"144",2018-01-26,"Brush Creek Trailhead","w1718","Hybrid",0,"Fri","weekday","sled","Brush/Cement","2","2","2",4.7,0.1,22,0,15,21.4,0,0,1,-2,0,0,1,-1
"145",2018-01-27,"Brush Creek Trailhead","w1718","Non.motorized",21,"Sat","weekend","no_sled","Brush/Cement","2","2","2",4.7,0,23,1,16,20.4,0,0,0,1,1,1,1,2
"146",2018-01-27,"Brush Creek Trailhead","w1718","Mechanized",0,"Sat","weekend","no_sled","Brush/Cement","2","2","2",4.7,0,23,1,16,20.4,0,0,0,1,1,1,1,2
"147",2018-01-27,"Brush Creek Trailhead","w1718","Motorized",0,"Sat","weekend","sled","Brush/Cement","2","2","2",4.7,0,23,1,16,20.4,0,0,0,1,1,1,1,2
"148",2018-01-27,"Brush Creek Trailhead","w1718","Hybrid",0,"Sat","weekend","sled","Brush/Cement","2","2","2",4.7,0,23,1,16,20.4,0,0,0,1,1,1,1,2
"149",2018-01-28,"Brush Creek Trailhead","w1718","Non.motorized",18,"Sun","weekend","no_sled","Brush/Cement","2","2","2",4.7,0,23,0,25,20.4,1,0,0,0,1,1,1,1
"150",2018-01-28,"Brush Creek Trailhead","w1718","Mechanized",0,"Sun","weekend","no_sled","Brush/Cement","2","2","2",4.7,0,23,0,25,20.4,1,0,0,0,1,1,1,1
"151",2018-01-28,"Brush Creek Trailhead","w1718","Motorized",0,"Sun","weekend","sled","Brush/Cement","2","2","2",4.7,0,23,0,25,20.4,1,0,0,0,1,1,1,1
"152",2018-01-28,"Brush Creek Trailhead","w1718","Hybrid",0,"Sun","weekend","sled","Brush/Cement","2","2","2",4.7,0,23,0,25,20.4,1,0,0,0,1,1,1,1
"153",2018-01-29,"Brush Creek Trailhead","w1718","Non.motorized",22,"Mon","weekday","no_sled","Brush/Cement","2","2","2",4.8,0.1,22,-1,30,21.8,0,1,0,0,-1,0,0,0
"154",2018-01-29,"Brush Creek Trailhead","w1718","Mechanized",0,"Mon","weekday","no_sled","Brush/Cement","2","2","2",4.8,0.1,22,-1,30,21.8,0,1,0,0,-1,0,0,0
"155",2018-01-29,"Brush Creek Trailhead","w1718","Motorized",0,"Mon","weekday","sled","Brush/Cement","2","2","2",4.8,0.1,22,-1,30,21.8,0,1,0,0,-1,0,0,0
"156",2018-01-29,"Brush Creek Trailhead","w1718","Hybrid",0,"Mon","weekday","sled","Brush/Cement","2","2","2",4.8,0.1,22,-1,30,21.8,0,1,0,0,-1,0,0,0
"157",2018-01-30,"Brush Creek Trailhead","w1718","Non.motorized",17,"Tue","weekday","no_sled","Brush/Cement","2","2","2",4.8,0,22,0,34,21.8,-1,0,1,0,-1,-1,0,0
"158",2018-01-30,"Brush Creek Trailhead","w1718","Mechanized",0,"Tue","weekday","no_sled","Brush/Cement","2","2","2",4.8,0,22,0,34,21.8,-1,0,1,0,-1,-1,0,0
"159",2018-01-30,"Brush Creek Trailhead","w1718","Motorized",0,"Tue","weekday","sled","Brush/Cement","2","2","2",4.8,0,22,0,34,21.8,-1,0,1,0,-1,-1,0,0
"160",2018-01-30,"Brush Creek Trailhead","w1718","Hybrid",0,"Tue","weekday","sled","Brush/Cement","2","2","2",4.8,0,22,0,34,21.8,-1,0,1,0,-1,-1,0,0
"161",2018-01-31,"Brush Creek Trailhead","w1718","Non.motorized",25,"Wed","weekday","no_sled","Brush/Cement","2","2","2",4.8,0,22,0,34,21.8,0,-1,0,1,0,-1,-1,0
"162",2018-01-31,"Brush Creek Trailhead","w1718","Mechanized",0,"Wed","weekday","no_sled","Brush/Cement","2","2","2",4.8,0,22,0,34,21.8,0,-1,0,1,0,-1,-1,0
"163",2018-01-31,"Brush Creek Trailhead","w1718","Motorized",0,"Wed","weekday","sled","Brush/Cement","2","2","2",4.8,0,22,0,34,21.8,0,-1,0,1,0,-1,-1,0
"164",2018-01-31,"Brush Creek Trailhead","w1718","Hybrid",0,"Wed","weekday","sled","Brush/Cement","2","2","2",4.8,0,22,0,34,21.8,0,-1,0,1,0,-1,-1,0
"165",2018-02-01,"Brush Creek Trailhead","w1718","Non.motorized",11,"Thu","weekday","no_sled","Brush/Cement","2","2","2",4.9,0.1,21,-1,32,23.3,0,0,-1,0,-1,-1,-2,-2
"166",2018-02-01,"Brush Creek Trailhead","w1718","Mechanized",0,"Thu","weekday","no_sled","Brush/Cement","2","2","2",4.9,0.1,21,-1,32,23.3,0,0,-1,0,-1,-1,-2,-2
"167",2018-02-01,"Brush Creek Trailhead","w1718","Motorized",0,"Thu","weekday","sled","Brush/Cement","2","2","2",4.9,0.1,21,-1,32,23.3,0,0,-1,0,-1,-1,-2,-2
"168",2018-02-01,"Brush Creek Trailhead","w1718","Hybrid",0,"Thu","weekday","sled","Brush/Cement","2","2","2",4.9,0.1,21,-1,32,23.3,0,0,-1,0,-1,-1,-2,-2
"169",2018-02-02,"Brush Creek Trailhead","w1718","Non.motorized",18,"Fri","weekday","no_sled","Brush/Cement","2","2","2",4.9,0,20,-1,33,24.5,-1,0,0,-1,-2,-2,-2,-3
"170",2018-02-02,"Brush Creek Trailhead","w1718","Mechanized",0,"Fri","weekday","no_sled","Brush/Cement","2","2","2",4.9,0,20,-1,33,24.5,-1,0,0,-1,-2,-2,-2,-3
"171",2018-02-02,"Brush Creek Trailhead","w1718","Motorized",0,"Fri","weekday","sled","Brush/Cement","2","2","2",4.9,0,20,-1,33,24.5,-1,0,0,-1,-2,-2,-2,-3
"172",2018-02-02,"Brush Creek Trailhead","w1718","Hybrid",0,"Fri","weekday","sled","Brush/Cement","2","2","2",4.9,0,20,-1,33,24.5,-1,0,0,-1,-2,-2,-2,-3
"173",2018-02-03,"Brush Creek Trailhead","w1718","Non.motorized",19,"Sat","weekend","no_sled","Brush/Cement","2","2","2",4.9,0,21,1,32,23.3,-1,-1,0,0,0,-1,-1,-1
"174",2018-02-03,"Brush Creek Trailhead","w1718","Mechanized",0,"Sat","weekend","no_sled","Brush/Cement","2","2","2",4.9,0,21,1,32,23.3,-1,-1,0,0,0,-1,-1,-1
"175",2018-02-03,"Brush Creek Trailhead","w1718","Motorized",0,"Sat","weekend","sled","Brush/Cement","2","2","2",4.9,0,21,1,32,23.3,-1,-1,0,0,0,-1,-1,-1
"176",2018-02-03,"Brush Creek Trailhead","w1718","Hybrid",0,"Sat","weekend","sled","Brush/Cement","2","2","2",4.9,0,21,1,32,23.3,-1,-1,0,0,0,-1,-1,-1
"177",2018-02-04,"Brush Creek Trailhead","w1718","Non.motorized",18,"Sun","weekend","no_sled","Brush/Cement","2","2","2",4.9,0,19,-2,32,25.8,1,-1,-1,0,-1,-2,-3,-3
"178",2018-02-04,"Brush Creek Trailhead","w1718","Mechanized",1,"Sun","weekend","no_sled","Brush/Cement","2","2","2",4.9,0,19,-2,32,25.8,1,-1,-1,0,-1,-2,-3,-3
"179",2018-02-04,"Brush Creek Trailhead","w1718","Motorized",0,"Sun","weekend","sled","Brush/Cement","2","2","2",4.9,0,19,-2,32,25.8,1,-1,-1,0,-1,-2,-3,-3
"180",2018-02-04,"Brush Creek Trailhead","w1718","Hybrid",0,"Sun","weekend","sled","Brush/Cement","2","2","2",4.9,0,19,-2,32,25.8,1,-1,-1,0,-1,-2,-3,-3
"181",2018-02-05,"Brush Creek Trailhead","w1718","Non.motorized",0,"Mon","weekday","no_sled","Brush/Cement","2","2","2",5,0.1,18,-1,29,27.8,-2,1,-1,-1,-3,-2,-3,-4
"182",2018-02-05,"Brush Creek Trailhead","w1718","Mechanized",0,"Mon","weekday","no_sled","Brush/Cement","2","2","2",5,0.1,18,-1,29,27.8,-2,1,-1,-1,-3,-2,-3,-4
"183",2018-02-05,"Brush Creek Trailhead","w1718","Motorized",0,"Mon","weekday","sled","Brush/Cement","2","2","2",5,0.1,18,-1,29,27.8,-2,1,-1,-1,-3,-2,-3,-4
"184",2018-02-05,"Brush Creek Trailhead","w1718","Hybrid",0,"Mon","weekday","sled","Brush/Cement","2","2","2",5,0.1,18,-1,29,27.8,-2,1,-1,-1,-3,-2,-3,-4
"185",2018-02-06,"Brush Creek Trailhead","w1718","Non.motorized",11,"Tue","weekday","no_sled","Brush/Cement","2","2","2",5.2,0.2,23,5,22,22.6,-1,-2,1,-1,4,2,3,2
"186",2018-02-06,"Brush Creek Trailhead","w1718","Mechanized",0,"Tue","weekday","no_sled","Brush/Cement","2","2","2",5.2,0.2,23,5,22,22.6,-1,-2,1,-1,4,2,3,2
"187",2018-02-06,"Brush Creek Trailhead","w1718","Motorized",0,"Tue","weekday","sled","Brush/Cement","2","2","2",5.2,0.2,23,5,22,22.6,-1,-2,1,-1,4,2,3,2
"188",2018-02-06,"Brush Creek Trailhead","w1718","Hybrid",0,"Tue","weekday","sled","Brush/Cement","2","2","2",5.2,0.2,23,5,22,22.6,-1,-2,1,-1,4,2,3,2
"189",2018-02-07,"Brush Creek Trailhead","w1718","Non.motorized",19,"Wed","weekday","no_sled","Brush/Cement","2","2","2",5.2,0,23,0,24,22.6,5,-1,-2,1,5,4,2,3
"190",2018-02-07,"Brush Creek Trailhead","w1718","Mechanized",0,"Wed","weekday","no_sled","Brush/Cement","2","2","2",5.2,0,23,0,24,22.6,5,-1,-2,1,5,4,2,3
"191",2018-02-07,"Brush Creek Trailhead","w1718","Motorized",0,"Wed","weekday","sled","Brush/Cement","2","2","2",5.2,0,23,0,24,22.6,5,-1,-2,1,5,4,2,3
"192",2018-02-07,"Brush Creek Trailhead","w1718","Hybrid",0,"Wed","weekday","sled","Brush/Cement","2","2","2",5.2,0,23,0,24,22.6,5,-1,-2,1,5,4,2,3
"193",2018-02-08,"Brush Creek Trailhead","w1718","Non.motorized",16,"Thu","weekday","no_sled","Brush/Cement","2","2","1",5.3,0.1,25,2,28,21.2,0,5,-1,-2,2,7,6,4
"194",2018-02-08,"Brush Creek Trailhead","w1718","Mechanized",0,"Thu","weekday","no_sled","Brush/Cement","2","2","1",5.3,0.1,25,2,28,21.2,0,5,-1,-2,2,7,6,4
"195",2018-02-08,"Brush Creek Trailhead","w1718","Motorized",0,"Thu","weekday","sled","Brush/Cement","2","2","1",5.3,0.1,25,2,28,21.2,0,5,-1,-2,2,7,6,4
"196",2018-02-08,"Brush Creek Trailhead","w1718","Hybrid",0,"Thu","weekday","sled","Brush/Cement","2","2","1",5.3,0.1,25,2,28,21.2,0,5,-1,-2,2,7,6,4
"197",2018-02-09,"Brush Creek Trailhead","w1718","Non.motorized",19,"Fri","weekday","no_sled","Brush/Cement","2","2","1",5.3,0,24,-1,33,22.1,2,0,5,-1,1,1,6,5
"198",2018-02-09,"Brush Creek Trailhead","w1718","Mechanized",3,"Fri","weekday","no_sled","Brush/Cement","2","2","1",5.3,0,24,-1,33,22.1,2,0,5,-1,1,1,6,5
"199",2018-02-09,"Brush Creek Trailhead","w1718","Motorized",0,"Fri","weekday","sled","Brush/Cement","2","2","1",5.3,0,24,-1,33,22.1,2,0,5,-1,1,1,6,5
"200",2018-02-09,"Brush Creek Trailhead","w1718","Hybrid",0,"Fri","weekday","sled","Brush/Cement","2","2","1",5.3,0,24,-1,33,22.1,2,0,5,-1,1,1,6,5
"201",2018-02-10,"Brush Creek Trailhead","w1718","Non.motorized",4,"Sat","weekend","no_sled","Brush/Cement","3","3","2",5.3,0,24,0,24,22.1,-1,2,0,5,-1,1,1,6
"202",2018-02-10,"Brush Creek Trailhead","w1718","Mechanized",0,"Sat","weekend","no_sled","Brush/Cement","3","3","2",5.3,0,24,0,24,22.1,-1,2,0,5,-1,1,1,6
"203",2018-02-10,"Brush Creek Trailhead","w1718","Motorized",0,"Sat","weekend","sled","Brush/Cement","3","3","2",5.3,0,24,0,24,22.1,-1,2,0,5,-1,1,1,6
"204",2018-02-10,"Brush Creek Trailhead","w1718","Hybrid",0,"Sat","weekend","sled","Brush/Cement","3","3","2",5.3,0,24,0,24,22.1,-1,2,0,5,-1,1,1,6
"205",2018-02-11,"Brush Creek Trailhead","w1718","Non.motorized",14,"Sun","weekend","no_sled","Brush/Cement","3","3","2",5.6,0.3,27,3,13,20.7,0,-1,2,0,3,2,4,4
"206",2018-02-11,"Brush Creek Trailhead","w1718","Mechanized",0,"Sun","weekend","no_sled","Brush/Cement","3","3","2",5.6,0.3,27,3,13,20.7,0,-1,2,0,3,2,4,4
"207",2018-02-11,"Brush Creek Trailhead","w1718","Motorized",0,"Sun","weekend","sled","Brush/Cement","3","3","2",5.6,0.3,27,3,13,20.7,0,-1,2,0,3,2,4,4
"208",2018-02-11,"Brush Creek Trailhead","w1718","Hybrid",0,"Sun","weekend","sled","Brush/Cement","3","3","2",5.6,0.3,27,3,13,20.7,0,-1,2,0,3,2,4,4
"209",2018-02-12,"Brush Creek Trailhead","w1718","Non.motorized",8,"Mon","weekday","no_sled","Brush/Cement","3","3","3",5.7,0.1,27,0,23,21.1,3,0,-1,2,3,3,2,4
"210",2018-02-12,"Brush Creek Trailhead","w1718","Mechanized",0,"Mon","weekday","no_sled","Brush/Cement","3","3","3",5.7,0.1,27,0,23,21.1,3,0,-1,2,3,3,2,4
"211",2018-02-12,"Brush Creek Trailhead","w1718","Motorized",0,"Mon","weekday","sled","Brush/Cement","3","3","3",5.7,0.1,27,0,23,21.1,3,0,-1,2,3,3,2,4
"212",2018-02-12,"Brush Creek Trailhead","w1718","Hybrid",0,"Mon","weekday","sled","Brush/Cement","3","3","3",5.7,0.1,27,0,23,21.1,3,0,-1,2,3,3,2,4
"213",2018-02-13,"Brush Creek Trailhead","w1718","Non.motorized",4,"Tue","weekday","no_sled","Brush/Cement","3","3","3",6.1,0.4,29,2,28,21,0,3,0,-1,2,5,5,4
"214",2018-02-13,"Brush Creek Trailhead","w1718","Mechanized",0,"Tue","weekday","no_sled","Brush/Cement","3","3","3",6.1,0.4,29,2,28,21,0,3,0,-1,2,5,5,4
"215",2018-02-13,"Brush Creek Trailhead","w1718","Motorized",0,"Tue","weekday","sled","Brush/Cement","3","3","3",6.1,0.4,29,2,28,21,0,3,0,-1,2,5,5,4
"216",2018-02-13,"Brush Creek Trailhead","w1718","Hybrid",0,"Tue","weekday","sled","Brush/Cement","3","3","3",6.1,0.4,29,2,28,21,0,3,0,-1,2,5,5,4
"217",2018-02-14,"Brush Creek Trailhead","w1718","Non.motorized",1,"Wed","weekday","no_sled","Brush/Cement","3","3","3",6.2,0.1,30,1,30,20.7,2,0,3,0,3,3,6,6
"218",2018-02-14,"Brush Creek Trailhead","w1718","Mechanized",0,"Wed","weekday","no_sled","Brush/Cement","3","3","3",6.2,0.1,30,1,30,20.7,2,0,3,0,3,3,6,6
"219",2018-02-14,"Brush Creek Trailhead","w1718","Motorized",0,"Wed","weekday","sled","Brush/Cement","3","3","3",6.2,0.1,30,1,30,20.7,2,0,3,0,3,3,6,6
"220",2018-02-14,"Brush Creek Trailhead","w1718","Hybrid",0,"Wed","weekday","sled","Brush/Cement","3","3","3",6.2,0.1,30,1,30,20.7,2,0,3,0,3,3,6,6
"221",2018-02-15,"Brush Creek Trailhead","w1718","Non.motorized",9,"Thu","weekday","no_sled","Brush/Cement","3","3","3",6.3,0.1,28,-2,24,22.5,1,2,0,3,-1,1,1,4
"222",2018-02-15,"Brush Creek Trailhead","w1718","Mechanized",0,"Thu","weekday","no_sled","Brush/Cement","3","3","3",6.3,0.1,28,-2,24,22.5,1,2,0,3,-1,1,1,4
"223",2018-02-15,"Brush Creek Trailhead","w1718","Motorized",0,"Thu","weekday","sled","Brush/Cement","3","3","3",6.3,0.1,28,-2,24,22.5,1,2,0,3,-1,1,1,4
"224",2018-02-15,"Brush Creek Trailhead","w1718","Hybrid",0,"Thu","weekday","sled","Brush/Cement","3","3","3",6.3,0.1,28,-2,24,22.5,1,2,0,3,-1,1,1,4
"225",2018-02-16,"Brush Creek Trailhead","w1718","Non.motorized",7,"Fri","weekday","no_sled","Brush/Cement","3","3","3",6.7,0.4,32,4,18,20.9,-2,1,2,0,2,3,5,5
"226",2018-02-16,"Brush Creek Trailhead","w1718","Mechanized",0,"Fri","weekday","no_sled","Brush/Cement","3","3","3",6.7,0.4,32,4,18,20.9,-2,1,2,0,2,3,5,5
"227",2018-02-16,"Brush Creek Trailhead","w1718","Motorized",0,"Fri","weekday","sled","Brush/Cement","3","3","3",6.7,0.4,32,4,18,20.9,-2,1,2,0,2,3,5,5
"228",2018-02-16,"Brush Creek Trailhead","w1718","Hybrid",0,"Fri","weekday","sled","Brush/Cement","3","3","3",6.7,0.4,32,4,18,20.9,-2,1,2,0,2,3,5,5
"229",2018-02-17,"Brush Creek Trailhead","w1718","Non.motorized",32,"Sat","weekend","no_sled","Brush/Cement","3","3","2",6.7,0,32,0,25,20.9,4,-2,1,2,4,2,3,5
"230",2018-02-17,"Brush Creek Trailhead","w1718","Mechanized",2,"Sat","weekend","no_sled","Brush/Cement","3","3","2",6.7,0,32,0,25,20.9,4,-2,1,2,4,2,3,5
"231",2018-02-17,"Brush Creek Trailhead","w1718","Motorized",2,"Sat","weekend","sled","Brush/Cement","3","3","2",6.7,0,32,0,25,20.9,4,-2,1,2,4,2,3,5
"232",2018-02-17,"Brush Creek Trailhead","w1718","Hybrid",0,"Sat","weekend","sled","Brush/Cement","3","3","2",6.7,0,32,0,25,20.9,4,-2,1,2,4,2,3,5
"233",2018-02-18,"Brush Creek Trailhead","w1718","Non.motorized",38,"Sun","weekend","no_sled","Brush/Cement","2","2","2",6.7,0,31,-1,32,21.6,0,4,-2,1,-1,3,1,2
"234",2018-02-18,"Brush Creek Trailhead","w1718","Mechanized",0,"Sun","weekend","no_sled","Brush/Cement","2","2","2",6.7,0,31,-1,32,21.6,0,4,-2,1,-1,3,1,2
"235",2018-02-18,"Brush Creek Trailhead","w1718","Motorized",0,"Sun","weekend","sled","Brush/Cement","2","2","2",6.7,0,31,-1,32,21.6,0,4,-2,1,-1,3,1,2
"236",2018-02-18,"Brush Creek Trailhead","w1718","Hybrid",0,"Sun","weekend","sled","Brush/Cement","2","2","2",6.7,0,31,-1,32,21.6,0,4,-2,1,-1,3,1,2
"237",2018-02-19,"Brush Creek Trailhead","w1718","Non.motorized",6,"Mon","weekday","no_sled","Brush/Cement","2","2","2",6.8,0.1,29,-2,24,23.4,-1,0,4,-2,-3,-3,1,-1
"238",2018-02-19,"Brush Creek Trailhead","w1718","Non.motorized",6,"Mon","weekday","no_sled","Brush/Cement","3","3","3",6.8,0.1,29,-2,24,23.4,-1,0,4,-2,-3,-3,1,-1
"239",2018-02-19,"Brush Creek Trailhead","w1718","Mechanized",0,"Mon","weekday","no_sled","Brush/Cement","2","2","2",6.8,0.1,29,-2,24,23.4,-1,0,4,-2,-3,-3,1,-1
"240",2018-02-19,"Brush Creek Trailhead","w1718","Mechanized",0,"Mon","weekday","no_sled","Brush/Cement","3","3","3",6.8,0.1,29,-2,24,23.4,-1,0,4,-2,-3,-3,1,-1
"241",2018-02-19,"Brush Creek Trailhead","w1718","Motorized",0,"Mon","weekday","sled","Brush/Cement","2","2","2",6.8,0.1,29,-2,24,23.4,-1,0,4,-2,-3,-3,1,-1
"242",2018-02-19,"Brush Creek Trailhead","w1718","Motorized",0,"Mon","weekday","sled","Brush/Cement","3","3","3",6.8,0.1,29,-2,24,23.4,-1,0,4,-2,-3,-3,1,-1
"243",2018-02-19,"Brush Creek Trailhead","w1718","Hybrid",0,"Mon","weekday","sled","Brush/Cement","2","2","2",6.8,0.1,29,-2,24,23.4,-1,0,4,-2,-3,-3,1,-1
"244",2018-02-19,"Brush Creek Trailhead","w1718","Hybrid",0,"Mon","weekday","sled","Brush/Cement","3","3","3",6.8,0.1,29,-2,24,23.4,-1,0,4,-2,-3,-3,1,-1
"245",2018-02-20,"Brush Creek Trailhead","w1718","Non.motorized",9,"Tue","weekday","no_sled","Brush/Cement","3","3","3",6.8,0,31,2,8,21.9,-2,-1,0,4,0,-1,-1,3
"246",2018-02-20,"Brush Creek Trailhead","w1718","Mechanized",0,"Tue","weekday","no_sled","Brush/Cement","3","3","3",6.8,0,31,2,8,21.9,-2,-1,0,4,0,-1,-1,3
"247",2018-02-20,"Brush Creek Trailhead","w1718","Motorized",0,"Tue","weekday","sled","Brush/Cement","3","3","3",6.8,0,31,2,8,21.9,-2,-1,0,4,0,-1,-1,3
"248",2018-02-20,"Brush Creek Trailhead","w1718","Hybrid",0,"Tue","weekday","sled","Brush/Cement","3","3","3",6.8,0,31,2,8,21.9,-2,-1,0,4,0,-1,-1,3
"249",2018-02-21,"Brush Creek Trailhead","w1718","Non.motorized",4,"Wed","weekday","no_sled","Brush/Cement","3","3","3",6.8,0,31,0,11,21.9,2,-2,-1,0,2,0,-1,-1
"250",2018-02-21,"Brush Creek Trailhead","w1718","Mechanized",0,"Wed","weekday","no_sled","Brush/Cement","3","3","3",6.8,0,31,0,11,21.9,2,-2,-1,0,2,0,-1,-1
"251",2018-02-21,"Brush Creek Trailhead","w1718","Motorized",0,"Wed","weekday","sled","Brush/Cement","3","3","3",6.8,0,31,0,11,21.9,2,-2,-1,0,2,0,-1,-1
"252",2018-02-21,"Brush Creek Trailhead","w1718","Hybrid",0,"Wed","weekday","sled","Brush/Cement","3","3","3",6.8,0,31,0,11,21.9,2,-2,-1,0,2,0,-1,-1
"253",2018-02-22,"Brush Creek Trailhead","w1718","Non.motorized",18,"Thu","weekday","no_sled","Brush/Cement","3","3","2",6.8,0,30,-1,16,22.7,0,2,-2,-1,-1,1,-1,-2
"254",2018-02-22,"Brush Creek Trailhead","w1718","Mechanized",0,"Thu","weekday","no_sled","Brush/Cement","3","3","2",6.8,0,30,-1,16,22.7,0,2,-2,-1,-1,1,-1,-2
"255",2018-02-22,"Brush Creek Trailhead","w1718","Motorized",0,"Thu","weekday","sled","Brush/Cement","3","3","2",6.8,0,30,-1,16,22.7,0,2,-2,-1,-1,1,-1,-2
"256",2018-02-22,"Brush Creek Trailhead","w1718","Hybrid",0,"Thu","weekday","sled","Brush/Cement","3","3","2",6.8,0,30,-1,16,22.7,0,2,-2,-1,-1,1,-1,-2
"257",2018-02-23,"Brush Creek Trailhead","w1718","Non.motorized",19,"Fri","weekday","no_sled","Brush/Cement","3","3","2",6.9,0.1,30,0,15,23,-1,0,2,-2,-1,-1,1,-1
"258",2018-02-23,"Brush Creek Trailhead","w1718","Mechanized",0,"Fri","weekday","no_sled","Brush/Cement","3","3","2",6.9,0.1,30,0,15,23,-1,0,2,-2,-1,-1,1,-1
"259",2018-02-23,"Brush Creek Trailhead","w1718","Motorized",0,"Fri","weekday","sled","Brush/Cement","3","3","2",6.9,0.1,30,0,15,23,-1,0,2,-2,-1,-1,1,-1
"260",2018-02-23,"Brush Creek Trailhead","w1718","Hybrid",0,"Fri","weekday","sled","Brush/Cement","3","3","2",6.9,0.1,30,0,15,23,-1,0,2,-2,-1,-1,1,-1
"261",2018-02-24,"Brush Creek Trailhead","w1718","Non.motorized",8,"Sat","weekend","no_sled","Brush/Cement","3","3","2",6.9,0,31,1,10,22.3,0,-1,0,2,1,0,0,2
"262",2018-02-24,"Brush Creek Trailhead","w1718","Mechanized",0,"Sat","weekend","no_sled","Brush/Cement","3","3","2",6.9,0,31,1,10,22.3,0,-1,0,2,1,0,0,2
"263",2018-02-24,"Brush Creek Trailhead","w1718","Motorized",0,"Sat","weekend","sled","Brush/Cement","3","3","2",6.9,0,31,1,10,22.3,0,-1,0,2,1,0,0,2
"264",2018-02-24,"Brush Creek Trailhead","w1718","Hybrid",0,"Sat","weekend","sled","Brush/Cement","3","3","2",6.9,0,31,1,10,22.3,0,-1,0,2,1,0,0,2
"265",2018-02-25,"Brush Creek Trailhead","w1718","Non.motorized",25,"Sun","weekend","no_sled","Brush/Cement","3","3","2",7.1,0.2,32,1,11,22.2,1,0,-1,0,2,2,1,1
"266",2018-02-25,"Brush Creek Trailhead","w1718","Mechanized",0,"Sun","weekend","no_sled","Brush/Cement","3","3","2",7.1,0.2,32,1,11,22.2,1,0,-1,0,2,2,1,1
"267",2018-02-25,"Brush Creek Trailhead","w1718","Motorized",0,"Sun","weekend","sled","Brush/Cement","3","3","2",7.1,0.2,32,1,11,22.2,1,0,-1,0,2,2,1,1
"268",2018-02-25,"Brush Creek Trailhead","w1718","Hybrid",0,"Sun","weekend","sled","Brush/Cement","3","3","2",7.1,0.2,32,1,11,22.2,1,0,-1,0,2,2,1,1
"269",2018-02-26,"Brush Creek Trailhead","w1718","Non.motorized",13,"Mon","weekday","no_sled","Brush/Cement","2","2","2",7.1,0,32,0,20,22.2,1,1,0,-1,1,2,2,1
"270",2018-02-26,"Brush Creek Trailhead","w1718","Mechanized",1,"Mon","weekday","no_sled","Brush/Cement","2","2","2",7.1,0,32,0,20,22.2,1,1,0,-1,1,2,2,1
"271",2018-02-26,"Brush Creek Trailhead","w1718","Motorized",0,"Mon","weekday","sled","Brush/Cement","2","2","2",7.1,0,32,0,20,22.2,1,1,0,-1,1,2,2,1
"272",2018-02-26,"Brush Creek Trailhead","w1718","Hybrid",0,"Mon","weekday","sled","Brush/Cement","2","2","2",7.1,0,32,0,20,22.2,1,1,0,-1,1,2,2,1
"273",2018-02-27,"Brush Creek Trailhead","w1718","Non.motorized",8,"Tue","weekday","no_sled","Brush/Cement","2","2","2",7.2,0.1,32,0,26,22.5,0,1,1,0,0,1,2,2
"274",2018-02-27,"Brush Creek Trailhead","w1718","Mechanized",1,"Tue","weekday","no_sled","Brush/Cement","2","2","2",7.2,0.1,32,0,26,22.5,0,1,1,0,0,1,2,2
"275",2018-02-27,"Brush Creek Trailhead","w1718","Motorized",0,"Tue","weekday","sled","Brush/Cement","2","2","2",7.2,0.1,32,0,26,22.5,0,1,1,0,0,1,2,2
"276",2018-02-27,"Brush Creek Trailhead","w1718","Hybrid",0,"Tue","weekday","sled","Brush/Cement","2","2","2",7.2,0.1,32,0,26,22.5,0,1,1,0,0,1,2,2
"277",2018-02-28,"Brush Creek Trailhead","w1718","Non.motorized",13,"Wed","weekday","no_sled","Brush/Cement","2","2","2",7.2,0,31,-1,23,23.2,0,0,1,1,-1,-1,0,1
"278",2018-02-28,"Brush Creek Trailhead","w1718","Mechanized",0,"Wed","weekday","no_sled","Brush/Cement","2","2","2",7.2,0,31,-1,23,23.2,0,0,1,1,-1,-1,0,1
"279",2018-02-28,"Brush Creek Trailhead","w1718","Motorized",0,"Wed","weekday","sled","Brush/Cement","2","2","2",7.2,0,31,-1,23,23.2,0,0,1,1,-1,-1,0,1
"280",2018-02-28,"Brush Creek Trailhead","w1718","Hybrid",0,"Wed","weekday","sled","Brush/Cement","2","2","2",7.2,0,31,-1,23,23.2,0,0,1,1,-1,-1,0,1
"281",2018-03-01,"Brush Creek Trailhead","w1718","Non.motorized",7,"Thu","weekday","no_sled","Brush/Cement","2","2","2",7.2,0,31,0,24,23.2,-1,0,0,1,-1,-1,-1,0
"282",2018-03-01,"Brush Creek Trailhead","w1718","Mechanized",1,"Thu","weekday","no_sled","Brush/Cement","2","2","2",7.2,0,31,0,24,23.2,-1,0,0,1,-1,-1,-1,0
"283",2018-03-01,"Brush Creek Trailhead","w1718","Motorized",0,"Thu","weekday","sled","Brush/Cement","2","2","2",7.2,0,31,0,24,23.2,-1,0,0,1,-1,-1,-1,0
"284",2018-03-01,"Brush Creek Trailhead","w1718","Hybrid",0,"Thu","weekday","sled","Brush/Cement","2","2","2",7.2,0,31,0,24,23.2,-1,0,0,1,-1,-1,-1,0
"285",2018-03-02,"Brush Creek Trailhead","w1718","Non.motorized",14,"Fri","weekday","no_sled","Brush/Cement","2","2","1",7.2,0,31,0,30,23.2,0,-1,0,0,0,-1,-1,-1
"286",2018-03-02,"Brush Creek Trailhead","w1718","Mechanized",0,"Fri","weekday","no_sled","Brush/Cement","2","2","1",7.2,0,31,0,30,23.2,0,-1,0,0,0,-1,-1,-1
"287",2018-03-02,"Brush Creek Trailhead","w1718","Motorized",0,"Fri","weekday","sled","Brush/Cement","2","2","1",7.2,0,31,0,30,23.2,0,-1,0,0,0,-1,-1,-1
"288",2018-03-02,"Brush Creek Trailhead","w1718","Hybrid",0,"Fri","weekday","sled","Brush/Cement","2","2","1",7.2,0,31,0,30,23.2,0,-1,0,0,0,-1,-1,-1
"289",2018-03-03,"Brush Creek Trailhead","w1718","Non.motorized",36,"Sat","weekend","no_sled","Brush/Cement","2","2","1",7.3,0.1,30,-1,34,24.3,0,0,-1,0,-1,-1,-2,-2
"290",2018-03-03,"Brush Creek Trailhead","w1718","Mechanized",0,"Sat","weekend","no_sled","Brush/Cement","2","2","1",7.3,0.1,30,-1,34,24.3,0,0,-1,0,-1,-1,-2,-2
"291",2018-03-03,"Brush Creek Trailhead","w1718","Motorized",0,"Sat","weekend","sled","Brush/Cement","2","2","1",7.3,0.1,30,-1,34,24.3,0,0,-1,0,-1,-1,-2,-2
"292",2018-03-03,"Brush Creek Trailhead","w1718","Hybrid",0,"Sat","weekend","sled","Brush/Cement","2","2","1",7.3,0.1,30,-1,34,24.3,0,0,-1,0,-1,-1,-2,-2
"293",2018-03-04,"Brush Creek Trailhead","w1718","Non.motorized",34,"Sun","weekend","no_sled","Brush/Cement","2","2","1",7.3,0,29,-1,24,25.2,-1,0,0,-1,-2,-2,-2,-3
"294",2018-03-04,"Brush Creek Trailhead","w1718","Mechanized",0,"Sun","weekend","no_sled","Brush/Cement","2","2","1",7.3,0,29,-1,24,25.2,-1,0,0,-1,-2,-2,-2,-3
"295",2018-03-04,"Brush Creek Trailhead","w1718","Motorized",0,"Sun","weekend","sled","Brush/Cement","2","2","1",7.3,0,29,-1,24,25.2,-1,0,0,-1,-2,-2,-2,-3
"296",2018-03-04,"Brush Creek Trailhead","w1718","Hybrid",0,"Sun","weekend","sled","Brush/Cement","2","2","1",7.3,0,29,-1,24,25.2,-1,0,0,-1,-2,-2,-2,-3
"297",2018-03-05,"Brush Creek Trailhead","w1718","Non.motorized",6,"Mon","weekday","no_sled","Brush/Cement","2","2","1",7.3,0,31,2,13,23.5,-1,-1,0,0,1,0,0,0
"298",2018-03-05,"Brush Creek Trailhead","w1718","Mechanized",0,"Mon","weekday","no_sled","Brush/Cement","2","2","1",7.3,0,31,2,13,23.5,-1,-1,0,0,1,0,0,0
"299",2018-03-05,"Brush Creek Trailhead","w1718","Motorized",0,"Mon","weekday","sled","Brush/Cement","2","2","1",7.3,0,31,2,13,23.5,-1,-1,0,0,1,0,0,0
"300",2018-03-05,"Brush Creek Trailhead","w1718","Hybrid",0,"Mon","weekday","sled","Brush/Cement","2","2","1",7.3,0,31,2,13,23.5,-1,-1,0,0,1,0,0,0
"301",2018-03-06,"Brush Creek Trailhead","w1718","Non.motorized",17,"Tue","weekday","no_sled","Brush/Cement","2","2","1",7.3,0,31,0,19,23.5,2,-1,-1,0,2,1,0,0
"302",2018-03-06,"Brush Creek Trailhead","w1718","Mechanized",0,"Tue","weekday","no_sled","Brush/Cement","2","2","1",7.3,0,31,0,19,23.5,2,-1,-1,0,2,1,0,0
"303",2018-03-06,"Brush Creek Trailhead","w1718","Motorized",0,"Tue","weekday","sled","Brush/Cement","2","2","1",7.3,0,31,0,19,23.5,2,-1,-1,0,2,1,0,0
"304",2018-03-06,"Brush Creek Trailhead","w1718","Hybrid",0,"Tue","weekday","sled","Brush/Cement","2","2","1",7.3,0,31,0,19,23.5,2,-1,-1,0,2,1,0,0
"305",2018-03-07,"Brush Creek Trailhead","w1718","Non.motorized",17,"Wed","weekday","no_sled","Brush/Cement","2","2","1",7.4,0.1,31,0,27,23.9,0,2,-1,-1,0,2,1,0
"306",2018-03-07,"Brush Creek Trailhead","w1718","Mechanized",0,"Wed","weekday","no_sled","Brush/Cement","2","2","1",7.4,0.1,31,0,27,23.9,0,2,-1,-1,0,2,1,0
"307",2018-03-07,"Brush Creek Trailhead","w1718","Motorized",0,"Wed","weekday","sled","Brush/Cement","2","2","1",7.4,0.1,31,0,27,23.9,0,2,-1,-1,0,2,1,0
"308",2018-03-07,"Brush Creek Trailhead","w1718","Hybrid",0,"Wed","weekday","sled","Brush/Cement","2","2","1",7.4,0.1,31,0,27,23.9,0,2,-1,-1,0,2,1,0
"309",2018-03-08,"Brush Creek Trailhead","w1718","Non.motorized",7,"Thu","weekday","no_sled","Brush/Cement","2","2","1",7.4,0,30,-1,33,24.7,0,0,2,-1,-1,-1,1,0
"310",2018-03-08,"Brush Creek Trailhead","w1718","Mechanized",0,"Thu","weekday","no_sled","Brush/Cement","2","2","1",7.4,0,30,-1,33,24.7,0,0,2,-1,-1,-1,1,0
"311",2018-03-08,"Brush Creek Trailhead","w1718","Motorized",0,"Thu","weekday","sled","Brush/Cement","2","2","1",7.4,0,30,-1,33,24.7,0,0,2,-1,-1,-1,1,0
"312",2018-03-08,"Brush Creek Trailhead","w1718","Hybrid",0,"Thu","weekday","sled","Brush/Cement","2","2","1",7.4,0,30,-1,33,24.7,0,0,2,-1,-1,-1,1,0
"313",2018-03-09,"Brush Creek Trailhead","w1718","Non.motorized",19,"Fri","weekday","no_sled","Brush/Cement","2","2","1",7.4,0,30,0,34,24.7,-1,0,0,2,-1,-1,-1,1
"314",2018-03-09,"Brush Creek Trailhead","w1718","Mechanized",0,"Fri","weekday","no_sled","Brush/Cement","2","2","1",7.4,0,30,0,34,24.7,-1,0,0,2,-1,-1,-1,1
"315",2018-03-09,"Brush Creek Trailhead","w1718","Motorized",0,"Fri","weekday","sled","Brush/Cement","2","2","1",7.4,0,30,0,34,24.7,-1,0,0,2,-1,-1,-1,1
"316",2018-03-09,"Brush Creek Trailhead","w1718","Hybrid",0,"Fri","weekday","sled","Brush/Cement","2","2","1",7.4,0,30,0,34,24.7,-1,0,0,2,-1,-1,-1,1
"317",2018-03-10,"Brush Creek Trailhead","w1718","Non.motorized",12,"Sat","weekend","no_sled","Brush/Cement","1","1","1",7.4,0,30,0,31,24.7,0,-1,0,0,0,-1,-1,-1
"318",2018-03-10,"Brush Creek Trailhead","w1718","Mechanized",0,"Sat","weekend","no_sled","Brush/Cement","1","1","1",7.4,0,30,0,31,24.7,0,-1,0,0,0,-1,-1,-1
"319",2018-03-10,"Brush Creek Trailhead","w1718","Motorized",0,"Sat","weekend","sled","Brush/Cement","1","1","1",7.4,0,30,0,31,24.7,0,-1,0,0,0,-1,-1,-1
"320",2018-03-10,"Brush Creek Trailhead","w1718","Hybrid",0,"Sat","weekend","sled","Brush/Cement","1","1","1",7.4,0,30,0,31,24.7,0,-1,0,0,0,-1,-1,-1
"321",2018-03-11,"Brush Creek Trailhead","w1718","Non.motorized",19,"Sun","weekend","no_sled","Brush/Cement","1","1","1",7.4,0,29,-1,31,25.5,0,0,-1,0,-1,-1,-2,-2
"322",2018-03-11,"Brush Creek Trailhead","w1718","Mechanized",0,"Sun","weekend","no_sled","Brush/Cement","1","1","1",7.4,0,29,-1,31,25.5,0,0,-1,0,-1,-1,-2,-2
"323",2018-03-11,"Brush Creek Trailhead","w1718","Motorized",0,"Sun","weekend","sled","Brush/Cement","1","1","1",7.4,0,29,-1,31,25.5,0,0,-1,0,-1,-1,-2,-2
"324",2018-03-11,"Brush Creek Trailhead","w1718","Hybrid",0,"Sun","weekend","sled","Brush/Cement","1","1","1",7.4,0,29,-1,31,25.5,0,0,-1,0,-1,-1,-2,-2
"325",2018-03-12,"Brush Creek Trailhead","w1718","Non.motorized",16,"Mon","weekday","no_sled","Brush/Cement","1","1","1",7.4,0,29,0,33,25.5,-1,0,0,-1,-1,-1,-1,-2
"326",2018-03-12,"Brush Creek Trailhead","w1718","Mechanized",0,"Mon","weekday","no_sled","Brush/Cement","1","1","1",7.4,0,29,0,33,25.5,-1,0,0,-1,-1,-1,-1,-2
"327",2018-03-12,"Brush Creek Trailhead","w1718","Motorized",0,"Mon","weekday","sled","Brush/Cement","1","1","1",7.4,0,29,0,33,25.5,-1,0,0,-1,-1,-1,-1,-2
"328",2018-03-12,"Brush Creek Trailhead","w1718","Hybrid",0,"Mon","weekday","sled","Brush/Cement","1","1","1",7.4,0,29,0,33,25.5,-1,0,0,-1,-1,-1,-1,-2
"329",2018-03-13,"Brush Creek Trailhead","w1718","Non.motorized",7,"Tue","weekday","no_sled","Brush/Cement","1","1","1",7.4,0,29,0,34,25.5,0,-1,0,0,0,-1,-1,-1
"330",2018-03-13,"Brush Creek Trailhead","w1718","Mechanized",0,"Tue","weekday","no_sled","Brush/Cement","1","1","1",7.4,0,29,0,34,25.5,0,-1,0,0,0,-1,-1,-1
"331",2018-03-13,"Brush Creek Trailhead","w1718","Motorized",0,"Tue","weekday","sled","Brush/Cement","1","1","1",7.4,0,29,0,34,25.5,0,-1,0,0,0,-1,-1,-1
"332",2018-03-13,"Brush Creek Trailhead","w1718","Hybrid",0,"Tue","weekday","sled","Brush/Cement","1","1","1",7.4,0,29,0,34,25.5,0,-1,0,0,0,-1,-1,-1
"333",2018-03-14,"Brush Creek Trailhead","w1718","Non.motorized",8,"Wed","weekday","no_sled","Brush/Cement","1","2","2",7.4,0,29,0,39,25.5,0,0,-1,0,0,0,-1,-1
"334",2018-03-14,"Brush Creek Trailhead","w1718","Mechanized",0,"Wed","weekday","no_sled","Brush/Cement","1","2","2",7.4,0,29,0,39,25.5,0,0,-1,0,0,0,-1,-1
"335",2018-03-14,"Brush Creek Trailhead","w1718","Motorized",0,"Wed","weekday","sled","Brush/Cement","1","2","2",7.4,0,29,0,39,25.5,0,0,-1,0,0,0,-1,-1
"336",2018-03-14,"Brush Creek Trailhead","w1718","Hybrid",0,"Wed","weekday","sled","Brush/Cement","1","2","2",7.4,0,29,0,39,25.5,0,0,-1,0,0,0,-1,-1
"337",2018-03-15,"Brush Creek Trailhead","w1718","Non.motorized",10,"Thu","weekday","no_sled","Brush/Cement","2","2","2",7.5,0.1,28,-1,31,26.8,0,0,0,-1,-1,-1,-1,-2
"338",2018-03-15,"Brush Creek Trailhead","w1718","Mechanized",0,"Thu","weekday","no_sled","Brush/Cement","2","2","2",7.5,0.1,28,-1,31,26.8,0,0,0,-1,-1,-1,-1,-2
"339",2018-03-15,"Brush Creek Trailhead","w1718","Motorized",0,"Thu","weekday","sled","Brush/Cement","2","2","2",7.5,0.1,28,-1,31,26.8,0,0,0,-1,-1,-1,-1,-2
"340",2018-03-15,"Brush Creek Trailhead","w1718","Hybrid",0,"Thu","weekday","sled","Brush/Cement","2","2","2",7.5,0.1,28,-1,31,26.8,0,0,0,-1,-1,-1,-1,-2
"341",2018-03-16,"Brush Creek Trailhead","w1718","Non.motorized",10,"Fri","weekday","no_sled","Brush/Cement","2","2","2",7.7,0.2,29,1,25,26.6,-1,0,0,0,0,0,0,0
"342",2018-03-16,"Brush Creek Trailhead","w1718","Mechanized",0,"Fri","weekday","no_sled","Brush/Cement","2","2","2",7.7,0.2,29,1,25,26.6,-1,0,0,0,0,0,0,0
"343",2018-03-16,"Brush Creek Trailhead","w1718","Motorized",0,"Fri","weekday","sled","Brush/Cement","2","2","2",7.7,0.2,29,1,25,26.6,-1,0,0,0,0,0,0,0
"344",2018-03-16,"Brush Creek Trailhead","w1718","Hybrid",0,"Fri","weekday","sled","Brush/Cement","2","2","2",7.7,0.2,29,1,25,26.6,-1,0,0,0,0,0,0,0
"345",2018-03-17,"Brush Creek Trailhead","w1718","Non.motorized",17,"Sat","weekend","no_sled","Brush/Cement","2","2","2",7.8,0.1,32,3,29,24.4,1,-1,0,0,4,3,3,3
"346",2018-03-17,"Brush Creek Trailhead","w1718","Mechanized",0,"Sat","weekend","no_sled","Brush/Cement","2","2","2",7.8,0.1,32,3,29,24.4,1,-1,0,0,4,3,3,3
"347",2018-03-17,"Brush Creek Trailhead","w1718","Motorized",0,"Sat","weekend","sled","Brush/Cement","2","2","2",7.8,0.1,32,3,29,24.4,1,-1,0,0,4,3,3,3
"348",2018-03-17,"Brush Creek Trailhead","w1718","Hybrid",0,"Sat","weekend","sled","Brush/Cement","2","2","2",7.8,0.1,32,3,29,24.4,1,-1,0,0,4,3,3,3
"349",2018-03-18,"Brush Creek Trailhead","w1718","Non.motorized",17,"Sun","weekend","no_sled","Brush/Cement","2","2","2",7.9,0.1,31,-1,24,25.5,3,1,-1,0,2,3,2,2
"350",2018-03-18,"Brush Creek Trailhead","w1718","Mechanized",0,"Sun","weekend","no_sled","Brush/Cement","2","2","2",7.9,0.1,31,-1,24,25.5,3,1,-1,0,2,3,2,2
"351",2018-03-18,"Brush Creek Trailhead","w1718","Motorized",0,"Sun","weekend","sled","Brush/Cement","2","2","2",7.9,0.1,31,-1,24,25.5,3,1,-1,0,2,3,2,2
"352",2018-03-18,"Brush Creek Trailhead","w1718","Hybrid",0,"Sun","weekend","sled","Brush/Cement","2","2","2",7.9,0.1,31,-1,24,25.5,3,1,-1,0,2,3,2,2
"353",2018-03-19,"Brush Creek Trailhead","w1718","Non.motorized",8,"Mon","weekday","no_sled","Brush/Cement","2","2","1",8,0.1,32,1,19,25,-1,3,1,-1,0,3,4,3
"354",2018-03-19,"Brush Creek Trailhead","w1718","Mechanized",0,"Mon","weekday","no_sled","Brush/Cement","2","2","1",8,0.1,32,1,19,25,-1,3,1,-1,0,3,4,3
"355",2018-03-19,"Brush Creek Trailhead","w1718","Motorized",0,"Mon","weekday","sled","Brush/Cement","2","2","1",8,0.1,32,1,19,25,-1,3,1,-1,0,3,4,3
"356",2018-03-19,"Brush Creek Trailhead","w1718","Hybrid",0,"Mon","weekday","sled","Brush/Cement","2","2","1",8,0.1,32,1,19,25,-1,3,1,-1,0,3,4,3
"357",2018-03-20,"Brush Creek Trailhead","w1718","Non.motorized",NA,"Tue","weekday","no_sled","Brush/Cement","2","2","1",8,0,30,-2,24,26.7,1,-1,3,1,-1,-2,1,2
"358",2018-03-20,"Brush Creek Trailhead","w1718","Mechanized",NA,"Tue","weekday","no_sled","Brush/Cement","2","2","1",8,0,30,-2,24,26.7,1,-1,3,1,-1,-2,1,2
"359",2018-03-20,"Brush Creek Trailhead","w1718","Motorized",NA,"Tue","weekday","sled","Brush/Cement","2","2","1",8,0,30,-2,24,26.7,1,-1,3,1,-1,-2,1,2
"360",2018-03-20,"Brush Creek Trailhead","w1718","Hybrid",0,"Tue","weekday","sled","Brush/Cement","2","2","1",8,0,30,-2,24,26.7,1,-1,3,1,-1,-2,1,2
"361",2018-03-21,"Brush Creek Trailhead","w1718","Non.motorized",NA,"Wed","weekday","no_sled","Brush/Cement","1","1","1",8.1,0.1,32,2,30,25.3,-2,1,-1,3,0,1,0,3
"362",2018-03-21,"Brush Creek Trailhead","w1718","Mechanized",NA,"Wed","weekday","no_sled","Brush/Cement","1","1","1",8.1,0.1,32,2,30,25.3,-2,1,-1,3,0,1,0,3
"363",2018-03-21,"Brush Creek Trailhead","w1718","Motorized",NA,"Wed","weekday","sled","Brush/Cement","1","1","1",8.1,0.1,32,2,30,25.3,-2,1,-1,3,0,1,0,3
"364",2018-03-21,"Brush Creek Trailhead","w1718","Hybrid",0,"Wed","weekday","sled","Brush/Cement","1","1","1",8.1,0.1,32,2,30,25.3,-2,1,-1,3,0,1,0,3
"365",2018-03-22,"Brush Creek Trailhead","w1718","Non.motorized",NA,"Thu","weekday","no_sled","Brush/Cement","1","1","1",8.1,0,30,-2,36,27,2,-2,1,-1,0,-2,-1,-2
"366",2018-03-22,"Brush Creek Trailhead","w1718","Mechanized",NA,"Thu","weekday","no_sled","Brush/Cement","1","1","1",8.1,0,30,-2,36,27,2,-2,1,-1,0,-2,-1,-2
"367",2018-03-22,"Brush Creek Trailhead","w1718","Motorized",NA,"Thu","weekday","sled","Brush/Cement","1","1","1",8.1,0,30,-2,36,27,2,-2,1,-1,0,-2,-1,-2
"368",2018-03-22,"Brush Creek Trailhead","w1718","Hybrid",0,"Thu","weekday","sled","Brush/Cement","1","1","1",8.1,0,30,-2,36,27,2,-2,1,-1,0,-2,-1,-2
"369",2018-03-23,"Brush Creek Trailhead","w1718","Non.motorized",1,"Fri","weekday","no_sled","Brush/Cement","2","2","3",8.2,0.1,29,-1,34,28.3,-2,2,-2,1,-3,-1,-3,-2
"370",2018-03-23,"Brush Creek Trailhead","w1718","Mechanized",0,"Fri","weekday","no_sled","Brush/Cement","2","2","3",8.2,0.1,29,-1,34,28.3,-2,2,-2,1,-3,-1,-3,-2
"371",2018-03-23,"Brush Creek Trailhead","w1718","Motorized",0,"Fri","weekday","sled","Brush/Cement","2","2","3",8.2,0.1,29,-1,34,28.3,-2,2,-2,1,-3,-1,-3,-2
"372",2018-03-23,"Brush Creek Trailhead","w1718","Hybrid",0,"Fri","weekday","sled","Brush/Cement","2","2","3",8.2,0.1,29,-1,34,28.3,-2,2,-2,1,-3,-1,-3,-2
"373",2018-03-24,"Brush Creek Trailhead","w1718","Non.motorized",4,"Sat","weekend","no_sled","Brush/Cement","2","2","1",8.9,0.7,34,5,32,26.2,-1,-2,2,-2,4,2,4,2
"374",2018-03-24,"Brush Creek Trailhead","w1718","Mechanized",0,"Sat","weekend","no_sled","Brush/Cement","2","2","1",8.9,0.7,34,5,32,26.2,-1,-2,2,-2,4,2,4,2
"375",2018-03-24,"Brush Creek Trailhead","w1718","Motorized",0,"Sat","weekend","sled","Brush/Cement","2","2","1",8.9,0.7,34,5,32,26.2,-1,-2,2,-2,4,2,4,2
"376",2018-03-24,"Brush Creek Trailhead","w1718","Hybrid",0,"Sat","weekend","sled","Brush/Cement","2","2","1",8.9,0.7,34,5,32,26.2,-1,-2,2,-2,4,2,4,2
"377",2018-02-06,"Brush Creek Rd","w1718","Non.motorized",5,"Tue","weekday","no_sled","Brush/Cement","2","2","2",5.2,0.2,23,5,22,22.6,-1,-2,1,-1,4,2,3,2
"378",2018-02-06,"Brush Creek Rd","w1718","Mechanized",0,"Tue","weekday","no_sled","Brush/Cement","2","2","2",5.2,0.2,23,5,22,22.6,-1,-2,1,-1,4,2,3,2
"379",2018-02-06,"Brush Creek Rd","w1718","Motorized",0,"Tue","weekday","sled","Brush/Cement","2","2","2",5.2,0.2,23,5,22,22.6,-1,-2,1,-1,4,2,3,2
"380",2018-02-06,"Brush Creek Rd","w1718","Hybrid",0,"Tue","weekday","sled","Brush/Cement","2","2","2",5.2,0.2,23,5,22,22.6,-1,-2,1,-1,4,2,3,2
"381",2018-02-07,"Brush Creek Rd","w1718","Non.motorized",6,"Wed","weekday","no_sled","Brush/Cement","2","2","2",5.2,0,23,0,24,22.6,5,-1,-2,1,5,4,2,3
"382",2018-02-07,"Brush Creek Rd","w1718","Mechanized",0,"Wed","weekday","no_sled","Brush/Cement","2","2","2",5.2,0,23,0,24,22.6,5,-1,-2,1,5,4,2,3
"383",2018-02-07,"Brush Creek Rd","w1718","Motorized",0,"Wed","weekday","sled","Brush/Cement","2","2","2",5.2,0,23,0,24,22.6,5,-1,-2,1,5,4,2,3
"384",2018-02-07,"Brush Creek Rd","w1718","Hybrid",0,"Wed","weekday","sled","Brush/Cement","2","2","2",5.2,0,23,0,24,22.6,5,-1,-2,1,5,4,2,3
"385",2018-02-08,"Brush Creek Rd","w1718","Non.motorized",6,"Thu","weekday","no_sled","Brush/Cement","2","2","1",5.3,0.1,25,2,28,21.2,0,5,-1,-2,2,7,6,4
"386",2018-02-08,"Brush Creek Rd","w1718","Mechanized",0,"Thu","weekday","no_sled","Brush/Cement","2","2","1",5.3,0.1,25,2,28,21.2,0,5,-1,-2,2,7,6,4
"387",2018-02-08,"Brush Creek Rd","w1718","Motorized",0,"Thu","weekday","sled","Brush/Cement","2","2","1",5.3,0.1,25,2,28,21.2,0,5,-1,-2,2,7,6,4
"388",2018-02-08,"Brush Creek Rd","w1718","Hybrid",0,"Thu","weekday","sled","Brush/Cement","2","2","1",5.3,0.1,25,2,28,21.2,0,5,-1,-2,2,7,6,4
"389",2018-02-09,"Brush Creek Rd","w1718","Non.motorized",9,"Fri","weekday","no_sled","Brush/Cement","2","2","1",5.3,0,24,-1,33,22.1,2,0,5,-1,1,1,6,5
"390",2018-02-09,"Brush Creek Rd","w1718","Mechanized",0,"Fri","weekday","no_sled","Brush/Cement","2","2","1",5.3,0,24,-1,33,22.1,2,0,5,-1,1,1,6,5
"391",2018-02-09,"Brush Creek Rd","w1718","Motorized",1,"Fri","weekday","sled","Brush/Cement","2","2","1",5.3,0,24,-1,33,22.1,2,0,5,-1,1,1,6,5
"392",2018-02-09,"Brush Creek Rd","w1718","Hybrid",0,"Fri","weekday","sled","Brush/Cement","2","2","1",5.3,0,24,-1,33,22.1,2,0,5,-1,1,1,6,5
"393",2018-02-10,"Brush Creek Rd","w1718","Non.motorized",5,"Sat","weekend","no_sled","Brush/Cement","3","3","2",5.3,0,24,0,24,22.1,-1,2,0,5,-1,1,1,6
"394",2018-02-10,"Brush Creek Rd","w1718","Mechanized",0,"Sat","weekend","no_sled","Brush/Cement","3","3","2",5.3,0,24,0,24,22.1,-1,2,0,5,-1,1,1,6
"395",2018-02-10,"Brush Creek Rd","w1718","Motorized",0,"Sat","weekend","sled","Brush/Cement","3","3","2",5.3,0,24,0,24,22.1,-1,2,0,5,-1,1,1,6
"396",2018-02-10,"Brush Creek Rd","w1718","Hybrid",0,"Sat","weekend","sled","Brush/Cement","3","3","2",5.3,0,24,0,24,22.1,-1,2,0,5,-1,1,1,6
"397",2018-02-11,"Brush Creek Rd","w1718","Non.motorized",11,"Sun","weekend","no_sled","Brush/Cement","3","3","2",5.6,0.3,27,3,13,20.7,0,-1,2,0,3,2,4,4
"398",2018-02-11,"Brush Creek Rd","w1718","Mechanized",0,"Sun","weekend","no_sled","Brush/Cement","3","3","2",5.6,0.3,27,3,13,20.7,0,-1,2,0,3,2,4,4
"399",2018-02-11,"Brush Creek Rd","w1718","Motorized",0,"Sun","weekend","sled","Brush/Cement","3","3","2",5.6,0.3,27,3,13,20.7,0,-1,2,0,3,2,4,4
"400",2018-02-11,"Brush Creek Rd","w1718","Hybrid",0,"Sun","weekend","sled","Brush/Cement","3","3","2",5.6,0.3,27,3,13,20.7,0,-1,2,0,3,2,4,4
"401",2018-02-12,"Brush Creek Rd","w1718","Non.motorized",1,"Mon","weekday","no_sled","Brush/Cement","3","3","3",5.7,0.1,27,0,23,21.1,3,0,-1,2,3,3,2,4
"402",2018-02-12,"Brush Creek Rd","w1718","Mechanized",0,"Mon","weekday","no_sled","Brush/Cement","3","3","3",5.7,0.1,27,0,23,21.1,3,0,-1,2,3,3,2,4
"403",2018-02-12,"Brush Creek Rd","w1718","Motorized",0,"Mon","weekday","sled","Brush/Cement","3","3","3",5.7,0.1,27,0,23,21.1,3,0,-1,2,3,3,2,4
"404",2018-02-12,"Brush Creek Rd","w1718","Hybrid",0,"Mon","weekday","sled","Brush/Cement","3","3","3",5.7,0.1,27,0,23,21.1,3,0,-1,2,3,3,2,4
"405",2018-02-13,"Brush Creek Rd","w1718","Non.motorized",0,"Tue","weekday","no_sled","Brush/Cement","3","3","3",6.1,0.4,29,2,28,21,0,3,0,-1,2,5,5,4
"406",2018-02-13,"Brush Creek Rd","w1718","Mechanized",0,"Tue","weekday","no_sled","Brush/Cement","3","3","3",6.1,0.4,29,2,28,21,0,3,0,-1,2,5,5,4
"407",2018-02-13,"Brush Creek Rd","w1718","Motorized",0,"Tue","weekday","sled","Brush/Cement","3","3","3",6.1,0.4,29,2,28,21,0,3,0,-1,2,5,5,4
"408",2018-02-13,"Brush Creek Rd","w1718","Hybrid",0,"Tue","weekday","sled","Brush/Cement","3","3","3",6.1,0.4,29,2,28,21,0,3,0,-1,2,5,5,4
"409",2018-02-14,"Brush Creek Rd","w1718","Non.motorized",3,"Wed","weekday","no_sled","Brush/Cement","3","3","3",6.2,0.1,30,1,30,20.7,2,0,3,0,3,3,6,6
"410",2018-02-14,"Brush Creek Rd","w1718","Mechanized",0,"Wed","weekday","no_sled","Brush/Cement","3","3","3",6.2,0.1,30,1,30,20.7,2,0,3,0,3,3,6,6
"411",2018-02-14,"Brush Creek Rd","w1718","Motorized",1,"Wed","weekday","sled","Brush/Cement","3","3","3",6.2,0.1,30,1,30,20.7,2,0,3,0,3,3,6,6
"412",2018-02-14,"Brush Creek Rd","w1718","Hybrid",0,"Wed","weekday","sled","Brush/Cement","3","3","3",6.2,0.1,30,1,30,20.7,2,0,3,0,3,3,6,6
"413",2018-02-15,"Brush Creek Rd","w1718","Non.motorized",5,"Thu","weekday","no_sled","Brush/Cement","3","3","3",6.3,0.1,28,-2,24,22.5,1,2,0,3,-1,1,1,4
"414",2018-02-15,"Brush Creek Rd","w1718","Mechanized",0,"Thu","weekday","no_sled","Brush/Cement","3","3","3",6.3,0.1,28,-2,24,22.5,1,2,0,3,-1,1,1,4
"415",2018-02-15,"Brush Creek Rd","w1718","Motorized",0,"Thu","weekday","sled","Brush/Cement","3","3","3",6.3,0.1,28,-2,24,22.5,1,2,0,3,-1,1,1,4
"416",2018-02-15,"Brush Creek Rd","w1718","Hybrid",0,"Thu","weekday","sled","Brush/Cement","3","3","3",6.3,0.1,28,-2,24,22.5,1,2,0,3,-1,1,1,4
"417",2018-02-16,"Brush Creek Rd","w1718","Non.motorized",6,"Fri","weekday","no_sled","Brush/Cement","3","3","3",6.7,0.4,32,4,18,20.9,-2,1,2,0,2,3,5,5
"418",2018-02-16,"Brush Creek Rd","w1718","Mechanized",0,"Fri","weekday","no_sled","Brush/Cement","3","3","3",6.7,0.4,32,4,18,20.9,-2,1,2,0,2,3,5,5
"419",2018-02-16,"Brush Creek Rd","w1718","Motorized",0,"Fri","weekday","sled","Brush/Cement","3","3","3",6.7,0.4,32,4,18,20.9,-2,1,2,0,2,3,5,5
"420",2018-02-16,"Brush Creek Rd","w1718","Hybrid",0,"Fri","weekday","sled","Brush/Cement","3","3","3",6.7,0.4,32,4,18,20.9,-2,1,2,0,2,3,5,5
"421",2018-02-17,"Brush Creek Rd","w1718","Non.motorized",24,"Sat","weekend","no_sled","Brush/Cement","3","3","2",6.7,0,32,0,25,20.9,4,-2,1,2,4,2,3,5
"422",2018-02-17,"Brush Creek Rd","w1718","Mechanized",3,"Sat","weekend","no_sled","Brush/Cement","3","3","2",6.7,0,32,0,25,20.9,4,-2,1,2,4,2,3,5
"423",2018-02-17,"Brush Creek Rd","w1718","Motorized",1,"Sat","weekend","sled","Brush/Cement","3","3","2",6.7,0,32,0,25,20.9,4,-2,1,2,4,2,3,5
"424",2018-02-17,"Brush Creek Rd","w1718","Hybrid",1,"Sat","weekend","sled","Brush/Cement","3","3","2",6.7,0,32,0,25,20.9,4,-2,1,2,4,2,3,5
"425",2018-02-18,"Brush Creek Rd","w1718","Non.motorized",21,"Sun","weekend","no_sled","Brush/Cement","2","2","2",6.7,0,31,-1,32,21.6,0,4,-2,1,-1,3,1,2
"426",2018-02-18,"Brush Creek Rd","w1718","Mechanized",3,"Sun","weekend","no_sled","Brush/Cement","2","2","2",6.7,0,31,-1,32,21.6,0,4,-2,1,-1,3,1,2
"427",2018-02-18,"Brush Creek Rd","w1718","Motorized",2,"Sun","weekend","sled","Brush/Cement","2","2","2",6.7,0,31,-1,32,21.6,0,4,-2,1,-1,3,1,2
"428",2018-02-18,"Brush Creek Rd","w1718","Hybrid",0,"Sun","weekend","sled","Brush/Cement","2","2","2",6.7,0,31,-1,32,21.6,0,4,-2,1,-1,3,1,2
"429",2018-02-19,"Brush Creek Rd","w1718","Non.motorized",1,"Mon","weekday","no_sled","Brush/Cement","2","2","2",6.8,0.1,29,-2,24,23.4,-1,0,4,-2,-3,-3,1,-1
"430",2018-02-19,"Brush Creek Rd","w1718","Non.motorized",1,"Mon","weekday","no_sled","Brush/Cement","3","3","3",6.8,0.1,29,-2,24,23.4,-1,0,4,-2,-3,-3,1,-1
"431",2018-02-19,"Brush Creek Rd","w1718","Mechanized",0,"Mon","weekday","no_sled","Brush/Cement","2","2","2",6.8,0.1,29,-2,24,23.4,-1,0,4,-2,-3,-3,1,-1
"432",2018-02-19,"Brush Creek Rd","w1718","Mechanized",0,"Mon","weekday","no_sled","Brush/Cement","3","3","3",6.8,0.1,29,-2,24,23.4,-1,0,4,-2,-3,-3,1,-1
"433",2018-02-19,"Brush Creek Rd","w1718","Motorized",0,"Mon","weekday","sled","Brush/Cement","2","2","2",6.8,0.1,29,-2,24,23.4,-1,0,4,-2,-3,-3,1,-1
"434",2018-02-19,"Brush Creek Rd","w1718","Motorized",0,"Mon","weekday","sled","Brush/Cement","3","3","3",6.8,0.1,29,-2,24,23.4,-1,0,4,-2,-3,-3,1,-1
"435",2018-02-19,"Brush Creek Rd","w1718","Hybrid",0,"Mon","weekday","sled","Brush/Cement","2","2","2",6.8,0.1,29,-2,24,23.4,-1,0,4,-2,-3,-3,1,-1
"436",2018-02-19,"Brush Creek Rd","w1718","Hybrid",0,"Mon","weekday","sled","Brush/Cement","3","3","3",6.8,0.1,29,-2,24,23.4,-1,0,4,-2,-3,-3,1,-1
"437",2018-02-20,"Brush Creek Rd","w1718","Non.motorized",0,"Tue","weekday","no_sled","Brush/Cement","3","3","3",6.8,0,31,2,8,21.9,-2,-1,0,4,0,-1,-1,3
"438",2018-02-20,"Brush Creek Rd","w1718","Mechanized",0,"Tue","weekday","no_sled","Brush/Cement","3","3","3",6.8,0,31,2,8,21.9,-2,-1,0,4,0,-1,-1,3
"439",2018-02-20,"Brush Creek Rd","w1718","Motorized",0,"Tue","weekday","sled","Brush/Cement","3","3","3",6.8,0,31,2,8,21.9,-2,-1,0,4,0,-1,-1,3
"440",2018-02-20,"Brush Creek Rd","w1718","Hybrid",0,"Tue","weekday","sled","Brush/Cement","3","3","3",6.8,0,31,2,8,21.9,-2,-1,0,4,0,-1,-1,3
"441",2018-02-21,"Brush Creek Rd","w1718","Non.motorized",9,"Wed","weekday","no_sled","Brush/Cement","3","3","3",6.8,0,31,0,11,21.9,2,-2,-1,0,2,0,-1,-1
"442",2018-02-21,"Brush Creek Rd","w1718","Mechanized",0,"Wed","weekday","no_sled","Brush/Cement","3","3","3",6.8,0,31,0,11,21.9,2,-2,-1,0,2,0,-1,-1
"443",2018-02-21,"Brush Creek Rd","w1718","Motorized",0,"Wed","weekday","sled","Brush/Cement","3","3","3",6.8,0,31,0,11,21.9,2,-2,-1,0,2,0,-1,-1
"444",2018-02-21,"Brush Creek Rd","w1718","Hybrid",0,"Wed","weekday","sled","Brush/Cement","3","3","3",6.8,0,31,0,11,21.9,2,-2,-1,0,2,0,-1,-1
"445",2018-02-22,"Brush Creek Rd","w1718","Non.motorized",2,"Thu","weekday","no_sled","Brush/Cement","3","3","2",6.8,0,30,-1,16,22.7,0,2,-2,-1,-1,1,-1,-2
"446",2018-02-22,"Brush Creek Rd","w1718","Mechanized",0,"Thu","weekday","no_sled","Brush/Cement","3","3","2",6.8,0,30,-1,16,22.7,0,2,-2,-1,-1,1,-1,-2
"447",2018-02-22,"Brush Creek Rd","w1718","Motorized",0,"Thu","weekday","sled","Brush/Cement","3","3","2",6.8,0,30,-1,16,22.7,0,2,-2,-1,-1,1,-1,-2
"448",2018-02-22,"Brush Creek Rd","w1718","Hybrid",0,"Thu","weekday","sled","Brush/Cement","3","3","2",6.8,0,30,-1,16,22.7,0,2,-2,-1,-1,1,-1,-2
"449",2018-02-23,"Brush Creek Rd","w1718","Non.motorized",12,"Fri","weekday","no_sled","Brush/Cement","3","3","2",6.9,0.1,30,0,15,23,-1,0,2,-2,-1,-1,1,-1
"450",2018-02-23,"Brush Creek Rd","w1718","Mechanized",0,"Fri","weekday","no_sled","Brush/Cement","3","3","2",6.9,0.1,30,0,15,23,-1,0,2,-2,-1,-1,1,-1
"451",2018-02-23,"Brush Creek Rd","w1718","Motorized",0,"Fri","weekday","sled","Brush/Cement","3","3","2",6.9,0.1,30,0,15,23,-1,0,2,-2,-1,-1,1,-1
"452",2018-02-23,"Brush Creek Rd","w1718","Hybrid",0,"Fri","weekday","sled","Brush/Cement","3","3","2",6.9,0.1,30,0,15,23,-1,0,2,-2,-1,-1,1,-1
"453",2018-02-24,"Brush Creek Rd","w1718","Non.motorized",18,"Sat","weekend","no_sled","Brush/Cement","3","3","2",6.9,0,31,1,10,22.3,0,-1,0,2,1,0,0,2
"454",2018-02-24,"Brush Creek Rd","w1718","Mechanized",2,"Sat","weekend","no_sled","Brush/Cement","3","3","2",6.9,0,31,1,10,22.3,0,-1,0,2,1,0,0,2
"455",2018-02-24,"Brush Creek Rd","w1718","Motorized",0,"Sat","weekend","sled","Brush/Cement","3","3","2",6.9,0,31,1,10,22.3,0,-1,0,2,1,0,0,2
"456",2018-02-24,"Brush Creek Rd","w1718","Hybrid",0,"Sat","weekend","sled","Brush/Cement","3","3","2",6.9,0,31,1,10,22.3,0,-1,0,2,1,0,0,2
"457",2018-02-25,"Brush Creek Rd","w1718","Non.motorized",8,"Sun","weekend","no_sled","Brush/Cement","3","3","2",7.1,0.2,32,1,11,22.2,1,0,-1,0,2,2,1,1
"458",2018-02-25,"Brush Creek Rd","w1718","Mechanized",1,"Sun","weekend","no_sled","Brush/Cement","3","3","2",7.1,0.2,32,1,11,22.2,1,0,-1,0,2,2,1,1
"459",2018-02-25,"Brush Creek Rd","w1718","Motorized",4,"Sun","weekend","sled","Brush/Cement","3","3","2",7.1,0.2,32,1,11,22.2,1,0,-1,0,2,2,1,1
"460",2018-02-25,"Brush Creek Rd","w1718","Hybrid",0,"Sun","weekend","sled","Brush/Cement","3","3","2",7.1,0.2,32,1,11,22.2,1,0,-1,0,2,2,1,1
"461",2018-02-26,"Brush Creek Rd","w1718","Non.motorized",2,"Mon","weekday","no_sled","Brush/Cement","2","2","2",7.1,0,32,0,20,22.2,1,1,0,-1,1,2,2,1
"462",2018-02-26,"Brush Creek Rd","w1718","Mechanized",3,"Mon","weekday","no_sled","Brush/Cement","2","2","2",7.1,0,32,0,20,22.2,1,1,0,-1,1,2,2,1
"463",2018-02-26,"Brush Creek Rd","w1718","Motorized",0,"Mon","weekday","sled","Brush/Cement","2","2","2",7.1,0,32,0,20,22.2,1,1,0,-1,1,2,2,1
"464",2018-02-26,"Brush Creek Rd","w1718","Hybrid",0,"Mon","weekday","sled","Brush/Cement","2","2","2",7.1,0,32,0,20,22.2,1,1,0,-1,1,2,2,1
"465",2018-02-27,"Brush Creek Rd","w1718","Non.motorized",NA,"Tue","weekday","no_sled","Brush/Cement","2","2","2",7.2,0.1,32,0,26,22.5,0,1,1,0,0,1,2,2
"466",2018-02-27,"Brush Creek Rd","w1718","Mechanized",NA,"Tue","weekday","no_sled","Brush/Cement","2","2","2",7.2,0.1,32,0,26,22.5,0,1,1,0,0,1,2,2
"467",2018-02-27,"Brush Creek Rd","w1718","Motorized",NA,"Tue","weekday","sled","Brush/Cement","2","2","2",7.2,0.1,32,0,26,22.5,0,1,1,0,0,1,2,2
"468",2018-02-27,"Brush Creek Rd","w1718","Hybrid",NA,"Tue","weekday","sled","Brush/Cement","2","2","2",7.2,0.1,32,0,26,22.5,0,1,1,0,0,1,2,2
"469",2018-02-28,"Brush Creek Rd","w1718","Non.motorized",NA,"Wed","weekday","no_sled","Brush/Cement","2","2","2",7.2,0,31,-1,23,23.2,0,0,1,1,-1,-1,0,1
"470",2018-02-28,"Brush Creek Rd","w1718","Mechanized",NA,"Wed","weekday","no_sled","Brush/Cement","2","2","2",7.2,0,31,-1,23,23.2,0,0,1,1,-1,-1,0,1
"471",2018-02-28,"Brush Creek Rd","w1718","Motorized",NA,"Wed","weekday","sled","Brush/Cement","2","2","2",7.2,0,31,-1,23,23.2,0,0,1,1,-1,-1,0,1
"472",2018-02-28,"Brush Creek Rd","w1718","Hybrid",NA,"Wed","weekday","sled","Brush/Cement","2","2","2",7.2,0,31,-1,23,23.2,0,0,1,1,-1,-1,0,1
"473",2018-03-01,"Brush Creek Rd","w1718","Non.motorized",NA,"Thu","weekday","no_sled","Brush/Cement","2","2","2",7.2,0,31,0,24,23.2,-1,0,0,1,-1,-1,-1,0
"474",2018-03-01,"Brush Creek Rd","w1718","Mechanized",NA,"Thu","weekday","no_sled","Brush/Cement","2","2","2",7.2,0,31,0,24,23.2,-1,0,0,1,-1,-1,-1,0
"475",2018-03-01,"Brush Creek Rd","w1718","Motorized",NA,"Thu","weekday","sled","Brush/Cement","2","2","2",7.2,0,31,0,24,23.2,-1,0,0,1,-1,-1,-1,0
"476",2018-03-01,"Brush Creek Rd","w1718","Hybrid",NA,"Thu","weekday","sled","Brush/Cement","2","2","2",7.2,0,31,0,24,23.2,-1,0,0,1,-1,-1,-1,0
"477",2018-03-02,"Brush Creek Rd","w1718","Non.motorized",NA,"Fri","weekday","no_sled","Brush/Cement","2","2","1",7.2,0,31,0,30,23.2,0,-1,0,0,0,-1,-1,-1
"478",2018-03-02,"Brush Creek Rd","w1718","Mechanized",NA,"Fri","weekday","no_sled","Brush/Cement","2","2","1",7.2,0,31,0,30,23.2,0,-1,0,0,0,-1,-1,-1
"479",2018-03-02,"Brush Creek Rd","w1718","Motorized",NA,"Fri","weekday","sled","Brush/Cement","2","2","1",7.2,0,31,0,30,23.2,0,-1,0,0,0,-1,-1,-1
"480",2018-03-02,"Brush Creek Rd","w1718","Hybrid",NA,"Fri","weekday","sled","Brush/Cement","2","2","1",7.2,0,31,0,30,23.2,0,-1,0,0,0,-1,-1,-1
"481",2018-03-03,"Brush Creek Rd","w1718","Non.motorized",NA,"Sat","weekend","no_sled","Brush/Cement","2","2","1",7.3,0.1,30,-1,34,24.3,0,0,-1,0,-1,-1,-2,-2
"482",2018-03-03,"Brush Creek Rd","w1718","Mechanized",NA,"Sat","weekend","no_sled","Brush/Cement","2","2","1",7.3,0.1,30,-1,34,24.3,0,0,-1,0,-1,-1,-2,-2
"483",2018-03-03,"Brush Creek Rd","w1718","Motorized",NA,"Sat","weekend","sled","Brush/Cement","2","2","1",7.3,0.1,30,-1,34,24.3,0,0,-1,0,-1,-1,-2,-2
"484",2018-03-03,"Brush Creek Rd","w1718","Hybrid",NA,"Sat","weekend","sled","Brush/Cement","2","2","1",7.3,0.1,30,-1,34,24.3,0,0,-1,0,-1,-1,-2,-2
"485",2018-03-04,"Brush Creek Rd","w1718","Non.motorized",NA,"Sun","weekend","no_sled","Brush/Cement","2","2","1",7.3,0,29,-1,24,25.2,-1,0,0,-1,-2,-2,-2,-3
"486",2018-03-04,"Brush Creek Rd","w1718","Mechanized",NA,"Sun","weekend","no_sled","Brush/Cement","2","2","1",7.3,0,29,-1,24,25.2,-1,0,0,-1,-2,-2,-2,-3
"487",2018-03-04,"Brush Creek Rd","w1718","Motorized",NA,"Sun","weekend","sled","Brush/Cement","2","2","1",7.3,0,29,-1,24,25.2,-1,0,0,-1,-2,-2,-2,-3
"488",2018-03-04,"Brush Creek Rd","w1718","Hybrid",NA,"Sun","weekend","sled","Brush/Cement","2","2","1",7.3,0,29,-1,24,25.2,-1,0,0,-1,-2,-2,-2,-3
"489",2018-03-05,"Brush Creek Rd","w1718","Non.motorized",NA,"Mon","weekday","no_sled","Brush/Cement","2","2","1",7.3,0,31,2,13,23.5,-1,-1,0,0,1,0,0,0
"490",2018-03-05,"Brush Creek Rd","w1718","Mechanized",NA,"Mon","weekday","no_sled","Brush/Cement","2","2","1",7.3,0,31,2,13,23.5,-1,-1,0,0,1,0,0,0
"491",2018-03-05,"Brush Creek Rd","w1718","Motorized",NA,"Mon","weekday","sled","Brush/Cement","2","2","1",7.3,0,31,2,13,23.5,-1,-1,0,0,1,0,0,0
"492",2018-03-05,"Brush Creek Rd","w1718","Hybrid",NA,"Mon","weekday","sled","Brush/Cement","2","2","1",7.3,0,31,2,13,23.5,-1,-1,0,0,1,0,0,0
"493",2018-03-06,"Brush Creek Rd","w1718","Non.motorized",0,"Tue","weekday","no_sled","Brush/Cement","2","2","1",7.3,0,31,0,19,23.5,2,-1,-1,0,2,1,0,0
"494",2018-03-06,"Brush Creek Rd","w1718","Mechanized",0,"Tue","weekday","no_sled","Brush/Cement","2","2","1",7.3,0,31,0,19,23.5,2,-1,-1,0,2,1,0,0
"495",2018-03-06,"Brush Creek Rd","w1718","Motorized",1,"Tue","weekday","sled","Brush/Cement","2","2","1",7.3,0,31,0,19,23.5,2,-1,-1,0,2,1,0,0
"496",2018-03-06,"Brush Creek Rd","w1718","Hybrid",0,"Tue","weekday","sled","Brush/Cement","2","2","1",7.3,0,31,0,19,23.5,2,-1,-1,0,2,1,0,0
"497",2018-03-07,"Brush Creek Rd","w1718","Non.motorized",6,"Wed","weekday","no_sled","Brush/Cement","2","2","1",7.4,0.1,31,0,27,23.9,0,2,-1,-1,0,2,1,0
"498",2018-03-07,"Brush Creek Rd","w1718","Mechanized",0,"Wed","weekday","no_sled","Brush/Cement","2","2","1",7.4,0.1,31,0,27,23.9,0,2,-1,-1,0,2,1,0
"499",2018-03-07,"Brush Creek Rd","w1718","Motorized",2,"Wed","weekday","sled","Brush/Cement","2","2","1",7.4,0.1,31,0,27,23.9,0,2,-1,-1,0,2,1,0
"500",2018-03-07,"Brush Creek Rd","w1718","Hybrid",0,"Wed","weekday","sled","Brush/Cement","2","2","1",7.4,0.1,31,0,27,23.9,0,2,-1,-1,0,2,1,0
"501",2018-03-08,"Brush Creek Rd","w1718","Non.motorized",4,"Thu","weekday","no_sled","Brush/Cement","2","2","1",7.4,0,30,-1,33,24.7,0,0,2,-1,-1,-1,1,0
"502",2018-03-08,"Brush Creek Rd","w1718","Mechanized",0,"Thu","weekday","no_sled","Brush/Cement","2","2","1",7.4,0,30,-1,33,24.7,0,0,2,-1,-1,-1,1,0
"503",2018-03-08,"Brush Creek Rd","w1718","Motorized",0,"Thu","weekday","sled","Brush/Cement","2","2","1",7.4,0,30,-1,33,24.7,0,0,2,-1,-1,-1,1,0
"504",2018-03-08,"Brush Creek Rd","w1718","Hybrid",0,"Thu","weekday","sled","Brush/Cement","2","2","1",7.4,0,30,-1,33,24.7,0,0,2,-1,-1,-1,1,0
"505",2018-03-09,"Brush Creek Rd","w1718","Non.motorized",NA,"Fri","weekday","no_sled","Brush/Cement","2","2","1",7.4,0,30,0,34,24.7,-1,0,0,2,-1,-1,-1,1
"506",2018-03-09,"Brush Creek Rd","w1718","Mechanized",NA,"Fri","weekday","no_sled","Brush/Cement","2","2","1",7.4,0,30,0,34,24.7,-1,0,0,2,-1,-1,-1,1
"507",2018-03-09,"Brush Creek Rd","w1718","Motorized",NA,"Fri","weekday","sled","Brush/Cement","2","2","1",7.4,0,30,0,34,24.7,-1,0,0,2,-1,-1,-1,1
"508",2018-03-09,"Brush Creek Rd","w1718","Hybrid",NA,"Fri","weekday","sled","Brush/Cement","2","2","1",7.4,0,30,0,34,24.7,-1,0,0,2,-1,-1,-1,1
"509",2018-03-10,"Brush Creek Rd","w1718","Non.motorized",NA,"Sat","weekend","no_sled","Brush/Cement","1","1","1",7.4,0,30,0,31,24.7,0,-1,0,0,0,-1,-1,-1
"510",2018-03-10,"Brush Creek Rd","w1718","Mechanized",NA,"Sat","weekend","no_sled","Brush/Cement","1","1","1",7.4,0,30,0,31,24.7,0,-1,0,0,0,-1,-1,-1
"511",2018-03-10,"Brush Creek Rd","w1718","Motorized",NA,"Sat","weekend","sled","Brush/Cement","1","1","1",7.4,0,30,0,31,24.7,0,-1,0,0,0,-1,-1,-1
"512",2018-03-10,"Brush Creek Rd","w1718","Hybrid",NA,"Sat","weekend","sled","Brush/Cement","1","1","1",7.4,0,30,0,31,24.7,0,-1,0,0,0,-1,-1,-1
"513",2018-03-11,"Brush Creek Rd","w1718","Non.motorized",NA,"Sun","weekend","no_sled","Brush/Cement","1","1","1",7.4,0,29,-1,31,25.5,0,0,-1,0,-1,-1,-2,-2
"514",2018-03-11,"Brush Creek Rd","w1718","Mechanized",NA,"Sun","weekend","no_sled","Brush/Cement","1","1","1",7.4,0,29,-1,31,25.5,0,0,-1,0,-1,-1,-2,-2
"515",2018-03-11,"Brush Creek Rd","w1718","Motorized",NA,"Sun","weekend","sled","Brush/Cement","1","1","1",7.4,0,29,-1,31,25.5,0,0,-1,0,-1,-1,-2,-2
"516",2018-03-11,"Brush Creek Rd","w1718","Hybrid",NA,"Sun","weekend","sled","Brush/Cement","1","1","1",7.4,0,29,-1,31,25.5,0,0,-1,0,-1,-1,-2,-2
"517",2018-03-12,"Brush Creek Rd","w1718","Non.motorized",NA,"Mon","weekday","no_sled","Brush/Cement","1","1","1",7.4,0,29,0,33,25.5,-1,0,0,-1,-1,-1,-1,-2
"518",2018-03-12,"Brush Creek Rd","w1718","Mechanized",NA,"Mon","weekday","no_sled","Brush/Cement","1","1","1",7.4,0,29,0,33,25.5,-1,0,0,-1,-1,-1,-1,-2
"519",2018-03-12,"Brush Creek Rd","w1718","Motorized",NA,"Mon","weekday","sled","Brush/Cement","1","1","1",7.4,0,29,0,33,25.5,-1,0,0,-1,-1,-1,-1,-2
"520",2018-03-12,"Brush Creek Rd","w1718","Hybrid",NA,"Mon","weekday","sled","Brush/Cement","1","1","1",7.4,0,29,0,33,25.5,-1,0,0,-1,-1,-1,-1,-2
"521",2018-03-13,"Brush Creek Rd","w1718","Non.motorized",NA,"Tue","weekday","no_sled","Brush/Cement","1","1","1",7.4,0,29,0,34,25.5,0,-1,0,0,0,-1,-1,-1
"522",2018-03-13,"Brush Creek Rd","w1718","Mechanized",NA,"Tue","weekday","no_sled","Brush/Cement","1","1","1",7.4,0,29,0,34,25.5,0,-1,0,0,0,-1,-1,-1
"523",2018-03-13,"Brush Creek Rd","w1718","Motorized",NA,"Tue","weekday","sled","Brush/Cement","1","1","1",7.4,0,29,0,34,25.5,0,-1,0,0,0,-1,-1,-1
"524",2018-03-13,"Brush Creek Rd","w1718","Hybrid",NA,"Tue","weekday","sled","Brush/Cement","1","1","1",7.4,0,29,0,34,25.5,0,-1,0,0,0,-1,-1,-1
"525",2018-03-14,"Brush Creek Rd","w1718","Non.motorized",NA,"Wed","weekday","no_sled","Brush/Cement","1","2","2",7.4,0,29,0,39,25.5,0,0,-1,0,0,0,-1,-1
"526",2018-03-14,"Brush Creek Rd","w1718","Mechanized",NA,"Wed","weekday","no_sled","Brush/Cement","1","2","2",7.4,0,29,0,39,25.5,0,0,-1,0,0,0,-1,-1
"527",2018-03-14,"Brush Creek Rd","w1718","Motorized",NA,"Wed","weekday","sled","Brush/Cement","1","2","2",7.4,0,29,0,39,25.5,0,0,-1,0,0,0,-1,-1
"528",2018-03-14,"Brush Creek Rd","w1718","Hybrid",NA,"Wed","weekday","sled","Brush/Cement","1","2","2",7.4,0,29,0,39,25.5,0,0,-1,0,0,0,-1,-1
"529",2018-03-15,"Brush Creek Rd","w1718","Non.motorized",NA,"Thu","weekday","no_sled","Brush/Cement","2","2","2",7.5,0.1,28,-1,31,26.8,0,0,0,-1,-1,-1,-1,-2
"530",2018-03-15,"Brush Creek Rd","w1718","Mechanized",NA,"Thu","weekday","no_sled","Brush/Cement","2","2","2",7.5,0.1,28,-1,31,26.8,0,0,0,-1,-1,-1,-1,-2
"531",2018-03-15,"Brush Creek Rd","w1718","Motorized",NA,"Thu","weekday","sled","Brush/Cement","2","2","2",7.5,0.1,28,-1,31,26.8,0,0,0,-1,-1,-1,-1,-2
"532",2018-03-15,"Brush Creek Rd","w1718","Hybrid",NA,"Thu","weekday","sled","Brush/Cement","2","2","2",7.5,0.1,28,-1,31,26.8,0,0,0,-1,-1,-1,-1,-2
"533",2018-03-16,"Brush Creek Rd","w1718","Non.motorized",NA,"Fri","weekday","no_sled","Brush/Cement","2","2","2",7.7,0.2,29,1,25,26.6,-1,0,0,0,0,0,0,0
"534",2018-03-16,"Brush Creek Rd","w1718","Mechanized",NA,"Fri","weekday","no_sled","Brush/Cement","2","2","2",7.7,0.2,29,1,25,26.6,-1,0,0,0,0,0,0,0
"535",2018-03-16,"Brush Creek Rd","w1718","Motorized",NA,"Fri","weekday","sled","Brush/Cement","2","2","2",7.7,0.2,29,1,25,26.6,-1,0,0,0,0,0,0,0
"536",2018-03-16,"Brush Creek Rd","w1718","Hybrid",NA,"Fri","weekday","sled","Brush/Cement","2","2","2",7.7,0.2,29,1,25,26.6,-1,0,0,0,0,0,0,0
"537",2018-03-17,"Brush Creek Rd","w1718","Non.motorized",NA,"Sat","weekend","no_sled","Brush/Cement","2","2","2",7.8,0.1,32,3,29,24.4,1,-1,0,0,4,3,3,3
"538",2018-03-17,"Brush Creek Rd","w1718","Mechanized",NA,"Sat","weekend","no_sled","Brush/Cement","2","2","2",7.8,0.1,32,3,29,24.4,1,-1,0,0,4,3,3,3
"539",2018-03-17,"Brush Creek Rd","w1718","Motorized",NA,"Sat","weekend","sled","Brush/Cement","2","2","2",7.8,0.1,32,3,29,24.4,1,-1,0,0,4,3,3,3
"540",2018-03-17,"Brush Creek Rd","w1718","Hybrid",NA,"Sat","weekend","sled","Brush/Cement","2","2","2",7.8,0.1,32,3,29,24.4,1,-1,0,0,4,3,3,3
"541",2018-03-18,"Brush Creek Rd","w1718","Non.motorized",NA,"Sun","weekend","no_sled","Brush/Cement","2","2","2",7.9,0.1,31,-1,24,25.5,3,1,-1,0,2,3,2,2
"542",2018-03-18,"Brush Creek Rd","w1718","Mechanized",NA,"Sun","weekend","no_sled","Brush/Cement","2","2","2",7.9,0.1,31,-1,24,25.5,3,1,-1,0,2,3,2,2
"543",2018-03-18,"Brush Creek Rd","w1718","Motorized",NA,"Sun","weekend","sled","Brush/Cement","2","2","2",7.9,0.1,31,-1,24,25.5,3,1,-1,0,2,3,2,2
"544",2018-03-18,"Brush Creek Rd","w1718","Hybrid",NA,"Sun","weekend","sled","Brush/Cement","2","2","2",7.9,0.1,31,-1,24,25.5,3,1,-1,0,2,3,2,2
"545",2018-03-19,"Brush Creek Rd","w1718","Non.motorized",NA,"Mon","weekday","no_sled","Brush/Cement","2","2","1",8,0.1,32,1,19,25,-1,3,1,-1,0,3,4,3
"546",2018-03-19,"Brush Creek Rd","w1718","Mechanized",NA,"Mon","weekday","no_sled","Brush/Cement","2","2","1",8,0.1,32,1,19,25,-1,3,1,-1,0,3,4,3
"547",2018-03-19,"Brush Creek Rd","w1718","Motorized",NA,"Mon","weekday","sled","Brush/Cement","2","2","1",8,0.1,32,1,19,25,-1,3,1,-1,0,3,4,3
"548",2018-03-19,"Brush Creek Rd","w1718","Hybrid",NA,"Mon","weekday","sled","Brush/Cement","2","2","1",8,0.1,32,1,19,25,-1,3,1,-1,0,3,4,3
"549",2018-03-20,"Brush Creek Rd","w1718","Non.motorized",9,"Tue","weekday","no_sled","Brush/Cement","2","2","1",8,0,30,-2,24,26.7,1,-1,3,1,-1,-2,1,2
"550",2018-03-20,"Brush Creek Rd","w1718","Mechanized",0,"Tue","weekday","no_sled","Brush/Cement","2","2","1",8,0,30,-2,24,26.7,1,-1,3,1,-1,-2,1,2
"551",2018-03-20,"Brush Creek Rd","w1718","Motorized",0,"Tue","weekday","sled","Brush/Cement","2","2","1",8,0,30,-2,24,26.7,1,-1,3,1,-1,-2,1,2
"552",2018-03-20,"Brush Creek Rd","w1718","Hybrid",0,"Tue","weekday","sled","Brush/Cement","2","2","1",8,0,30,-2,24,26.7,1,-1,3,1,-1,-2,1,2
"553",2018-03-21,"Brush Creek Rd","w1718","Non.motorized",274,"Wed","weekday","no_sled","Brush/Cement","1","1","1",8.1,0.1,32,2,30,25.3,-2,1,-1,3,0,1,0,3
"554",2018-03-21,"Brush Creek Rd","w1718","Mechanized",2,"Wed","weekday","no_sled","Brush/Cement","1","1","1",8.1,0.1,32,2,30,25.3,-2,1,-1,3,0,1,0,3
"555",2018-03-21,"Brush Creek Rd","w1718","Motorized",8,"Wed","weekday","sled","Brush/Cement","1","1","1",8.1,0.1,32,2,30,25.3,-2,1,-1,3,0,1,0,3
"556",2018-03-21,"Brush Creek Rd","w1718","Hybrid",0,"Wed","weekday","sled","Brush/Cement","1","1","1",8.1,0.1,32,2,30,25.3,-2,1,-1,3,0,1,0,3
"557",2018-03-22,"Brush Creek Rd","w1718","Non.motorized",10,"Thu","weekday","no_sled","Brush/Cement","1","1","1",8.1,0,30,-2,36,27,2,-2,1,-1,0,-2,-1,-2
"558",2018-03-22,"Brush Creek Rd","w1718","Mechanized",1,"Thu","weekday","no_sled","Brush/Cement","1","1","1",8.1,0,30,-2,36,27,2,-2,1,-1,0,-2,-1,-2
"559",2018-03-22,"Brush Creek Rd","w1718","Motorized",1,"Thu","weekday","sled","Brush/Cement","1","1","1",8.1,0,30,-2,36,27,2,-2,1,-1,0,-2,-1,-2
"560",2018-03-22,"Brush Creek Rd","w1718","Hybrid",0,"Thu","weekday","sled","Brush/Cement","1","1","1",8.1,0,30,-2,36,27,2,-2,1,-1,0,-2,-1,-2
"561",2018-03-23,"Brush Creek Rd","w1718","Non.motorized",6,"Fri","weekday","no_sled","Brush/Cement","2","2","3",8.2,0.1,29,-1,34,28.3,-2,2,-2,1,-3,-1,-3,-2
"562",2018-03-23,"Brush Creek Rd","w1718","Mechanized",0,"Fri","weekday","no_sled","Brush/Cement","2","2","3",8.2,0.1,29,-1,34,28.3,-2,2,-2,1,-3,-1,-3,-2
"563",2018-03-23,"Brush Creek Rd","w1718","Motorized",0,"Fri","weekday","sled","Brush/Cement","2","2","3",8.2,0.1,29,-1,34,28.3,-2,2,-2,1,-3,-1,-3,-2
"564",2018-03-23,"Brush Creek Rd","w1718","Hybrid",0,"Fri","weekday","sled","Brush/Cement","2","2","3",8.2,0.1,29,-1,34,28.3,-2,2,-2,1,-3,-1,-3,-2
"565",2018-03-24,"Brush Creek Rd","w1718","Non.motorized",3,"Sat","weekend","no_sled","Brush/Cement","2","2","1",8.9,0.7,34,5,32,26.2,-1,-2,2,-2,4,2,4,2
"566",2018-03-24,"Brush Creek Rd","w1718","Mechanized",0,"Sat","weekend","no_sled","Brush/Cement","2","2","1",8.9,0.7,34,5,32,26.2,-1,-2,2,-2,4,2,4,2
"567",2018-03-24,"Brush Creek Rd","w1718","Motorized",2,"Sat","weekend","sled","Brush/Cement","2","2","1",8.9,0.7,34,5,32,26.2,-1,-2,2,-2,4,2,4,2
"568",2018-03-24,"Brush Creek Rd","w1718","Hybrid",1,"Sat","weekend","sled","Brush/Cement","2","2","1",8.9,0.7,34,5,32,26.2,-1,-2,2,-2,4,2,4,2
"569",2018-03-25,"Brush Creek Rd","w1718","Non.motorized",2,"Sun","weekend","no_sled","Brush/Cement","2","2","1",8.9,0,35,1,35,25.4,5,-1,-2,2,6,5,3,5
"570",2018-03-25,"Brush Creek Rd","w1718","Mechanized",0,"Sun","weekend","no_sled","Brush/Cement","2","2","1",8.9,0,35,1,35,25.4,5,-1,-2,2,6,5,3,5
"571",2018-03-25,"Brush Creek Rd","w1718","Motorized",0,"Sun","weekend","sled","Brush/Cement","2","2","1",8.9,0,35,1,35,25.4,5,-1,-2,2,6,5,3,5
"572",2018-03-25,"Brush Creek Rd","w1718","Hybrid",0,"Sun","weekend","sled","Brush/Cement","2","2","1",8.9,0,35,1,35,25.4,5,-1,-2,2,6,5,3,5
"573",2018-03-26,"Brush Creek Rd","w1718","Non.motorized",2,"Mon","weekday","no_sled","Brush/Cement","1","1","1",8.9,0,34,-1,31,26.2,1,5,-1,-2,0,5,4,2
"574",2018-03-26,"Brush Creek Rd","w1718","Non.motorized",2,"Mon","weekday","no_sled","Brush/Cement","2","1","1",8.9,0,34,-1,31,26.2,1,5,-1,-2,0,5,4,2
"575",2018-03-26,"Brush Creek Rd","w1718","Mechanized",0,"Mon","weekday","no_sled","Brush/Cement","1","1","1",8.9,0,34,-1,31,26.2,1,5,-1,-2,0,5,4,2
"576",2018-03-26,"Brush Creek Rd","w1718","Mechanized",0,"Mon","weekday","no_sled","Brush/Cement","2","1","1",8.9,0,34,-1,31,26.2,1,5,-1,-2,0,5,4,2
"577",2018-03-26,"Brush Creek Rd","w1718","Motorized",4,"Mon","weekday","sled","Brush/Cement","1","1","1",8.9,0,34,-1,31,26.2,1,5,-1,-2,0,5,4,2
"578",2018-03-26,"Brush Creek Rd","w1718","Motorized",4,"Mon","weekday","sled","Brush/Cement","2","1","1",8.9,0,34,-1,31,26.2,1,5,-1,-2,0,5,4,2
"579",2018-03-26,"Brush Creek Rd","w1718","Hybrid",2,"Mon","weekday","sled","Brush/Cement","1","1","1",8.9,0,34,-1,31,26.2,1,5,-1,-2,0,5,4,2
"580",2018-03-26,"Brush Creek Rd","w1718","Hybrid",2,"Mon","weekday","sled","Brush/Cement","2","1","1",8.9,0,34,-1,31,26.2,1,5,-1,-2,0,5,4,2
"581",2018-03-27,"Brush Creek Rd","w1718","Non.motorized",2,"Tue","weekday","no_sled","Brush/Cement","1","1","1",8.9,0,33,-1,29,27,-1,1,5,-1,-2,-1,4,3
"582",2018-03-27,"Brush Creek Rd","w1718","Mechanized",0,"Tue","weekday","no_sled","Brush/Cement","1","1","1",8.9,0,33,-1,29,27,-1,1,5,-1,-2,-1,4,3
"583",2018-03-27,"Brush Creek Rd","w1718","Motorized",0,"Tue","weekday","sled","Brush/Cement","1","1","1",8.9,0,33,-1,29,27,-1,1,5,-1,-2,-1,4,3
"584",2018-03-27,"Brush Creek Rd","w1718","Hybrid",0,"Tue","weekday","sled","Brush/Cement","1","1","1",8.9,0,33,-1,29,27,-1,1,5,-1,-2,-1,4,3
"585",2018-03-28,"Brush Creek Rd","w1718","Non.motorized",7,"Wed","weekday","no_sled","Brush/Cement","1","1","1",8.9,0,33,0,27,27,-1,-1,1,5,-1,-2,-1,4
"586",2018-03-28,"Brush Creek Rd","w1718","Mechanized",0,"Wed","weekday","no_sled","Brush/Cement","1","1","1",8.9,0,33,0,27,27,-1,-1,1,5,-1,-2,-1,4
"587",2018-03-28,"Brush Creek Rd","w1718","Motorized",0,"Wed","weekday","sled","Brush/Cement","1","1","1",8.9,0,33,0,27,27,-1,-1,1,5,-1,-2,-1,4
"588",2018-03-28,"Brush Creek Rd","w1718","Hybrid",0,"Wed","weekday","sled","Brush/Cement","1","1","1",8.9,0,33,0,27,27,-1,-1,1,5,-1,-2,-1,4
"589",2018-03-29,"Brush Creek Rd","w1718","Non.motorized",6,"Thu","weekday","no_sled","Brush/Cement","1","1","1",8.9,0,33,0,27,27,0,-1,-1,1,0,-1,-2,-1
"590",2018-03-29,"Brush Creek Rd","w1718","Mechanized",3,"Thu","weekday","no_sled","Brush/Cement","1","1","1",8.9,0,33,0,27,27,0,-1,-1,1,0,-1,-2,-1
"591",2018-03-29,"Brush Creek Rd","w1718","Motorized",0,"Thu","weekday","sled","Brush/Cement","1","1","1",8.9,0,33,0,27,27,0,-1,-1,1,0,-1,-2,-1
"592",2018-03-29,"Brush Creek Rd","w1718","Hybrid",0,"Thu","weekday","sled","Brush/Cement","1","1","1",8.9,0,33,0,27,27,0,-1,-1,1,0,-1,-2,-1
"593",2018-03-30,"Brush Creek Rd","w1718","Non.motorized",0,"Fri","weekday","no_sled","Brush/Cement","1","1","1",8.9,0,32,-1,33,27.8,0,0,-1,-1,-1,-1,-2,-3
"594",2018-03-30,"Brush Creek Rd","w1718","Mechanized",0,"Fri","weekday","no_sled","Brush/Cement","1","1","1",8.9,0,32,-1,33,27.8,0,0,-1,-1,-1,-1,-2,-3
"595",2018-03-30,"Brush Creek Rd","w1718","Motorized",1,"Fri","weekday","sled","Brush/Cement","1","1","1",8.9,0,32,-1,33,27.8,0,0,-1,-1,-1,-1,-2,-3
"596",2018-03-30,"Brush Creek Rd","w1718","Hybrid",0,"Fri","weekday","sled","Brush/Cement","1","1","1",8.9,0,32,-1,33,27.8,0,0,-1,-1,-1,-1,-2,-3
"597",2018-03-31,"Brush Creek Rd","w1718","Non.motorized",0,"Sat","weekend","no_sled","Brush/Cement","1","1","1",8.9,0,32,0,39,27.8,-1,0,0,-1,-1,-1,-1,-2
"598",2018-03-31,"Brush Creek Rd","w1718","Mechanized",0,"Sat","weekend","no_sled","Brush/Cement","1","1","1",8.9,0,32,0,39,27.8,-1,0,0,-1,-1,-1,-1,-2
"599",2018-03-31,"Brush Creek Rd","w1718","Motorized",0,"Sat","weekend","sled","Brush/Cement","1","1","1",8.9,0,32,0,39,27.8,-1,0,0,-1,-1,-1,-1,-2
"600",2018-03-31,"Brush Creek Rd","w1718","Hybrid",0,"Sat","weekend","sled","Brush/Cement","1","1","1",8.9,0,32,0,39,27.8,-1,0,0,-1,-1,-1,-1,-2
"601",2018-04-01,"Brush Creek Rd","w1718","Non.motorized",3,"Sun","weekend","no_sled","Brush/Cement","1","1","1",8.8,-0.1,30,-2,41,29.3,0,-1,0,0,-2,-3,-3,-3
"602",2018-04-01,"Brush Creek Rd","w1718","Mechanized",0,"Sun","weekend","no_sled","Brush/Cement","1","1","1",8.8,-0.1,30,-2,41,29.3,0,-1,0,0,-2,-3,-3,-3
"603",2018-04-01,"Brush Creek Rd","w1718","Motorized",0,"Sun","weekend","sled","Brush/Cement","1","1","1",8.8,-0.1,30,-2,41,29.3,0,-1,0,0,-2,-3,-3,-3
"604",2018-04-01,"Brush Creek Rd","w1718","Hybrid",0,"Sun","weekend","sled","Brush/Cement","1","1","1",8.8,-0.1,30,-2,41,29.3,0,-1,0,0,-2,-3,-3,-3
"605",2018-04-02,"Brush Creek Rd","w1718","Non.motorized",0,"Mon","weekday","no_sled","Brush/Cement","1","1","1",8.7,-0.1,29,-1,39,30,-2,0,-1,0,-3,-3,-4,-4
"606",2018-04-02,"Brush Creek Rd","w1718","Mechanized",0,"Mon","weekday","no_sled","Brush/Cement","1","1","1",8.7,-0.1,29,-1,39,30,-2,0,-1,0,-3,-3,-4,-4
"607",2018-04-02,"Brush Creek Rd","w1718","Motorized",0,"Mon","weekday","sled","Brush/Cement","1","1","1",8.7,-0.1,29,-1,39,30,-2,0,-1,0,-3,-3,-4,-4
"608",2018-04-02,"Brush Creek Rd","w1718","Hybrid",0,"Mon","weekday","sled","Brush/Cement","1","1","1",8.7,-0.1,29,-1,39,30,-2,0,-1,0,-3,-3,-4,-4
"609",2018-04-03,"Brush Creek Rd","w1718","Non.motorized",0,"Tue","weekday","no_sled","Brush/Cement","1","1","1",8.8,0.1,30,1,27,29.3,-1,-2,0,-1,0,-2,-2,-3
"610",2018-04-03,"Brush Creek Rd","w1718","Mechanized",0,"Tue","weekday","no_sled","Brush/Cement","1","1","1",8.8,0.1,30,1,27,29.3,-1,-2,0,-1,0,-2,-2,-3
"611",2018-04-03,"Brush Creek Rd","w1718","Motorized",0,"Tue","weekday","sled","Brush/Cement","1","1","1",8.8,0.1,30,1,27,29.3,-1,-2,0,-1,0,-2,-2,-3
"612",2018-04-03,"Brush Creek Rd","w1718","Hybrid",0,"Tue","weekday","sled","Brush/Cement","1","1","1",8.8,0.1,30,1,27,29.3,-1,-2,0,-1,0,-2,-2,-3
"613",2018-04-04,"Brush Creek Rd","w1718","Non.motorized",0,"Wed","weekday","no_sled","Brush/Cement","1","2","2",8.9,0.1,28,-2,33,31.8,1,-1,-2,0,-1,-2,-4,-4
"614",2018-04-04,"Brush Creek Rd","w1718","Mechanized",0,"Wed","weekday","no_sled","Brush/Cement","1","2","2",8.9,0.1,28,-2,33,31.8,1,-1,-2,0,-1,-2,-4,-4
"615",2018-04-04,"Brush Creek Rd","w1718","Motorized",0,"Wed","weekday","sled","Brush/Cement","1","2","2",8.9,0.1,28,-2,33,31.8,1,-1,-2,0,-1,-2,-4,-4
"616",2018-04-04,"Brush Creek Rd","w1718","Hybrid",0,"Wed","weekday","sled","Brush/Cement","1","2","2",8.9,0.1,28,-2,33,31.8,1,-1,-2,0,-1,-2,-4,-4
"617",2018-04-05,"Brush Creek Rd","w1718","Non.motorized",0,"Thu","weekday","no_sled","Brush/Cement","1","2","2",8.9,0,27,-1,35,33,-2,1,-1,-2,-3,-2,-3,-5
"618",2018-04-05,"Brush Creek Rd","w1718","Mechanized",0,"Thu","weekday","no_sled","Brush/Cement","1","2","2",8.9,0,27,-1,35,33,-2,1,-1,-2,-3,-2,-3,-5
"619",2018-04-05,"Brush Creek Rd","w1718","Motorized",0,"Thu","weekday","sled","Brush/Cement","1","2","2",8.9,0,27,-1,35,33,-2,1,-1,-2,-3,-2,-3,-5
"620",2018-04-05,"Brush Creek Rd","w1718","Hybrid",0,"Thu","weekday","sled","Brush/Cement","1","2","2",8.9,0,27,-1,35,33,-2,1,-1,-2,-3,-2,-3,-5
"621",2018-02-15,"Cement Creek","w1718","Non.motorized",2,"Thu","weekday","no_sled","Brush/Cement","3","3","3",6.3,0.1,28,-2,24,22.5,1,2,0,3,-1,1,1,4
"622",2018-02-15,"Cement Creek","w1718","Mechanized",0,"Thu","weekday","no_sled","Brush/Cement","3","3","3",6.3,0.1,28,-2,24,22.5,1,2,0,3,-1,1,1,4
"623",2018-02-15,"Cement Creek","w1718","Motorized",0,"Thu","weekday","sled","Brush/Cement","3","3","3",6.3,0.1,28,-2,24,22.5,1,2,0,3,-1,1,1,4
"624",2018-02-15,"Cement Creek","w1718","Hybrid",0,"Thu","weekday","sled","Brush/Cement","3","3","3",6.3,0.1,28,-2,24,22.5,1,2,0,3,-1,1,1,4
"625",2018-02-16,"Cement Creek","w1718","Non.motorized",1,"Fri","weekday","no_sled","Brush/Cement","3","3","3",6.7,0.4,32,4,18,20.9,-2,1,2,0,2,3,5,5
"626",2018-02-16,"Cement Creek","w1718","Mechanized",0,"Fri","weekday","no_sled","Brush/Cement","3","3","3",6.7,0.4,32,4,18,20.9,-2,1,2,0,2,3,5,5
"627",2018-02-16,"Cement Creek","w1718","Motorized",0,"Fri","weekday","sled","Brush/Cement","3","3","3",6.7,0.4,32,4,18,20.9,-2,1,2,0,2,3,5,5
"628",2018-02-16,"Cement Creek","w1718","Hybrid",0,"Fri","weekday","sled","Brush/Cement","3","3","3",6.7,0.4,32,4,18,20.9,-2,1,2,0,2,3,5,5
"629",2018-02-17,"Cement Creek","w1718","Non.motorized",26,"Sat","weekend","no_sled","Brush/Cement","3","3","2",6.7,0,32,0,25,20.9,4,-2,1,2,4,2,3,5
"630",2018-02-17,"Cement Creek","w1718","Mechanized",0,"Sat","weekend","no_sled","Brush/Cement","3","3","2",6.7,0,32,0,25,20.9,4,-2,1,2,4,2,3,5
"631",2018-02-17,"Cement Creek","w1718","Motorized",0,"Sat","weekend","sled","Brush/Cement","3","3","2",6.7,0,32,0,25,20.9,4,-2,1,2,4,2,3,5
"632",2018-02-17,"Cement Creek","w1718","Hybrid",0,"Sat","weekend","sled","Brush/Cement","3","3","2",6.7,0,32,0,25,20.9,4,-2,1,2,4,2,3,5
"633",2018-02-18,"Cement Creek","w1718","Non.motorized",19,"Sun","weekend","no_sled","Brush/Cement","2","2","2",6.7,0,31,-1,32,21.6,0,4,-2,1,-1,3,1,2
"634",2018-02-18,"Cement Creek","w1718","Mechanized",0,"Sun","weekend","no_sled","Brush/Cement","2","2","2",6.7,0,31,-1,32,21.6,0,4,-2,1,-1,3,1,2
"635",2018-02-18,"Cement Creek","w1718","Motorized",0,"Sun","weekend","sled","Brush/Cement","2","2","2",6.7,0,31,-1,32,21.6,0,4,-2,1,-1,3,1,2
"636",2018-02-18,"Cement Creek","w1718","Hybrid",0,"Sun","weekend","sled","Brush/Cement","2","2","2",6.7,0,31,-1,32,21.6,0,4,-2,1,-1,3,1,2
"637",2018-02-19,"Cement Creek","w1718","Non.motorized",1,"Mon","weekday","no_sled","Brush/Cement","2","2","2",6.8,0.1,29,-2,24,23.4,-1,0,4,-2,-3,-3,1,-1
"638",2018-02-19,"Cement Creek","w1718","Non.motorized",1,"Mon","weekday","no_sled","Brush/Cement","3","3","3",6.8,0.1,29,-2,24,23.4,-1,0,4,-2,-3,-3,1,-1
"639",2018-02-19,"Cement Creek","w1718","Mechanized",0,"Mon","weekday","no_sled","Brush/Cement","2","2","2",6.8,0.1,29,-2,24,23.4,-1,0,4,-2,-3,-3,1,-1
"640",2018-02-19,"Cement Creek","w1718","Mechanized",0,"Mon","weekday","no_sled","Brush/Cement","3","3","3",6.8,0.1,29,-2,24,23.4,-1,0,4,-2,-3,-3,1,-1
"641",2018-02-19,"Cement Creek","w1718","Motorized",0,"Mon","weekday","sled","Brush/Cement","2","2","2",6.8,0.1,29,-2,24,23.4,-1,0,4,-2,-3,-3,1,-1
"642",2018-02-19,"Cement Creek","w1718","Motorized",0,"Mon","weekday","sled","Brush/Cement","3","3","3",6.8,0.1,29,-2,24,23.4,-1,0,4,-2,-3,-3,1,-1
"643",2018-02-19,"Cement Creek","w1718","Hybrid",0,"Mon","weekday","sled","Brush/Cement","2","2","2",6.8,0.1,29,-2,24,23.4,-1,0,4,-2,-3,-3,1,-1
"644",2018-02-19,"Cement Creek","w1718","Hybrid",0,"Mon","weekday","sled","Brush/Cement","3","3","3",6.8,0.1,29,-2,24,23.4,-1,0,4,-2,-3,-3,1,-1
"645",2018-02-20,"Cement Creek","w1718","Non.motorized",0,"Tue","weekday","no_sled","Brush/Cement","3","3","3",6.8,0,31,2,8,21.9,-2,-1,0,4,0,-1,-1,3
"646",2018-02-20,"Cement Creek","w1718","Mechanized",0,"Tue","weekday","no_sled","Brush/Cement","3","3","3",6.8,0,31,2,8,21.9,-2,-1,0,4,0,-1,-1,3
"647",2018-02-20,"Cement Creek","w1718","Motorized",0,"Tue","weekday","sled","Brush/Cement","3","3","3",6.8,0,31,2,8,21.9,-2,-1,0,4,0,-1,-1,3
"648",2018-02-20,"Cement Creek","w1718","Hybrid",0,"Tue","weekday","sled","Brush/Cement","3","3","3",6.8,0,31,2,8,21.9,-2,-1,0,4,0,-1,-1,3
"649",2018-02-21,"Cement Creek","w1718","Non.motorized",1,"Wed","weekday","no_sled","Brush/Cement","3","3","3",6.8,0,31,0,11,21.9,2,-2,-1,0,2,0,-1,-1
"650",2018-02-21,"Cement Creek","w1718","Mechanized",0,"Wed","weekday","no_sled","Brush/Cement","3","3","3",6.8,0,31,0,11,21.9,2,-2,-1,0,2,0,-1,-1
"651",2018-02-21,"Cement Creek","w1718","Motorized",1,"Wed","weekday","sled","Brush/Cement","3","3","3",6.8,0,31,0,11,21.9,2,-2,-1,0,2,0,-1,-1
"652",2018-02-21,"Cement Creek","w1718","Hybrid",0,"Wed","weekday","sled","Brush/Cement","3","3","3",6.8,0,31,0,11,21.9,2,-2,-1,0,2,0,-1,-1
"653",2018-02-22,"Cement Creek","w1718","Non.motorized",0,"Thu","weekday","no_sled","Brush/Cement","3","3","2",6.8,0,30,-1,16,22.7,0,2,-2,-1,-1,1,-1,-2
"654",2018-02-22,"Cement Creek","w1718","Mechanized",0,"Thu","weekday","no_sled","Brush/Cement","3","3","2",6.8,0,30,-1,16,22.7,0,2,-2,-1,-1,1,-1,-2
"655",2018-02-22,"Cement Creek","w1718","Motorized",0,"Thu","weekday","sled","Brush/Cement","3","3","2",6.8,0,30,-1,16,22.7,0,2,-2,-1,-1,1,-1,-2
"656",2018-02-22,"Cement Creek","w1718","Hybrid",0,"Thu","weekday","sled","Brush/Cement","3","3","2",6.8,0,30,-1,16,22.7,0,2,-2,-1,-1,1,-1,-2
"657",2018-02-23,"Cement Creek","w1718","Non.motorized",0,"Fri","weekday","no_sled","Brush/Cement","3","3","2",6.9,0.1,30,0,15,23,-1,0,2,-2,-1,-1,1,-1
"658",2018-02-23,"Cement Creek","w1718","Mechanized",0,"Fri","weekday","no_sled","Brush/Cement","3","3","2",6.9,0.1,30,0,15,23,-1,0,2,-2,-1,-1,1,-1
"659",2018-02-23,"Cement Creek","w1718","Motorized",0,"Fri","weekday","sled","Brush/Cement","3","3","2",6.9,0.1,30,0,15,23,-1,0,2,-2,-1,-1,1,-1
"660",2018-02-23,"Cement Creek","w1718","Hybrid",0,"Fri","weekday","sled","Brush/Cement","3","3","2",6.9,0.1,30,0,15,23,-1,0,2,-2,-1,-1,1,-1
"661",2018-02-24,"Cement Creek","w1718","Non.motorized",1,"Sat","weekend","no_sled","Brush/Cement","3","3","2",6.9,0,31,1,10,22.3,0,-1,0,2,1,0,0,2
"662",2018-02-24,"Cement Creek","w1718","Mechanized",0,"Sat","weekend","no_sled","Brush/Cement","3","3","2",6.9,0,31,1,10,22.3,0,-1,0,2,1,0,0,2
"663",2018-02-24,"Cement Creek","w1718","Motorized",0,"Sat","weekend","sled","Brush/Cement","3","3","2",6.9,0,31,1,10,22.3,0,-1,0,2,1,0,0,2
"664",2018-02-24,"Cement Creek","w1718","Hybrid",0,"Sat","weekend","sled","Brush/Cement","3","3","2",6.9,0,31,1,10,22.3,0,-1,0,2,1,0,0,2
"665",2018-02-25,"Cement Creek","w1718","Non.motorized",3,"Sun","weekend","no_sled","Brush/Cement","3","3","2",7.1,0.2,32,1,11,22.2,1,0,-1,0,2,2,1,1
"666",2018-02-25,"Cement Creek","w1718","Mechanized",0,"Sun","weekend","no_sled","Brush/Cement","3","3","2",7.1,0.2,32,1,11,22.2,1,0,-1,0,2,2,1,1
"667",2018-02-25,"Cement Creek","w1718","Motorized",0,"Sun","weekend","sled","Brush/Cement","3","3","2",7.1,0.2,32,1,11,22.2,1,0,-1,0,2,2,1,1
"668",2018-02-25,"Cement Creek","w1718","Hybrid",0,"Sun","weekend","sled","Brush/Cement","3","3","2",7.1,0.2,32,1,11,22.2,1,0,-1,0,2,2,1,1
"669",2018-02-26,"Cement Creek","w1718","Non.motorized",3,"Mon","weekday","no_sled","Brush/Cement","2","2","2",7.1,0,32,0,20,22.2,1,1,0,-1,1,2,2,1
"670",2018-02-26,"Cement Creek","w1718","Mechanized",0,"Mon","weekday","no_sled","Brush/Cement","2","2","2",7.1,0,32,0,20,22.2,1,1,0,-1,1,2,2,1
"671",2018-02-26,"Cement Creek","w1718","Motorized",0,"Mon","weekday","sled","Brush/Cement","2","2","2",7.1,0,32,0,20,22.2,1,1,0,-1,1,2,2,1
"672",2018-02-26,"Cement Creek","w1718","Hybrid",0,"Mon","weekday","sled","Brush/Cement","2","2","2",7.1,0,32,0,20,22.2,1,1,0,-1,1,2,2,1
"673",2018-02-27,"Cement Creek","w1718","Non.motorized",16,"Tue","weekday","no_sled","Brush/Cement","2","2","2",7.2,0.1,32,0,26,22.5,0,1,1,0,0,1,2,2
"674",2018-02-27,"Cement Creek","w1718","Mechanized",2,"Tue","weekday","no_sled","Brush/Cement","2","2","2",7.2,0.1,32,0,26,22.5,0,1,1,0,0,1,2,2
"675",2018-02-27,"Cement Creek","w1718","Motorized",9,"Tue","weekday","sled","Brush/Cement","2","2","2",7.2,0.1,32,0,26,22.5,0,1,1,0,0,1,2,2
"676",2018-02-27,"Cement Creek","w1718","Hybrid",0,"Tue","weekday","sled","Brush/Cement","2","2","2",7.2,0.1,32,0,26,22.5,0,1,1,0,0,1,2,2
"677",2018-02-28,"Cement Creek","w1718","Non.motorized",12,"Wed","weekday","no_sled","Brush/Cement","2","2","2",7.2,0,31,-1,23,23.2,0,0,1,1,-1,-1,0,1
"678",2018-02-28,"Cement Creek","w1718","Mechanized",1,"Wed","weekday","no_sled","Brush/Cement","2","2","2",7.2,0,31,-1,23,23.2,0,0,1,1,-1,-1,0,1
"679",2018-02-28,"Cement Creek","w1718","Motorized",5,"Wed","weekday","sled","Brush/Cement","2","2","2",7.2,0,31,-1,23,23.2,0,0,1,1,-1,-1,0,1
"680",2018-02-28,"Cement Creek","w1718","Hybrid",0,"Wed","weekday","sled","Brush/Cement","2","2","2",7.2,0,31,-1,23,23.2,0,0,1,1,-1,-1,0,1
"681",2018-03-01,"Cement Creek","w1718","Non.motorized",10,"Thu","weekday","no_sled","Brush/Cement","2","2","2",7.2,0,31,0,24,23.2,-1,0,0,1,-1,-1,-1,0
"682",2018-03-01,"Cement Creek","w1718","Mechanized",5,"Thu","weekday","no_sled","Brush/Cement","2","2","2",7.2,0,31,0,24,23.2,-1,0,0,1,-1,-1,-1,0
"683",2018-03-01,"Cement Creek","w1718","Motorized",7,"Thu","weekday","sled","Brush/Cement","2","2","2",7.2,0,31,0,24,23.2,-1,0,0,1,-1,-1,-1,0
"684",2018-03-01,"Cement Creek","w1718","Hybrid",0,"Thu","weekday","sled","Brush/Cement","2","2","2",7.2,0,31,0,24,23.2,-1,0,0,1,-1,-1,-1,0
"685",2018-03-02,"Cement Creek","w1718","Non.motorized",19,"Fri","weekday","no_sled","Brush/Cement","2","2","1",7.2,0,31,0,30,23.2,0,-1,0,0,0,-1,-1,-1
"686",2018-03-02,"Cement Creek","w1718","Mechanized",2,"Fri","weekday","no_sled","Brush/Cement","2","2","1",7.2,0,31,0,30,23.2,0,-1,0,0,0,-1,-1,-1
"687",2018-03-02,"Cement Creek","w1718","Motorized",12,"Fri","weekday","sled","Brush/Cement","2","2","1",7.2,0,31,0,30,23.2,0,-1,0,0,0,-1,-1,-1
"688",2018-03-02,"Cement Creek","w1718","Hybrid",0,"Fri","weekday","sled","Brush/Cement","2","2","1",7.2,0,31,0,30,23.2,0,-1,0,0,0,-1,-1,-1
"689",2018-03-03,"Cement Creek","w1718","Non.motorized",49,"Sat","weekend","no_sled","Brush/Cement","2","2","1",7.3,0.1,30,-1,34,24.3,0,0,-1,0,-1,-1,-2,-2
"690",2018-03-03,"Cement Creek","w1718","Mechanized",1,"Sat","weekend","no_sled","Brush/Cement","2","2","1",7.3,0.1,30,-1,34,24.3,0,0,-1,0,-1,-1,-2,-2
"691",2018-03-03,"Cement Creek","w1718","Motorized",7,"Sat","weekend","sled","Brush/Cement","2","2","1",7.3,0.1,30,-1,34,24.3,0,0,-1,0,-1,-1,-2,-2
"692",2018-03-03,"Cement Creek","w1718","Hybrid",0,"Sat","weekend","sled","Brush/Cement","2","2","1",7.3,0.1,30,-1,34,24.3,0,0,-1,0,-1,-1,-2,-2
"693",2018-03-04,"Cement Creek","w1718","Non.motorized",39,"Sun","weekend","no_sled","Brush/Cement","2","2","1",7.3,0,29,-1,24,25.2,-1,0,0,-1,-2,-2,-2,-3
"694",2018-03-04,"Cement Creek","w1718","Mechanized",2,"Sun","weekend","no_sled","Brush/Cement","2","2","1",7.3,0,29,-1,24,25.2,-1,0,0,-1,-2,-2,-2,-3
"695",2018-03-04,"Cement Creek","w1718","Motorized",5,"Sun","weekend","sled","Brush/Cement","2","2","1",7.3,0,29,-1,24,25.2,-1,0,0,-1,-2,-2,-2,-3
"696",2018-03-04,"Cement Creek","w1718","Hybrid",0,"Sun","weekend","sled","Brush/Cement","2","2","1",7.3,0,29,-1,24,25.2,-1,0,0,-1,-2,-2,-2,-3
"697",2018-03-05,"Cement Creek","w1718","Non.motorized",17,"Mon","weekday","no_sled","Brush/Cement","2","2","1",7.3,0,31,2,13,23.5,-1,-1,0,0,1,0,0,0
"698",2018-03-05,"Cement Creek","w1718","Mechanized",0,"Mon","weekday","no_sled","Brush/Cement","2","2","1",7.3,0,31,2,13,23.5,-1,-1,0,0,1,0,0,0
"699",2018-03-05,"Cement Creek","w1718","Motorized",9,"Mon","weekday","sled","Brush/Cement","2","2","1",7.3,0,31,2,13,23.5,-1,-1,0,0,1,0,0,0
"700",2018-03-05,"Cement Creek","w1718","Hybrid",0,"Mon","weekday","sled","Brush/Cement","2","2","1",7.3,0,31,2,13,23.5,-1,-1,0,0,1,0,0,0
"701",2018-03-06,"Cement Creek","w1718","Non.motorized",12,"Tue","weekday","no_sled","Brush/Cement","2","2","1",7.3,0,31,0,19,23.5,2,-1,-1,0,2,1,0,0
"702",2018-03-06,"Cement Creek","w1718","Mechanized",1,"Tue","weekday","no_sled","Brush/Cement","2","2","1",7.3,0,31,0,19,23.5,2,-1,-1,0,2,1,0,0
"703",2018-03-06,"Cement Creek","w1718","Motorized",6,"Tue","weekday","sled","Brush/Cement","2","2","1",7.3,0,31,0,19,23.5,2,-1,-1,0,2,1,0,0
"704",2018-03-06,"Cement Creek","w1718","Hybrid",0,"Tue","weekday","sled","Brush/Cement","2","2","1",7.3,0,31,0,19,23.5,2,-1,-1,0,2,1,0,0
"705",2018-03-07,"Cement Creek","w1718","Non.motorized",22,"Wed","weekday","no_sled","Brush/Cement","2","2","1",7.4,0.1,31,0,27,23.9,0,2,-1,-1,0,2,1,0
"706",2018-03-07,"Cement Creek","w1718","Mechanized",3,"Wed","weekday","no_sled","Brush/Cement","2","2","1",7.4,0.1,31,0,27,23.9,0,2,-1,-1,0,2,1,0
"707",2018-03-07,"Cement Creek","w1718","Motorized",7,"Wed","weekday","sled","Brush/Cement","2","2","1",7.4,0.1,31,0,27,23.9,0,2,-1,-1,0,2,1,0
"708",2018-03-07,"Cement Creek","w1718","Hybrid",2,"Wed","weekday","sled","Brush/Cement","2","2","1",7.4,0.1,31,0,27,23.9,0,2,-1,-1,0,2,1,0
"709",2018-03-08,"Cement Creek","w1718","Non.motorized",13,"Thu","weekday","no_sled","Brush/Cement","2","2","1",7.4,0,30,-1,33,24.7,0,0,2,-1,-1,-1,1,0
"710",2018-03-08,"Cement Creek","w1718","Mechanized",1,"Thu","weekday","no_sled","Brush/Cement","2","2","1",7.4,0,30,-1,33,24.7,0,0,2,-1,-1,-1,1,0
"711",2018-03-08,"Cement Creek","w1718","Motorized",2,"Thu","weekday","sled","Brush/Cement","2","2","1",7.4,0,30,-1,33,24.7,0,0,2,-1,-1,-1,1,0
"712",2018-03-08,"Cement Creek","w1718","Hybrid",0,"Thu","weekday","sled","Brush/Cement","2","2","1",7.4,0,30,-1,33,24.7,0,0,2,-1,-1,-1,1,0
"713",2018-03-09,"Cement Creek","w1718","Non.motorized",5,"Fri","weekday","no_sled","Brush/Cement","2","2","1",7.4,0,30,0,34,24.7,-1,0,0,2,-1,-1,-1,1
"714",2018-03-09,"Cement Creek","w1718","Mechanized",2,"Fri","weekday","no_sled","Brush/Cement","2","2","1",7.4,0,30,0,34,24.7,-1,0,0,2,-1,-1,-1,1
"715",2018-03-09,"Cement Creek","w1718","Motorized",7,"Fri","weekday","sled","Brush/Cement","2","2","1",7.4,0,30,0,34,24.7,-1,0,0,2,-1,-1,-1,1
"716",2018-03-09,"Cement Creek","w1718","Hybrid",0,"Fri","weekday","sled","Brush/Cement","2","2","1",7.4,0,30,0,34,24.7,-1,0,0,2,-1,-1,-1,1
"717",2018-03-10,"Cement Creek","w1718","Non.motorized",11,"Sat","weekend","no_sled","Brush/Cement","1","1","1",7.4,0,30,0,31,24.7,0,-1,0,0,0,-1,-1,-1
"718",2018-03-10,"Cement Creek","w1718","Mechanized",2,"Sat","weekend","no_sled","Brush/Cement","1","1","1",7.4,0,30,0,31,24.7,0,-1,0,0,0,-1,-1,-1
"719",2018-03-10,"Cement Creek","w1718","Motorized",5,"Sat","weekend","sled","Brush/Cement","1","1","1",7.4,0,30,0,31,24.7,0,-1,0,0,0,-1,-1,-1
"720",2018-03-10,"Cement Creek","w1718","Hybrid",0,"Sat","weekend","sled","Brush/Cement","1","1","1",7.4,0,30,0,31,24.7,0,-1,0,0,0,-1,-1,-1
"721",2018-03-11,"Cement Creek","w1718","Non.motorized",30,"Sun","weekend","no_sled","Brush/Cement","1","1","1",7.4,0,29,-1,31,25.5,0,0,-1,0,-1,-1,-2,-2
"722",2018-03-11,"Cement Creek","w1718","Mechanized",0,"Sun","weekend","no_sled","Brush/Cement","1","1","1",7.4,0,29,-1,31,25.5,0,0,-1,0,-1,-1,-2,-2
"723",2018-03-11,"Cement Creek","w1718","Motorized",6,"Sun","weekend","sled","Brush/Cement","1","1","1",7.4,0,29,-1,31,25.5,0,0,-1,0,-1,-1,-2,-2
"724",2018-03-11,"Cement Creek","w1718","Hybrid",2,"Sun","weekend","sled","Brush/Cement","1","1","1",7.4,0,29,-1,31,25.5,0,0,-1,0,-1,-1,-2,-2
"725",2018-03-12,"Cement Creek","w1718","Non.motorized",15,"Mon","weekday","no_sled","Brush/Cement","1","1","1",7.4,0,29,0,33,25.5,-1,0,0,-1,-1,-1,-1,-2
"726",2018-03-12,"Cement Creek","w1718","Mechanized",0,"Mon","weekday","no_sled","Brush/Cement","1","1","1",7.4,0,29,0,33,25.5,-1,0,0,-1,-1,-1,-1,-2
"727",2018-03-12,"Cement Creek","w1718","Motorized",4,"Mon","weekday","sled","Brush/Cement","1","1","1",7.4,0,29,0,33,25.5,-1,0,0,-1,-1,-1,-1,-2
"728",2018-03-12,"Cement Creek","w1718","Hybrid",2,"Mon","weekday","sled","Brush/Cement","1","1","1",7.4,0,29,0,33,25.5,-1,0,0,-1,-1,-1,-1,-2
"729",2018-03-13,"Cement Creek","w1718","Non.motorized",4,"Tue","weekday","no_sled","Brush/Cement","1","1","1",7.4,0,29,0,34,25.5,0,-1,0,0,0,-1,-1,-1
"730",2018-03-13,"Cement Creek","w1718","Mechanized",0,"Tue","weekday","no_sled","Brush/Cement","1","1","1",7.4,0,29,0,34,25.5,0,-1,0,0,0,-1,-1,-1
"731",2018-03-13,"Cement Creek","w1718","Motorized",10,"Tue","weekday","sled","Brush/Cement","1","1","1",7.4,0,29,0,34,25.5,0,-1,0,0,0,-1,-1,-1
"732",2018-03-13,"Cement Creek","w1718","Hybrid",3,"Tue","weekday","sled","Brush/Cement","1","1","1",7.4,0,29,0,34,25.5,0,-1,0,0,0,-1,-1,-1
"733",2018-03-14,"Cement Creek","w1718","Non.motorized",13,"Wed","weekday","no_sled","Brush/Cement","1","2","2",7.4,0,29,0,39,25.5,0,0,-1,0,0,0,-1,-1
"734",2018-03-14,"Cement Creek","w1718","Mechanized",2,"Wed","weekday","no_sled","Brush/Cement","1","2","2",7.4,0,29,0,39,25.5,0,0,-1,0,0,0,-1,-1
"735",2018-03-14,"Cement Creek","w1718","Motorized",3,"Wed","weekday","sled","Brush/Cement","1","2","2",7.4,0,29,0,39,25.5,0,0,-1,0,0,0,-1,-1
"736",2018-03-14,"Cement Creek","w1718","Hybrid",0,"Wed","weekday","sled","Brush/Cement","1","2","2",7.4,0,29,0,39,25.5,0,0,-1,0,0,0,-1,-1
"737",2018-03-15,"Cement Creek","w1718","Non.motorized",11,"Thu","weekday","no_sled","Brush/Cement","2","2","2",7.5,0.1,28,-1,31,26.8,0,0,0,-1,-1,-1,-1,-2
"738",2018-03-15,"Cement Creek","w1718","Mechanized",0,"Thu","weekday","no_sled","Brush/Cement","2","2","2",7.5,0.1,28,-1,31,26.8,0,0,0,-1,-1,-1,-1,-2
"739",2018-03-15,"Cement Creek","w1718","Motorized",0,"Thu","weekday","sled","Brush/Cement","2","2","2",7.5,0.1,28,-1,31,26.8,0,0,0,-1,-1,-1,-1,-2
"740",2018-03-15,"Cement Creek","w1718","Hybrid",0,"Thu","weekday","sled","Brush/Cement","2","2","2",7.5,0.1,28,-1,31,26.8,0,0,0,-1,-1,-1,-1,-2
"741",2018-03-16,"Cement Creek","w1718","Non.motorized",21,"Fri","weekday","no_sled","Brush/Cement","2","2","2",7.7,0.2,29,1,25,26.6,-1,0,0,0,0,0,0,0
"742",2018-03-16,"Cement Creek","w1718","Mechanized",0,"Fri","weekday","no_sled","Brush/Cement","2","2","2",7.7,0.2,29,1,25,26.6,-1,0,0,0,0,0,0,0
"743",2018-03-16,"Cement Creek","w1718","Motorized",6,"Fri","weekday","sled","Brush/Cement","2","2","2",7.7,0.2,29,1,25,26.6,-1,0,0,0,0,0,0,0
"744",2018-03-16,"Cement Creek","w1718","Hybrid",0,"Fri","weekday","sled","Brush/Cement","2","2","2",7.7,0.2,29,1,25,26.6,-1,0,0,0,0,0,0,0
"745",2018-03-17,"Cement Creek","w1718","Non.motorized",40,"Sat","weekend","no_sled","Brush/Cement","2","2","2",7.8,0.1,32,3,29,24.4,1,-1,0,0,4,3,3,3
"746",2018-03-17,"Cement Creek","w1718","Mechanized",1,"Sat","weekend","no_sled","Brush/Cement","2","2","2",7.8,0.1,32,3,29,24.4,1,-1,0,0,4,3,3,3
"747",2018-03-17,"Cement Creek","w1718","Motorized",8,"Sat","weekend","sled","Brush/Cement","2","2","2",7.8,0.1,32,3,29,24.4,1,-1,0,0,4,3,3,3
"748",2018-03-17,"Cement Creek","w1718","Hybrid",0,"Sat","weekend","sled","Brush/Cement","2","2","2",7.8,0.1,32,3,29,24.4,1,-1,0,0,4,3,3,3
"749",2018-03-18,"Cement Creek","w1718","Non.motorized",13,"Sun","weekend","no_sled","Brush/Cement","2","2","2",7.9,0.1,31,-1,24,25.5,3,1,-1,0,2,3,2,2
"750",2018-03-18,"Cement Creek","w1718","Mechanized",1,"Sun","weekend","no_sled","Brush/Cement","2","2","2",7.9,0.1,31,-1,24,25.5,3,1,-1,0,2,3,2,2
"751",2018-03-18,"Cement Creek","w1718","Motorized",8,"Sun","weekend","sled","Brush/Cement","2","2","2",7.9,0.1,31,-1,24,25.5,3,1,-1,0,2,3,2,2
"752",2018-03-18,"Cement Creek","w1718","Hybrid",0,"Sun","weekend","sled","Brush/Cement","2","2","2",7.9,0.1,31,-1,24,25.5,3,1,-1,0,2,3,2,2
"753",2018-03-19,"Cement Creek","w1718","Non.motorized",9,"Mon","weekday","no_sled","Brush/Cement","2","2","1",8,0.1,32,1,19,25,-1,3,1,-1,0,3,4,3
"754",2018-03-19,"Cement Creek","w1718","Mechanized",1,"Mon","weekday","no_sled","Brush/Cement","2","2","1",8,0.1,32,1,19,25,-1,3,1,-1,0,3,4,3
"755",2018-03-19,"Cement Creek","w1718","Motorized",7,"Mon","weekday","sled","Brush/Cement","2","2","1",8,0.1,32,1,19,25,-1,3,1,-1,0,3,4,3
"756",2018-03-19,"Cement Creek","w1718","Hybrid",0,"Mon","weekday","sled","Brush/Cement","2","2","1",8,0.1,32,1,19,25,-1,3,1,-1,0,3,4,3
"757",2018-03-20,"Cement Creek","w1718","Non.motorized",13,"Tue","weekday","no_sled","Brush/Cement","2","2","1",8,0,30,-2,24,26.7,1,-1,3,1,-1,-2,1,2
"758",2018-03-20,"Cement Creek","w1718","Mechanized",2,"Tue","weekday","no_sled","Brush/Cement","2","2","1",8,0,30,-2,24,26.7,1,-1,3,1,-1,-2,1,2
"759",2018-03-20,"Cement Creek","w1718","Motorized",10,"Tue","weekday","sled","Brush/Cement","2","2","1",8,0,30,-2,24,26.7,1,-1,3,1,-1,-2,1,2
"760",2018-03-20,"Cement Creek","w1718","Hybrid",0,"Tue","weekday","sled","Brush/Cement","2","2","1",8,0,30,-2,24,26.7,1,-1,3,1,-1,-2,1,2
"761",2018-03-21,"Cement Creek","w1718","Non.motorized",8,"Wed","weekday","no_sled","Brush/Cement","1","1","1",8.1,0.1,32,2,30,25.3,-2,1,-1,3,0,1,0,3
"762",2018-03-21,"Cement Creek","w1718","Mechanized",0,"Wed","weekday","no_sled","Brush/Cement","1","1","1",8.1,0.1,32,2,30,25.3,-2,1,-1,3,0,1,0,3
"763",2018-03-21,"Cement Creek","w1718","Motorized",6,"Wed","weekday","sled","Brush/Cement","1","1","1",8.1,0.1,32,2,30,25.3,-2,1,-1,3,0,1,0,3
"764",2018-03-21,"Cement Creek","w1718","Hybrid",1,"Wed","weekday","sled","Brush/Cement","1","1","1",8.1,0.1,32,2,30,25.3,-2,1,-1,3,0,1,0,3
"765",2018-03-22,"Cement Creek","w1718","Non.motorized",21,"Thu","weekday","no_sled","Brush/Cement","1","1","1",8.1,0,30,-2,36,27,2,-2,1,-1,0,-2,-1,-2
"766",2018-03-22,"Cement Creek","w1718","Mechanized",0,"Thu","weekday","no_sled","Brush/Cement","1","1","1",8.1,0,30,-2,36,27,2,-2,1,-1,0,-2,-1,-2
"767",2018-03-22,"Cement Creek","w1718","Motorized",3,"Thu","weekday","sled","Brush/Cement","1","1","1",8.1,0,30,-2,36,27,2,-2,1,-1,0,-2,-1,-2
"768",2018-03-22,"Cement Creek","w1718","Hybrid",0,"Thu","weekday","sled","Brush/Cement","1","1","1",8.1,0,30,-2,36,27,2,-2,1,-1,0,-2,-1,-2
"769",2018-03-23,"Cement Creek","w1718","Non.motorized",2,"Fri","weekday","no_sled","Brush/Cement","2","2","3",8.2,0.1,29,-1,34,28.3,-2,2,-2,1,-3,-1,-3,-2
"770",2018-03-23,"Cement Creek","w1718","Mechanized",0,"Fri","weekday","no_sled","Brush/Cement","2","2","3",8.2,0.1,29,-1,34,28.3,-2,2,-2,1,-3,-1,-3,-2
"771",2018-03-23,"Cement Creek","w1718","Motorized",4,"Fri","weekday","sled","Brush/Cement","2","2","3",8.2,0.1,29,-1,34,28.3,-2,2,-2,1,-3,-1,-3,-2
"772",2018-03-23,"Cement Creek","w1718","Hybrid",0,"Fri","weekday","sled","Brush/Cement","2","2","3",8.2,0.1,29,-1,34,28.3,-2,2,-2,1,-3,-1,-3,-2
"773",2018-03-24,"Cement Creek","w1718","Non.motorized",6,"Sat","weekend","no_sled","Brush/Cement","2","2","1",8.9,0.7,34,5,32,26.2,-1,-2,2,-2,4,2,4,2
"774",2018-03-24,"Cement Creek","w1718","Mechanized",0,"Sat","weekend","no_sled","Brush/Cement","2","2","1",8.9,0.7,34,5,32,26.2,-1,-2,2,-2,4,2,4,2
"775",2018-03-24,"Cement Creek","w1718","Motorized",5,"Sat","weekend","sled","Brush/Cement","2","2","1",8.9,0.7,34,5,32,26.2,-1,-2,2,-2,4,2,4,2
"776",2018-03-24,"Cement Creek","w1718","Hybrid",0,"Sat","weekend","sled","Brush/Cement","2","2","1",8.9,0.7,34,5,32,26.2,-1,-2,2,-2,4,2,4,2
"777",2018-03-25,"Cement Creek","w1718","Non.motorized",20,"Sun","weekend","no_sled","Brush/Cement","2","2","1",8.9,0,35,1,35,25.4,5,-1,-2,2,6,5,3,5
"778",2018-03-25,"Cement Creek","w1718","Mechanized",0,"Sun","weekend","no_sled","Brush/Cement","2","2","1",8.9,0,35,1,35,25.4,5,-1,-2,2,6,5,3,5
"779",2018-03-25,"Cement Creek","w1718","Motorized",6,"Sun","weekend","sled","Brush/Cement","2","2","1",8.9,0,35,1,35,25.4,5,-1,-2,2,6,5,3,5
"780",2018-03-25,"Cement Creek","w1718","Hybrid",2,"Sun","weekend","sled","Brush/Cement","2","2","1",8.9,0,35,1,35,25.4,5,-1,-2,2,6,5,3,5
"781",2018-03-26,"Cement Creek","w1718","Non.motorized",10,"Mon","weekday","no_sled","Brush/Cement","1","1","1",8.9,0,34,-1,31,26.2,1,5,-1,-2,0,5,4,2
"782",2018-03-26,"Cement Creek","w1718","Non.motorized",10,"Mon","weekday","no_sled","Brush/Cement","2","1","1",8.9,0,34,-1,31,26.2,1,5,-1,-2,0,5,4,2
"783",2018-03-26,"Cement Creek","w1718","Mechanized",1,"Mon","weekday","no_sled","Brush/Cement","1","1","1",8.9,0,34,-1,31,26.2,1,5,-1,-2,0,5,4,2
"784",2018-03-26,"Cement Creek","w1718","Mechanized",1,"Mon","weekday","no_sled","Brush/Cement","2","1","1",8.9,0,34,-1,31,26.2,1,5,-1,-2,0,5,4,2
"785",2018-03-26,"Cement Creek","w1718","Motorized",2,"Mon","weekday","sled","Brush/Cement","1","1","1",8.9,0,34,-1,31,26.2,1,5,-1,-2,0,5,4,2
"786",2018-03-26,"Cement Creek","w1718","Motorized",2,"Mon","weekday","sled","Brush/Cement","2","1","1",8.9,0,34,-1,31,26.2,1,5,-1,-2,0,5,4,2
"787",2018-03-26,"Cement Creek","w1718","Hybrid",0,"Mon","weekday","sled","Brush/Cement","1","1","1",8.9,0,34,-1,31,26.2,1,5,-1,-2,0,5,4,2
"788",2018-03-26,"Cement Creek","w1718","Hybrid",0,"Mon","weekday","sled","Brush/Cement","2","1","1",8.9,0,34,-1,31,26.2,1,5,-1,-2,0,5,4,2
"789",2018-03-27,"Cement Creek","w1718","Non.motorized",2,"Tue","weekday","no_sled","Brush/Cement","1","1","1",8.9,0,33,-1,29,27,-1,1,5,-1,-2,-1,4,3
"790",2018-03-27,"Cement Creek","w1718","Mechanized",0,"Tue","weekday","no_sled","Brush/Cement","1","1","1",8.9,0,33,-1,29,27,-1,1,5,-1,-2,-1,4,3
"791",2018-03-27,"Cement Creek","w1718","Motorized",4,"Tue","weekday","sled","Brush/Cement","1","1","1",8.9,0,33,-1,29,27,-1,1,5,-1,-2,-1,4,3
"792",2018-03-27,"Cement Creek","w1718","Hybrid",0,"Tue","weekday","sled","Brush/Cement","1","1","1",8.9,0,33,-1,29,27,-1,1,5,-1,-2,-1,4,3
"793",2018-03-28,"Cement Creek","w1718","Non.motorized",10,"Wed","weekday","no_sled","Brush/Cement","1","1","1",8.9,0,33,0,27,27,-1,-1,1,5,-1,-2,-1,4
"794",2018-03-28,"Cement Creek","w1718","Mechanized",0,"Wed","weekday","no_sled","Brush/Cement","1","1","1",8.9,0,33,0,27,27,-1,-1,1,5,-1,-2,-1,4
"795",2018-03-28,"Cement Creek","w1718","Motorized",1,"Wed","weekday","sled","Brush/Cement","1","1","1",8.9,0,33,0,27,27,-1,-1,1,5,-1,-2,-1,4
"796",2018-03-28,"Cement Creek","w1718","Hybrid",0,"Wed","weekday","sled","Brush/Cement","1","1","1",8.9,0,33,0,27,27,-1,-1,1,5,-1,-2,-1,4
"797",2018-03-29,"Cement Creek","w1718","Non.motorized",10,"Thu","weekday","no_sled","Brush/Cement","1","1","1",8.9,0,33,0,27,27,0,-1,-1,1,0,-1,-2,-1
"798",2018-03-29,"Cement Creek","w1718","Mechanized",0,"Thu","weekday","no_sled","Brush/Cement","1","1","1",8.9,0,33,0,27,27,0,-1,-1,1,0,-1,-2,-1
"799",2018-03-29,"Cement Creek","w1718","Motorized",4,"Thu","weekday","sled","Brush/Cement","1","1","1",8.9,0,33,0,27,27,0,-1,-1,1,0,-1,-2,-1
"800",2018-03-29,"Cement Creek","w1718","Hybrid",0,"Thu","weekday","sled","Brush/Cement","1","1","1",8.9,0,33,0,27,27,0,-1,-1,1,0,-1,-2,-1
"801",2018-03-30,"Cement Creek","w1718","Non.motorized",11,"Fri","weekday","no_sled","Brush/Cement","1","1","1",8.9,0,32,-1,33,27.8,0,0,-1,-1,-1,-1,-2,-3
"802",2018-03-30,"Cement Creek","w1718","Mechanized",0,"Fri","weekday","no_sled","Brush/Cement","1","1","1",8.9,0,32,-1,33,27.8,0,0,-1,-1,-1,-1,-2,-3
"803",2018-03-30,"Cement Creek","w1718","Motorized",8,"Fri","weekday","sled","Brush/Cement","1","1","1",8.9,0,32,-1,33,27.8,0,0,-1,-1,-1,-1,-2,-3
"804",2018-03-30,"Cement Creek","w1718","Hybrid",0,"Fri","weekday","sled","Brush/Cement","1","1","1",8.9,0,32,-1,33,27.8,0,0,-1,-1,-1,-1,-2,-3
"805",2017-12-22,"Gothic Rd","w1718","Non.motorized",0,"Fri","weekday","no_sled","East River","2","2","1",2,0,11,3,17,18.2,0,0,0,0,3,3,3,3
"806",2017-12-22,"Gothic Rd","w1718","Mechanized",0,"Fri","weekday","no_sled","East River","2","2","1",2,0,11,3,17,18.2,0,0,0,0,3,3,3,3
"807",2017-12-22,"Gothic Rd","w1718","Motorized",0,"Fri","weekday","sled","East River","2","2","1",2,0,11,3,17,18.2,0,0,0,0,3,3,3,3
"808",2017-12-22,"Gothic Rd","w1718","Hybrid",0,"Fri","weekday","sled","East River","2","2","1",2,0,11,3,17,18.2,0,0,0,0,3,3,3,3
"809",2017-12-23,"Gothic Rd","w1718","Non.motorized",0,"Sat","weekend","no_sled","East River","2","1","1",2.1,0.1,10,-1,21,21,3,0,0,0,2,2,2,2
"810",2017-12-23,"Gothic Rd","w1718","Mechanized",0,"Sat","weekend","no_sled","East River","2","1","1",2.1,0.1,10,-1,21,21,3,0,0,0,2,2,2,2
"811",2017-12-23,"Gothic Rd","w1718","Motorized",0,"Sat","weekend","sled","East River","2","1","1",2.1,0.1,10,-1,21,21,3,0,0,0,2,2,2,2
"812",2017-12-23,"Gothic Rd","w1718","Hybrid",0,"Sat","weekend","sled","East River","2","1","1",2.1,0.1,10,-1,21,21,3,0,0,0,2,2,2,2
"813",2017-12-24,"Gothic Rd","w1718","Non.motorized",0,"Sun","weekend","no_sled","East River","1","1","1",2.4,0.3,14,4,19,17.1,-1,3,0,0,3,6,6,6
"814",2017-12-24,"Gothic Rd","w1718","Mechanized",0,"Sun","weekend","no_sled","East River","1","1","1",2.4,0.3,14,4,19,17.1,-1,3,0,0,3,6,6,6
"815",2017-12-24,"Gothic Rd","w1718","Motorized",0,"Sun","weekend","sled","East River","1","1","1",2.4,0.3,14,4,19,17.1,-1,3,0,0,3,6,6,6
"816",2017-12-24,"Gothic Rd","w1718","Hybrid",0,"Sun","weekend","sled","East River","1","1","1",2.4,0.3,14,4,19,17.1,-1,3,0,0,3,6,6,6
"817",2017-12-25,"Gothic Rd","w1718","Non.motorized",42,"Mon","weekday","no_sled","East River","2","1","1",2.6,0.2,14,0,25,18.6,4,-1,3,0,4,3,6,6
"818",2017-12-25,"Gothic Rd","w1718","Mechanized",0,"Mon","weekday","no_sled","East River","2","1","1",2.6,0.2,14,0,25,18.6,4,-1,3,0,4,3,6,6
"819",2017-12-25,"Gothic Rd","w1718","Motorized",2,"Mon","weekday","sled","East River","2","1","1",2.6,0.2,14,0,25,18.6,4,-1,3,0,4,3,6,6
"820",2017-12-25,"Gothic Rd","w1718","Hybrid",0,"Mon","weekday","sled","East River","2","1","1",2.6,0.2,14,0,25,18.6,4,-1,3,0,4,3,6,6
"821",2017-12-26,"Gothic Rd","w1718","Non.motorized",55,"Tue","weekday","no_sled","East River","1","1","1",3.1,0.5,20,6,25,15.5,0,4,-1,3,6,10,9,12
"822",2017-12-26,"Gothic Rd","w1718","Mechanized",0,"Tue","weekday","no_sled","East River","1","1","1",3.1,0.5,20,6,25,15.5,0,4,-1,3,6,10,9,12
"823",2017-12-26,"Gothic Rd","w1718","Motorized",4,"Tue","weekday","sled","East River","1","1","1",3.1,0.5,20,6,25,15.5,0,4,-1,3,6,10,9,12
"824",2017-12-26,"Gothic Rd","w1718","Hybrid",0,"Tue","weekday","sled","East River","1","1","1",3.1,0.5,20,6,25,15.5,0,4,-1,3,6,10,9,12
"825",2017-12-27,"Gothic Rd","w1718","Non.motorized",6,"Wed","weekday","no_sled","East River","1","1","1",3.1,0,18,-2,27,17.2,6,0,4,-1,4,4,8,7
"826",2017-12-27,"Gothic Rd","w1718","Mechanized",1,"Wed","weekday","no_sled","East River","1","1","1",3.1,0,18,-2,27,17.2,6,0,4,-1,4,4,8,7
"827",2017-12-27,"Gothic Rd","w1718","Motorized",0,"Wed","weekday","sled","East River","1","1","1",3.1,0,18,-2,27,17.2,6,0,4,-1,4,4,8,7
"828",2017-12-27,"Gothic Rd","w1718","Hybrid",0,"Wed","weekday","sled","East River","1","1","1",3.1,0,18,-2,27,17.2,6,0,4,-1,4,4,8,7
"829",2017-12-28,"Gothic Rd","w1718","Non.motorized",77,"Thu","weekday","no_sled","East River","1","1","1",3.2,0.1,17,-1,31,18.8,-2,6,0,4,-3,3,3,7
"830",2017-12-28,"Gothic Rd","w1718","Mechanized",16,"Thu","weekday","no_sled","East River","1","1","1",3.2,0.1,17,-1,31,18.8,-2,6,0,4,-3,3,3,7
"831",2017-12-28,"Gothic Rd","w1718","Motorized",1,"Thu","weekday","sled","East River","1","1","1",3.2,0.1,17,-1,31,18.8,-2,6,0,4,-3,3,3,7
"832",2017-12-28,"Gothic Rd","w1718","Hybrid",0,"Thu","weekday","sled","East River","1","1","1",3.2,0.1,17,-1,31,18.8,-2,6,0,4,-3,3,3,7
"833",2017-12-29,"Gothic Rd","w1718","Non.motorized",117,"Fri","weekday","no_sled","East River","1","1","1",3.2,0,17,0,36,18.8,-1,-2,6,0,-1,-3,3,3
"834",2017-12-29,"Gothic Rd","w1718","Mechanized",9,"Fri","weekday","no_sled","East River","1","1","1",3.2,0,17,0,36,18.8,-1,-2,6,0,-1,-3,3,3
"835",2017-12-29,"Gothic Rd","w1718","Motorized",0,"Fri","weekday","sled","East River","1","1","1",3.2,0,17,0,36,18.8,-1,-2,6,0,-1,-3,3,3
"836",2017-12-29,"Gothic Rd","w1718","Hybrid",0,"Fri","weekday","sled","East River","1","1","1",3.2,0,17,0,36,18.8,-1,-2,6,0,-1,-3,3,3
"837",2017-12-30,"Gothic Rd","w1718","Non.motorized",147,"Sat","weekend","no_sled","East River","1","1","1",3.2,0,15,-2,37,21.3,0,-1,-2,6,-2,-3,-5,1
"838",2017-12-30,"Gothic Rd","w1718","Mechanized",10,"Sat","weekend","no_sled","East River","1","1","1",3.2,0,15,-2,37,21.3,0,-1,-2,6,-2,-3,-5,1
"839",2017-12-30,"Gothic Rd","w1718","Motorized",2,"Sat","weekend","sled","East River","1","1","1",3.2,0,15,-2,37,21.3,0,-1,-2,6,-2,-3,-5,1
"840",2017-12-30,"Gothic Rd","w1718","Hybrid",0,"Sat","weekend","sled","East River","1","1","1",3.2,0,15,-2,37,21.3,0,-1,-2,6,-2,-3,-5,1
"841",2017-12-31,"Gothic Rd","w1718","Non.motorized",106,"Sun","weekend","no_sled","East River","1","1","1",3.2,0,15,0,31,21.3,-2,0,-1,-2,-2,-2,-3,-5
"842",2017-12-31,"Gothic Rd","w1718","Mechanized",6,"Sun","weekend","no_sled","East River","1","1","1",3.2,0,15,0,31,21.3,-2,0,-1,-2,-2,-2,-3,-5
"843",2017-12-31,"Gothic Rd","w1718","Motorized",4,"Sun","weekend","sled","East River","1","1","1",3.2,0,15,0,31,21.3,-2,0,-1,-2,-2,-2,-3,-5
"844",2017-12-31,"Gothic Rd","w1718","Hybrid",0,"Sun","weekend","sled","East River","1","1","1",3.2,0,15,0,31,21.3,-2,0,-1,-2,-2,-2,-3,-5
"845",2018-01-01,"Gothic Rd","w1718","Non.motorized",93,"Mon","weekday","no_sled","East River","1","1","1",3.2,0,15,0,27,21.3,0,-2,0,-1,0,-2,-2,-3
"846",2018-01-01,"Gothic Rd","w1718","Mechanized",2,"Mon","weekday","no_sled","East River","1","1","1",3.2,0,15,0,27,21.3,0,-2,0,-1,0,-2,-2,-3
"847",2018-01-01,"Gothic Rd","w1718","Motorized",0,"Mon","weekday","sled","East River","1","1","1",3.2,0,15,0,27,21.3,0,-2,0,-1,0,-2,-2,-3
"848",2018-01-01,"Gothic Rd","w1718","Hybrid",0,"Mon","weekday","sled","East River","1","1","1",3.2,0,15,0,27,21.3,0,-2,0,-1,0,-2,-2,-3
"849",2018-01-02,"Gothic Rd","w1718","Non.motorized",NA,"Tue","weekday","no_sled","East River","1","1","1",3.2,0,15,0,22,21.3,0,0,-2,0,0,0,-2,-2
"850",2018-01-02,"Gothic Rd","w1718","Mechanized",NA,"Tue","weekday","no_sled","East River","1","1","1",3.2,0,15,0,22,21.3,0,0,-2,0,0,0,-2,-2
"851",2018-01-02,"Gothic Rd","w1718","Motorized",NA,"Tue","weekday","sled","East River","1","1","1",3.2,0,15,0,22,21.3,0,0,-2,0,0,0,-2,-2
"852",2018-01-02,"Gothic Rd","w1718","Hybrid",NA,"Tue","weekday","sled","East River","1","1","1",3.2,0,15,0,22,21.3,0,0,-2,0,0,0,-2,-2
"853",2018-01-03,"Gothic Rd","w1718","Non.motorized",NA,"Wed","weekday","no_sled","East River","1","1","1",3.2,0,15,0,27,21.3,0,0,0,-2,0,0,0,-2
"854",2018-01-03,"Gothic Rd","w1718","Mechanized",NA,"Wed","weekday","no_sled","East River","1","1","1",3.2,0,15,0,27,21.3,0,0,0,-2,0,0,0,-2
"855",2018-01-03,"Gothic Rd","w1718","Motorized",NA,"Wed","weekday","sled","East River","1","1","1",3.2,0,15,0,27,21.3,0,0,0,-2,0,0,0,-2
"856",2018-01-03,"Gothic Rd","w1718","Hybrid",NA,"Wed","weekday","sled","East River","1","1","1",3.2,0,15,0,27,21.3,0,0,0,-2,0,0,0,-2
"857",2018-01-04,"Gothic Rd","w1718","Non.motorized",NA,"Thu","weekday","no_sled","East River","1","1","1",3.2,0,15,0,29,21.3,0,0,0,0,0,0,0,0
"858",2018-01-04,"Gothic Rd","w1718","Mechanized",NA,"Thu","weekday","no_sled","East River","1","1","1",3.2,0,15,0,29,21.3,0,0,0,0,0,0,0,0
"859",2018-01-04,"Gothic Rd","w1718","Motorized",NA,"Thu","weekday","sled","East River","1","1","1",3.2,0,15,0,29,21.3,0,0,0,0,0,0,0,0
"860",2018-01-04,"Gothic Rd","w1718","Hybrid",NA,"Thu","weekday","sled","East River","1","1","1",3.2,0,15,0,29,21.3,0,0,0,0,0,0,0,0
"861",2018-01-05,"Gothic Rd","w1718","Non.motorized",NA,"Fri","weekday","no_sled","East River","1","1","1",3.2,0,14,-1,32,22.9,0,0,0,0,-1,-1,-1,-1
"862",2018-01-05,"Gothic Rd","w1718","Mechanized",NA,"Fri","weekday","no_sled","East River","1","1","1",3.2,0,14,-1,32,22.9,0,0,0,0,-1,-1,-1,-1
"863",2018-01-05,"Gothic Rd","w1718","Motorized",NA,"Fri","weekday","sled","East River","1","1","1",3.2,0,14,-1,32,22.9,0,0,0,0,-1,-1,-1,-1
"864",2018-01-05,"Gothic Rd","w1718","Hybrid",NA,"Fri","weekday","sled","East River","1","1","1",3.2,0,14,-1,32,22.9,0,0,0,0,-1,-1,-1,-1
"865",2018-01-06,"Gothic Rd","w1718","Non.motorized",NA,"Sat","weekend","no_sled","East River","1","1","1",3.2,0,14,0,30,22.9,-1,0,0,0,-1,-1,-1,-1
"866",2018-01-06,"Gothic Rd","w1718","Mechanized",NA,"Sat","weekend","no_sled","East River","1","1","1",3.2,0,14,0,30,22.9,-1,0,0,0,-1,-1,-1,-1
"867",2018-01-06,"Gothic Rd","w1718","Motorized",NA,"Sat","weekend","sled","East River","1","1","1",3.2,0,14,0,30,22.9,-1,0,0,0,-1,-1,-1,-1
"868",2018-01-06,"Gothic Rd","w1718","Hybrid",NA,"Sat","weekend","sled","East River","1","1","1",3.2,0,14,0,30,22.9,-1,0,0,0,-1,-1,-1,-1
"869",2018-01-07,"Gothic Rd","w1718","Non.motorized",16,"Sun","weekend","no_sled","East River","2","2","2",3.5,0.3,18,4,25,19.4,0,-1,0,0,4,3,3,3
"870",2018-01-07,"Gothic Rd","w1718","Mechanized",0,"Sun","weekend","no_sled","East River","2","2","2",3.5,0.3,18,4,25,19.4,0,-1,0,0,4,3,3,3
"871",2018-01-07,"Gothic Rd","w1718","Motorized",0,"Sun","weekend","sled","East River","2","2","2",3.5,0.3,18,4,25,19.4,0,-1,0,0,4,3,3,3
"872",2018-01-07,"Gothic Rd","w1718","Hybrid",0,"Sun","weekend","sled","East River","2","2","2",3.5,0.3,18,4,25,19.4,0,-1,0,0,4,3,3,3
"873",2018-01-08,"Gothic Rd","w1718","Non.motorized",24,"Mon","weekday","no_sled","East River","2","2","1",3.7,0.2,20,2,29,18.5,4,0,-1,0,6,6,5,5
"874",2018-01-08,"Gothic Rd","w1718","Mechanized",1,"Mon","weekday","no_sled","East River","2","2","1",3.7,0.2,20,2,29,18.5,4,0,-1,0,6,6,5,5
"875",2018-01-08,"Gothic Rd","w1718","Motorized",0,"Mon","weekday","sled","East River","2","2","1",3.7,0.2,20,2,29,18.5,4,0,-1,0,6,6,5,5
"876",2018-01-08,"Gothic Rd","w1718","Hybrid",0,"Mon","weekday","sled","East River","2","2","1",3.7,0.2,20,2,29,18.5,4,0,-1,0,6,6,5,5
"877",2018-01-09,"Gothic Rd","w1718","Non.motorized",26,"Tue","weekday","no_sled","East River","2","2","1",3.8,0.1,21,1,34,18.1,2,4,0,-1,3,7,7,6
"878",2018-01-09,"Gothic Rd","w1718","Mechanized",0,"Tue","weekday","no_sled","East River","2","2","1",3.8,0.1,21,1,34,18.1,2,4,0,-1,3,7,7,6
"879",2018-01-09,"Gothic Rd","w1718","Motorized",1,"Tue","weekday","sled","East River","2","2","1",3.8,0.1,21,1,34,18.1,2,4,0,-1,3,7,7,6
"880",2018-01-09,"Gothic Rd","w1718","Hybrid",0,"Tue","weekday","sled","East River","2","2","1",3.8,0.1,21,1,34,18.1,2,4,0,-1,3,7,7,6
"881",2018-01-10,"Gothic Rd","w1718","Non.motorized",NA,"Wed","weekday","no_sled","East River","3","3","3",4,0.2,21,0,28,19,1,2,4,0,1,3,7,7
"882",2018-01-10,"Gothic Rd","w1718","Mechanized",NA,"Wed","weekday","no_sled","East River","3","3","3",4,0.2,21,0,28,19,1,2,4,0,1,3,7,7
"883",2018-01-10,"Gothic Rd","w1718","Motorized",NA,"Wed","weekday","sled","East River","3","3","3",4,0.2,21,0,28,19,1,2,4,0,1,3,7,7
"884",2018-01-10,"Gothic Rd","w1718","Hybrid",NA,"Wed","weekday","sled","East River","3","3","3",4,0.2,21,0,28,19,1,2,4,0,1,3,7,7
"885",2018-01-11,"Gothic Rd","w1718","Non.motorized",NA,"Thu","weekday","no_sled","East River","3","3","3",4.1,0.1,26,5,17,15.8,0,1,2,4,5,6,8,12
"886",2018-01-11,"Gothic Rd","w1718","Mechanized",NA,"Thu","weekday","no_sled","East River","3","3","3",4.1,0.1,26,5,17,15.8,0,1,2,4,5,6,8,12
"887",2018-01-11,"Gothic Rd","w1718","Motorized",NA,"Thu","weekday","sled","East River","3","3","3",4.1,0.1,26,5,17,15.8,0,1,2,4,5,6,8,12
"888",2018-01-11,"Gothic Rd","w1718","Hybrid",NA,"Thu","weekday","sled","East River","3","3","3",4.1,0.1,26,5,17,15.8,0,1,2,4,5,6,8,12
"889",2018-01-12,"Gothic Rd","w1718","Non.motorized",NA,"Fri","weekday","no_sled","East River","3","3","3",4.3,0.2,24,-2,22,17.9,5,0,1,2,3,3,4,6
"890",2018-01-12,"Gothic Rd","w1718","Mechanized",NA,"Fri","weekday","no_sled","East River","3","3","3",4.3,0.2,24,-2,22,17.9,5,0,1,2,3,3,4,6
"891",2018-01-12,"Gothic Rd","w1718","Motorized",NA,"Fri","weekday","sled","East River","3","3","3",4.3,0.2,24,-2,22,17.9,5,0,1,2,3,3,4,6
"892",2018-01-12,"Gothic Rd","w1718","Hybrid",NA,"Fri","weekday","sled","East River","3","3","3",4.3,0.2,24,-2,22,17.9,5,0,1,2,3,3,4,6
"893",2018-01-13,"Gothic Rd","w1718","Non.motorized",NA,"Sat","weekend","no_sled","East River","3","3","3",4.4,0.1,24,0,24,18.3,-2,5,0,1,-2,3,3,4
"894",2018-01-13,"Gothic Rd","w1718","Mechanized",NA,"Sat","weekend","no_sled","East River","3","3","3",4.4,0.1,24,0,24,18.3,-2,5,0,1,-2,3,3,4
"895",2018-01-13,"Gothic Rd","w1718","Motorized",NA,"Sat","weekend","sled","East River","3","3","3",4.4,0.1,24,0,24,18.3,-2,5,0,1,-2,3,3,4
"896",2018-01-13,"Gothic Rd","w1718","Hybrid",NA,"Sat","weekend","sled","East River","3","3","3",4.4,0.1,24,0,24,18.3,-2,5,0,1,-2,3,3,4
"897",2018-01-14,"Gothic Rd","w1718","Non.motorized",NA,"Sun","weekend","no_sled","East River","3","3","2",4.4,0,24,0,27,18.3,0,-2,5,0,0,-2,3,3
"898",2018-01-14,"Gothic Rd","w1718","Mechanized",NA,"Sun","weekend","no_sled","East River","3","3","2",4.4,0,24,0,27,18.3,0,-2,5,0,0,-2,3,3
"899",2018-01-14,"Gothic Rd","w1718","Motorized",NA,"Sun","weekend","sled","East River","3","3","2",4.4,0,24,0,27,18.3,0,-2,5,0,0,-2,3,3
"900",2018-01-14,"Gothic Rd","w1718","Hybrid",NA,"Sun","weekend","sled","East River","3","3","2",4.4,0,24,0,27,18.3,0,-2,5,0,0,-2,3,3
"901",2018-01-15,"Gothic Rd","w1718","Non.motorized",NA,"Mon","weekday","no_sled","East River","3","3","2",4.4,0,23,-1,27,19.1,0,0,-2,5,-1,-1,-3,2
"902",2018-01-15,"Gothic Rd","w1718","Mechanized",NA,"Mon","weekday","no_sled","East River","3","3","2",4.4,0,23,-1,27,19.1,0,0,-2,5,-1,-1,-3,2
"903",2018-01-15,"Gothic Rd","w1718","Motorized",NA,"Mon","weekday","sled","East River","3","3","2",4.4,0,23,-1,27,19.1,0,0,-2,5,-1,-1,-3,2
"904",2018-01-15,"Gothic Rd","w1718","Hybrid",NA,"Mon","weekday","sled","East River","3","3","2",4.4,0,23,-1,27,19.1,0,0,-2,5,-1,-1,-3,2
"905",2018-01-16,"Gothic Rd","w1718","Non.motorized",NA,"Tue","weekday","no_sled","East River","3","3","2",4.4,0,22,-1,20,20,-1,0,0,-2,-2,-2,-2,-4
"906",2018-01-16,"Gothic Rd","w1718","Mechanized",NA,"Tue","weekday","no_sled","East River","3","3","2",4.4,0,22,-1,20,20,-1,0,0,-2,-2,-2,-2,-4
"907",2018-01-16,"Gothic Rd","w1718","Motorized",NA,"Tue","weekday","sled","East River","3","3","2",4.4,0,22,-1,20,20,-1,0,0,-2,-2,-2,-2,-4
"908",2018-01-16,"Gothic Rd","w1718","Hybrid",NA,"Tue","weekday","sled","East River","3","3","2",4.4,0,22,-1,20,20,-1,0,0,-2,-2,-2,-2,-4
"909",2018-01-17,"Gothic Rd","w1718","Non.motorized",NA,"Wed","weekday","no_sled","East River","2","2","2",4.4,0,22,0,24,20,-1,-1,0,0,-1,-2,-2,-2
"910",2018-01-17,"Gothic Rd","w1718","Mechanized",NA,"Wed","weekday","no_sled","East River","2","2","2",4.4,0,22,0,24,20,-1,-1,0,0,-1,-2,-2,-2
"911",2018-01-17,"Gothic Rd","w1718","Motorized",NA,"Wed","weekday","sled","East River","2","2","2",4.4,0,22,0,24,20,-1,-1,0,0,-1,-2,-2,-2
"912",2018-01-17,"Gothic Rd","w1718","Hybrid",NA,"Wed","weekday","sled","East River","2","2","2",4.4,0,22,0,24,20,-1,-1,0,0,-1,-2,-2,-2
"913",2018-01-18,"Gothic Rd","w1718","Non.motorized",NA,"Thu","weekday","no_sled","East River","2","2","2",4.4,0,21,-1,29,21,0,-1,-1,0,-1,-2,-3,-3
"914",2018-01-18,"Gothic Rd","w1718","Mechanized",NA,"Thu","weekday","no_sled","East River","2","2","2",4.4,0,21,-1,29,21,0,-1,-1,0,-1,-2,-3,-3
"915",2018-01-18,"Gothic Rd","w1718","Motorized",NA,"Thu","weekday","sled","East River","2","2","2",4.4,0,21,-1,29,21,0,-1,-1,0,-1,-2,-3,-3
"916",2018-01-18,"Gothic Rd","w1718","Hybrid",NA,"Thu","weekday","sled","East River","2","2","2",4.4,0,21,-1,29,21,0,-1,-1,0,-1,-2,-3,-3
"917",2018-01-19,"Gothic Rd","w1718","Non.motorized",NA,"Fri","weekday","no_sled","East River","2","2","2",4.5,0.1,21,0,34,21.4,-1,0,-1,-1,-1,-1,-2,-3
"918",2018-01-19,"Gothic Rd","w1718","Mechanized",NA,"Fri","weekday","no_sled","East River","2","2","2",4.5,0.1,21,0,34,21.4,-1,0,-1,-1,-1,-1,-2,-3
"919",2018-01-19,"Gothic Rd","w1718","Motorized",NA,"Fri","weekday","sled","East River","2","2","2",4.5,0.1,21,0,34,21.4,-1,0,-1,-1,-1,-1,-2,-3
"920",2018-01-19,"Gothic Rd","w1718","Hybrid",NA,"Fri","weekday","sled","East River","2","2","2",4.5,0.1,21,0,34,21.4,-1,0,-1,-1,-1,-1,-2,-3
"921",2018-01-20,"Gothic Rd","w1718","Non.motorized",NA,"Sat","weekend","no_sled","East River","2","2","2",4.5,0,21,0,32,21.4,0,-1,0,-1,0,-1,-1,-2
"922",2018-01-20,"Gothic Rd","w1718","Mechanized",NA,"Sat","weekend","no_sled","East River","2","2","2",4.5,0,21,0,32,21.4,0,-1,0,-1,0,-1,-1,-2
"923",2018-01-20,"Gothic Rd","w1718","Motorized",NA,"Sat","weekend","sled","East River","2","2","2",4.5,0,21,0,32,21.4,0,-1,0,-1,0,-1,-1,-2
"924",2018-01-20,"Gothic Rd","w1718","Hybrid",NA,"Sat","weekend","sled","East River","2","2","2",4.5,0,21,0,32,21.4,0,-1,0,-1,0,-1,-1,-2
"925",2018-01-21,"Gothic Rd","w1718","Non.motorized",NA,"Sun","weekend","no_sled","East River","3","3","3",4.6,0.1,23,2,15,20,0,0,-1,0,2,2,1,1
"926",2018-01-21,"Gothic Rd","w1718","Mechanized",NA,"Sun","weekend","no_sled","East River","3","3","3",4.6,0.1,23,2,15,20,0,0,-1,0,2,2,1,1
"927",2018-01-21,"Gothic Rd","w1718","Motorized",NA,"Sun","weekend","sled","East River","3","3","3",4.6,0.1,23,2,15,20,0,0,-1,0,2,2,1,1
"928",2018-01-21,"Gothic Rd","w1718","Hybrid",NA,"Sun","weekend","sled","East River","3","3","3",4.6,0.1,23,2,15,20,0,0,-1,0,2,2,1,1
"929",2018-01-22,"Gothic Rd","w1718","Non.motorized",NA,"Mon","weekday","no_sled","East River","3","3","3",4.6,0,21,-2,12,21.9,2,0,0,-1,0,0,0,-1
"930",2018-01-22,"Gothic Rd","w1718","Mechanized",NA,"Mon","weekday","no_sled","East River","3","3","3",4.6,0,21,-2,12,21.9,2,0,0,-1,0,0,0,-1
"931",2018-01-22,"Gothic Rd","w1718","Motorized",NA,"Mon","weekday","sled","East River","3","3","3",4.6,0,21,-2,12,21.9,2,0,0,-1,0,0,0,-1
"932",2018-01-22,"Gothic Rd","w1718","Hybrid",NA,"Mon","weekday","sled","East River","3","3","3",4.6,0,21,-2,12,21.9,2,0,0,-1,0,0,0,-1
"933",2018-01-23,"Gothic Rd","w1718","Non.motorized",NA,"Tue","weekday","no_sled","East River","3","3","3",4.6,0,22,1,16,20.9,-2,2,0,0,-1,1,1,1
"934",2018-01-23,"Gothic Rd","w1718","Mechanized",NA,"Tue","weekday","no_sled","East River","3","3","3",4.6,0,22,1,16,20.9,-2,2,0,0,-1,1,1,1
"935",2018-01-23,"Gothic Rd","w1718","Motorized",NA,"Tue","weekday","sled","East River","3","3","3",4.6,0,22,1,16,20.9,-2,2,0,0,-1,1,1,1
"936",2018-01-23,"Gothic Rd","w1718","Hybrid",NA,"Tue","weekday","sled","East River","3","3","3",4.6,0,22,1,16,20.9,-2,2,0,0,-1,1,1,1
"937",2018-01-24,"Gothic Rd","w1718","Non.motorized",NA,"Wed","weekday","no_sled","East River","2","2","2",4.6,0,22,0,22,20.9,1,-2,2,0,1,-1,1,1
"938",2018-01-24,"Gothic Rd","w1718","Mechanized",NA,"Wed","weekday","no_sled","East River","2","2","2",4.6,0,22,0,22,20.9,1,-2,2,0,1,-1,1,1
"939",2018-01-24,"Gothic Rd","w1718","Motorized",NA,"Wed","weekday","sled","East River","2","2","2",4.6,0,22,0,22,20.9,1,-2,2,0,1,-1,1,1
"940",2018-01-24,"Gothic Rd","w1718","Hybrid",NA,"Wed","weekday","sled","East River","2","2","2",4.6,0,22,0,22,20.9,1,-2,2,0,1,-1,1,1
"941",2018-01-25,"Gothic Rd","w1718","Non.motorized",NA,"Thu","weekday","no_sled","East River","2","2","2",4.6,0,22,0,28,20.9,0,1,-2,2,0,1,-1,1
"942",2018-01-25,"Gothic Rd","w1718","Mechanized",NA,"Thu","weekday","no_sled","East River","2","2","2",4.6,0,22,0,28,20.9,0,1,-2,2,0,1,-1,1
"943",2018-01-25,"Gothic Rd","w1718","Motorized",NA,"Thu","weekday","sled","East River","2","2","2",4.6,0,22,0,28,20.9,0,1,-2,2,0,1,-1,1
"944",2018-01-25,"Gothic Rd","w1718","Hybrid",NA,"Thu","weekday","sled","East River","2","2","2",4.6,0,22,0,28,20.9,0,1,-2,2,0,1,-1,1
"945",2018-01-26,"Gothic Rd","w1718","Non.motorized",NA,"Fri","weekday","no_sled","East River","2","2","2",4.7,0.1,22,0,15,21.4,0,0,1,-2,0,0,1,-1
"946",2018-01-26,"Gothic Rd","w1718","Mechanized",NA,"Fri","weekday","no_sled","East River","2","2","2",4.7,0.1,22,0,15,21.4,0,0,1,-2,0,0,1,-1
"947",2018-01-26,"Gothic Rd","w1718","Motorized",NA,"Fri","weekday","sled","East River","2","2","2",4.7,0.1,22,0,15,21.4,0,0,1,-2,0,0,1,-1
"948",2018-01-26,"Gothic Rd","w1718","Hybrid",NA,"Fri","weekday","sled","East River","2","2","2",4.7,0.1,22,0,15,21.4,0,0,1,-2,0,0,1,-1
"949",2018-01-27,"Gothic Rd","w1718","Non.motorized",NA,"Sat","weekend","no_sled","East River","2","2","2",4.7,0,23,1,16,20.4,0,0,0,1,1,1,1,2
"950",2018-01-27,"Gothic Rd","w1718","Mechanized",NA,"Sat","weekend","no_sled","East River","2","2","2",4.7,0,23,1,16,20.4,0,0,0,1,1,1,1,2
"951",2018-01-27,"Gothic Rd","w1718","Motorized",NA,"Sat","weekend","sled","East River","2","2","2",4.7,0,23,1,16,20.4,0,0,0,1,1,1,1,2
"952",2018-01-27,"Gothic Rd","w1718","Hybrid",NA,"Sat","weekend","sled","East River","2","2","2",4.7,0,23,1,16,20.4,0,0,0,1,1,1,1,2
"953",2018-01-28,"Gothic Rd","w1718","Non.motorized",NA,"Sun","weekend","no_sled","East River","2","2","2",4.7,0,23,0,25,20.4,1,0,0,0,1,1,1,1
"954",2018-01-28,"Gothic Rd","w1718","Mechanized",NA,"Sun","weekend","no_sled","East River","2","2","2",4.7,0,23,0,25,20.4,1,0,0,0,1,1,1,1
"955",2018-01-28,"Gothic Rd","w1718","Motorized",NA,"Sun","weekend","sled","East River","2","2","2",4.7,0,23,0,25,20.4,1,0,0,0,1,1,1,1
"956",2018-01-28,"Gothic Rd","w1718","Hybrid",NA,"Sun","weekend","sled","East River","2","2","2",4.7,0,23,0,25,20.4,1,0,0,0,1,1,1,1
"957",2018-01-29,"Gothic Rd","w1718","Non.motorized",NA,"Mon","weekday","no_sled","East River","2","2","2",4.8,0.1,22,-1,30,21.8,0,1,0,0,-1,0,0,0
"958",2018-01-29,"Gothic Rd","w1718","Mechanized",NA,"Mon","weekday","no_sled","East River","2","2","2",4.8,0.1,22,-1,30,21.8,0,1,0,0,-1,0,0,0
"959",2018-01-29,"Gothic Rd","w1718","Motorized",NA,"Mon","weekday","sled","East River","2","2","2",4.8,0.1,22,-1,30,21.8,0,1,0,0,-1,0,0,0
"960",2018-01-29,"Gothic Rd","w1718","Hybrid",NA,"Mon","weekday","sled","East River","2","2","2",4.8,0.1,22,-1,30,21.8,0,1,0,0,-1,0,0,0
"961",2018-01-30,"Gothic Rd","w1718","Non.motorized",NA,"Tue","weekday","no_sled","East River","2","2","2",4.8,0,22,0,34,21.8,-1,0,1,0,-1,-1,0,0
"962",2018-01-30,"Gothic Rd","w1718","Mechanized",NA,"Tue","weekday","no_sled","East River","2","2","2",4.8,0,22,0,34,21.8,-1,0,1,0,-1,-1,0,0
"963",2018-01-30,"Gothic Rd","w1718","Motorized",NA,"Tue","weekday","sled","East River","2","2","2",4.8,0,22,0,34,21.8,-1,0,1,0,-1,-1,0,0
"964",2018-01-30,"Gothic Rd","w1718","Hybrid",NA,"Tue","weekday","sled","East River","2","2","2",4.8,0,22,0,34,21.8,-1,0,1,0,-1,-1,0,0
"965",2018-01-31,"Gothic Rd","w1718","Non.motorized",7,"Wed","weekday","no_sled","East River","2","2","2",4.8,0,22,0,34,21.8,0,-1,0,1,0,-1,-1,0
"966",2018-01-31,"Gothic Rd","w1718","Mechanized",0,"Wed","weekday","no_sled","East River","2","2","2",4.8,0,22,0,34,21.8,0,-1,0,1,0,-1,-1,0
"967",2018-01-31,"Gothic Rd","w1718","Motorized",1,"Wed","weekday","sled","East River","2","2","2",4.8,0,22,0,34,21.8,0,-1,0,1,0,-1,-1,0
"968",2018-01-31,"Gothic Rd","w1718","Hybrid",0,"Wed","weekday","sled","East River","2","2","2",4.8,0,22,0,34,21.8,0,-1,0,1,0,-1,-1,0
"969",2018-02-01,"Gothic Rd","w1718","Non.motorized",25,"Thu","weekday","no_sled","East River","2","2","2",4.9,0.1,21,-1,32,23.3,0,0,-1,0,-1,-1,-2,-2
"970",2018-02-01,"Gothic Rd","w1718","Mechanized",2,"Thu","weekday","no_sled","East River","2","2","2",4.9,0.1,21,-1,32,23.3,0,0,-1,0,-1,-1,-2,-2
"971",2018-02-01,"Gothic Rd","w1718","Motorized",0,"Thu","weekday","sled","East River","2","2","2",4.9,0.1,21,-1,32,23.3,0,0,-1,0,-1,-1,-2,-2
"972",2018-02-01,"Gothic Rd","w1718","Hybrid",0,"Thu","weekday","sled","East River","2","2","2",4.9,0.1,21,-1,32,23.3,0,0,-1,0,-1,-1,-2,-2
"973",2018-02-02,"Gothic Rd","w1718","Non.motorized",55,"Fri","weekday","no_sled","East River","2","2","2",4.9,0,20,-1,33,24.5,-1,0,0,-1,-2,-2,-2,-3
"974",2018-02-02,"Gothic Rd","w1718","Mechanized",7,"Fri","weekday","no_sled","East River","2","2","2",4.9,0,20,-1,33,24.5,-1,0,0,-1,-2,-2,-2,-3
"975",2018-02-02,"Gothic Rd","w1718","Motorized",0,"Fri","weekday","sled","East River","2","2","2",4.9,0,20,-1,33,24.5,-1,0,0,-1,-2,-2,-2,-3
"976",2018-02-02,"Gothic Rd","w1718","Hybrid",0,"Fri","weekday","sled","East River","2","2","2",4.9,0,20,-1,33,24.5,-1,0,0,-1,-2,-2,-2,-3
"977",2018-02-03,"Gothic Rd","w1718","Non.motorized",106,"Sat","weekend","no_sled","East River","2","2","2",4.9,0,21,1,32,23.3,-1,-1,0,0,0,-1,-1,-1
"978",2018-02-03,"Gothic Rd","w1718","Mechanized",3,"Sat","weekend","no_sled","East River","2","2","2",4.9,0,21,1,32,23.3,-1,-1,0,0,0,-1,-1,-1
"979",2018-02-03,"Gothic Rd","w1718","Motorized",7,"Sat","weekend","sled","East River","2","2","2",4.9,0,21,1,32,23.3,-1,-1,0,0,0,-1,-1,-1
"980",2018-02-03,"Gothic Rd","w1718","Hybrid",0,"Sat","weekend","sled","East River","2","2","2",4.9,0,21,1,32,23.3,-1,-1,0,0,0,-1,-1,-1
"981",2018-02-04,"Gothic Rd","w1718","Non.motorized",89,"Sun","weekend","no_sled","East River","2","2","2",4.9,0,19,-2,32,25.8,1,-1,-1,0,-1,-2,-3,-3
"982",2018-02-04,"Gothic Rd","w1718","Mechanized",7,"Sun","weekend","no_sled","East River","2","2","2",4.9,0,19,-2,32,25.8,1,-1,-1,0,-1,-2,-3,-3
"983",2018-02-04,"Gothic Rd","w1718","Motorized",3,"Sun","weekend","sled","East River","2","2","2",4.9,0,19,-2,32,25.8,1,-1,-1,0,-1,-2,-3,-3
"984",2018-02-04,"Gothic Rd","w1718","Hybrid",2,"Sun","weekend","sled","East River","2","2","2",4.9,0,19,-2,32,25.8,1,-1,-1,0,-1,-2,-3,-3
"985",2018-02-05,"Gothic Rd","w1718","Non.motorized",29,"Mon","weekday","no_sled","East River","2","2","2",5,0.1,18,-1,29,27.8,-2,1,-1,-1,-3,-2,-3,-4
"986",2018-02-05,"Gothic Rd","w1718","Mechanized",1,"Mon","weekday","no_sled","East River","2","2","2",5,0.1,18,-1,29,27.8,-2,1,-1,-1,-3,-2,-3,-4
"987",2018-02-05,"Gothic Rd","w1718","Motorized",0,"Mon","weekday","sled","East River","2","2","2",5,0.1,18,-1,29,27.8,-2,1,-1,-1,-3,-2,-3,-4
"988",2018-02-05,"Gothic Rd","w1718","Hybrid",0,"Mon","weekday","sled","East River","2","2","2",5,0.1,18,-1,29,27.8,-2,1,-1,-1,-3,-2,-3,-4
"989",2018-02-06,"Gothic Rd","w1718","Non.motorized",15,"Tue","weekday","no_sled","East River","2","2","2",5.2,0.2,23,5,22,22.6,-1,-2,1,-1,4,2,3,2
"990",2018-02-06,"Gothic Rd","w1718","Mechanized",0,"Tue","weekday","no_sled","East River","2","2","2",5.2,0.2,23,5,22,22.6,-1,-2,1,-1,4,2,3,2
"991",2018-02-06,"Gothic Rd","w1718","Motorized",0,"Tue","weekday","sled","East River","2","2","2",5.2,0.2,23,5,22,22.6,-1,-2,1,-1,4,2,3,2
"992",2018-02-06,"Gothic Rd","w1718","Hybrid",0,"Tue","weekday","sled","East River","2","2","2",5.2,0.2,23,5,22,22.6,-1,-2,1,-1,4,2,3,2
"993",2018-02-07,"Gothic Rd","w1718","Non.motorized",51,"Wed","weekday","no_sled","East River","2","2","2",5.2,0,23,0,24,22.6,5,-1,-2,1,5,4,2,3
"994",2018-02-07,"Gothic Rd","w1718","Mechanized",8,"Wed","weekday","no_sled","East River","2","2","2",5.2,0,23,0,24,22.6,5,-1,-2,1,5,4,2,3
"995",2018-02-07,"Gothic Rd","w1718","Motorized",1,"Wed","weekday","sled","East River","2","2","2",5.2,0,23,0,24,22.6,5,-1,-2,1,5,4,2,3
"996",2018-02-07,"Gothic Rd","w1718","Hybrid",0,"Wed","weekday","sled","East River","2","2","2",5.2,0,23,0,24,22.6,5,-1,-2,1,5,4,2,3
"997",2018-02-08,"Gothic Rd","w1718","Non.motorized",60,"Thu","weekday","no_sled","East River","2","2","1",5.3,0.1,25,2,28,21.2,0,5,-1,-2,2,7,6,4
"998",2018-02-08,"Gothic Rd","w1718","Mechanized",7,"Thu","weekday","no_sled","East River","2","2","1",5.3,0.1,25,2,28,21.2,0,5,-1,-2,2,7,6,4
"999",2018-02-08,"Gothic Rd","w1718","Motorized",0,"Thu","weekday","sled","East River","2","2","1",5.3,0.1,25,2,28,21.2,0,5,-1,-2,2,7,6,4
"1000",2018-02-08,"Gothic Rd","w1718","Hybrid",0,"Thu","weekday","sled","East River","2","2","1",5.3,0.1,25,2,28,21.2,0,5,-1,-2,2,7,6,4
"1001",2018-02-09,"Gothic Rd","w1718","Non.motorized",72,"Fri","weekday","no_sled","East River","2","2","1",5.3,0,24,-1,33,22.1,2,0,5,-1,1,1,6,5
"1002",2018-02-09,"Gothic Rd","w1718","Mechanized",8,"Fri","weekday","no_sled","East River","2","2","1",5.3,0,24,-1,33,22.1,2,0,5,-1,1,1,6,5
"1003",2018-02-09,"Gothic Rd","w1718","Motorized",0,"Fri","weekday","sled","East River","2","2","1",5.3,0,24,-1,33,22.1,2,0,5,-1,1,1,6,5
"1004",2018-02-09,"Gothic Rd","w1718","Hybrid",0,"Fri","weekday","sled","East River","2","2","1",5.3,0,24,-1,33,22.1,2,0,5,-1,1,1,6,5
"1005",2018-02-10,"Gothic Rd","w1718","Non.motorized",42,"Sat","weekend","no_sled","East River","3","3","2",5.3,0,24,0,24,22.1,-1,2,0,5,-1,1,1,6
"1006",2018-02-10,"Gothic Rd","w1718","Mechanized",7,"Sat","weekend","no_sled","East River","3","3","2",5.3,0,24,0,24,22.1,-1,2,0,5,-1,1,1,6
"1007",2018-02-10,"Gothic Rd","w1718","Motorized",0,"Sat","weekend","sled","East River","3","3","2",5.3,0,24,0,24,22.1,-1,2,0,5,-1,1,1,6
"1008",2018-02-10,"Gothic Rd","w1718","Hybrid",0,"Sat","weekend","sled","East River","3","3","2",5.3,0,24,0,24,22.1,-1,2,0,5,-1,1,1,6
"1009",2018-02-11,"Gothic Rd","w1718","Non.motorized",39,"Sun","weekend","no_sled","East River","3","3","2",5.6,0.3,27,3,13,20.7,0,-1,2,0,3,2,4,4
"1010",2018-02-11,"Gothic Rd","w1718","Mechanized",1,"Sun","weekend","no_sled","East River","3","3","2",5.6,0.3,27,3,13,20.7,0,-1,2,0,3,2,4,4
"1011",2018-02-11,"Gothic Rd","w1718","Motorized",0,"Sun","weekend","sled","East River","3","3","2",5.6,0.3,27,3,13,20.7,0,-1,2,0,3,2,4,4
"1012",2018-02-11,"Gothic Rd","w1718","Hybrid",0,"Sun","weekend","sled","East River","3","3","2",5.6,0.3,27,3,13,20.7,0,-1,2,0,3,2,4,4
"1013",2018-02-12,"Gothic Rd","w1718","Non.motorized",25,"Mon","weekday","no_sled","East River","3","3","3",5.7,0.1,27,0,23,21.1,3,0,-1,2,3,3,2,4
"1014",2018-02-12,"Gothic Rd","w1718","Mechanized",0,"Mon","weekday","no_sled","East River","3","3","3",5.7,0.1,27,0,23,21.1,3,0,-1,2,3,3,2,4
"1015",2018-02-12,"Gothic Rd","w1718","Motorized",0,"Mon","weekday","sled","East River","3","3","3",5.7,0.1,27,0,23,21.1,3,0,-1,2,3,3,2,4
"1016",2018-02-12,"Gothic Rd","w1718","Hybrid",0,"Mon","weekday","sled","East River","3","3","3",5.7,0.1,27,0,23,21.1,3,0,-1,2,3,3,2,4
"1017",2018-02-13,"Gothic Rd","w1718","Non.motorized",20,"Tue","weekday","no_sled","East River","3","3","3",6.1,0.4,29,2,28,21,0,3,0,-1,2,5,5,4
"1018",2018-02-13,"Gothic Rd","w1718","Mechanized",2,"Tue","weekday","no_sled","East River","3","3","3",6.1,0.4,29,2,28,21,0,3,0,-1,2,5,5,4
"1019",2018-02-13,"Gothic Rd","w1718","Motorized",0,"Tue","weekday","sled","East River","3","3","3",6.1,0.4,29,2,28,21,0,3,0,-1,2,5,5,4
"1020",2018-02-13,"Gothic Rd","w1718","Hybrid",0,"Tue","weekday","sled","East River","3","3","3",6.1,0.4,29,2,28,21,0,3,0,-1,2,5,5,4
"1021",2018-02-14,"Gothic Rd","w1718","Non.motorized",32,"Wed","weekday","no_sled","East River","3","3","3",6.2,0.1,30,1,30,20.7,2,0,3,0,3,3,6,6
"1022",2018-02-14,"Gothic Rd","w1718","Mechanized",4,"Wed","weekday","no_sled","East River","3","3","3",6.2,0.1,30,1,30,20.7,2,0,3,0,3,3,6,6
"1023",2018-02-14,"Gothic Rd","w1718","Motorized",0,"Wed","weekday","sled","East River","3","3","3",6.2,0.1,30,1,30,20.7,2,0,3,0,3,3,6,6
"1024",2018-02-14,"Gothic Rd","w1718","Hybrid",0,"Wed","weekday","sled","East River","3","3","3",6.2,0.1,30,1,30,20.7,2,0,3,0,3,3,6,6
"1025",2018-02-15,"Gothic Rd","w1718","Non.motorized",10,"Thu","weekday","no_sled","East River","3","3","3",6.3,0.1,28,-2,24,22.5,1,2,0,3,-1,1,1,4
"1026",2018-02-15,"Gothic Rd","w1718","Mechanized",0,"Thu","weekday","no_sled","East River","3","3","3",6.3,0.1,28,-2,24,22.5,1,2,0,3,-1,1,1,4
"1027",2018-02-15,"Gothic Rd","w1718","Motorized",0,"Thu","weekday","sled","East River","3","3","3",6.3,0.1,28,-2,24,22.5,1,2,0,3,-1,1,1,4
"1028",2018-02-15,"Gothic Rd","w1718","Hybrid",0,"Thu","weekday","sled","East River","3","3","3",6.3,0.1,28,-2,24,22.5,1,2,0,3,-1,1,1,4
"1029",2018-02-16,"Gothic Rd","w1718","Non.motorized",23,"Fri","weekday","no_sled","East River","3","3","3",6.7,0.4,32,4,18,20.9,-2,1,2,0,2,3,5,5
"1030",2018-02-16,"Gothic Rd","w1718","Mechanized",0,"Fri","weekday","no_sled","East River","3","3","3",6.7,0.4,32,4,18,20.9,-2,1,2,0,2,3,5,5
"1031",2018-02-16,"Gothic Rd","w1718","Motorized",1,"Fri","weekday","sled","East River","3","3","3",6.7,0.4,32,4,18,20.9,-2,1,2,0,2,3,5,5
"1032",2018-02-16,"Gothic Rd","w1718","Hybrid",0,"Fri","weekday","sled","East River","3","3","3",6.7,0.4,32,4,18,20.9,-2,1,2,0,2,3,5,5
"1033",2018-02-17,"Gothic Rd","w1718","Non.motorized",107,"Sat","weekend","no_sled","East River","3","3","2",6.7,0,32,0,25,20.9,4,-2,1,2,4,2,3,5
"1034",2018-02-17,"Gothic Rd","w1718","Mechanized",8,"Sat","weekend","no_sled","East River","3","3","2",6.7,0,32,0,25,20.9,4,-2,1,2,4,2,3,5
"1035",2018-02-17,"Gothic Rd","w1718","Motorized",1,"Sat","weekend","sled","East River","3","3","2",6.7,0,32,0,25,20.9,4,-2,1,2,4,2,3,5
"1036",2018-02-17,"Gothic Rd","w1718","Hybrid",0,"Sat","weekend","sled","East River","3","3","2",6.7,0,32,0,25,20.9,4,-2,1,2,4,2,3,5
"1037",2018-02-18,"Gothic Rd","w1718","Non.motorized",122,"Sun","weekend","no_sled","East River","2","2","2",6.7,0,31,-1,32,21.6,0,4,-2,1,-1,3,1,2
"1038",2018-02-18,"Gothic Rd","w1718","Mechanized",9,"Sun","weekend","no_sled","East River","2","2","2",6.7,0,31,-1,32,21.6,0,4,-2,1,-1,3,1,2
"1039",2018-02-18,"Gothic Rd","w1718","Motorized",4,"Sun","weekend","sled","East River","2","2","2",6.7,0,31,-1,32,21.6,0,4,-2,1,-1,3,1,2
"1040",2018-02-18,"Gothic Rd","w1718","Hybrid",0,"Sun","weekend","sled","East River","2","2","2",6.7,0,31,-1,32,21.6,0,4,-2,1,-1,3,1,2
"1041",2018-02-19,"Gothic Rd","w1718","Non.motorized",36,"Mon","weekday","no_sled","East River","2","2","2",6.8,0.1,29,-2,24,23.4,-1,0,4,-2,-3,-3,1,-1
"1042",2018-02-19,"Gothic Rd","w1718","Non.motorized",36,"Mon","weekday","no_sled","East River","3","3","3",6.8,0.1,29,-2,24,23.4,-1,0,4,-2,-3,-3,1,-1
"1043",2018-02-19,"Gothic Rd","w1718","Mechanized",0,"Mon","weekday","no_sled","East River","2","2","2",6.8,0.1,29,-2,24,23.4,-1,0,4,-2,-3,-3,1,-1
"1044",2018-02-19,"Gothic Rd","w1718","Mechanized",0,"Mon","weekday","no_sled","East River","3","3","3",6.8,0.1,29,-2,24,23.4,-1,0,4,-2,-3,-3,1,-1
"1045",2018-02-19,"Gothic Rd","w1718","Motorized",0,"Mon","weekday","sled","East River","2","2","2",6.8,0.1,29,-2,24,23.4,-1,0,4,-2,-3,-3,1,-1
"1046",2018-02-19,"Gothic Rd","w1718","Motorized",0,"Mon","weekday","sled","East River","3","3","3",6.8,0.1,29,-2,24,23.4,-1,0,4,-2,-3,-3,1,-1
"1047",2018-02-19,"Gothic Rd","w1718","Hybrid",0,"Mon","weekday","sled","East River","2","2","2",6.8,0.1,29,-2,24,23.4,-1,0,4,-2,-3,-3,1,-1
"1048",2018-02-19,"Gothic Rd","w1718","Hybrid",0,"Mon","weekday","sled","East River","3","3","3",6.8,0.1,29,-2,24,23.4,-1,0,4,-2,-3,-3,1,-1
"1049",2018-02-20,"Gothic Rd","w1718","Non.motorized",21,"Tue","weekday","no_sled","East River","3","3","3",6.8,0,31,2,8,21.9,-2,-1,0,4,0,-1,-1,3
"1050",2018-02-20,"Gothic Rd","w1718","Mechanized",0,"Tue","weekday","no_sled","East River","3","3","3",6.8,0,31,2,8,21.9,-2,-1,0,4,0,-1,-1,3
"1051",2018-02-20,"Gothic Rd","w1718","Motorized",1,"Tue","weekday","sled","East River","3","3","3",6.8,0,31,2,8,21.9,-2,-1,0,4,0,-1,-1,3
"1052",2018-02-20,"Gothic Rd","w1718","Hybrid",0,"Tue","weekday","sled","East River","3","3","3",6.8,0,31,2,8,21.9,-2,-1,0,4,0,-1,-1,3
"1053",2018-02-21,"Gothic Rd","w1718","Non.motorized",27,"Wed","weekday","no_sled","East River","3","3","3",6.8,0,31,0,11,21.9,2,-2,-1,0,2,0,-1,-1
"1054",2018-02-21,"Gothic Rd","w1718","Mechanized",1,"Wed","weekday","no_sled","East River","3","3","3",6.8,0,31,0,11,21.9,2,-2,-1,0,2,0,-1,-1
"1055",2018-02-21,"Gothic Rd","w1718","Motorized",0,"Wed","weekday","sled","East River","3","3","3",6.8,0,31,0,11,21.9,2,-2,-1,0,2,0,-1,-1
"1056",2018-02-21,"Gothic Rd","w1718","Hybrid",0,"Wed","weekday","sled","East River","3","3","3",6.8,0,31,0,11,21.9,2,-2,-1,0,2,0,-1,-1
"1057",2018-02-22,"Gothic Rd","w1718","Non.motorized",17,"Thu","weekday","no_sled","East River","3","3","2",6.8,0,30,-1,16,22.7,0,2,-2,-1,-1,1,-1,-2
"1058",2018-02-22,"Gothic Rd","w1718","Mechanized",0,"Thu","weekday","no_sled","East River","3","3","2",6.8,0,30,-1,16,22.7,0,2,-2,-1,-1,1,-1,-2
"1059",2018-02-22,"Gothic Rd","w1718","Motorized",0,"Thu","weekday","sled","East River","3","3","2",6.8,0,30,-1,16,22.7,0,2,-2,-1,-1,1,-1,-2
"1060",2018-02-22,"Gothic Rd","w1718","Hybrid",0,"Thu","weekday","sled","East River","3","3","2",6.8,0,30,-1,16,22.7,0,2,-2,-1,-1,1,-1,-2
"1061",2018-02-23,"Gothic Rd","w1718","Non.motorized",25,"Fri","weekday","no_sled","East River","3","3","2",6.9,0.1,30,0,15,23,-1,0,2,-2,-1,-1,1,-1
"1062",2018-02-23,"Gothic Rd","w1718","Mechanized",1,"Fri","weekday","no_sled","East River","3","3","2",6.9,0.1,30,0,15,23,-1,0,2,-2,-1,-1,1,-1
"1063",2018-02-23,"Gothic Rd","w1718","Motorized",0,"Fri","weekday","sled","East River","3","3","2",6.9,0.1,30,0,15,23,-1,0,2,-2,-1,-1,1,-1
"1064",2018-02-23,"Gothic Rd","w1718","Hybrid",0,"Fri","weekday","sled","East River","3","3","2",6.9,0.1,30,0,15,23,-1,0,2,-2,-1,-1,1,-1
"1065",2018-02-24,"Gothic Rd","w1718","Non.motorized",46,"Sat","weekend","no_sled","East River","3","3","2",6.9,0,31,1,10,22.3,0,-1,0,2,1,0,0,2
"1066",2018-02-24,"Gothic Rd","w1718","Mechanized",3,"Sat","weekend","no_sled","East River","3","3","2",6.9,0,31,1,10,22.3,0,-1,0,2,1,0,0,2
"1067",2018-02-24,"Gothic Rd","w1718","Motorized",0,"Sat","weekend","sled","East River","3","3","2",6.9,0,31,1,10,22.3,0,-1,0,2,1,0,0,2
"1068",2018-02-24,"Gothic Rd","w1718","Hybrid",0,"Sat","weekend","sled","East River","3","3","2",6.9,0,31,1,10,22.3,0,-1,0,2,1,0,0,2
"1069",2018-02-25,"Gothic Rd","w1718","Non.motorized",30,"Sun","weekend","no_sled","East River","3","3","2",7.1,0.2,32,1,11,22.2,1,0,-1,0,2,2,1,1
"1070",2018-02-25,"Gothic Rd","w1718","Mechanized",9,"Sun","weekend","no_sled","East River","3","3","2",7.1,0.2,32,1,11,22.2,1,0,-1,0,2,2,1,1
"1071",2018-02-25,"Gothic Rd","w1718","Motorized",0,"Sun","weekend","sled","East River","3","3","2",7.1,0.2,32,1,11,22.2,1,0,-1,0,2,2,1,1
"1072",2018-02-25,"Gothic Rd","w1718","Hybrid",0,"Sun","weekend","sled","East River","3","3","2",7.1,0.2,32,1,11,22.2,1,0,-1,0,2,2,1,1
"1073",2018-02-26,"Gothic Rd","w1718","Non.motorized",25,"Mon","weekday","no_sled","East River","2","2","2",7.1,0,32,0,20,22.2,1,1,0,-1,1,2,2,1
"1074",2018-02-26,"Gothic Rd","w1718","Mechanized",5,"Mon","weekday","no_sled","East River","2","2","2",7.1,0,32,0,20,22.2,1,1,0,-1,1,2,2,1
"1075",2018-02-26,"Gothic Rd","w1718","Motorized",0,"Mon","weekday","sled","East River","2","2","2",7.1,0,32,0,20,22.2,1,1,0,-1,1,2,2,1
"1076",2018-02-26,"Gothic Rd","w1718","Hybrid",0,"Mon","weekday","sled","East River","2","2","2",7.1,0,32,0,20,22.2,1,1,0,-1,1,2,2,1
"1077",2018-02-27,"Gothic Rd","w1718","Non.motorized",38,"Tue","weekday","no_sled","East River","2","2","2",7.2,0.1,32,0,26,22.5,0,1,1,0,0,1,2,2
"1078",2018-02-27,"Gothic Rd","w1718","Mechanized",2,"Tue","weekday","no_sled","East River","2","2","2",7.2,0.1,32,0,26,22.5,0,1,1,0,0,1,2,2
"1079",2018-02-27,"Gothic Rd","w1718","Motorized",1,"Tue","weekday","sled","East River","2","2","2",7.2,0.1,32,0,26,22.5,0,1,1,0,0,1,2,2
"1080",2018-02-27,"Gothic Rd","w1718","Hybrid",0,"Tue","weekday","sled","East River","2","2","2",7.2,0.1,32,0,26,22.5,0,1,1,0,0,1,2,2
"1081",2018-02-28,"Gothic Rd","w1718","Non.motorized",33,"Wed","weekday","no_sled","East River","2","2","2",7.2,0,31,-1,23,23.2,0,0,1,1,-1,-1,0,1
"1082",2018-02-28,"Gothic Rd","w1718","Mechanized",2,"Wed","weekday","no_sled","East River","2","2","2",7.2,0,31,-1,23,23.2,0,0,1,1,-1,-1,0,1
"1083",2018-02-28,"Gothic Rd","w1718","Motorized",0,"Wed","weekday","sled","East River","2","2","2",7.2,0,31,-1,23,23.2,0,0,1,1,-1,-1,0,1
"1084",2018-02-28,"Gothic Rd","w1718","Hybrid",0,"Wed","weekday","sled","East River","2","2","2",7.2,0,31,-1,23,23.2,0,0,1,1,-1,-1,0,1
"1085",2018-03-01,"Gothic Rd","w1718","Non.motorized",28,"Thu","weekday","no_sled","East River","2","2","2",7.2,0,31,0,24,23.2,-1,0,0,1,-1,-1,-1,0
"1086",2018-03-01,"Gothic Rd","w1718","Mechanized",1,"Thu","weekday","no_sled","East River","2","2","2",7.2,0,31,0,24,23.2,-1,0,0,1,-1,-1,-1,0
"1087",2018-03-01,"Gothic Rd","w1718","Motorized",1,"Thu","weekday","sled","East River","2","2","2",7.2,0,31,0,24,23.2,-1,0,0,1,-1,-1,-1,0
"1088",2018-03-01,"Gothic Rd","w1718","Hybrid",0,"Thu","weekday","sled","East River","2","2","2",7.2,0,31,0,24,23.2,-1,0,0,1,-1,-1,-1,0
"1089",2018-03-02,"Gothic Rd","w1718","Non.motorized",62,"Fri","weekday","no_sled","East River","2","2","1",7.2,0,31,0,30,23.2,0,-1,0,0,0,-1,-1,-1
"1090",2018-03-02,"Gothic Rd","w1718","Mechanized",4,"Fri","weekday","no_sled","East River","2","2","1",7.2,0,31,0,30,23.2,0,-1,0,0,0,-1,-1,-1
"1091",2018-03-02,"Gothic Rd","w1718","Motorized",2,"Fri","weekday","sled","East River","2","2","1",7.2,0,31,0,30,23.2,0,-1,0,0,0,-1,-1,-1
"1092",2018-03-02,"Gothic Rd","w1718","Hybrid",0,"Fri","weekday","sled","East River","2","2","1",7.2,0,31,0,30,23.2,0,-1,0,0,0,-1,-1,-1
"1093",2018-03-03,"Gothic Rd","w1718","Non.motorized",68,"Sat","weekend","no_sled","East River","2","2","1",7.3,0.1,30,-1,34,24.3,0,0,-1,0,-1,-1,-2,-2
"1094",2018-03-03,"Gothic Rd","w1718","Mechanized",5,"Sat","weekend","no_sled","East River","2","2","1",7.3,0.1,30,-1,34,24.3,0,0,-1,0,-1,-1,-2,-2
"1095",2018-03-03,"Gothic Rd","w1718","Motorized",1,"Sat","weekend","sled","East River","2","2","1",7.3,0.1,30,-1,34,24.3,0,0,-1,0,-1,-1,-2,-2
"1096",2018-03-03,"Gothic Rd","w1718","Hybrid",0,"Sat","weekend","sled","East River","2","2","1",7.3,0.1,30,-1,34,24.3,0,0,-1,0,-1,-1,-2,-2
"1097",2018-03-04,"Gothic Rd","w1718","Non.motorized",NA,"Sun","weekend","no_sled","East River","2","2","1",7.3,0,29,-1,24,25.2,-1,0,0,-1,-2,-2,-2,-3
"1098",2018-03-04,"Gothic Rd","w1718","Mechanized",NA,"Sun","weekend","no_sled","East River","2","2","1",7.3,0,29,-1,24,25.2,-1,0,0,-1,-2,-2,-2,-3
"1099",2018-03-04,"Gothic Rd","w1718","Motorized",NA,"Sun","weekend","sled","East River","2","2","1",7.3,0,29,-1,24,25.2,-1,0,0,-1,-2,-2,-2,-3
"1100",2018-03-04,"Gothic Rd","w1718","Hybrid",NA,"Sun","weekend","sled","East River","2","2","1",7.3,0,29,-1,24,25.2,-1,0,0,-1,-2,-2,-2,-3
"1101",2018-03-05,"Gothic Rd","w1718","Non.motorized",NA,"Mon","weekday","no_sled","East River","2","2","1",7.3,0,31,2,13,23.5,-1,-1,0,0,1,0,0,0
"1102",2018-03-05,"Gothic Rd","w1718","Mechanized",NA,"Mon","weekday","no_sled","East River","2","2","1",7.3,0,31,2,13,23.5,-1,-1,0,0,1,0,0,0
"1103",2018-03-05,"Gothic Rd","w1718","Motorized",NA,"Mon","weekday","sled","East River","2","2","1",7.3,0,31,2,13,23.5,-1,-1,0,0,1,0,0,0
"1104",2018-03-05,"Gothic Rd","w1718","Hybrid",NA,"Mon","weekday","sled","East River","2","2","1",7.3,0,31,2,13,23.5,-1,-1,0,0,1,0,0,0
"1105",2018-03-06,"Gothic Rd","w1718","Non.motorized",NA,"Tue","weekday","no_sled","East River","2","2","1",7.3,0,31,0,19,23.5,2,-1,-1,0,2,1,0,0
"1106",2018-03-06,"Gothic Rd","w1718","Mechanized",NA,"Tue","weekday","no_sled","East River","2","2","1",7.3,0,31,0,19,23.5,2,-1,-1,0,2,1,0,0
"1107",2018-03-06,"Gothic Rd","w1718","Motorized",NA,"Tue","weekday","sled","East River","2","2","1",7.3,0,31,0,19,23.5,2,-1,-1,0,2,1,0,0
"1108",2018-03-06,"Gothic Rd","w1718","Hybrid",NA,"Tue","weekday","sled","East River","2","2","1",7.3,0,31,0,19,23.5,2,-1,-1,0,2,1,0,0
"1109",2018-03-07,"Gothic Rd","w1718","Non.motorized",NA,"Wed","weekday","no_sled","East River","2","2","1",7.4,0.1,31,0,27,23.9,0,2,-1,-1,0,2,1,0
"1110",2018-03-07,"Gothic Rd","w1718","Mechanized",NA,"Wed","weekday","no_sled","East River","2","2","1",7.4,0.1,31,0,27,23.9,0,2,-1,-1,0,2,1,0
"1111",2018-03-07,"Gothic Rd","w1718","Motorized",NA,"Wed","weekday","sled","East River","2","2","1",7.4,0.1,31,0,27,23.9,0,2,-1,-1,0,2,1,0
"1112",2018-03-07,"Gothic Rd","w1718","Hybrid",NA,"Wed","weekday","sled","East River","2","2","1",7.4,0.1,31,0,27,23.9,0,2,-1,-1,0,2,1,0
"1113",2018-03-08,"Gothic Rd","w1718","Non.motorized",NA,"Thu","weekday","no_sled","East River","2","2","1",7.4,0,30,-1,33,24.7,0,0,2,-1,-1,-1,1,0
"1114",2018-03-08,"Gothic Rd","w1718","Mechanized",NA,"Thu","weekday","no_sled","East River","2","2","1",7.4,0,30,-1,33,24.7,0,0,2,-1,-1,-1,1,0
"1115",2018-03-08,"Gothic Rd","w1718","Motorized",NA,"Thu","weekday","sled","East River","2","2","1",7.4,0,30,-1,33,24.7,0,0,2,-1,-1,-1,1,0
"1116",2018-03-08,"Gothic Rd","w1718","Hybrid",NA,"Thu","weekday","sled","East River","2","2","1",7.4,0,30,-1,33,24.7,0,0,2,-1,-1,-1,1,0
"1117",2018-03-09,"Gothic Rd","w1718","Non.motorized",10,"Fri","weekday","no_sled","East River","2","2","1",7.4,0,30,0,34,24.7,-1,0,0,2,-1,-1,-1,1
"1118",2018-03-09,"Gothic Rd","w1718","Mechanized",0,"Fri","weekday","no_sled","East River","2","2","1",7.4,0,30,0,34,24.7,-1,0,0,2,-1,-1,-1,1
"1119",2018-03-09,"Gothic Rd","w1718","Motorized",0,"Fri","weekday","sled","East River","2","2","1",7.4,0,30,0,34,24.7,-1,0,0,2,-1,-1,-1,1
"1120",2018-03-09,"Gothic Rd","w1718","Hybrid",0,"Fri","weekday","sled","East River","2","2","1",7.4,0,30,0,34,24.7,-1,0,0,2,-1,-1,-1,1
"1121",2018-03-10,"Gothic Rd","w1718","Non.motorized",80,"Sat","weekend","no_sled","East River","1","1","1",7.4,0,30,0,31,24.7,0,-1,0,0,0,-1,-1,-1
"1122",2018-03-10,"Gothic Rd","w1718","Mechanized",4,"Sat","weekend","no_sled","East River","1","1","1",7.4,0,30,0,31,24.7,0,-1,0,0,0,-1,-1,-1
"1123",2018-03-10,"Gothic Rd","w1718","Motorized",3,"Sat","weekend","sled","East River","1","1","1",7.4,0,30,0,31,24.7,0,-1,0,0,0,-1,-1,-1
"1124",2018-03-10,"Gothic Rd","w1718","Hybrid",0,"Sat","weekend","sled","East River","1","1","1",7.4,0,30,0,31,24.7,0,-1,0,0,0,-1,-1,-1
"1125",2018-03-11,"Gothic Rd","w1718","Non.motorized",77,"Sun","weekend","no_sled","East River","1","1","1",7.4,0,29,-1,31,25.5,0,0,-1,0,-1,-1,-2,-2
"1126",2018-03-11,"Gothic Rd","w1718","Mechanized",7,"Sun","weekend","no_sled","East River","1","1","1",7.4,0,29,-1,31,25.5,0,0,-1,0,-1,-1,-2,-2
"1127",2018-03-11,"Gothic Rd","w1718","Motorized",1,"Sun","weekend","sled","East River","1","1","1",7.4,0,29,-1,31,25.5,0,0,-1,0,-1,-1,-2,-2
"1128",2018-03-11,"Gothic Rd","w1718","Hybrid",0,"Sun","weekend","sled","East River","1","1","1",7.4,0,29,-1,31,25.5,0,0,-1,0,-1,-1,-2,-2
"1129",2018-03-12,"Gothic Rd","w1718","Non.motorized",28,"Mon","weekday","no_sled","East River","1","1","1",7.4,0,29,0,33,25.5,-1,0,0,-1,-1,-1,-1,-2
"1130",2018-03-12,"Gothic Rd","w1718","Mechanized",3,"Mon","weekday","no_sled","East River","1","1","1",7.4,0,29,0,33,25.5,-1,0,0,-1,-1,-1,-1,-2
"1131",2018-03-12,"Gothic Rd","w1718","Motorized",2,"Mon","weekday","sled","East River","1","1","1",7.4,0,29,0,33,25.5,-1,0,0,-1,-1,-1,-1,-2
"1132",2018-03-12,"Gothic Rd","w1718","Hybrid",2,"Mon","weekday","sled","East River","1","1","1",7.4,0,29,0,33,25.5,-1,0,0,-1,-1,-1,-1,-2
"1133",2018-03-13,"Gothic Rd","w1718","Non.motorized",50,"Tue","weekday","no_sled","East River","1","1","1",7.4,0,29,0,34,25.5,0,-1,0,0,0,-1,-1,-1
"1134",2018-03-13,"Gothic Rd","w1718","Mechanized",6,"Tue","weekday","no_sled","East River","1","1","1",7.4,0,29,0,34,25.5,0,-1,0,0,0,-1,-1,-1
"1135",2018-03-13,"Gothic Rd","w1718","Motorized",1,"Tue","weekday","sled","East River","1","1","1",7.4,0,29,0,34,25.5,0,-1,0,0,0,-1,-1,-1
"1136",2018-03-13,"Gothic Rd","w1718","Hybrid",0,"Tue","weekday","sled","East River","1","1","1",7.4,0,29,0,34,25.5,0,-1,0,0,0,-1,-1,-1
"1137",2018-03-14,"Gothic Rd","w1718","Non.motorized",31,"Wed","weekday","no_sled","East River","1","2","2",7.4,0,29,0,39,25.5,0,0,-1,0,0,0,-1,-1
"1138",2018-03-14,"Gothic Rd","w1718","Mechanized",3,"Wed","weekday","no_sled","East River","1","2","2",7.4,0,29,0,39,25.5,0,0,-1,0,0,0,-1,-1
"1139",2018-03-14,"Gothic Rd","w1718","Motorized",0,"Wed","weekday","sled","East River","1","2","2",7.4,0,29,0,39,25.5,0,0,-1,0,0,0,-1,-1
"1140",2018-03-14,"Gothic Rd","w1718","Hybrid",0,"Wed","weekday","sled","East River","1","2","2",7.4,0,29,0,39,25.5,0,0,-1,0,0,0,-1,-1
"1141",2018-03-15,"Gothic Rd","w1718","Non.motorized",14,"Thu","weekday","no_sled","East River","2","2","2",7.5,0.1,28,-1,31,26.8,0,0,0,-1,-1,-1,-1,-2
"1142",2018-03-15,"Gothic Rd","w1718","Mechanized",2,"Thu","weekday","no_sled","East River","2","2","2",7.5,0.1,28,-1,31,26.8,0,0,0,-1,-1,-1,-1,-2
"1143",2018-03-15,"Gothic Rd","w1718","Motorized",0,"Thu","weekday","sled","East River","2","2","2",7.5,0.1,28,-1,31,26.8,0,0,0,-1,-1,-1,-1,-2
"1144",2018-03-15,"Gothic Rd","w1718","Hybrid",0,"Thu","weekday","sled","East River","2","2","2",7.5,0.1,28,-1,31,26.8,0,0,0,-1,-1,-1,-1,-2
"1145",2018-03-16,"Gothic Rd","w1718","Non.motorized",37,"Fri","weekday","no_sled","East River","2","2","2",7.7,0.2,29,1,25,26.6,-1,0,0,0,0,0,0,0
"1146",2018-03-16,"Gothic Rd","w1718","Mechanized",3,"Fri","weekday","no_sled","East River","2","2","2",7.7,0.2,29,1,25,26.6,-1,0,0,0,0,0,0,0
"1147",2018-03-16,"Gothic Rd","w1718","Motorized",0,"Fri","weekday","sled","East River","2","2","2",7.7,0.2,29,1,25,26.6,-1,0,0,0,0,0,0,0
"1148",2018-03-16,"Gothic Rd","w1718","Hybrid",0,"Fri","weekday","sled","East River","2","2","2",7.7,0.2,29,1,25,26.6,-1,0,0,0,0,0,0,0
"1149",2018-03-17,"Gothic Rd","w1718","Non.motorized",54,"Sat","weekend","no_sled","East River","2","2","2",7.8,0.1,32,3,29,24.4,1,-1,0,0,4,3,3,3
"1150",2018-03-17,"Gothic Rd","w1718","Mechanized",5,"Sat","weekend","no_sled","East River","2","2","2",7.8,0.1,32,3,29,24.4,1,-1,0,0,4,3,3,3
"1151",2018-03-17,"Gothic Rd","w1718","Motorized",0,"Sat","weekend","sled","East River","2","2","2",7.8,0.1,32,3,29,24.4,1,-1,0,0,4,3,3,3
"1152",2018-03-17,"Gothic Rd","w1718","Hybrid",0,"Sat","weekend","sled","East River","2","2","2",7.8,0.1,32,3,29,24.4,1,-1,0,0,4,3,3,3
"1153",2018-03-18,"Gothic Rd","w1718","Non.motorized",27,"Sun","weekend","no_sled","East River","2","2","2",7.9,0.1,31,-1,24,25.5,3,1,-1,0,2,3,2,2
"1154",2018-03-18,"Gothic Rd","w1718","Mechanized",4,"Sun","weekend","no_sled","East River","2","2","2",7.9,0.1,31,-1,24,25.5,3,1,-1,0,2,3,2,2
"1155",2018-03-18,"Gothic Rd","w1718","Motorized",0,"Sun","weekend","sled","East River","2","2","2",7.9,0.1,31,-1,24,25.5,3,1,-1,0,2,3,2,2
"1156",2018-03-18,"Gothic Rd","w1718","Hybrid",0,"Sun","weekend","sled","East River","2","2","2",7.9,0.1,31,-1,24,25.5,3,1,-1,0,2,3,2,2
"1157",2018-03-19,"Gothic Rd","w1718","Non.motorized",51,"Mon","weekday","no_sled","East River","2","2","1",8,0.1,32,1,19,25,-1,3,1,-1,0,3,4,3
"1158",2018-03-19,"Gothic Rd","w1718","Mechanized",0,"Mon","weekday","no_sled","East River","2","2","1",8,0.1,32,1,19,25,-1,3,1,-1,0,3,4,3
"1159",2018-03-19,"Gothic Rd","w1718","Motorized",1,"Mon","weekday","sled","East River","2","2","1",8,0.1,32,1,19,25,-1,3,1,-1,0,3,4,3
"1160",2018-03-19,"Gothic Rd","w1718","Hybrid",0,"Mon","weekday","sled","East River","2","2","1",8,0.1,32,1,19,25,-1,3,1,-1,0,3,4,3
"1161",2018-03-20,"Gothic Rd","w1718","Non.motorized",19,"Tue","weekday","no_sled","East River","2","2","1",8,0,30,-2,24,26.7,1,-1,3,1,-1,-2,1,2
"1162",2018-03-20,"Gothic Rd","w1718","Mechanized",0,"Tue","weekday","no_sled","East River","2","2","1",8,0,30,-2,24,26.7,1,-1,3,1,-1,-2,1,2
"1163",2018-03-20,"Gothic Rd","w1718","Motorized",0,"Tue","weekday","sled","East River","2","2","1",8,0,30,-2,24,26.7,1,-1,3,1,-1,-2,1,2
"1164",2018-03-20,"Gothic Rd","w1718","Hybrid",0,"Tue","weekday","sled","East River","2","2","1",8,0,30,-2,24,26.7,1,-1,3,1,-1,-2,1,2
"1165",2018-03-21,"Gothic Rd","w1718","Non.motorized",29,"Wed","weekday","no_sled","East River","1","1","1",8.1,0.1,32,2,30,25.3,-2,1,-1,3,0,1,0,3
"1166",2018-03-21,"Gothic Rd","w1718","Mechanized",2,"Wed","weekday","no_sled","East River","1","1","1",8.1,0.1,32,2,30,25.3,-2,1,-1,3,0,1,0,3
"1167",2018-03-21,"Gothic Rd","w1718","Motorized",0,"Wed","weekday","sled","East River","1","1","1",8.1,0.1,32,2,30,25.3,-2,1,-1,3,0,1,0,3
"1168",2018-03-21,"Gothic Rd","w1718","Hybrid",0,"Wed","weekday","sled","East River","1","1","1",8.1,0.1,32,2,30,25.3,-2,1,-1,3,0,1,0,3
"1169",2018-03-22,"Gothic Rd","w1718","Non.motorized",30,"Thu","weekday","no_sled","East River","1","1","1",8.1,0,30,-2,36,27,2,-2,1,-1,0,-2,-1,-2
"1170",2018-03-22,"Gothic Rd","w1718","Mechanized",0,"Thu","weekday","no_sled","East River","1","1","1",8.1,0,30,-2,36,27,2,-2,1,-1,0,-2,-1,-2
"1171",2018-03-22,"Gothic Rd","w1718","Motorized",0,"Thu","weekday","sled","East River","1","1","1",8.1,0,30,-2,36,27,2,-2,1,-1,0,-2,-1,-2
"1172",2018-03-22,"Gothic Rd","w1718","Hybrid",0,"Thu","weekday","sled","East River","1","1","1",8.1,0,30,-2,36,27,2,-2,1,-1,0,-2,-1,-2
"1173",2018-03-23,"Gothic Rd","w1718","Non.motorized",18,"Fri","weekday","no_sled","East River","2","2","3",8.2,0.1,29,-1,34,28.3,-2,2,-2,1,-3,-1,-3,-2
"1174",2018-03-23,"Gothic Rd","w1718","Mechanized",0,"Fri","weekday","no_sled","East River","2","2","3",8.2,0.1,29,-1,34,28.3,-2,2,-2,1,-3,-1,-3,-2
"1175",2018-03-23,"Gothic Rd","w1718","Motorized",0,"Fri","weekday","sled","East River","2","2","3",8.2,0.1,29,-1,34,28.3,-2,2,-2,1,-3,-1,-3,-2
"1176",2018-03-23,"Gothic Rd","w1718","Hybrid",0,"Fri","weekday","sled","East River","2","2","3",8.2,0.1,29,-1,34,28.3,-2,2,-2,1,-3,-1,-3,-2
"1177",2018-03-24,"Gothic Rd","w1718","Non.motorized",25,"Sat","weekend","no_sled","East River","2","2","1",8.9,0.7,34,5,32,26.2,-1,-2,2,-2,4,2,4,2
"1178",2018-03-24,"Gothic Rd","w1718","Mechanized",7,"Sat","weekend","no_sled","East River","2","2","1",8.9,0.7,34,5,32,26.2,-1,-2,2,-2,4,2,4,2
"1179",2018-03-24,"Gothic Rd","w1718","Motorized",1,"Sat","weekend","sled","East River","2","2","1",8.9,0.7,34,5,32,26.2,-1,-2,2,-2,4,2,4,2
"1180",2018-03-24,"Gothic Rd","w1718","Hybrid",0,"Sat","weekend","sled","East River","2","2","1",8.9,0.7,34,5,32,26.2,-1,-2,2,-2,4,2,4,2
"1181",2018-03-25,"Gothic Rd","w1718","Non.motorized",65,"Sun","weekend","no_sled","East River","2","2","1",8.9,0,35,1,35,25.4,5,-1,-2,2,6,5,3,5
"1182",2018-03-25,"Gothic Rd","w1718","Mechanized",3,"Sun","weekend","no_sled","East River","2","2","1",8.9,0,35,1,35,25.4,5,-1,-2,2,6,5,3,5
"1183",2018-03-25,"Gothic Rd","w1718","Motorized",0,"Sun","weekend","sled","East River","2","2","1",8.9,0,35,1,35,25.4,5,-1,-2,2,6,5,3,5
"1184",2018-03-25,"Gothic Rd","w1718","Hybrid",0,"Sun","weekend","sled","East River","2","2","1",8.9,0,35,1,35,25.4,5,-1,-2,2,6,5,3,5
"1185",2018-03-26,"Gothic Rd","w1718","Non.motorized",52,"Mon","weekday","no_sled","East River","1","1","1",8.9,0,34,-1,31,26.2,1,5,-1,-2,0,5,4,2
"1186",2018-03-26,"Gothic Rd","w1718","Non.motorized",52,"Mon","weekday","no_sled","East River","2","1","1",8.9,0,34,-1,31,26.2,1,5,-1,-2,0,5,4,2
"1187",2018-03-26,"Gothic Rd","w1718","Mechanized",4,"Mon","weekday","no_sled","East River","1","1","1",8.9,0,34,-1,31,26.2,1,5,-1,-2,0,5,4,2
"1188",2018-03-26,"Gothic Rd","w1718","Mechanized",4,"Mon","weekday","no_sled","East River","2","1","1",8.9,0,34,-1,31,26.2,1,5,-1,-2,0,5,4,2
"1189",2018-03-26,"Gothic Rd","w1718","Motorized",0,"Mon","weekday","sled","East River","1","1","1",8.9,0,34,-1,31,26.2,1,5,-1,-2,0,5,4,2
"1190",2018-03-26,"Gothic Rd","w1718","Motorized",0,"Mon","weekday","sled","East River","2","1","1",8.9,0,34,-1,31,26.2,1,5,-1,-2,0,5,4,2
"1191",2018-03-26,"Gothic Rd","w1718","Hybrid",0,"Mon","weekday","sled","East River","1","1","1",8.9,0,34,-1,31,26.2,1,5,-1,-2,0,5,4,2
"1192",2018-03-26,"Gothic Rd","w1718","Hybrid",0,"Mon","weekday","sled","East River","2","1","1",8.9,0,34,-1,31,26.2,1,5,-1,-2,0,5,4,2
"1193",2018-03-27,"Gothic Rd","w1718","Non.motorized",34,"Tue","weekday","no_sled","East River","1","1","1",8.9,0,33,-1,29,27,-1,1,5,-1,-2,-1,4,3
"1194",2018-03-27,"Gothic Rd","w1718","Mechanized",3,"Tue","weekday","no_sled","East River","1","1","1",8.9,0,33,-1,29,27,-1,1,5,-1,-2,-1,4,3
"1195",2018-03-27,"Gothic Rd","w1718","Motorized",0,"Tue","weekday","sled","East River","1","1","1",8.9,0,33,-1,29,27,-1,1,5,-1,-2,-1,4,3
"1196",2018-03-27,"Gothic Rd","w1718","Hybrid",0,"Tue","weekday","sled","East River","1","1","1",8.9,0,33,-1,29,27,-1,1,5,-1,-2,-1,4,3
"1197",2018-03-28,"Gothic Rd","w1718","Non.motorized",25,"Wed","weekday","no_sled","East River","1","1","1",8.9,0,33,0,27,27,-1,-1,1,5,-1,-2,-1,4
"1198",2018-03-28,"Gothic Rd","w1718","Mechanized",0,"Wed","weekday","no_sled","East River","1","1","1",8.9,0,33,0,27,27,-1,-1,1,5,-1,-2,-1,4
"1199",2018-03-28,"Gothic Rd","w1718","Motorized",0,"Wed","weekday","sled","East River","1","1","1",8.9,0,33,0,27,27,-1,-1,1,5,-1,-2,-1,4
"1200",2018-03-28,"Gothic Rd","w1718","Hybrid",0,"Wed","weekday","sled","East River","1","1","1",8.9,0,33,0,27,27,-1,-1,1,5,-1,-2,-1,4
"1201",2018-03-29,"Gothic Rd","w1718","Non.motorized",36,"Thu","weekday","no_sled","East River","1","1","1",8.9,0,33,0,27,27,0,-1,-1,1,0,-1,-2,-1
"1202",2018-03-29,"Gothic Rd","w1718","Mechanized",3,"Thu","weekday","no_sled","East River","1","1","1",8.9,0,33,0,27,27,0,-1,-1,1,0,-1,-2,-1
"1203",2018-03-29,"Gothic Rd","w1718","Motorized",0,"Thu","weekday","sled","East River","1","1","1",8.9,0,33,0,27,27,0,-1,-1,1,0,-1,-2,-1
"1204",2018-03-29,"Gothic Rd","w1718","Hybrid",0,"Thu","weekday","sled","East River","1","1","1",8.9,0,33,0,27,27,0,-1,-1,1,0,-1,-2,-1
"1205",2018-03-30,"Gothic Rd","w1718","Non.motorized",61,"Fri","weekday","no_sled","East River","1","1","1",8.9,0,32,-1,33,27.8,0,0,-1,-1,-1,-1,-2,-3
"1206",2018-03-30,"Gothic Rd","w1718","Mechanized",3,"Fri","weekday","no_sled","East River","1","1","1",8.9,0,32,-1,33,27.8,0,0,-1,-1,-1,-1,-2,-3
"1207",2018-03-30,"Gothic Rd","w1718","Motorized",2,"Fri","weekday","sled","East River","1","1","1",8.9,0,32,-1,33,27.8,0,0,-1,-1,-1,-1,-2,-3
"1208",2018-03-30,"Gothic Rd","w1718","Hybrid",0,"Fri","weekday","sled","East River","1","1","1",8.9,0,32,-1,33,27.8,0,0,-1,-1,-1,-1,-2,-3
"1209",2018-03-31,"Gothic Rd","w1718","Non.motorized",58,"Sat","weekend","no_sled","East River","1","1","1",8.9,0,32,0,39,27.8,-1,0,0,-1,-1,-1,-1,-2
"1210",2018-03-31,"Gothic Rd","w1718","Mechanized",1,"Sat","weekend","no_sled","East River","1","1","1",8.9,0,32,0,39,27.8,-1,0,0,-1,-1,-1,-1,-2
"1211",2018-03-31,"Gothic Rd","w1718","Motorized",0,"Sat","weekend","sled","East River","1","1","1",8.9,0,32,0,39,27.8,-1,0,0,-1,-1,-1,-1,-2
"1212",2018-03-31,"Gothic Rd","w1718","Hybrid",0,"Sat","weekend","sled","East River","1","1","1",8.9,0,32,0,39,27.8,-1,0,0,-1,-1,-1,-1,-2
"1213",2018-04-01,"Gothic Rd","w1718","Non.motorized",27,"Sun","weekend","no_sled","East River","1","1","1",8.8,-0.1,30,-2,41,29.3,0,-1,0,0,-2,-3,-3,-3
"1214",2018-04-01,"Gothic Rd","w1718","Mechanized",0,"Sun","weekend","no_sled","East River","1","1","1",8.8,-0.1,30,-2,41,29.3,0,-1,0,0,-2,-3,-3,-3
"1215",2018-04-01,"Gothic Rd","w1718","Motorized",0,"Sun","weekend","sled","East River","1","1","1",8.8,-0.1,30,-2,41,29.3,0,-1,0,0,-2,-3,-3,-3
"1216",2018-04-01,"Gothic Rd","w1718","Hybrid",0,"Sun","weekend","sled","East River","1","1","1",8.8,-0.1,30,-2,41,29.3,0,-1,0,0,-2,-3,-3,-3
"1217",2018-04-02,"Gothic Rd","w1718","Non.motorized",21,"Mon","weekday","no_sled","East River","1","1","1",8.7,-0.1,29,-1,39,30,-2,0,-1,0,-3,-3,-4,-4
"1218",2018-04-02,"Gothic Rd","w1718","Mechanized",0,"Mon","weekday","no_sled","East River","1","1","1",8.7,-0.1,29,-1,39,30,-2,0,-1,0,-3,-3,-4,-4
"1219",2018-04-02,"Gothic Rd","w1718","Motorized",0,"Mon","weekday","sled","East River","1","1","1",8.7,-0.1,29,-1,39,30,-2,0,-1,0,-3,-3,-4,-4
"1220",2018-04-02,"Gothic Rd","w1718","Hybrid",0,"Mon","weekday","sled","East River","1","1","1",8.7,-0.1,29,-1,39,30,-2,0,-1,0,-3,-3,-4,-4
"1221",2018-04-03,"Gothic Rd","w1718","Non.motorized",11,"Tue","weekday","no_sled","East River","1","1","1",8.8,0.1,30,1,27,29.3,-1,-2,0,-1,0,-2,-2,-3
"1222",2018-04-03,"Gothic Rd","w1718","Mechanized",0,"Tue","weekday","no_sled","East River","1","1","1",8.8,0.1,30,1,27,29.3,-1,-2,0,-1,0,-2,-2,-3
"1223",2018-04-03,"Gothic Rd","w1718","Motorized",0,"Tue","weekday","sled","East River","1","1","1",8.8,0.1,30,1,27,29.3,-1,-2,0,-1,0,-2,-2,-3
"1224",2018-04-03,"Gothic Rd","w1718","Hybrid",0,"Tue","weekday","sled","East River","1","1","1",8.8,0.1,30,1,27,29.3,-1,-2,0,-1,0,-2,-2,-3
"1225",2018-04-04,"Gothic Rd","w1718","Non.motorized",16,"Wed","weekday","no_sled","East River","1","2","2",8.9,0.1,28,-2,33,31.8,1,-1,-2,0,-1,-2,-4,-4
"1226",2018-04-04,"Gothic Rd","w1718","Mechanized",0,"Wed","weekday","no_sled","East River","1","2","2",8.9,0.1,28,-2,33,31.8,1,-1,-2,0,-1,-2,-4,-4
"1227",2018-04-04,"Gothic Rd","w1718","Motorized",0,"Wed","weekday","sled","East River","1","2","2",8.9,0.1,28,-2,33,31.8,1,-1,-2,0,-1,-2,-4,-4
"1228",2018-04-04,"Gothic Rd","w1718","Hybrid",0,"Wed","weekday","sled","East River","1","2","2",8.9,0.1,28,-2,33,31.8,1,-1,-2,0,-1,-2,-4,-4
"1229",2018-04-05,"Gothic Rd","w1718","Non.motorized",17,"Thu","weekday","no_sled","East River","1","2","2",8.9,0,27,-1,35,33,-2,1,-1,-2,-3,-2,-3,-5
"1230",2018-04-05,"Gothic Rd","w1718","Mechanized",0,"Thu","weekday","no_sled","East River","1","2","2",8.9,0,27,-1,35,33,-2,1,-1,-2,-3,-2,-3,-5
"1231",2018-04-05,"Gothic Rd","w1718","Motorized",1,"Thu","weekday","sled","East River","1","2","2",8.9,0,27,-1,35,33,-2,1,-1,-2,-3,-2,-3,-5
"1232",2018-04-05,"Gothic Rd","w1718","Hybrid",0,"Thu","weekday","sled","East River","1","2","2",8.9,0,27,-1,35,33,-2,1,-1,-2,-3,-2,-3,-5
"1233",2018-04-06,"Gothic Rd","w1718","Non.motorized",4,"Fri","weekday","no_sled","East River","1","2","2",8.9,0,25,-2,35,35.6,-1,-2,1,-1,-3,-5,-4,-5
"1234",2018-04-06,"Gothic Rd","w1718","Mechanized",0,"Fri","weekday","no_sled","East River","1","2","2",8.9,0,25,-2,35,35.6,-1,-2,1,-1,-3,-5,-4,-5
"1235",2018-04-06,"Gothic Rd","w1718","Motorized",0,"Fri","weekday","sled","East River","1","2","2",8.9,0,25,-2,35,35.6,-1,-2,1,-1,-3,-5,-4,-5
"1236",2018-04-06,"Gothic Rd","w1718","Hybrid",0,"Fri","weekday","sled","East River","1","2","2",8.9,0,25,-2,35,35.6,-1,-2,1,-1,-3,-5,-4,-5
"1237",2018-04-07,"Gothic Rd","w1718","Non.motorized",18,"Sat","weekend","no_sled","East River","2","2","2",9.2,0.3,31,6,37,29.7,-2,-1,-2,1,4,3,1,2
"1238",2018-04-07,"Gothic Rd","w1718","Mechanized",0,"Sat","weekend","no_sled","East River","2","2","2",9.2,0.3,31,6,37,29.7,-2,-1,-2,1,4,3,1,2
"1239",2018-04-07,"Gothic Rd","w1718","Motorized",0,"Sat","weekend","sled","East River","2","2","2",9.2,0.3,31,6,37,29.7,-2,-1,-2,1,4,3,1,2
"1240",2018-04-07,"Gothic Rd","w1718","Hybrid",0,"Sat","weekend","sled","East River","2","2","2",9.2,0.3,31,6,37,29.7,-2,-1,-2,1,4,3,1,2
"1241",2018-04-08,"Gothic Rd","w1718","Non.motorized",6,"Sun","weekend","no_sled","East River","3","3","3",10,0.8,33,2,33,30.3,6,-2,-1,-2,8,6,5,3
"1242",2018-04-08,"Gothic Rd","w1718","Mechanized",0,"Sun","weekend","no_sled","East River","3","3","3",10,0.8,33,2,33,30.3,6,-2,-1,-2,8,6,5,3
"1243",2018-04-08,"Gothic Rd","w1718","Motorized",0,"Sun","weekend","sled","East River","3","3","3",10,0.8,33,2,33,30.3,6,-2,-1,-2,8,6,5,3
"1244",2018-04-08,"Gothic Rd","w1718","Hybrid",0,"Sun","weekend","sled","East River","3","3","3",10,0.8,33,2,33,30.3,6,-2,-1,-2,8,6,5,3
"1245",2018-04-09,"Gothic Rd","w1718","Non.motorized",7,"Mon","weekday","no_sled","East River","1","1","1",10.1,0.1,33,0,31,30.6,2,6,-2,-1,2,8,6,5
"1246",2018-04-09,"Gothic Rd","w1718","Mechanized",0,"Mon","weekday","no_sled","East River","1","1","1",10.1,0.1,33,0,31,30.6,2,6,-2,-1,2,8,6,5
"1247",2018-04-09,"Gothic Rd","w1718","Motorized",0,"Mon","weekday","sled","East River","1","1","1",10.1,0.1,33,0,31,30.6,2,6,-2,-1,2,8,6,5
"1248",2018-04-09,"Gothic Rd","w1718","Hybrid",0,"Mon","weekday","sled","East River","1","1","1",10.1,0.1,33,0,31,30.6,2,6,-2,-1,2,8,6,5
"1249",2018-04-10,"Gothic Rd","w1718","Non.motorized",12,"Tue","weekday","no_sled","East River","1","1","1",10.1,0,31,-2,38,32.6,0,2,6,-2,-2,0,6,4
"1250",2018-04-10,"Gothic Rd","w1718","Mechanized",0,"Tue","weekday","no_sled","East River","1","1","1",10.1,0,31,-2,38,32.6,0,2,6,-2,-2,0,6,4
"1251",2018-04-10,"Gothic Rd","w1718","Motorized",0,"Tue","weekday","sled","East River","1","1","1",10.1,0,31,-2,38,32.6,0,2,6,-2,-2,0,6,4
"1252",2018-04-10,"Gothic Rd","w1718","Hybrid",0,"Tue","weekday","sled","East River","1","1","1",10.1,0,31,-2,38,32.6,0,2,6,-2,-2,0,6,4
"1253",2018-04-11,"Gothic Rd","w1718","Non.motorized",11,"Wed","weekday","no_sled","East River","2","2","2",9.9,-0.2,29,-2,45,34.1,-2,0,2,6,-4,-4,-2,4
"1254",2018-04-11,"Gothic Rd","w1718","Mechanized",0,"Wed","weekday","no_sled","East River","2","2","2",9.9,-0.2,29,-2,45,34.1,-2,0,2,6,-4,-4,-2,4
"1255",2018-04-11,"Gothic Rd","w1718","Motorized",0,"Wed","weekday","sled","East River","2","2","2",9.9,-0.2,29,-2,45,34.1,-2,0,2,6,-4,-4,-2,4
"1256",2018-04-11,"Gothic Rd","w1718","Hybrid",0,"Wed","weekday","sled","East River","2","2","2",9.9,-0.2,29,-2,45,34.1,-2,0,2,6,-4,-4,-2,4
"1257",2018-04-12,"Gothic Rd","w1718","Non.motorized",6,"Thu","weekday","no_sled","East River","1","2","2",9.5,-0.4,28,-1,40,33.9,-2,-2,0,2,-3,-5,-5,-3
"1258",2018-04-12,"Gothic Rd","w1718","Mechanized",0,"Thu","weekday","no_sled","East River","1","2","2",9.5,-0.4,28,-1,40,33.9,-2,-2,0,2,-3,-5,-5,-3
"1259",2018-04-12,"Gothic Rd","w1718","Motorized",0,"Thu","weekday","sled","East River","1","2","2",9.5,-0.4,28,-1,40,33.9,-2,-2,0,2,-3,-5,-5,-3
"1260",2018-04-12,"Gothic Rd","w1718","Hybrid",0,"Thu","weekday","sled","East River","1","2","2",9.5,-0.4,28,-1,40,33.9,-2,-2,0,2,-3,-5,-5,-3
"1261",2018-04-13,"Gothic Rd","w1718","Non.motorized",6,"Fri","weekday","no_sled","East River","2","2","1",9.4,-0.1,26,-2,23,36.2,-1,-2,-2,0,-3,-5,-7,-7
"1262",2018-04-13,"Gothic Rd","w1718","Mechanized",1,"Fri","weekday","no_sled","East River","2","2","1",9.4,-0.1,26,-2,23,36.2,-1,-2,-2,0,-3,-5,-7,-7
"1263",2018-04-13,"Gothic Rd","w1718","Motorized",0,"Fri","weekday","sled","East River","2","2","1",9.4,-0.1,26,-2,23,36.2,-1,-2,-2,0,-3,-5,-7,-7
"1264",2018-04-13,"Gothic Rd","w1718","Hybrid",0,"Fri","weekday","sled","East River","2","2","1",9.4,-0.1,26,-2,23,36.2,-1,-2,-2,0,-3,-5,-7,-7
"1265",2018-04-14,"Gothic Rd","w1718","Non.motorized",9,"Sat","weekend","no_sled","East River","2","2","1",9.4,0,28,2,28,33.6,-2,-1,-2,-2,0,-1,-3,-5
"1266",2018-04-14,"Gothic Rd","w1718","Mechanized",0,"Sat","weekend","no_sled","East River","2","2","1",9.4,0,28,2,28,33.6,-2,-1,-2,-2,0,-1,-3,-5
"1267",2018-04-14,"Gothic Rd","w1718","Motorized",0,"Sat","weekend","sled","East River","2","2","1",9.4,0,28,2,28,33.6,-2,-1,-2,-2,0,-1,-3,-5
"1268",2018-04-14,"Gothic Rd","w1718","Hybrid",0,"Sat","weekend","sled","East River","2","2","1",9.4,0,28,2,28,33.6,-2,-1,-2,-2,0,-1,-3,-5
"1269",2018-04-15,"Gothic Rd","w1718","Non.motorized",11,"Sun","weekend","no_sled","East River","2","2","1",9.2,-0.2,27,-1,37,34.1,2,-2,-1,-2,1,-1,-2,-4
"1270",2018-04-15,"Gothic Rd","w1718","Mechanized",0,"Sun","weekend","no_sled","East River","2","2","1",9.2,-0.2,27,-1,37,34.1,2,-2,-1,-2,1,-1,-2,-4
"1271",2018-04-15,"Gothic Rd","w1718","Motorized",0,"Sun","weekend","sled","East River","2","2","1",9.2,-0.2,27,-1,37,34.1,2,-2,-1,-2,1,-1,-2,-4
"1272",2018-04-15,"Gothic Rd","w1718","Hybrid",0,"Sun","weekend","sled","East River","2","2","1",9.2,-0.2,27,-1,37,34.1,2,-2,-1,-2,1,-1,-2,-4
"1273",2018-02-09,"Kebler","w1718","Non.motorized",1,"Fri","weekday","no_sled","Kebler","2","2","1",5.3,0,24,-1,33,22.1,2,0,5,-1,1,1,6,5
"1274",2018-02-09,"Kebler","w1718","Mechanized",1,"Fri","weekday","no_sled","Kebler","2","2","1",5.3,0,24,-1,33,22.1,2,0,5,-1,1,1,6,5
"1275",2018-02-09,"Kebler","w1718","Motorized",29,"Fri","weekday","sled","Kebler","2","2","1",5.3,0,24,-1,33,22.1,2,0,5,-1,1,1,6,5
"1276",2018-02-09,"Kebler","w1718","Hybrid",0,"Fri","weekday","sled","Kebler","2","2","1",5.3,0,24,-1,33,22.1,2,0,5,-1,1,1,6,5
"1277",2018-02-10,"Kebler","w1718","Non.motorized",3,"Sat","weekend","no_sled","Kebler","3","3","2",5.3,0,24,0,24,22.1,-1,2,0,5,-1,1,1,6
"1278",2018-02-10,"Kebler","w1718","Mechanized",1,"Sat","weekend","no_sled","Kebler","3","3","2",5.3,0,24,0,24,22.1,-1,2,0,5,-1,1,1,6
"1279",2018-02-10,"Kebler","w1718","Motorized",20,"Sat","weekend","sled","Kebler","3","3","2",5.3,0,24,0,24,22.1,-1,2,0,5,-1,1,1,6
"1280",2018-02-10,"Kebler","w1718","Hybrid",4,"Sat","weekend","sled","Kebler","3","3","2",5.3,0,24,0,24,22.1,-1,2,0,5,-1,1,1,6
"1281",2018-02-11,"Kebler","w1718","Non.motorized",10,"Sun","weekend","no_sled","Kebler","3","3","2",5.6,0.3,27,3,13,20.7,0,-1,2,0,3,2,4,4
"1282",2018-02-11,"Kebler","w1718","Mechanized",0,"Sun","weekend","no_sled","Kebler","3","3","2",5.6,0.3,27,3,13,20.7,0,-1,2,0,3,2,4,4
"1283",2018-02-11,"Kebler","w1718","Motorized",129,"Sun","weekend","sled","Kebler","3","3","2",5.6,0.3,27,3,13,20.7,0,-1,2,0,3,2,4,4
"1284",2018-02-11,"Kebler","w1718","Hybrid",21,"Sun","weekend","sled","Kebler","3","3","2",5.6,0.3,27,3,13,20.7,0,-1,2,0,3,2,4,4
"1285",2018-02-12,"Kebler","w1718","Non.motorized",0,"Mon","weekday","no_sled","Kebler","3","3","3",5.7,0.1,27,0,23,21.1,3,0,-1,2,3,3,2,4
"1286",2018-02-12,"Kebler","w1718","Mechanized",0,"Mon","weekday","no_sled","Kebler","3","3","3",5.7,0.1,27,0,23,21.1,3,0,-1,2,3,3,2,4
"1287",2018-02-12,"Kebler","w1718","Motorized",32,"Mon","weekday","sled","Kebler","3","3","3",5.7,0.1,27,0,23,21.1,3,0,-1,2,3,3,2,4
"1288",2018-02-12,"Kebler","w1718","Hybrid",9,"Mon","weekday","sled","Kebler","3","3","3",5.7,0.1,27,0,23,21.1,3,0,-1,2,3,3,2,4
"1289",2018-02-13,"Kebler","w1718","Non.motorized",16,"Tue","weekday","no_sled","Kebler","3","3","3",6.1,0.4,29,2,28,21,0,3,0,-1,2,5,5,4
"1290",2018-02-13,"Kebler","w1718","Mechanized",1,"Tue","weekday","no_sled","Kebler","3","3","3",6.1,0.4,29,2,28,21,0,3,0,-1,2,5,5,4
"1291",2018-02-13,"Kebler","w1718","Motorized",38,"Tue","weekday","sled","Kebler","3","3","3",6.1,0.4,29,2,28,21,0,3,0,-1,2,5,5,4
"1292",2018-02-13,"Kebler","w1718","Hybrid",2,"Tue","weekday","sled","Kebler","3","3","3",6.1,0.4,29,2,28,21,0,3,0,-1,2,5,5,4
"1293",2018-02-14,"Kebler","w1718","Non.motorized",9,"Wed","weekday","no_sled","Kebler","3","3","3",6.2,0.1,30,1,30,20.7,2,0,3,0,3,3,6,6
"1294",2018-02-14,"Kebler","w1718","Mechanized",0,"Wed","weekday","no_sled","Kebler","3","3","3",6.2,0.1,30,1,30,20.7,2,0,3,0,3,3,6,6
"1295",2018-02-14,"Kebler","w1718","Motorized",80,"Wed","weekday","sled","Kebler","3","3","3",6.2,0.1,30,1,30,20.7,2,0,3,0,3,3,6,6
"1296",2018-02-14,"Kebler","w1718","Hybrid",0,"Wed","weekday","sled","Kebler","3","3","3",6.2,0.1,30,1,30,20.7,2,0,3,0,3,3,6,6
"1297",2018-02-15,"Kebler","w1718","Non.motorized",10,"Thu","weekday","no_sled","Kebler","3","3","3",6.3,0.1,28,-2,24,22.5,1,2,0,3,-1,1,1,4
"1298",2018-02-15,"Kebler","w1718","Mechanized",0,"Thu","weekday","no_sled","Kebler","3","3","3",6.3,0.1,28,-2,24,22.5,1,2,0,3,-1,1,1,4
"1299",2018-02-15,"Kebler","w1718","Motorized",43,"Thu","weekday","sled","Kebler","3","3","3",6.3,0.1,28,-2,24,22.5,1,2,0,3,-1,1,1,4
"1300",2018-02-15,"Kebler","w1718","Hybrid",0,"Thu","weekday","sled","Kebler","3","3","3",6.3,0.1,28,-2,24,22.5,1,2,0,3,-1,1,1,4
"1301",2018-02-16,"Kebler","w1718","Non.motorized",12,"Fri","weekday","no_sled","Kebler","3","3","3",6.7,0.4,32,4,18,20.9,-2,1,2,0,2,3,5,5
"1302",2018-02-16,"Kebler","w1718","Mechanized",0,"Fri","weekday","no_sled","Kebler","3","3","3",6.7,0.4,32,4,18,20.9,-2,1,2,0,2,3,5,5
"1303",2018-02-16,"Kebler","w1718","Motorized",114,"Fri","weekday","sled","Kebler","3","3","3",6.7,0.4,32,4,18,20.9,-2,1,2,0,2,3,5,5
"1304",2018-02-16,"Kebler","w1718","Hybrid",6,"Fri","weekday","sled","Kebler","3","3","3",6.7,0.4,32,4,18,20.9,-2,1,2,0,2,3,5,5
"1305",2018-02-17,"Kebler","w1718","Non.motorized",39,"Sat","weekend","no_sled","Kebler","3","3","2",6.7,0,32,0,25,20.9,4,-2,1,2,4,2,3,5
"1306",2018-02-17,"Kebler","w1718","Mechanized",0,"Sat","weekend","no_sled","Kebler","3","3","2",6.7,0,32,0,25,20.9,4,-2,1,2,4,2,3,5
"1307",2018-02-17,"Kebler","w1718","Motorized",184,"Sat","weekend","sled","Kebler","3","3","2",6.7,0,32,0,25,20.9,4,-2,1,2,4,2,3,5
"1308",2018-02-17,"Kebler","w1718","Hybrid",2,"Sat","weekend","sled","Kebler","3","3","2",6.7,0,32,0,25,20.9,4,-2,1,2,4,2,3,5
"1309",2018-02-18,"Kebler","w1718","Non.motorized",19,"Sun","weekend","no_sled","Kebler","2","2","2",6.7,0,31,-1,32,21.6,0,4,-2,1,-1,3,1,2
"1310",2018-02-18,"Kebler","w1718","Mechanized",0,"Sun","weekend","no_sled","Kebler","2","2","2",6.7,0,31,-1,32,21.6,0,4,-2,1,-1,3,1,2
"1311",2018-02-18,"Kebler","w1718","Motorized",156,"Sun","weekend","sled","Kebler","2","2","2",6.7,0,31,-1,32,21.6,0,4,-2,1,-1,3,1,2
"1312",2018-02-18,"Kebler","w1718","Hybrid",17,"Sun","weekend","sled","Kebler","2","2","2",6.7,0,31,-1,32,21.6,0,4,-2,1,-1,3,1,2
"1313",2018-02-19,"Kebler","w1718","Non.motorized",0,"Mon","weekday","no_sled","Kebler","2","2","2",6.8,0.1,29,-2,24,23.4,-1,0,4,-2,-3,-3,1,-1
"1314",2018-02-19,"Kebler","w1718","Non.motorized",0,"Mon","weekday","no_sled","Kebler","3","3","3",6.8,0.1,29,-2,24,23.4,-1,0,4,-2,-3,-3,1,-1
"1315",2018-02-19,"Kebler","w1718","Mechanized",0,"Mon","weekday","no_sled","Kebler","2","2","2",6.8,0.1,29,-2,24,23.4,-1,0,4,-2,-3,-3,1,-1
"1316",2018-02-19,"Kebler","w1718","Mechanized",0,"Mon","weekday","no_sled","Kebler","3","3","3",6.8,0.1,29,-2,24,23.4,-1,0,4,-2,-3,-3,1,-1
"1317",2018-02-19,"Kebler","w1718","Motorized",49,"Mon","weekday","sled","Kebler","2","2","2",6.8,0.1,29,-2,24,23.4,-1,0,4,-2,-3,-3,1,-1
"1318",2018-02-19,"Kebler","w1718","Motorized",49,"Mon","weekday","sled","Kebler","3","3","3",6.8,0.1,29,-2,24,23.4,-1,0,4,-2,-3,-3,1,-1
"1319",2018-02-19,"Kebler","w1718","Hybrid",2,"Mon","weekday","sled","Kebler","2","2","2",6.8,0.1,29,-2,24,23.4,-1,0,4,-2,-3,-3,1,-1
"1320",2018-02-19,"Kebler","w1718","Hybrid",2,"Mon","weekday","sled","Kebler","3","3","3",6.8,0.1,29,-2,24,23.4,-1,0,4,-2,-3,-3,1,-1
"1321",2018-02-20,"Kebler","w1718","Non.motorized",8,"Tue","weekday","no_sled","Kebler","3","3","3",6.8,0,31,2,8,21.9,-2,-1,0,4,0,-1,-1,3
"1322",2018-02-20,"Kebler","w1718","Mechanized",0,"Tue","weekday","no_sled","Kebler","3","3","3",6.8,0,31,2,8,21.9,-2,-1,0,4,0,-1,-1,3
"1323",2018-02-20,"Kebler","w1718","Motorized",35,"Tue","weekday","sled","Kebler","3","3","3",6.8,0,31,2,8,21.9,-2,-1,0,4,0,-1,-1,3
"1324",2018-02-20,"Kebler","w1718","Hybrid",1,"Tue","weekday","sled","Kebler","3","3","3",6.8,0,31,2,8,21.9,-2,-1,0,4,0,-1,-1,3
"1325",2018-02-21,"Kebler","w1718","Non.motorized",18,"Wed","weekday","no_sled","Kebler","3","3","3",6.8,0,31,0,11,21.9,2,-2,-1,0,2,0,-1,-1
"1326",2018-02-21,"Kebler","w1718","Mechanized",0,"Wed","weekday","no_sled","Kebler","3","3","3",6.8,0,31,0,11,21.9,2,-2,-1,0,2,0,-1,-1
"1327",2018-02-21,"Kebler","w1718","Motorized",63,"Wed","weekday","sled","Kebler","3","3","3",6.8,0,31,0,11,21.9,2,-2,-1,0,2,0,-1,-1
"1328",2018-02-21,"Kebler","w1718","Hybrid",3,"Wed","weekday","sled","Kebler","3","3","3",6.8,0,31,0,11,21.9,2,-2,-1,0,2,0,-1,-1
"1329",2018-02-22,"Kebler","w1718","Non.motorized",1,"Thu","weekday","no_sled","Kebler","3","3","2",6.8,0,30,-1,16,22.7,0,2,-2,-1,-1,1,-1,-2
"1330",2018-02-22,"Kebler","w1718","Mechanized",0,"Thu","weekday","no_sled","Kebler","3","3","2",6.8,0,30,-1,16,22.7,0,2,-2,-1,-1,1,-1,-2
"1331",2018-02-22,"Kebler","w1718","Motorized",49,"Thu","weekday","sled","Kebler","3","3","2",6.8,0,30,-1,16,22.7,0,2,-2,-1,-1,1,-1,-2
"1332",2018-02-22,"Kebler","w1718","Hybrid",0,"Thu","weekday","sled","Kebler","3","3","2",6.8,0,30,-1,16,22.7,0,2,-2,-1,-1,1,-1,-2
"1333",2018-02-23,"Kebler","w1718","Non.motorized",16,"Fri","weekday","no_sled","Kebler","3","3","2",6.9,0.1,30,0,15,23,-1,0,2,-2,-1,-1,1,-1
"1334",2018-02-23,"Kebler","w1718","Mechanized",0,"Fri","weekday","no_sled","Kebler","3","3","2",6.9,0.1,30,0,15,23,-1,0,2,-2,-1,-1,1,-1
"1335",2018-02-23,"Kebler","w1718","Motorized",66,"Fri","weekday","sled","Kebler","3","3","2",6.9,0.1,30,0,15,23,-1,0,2,-2,-1,-1,1,-1
"1336",2018-02-23,"Kebler","w1718","Hybrid",2,"Fri","weekday","sled","Kebler","3","3","2",6.9,0.1,30,0,15,23,-1,0,2,-2,-1,-1,1,-1
"1337",2018-02-24,"Kebler","w1718","Non.motorized",7,"Sat","weekend","no_sled","Kebler","3","3","2",6.9,0,31,1,10,22.3,0,-1,0,2,1,0,0,2
"1338",2018-02-24,"Kebler","w1718","Mechanized",0,"Sat","weekend","no_sled","Kebler","3","3","2",6.9,0,31,1,10,22.3,0,-1,0,2,1,0,0,2
"1339",2018-02-24,"Kebler","w1718","Motorized",86,"Sat","weekend","sled","Kebler","3","3","2",6.9,0,31,1,10,22.3,0,-1,0,2,1,0,0,2
"1340",2018-02-24,"Kebler","w1718","Hybrid",5,"Sat","weekend","sled","Kebler","3","3","2",6.9,0,31,1,10,22.3,0,-1,0,2,1,0,0,2
"1341",2018-02-25,"Kebler","w1718","Non.motorized",9,"Sun","weekend","no_sled","Kebler","3","3","2",7.1,0.2,32,1,11,22.2,1,0,-1,0,2,2,1,1
"1342",2018-02-25,"Kebler","w1718","Mechanized",0,"Sun","weekend","no_sled","Kebler","3","3","2",7.1,0.2,32,1,11,22.2,1,0,-1,0,2,2,1,1
"1343",2018-02-25,"Kebler","w1718","Motorized",57,"Sun","weekend","sled","Kebler","3","3","2",7.1,0.2,32,1,11,22.2,1,0,-1,0,2,2,1,1
"1344",2018-02-25,"Kebler","w1718","Hybrid",7,"Sun","weekend","sled","Kebler","3","3","2",7.1,0.2,32,1,11,22.2,1,0,-1,0,2,2,1,1
"1345",2018-02-26,"Kebler","w1718","Non.motorized",23,"Mon","weekday","no_sled","Kebler","2","2","2",7.1,0,32,0,20,22.2,1,1,0,-1,1,2,2,1
"1346",2018-02-26,"Kebler","w1718","Mechanized",0,"Mon","weekday","no_sled","Kebler","2","2","2",7.1,0,32,0,20,22.2,1,1,0,-1,1,2,2,1
"1347",2018-02-26,"Kebler","w1718","Motorized",103,"Mon","weekday","sled","Kebler","2","2","2",7.1,0,32,0,20,22.2,1,1,0,-1,1,2,2,1
"1348",2018-02-26,"Kebler","w1718","Hybrid",5,"Mon","weekday","sled","Kebler","2","2","2",7.1,0,32,0,20,22.2,1,1,0,-1,1,2,2,1
"1349",2018-02-27,"Kebler","w1718","Non.motorized",3,"Tue","weekday","no_sled","Kebler","2","2","2",7.2,0.1,32,0,26,22.5,0,1,1,0,0,1,2,2
"1350",2018-02-27,"Kebler","w1718","Mechanized",0,"Tue","weekday","no_sled","Kebler","2","2","2",7.2,0.1,32,0,26,22.5,0,1,1,0,0,1,2,2
"1351",2018-02-27,"Kebler","w1718","Motorized",76,"Tue","weekday","sled","Kebler","2","2","2",7.2,0.1,32,0,26,22.5,0,1,1,0,0,1,2,2
"1352",2018-02-27,"Kebler","w1718","Hybrid",2,"Tue","weekday","sled","Kebler","2","2","2",7.2,0.1,32,0,26,22.5,0,1,1,0,0,1,2,2
"1353",2018-02-28,"Kebler","w1718","Non.motorized",6,"Wed","weekday","no_sled","Kebler","2","2","2",7.2,0,31,-1,23,23.2,0,0,1,1,-1,-1,0,1
"1354",2018-02-28,"Kebler","w1718","Mechanized",0,"Wed","weekday","no_sled","Kebler","2","2","2",7.2,0,31,-1,23,23.2,0,0,1,1,-1,-1,0,1
"1355",2018-02-28,"Kebler","w1718","Motorized",81,"Wed","weekday","sled","Kebler","2","2","2",7.2,0,31,-1,23,23.2,0,0,1,1,-1,-1,0,1
"1356",2018-02-28,"Kebler","w1718","Hybrid",2,"Wed","weekday","sled","Kebler","2","2","2",7.2,0,31,-1,23,23.2,0,0,1,1,-1,-1,0,1
"1357",2018-03-01,"Kebler","w1718","Non.motorized",1,"Thu","weekday","no_sled","Kebler","2","2","2",7.2,0,31,0,24,23.2,-1,0,0,1,-1,-1,-1,0
"1358",2018-03-01,"Kebler","w1718","Mechanized",0,"Thu","weekday","no_sled","Kebler","2","2","2",7.2,0,31,0,24,23.2,-1,0,0,1,-1,-1,-1,0
"1359",2018-03-01,"Kebler","w1718","Motorized",29,"Thu","weekday","sled","Kebler","2","2","2",7.2,0,31,0,24,23.2,-1,0,0,1,-1,-1,-1,0
"1360",2018-03-01,"Kebler","w1718","Hybrid",0,"Thu","weekday","sled","Kebler","2","2","2",7.2,0,31,0,24,23.2,-1,0,0,1,-1,-1,-1,0
"1361",2018-03-02,"Kebler","w1718","Non.motorized",0,"Fri","weekday","no_sled","Kebler","2","2","1",7.2,0,31,0,30,23.2,0,-1,0,0,0,-1,-1,-1
"1362",2018-03-02,"Kebler","w1718","Mechanized",0,"Fri","weekday","no_sled","Kebler","2","2","1",7.2,0,31,0,30,23.2,0,-1,0,0,0,-1,-1,-1
"1363",2018-03-02,"Kebler","w1718","Motorized",62,"Fri","weekday","sled","Kebler","2","2","1",7.2,0,31,0,30,23.2,0,-1,0,0,0,-1,-1,-1
"1364",2018-03-02,"Kebler","w1718","Hybrid",5,"Fri","weekday","sled","Kebler","2","2","1",7.2,0,31,0,30,23.2,0,-1,0,0,0,-1,-1,-1
"1365",2018-03-03,"Kebler","w1718","Non.motorized",12,"Sat","weekend","no_sled","Kebler","2","2","1",7.3,0.1,30,-1,34,24.3,0,0,-1,0,-1,-1,-2,-2
"1366",2018-03-03,"Kebler","w1718","Mechanized",0,"Sat","weekend","no_sled","Kebler","2","2","1",7.3,0.1,30,-1,34,24.3,0,0,-1,0,-1,-1,-2,-2
"1367",2018-03-03,"Kebler","w1718","Motorized",102,"Sat","weekend","sled","Kebler","2","2","1",7.3,0.1,30,-1,34,24.3,0,0,-1,0,-1,-1,-2,-2
"1368",2018-03-03,"Kebler","w1718","Hybrid",23,"Sat","weekend","sled","Kebler","2","2","1",7.3,0.1,30,-1,34,24.3,0,0,-1,0,-1,-1,-2,-2
"1369",2018-03-04,"Kebler","w1718","Non.motorized",0,"Sun","weekend","no_sled","Kebler","2","2","1",7.3,0,29,-1,24,25.2,-1,0,0,-1,-2,-2,-2,-3
"1370",2018-03-04,"Kebler","w1718","Mechanized",1,"Sun","weekend","no_sled","Kebler","2","2","1",7.3,0,29,-1,24,25.2,-1,0,0,-1,-2,-2,-2,-3
"1371",2018-03-04,"Kebler","w1718","Motorized",55,"Sun","weekend","sled","Kebler","2","2","1",7.3,0,29,-1,24,25.2,-1,0,0,-1,-2,-2,-2,-3
"1372",2018-03-04,"Kebler","w1718","Hybrid",9,"Sun","weekend","sled","Kebler","2","2","1",7.3,0,29,-1,24,25.2,-1,0,0,-1,-2,-2,-2,-3
"1373",2018-03-05,"Kebler","w1718","Non.motorized",5,"Mon","weekday","no_sled","Kebler","2","2","1",7.3,0,31,2,13,23.5,-1,-1,0,0,1,0,0,0
"1374",2018-03-05,"Kebler","w1718","Mechanized",0,"Mon","weekday","no_sled","Kebler","2","2","1",7.3,0,31,2,13,23.5,-1,-1,0,0,1,0,0,0
"1375",2018-03-05,"Kebler","w1718","Motorized",60,"Mon","weekday","sled","Kebler","2","2","1",7.3,0,31,2,13,23.5,-1,-1,0,0,1,0,0,0
"1376",2018-03-05,"Kebler","w1718","Hybrid",3,"Mon","weekday","sled","Kebler","2","2","1",7.3,0,31,2,13,23.5,-1,-1,0,0,1,0,0,0
"1377",2018-03-06,"Kebler","w1718","Non.motorized",0,"Tue","weekday","no_sled","Kebler","2","2","1",7.3,0,31,0,19,23.5,2,-1,-1,0,2,1,0,0
"1378",2018-03-06,"Kebler","w1718","Mechanized",0,"Tue","weekday","no_sled","Kebler","2","2","1",7.3,0,31,0,19,23.5,2,-1,-1,0,2,1,0,0
"1379",2018-03-06,"Kebler","w1718","Motorized",68,"Tue","weekday","sled","Kebler","2","2","1",7.3,0,31,0,19,23.5,2,-1,-1,0,2,1,0,0
"1380",2018-03-06,"Kebler","w1718","Hybrid",6,"Tue","weekday","sled","Kebler","2","2","1",7.3,0,31,0,19,23.5,2,-1,-1,0,2,1,0,0
"1381",2018-03-07,"Kebler","w1718","Non.motorized",6,"Wed","weekday","no_sled","Kebler","2","2","1",7.4,0.1,31,0,27,23.9,0,2,-1,-1,0,2,1,0
"1382",2018-03-07,"Kebler","w1718","Mechanized",0,"Wed","weekday","no_sled","Kebler","2","2","1",7.4,0.1,31,0,27,23.9,0,2,-1,-1,0,2,1,0
"1383",2018-03-07,"Kebler","w1718","Motorized",43,"Wed","weekday","sled","Kebler","2","2","1",7.4,0.1,31,0,27,23.9,0,2,-1,-1,0,2,1,0
"1384",2018-03-07,"Kebler","w1718","Hybrid",4,"Wed","weekday","sled","Kebler","2","2","1",7.4,0.1,31,0,27,23.9,0,2,-1,-1,0,2,1,0
"1385",2018-03-08,"Kebler","w1718","Non.motorized",0,"Thu","weekday","no_sled","Kebler","2","2","1",7.4,0,30,-1,33,24.7,0,0,2,-1,-1,-1,1,0
"1386",2018-03-08,"Kebler","w1718","Mechanized",0,"Thu","weekday","no_sled","Kebler","2","2","1",7.4,0,30,-1,33,24.7,0,0,2,-1,-1,-1,1,0
"1387",2018-03-08,"Kebler","w1718","Motorized",77,"Thu","weekday","sled","Kebler","2","2","1",7.4,0,30,-1,33,24.7,0,0,2,-1,-1,-1,1,0
"1388",2018-03-08,"Kebler","w1718","Hybrid",8,"Thu","weekday","sled","Kebler","2","2","1",7.4,0,30,-1,33,24.7,0,0,2,-1,-1,-1,1,0
"1389",2018-03-09,"Kebler","w1718","Non.motorized",6,"Fri","weekday","no_sled","Kebler","2","2","1",7.4,0,30,0,34,24.7,-1,0,0,2,-1,-1,-1,1
"1390",2018-03-09,"Kebler","w1718","Mechanized",0,"Fri","weekday","no_sled","Kebler","2","2","1",7.4,0,30,0,34,24.7,-1,0,0,2,-1,-1,-1,1
"1391",2018-03-09,"Kebler","w1718","Motorized",105,"Fri","weekday","sled","Kebler","2","2","1",7.4,0,30,0,34,24.7,-1,0,0,2,-1,-1,-1,1
"1392",2018-03-09,"Kebler","w1718","Hybrid",0,"Fri","weekday","sled","Kebler","2","2","1",7.4,0,30,0,34,24.7,-1,0,0,2,-1,-1,-1,1
"1393",2018-03-10,"Kebler","w1718","Non.motorized",8,"Sat","weekend","no_sled","Kebler","1","1","1",7.4,0,30,0,31,24.7,0,-1,0,0,0,-1,-1,-1
"1394",2018-03-10,"Kebler","w1718","Mechanized",0,"Sat","weekend","no_sled","Kebler","1","1","1",7.4,0,30,0,31,24.7,0,-1,0,0,0,-1,-1,-1
"1395",2018-03-10,"Kebler","w1718","Motorized",138,"Sat","weekend","sled","Kebler","1","1","1",7.4,0,30,0,31,24.7,0,-1,0,0,0,-1,-1,-1
"1396",2018-03-10,"Kebler","w1718","Hybrid",11,"Sat","weekend","sled","Kebler","1","1","1",7.4,0,30,0,31,24.7,0,-1,0,0,0,-1,-1,-1
"1397",2018-03-11,"Kebler","w1718","Non.motorized",16,"Sun","weekend","no_sled","Kebler","1","1","1",7.4,0,29,-1,31,25.5,0,0,-1,0,-1,-1,-2,-2
"1398",2018-03-11,"Kebler","w1718","Mechanized",0,"Sun","weekend","no_sled","Kebler","1","1","1",7.4,0,29,-1,31,25.5,0,0,-1,0,-1,-1,-2,-2
"1399",2018-03-11,"Kebler","w1718","Motorized",170,"Sun","weekend","sled","Kebler","1","1","1",7.4,0,29,-1,31,25.5,0,0,-1,0,-1,-1,-2,-2
"1400",2018-03-11,"Kebler","w1718","Hybrid",14,"Sun","weekend","sled","Kebler","1","1","1",7.4,0,29,-1,31,25.5,0,0,-1,0,-1,-1,-2,-2
"1401",2018-03-12,"Kebler","w1718","Non.motorized",2,"Mon","weekday","no_sled","Kebler","1","1","1",7.4,0,29,0,33,25.5,-1,0,0,-1,-1,-1,-1,-2
"1402",2018-03-12,"Kebler","w1718","Mechanized",0,"Mon","weekday","no_sled","Kebler","1","1","1",7.4,0,29,0,33,25.5,-1,0,0,-1,-1,-1,-1,-2
"1403",2018-03-12,"Kebler","w1718","Motorized",99,"Mon","weekday","sled","Kebler","1","1","1",7.4,0,29,0,33,25.5,-1,0,0,-1,-1,-1,-1,-2
"1404",2018-03-12,"Kebler","w1718","Hybrid",0,"Mon","weekday","sled","Kebler","1","1","1",7.4,0,29,0,33,25.5,-1,0,0,-1,-1,-1,-1,-2
"1405",2018-03-13,"Kebler","w1718","Non.motorized",7,"Tue","weekday","no_sled","Kebler","1","1","1",7.4,0,29,0,34,25.5,0,-1,0,0,0,-1,-1,-1
"1406",2018-03-13,"Kebler","w1718","Mechanized",2,"Tue","weekday","no_sled","Kebler","1","1","1",7.4,0,29,0,34,25.5,0,-1,0,0,0,-1,-1,-1
"1407",2018-03-13,"Kebler","w1718","Motorized",163,"Tue","weekday","sled","Kebler","1","1","1",7.4,0,29,0,34,25.5,0,-1,0,0,0,-1,-1,-1
"1408",2018-03-13,"Kebler","w1718","Hybrid",3,"Tue","weekday","sled","Kebler","1","1","1",7.4,0,29,0,34,25.5,0,-1,0,0,0,-1,-1,-1
"1409",2018-03-14,"Kebler","w1718","Non.motorized",10,"Wed","weekday","no_sled","Kebler","1","2","2",7.4,0,29,0,39,25.5,0,0,-1,0,0,0,-1,-1
"1410",2018-03-14,"Kebler","w1718","Mechanized",0,"Wed","weekday","no_sled","Kebler","1","2","2",7.4,0,29,0,39,25.5,0,0,-1,0,0,0,-1,-1
"1411",2018-03-14,"Kebler","w1718","Motorized",137,"Wed","weekday","sled","Kebler","1","2","2",7.4,0,29,0,39,25.5,0,0,-1,0,0,0,-1,-1
"1412",2018-03-14,"Kebler","w1718","Hybrid",6,"Wed","weekday","sled","Kebler","1","2","2",7.4,0,29,0,39,25.5,0,0,-1,0,0,0,-1,-1
"1413",2018-03-15,"Kebler","w1718","Non.motorized",3,"Thu","weekday","no_sled","Kebler","2","2","2",7.5,0.1,28,-1,31,26.8,0,0,0,-1,-1,-1,-1,-2
"1414",2018-03-15,"Kebler","w1718","Mechanized",0,"Thu","weekday","no_sled","Kebler","2","2","2",7.5,0.1,28,-1,31,26.8,0,0,0,-1,-1,-1,-1,-2
"1415",2018-03-15,"Kebler","w1718","Motorized",157,"Thu","weekday","sled","Kebler","2","2","2",7.5,0.1,28,-1,31,26.8,0,0,0,-1,-1,-1,-1,-2
"1416",2018-03-15,"Kebler","w1718","Hybrid",3,"Thu","weekday","sled","Kebler","2","2","2",7.5,0.1,28,-1,31,26.8,0,0,0,-1,-1,-1,-1,-2
"1417",2018-03-16,"Kebler","w1718","Non.motorized",10,"Fri","weekday","no_sled","Kebler","2","2","2",7.7,0.2,29,1,25,26.6,-1,0,0,0,0,0,0,0
"1418",2018-03-16,"Kebler","w1718","Mechanized",0,"Fri","weekday","no_sled","Kebler","2","2","2",7.7,0.2,29,1,25,26.6,-1,0,0,0,0,0,0,0
"1419",2018-03-16,"Kebler","w1718","Motorized",99,"Fri","weekday","sled","Kebler","2","2","2",7.7,0.2,29,1,25,26.6,-1,0,0,0,0,0,0,0
"1420",2018-03-16,"Kebler","w1718","Hybrid",12,"Fri","weekday","sled","Kebler","2","2","2",7.7,0.2,29,1,25,26.6,-1,0,0,0,0,0,0,0
"1421",2018-03-17,"Kebler","w1718","Non.motorized",3,"Sat","weekend","no_sled","Kebler","2","2","2",7.8,0.1,32,3,29,24.4,1,-1,0,0,4,3,3,3
"1422",2018-03-17,"Kebler","w1718","Mechanized",1,"Sat","weekend","no_sled","Kebler","2","2","2",7.8,0.1,32,3,29,24.4,1,-1,0,0,4,3,3,3
"1423",2018-03-17,"Kebler","w1718","Motorized",130,"Sat","weekend","sled","Kebler","2","2","2",7.8,0.1,32,3,29,24.4,1,-1,0,0,4,3,3,3
"1424",2018-03-17,"Kebler","w1718","Hybrid",17,"Sat","weekend","sled","Kebler","2","2","2",7.8,0.1,32,3,29,24.4,1,-1,0,0,4,3,3,3
"1425",2018-03-18,"Kebler","w1718","Non.motorized",4,"Sun","weekend","no_sled","Kebler","2","2","2",7.9,0.1,31,-1,24,25.5,3,1,-1,0,2,3,2,2
"1426",2018-03-18,"Kebler","w1718","Mechanized",0,"Sun","weekend","no_sled","Kebler","2","2","2",7.9,0.1,31,-1,24,25.5,3,1,-1,0,2,3,2,2
"1427",2018-03-18,"Kebler","w1718","Motorized",92,"Sun","weekend","sled","Kebler","2","2","2",7.9,0.1,31,-1,24,25.5,3,1,-1,0,2,3,2,2
"1428",2018-03-18,"Kebler","w1718","Hybrid",14,"Sun","weekend","sled","Kebler","2","2","2",7.9,0.1,31,-1,24,25.5,3,1,-1,0,2,3,2,2
"1429",2018-03-19,"Kebler","w1718","Non.motorized",2,"Mon","weekday","no_sled","Kebler","2","2","1",8,0.1,32,1,19,25,-1,3,1,-1,0,3,4,3
"1430",2018-03-19,"Kebler","w1718","Mechanized",0,"Mon","weekday","no_sled","Kebler","2","2","1",8,0.1,32,1,19,25,-1,3,1,-1,0,3,4,3
"1431",2018-03-19,"Kebler","w1718","Motorized",61,"Mon","weekday","sled","Kebler","2","2","1",8,0.1,32,1,19,25,-1,3,1,-1,0,3,4,3
"1432",2018-03-19,"Kebler","w1718","Hybrid",7,"Mon","weekday","sled","Kebler","2","2","1",8,0.1,32,1,19,25,-1,3,1,-1,0,3,4,3
"1433",2018-03-20,"Kebler","w1718","Non.motorized",3,"Tue","weekday","no_sled","Kebler","2","2","1",8,0,30,-2,24,26.7,1,-1,3,1,-1,-2,1,2
"1434",2018-03-20,"Kebler","w1718","Mechanized",0,"Tue","weekday","no_sled","Kebler","2","2","1",8,0,30,-2,24,26.7,1,-1,3,1,-1,-2,1,2
"1435",2018-03-20,"Kebler","w1718","Motorized",87,"Tue","weekday","sled","Kebler","2","2","1",8,0,30,-2,24,26.7,1,-1,3,1,-1,-2,1,2
"1436",2018-03-20,"Kebler","w1718","Hybrid",7,"Tue","weekday","sled","Kebler","2","2","1",8,0,30,-2,24,26.7,1,-1,3,1,-1,-2,1,2
"1437",2018-03-21,"Kebler","w1718","Non.motorized",0,"Wed","weekday","no_sled","Kebler","1","1","1",8.1,0.1,32,2,30,25.3,-2,1,-1,3,0,1,0,3
"1438",2018-03-21,"Kebler","w1718","Mechanized",0,"Wed","weekday","no_sled","Kebler","1","1","1",8.1,0.1,32,2,30,25.3,-2,1,-1,3,0,1,0,3
"1439",2018-03-21,"Kebler","w1718","Motorized",86,"Wed","weekday","sled","Kebler","1","1","1",8.1,0.1,32,2,30,25.3,-2,1,-1,3,0,1,0,3
"1440",2018-03-21,"Kebler","w1718","Hybrid",7,"Wed","weekday","sled","Kebler","1","1","1",8.1,0.1,32,2,30,25.3,-2,1,-1,3,0,1,0,3
"1441",2018-03-22,"Kebler","w1718","Non.motorized",3,"Thu","weekday","no_sled","Kebler","1","1","1",8.1,0,30,-2,36,27,2,-2,1,-1,0,-2,-1,-2
"1442",2018-03-22,"Kebler","w1718","Mechanized",0,"Thu","weekday","no_sled","Kebler","1","1","1",8.1,0,30,-2,36,27,2,-2,1,-1,0,-2,-1,-2
"1443",2018-03-22,"Kebler","w1718","Motorized",67,"Thu","weekday","sled","Kebler","1","1","1",8.1,0,30,-2,36,27,2,-2,1,-1,0,-2,-1,-2
"1444",2018-03-22,"Kebler","w1718","Hybrid",4,"Thu","weekday","sled","Kebler","1","1","1",8.1,0,30,-2,36,27,2,-2,1,-1,0,-2,-1,-2
"1445",2018-03-23,"Kebler","w1718","Non.motorized",1,"Fri","weekday","no_sled","Kebler","2","2","3",8.2,0.1,29,-1,34,28.3,-2,2,-2,1,-3,-1,-3,-2
"1446",2018-03-23,"Kebler","w1718","Mechanized",0,"Fri","weekday","no_sled","Kebler","2","2","3",8.2,0.1,29,-1,34,28.3,-2,2,-2,1,-3,-1,-3,-2
"1447",2018-03-23,"Kebler","w1718","Motorized",30,"Fri","weekday","sled","Kebler","2","2","3",8.2,0.1,29,-1,34,28.3,-2,2,-2,1,-3,-1,-3,-2
"1448",2018-03-23,"Kebler","w1718","Hybrid",1,"Fri","weekday","sled","Kebler","2","2","3",8.2,0.1,29,-1,34,28.3,-2,2,-2,1,-3,-1,-3,-2
"1449",2018-03-24,"Kebler","w1718","Non.motorized",5,"Sat","weekend","no_sled","Kebler","2","2","1",8.9,0.7,34,5,32,26.2,-1,-2,2,-2,4,2,4,2
"1450",2018-03-24,"Kebler","w1718","Mechanized",0,"Sat","weekend","no_sled","Kebler","2","2","1",8.9,0.7,34,5,32,26.2,-1,-2,2,-2,4,2,4,2
"1451",2018-03-24,"Kebler","w1718","Motorized",74,"Sat","weekend","sled","Kebler","2","2","1",8.9,0.7,34,5,32,26.2,-1,-2,2,-2,4,2,4,2
"1452",2018-03-24,"Kebler","w1718","Hybrid",4,"Sat","weekend","sled","Kebler","2","2","1",8.9,0.7,34,5,32,26.2,-1,-2,2,-2,4,2,4,2
"1453",2018-03-25,"Kebler","w1718","Non.motorized",5,"Sun","weekend","no_sled","Kebler","2","2","1",8.9,0,35,1,35,25.4,5,-1,-2,2,6,5,3,5
"1454",2018-03-25,"Kebler","w1718","Mechanized",0,"Sun","weekend","no_sled","Kebler","2","2","1",8.9,0,35,1,35,25.4,5,-1,-2,2,6,5,3,5
"1455",2018-03-25,"Kebler","w1718","Motorized",90,"Sun","weekend","sled","Kebler","2","2","1",8.9,0,35,1,35,25.4,5,-1,-2,2,6,5,3,5
"1456",2018-03-25,"Kebler","w1718","Hybrid",11,"Sun","weekend","sled","Kebler","2","2","1",8.9,0,35,1,35,25.4,5,-1,-2,2,6,5,3,5
"1457",2018-03-26,"Kebler","w1718","Non.motorized",12,"Mon","weekday","no_sled","Kebler","1","1","1",8.9,0,34,-1,31,26.2,1,5,-1,-2,0,5,4,2
"1458",2018-03-26,"Kebler","w1718","Non.motorized",12,"Mon","weekday","no_sled","Kebler","2","1","1",8.9,0,34,-1,31,26.2,1,5,-1,-2,0,5,4,2
"1459",2018-03-26,"Kebler","w1718","Mechanized",0,"Mon","weekday","no_sled","Kebler","1","1","1",8.9,0,34,-1,31,26.2,1,5,-1,-2,0,5,4,2
"1460",2018-03-26,"Kebler","w1718","Mechanized",0,"Mon","weekday","no_sled","Kebler","2","1","1",8.9,0,34,-1,31,26.2,1,5,-1,-2,0,5,4,2
"1461",2018-03-26,"Kebler","w1718","Motorized",76,"Mon","weekday","sled","Kebler","1","1","1",8.9,0,34,-1,31,26.2,1,5,-1,-2,0,5,4,2
"1462",2018-03-26,"Kebler","w1718","Motorized",76,"Mon","weekday","sled","Kebler","2","1","1",8.9,0,34,-1,31,26.2,1,5,-1,-2,0,5,4,2
"1463",2018-03-26,"Kebler","w1718","Hybrid",9,"Mon","weekday","sled","Kebler","1","1","1",8.9,0,34,-1,31,26.2,1,5,-1,-2,0,5,4,2
"1464",2018-03-26,"Kebler","w1718","Hybrid",9,"Mon","weekday","sled","Kebler","2","1","1",8.9,0,34,-1,31,26.2,1,5,-1,-2,0,5,4,2
"1465",2018-03-27,"Kebler","w1718","Non.motorized",4,"Tue","weekday","no_sled","Kebler","1","1","1",8.9,0,33,-1,29,27,-1,1,5,-1,-2,-1,4,3
"1466",2018-03-27,"Kebler","w1718","Mechanized",1,"Tue","weekday","no_sled","Kebler","1","1","1",8.9,0,33,-1,29,27,-1,1,5,-1,-2,-1,4,3
"1467",2018-03-27,"Kebler","w1718","Motorized",54,"Tue","weekday","sled","Kebler","1","1","1",8.9,0,33,-1,29,27,-1,1,5,-1,-2,-1,4,3
"1468",2018-03-27,"Kebler","w1718","Hybrid",8,"Tue","weekday","sled","Kebler","1","1","1",8.9,0,33,-1,29,27,-1,1,5,-1,-2,-1,4,3
"1469",2018-03-28,"Kebler","w1718","Non.motorized",2,"Wed","weekday","no_sled","Kebler","1","1","1",8.9,0,33,0,27,27,-1,-1,1,5,-1,-2,-1,4
"1470",2018-03-28,"Kebler","w1718","Mechanized",0,"Wed","weekday","no_sled","Kebler","1","1","1",8.9,0,33,0,27,27,-1,-1,1,5,-1,-2,-1,4
"1471",2018-03-28,"Kebler","w1718","Motorized",58,"Wed","weekday","sled","Kebler","1","1","1",8.9,0,33,0,27,27,-1,-1,1,5,-1,-2,-1,4
"1472",2018-03-28,"Kebler","w1718","Hybrid",4,"Wed","weekday","sled","Kebler","1","1","1",8.9,0,33,0,27,27,-1,-1,1,5,-1,-2,-1,4
"1473",2018-03-29,"Kebler","w1718","Non.motorized",1,"Thu","weekday","no_sled","Kebler","1","1","1",8.9,0,33,0,27,27,0,-1,-1,1,0,-1,-2,-1
"1474",2018-03-29,"Kebler","w1718","Mechanized",4,"Thu","weekday","no_sled","Kebler","1","1","1",8.9,0,33,0,27,27,0,-1,-1,1,0,-1,-2,-1
"1475",2018-03-29,"Kebler","w1718","Motorized",69,"Thu","weekday","sled","Kebler","1","1","1",8.9,0,33,0,27,27,0,-1,-1,1,0,-1,-2,-1
"1476",2018-03-29,"Kebler","w1718","Hybrid",10,"Thu","weekday","sled","Kebler","1","1","1",8.9,0,33,0,27,27,0,-1,-1,1,0,-1,-2,-1
"1477",2018-03-30,"Kebler","w1718","Non.motorized",12,"Fri","weekday","no_sled","Kebler","1","1","1",8.9,0,32,-1,33,27.8,0,0,-1,-1,-1,-1,-2,-3
"1478",2018-03-30,"Kebler","w1718","Mechanized",0,"Fri","weekday","no_sled","Kebler","1","1","1",8.9,0,32,-1,33,27.8,0,0,-1,-1,-1,-1,-2,-3
"1479",2018-03-30,"Kebler","w1718","Motorized",83,"Fri","weekday","sled","Kebler","1","1","1",8.9,0,32,-1,33,27.8,0,0,-1,-1,-1,-1,-2,-3
"1480",2018-03-30,"Kebler","w1718","Hybrid",14,"Fri","weekday","sled","Kebler","1","1","1",8.9,0,32,-1,33,27.8,0,0,-1,-1,-1,-1,-2,-3
"1481",2018-03-31,"Kebler","w1718","Non.motorized",4,"Sat","weekend","no_sled","Kebler","1","1","1",8.9,0,32,0,39,27.8,-1,0,0,-1,-1,-1,-1,-2
"1482",2018-03-31,"Kebler","w1718","Mechanized",0,"Sat","weekend","no_sled","Kebler","1","1","1",8.9,0,32,0,39,27.8,-1,0,0,-1,-1,-1,-1,-2
"1483",2018-03-31,"Kebler","w1718","Motorized",78,"Sat","weekend","sled","Kebler","1","1","1",8.9,0,32,0,39,27.8,-1,0,0,-1,-1,-1,-1,-2
"1484",2018-03-31,"Kebler","w1718","Hybrid",14,"Sat","weekend","sled","Kebler","1","1","1",8.9,0,32,0,39,27.8,-1,0,0,-1,-1,-1,-1,-2
"1485",2018-04-01,"Kebler","w1718","Non.motorized",4,"Sun","weekend","no_sled","Kebler","1","1","1",8.8,-0.1,30,-2,41,29.3,0,-1,0,0,-2,-3,-3,-3
"1486",2018-04-01,"Kebler","w1718","Mechanized",0,"Sun","weekend","no_sled","Kebler","1","1","1",8.8,-0.1,30,-2,41,29.3,0,-1,0,0,-2,-3,-3,-3
"1487",2018-04-01,"Kebler","w1718","Motorized",37,"Sun","weekend","sled","Kebler","1","1","1",8.8,-0.1,30,-2,41,29.3,0,-1,0,0,-2,-3,-3,-3
"1488",2018-04-01,"Kebler","w1718","Hybrid",4,"Sun","weekend","sled","Kebler","1","1","1",8.8,-0.1,30,-2,41,29.3,0,-1,0,0,-2,-3,-3,-3
"1489",2018-04-02,"Kebler","w1718","Non.motorized",2,"Mon","weekday","no_sled","Kebler","1","1","1",8.7,-0.1,29,-1,39,30,-2,0,-1,0,-3,-3,-4,-4
"1490",2018-04-02,"Kebler","w1718","Mechanized",0,"Mon","weekday","no_sled","Kebler","1","1","1",8.7,-0.1,29,-1,39,30,-2,0,-1,0,-3,-3,-4,-4
"1491",2018-04-02,"Kebler","w1718","Motorized",47,"Mon","weekday","sled","Kebler","1","1","1",8.7,-0.1,29,-1,39,30,-2,0,-1,0,-3,-3,-4,-4
"1492",2018-04-02,"Kebler","w1718","Hybrid",7,"Mon","weekday","sled","Kebler","1","1","1",8.7,-0.1,29,-1,39,30,-2,0,-1,0,-3,-3,-4,-4
"1493",2018-04-03,"Kebler","w1718","Non.motorized",0,"Tue","weekday","no_sled","Kebler","1","1","1",8.8,0.1,30,1,27,29.3,-1,-2,0,-1,0,-2,-2,-3
"1494",2018-04-03,"Kebler","w1718","Mechanized",0,"Tue","weekday","no_sled","Kebler","1","1","1",8.8,0.1,30,1,27,29.3,-1,-2,0,-1,0,-2,-2,-3
"1495",2018-04-03,"Kebler","w1718","Motorized",54,"Tue","weekday","sled","Kebler","1","1","1",8.8,0.1,30,1,27,29.3,-1,-2,0,-1,0,-2,-2,-3
"1496",2018-04-03,"Kebler","w1718","Hybrid",4,"Tue","weekday","sled","Kebler","1","1","1",8.8,0.1,30,1,27,29.3,-1,-2,0,-1,0,-2,-2,-3
"1497",2018-04-04,"Kebler","w1718","Non.motorized",6,"Wed","weekday","no_sled","Kebler","1","2","2",8.9,0.1,28,-2,33,31.8,1,-1,-2,0,-1,-2,-4,-4
"1498",2018-04-04,"Kebler","w1718","Mechanized",0,"Wed","weekday","no_sled","Kebler","1","2","2",8.9,0.1,28,-2,33,31.8,1,-1,-2,0,-1,-2,-4,-4
"1499",2018-04-04,"Kebler","w1718","Motorized",65,"Wed","weekday","sled","Kebler","1","2","2",8.9,0.1,28,-2,33,31.8,1,-1,-2,0,-1,-2,-4,-4
"1500",2018-04-04,"Kebler","w1718","Hybrid",5,"Wed","weekday","sled","Kebler","1","2","2",8.9,0.1,28,-2,33,31.8,1,-1,-2,0,-1,-2,-4,-4
"1501",2018-04-05,"Kebler","w1718","Non.motorized",3,"Thu","weekday","no_sled","Kebler","1","2","2",8.9,0,27,-1,35,33,-2,1,-1,-2,-3,-2,-3,-5
"1502",2018-04-05,"Kebler","w1718","Mechanized",1,"Thu","weekday","no_sled","Kebler","1","2","2",8.9,0,27,-1,35,33,-2,1,-1,-2,-3,-2,-3,-5
"1503",2018-04-05,"Kebler","w1718","Motorized",57,"Thu","weekday","sled","Kebler","1","2","2",8.9,0,27,-1,35,33,-2,1,-1,-2,-3,-2,-3,-5
"1504",2018-04-05,"Kebler","w1718","Hybrid",4,"Thu","weekday","sled","Kebler","1","2","2",8.9,0,27,-1,35,33,-2,1,-1,-2,-3,-2,-3,-5
"1505",2018-04-06,"Kebler","w1718","Non.motorized",0,"Fri","weekday","no_sled","Kebler","1","2","2",8.9,0,25,-2,35,35.6,-1,-2,1,-1,-3,-5,-4,-5
"1506",2018-04-06,"Kebler","w1718","Mechanized",0,"Fri","weekday","no_sled","Kebler","1","2","2",8.9,0,25,-2,35,35.6,-1,-2,1,-1,-3,-5,-4,-5
"1507",2018-04-06,"Kebler","w1718","Motorized",86,"Fri","weekday","sled","Kebler","1","2","2",8.9,0,25,-2,35,35.6,-1,-2,1,-1,-3,-5,-4,-5
"1508",2018-04-06,"Kebler","w1718","Hybrid",3,"Fri","weekday","sled","Kebler","1","2","2",8.9,0,25,-2,35,35.6,-1,-2,1,-1,-3,-5,-4,-5
"1509",2018-04-07,"Kebler","w1718","Non.motorized",0,"Sat","weekend","no_sled","Kebler","2","2","2",9.2,0.3,31,6,37,29.7,-2,-1,-2,1,4,3,1,2
"1510",2018-04-07,"Kebler","w1718","Mechanized",0,"Sat","weekend","no_sled","Kebler","2","2","2",9.2,0.3,31,6,37,29.7,-2,-1,-2,1,4,3,1,2
"1511",2018-04-07,"Kebler","w1718","Motorized",50,"Sat","weekend","sled","Kebler","2","2","2",9.2,0.3,31,6,37,29.7,-2,-1,-2,1,4,3,1,2
"1512",2018-04-07,"Kebler","w1718","Hybrid",8,"Sat","weekend","sled","Kebler","2","2","2",9.2,0.3,31,6,37,29.7,-2,-1,-2,1,4,3,1,2
"1513",2018-04-08,"Kebler","w1718","Non.motorized",0,"Sun","weekend","no_sled","Kebler","3","3","3",10,0.8,33,2,33,30.3,6,-2,-1,-2,8,6,5,3
"1514",2018-04-08,"Kebler","w1718","Mechanized",1,"Sun","weekend","no_sled","Kebler","3","3","3",10,0.8,33,2,33,30.3,6,-2,-1,-2,8,6,5,3
"1515",2018-04-08,"Kebler","w1718","Motorized",40,"Sun","weekend","sled","Kebler","3","3","3",10,0.8,33,2,33,30.3,6,-2,-1,-2,8,6,5,3
"1516",2018-04-08,"Kebler","w1718","Hybrid",0,"Sun","weekend","sled","Kebler","3","3","3",10,0.8,33,2,33,30.3,6,-2,-1,-2,8,6,5,3
"1517",2018-04-09,"Kebler","w1718","Non.motorized",0,"Mon","weekday","no_sled","Kebler","1","1","1",10.1,0.1,33,0,31,30.6,2,6,-2,-1,2,8,6,5
"1518",2018-04-09,"Kebler","w1718","Mechanized",0,"Mon","weekday","no_sled","Kebler","1","1","1",10.1,0.1,33,0,31,30.6,2,6,-2,-1,2,8,6,5
"1519",2018-04-09,"Kebler","w1718","Motorized",11,"Mon","weekday","sled","Kebler","1","1","1",10.1,0.1,33,0,31,30.6,2,6,-2,-1,2,8,6,5
"1520",2018-04-09,"Kebler","w1718","Hybrid",3,"Mon","weekday","sled","Kebler","1","1","1",10.1,0.1,33,0,31,30.6,2,6,-2,-1,2,8,6,5
"1521",2017-12-22,"Slate River Rd","w1718","Non.motorized",14,"Fri","weekday","no_sled","Slate River Rd","2","2","1",2,0,11,3,17,18.2,0,0,0,0,3,3,3,3
"1522",2017-12-22,"Slate River Rd","w1718","Mechanized",1,"Fri","weekday","no_sled","Slate River Rd","2","2","1",2,0,11,3,17,18.2,0,0,0,0,3,3,3,3
"1523",2017-12-22,"Slate River Rd","w1718","Motorized",0,"Fri","weekday","sled","Slate River Rd","2","2","1",2,0,11,3,17,18.2,0,0,0,0,3,3,3,3
"1524",2017-12-22,"Slate River Rd","w1718","Hybrid",0,"Fri","weekday","sled","Slate River Rd","2","2","1",2,0,11,3,17,18.2,0,0,0,0,3,3,3,3
"1525",2017-12-23,"Slate River Rd","w1718","Non.motorized",5,"Sat","weekend","no_sled","Slate River Rd","2","1","1",2.1,0.1,10,-1,21,21,3,0,0,0,2,2,2,2
"1526",2017-12-23,"Slate River Rd","w1718","Mechanized",2,"Sat","weekend","no_sled","Slate River Rd","2","1","1",2.1,0.1,10,-1,21,21,3,0,0,0,2,2,2,2
"1527",2017-12-23,"Slate River Rd","w1718","Motorized",4,"Sat","weekend","sled","Slate River Rd","2","1","1",2.1,0.1,10,-1,21,21,3,0,0,0,2,2,2,2
"1528",2017-12-23,"Slate River Rd","w1718","Hybrid",0,"Sat","weekend","sled","Slate River Rd","2","1","1",2.1,0.1,10,-1,21,21,3,0,0,0,2,2,2,2
"1529",2017-12-24,"Slate River Rd","w1718","Non.motorized",7,"Sun","weekend","no_sled","Slate River Rd","1","1","1",2.4,0.3,14,4,19,17.1,-1,3,0,0,3,6,6,6
"1530",2017-12-24,"Slate River Rd","w1718","Mechanized",2,"Sun","weekend","no_sled","Slate River Rd","1","1","1",2.4,0.3,14,4,19,17.1,-1,3,0,0,3,6,6,6
"1531",2017-12-24,"Slate River Rd","w1718","Motorized",5,"Sun","weekend","sled","Slate River Rd","1","1","1",2.4,0.3,14,4,19,17.1,-1,3,0,0,3,6,6,6
"1532",2017-12-24,"Slate River Rd","w1718","Hybrid",2,"Sun","weekend","sled","Slate River Rd","1","1","1",2.4,0.3,14,4,19,17.1,-1,3,0,0,3,6,6,6
"1533",2017-12-25,"Slate River Rd","w1718","Non.motorized",18,"Mon","weekday","no_sled","Slate River Rd","2","1","1",2.6,0.2,14,0,25,18.6,4,-1,3,0,4,3,6,6
"1534",2017-12-25,"Slate River Rd","w1718","Mechanized",3,"Mon","weekday","no_sled","Slate River Rd","2","1","1",2.6,0.2,14,0,25,18.6,4,-1,3,0,4,3,6,6
"1535",2017-12-25,"Slate River Rd","w1718","Motorized",5,"Mon","weekday","sled","Slate River Rd","2","1","1",2.6,0.2,14,0,25,18.6,4,-1,3,0,4,3,6,6
"1536",2017-12-25,"Slate River Rd","w1718","Hybrid",3,"Mon","weekday","sled","Slate River Rd","2","1","1",2.6,0.2,14,0,25,18.6,4,-1,3,0,4,3,6,6
"1537",2017-12-26,"Slate River Rd","w1718","Non.motorized",30,"Tue","weekday","no_sled","Slate River Rd","1","1","1",3.1,0.5,20,6,25,15.5,0,4,-1,3,6,10,9,12
"1538",2017-12-26,"Slate River Rd","w1718","Mechanized",4,"Tue","weekday","no_sled","Slate River Rd","1","1","1",3.1,0.5,20,6,25,15.5,0,4,-1,3,6,10,9,12
"1539",2017-12-26,"Slate River Rd","w1718","Motorized",6,"Tue","weekday","sled","Slate River Rd","1","1","1",3.1,0.5,20,6,25,15.5,0,4,-1,3,6,10,9,12
"1540",2017-12-26,"Slate River Rd","w1718","Hybrid",5,"Tue","weekday","sled","Slate River Rd","1","1","1",3.1,0.5,20,6,25,15.5,0,4,-1,3,6,10,9,12
"1541",2017-12-27,"Slate River Rd","w1718","Non.motorized",71,"Wed","weekday","no_sled","Slate River Rd","1","1","1",3.1,0,18,-2,27,17.2,6,0,4,-1,4,4,8,7
"1542",2017-12-27,"Slate River Rd","w1718","Mechanized",0,"Wed","weekday","no_sled","Slate River Rd","1","1","1",3.1,0,18,-2,27,17.2,6,0,4,-1,4,4,8,7
"1543",2017-12-27,"Slate River Rd","w1718","Motorized",92,"Wed","weekday","sled","Slate River Rd","1","1","1",3.1,0,18,-2,27,17.2,6,0,4,-1,4,4,8,7
"1544",2017-12-27,"Slate River Rd","w1718","Hybrid",88,"Wed","weekday","sled","Slate River Rd","1","1","1",3.1,0,18,-2,27,17.2,6,0,4,-1,4,4,8,7
"1545",2017-12-28,"Slate River Rd","w1718","Non.motorized",66,"Thu","weekday","no_sled","Slate River Rd","1","1","1",3.2,0.1,17,-1,31,18.8,-2,6,0,4,-3,3,3,7
"1546",2017-12-28,"Slate River Rd","w1718","Mechanized",4,"Thu","weekday","no_sled","Slate River Rd","1","1","1",3.2,0.1,17,-1,31,18.8,-2,6,0,4,-3,3,3,7
"1547",2017-12-28,"Slate River Rd","w1718","Motorized",4,"Thu","weekday","sled","Slate River Rd","1","1","1",3.2,0.1,17,-1,31,18.8,-2,6,0,4,-3,3,3,7
"1548",2017-12-28,"Slate River Rd","w1718","Hybrid",1,"Thu","weekday","sled","Slate River Rd","1","1","1",3.2,0.1,17,-1,31,18.8,-2,6,0,4,-3,3,3,7
"1549",2017-12-29,"Slate River Rd","w1718","Non.motorized",50,"Fri","weekday","no_sled","Slate River Rd","1","1","1",3.2,0,17,0,36,18.8,-1,-2,6,0,-1,-3,3,3
"1550",2017-12-29,"Slate River Rd","w1718","Mechanized",0,"Fri","weekday","no_sled","Slate River Rd","1","1","1",3.2,0,17,0,36,18.8,-1,-2,6,0,-1,-3,3,3
"1551",2017-12-29,"Slate River Rd","w1718","Motorized",3,"Fri","weekday","sled","Slate River Rd","1","1","1",3.2,0,17,0,36,18.8,-1,-2,6,0,-1,-3,3,3
"1552",2017-12-29,"Slate River Rd","w1718","Hybrid",2,"Fri","weekday","sled","Slate River Rd","1","1","1",3.2,0,17,0,36,18.8,-1,-2,6,0,-1,-3,3,3
"1553",2017-12-30,"Slate River Rd","w1718","Non.motorized",65,"Sat","weekend","no_sled","Slate River Rd","1","1","1",3.2,0,15,-2,37,21.3,0,-1,-2,6,-2,-3,-5,1
"1554",2017-12-30,"Slate River Rd","w1718","Mechanized",8,"Sat","weekend","no_sled","Slate River Rd","1","1","1",3.2,0,15,-2,37,21.3,0,-1,-2,6,-2,-3,-5,1
"1555",2017-12-30,"Slate River Rd","w1718","Motorized",13,"Sat","weekend","sled","Slate River Rd","1","1","1",3.2,0,15,-2,37,21.3,0,-1,-2,6,-2,-3,-5,1
"1556",2017-12-30,"Slate River Rd","w1718","Hybrid",9,"Sat","weekend","sled","Slate River Rd","1","1","1",3.2,0,15,-2,37,21.3,0,-1,-2,6,-2,-3,-5,1
"1557",2017-12-31,"Slate River Rd","w1718","Non.motorized",78,"Sun","weekend","no_sled","Slate River Rd","1","1","1",3.2,0,15,0,31,21.3,-2,0,-1,-2,-2,-2,-3,-5
"1558",2017-12-31,"Slate River Rd","w1718","Mechanized",2,"Sun","weekend","no_sled","Slate River Rd","1","1","1",3.2,0,15,0,31,21.3,-2,0,-1,-2,-2,-2,-3,-5
"1559",2017-12-31,"Slate River Rd","w1718","Motorized",20,"Sun","weekend","sled","Slate River Rd","1","1","1",3.2,0,15,0,31,21.3,-2,0,-1,-2,-2,-2,-3,-5
"1560",2017-12-31,"Slate River Rd","w1718","Hybrid",4,"Sun","weekend","sled","Slate River Rd","1","1","1",3.2,0,15,0,31,21.3,-2,0,-1,-2,-2,-2,-3,-5
"1561",2018-01-01,"Slate River Rd","w1718","Non.motorized",63,"Mon","weekday","no_sled","Slate River Rd","1","1","1",3.2,0,15,0,27,21.3,0,-2,0,-1,0,-2,-2,-3
"1562",2018-01-01,"Slate River Rd","w1718","Mechanized",7,"Mon","weekday","no_sled","Slate River Rd","1","1","1",3.2,0,15,0,27,21.3,0,-2,0,-1,0,-2,-2,-3
"1563",2018-01-01,"Slate River Rd","w1718","Motorized",26,"Mon","weekday","sled","Slate River Rd","1","1","1",3.2,0,15,0,27,21.3,0,-2,0,-1,0,-2,-2,-3
"1564",2018-01-01,"Slate River Rd","w1718","Hybrid",14,"Mon","weekday","sled","Slate River Rd","1","1","1",3.2,0,15,0,27,21.3,0,-2,0,-1,0,-2,-2,-3
"1565",2018-01-02,"Slate River Rd","w1718","Non.motorized",29,"Tue","weekday","no_sled","Slate River Rd","1","1","1",3.2,0,15,0,22,21.3,0,0,-2,0,0,0,-2,-2
"1566",2018-01-02,"Slate River Rd","w1718","Mechanized",3,"Tue","weekday","no_sled","Slate River Rd","1","1","1",3.2,0,15,0,22,21.3,0,0,-2,0,0,0,-2,-2
"1567",2018-01-02,"Slate River Rd","w1718","Motorized",17,"Tue","weekday","sled","Slate River Rd","1","1","1",3.2,0,15,0,22,21.3,0,0,-2,0,0,0,-2,-2
"1568",2018-01-02,"Slate River Rd","w1718","Hybrid",11,"Tue","weekday","sled","Slate River Rd","1","1","1",3.2,0,15,0,22,21.3,0,0,-2,0,0,0,-2,-2
"1569",2018-01-03,"Slate River Rd","w1718","Non.motorized",26,"Wed","weekday","no_sled","Slate River Rd","1","1","1",3.2,0,15,0,27,21.3,0,0,0,-2,0,0,0,-2
"1570",2018-01-03,"Slate River Rd","w1718","Mechanized",4,"Wed","weekday","no_sled","Slate River Rd","1","1","1",3.2,0,15,0,27,21.3,0,0,0,-2,0,0,0,-2
"1571",2018-01-03,"Slate River Rd","w1718","Motorized",14,"Wed","weekday","sled","Slate River Rd","1","1","1",3.2,0,15,0,27,21.3,0,0,0,-2,0,0,0,-2
"1572",2018-01-03,"Slate River Rd","w1718","Hybrid",4,"Wed","weekday","sled","Slate River Rd","1","1","1",3.2,0,15,0,27,21.3,0,0,0,-2,0,0,0,-2
"1573",2018-01-04,"Slate River Rd","w1718","Non.motorized",19,"Thu","weekday","no_sled","Slate River Rd","1","1","1",3.2,0,15,0,29,21.3,0,0,0,0,0,0,0,0
"1574",2018-01-04,"Slate River Rd","w1718","Mechanized",5,"Thu","weekday","no_sled","Slate River Rd","1","1","1",3.2,0,15,0,29,21.3,0,0,0,0,0,0,0,0
"1575",2018-01-04,"Slate River Rd","w1718","Motorized",17,"Thu","weekday","sled","Slate River Rd","1","1","1",3.2,0,15,0,29,21.3,0,0,0,0,0,0,0,0
"1576",2018-01-04,"Slate River Rd","w1718","Hybrid",4,"Thu","weekday","sled","Slate River Rd","1","1","1",3.2,0,15,0,29,21.3,0,0,0,0,0,0,0,0
"1577",2018-01-05,"Slate River Rd","w1718","Non.motorized",25,"Fri","weekday","no_sled","Slate River Rd","1","1","1",3.2,0,14,-1,32,22.9,0,0,0,0,-1,-1,-1,-1
"1578",2018-01-05,"Slate River Rd","w1718","Mechanized",3,"Fri","weekday","no_sled","Slate River Rd","1","1","1",3.2,0,14,-1,32,22.9,0,0,0,0,-1,-1,-1,-1
"1579",2018-01-05,"Slate River Rd","w1718","Motorized",18,"Fri","weekday","sled","Slate River Rd","1","1","1",3.2,0,14,-1,32,22.9,0,0,0,0,-1,-1,-1,-1
"1580",2018-01-05,"Slate River Rd","w1718","Hybrid",2,"Fri","weekday","sled","Slate River Rd","1","1","1",3.2,0,14,-1,32,22.9,0,0,0,0,-1,-1,-1,-1
"1581",2018-01-06,"Slate River Rd","w1718","Non.motorized",20,"Sat","weekend","no_sled","Slate River Rd","1","1","1",3.2,0,14,0,30,22.9,-1,0,0,0,-1,-1,-1,-1
"1582",2018-01-06,"Slate River Rd","w1718","Mechanized",6,"Sat","weekend","no_sled","Slate River Rd","1","1","1",3.2,0,14,0,30,22.9,-1,0,0,0,-1,-1,-1,-1
"1583",2018-01-06,"Slate River Rd","w1718","Motorized",24,"Sat","weekend","sled","Slate River Rd","1","1","1",3.2,0,14,0,30,22.9,-1,0,0,0,-1,-1,-1,-1
"1584",2018-01-06,"Slate River Rd","w1718","Hybrid",6,"Sat","weekend","sled","Slate River Rd","1","1","1",3.2,0,14,0,30,22.9,-1,0,0,0,-1,-1,-1,-1
"1585",2018-01-07,"Slate River Rd","w1718","Non.motorized",NA,"Sun","weekend","no_sled","Slate River Rd","2","2","2",3.5,0.3,18,4,25,19.4,0,-1,0,0,4,3,3,3
"1586",2018-01-07,"Slate River Rd","w1718","Mechanized",NA,"Sun","weekend","no_sled","Slate River Rd","2","2","2",3.5,0.3,18,4,25,19.4,0,-1,0,0,4,3,3,3
"1587",2018-01-07,"Slate River Rd","w1718","Motorized",NA,"Sun","weekend","sled","Slate River Rd","2","2","2",3.5,0.3,18,4,25,19.4,0,-1,0,0,4,3,3,3
"1588",2018-01-07,"Slate River Rd","w1718","Hybrid",NA,"Sun","weekend","sled","Slate River Rd","2","2","2",3.5,0.3,18,4,25,19.4,0,-1,0,0,4,3,3,3
"1589",2018-01-08,"Slate River Rd","w1718","Non.motorized",NA,"Mon","weekday","no_sled","Slate River Rd","2","2","1",3.7,0.2,20,2,29,18.5,4,0,-1,0,6,6,5,5
"1590",2018-01-08,"Slate River Rd","w1718","Mechanized",NA,"Mon","weekday","no_sled","Slate River Rd","2","2","1",3.7,0.2,20,2,29,18.5,4,0,-1,0,6,6,5,5
"1591",2018-01-08,"Slate River Rd","w1718","Motorized",NA,"Mon","weekday","sled","Slate River Rd","2","2","1",3.7,0.2,20,2,29,18.5,4,0,-1,0,6,6,5,5
"1592",2018-01-08,"Slate River Rd","w1718","Hybrid",NA,"Mon","weekday","sled","Slate River Rd","2","2","1",3.7,0.2,20,2,29,18.5,4,0,-1,0,6,6,5,5
"1593",2018-01-09,"Slate River Rd","w1718","Non.motorized",NA,"Tue","weekday","no_sled","Slate River Rd","2","2","1",3.8,0.1,21,1,34,18.1,2,4,0,-1,3,7,7,6
"1594",2018-01-09,"Slate River Rd","w1718","Mechanized",NA,"Tue","weekday","no_sled","Slate River Rd","2","2","1",3.8,0.1,21,1,34,18.1,2,4,0,-1,3,7,7,6
"1595",2018-01-09,"Slate River Rd","w1718","Motorized",NA,"Tue","weekday","sled","Slate River Rd","2","2","1",3.8,0.1,21,1,34,18.1,2,4,0,-1,3,7,7,6
"1596",2018-01-09,"Slate River Rd","w1718","Hybrid",NA,"Tue","weekday","sled","Slate River Rd","2","2","1",3.8,0.1,21,1,34,18.1,2,4,0,-1,3,7,7,6
"1597",2018-01-10,"Slate River Rd","w1718","Non.motorized",NA,"Wed","weekday","no_sled","Slate River Rd","3","3","3",4,0.2,21,0,28,19,1,2,4,0,1,3,7,7
"1598",2018-01-10,"Slate River Rd","w1718","Mechanized",NA,"Wed","weekday","no_sled","Slate River Rd","3","3","3",4,0.2,21,0,28,19,1,2,4,0,1,3,7,7
"1599",2018-01-10,"Slate River Rd","w1718","Motorized",NA,"Wed","weekday","sled","Slate River Rd","3","3","3",4,0.2,21,0,28,19,1,2,4,0,1,3,7,7
"1600",2018-01-10,"Slate River Rd","w1718","Hybrid",NA,"Wed","weekday","sled","Slate River Rd","3","3","3",4,0.2,21,0,28,19,1,2,4,0,1,3,7,7
"1601",2018-01-11,"Slate River Rd","w1718","Non.motorized",3,"Thu","weekday","no_sled","Slate River Rd","3","3","3",4.1,0.1,26,5,17,15.8,0,1,2,4,5,6,8,12
"1602",2018-01-11,"Slate River Rd","w1718","Mechanized",0,"Thu","weekday","no_sled","Slate River Rd","3","3","3",4.1,0.1,26,5,17,15.8,0,1,2,4,5,6,8,12
"1603",2018-01-11,"Slate River Rd","w1718","Motorized",2,"Thu","weekday","sled","Slate River Rd","3","3","3",4.1,0.1,26,5,17,15.8,0,1,2,4,5,6,8,12
"1604",2018-01-11,"Slate River Rd","w1718","Hybrid",1,"Thu","weekday","sled","Slate River Rd","3","3","3",4.1,0.1,26,5,17,15.8,0,1,2,4,5,6,8,12
"1605",2018-01-12,"Slate River Rd","w1718","Non.motorized",3,"Fri","weekday","no_sled","Slate River Rd","3","3","3",4.3,0.2,24,-2,22,17.9,5,0,1,2,3,3,4,6
"1606",2018-01-12,"Slate River Rd","w1718","Mechanized",0,"Fri","weekday","no_sled","Slate River Rd","3","3","3",4.3,0.2,24,-2,22,17.9,5,0,1,2,3,3,4,6
"1607",2018-01-12,"Slate River Rd","w1718","Motorized",4,"Fri","weekday","sled","Slate River Rd","3","3","3",4.3,0.2,24,-2,22,17.9,5,0,1,2,3,3,4,6
"1608",2018-01-12,"Slate River Rd","w1718","Hybrid",3,"Fri","weekday","sled","Slate River Rd","3","3","3",4.3,0.2,24,-2,22,17.9,5,0,1,2,3,3,4,6
"1609",2018-01-13,"Slate River Rd","w1718","Non.motorized",34,"Sat","weekend","no_sled","Slate River Rd","3","3","3",4.4,0.1,24,0,24,18.3,-2,5,0,1,-2,3,3,4
"1610",2018-01-13,"Slate River Rd","w1718","Mechanized",2,"Sat","weekend","no_sled","Slate River Rd","3","3","3",4.4,0.1,24,0,24,18.3,-2,5,0,1,-2,3,3,4
"1611",2018-01-13,"Slate River Rd","w1718","Motorized",18,"Sat","weekend","sled","Slate River Rd","3","3","3",4.4,0.1,24,0,24,18.3,-2,5,0,1,-2,3,3,4
"1612",2018-01-13,"Slate River Rd","w1718","Hybrid",15,"Sat","weekend","sled","Slate River Rd","3","3","3",4.4,0.1,24,0,24,18.3,-2,5,0,1,-2,3,3,4
"1613",2018-01-14,"Slate River Rd","w1718","Non.motorized",39,"Sun","weekend","no_sled","Slate River Rd","3","3","2",4.4,0,24,0,27,18.3,0,-2,5,0,0,-2,3,3
"1614",2018-01-14,"Slate River Rd","w1718","Mechanized",0,"Sun","weekend","no_sled","Slate River Rd","3","3","2",4.4,0,24,0,27,18.3,0,-2,5,0,0,-2,3,3
"1615",2018-01-14,"Slate River Rd","w1718","Motorized",18,"Sun","weekend","sled","Slate River Rd","3","3","2",4.4,0,24,0,27,18.3,0,-2,5,0,0,-2,3,3
"1616",2018-01-14,"Slate River Rd","w1718","Hybrid",13,"Sun","weekend","sled","Slate River Rd","3","3","2",4.4,0,24,0,27,18.3,0,-2,5,0,0,-2,3,3
"1617",2018-01-15,"Slate River Rd","w1718","Non.motorized",12,"Mon","weekday","no_sled","Slate River Rd","3","3","2",4.4,0,23,-1,27,19.1,0,0,-2,5,-1,-1,-3,2
"1618",2018-01-15,"Slate River Rd","w1718","Mechanized",0,"Mon","weekday","no_sled","Slate River Rd","3","3","2",4.4,0,23,-1,27,19.1,0,0,-2,5,-1,-1,-3,2
"1619",2018-01-15,"Slate River Rd","w1718","Motorized",8,"Mon","weekday","sled","Slate River Rd","3","3","2",4.4,0,23,-1,27,19.1,0,0,-2,5,-1,-1,-3,2
"1620",2018-01-15,"Slate River Rd","w1718","Hybrid",7,"Mon","weekday","sled","Slate River Rd","3","3","2",4.4,0,23,-1,27,19.1,0,0,-2,5,-1,-1,-3,2
"1621",2018-01-16,"Slate River Rd","w1718","Non.motorized",11,"Tue","weekday","no_sled","Slate River Rd","3","3","2",4.4,0,22,-1,20,20,-1,0,0,-2,-2,-2,-2,-4
"1622",2018-01-16,"Slate River Rd","w1718","Mechanized",0,"Tue","weekday","no_sled","Slate River Rd","3","3","2",4.4,0,22,-1,20,20,-1,0,0,-2,-2,-2,-2,-4
"1623",2018-01-16,"Slate River Rd","w1718","Motorized",10,"Tue","weekday","sled","Slate River Rd","3","3","2",4.4,0,22,-1,20,20,-1,0,0,-2,-2,-2,-2,-4
"1624",2018-01-16,"Slate River Rd","w1718","Hybrid",9,"Tue","weekday","sled","Slate River Rd","3","3","2",4.4,0,22,-1,20,20,-1,0,0,-2,-2,-2,-2,-4
"1625",2018-01-17,"Slate River Rd","w1718","Non.motorized",10,"Wed","weekday","no_sled","Slate River Rd","2","2","2",4.4,0,22,0,24,20,-1,-1,0,0,-1,-2,-2,-2
"1626",2018-01-17,"Slate River Rd","w1718","Mechanized",0,"Wed","weekday","no_sled","Slate River Rd","2","2","2",4.4,0,22,0,24,20,-1,-1,0,0,-1,-2,-2,-2
"1627",2018-01-17,"Slate River Rd","w1718","Motorized",0,"Wed","weekday","sled","Slate River Rd","2","2","2",4.4,0,22,0,24,20,-1,-1,0,0,-1,-2,-2,-2
"1628",2018-01-17,"Slate River Rd","w1718","Hybrid",0,"Wed","weekday","sled","Slate River Rd","2","2","2",4.4,0,22,0,24,20,-1,-1,0,0,-1,-2,-2,-2
"1629",2018-01-18,"Slate River Rd","w1718","Non.motorized",13,"Thu","weekday","no_sled","Slate River Rd","2","2","2",4.4,0,21,-1,29,21,0,-1,-1,0,-1,-2,-3,-3
"1630",2018-01-18,"Slate River Rd","w1718","Mechanized",0,"Thu","weekday","no_sled","Slate River Rd","2","2","2",4.4,0,21,-1,29,21,0,-1,-1,0,-1,-2,-3,-3
"1631",2018-01-18,"Slate River Rd","w1718","Motorized",2,"Thu","weekday","sled","Slate River Rd","2","2","2",4.4,0,21,-1,29,21,0,-1,-1,0,-1,-2,-3,-3
"1632",2018-01-18,"Slate River Rd","w1718","Hybrid",2,"Thu","weekday","sled","Slate River Rd","2","2","2",4.4,0,21,-1,29,21,0,-1,-1,0,-1,-2,-3,-3
"1633",2018-01-19,"Slate River Rd","w1718","Non.motorized",30,"Fri","weekday","no_sled","Slate River Rd","2","2","2",4.5,0.1,21,0,34,21.4,-1,0,-1,-1,-1,-1,-2,-3
"1634",2018-01-19,"Slate River Rd","w1718","Mechanized",0,"Fri","weekday","no_sled","Slate River Rd","2","2","2",4.5,0.1,21,0,34,21.4,-1,0,-1,-1,-1,-1,-2,-3
"1635",2018-01-19,"Slate River Rd","w1718","Motorized",2,"Fri","weekday","sled","Slate River Rd","2","2","2",4.5,0.1,21,0,34,21.4,-1,0,-1,-1,-1,-1,-2,-3
"1636",2018-01-19,"Slate River Rd","w1718","Hybrid",2,"Fri","weekday","sled","Slate River Rd","2","2","2",4.5,0.1,21,0,34,21.4,-1,0,-1,-1,-1,-1,-2,-3
"1637",2018-01-20,"Slate River Rd","w1718","Non.motorized",34,"Sat","weekend","no_sled","Slate River Rd","2","2","2",4.5,0,21,0,32,21.4,0,-1,0,-1,0,-1,-1,-2
"1638",2018-01-20,"Slate River Rd","w1718","Mechanized",0,"Sat","weekend","no_sled","Slate River Rd","2","2","2",4.5,0,21,0,32,21.4,0,-1,0,-1,0,-1,-1,-2
"1639",2018-01-20,"Slate River Rd","w1718","Motorized",17,"Sat","weekend","sled","Slate River Rd","2","2","2",4.5,0,21,0,32,21.4,0,-1,0,-1,0,-1,-1,-2
"1640",2018-01-20,"Slate River Rd","w1718","Hybrid",17,"Sat","weekend","sled","Slate River Rd","2","2","2",4.5,0,21,0,32,21.4,0,-1,0,-1,0,-1,-1,-2
"1641",2018-01-21,"Slate River Rd","w1718","Non.motorized",5,"Sun","weekend","no_sled","Slate River Rd","3","3","3",4.6,0.1,23,2,15,20,0,0,-1,0,2,2,1,1
"1642",2018-01-21,"Slate River Rd","w1718","Mechanized",0,"Sun","weekend","no_sled","Slate River Rd","3","3","3",4.6,0.1,23,2,15,20,0,0,-1,0,2,2,1,1
"1643",2018-01-21,"Slate River Rd","w1718","Motorized",0,"Sun","weekend","sled","Slate River Rd","3","3","3",4.6,0.1,23,2,15,20,0,0,-1,0,2,2,1,1
"1644",2018-01-21,"Slate River Rd","w1718","Hybrid",0,"Sun","weekend","sled","Slate River Rd","3","3","3",4.6,0.1,23,2,15,20,0,0,-1,0,2,2,1,1
"1645",2018-01-22,"Slate River Rd","w1718","Non.motorized",19,"Mon","weekday","no_sled","Slate River Rd","3","3","3",4.6,0,21,-2,12,21.9,2,0,0,-1,0,0,0,-1
"1646",2018-01-22,"Slate River Rd","w1718","Mechanized",0,"Mon","weekday","no_sled","Slate River Rd","3","3","3",4.6,0,21,-2,12,21.9,2,0,0,-1,0,0,0,-1
"1647",2018-01-22,"Slate River Rd","w1718","Motorized",6,"Mon","weekday","sled","Slate River Rd","3","3","3",4.6,0,21,-2,12,21.9,2,0,0,-1,0,0,0,-1
"1648",2018-01-22,"Slate River Rd","w1718","Hybrid",6,"Mon","weekday","sled","Slate River Rd","3","3","3",4.6,0,21,-2,12,21.9,2,0,0,-1,0,0,0,-1
"1649",2018-01-23,"Slate River Rd","w1718","Non.motorized",9,"Tue","weekday","no_sled","Slate River Rd","3","3","3",4.6,0,22,1,16,20.9,-2,2,0,0,-1,1,1,1
"1650",2018-01-23,"Slate River Rd","w1718","Mechanized",0,"Tue","weekday","no_sled","Slate River Rd","3","3","3",4.6,0,22,1,16,20.9,-2,2,0,0,-1,1,1,1
"1651",2018-01-23,"Slate River Rd","w1718","Motorized",7,"Tue","weekday","sled","Slate River Rd","3","3","3",4.6,0,22,1,16,20.9,-2,2,0,0,-1,1,1,1
"1652",2018-01-23,"Slate River Rd","w1718","Hybrid",7,"Tue","weekday","sled","Slate River Rd","3","3","3",4.6,0,22,1,16,20.9,-2,2,0,0,-1,1,1,1
"1653",2018-01-24,"Slate River Rd","w1718","Non.motorized",12,"Wed","weekday","no_sled","Slate River Rd","2","2","2",4.6,0,22,0,22,20.9,1,-2,2,0,1,-1,1,1
"1654",2018-01-24,"Slate River Rd","w1718","Mechanized",0,"Wed","weekday","no_sled","Slate River Rd","2","2","2",4.6,0,22,0,22,20.9,1,-2,2,0,1,-1,1,1
"1655",2018-01-24,"Slate River Rd","w1718","Motorized",0,"Wed","weekday","sled","Slate River Rd","2","2","2",4.6,0,22,0,22,20.9,1,-2,2,0,1,-1,1,1
"1656",2018-01-24,"Slate River Rd","w1718","Hybrid",0,"Wed","weekday","sled","Slate River Rd","2","2","2",4.6,0,22,0,22,20.9,1,-2,2,0,1,-1,1,1
"1657",2018-01-25,"Slate River Rd","w1718","Non.motorized",21,"Thu","weekday","no_sled","Slate River Rd","2","2","2",4.6,0,22,0,28,20.9,0,1,-2,2,0,1,-1,1
"1658",2018-01-25,"Slate River Rd","w1718","Mechanized",0,"Thu","weekday","no_sled","Slate River Rd","2","2","2",4.6,0,22,0,28,20.9,0,1,-2,2,0,1,-1,1
"1659",2018-01-25,"Slate River Rd","w1718","Motorized",9,"Thu","weekday","sled","Slate River Rd","2","2","2",4.6,0,22,0,28,20.9,0,1,-2,2,0,1,-1,1
"1660",2018-01-25,"Slate River Rd","w1718","Hybrid",9,"Thu","weekday","sled","Slate River Rd","2","2","2",4.6,0,22,0,28,20.9,0,1,-2,2,0,1,-1,1
"1661",2018-01-26,"Slate River Rd","w1718","Non.motorized",4,"Fri","weekday","no_sled","Slate River Rd","2","2","2",4.7,0.1,22,0,15,21.4,0,0,1,-2,0,0,1,-1
"1662",2018-01-26,"Slate River Rd","w1718","Mechanized",0,"Fri","weekday","no_sled","Slate River Rd","2","2","2",4.7,0.1,22,0,15,21.4,0,0,1,-2,0,0,1,-1
"1663",2018-01-26,"Slate River Rd","w1718","Motorized",1,"Fri","weekday","sled","Slate River Rd","2","2","2",4.7,0.1,22,0,15,21.4,0,0,1,-2,0,0,1,-1
"1664",2018-01-26,"Slate River Rd","w1718","Hybrid",1,"Fri","weekday","sled","Slate River Rd","2","2","2",4.7,0.1,22,0,15,21.4,0,0,1,-2,0,0,1,-1
"1665",2018-01-27,"Slate River Rd","w1718","Non.motorized",34,"Sat","weekend","no_sled","Slate River Rd","2","2","2",4.7,0,23,1,16,20.4,0,0,0,1,1,1,1,2
"1666",2018-01-27,"Slate River Rd","w1718","Mechanized",1,"Sat","weekend","no_sled","Slate River Rd","2","2","2",4.7,0,23,1,16,20.4,0,0,0,1,1,1,1,2
"1667",2018-01-27,"Slate River Rd","w1718","Motorized",19,"Sat","weekend","sled","Slate River Rd","2","2","2",4.7,0,23,1,16,20.4,0,0,0,1,1,1,1,2
"1668",2018-01-27,"Slate River Rd","w1718","Hybrid",17,"Sat","weekend","sled","Slate River Rd","2","2","2",4.7,0,23,1,16,20.4,0,0,0,1,1,1,1,2
"1669",2018-01-28,"Slate River Rd","w1718","Non.motorized",41,"Sun","weekend","no_sled","Slate River Rd","2","2","2",4.7,0,23,0,25,20.4,1,0,0,0,1,1,1,1
"1670",2018-01-28,"Slate River Rd","w1718","Mechanized",2,"Sun","weekend","no_sled","Slate River Rd","2","2","2",4.7,0,23,0,25,20.4,1,0,0,0,1,1,1,1
"1671",2018-01-28,"Slate River Rd","w1718","Motorized",17,"Sun","weekend","sled","Slate River Rd","2","2","2",4.7,0,23,0,25,20.4,1,0,0,0,1,1,1,1
"1672",2018-01-28,"Slate River Rd","w1718","Hybrid",17,"Sun","weekend","sled","Slate River Rd","2","2","2",4.7,0,23,0,25,20.4,1,0,0,0,1,1,1,1
"1673",2018-01-29,"Slate River Rd","w1718","Non.motorized",21,"Mon","weekday","no_sled","Slate River Rd","2","2","2",4.8,0.1,22,-1,30,21.8,0,1,0,0,-1,0,0,0
"1674",2018-01-29,"Slate River Rd","w1718","Mechanized",0,"Mon","weekday","no_sled","Slate River Rd","2","2","2",4.8,0.1,22,-1,30,21.8,0,1,0,0,-1,0,0,0
"1675",2018-01-29,"Slate River Rd","w1718","Motorized",8,"Mon","weekday","sled","Slate River Rd","2","2","2",4.8,0.1,22,-1,30,21.8,0,1,0,0,-1,0,0,0
"1676",2018-01-29,"Slate River Rd","w1718","Hybrid",7,"Mon","weekday","sled","Slate River Rd","2","2","2",4.8,0.1,22,-1,30,21.8,0,1,0,0,-1,0,0,0
"1677",2018-01-30,"Slate River Rd","w1718","Non.motorized",19,"Tue","weekday","no_sled","Slate River Rd","2","2","2",4.8,0,22,0,34,21.8,-1,0,1,0,-1,-1,0,0
"1678",2018-01-30,"Slate River Rd","w1718","Mechanized",0,"Tue","weekday","no_sled","Slate River Rd","2","2","2",4.8,0,22,0,34,21.8,-1,0,1,0,-1,-1,0,0
"1679",2018-01-30,"Slate River Rd","w1718","Motorized",7,"Tue","weekday","sled","Slate River Rd","2","2","2",4.8,0,22,0,34,21.8,-1,0,1,0,-1,-1,0,0
"1680",2018-01-30,"Slate River Rd","w1718","Hybrid",7,"Tue","weekday","sled","Slate River Rd","2","2","2",4.8,0,22,0,34,21.8,-1,0,1,0,-1,-1,0,0
"1681",2018-01-31,"Slate River Rd","w1718","Non.motorized",13,"Wed","weekday","no_sled","Slate River Rd","2","2","2",4.8,0,22,0,34,21.8,0,-1,0,1,0,-1,-1,0
"1682",2018-01-31,"Slate River Rd","w1718","Mechanized",0,"Wed","weekday","no_sled","Slate River Rd","2","2","2",4.8,0,22,0,34,21.8,0,-1,0,1,0,-1,-1,0
"1683",2018-01-31,"Slate River Rd","w1718","Motorized",2,"Wed","weekday","sled","Slate River Rd","2","2","2",4.8,0,22,0,34,21.8,0,-1,0,1,0,-1,-1,0
"1684",2018-01-31,"Slate River Rd","w1718","Hybrid",2,"Wed","weekday","sled","Slate River Rd","2","2","2",4.8,0,22,0,34,21.8,0,-1,0,1,0,-1,-1,0
"1685",2018-02-01,"Slate River Rd","w1718","Non.motorized",16,"Thu","weekday","no_sled","Slate River Rd","2","2","2",4.9,0.1,21,-1,32,23.3,0,0,-1,0,-1,-1,-2,-2
"1686",2018-02-01,"Slate River Rd","w1718","Mechanized",0,"Thu","weekday","no_sled","Slate River Rd","2","2","2",4.9,0.1,21,-1,32,23.3,0,0,-1,0,-1,-1,-2,-2
"1687",2018-02-01,"Slate River Rd","w1718","Motorized",7,"Thu","weekday","sled","Slate River Rd","2","2","2",4.9,0.1,21,-1,32,23.3,0,0,-1,0,-1,-1,-2,-2
"1688",2018-02-01,"Slate River Rd","w1718","Hybrid",6,"Thu","weekday","sled","Slate River Rd","2","2","2",4.9,0.1,21,-1,32,23.3,0,0,-1,0,-1,-1,-2,-2
"1689",2018-02-02,"Slate River Rd","w1718","Non.motorized",11,"Fri","weekday","no_sled","Slate River Rd","2","2","2",4.9,0,20,-1,33,24.5,-1,0,0,-1,-2,-2,-2,-3
"1690",2018-02-02,"Slate River Rd","w1718","Mechanized",2,"Fri","weekday","no_sled","Slate River Rd","2","2","2",4.9,0,20,-1,33,24.5,-1,0,0,-1,-2,-2,-2,-3
"1691",2018-02-02,"Slate River Rd","w1718","Motorized",8,"Fri","weekday","sled","Slate River Rd","2","2","2",4.9,0,20,-1,33,24.5,-1,0,0,-1,-2,-2,-2,-3
"1692",2018-02-02,"Slate River Rd","w1718","Hybrid",8,"Fri","weekday","sled","Slate River Rd","2","2","2",4.9,0,20,-1,33,24.5,-1,0,0,-1,-2,-2,-2,-3
"1693",2018-02-03,"Slate River Rd","w1718","Non.motorized",42,"Sat","weekend","no_sled","Slate River Rd","2","2","2",4.9,0,21,1,32,23.3,-1,-1,0,0,0,-1,-1,-1
"1694",2018-02-03,"Slate River Rd","w1718","Mechanized",2,"Sat","weekend","no_sled","Slate River Rd","2","2","2",4.9,0,21,1,32,23.3,-1,-1,0,0,0,-1,-1,-1
"1695",2018-02-03,"Slate River Rd","w1718","Motorized",7,"Sat","weekend","sled","Slate River Rd","2","2","2",4.9,0,21,1,32,23.3,-1,-1,0,0,0,-1,-1,-1
"1696",2018-02-03,"Slate River Rd","w1718","Hybrid",3,"Sat","weekend","sled","Slate River Rd","2","2","2",4.9,0,21,1,32,23.3,-1,-1,0,0,0,-1,-1,-1
"1697",2018-02-04,"Slate River Rd","w1718","Non.motorized",54,"Sun","weekend","no_sled","Slate River Rd","2","2","2",4.9,0,19,-2,32,25.8,1,-1,-1,0,-1,-2,-3,-3
"1698",2018-02-04,"Slate River Rd","w1718","Mechanized",4,"Sun","weekend","no_sled","Slate River Rd","2","2","2",4.9,0,19,-2,32,25.8,1,-1,-1,0,-1,-2,-3,-3
"1699",2018-02-04,"Slate River Rd","w1718","Motorized",10,"Sun","weekend","sled","Slate River Rd","2","2","2",4.9,0,19,-2,32,25.8,1,-1,-1,0,-1,-2,-3,-3
"1700",2018-02-04,"Slate River Rd","w1718","Hybrid",9,"Sun","weekend","sled","Slate River Rd","2","2","2",4.9,0,19,-2,32,25.8,1,-1,-1,0,-1,-2,-3,-3
"1701",2018-02-05,"Slate River Rd","w1718","Non.motorized",37,"Mon","weekday","no_sled","Slate River Rd","2","2","2",5,0.1,18,-1,29,27.8,-2,1,-1,-1,-3,-2,-3,-4
"1702",2018-02-05,"Slate River Rd","w1718","Mechanized",0,"Mon","weekday","no_sled","Slate River Rd","2","2","2",5,0.1,18,-1,29,27.8,-2,1,-1,-1,-3,-2,-3,-4
"1703",2018-02-05,"Slate River Rd","w1718","Motorized",5,"Mon","weekday","sled","Slate River Rd","2","2","2",5,0.1,18,-1,29,27.8,-2,1,-1,-1,-3,-2,-3,-4
"1704",2018-02-05,"Slate River Rd","w1718","Hybrid",4,"Mon","weekday","sled","Slate River Rd","2","2","2",5,0.1,18,-1,29,27.8,-2,1,-1,-1,-3,-2,-3,-4
"1705",2018-02-06,"Slate River Rd","w1718","Non.motorized",16,"Tue","weekday","no_sled","Slate River Rd","2","2","2",5.2,0.2,23,5,22,22.6,-1,-2,1,-1,4,2,3,2
"1706",2018-02-06,"Slate River Rd","w1718","Mechanized",0,"Tue","weekday","no_sled","Slate River Rd","2","2","2",5.2,0.2,23,5,22,22.6,-1,-2,1,-1,4,2,3,2
"1707",2018-02-06,"Slate River Rd","w1718","Motorized",7,"Tue","weekday","sled","Slate River Rd","2","2","2",5.2,0.2,23,5,22,22.6,-1,-2,1,-1,4,2,3,2
"1708",2018-02-06,"Slate River Rd","w1718","Hybrid",6,"Tue","weekday","sled","Slate River Rd","2","2","2",5.2,0.2,23,5,22,22.6,-1,-2,1,-1,4,2,3,2
"1709",2018-02-07,"Slate River Rd","w1718","Non.motorized",18,"Wed","weekday","no_sled","Slate River Rd","2","2","2",5.2,0,23,0,24,22.6,5,-1,-2,1,5,4,2,3
"1710",2018-02-07,"Slate River Rd","w1718","Mechanized",0,"Wed","weekday","no_sled","Slate River Rd","2","2","2",5.2,0,23,0,24,22.6,5,-1,-2,1,5,4,2,3
"1711",2018-02-07,"Slate River Rd","w1718","Motorized",11,"Wed","weekday","sled","Slate River Rd","2","2","2",5.2,0,23,0,24,22.6,5,-1,-2,1,5,4,2,3
"1712",2018-02-07,"Slate River Rd","w1718","Hybrid",10,"Wed","weekday","sled","Slate River Rd","2","2","2",5.2,0,23,0,24,22.6,5,-1,-2,1,5,4,2,3
"1713",2018-02-08,"Slate River Rd","w1718","Non.motorized",23,"Thu","weekday","no_sled","Slate River Rd","2","2","1",5.3,0.1,25,2,28,21.2,0,5,-1,-2,2,7,6,4
"1714",2018-02-08,"Slate River Rd","w1718","Mechanized",0,"Thu","weekday","no_sled","Slate River Rd","2","2","1",5.3,0.1,25,2,28,21.2,0,5,-1,-2,2,7,6,4
"1715",2018-02-08,"Slate River Rd","w1718","Motorized",4,"Thu","weekday","sled","Slate River Rd","2","2","1",5.3,0.1,25,2,28,21.2,0,5,-1,-2,2,7,6,4
"1716",2018-02-08,"Slate River Rd","w1718","Hybrid",3,"Thu","weekday","sled","Slate River Rd","2","2","1",5.3,0.1,25,2,28,21.2,0,5,-1,-2,2,7,6,4
"1717",2018-02-09,"Slate River Rd","w1718","Non.motorized",16,"Fri","weekday","no_sled","Slate River Rd","2","2","1",5.3,0,24,-1,33,22.1,2,0,5,-1,1,1,6,5
"1718",2018-02-09,"Slate River Rd","w1718","Mechanized",0,"Fri","weekday","no_sled","Slate River Rd","2","2","1",5.3,0,24,-1,33,22.1,2,0,5,-1,1,1,6,5
"1719",2018-02-09,"Slate River Rd","w1718","Motorized",4,"Fri","weekday","sled","Slate River Rd","2","2","1",5.3,0,24,-1,33,22.1,2,0,5,-1,1,1,6,5
"1720",2018-02-09,"Slate River Rd","w1718","Hybrid",4,"Fri","weekday","sled","Slate River Rd","2","2","1",5.3,0,24,-1,33,22.1,2,0,5,-1,1,1,6,5
"1721",2018-02-10,"Slate River Rd","w1718","Non.motorized",3,"Sat","weekend","no_sled","Slate River Rd","3","3","2",5.3,0,24,0,24,22.1,-1,2,0,5,-1,1,1,6
"1722",2018-02-10,"Slate River Rd","w1718","Mechanized",0,"Sat","weekend","no_sled","Slate River Rd","3","3","2",5.3,0,24,0,24,22.1,-1,2,0,5,-1,1,1,6
"1723",2018-02-10,"Slate River Rd","w1718","Motorized",0,"Sat","weekend","sled","Slate River Rd","3","3","2",5.3,0,24,0,24,22.1,-1,2,0,5,-1,1,1,6
"1724",2018-02-10,"Slate River Rd","w1718","Hybrid",0,"Sat","weekend","sled","Slate River Rd","3","3","2",5.3,0,24,0,24,22.1,-1,2,0,5,-1,1,1,6
"1725",2018-02-11,"Slate River Rd","w1718","Non.motorized",20,"Sun","weekend","no_sled","Slate River Rd","3","3","2",5.6,0.3,27,3,13,20.7,0,-1,2,0,3,2,4,4
"1726",2018-02-11,"Slate River Rd","w1718","Mechanized",1,"Sun","weekend","no_sled","Slate River Rd","3","3","2",5.6,0.3,27,3,13,20.7,0,-1,2,0,3,2,4,4
"1727",2018-02-11,"Slate River Rd","w1718","Motorized",4,"Sun","weekend","sled","Slate River Rd","3","3","2",5.6,0.3,27,3,13,20.7,0,-1,2,0,3,2,4,4
"1728",2018-02-11,"Slate River Rd","w1718","Hybrid",3,"Sun","weekend","sled","Slate River Rd","3","3","2",5.6,0.3,27,3,13,20.7,0,-1,2,0,3,2,4,4
"1729",2018-02-12,"Slate River Rd","w1718","Non.motorized",11,"Mon","weekday","no_sled","Slate River Rd","3","3","3",5.7,0.1,27,0,23,21.1,3,0,-1,2,3,3,2,4
"1730",2018-02-12,"Slate River Rd","w1718","Mechanized",0,"Mon","weekday","no_sled","Slate River Rd","3","3","3",5.7,0.1,27,0,23,21.1,3,0,-1,2,3,3,2,4
"1731",2018-02-12,"Slate River Rd","w1718","Motorized",4,"Mon","weekday","sled","Slate River Rd","3","3","3",5.7,0.1,27,0,23,21.1,3,0,-1,2,3,3,2,4
"1732",2018-02-12,"Slate River Rd","w1718","Hybrid",4,"Mon","weekday","sled","Slate River Rd","3","3","3",5.7,0.1,27,0,23,21.1,3,0,-1,2,3,3,2,4
"1733",2018-02-13,"Slate River Rd","w1718","Non.motorized",7,"Tue","weekday","no_sled","Slate River Rd","3","3","3",6.1,0.4,29,2,28,21,0,3,0,-1,2,5,5,4
"1734",2018-02-13,"Slate River Rd","w1718","Mechanized",2,"Tue","weekday","no_sled","Slate River Rd","3","3","3",6.1,0.4,29,2,28,21,0,3,0,-1,2,5,5,4
"1735",2018-02-13,"Slate River Rd","w1718","Motorized",6,"Tue","weekday","sled","Slate River Rd","3","3","3",6.1,0.4,29,2,28,21,0,3,0,-1,2,5,5,4
"1736",2018-02-13,"Slate River Rd","w1718","Hybrid",6,"Tue","weekday","sled","Slate River Rd","3","3","3",6.1,0.4,29,2,28,21,0,3,0,-1,2,5,5,4
"1737",2018-02-14,"Slate River Rd","w1718","Non.motorized",14,"Wed","weekday","no_sled","Slate River Rd","3","3","3",6.2,0.1,30,1,30,20.7,2,0,3,0,3,3,6,6
"1738",2018-02-14,"Slate River Rd","w1718","Mechanized",0,"Wed","weekday","no_sled","Slate River Rd","3","3","3",6.2,0.1,30,1,30,20.7,2,0,3,0,3,3,6,6
"1739",2018-02-14,"Slate River Rd","w1718","Motorized",4,"Wed","weekday","sled","Slate River Rd","3","3","3",6.2,0.1,30,1,30,20.7,2,0,3,0,3,3,6,6
"1740",2018-02-14,"Slate River Rd","w1718","Hybrid",4,"Wed","weekday","sled","Slate River Rd","3","3","3",6.2,0.1,30,1,30,20.7,2,0,3,0,3,3,6,6
"1741",2018-02-15,"Slate River Rd","w1718","Non.motorized",7,"Thu","weekday","no_sled","Slate River Rd","3","3","3",6.3,0.1,28,-2,24,22.5,1,2,0,3,-1,1,1,4
"1742",2018-02-15,"Slate River Rd","w1718","Mechanized",0,"Thu","weekday","no_sled","Slate River Rd","3","3","3",6.3,0.1,28,-2,24,22.5,1,2,0,3,-1,1,1,4
"1743",2018-02-15,"Slate River Rd","w1718","Motorized",10,"Thu","weekday","sled","Slate River Rd","3","3","3",6.3,0.1,28,-2,24,22.5,1,2,0,3,-1,1,1,4
"1744",2018-02-15,"Slate River Rd","w1718","Hybrid",10,"Thu","weekday","sled","Slate River Rd","3","3","3",6.3,0.1,28,-2,24,22.5,1,2,0,3,-1,1,1,4
"1745",2018-02-16,"Slate River Rd","w1718","Non.motorized",14,"Fri","weekday","no_sled","Slate River Rd","3","3","3",6.7,0.4,32,4,18,20.9,-2,1,2,0,2,3,5,5
"1746",2018-02-16,"Slate River Rd","w1718","Mechanized",1,"Fri","weekday","no_sled","Slate River Rd","3","3","3",6.7,0.4,32,4,18,20.9,-2,1,2,0,2,3,5,5
"1747",2018-02-16,"Slate River Rd","w1718","Motorized",8,"Fri","weekday","sled","Slate River Rd","3","3","3",6.7,0.4,32,4,18,20.9,-2,1,2,0,2,3,5,5
"1748",2018-02-16,"Slate River Rd","w1718","Hybrid",6,"Fri","weekday","sled","Slate River Rd","3","3","3",6.7,0.4,32,4,18,20.9,-2,1,2,0,2,3,5,5
"1749",2018-02-17,"Slate River Rd","w1718","Non.motorized",65,"Sat","weekend","no_sled","Slate River Rd","3","3","2",6.7,0,32,0,25,20.9,4,-2,1,2,4,2,3,5
"1750",2018-02-17,"Slate River Rd","w1718","Mechanized",4,"Sat","weekend","no_sled","Slate River Rd","3","3","2",6.7,0,32,0,25,20.9,4,-2,1,2,4,2,3,5
"1751",2018-02-17,"Slate River Rd","w1718","Motorized",10,"Sat","weekend","sled","Slate River Rd","3","3","2",6.7,0,32,0,25,20.9,4,-2,1,2,4,2,3,5
"1752",2018-02-17,"Slate River Rd","w1718","Hybrid",9,"Sat","weekend","sled","Slate River Rd","3","3","2",6.7,0,32,0,25,20.9,4,-2,1,2,4,2,3,5
"1753",2018-02-18,"Slate River Rd","w1718","Non.motorized",51,"Sun","weekend","no_sled","Slate River Rd","2","2","2",6.7,0,31,-1,32,21.6,0,4,-2,1,-1,3,1,2
"1754",2018-02-18,"Slate River Rd","w1718","Mechanized",6,"Sun","weekend","no_sled","Slate River Rd","2","2","2",6.7,0,31,-1,32,21.6,0,4,-2,1,-1,3,1,2
"1755",2018-02-18,"Slate River Rd","w1718","Motorized",6,"Sun","weekend","sled","Slate River Rd","2","2","2",6.7,0,31,-1,32,21.6,0,4,-2,1,-1,3,1,2
"1756",2018-02-18,"Slate River Rd","w1718","Hybrid",6,"Sun","weekend","sled","Slate River Rd","2","2","2",6.7,0,31,-1,32,21.6,0,4,-2,1,-1,3,1,2
"1757",2018-02-19,"Slate River Rd","w1718","Non.motorized",6,"Mon","weekday","no_sled","Slate River Rd","2","2","2",6.8,0.1,29,-2,24,23.4,-1,0,4,-2,-3,-3,1,-1
"1758",2018-02-19,"Slate River Rd","w1718","Non.motorized",6,"Mon","weekday","no_sled","Slate River Rd","3","3","3",6.8,0.1,29,-2,24,23.4,-1,0,4,-2,-3,-3,1,-1
"1759",2018-02-19,"Slate River Rd","w1718","Mechanized",0,"Mon","weekday","no_sled","Slate River Rd","2","2","2",6.8,0.1,29,-2,24,23.4,-1,0,4,-2,-3,-3,1,-1
"1760",2018-02-19,"Slate River Rd","w1718","Mechanized",0,"Mon","weekday","no_sled","Slate River Rd","3","3","3",6.8,0.1,29,-2,24,23.4,-1,0,4,-2,-3,-3,1,-1
"1761",2018-02-19,"Slate River Rd","w1718","Motorized",17,"Mon","weekday","sled","Slate River Rd","2","2","2",6.8,0.1,29,-2,24,23.4,-1,0,4,-2,-3,-3,1,-1
"1762",2018-02-19,"Slate River Rd","w1718","Motorized",17,"Mon","weekday","sled","Slate River Rd","3","3","3",6.8,0.1,29,-2,24,23.4,-1,0,4,-2,-3,-3,1,-1
"1763",2018-02-19,"Slate River Rd","w1718","Hybrid",16,"Mon","weekday","sled","Slate River Rd","2","2","2",6.8,0.1,29,-2,24,23.4,-1,0,4,-2,-3,-3,1,-1
"1764",2018-02-19,"Slate River Rd","w1718","Hybrid",16,"Mon","weekday","sled","Slate River Rd","3","3","3",6.8,0.1,29,-2,24,23.4,-1,0,4,-2,-3,-3,1,-1
"1765",2018-02-20,"Slate River Rd","w1718","Non.motorized",0,"Tue","weekday","no_sled","Slate River Rd","3","3","3",6.8,0,31,2,8,21.9,-2,-1,0,4,0,-1,-1,3
"1766",2018-02-20,"Slate River Rd","w1718","Mechanized",0,"Tue","weekday","no_sled","Slate River Rd","3","3","3",6.8,0,31,2,8,21.9,-2,-1,0,4,0,-1,-1,3
"1767",2018-02-20,"Slate River Rd","w1718","Motorized",1,"Tue","weekday","sled","Slate River Rd","3","3","3",6.8,0,31,2,8,21.9,-2,-1,0,4,0,-1,-1,3
"1768",2018-02-20,"Slate River Rd","w1718","Hybrid",1,"Tue","weekday","sled","Slate River Rd","3","3","3",6.8,0,31,2,8,21.9,-2,-1,0,4,0,-1,-1,3
"1769",2018-02-21,"Slate River Rd","w1718","Non.motorized",19,"Wed","weekday","no_sled","Slate River Rd","3","3","3",6.8,0,31,0,11,21.9,2,-2,-1,0,2,0,-1,-1
"1770",2018-02-21,"Slate River Rd","w1718","Mechanized",0,"Wed","weekday","no_sled","Slate River Rd","3","3","3",6.8,0,31,0,11,21.9,2,-2,-1,0,2,0,-1,-1
"1771",2018-02-21,"Slate River Rd","w1718","Motorized",2,"Wed","weekday","sled","Slate River Rd","3","3","3",6.8,0,31,0,11,21.9,2,-2,-1,0,2,0,-1,-1
"1772",2018-02-21,"Slate River Rd","w1718","Hybrid",2,"Wed","weekday","sled","Slate River Rd","3","3","3",6.8,0,31,0,11,21.9,2,-2,-1,0,2,0,-1,-1
"1773",2018-02-22,"Slate River Rd","w1718","Non.motorized",14,"Thu","weekday","no_sled","Slate River Rd","3","3","2",6.8,0,30,-1,16,22.7,0,2,-2,-1,-1,1,-1,-2
"1774",2018-02-22,"Slate River Rd","w1718","Mechanized",0,"Thu","weekday","no_sled","Slate River Rd","3","3","2",6.8,0,30,-1,16,22.7,0,2,-2,-1,-1,1,-1,-2
"1775",2018-02-22,"Slate River Rd","w1718","Motorized",3,"Thu","weekday","sled","Slate River Rd","3","3","2",6.8,0,30,-1,16,22.7,0,2,-2,-1,-1,1,-1,-2
"1776",2018-02-22,"Slate River Rd","w1718","Hybrid",3,"Thu","weekday","sled","Slate River Rd","3","3","2",6.8,0,30,-1,16,22.7,0,2,-2,-1,-1,1,-1,-2
"1777",2018-02-23,"Slate River Rd","w1718","Non.motorized",10,"Fri","weekday","no_sled","Slate River Rd","3","3","2",6.9,0.1,30,0,15,23,-1,0,2,-2,-1,-1,1,-1
"1778",2018-02-23,"Slate River Rd","w1718","Mechanized",1,"Fri","weekday","no_sled","Slate River Rd","3","3","2",6.9,0.1,30,0,15,23,-1,0,2,-2,-1,-1,1,-1
"1779",2018-02-23,"Slate River Rd","w1718","Motorized",8,"Fri","weekday","sled","Slate River Rd","3","3","2",6.9,0.1,30,0,15,23,-1,0,2,-2,-1,-1,1,-1
"1780",2018-02-23,"Slate River Rd","w1718","Hybrid",7,"Fri","weekday","sled","Slate River Rd","3","3","2",6.9,0.1,30,0,15,23,-1,0,2,-2,-1,-1,1,-1
"1781",2018-02-24,"Slate River Rd","w1718","Non.motorized",8,"Sat","weekend","no_sled","Slate River Rd","3","3","2",6.9,0,31,1,10,22.3,0,-1,0,2,1,0,0,2
"1782",2018-02-24,"Slate River Rd","w1718","Mechanized",1,"Sat","weekend","no_sled","Slate River Rd","3","3","2",6.9,0,31,1,10,22.3,0,-1,0,2,1,0,0,2
"1783",2018-02-24,"Slate River Rd","w1718","Motorized",2,"Sat","weekend","sled","Slate River Rd","3","3","2",6.9,0,31,1,10,22.3,0,-1,0,2,1,0,0,2
"1784",2018-02-24,"Slate River Rd","w1718","Hybrid",0,"Sat","weekend","sled","Slate River Rd","3","3","2",6.9,0,31,1,10,22.3,0,-1,0,2,1,0,0,2
"1785",2018-02-25,"Slate River Rd","w1718","Non.motorized",4,"Sun","weekend","no_sled","Slate River Rd","3","3","2",7.1,0.2,32,1,11,22.2,1,0,-1,0,2,2,1,1
"1786",2018-02-25,"Slate River Rd","w1718","Mechanized",1,"Sun","weekend","no_sled","Slate River Rd","3","3","2",7.1,0.2,32,1,11,22.2,1,0,-1,0,2,2,1,1
"1787",2018-02-25,"Slate River Rd","w1718","Motorized",5,"Sun","weekend","sled","Slate River Rd","3","3","2",7.1,0.2,32,1,11,22.2,1,0,-1,0,2,2,1,1
"1788",2018-02-25,"Slate River Rd","w1718","Hybrid",5,"Sun","weekend","sled","Slate River Rd","3","3","2",7.1,0.2,32,1,11,22.2,1,0,-1,0,2,2,1,1
"1789",2018-02-26,"Slate River Rd","w1718","Non.motorized",20,"Mon","weekday","no_sled","Slate River Rd","2","2","2",7.1,0,32,0,20,22.2,1,1,0,-1,1,2,2,1
"1790",2018-02-26,"Slate River Rd","w1718","Mechanized",0,"Mon","weekday","no_sled","Slate River Rd","2","2","2",7.1,0,32,0,20,22.2,1,1,0,-1,1,2,2,1
"1791",2018-02-26,"Slate River Rd","w1718","Motorized",0,"Mon","weekday","sled","Slate River Rd","2","2","2",7.1,0,32,0,20,22.2,1,1,0,-1,1,2,2,1
"1792",2018-02-26,"Slate River Rd","w1718","Hybrid",0,"Mon","weekday","sled","Slate River Rd","2","2","2",7.1,0,32,0,20,22.2,1,1,0,-1,1,2,2,1
"1793",2018-02-27,"Slate River Rd","w1718","Non.motorized",19,"Tue","weekday","no_sled","Slate River Rd","2","2","2",7.2,0.1,32,0,26,22.5,0,1,1,0,0,1,2,2
"1794",2018-02-27,"Slate River Rd","w1718","Mechanized",0,"Tue","weekday","no_sled","Slate River Rd","2","2","2",7.2,0.1,32,0,26,22.5,0,1,1,0,0,1,2,2
"1795",2018-02-27,"Slate River Rd","w1718","Motorized",1,"Tue","weekday","sled","Slate River Rd","2","2","2",7.2,0.1,32,0,26,22.5,0,1,1,0,0,1,2,2
"1796",2018-02-27,"Slate River Rd","w1718","Hybrid",0,"Tue","weekday","sled","Slate River Rd","2","2","2",7.2,0.1,32,0,26,22.5,0,1,1,0,0,1,2,2
"1797",2018-02-28,"Slate River Rd","w1718","Non.motorized",7,"Wed","weekday","no_sled","Slate River Rd","2","2","2",7.2,0,31,-1,23,23.2,0,0,1,1,-1,-1,0,1
"1798",2018-02-28,"Slate River Rd","w1718","Mechanized",0,"Wed","weekday","no_sled","Slate River Rd","2","2","2",7.2,0,31,-1,23,23.2,0,0,1,1,-1,-1,0,1
"1799",2018-02-28,"Slate River Rd","w1718","Motorized",1,"Wed","weekday","sled","Slate River Rd","2","2","2",7.2,0,31,-1,23,23.2,0,0,1,1,-1,-1,0,1
"1800",2018-02-28,"Slate River Rd","w1718","Hybrid",0,"Wed","weekday","sled","Slate River Rd","2","2","2",7.2,0,31,-1,23,23.2,0,0,1,1,-1,-1,0,1
"1801",2018-03-01,"Slate River Rd","w1718","Non.motorized",15,"Thu","weekday","no_sled","Slate River Rd","2","2","2",7.2,0,31,0,24,23.2,-1,0,0,1,-1,-1,-1,0
"1802",2018-03-01,"Slate River Rd","w1718","Mechanized",15,"Thu","weekday","no_sled","Slate River Rd","2","2","2",7.2,0,31,0,24,23.2,-1,0,0,1,-1,-1,-1,0
"1803",2018-03-01,"Slate River Rd","w1718","Motorized",12,"Thu","weekday","sled","Slate River Rd","2","2","2",7.2,0,31,0,24,23.2,-1,0,0,1,-1,-1,-1,0
"1804",2018-03-01,"Slate River Rd","w1718","Hybrid",8,"Thu","weekday","sled","Slate River Rd","2","2","2",7.2,0,31,0,24,23.2,-1,0,0,1,-1,-1,-1,0
"1805",2018-03-02,"Slate River Rd","w1718","Non.motorized",11,"Fri","weekday","no_sled","Slate River Rd","2","2","1",7.2,0,31,0,30,23.2,0,-1,0,0,0,-1,-1,-1
"1806",2018-03-02,"Slate River Rd","w1718","Mechanized",0,"Fri","weekday","no_sled","Slate River Rd","2","2","1",7.2,0,31,0,30,23.2,0,-1,0,0,0,-1,-1,-1
"1807",2018-03-02,"Slate River Rd","w1718","Motorized",5,"Fri","weekday","sled","Slate River Rd","2","2","1",7.2,0,31,0,30,23.2,0,-1,0,0,0,-1,-1,-1
"1808",2018-03-02,"Slate River Rd","w1718","Hybrid",5,"Fri","weekday","sled","Slate River Rd","2","2","1",7.2,0,31,0,30,23.2,0,-1,0,0,0,-1,-1,-1
"1809",2018-03-03,"Slate River Rd","w1718","Non.motorized",44,"Sat","weekend","no_sled","Slate River Rd","2","2","1",7.3,0.1,30,-1,34,24.3,0,0,-1,0,-1,-1,-2,-2
"1810",2018-03-03,"Slate River Rd","w1718","Mechanized",1,"Sat","weekend","no_sled","Slate River Rd","2","2","1",7.3,0.1,30,-1,34,24.3,0,0,-1,0,-1,-1,-2,-2
"1811",2018-03-03,"Slate River Rd","w1718","Motorized",11,"Sat","weekend","sled","Slate River Rd","2","2","1",7.3,0.1,30,-1,34,24.3,0,0,-1,0,-1,-1,-2,-2
"1812",2018-03-03,"Slate River Rd","w1718","Hybrid",11,"Sat","weekend","sled","Slate River Rd","2","2","1",7.3,0.1,30,-1,34,24.3,0,0,-1,0,-1,-1,-2,-2
"1813",2018-03-04,"Slate River Rd","w1718","Non.motorized",35,"Sun","weekend","no_sled","Slate River Rd","2","2","1",7.3,0,29,-1,24,25.2,-1,0,0,-1,-2,-2,-2,-3
"1814",2018-03-04,"Slate River Rd","w1718","Mechanized",1,"Sun","weekend","no_sled","Slate River Rd","2","2","1",7.3,0,29,-1,24,25.2,-1,0,0,-1,-2,-2,-2,-3
"1815",2018-03-04,"Slate River Rd","w1718","Motorized",13,"Sun","weekend","sled","Slate River Rd","2","2","1",7.3,0,29,-1,24,25.2,-1,0,0,-1,-2,-2,-2,-3
"1816",2018-03-04,"Slate River Rd","w1718","Hybrid",13,"Sun","weekend","sled","Slate River Rd","2","2","1",7.3,0,29,-1,24,25.2,-1,0,0,-1,-2,-2,-2,-3
"1817",2018-03-05,"Slate River Rd","w1718","Non.motorized",14,"Mon","weekday","no_sled","Slate River Rd","2","2","1",7.3,0,31,2,13,23.5,-1,-1,0,0,1,0,0,0
"1818",2018-03-05,"Slate River Rd","w1718","Mechanized",3,"Mon","weekday","no_sled","Slate River Rd","2","2","1",7.3,0,31,2,13,23.5,-1,-1,0,0,1,0,0,0
"1819",2018-03-05,"Slate River Rd","w1718","Motorized",2,"Mon","weekday","sled","Slate River Rd","2","2","1",7.3,0,31,2,13,23.5,-1,-1,0,0,1,0,0,0
"1820",2018-03-05,"Slate River Rd","w1718","Hybrid",0,"Mon","weekday","sled","Slate River Rd","2","2","1",7.3,0,31,2,13,23.5,-1,-1,0,0,1,0,0,0
"1821",2018-03-06,"Slate River Rd","w1718","Non.motorized",9,"Tue","weekday","no_sled","Slate River Rd","2","2","1",7.3,0,31,0,19,23.5,2,-1,-1,0,2,1,0,0
"1822",2018-03-06,"Slate River Rd","w1718","Mechanized",0,"Tue","weekday","no_sled","Slate River Rd","2","2","1",7.3,0,31,0,19,23.5,2,-1,-1,0,2,1,0,0
"1823",2018-03-06,"Slate River Rd","w1718","Motorized",6,"Tue","weekday","sled","Slate River Rd","2","2","1",7.3,0,31,0,19,23.5,2,-1,-1,0,2,1,0,0
"1824",2018-03-06,"Slate River Rd","w1718","Hybrid",4,"Tue","weekday","sled","Slate River Rd","2","2","1",7.3,0,31,0,19,23.5,2,-1,-1,0,2,1,0,0
"1825",2018-03-07,"Slate River Rd","w1718","Non.motorized",16,"Wed","weekday","no_sled","Slate River Rd","2","2","1",7.4,0.1,31,0,27,23.9,0,2,-1,-1,0,2,1,0
"1826",2018-03-07,"Slate River Rd","w1718","Mechanized",0,"Wed","weekday","no_sled","Slate River Rd","2","2","1",7.4,0.1,31,0,27,23.9,0,2,-1,-1,0,2,1,0
"1827",2018-03-07,"Slate River Rd","w1718","Motorized",9,"Wed","weekday","sled","Slate River Rd","2","2","1",7.4,0.1,31,0,27,23.9,0,2,-1,-1,0,2,1,0
"1828",2018-03-07,"Slate River Rd","w1718","Hybrid",9,"Wed","weekday","sled","Slate River Rd","2","2","1",7.4,0.1,31,0,27,23.9,0,2,-1,-1,0,2,1,0
"1829",2018-03-08,"Slate River Rd","w1718","Non.motorized",17,"Thu","weekday","no_sled","Slate River Rd","2","2","1",7.4,0,30,-1,33,24.7,0,0,2,-1,-1,-1,1,0
"1830",2018-03-08,"Slate River Rd","w1718","Mechanized",0,"Thu","weekday","no_sled","Slate River Rd","2","2","1",7.4,0,30,-1,33,24.7,0,0,2,-1,-1,-1,1,0
"1831",2018-03-08,"Slate River Rd","w1718","Motorized",10,"Thu","weekday","sled","Slate River Rd","2","2","1",7.4,0,30,-1,33,24.7,0,0,2,-1,-1,-1,1,0
"1832",2018-03-08,"Slate River Rd","w1718","Hybrid",8,"Thu","weekday","sled","Slate River Rd","2","2","1",7.4,0,30,-1,33,24.7,0,0,2,-1,-1,-1,1,0
"1833",2018-03-09,"Slate River Rd","w1718","Non.motorized",41,"Fri","weekday","no_sled","Slate River Rd","2","2","1",7.4,0,30,0,34,24.7,-1,0,0,2,-1,-1,-1,1
"1834",2018-03-09,"Slate River Rd","w1718","Mechanized",0,"Fri","weekday","no_sled","Slate River Rd","2","2","1",7.4,0,30,0,34,24.7,-1,0,0,2,-1,-1,-1,1
"1835",2018-03-09,"Slate River Rd","w1718","Motorized",10,"Fri","weekday","sled","Slate River Rd","2","2","1",7.4,0,30,0,34,24.7,-1,0,0,2,-1,-1,-1,1
"1836",2018-03-09,"Slate River Rd","w1718","Hybrid",10,"Fri","weekday","sled","Slate River Rd","2","2","1",7.4,0,30,0,34,24.7,-1,0,0,2,-1,-1,-1,1
"1837",2018-03-10,"Slate River Rd","w1718","Non.motorized",37,"Sat","weekend","no_sled","Slate River Rd","1","1","1",7.4,0,30,0,31,24.7,0,-1,0,0,0,-1,-1,-1
"1838",2018-03-10,"Slate River Rd","w1718","Mechanized",0,"Sat","weekend","no_sled","Slate River Rd","1","1","1",7.4,0,30,0,31,24.7,0,-1,0,0,0,-1,-1,-1
"1839",2018-03-10,"Slate River Rd","w1718","Motorized",6,"Sat","weekend","sled","Slate River Rd","1","1","1",7.4,0,30,0,31,24.7,0,-1,0,0,0,-1,-1,-1
"1840",2018-03-10,"Slate River Rd","w1718","Hybrid",5,"Sat","weekend","sled","Slate River Rd","1","1","1",7.4,0,30,0,31,24.7,0,-1,0,0,0,-1,-1,-1
"1841",2018-03-11,"Slate River Rd","w1718","Non.motorized",54,"Sun","weekend","no_sled","Slate River Rd","1","1","1",7.4,0,29,-1,31,25.5,0,0,-1,0,-1,-1,-2,-2
"1842",2018-03-11,"Slate River Rd","w1718","Mechanized",0,"Sun","weekend","no_sled","Slate River Rd","1","1","1",7.4,0,29,-1,31,25.5,0,0,-1,0,-1,-1,-2,-2
"1843",2018-03-11,"Slate River Rd","w1718","Motorized",4,"Sun","weekend","sled","Slate River Rd","1","1","1",7.4,0,29,-1,31,25.5,0,0,-1,0,-1,-1,-2,-2
"1844",2018-03-11,"Slate River Rd","w1718","Hybrid",4,"Sun","weekend","sled","Slate River Rd","1","1","1",7.4,0,29,-1,31,25.5,0,0,-1,0,-1,-1,-2,-2
"1845",2018-03-12,"Slate River Rd","w1718","Non.motorized",26,"Mon","weekday","no_sled","Slate River Rd","1","1","1",7.4,0,29,0,33,25.5,-1,0,0,-1,-1,-1,-1,-2
"1846",2018-03-12,"Slate River Rd","w1718","Mechanized",0,"Mon","weekday","no_sled","Slate River Rd","1","1","1",7.4,0,29,0,33,25.5,-1,0,0,-1,-1,-1,-1,-2
"1847",2018-03-12,"Slate River Rd","w1718","Motorized",4,"Mon","weekday","sled","Slate River Rd","1","1","1",7.4,0,29,0,33,25.5,-1,0,0,-1,-1,-1,-1,-2
"1848",2018-03-12,"Slate River Rd","w1718","Hybrid",2,"Mon","weekday","sled","Slate River Rd","1","1","1",7.4,0,29,0,33,25.5,-1,0,0,-1,-1,-1,-1,-2
"1849",2018-03-13,"Slate River Rd","w1718","Non.motorized",49,"Tue","weekday","no_sled","Slate River Rd","1","1","1",7.4,0,29,0,34,25.5,0,-1,0,0,0,-1,-1,-1
"1850",2018-03-13,"Slate River Rd","w1718","Mechanized",1,"Tue","weekday","no_sled","Slate River Rd","1","1","1",7.4,0,29,0,34,25.5,0,-1,0,0,0,-1,-1,-1
"1851",2018-03-13,"Slate River Rd","w1718","Motorized",3,"Tue","weekday","sled","Slate River Rd","1","1","1",7.4,0,29,0,34,25.5,0,-1,0,0,0,-1,-1,-1
"1852",2018-03-13,"Slate River Rd","w1718","Hybrid",2,"Tue","weekday","sled","Slate River Rd","1","1","1",7.4,0,29,0,34,25.5,0,-1,0,0,0,-1,-1,-1
"1853",2018-03-14,"Slate River Rd","w1718","Non.motorized",27,"Wed","weekday","no_sled","Slate River Rd","1","2","2",7.4,0,29,0,39,25.5,0,0,-1,0,0,0,-1,-1
"1854",2018-03-14,"Slate River Rd","w1718","Mechanized",0,"Wed","weekday","no_sled","Slate River Rd","1","2","2",7.4,0,29,0,39,25.5,0,0,-1,0,0,0,-1,-1
"1855",2018-03-14,"Slate River Rd","w1718","Motorized",7,"Wed","weekday","sled","Slate River Rd","1","2","2",7.4,0,29,0,39,25.5,0,0,-1,0,0,0,-1,-1
"1856",2018-03-14,"Slate River Rd","w1718","Hybrid",2,"Wed","weekday","sled","Slate River Rd","1","2","2",7.4,0,29,0,39,25.5,0,0,-1,0,0,0,-1,-1
"1857",2018-03-15,"Slate River Rd","w1718","Non.motorized",12,"Thu","weekday","no_sled","Slate River Rd","2","2","2",7.5,0.1,28,-1,31,26.8,0,0,0,-1,-1,-1,-1,-2
"1858",2018-03-15,"Slate River Rd","w1718","Mechanized",0,"Thu","weekday","no_sled","Slate River Rd","2","2","2",7.5,0.1,28,-1,31,26.8,0,0,0,-1,-1,-1,-1,-2
"1859",2018-03-15,"Slate River Rd","w1718","Motorized",2,"Thu","weekday","sled","Slate River Rd","2","2","2",7.5,0.1,28,-1,31,26.8,0,0,0,-1,-1,-1,-1,-2
"1860",2018-03-15,"Slate River Rd","w1718","Hybrid",2,"Thu","weekday","sled","Slate River Rd","2","2","2",7.5,0.1,28,-1,31,26.8,0,0,0,-1,-1,-1,-1,-2
"1861",2018-03-16,"Slate River Rd","w1718","Non.motorized",20,"Fri","weekday","no_sled","Slate River Rd","2","2","2",7.7,0.2,29,1,25,26.6,-1,0,0,0,0,0,0,0
"1862",2018-03-16,"Slate River Rd","w1718","Mechanized",0,"Fri","weekday","no_sled","Slate River Rd","2","2","2",7.7,0.2,29,1,25,26.6,-1,0,0,0,0,0,0,0
"1863",2018-03-16,"Slate River Rd","w1718","Motorized",10,"Fri","weekday","sled","Slate River Rd","2","2","2",7.7,0.2,29,1,25,26.6,-1,0,0,0,0,0,0,0
"1864",2018-03-16,"Slate River Rd","w1718","Hybrid",10,"Fri","weekday","sled","Slate River Rd","2","2","2",7.7,0.2,29,1,25,26.6,-1,0,0,0,0,0,0,0
"1865",2018-03-17,"Slate River Rd","w1718","Non.motorized",22,"Sat","weekend","no_sled","Slate River Rd","2","2","2",7.8,0.1,32,3,29,24.4,1,-1,0,0,4,3,3,3
"1866",2018-03-17,"Slate River Rd","w1718","Mechanized",0,"Sat","weekend","no_sled","Slate River Rd","2","2","2",7.8,0.1,32,3,29,24.4,1,-1,0,0,4,3,3,3
"1867",2018-03-17,"Slate River Rd","w1718","Motorized",11,"Sat","weekend","sled","Slate River Rd","2","2","2",7.8,0.1,32,3,29,24.4,1,-1,0,0,4,3,3,3
"1868",2018-03-17,"Slate River Rd","w1718","Hybrid",11,"Sat","weekend","sled","Slate River Rd","2","2","2",7.8,0.1,32,3,29,24.4,1,-1,0,0,4,3,3,3
"1869",2018-03-18,"Slate River Rd","w1718","Non.motorized",11,"Sun","weekend","no_sled","Slate River Rd","2","2","2",7.9,0.1,31,-1,24,25.5,3,1,-1,0,2,3,2,2
"1870",2018-03-18,"Slate River Rd","w1718","Mechanized",1,"Sun","weekend","no_sled","Slate River Rd","2","2","2",7.9,0.1,31,-1,24,25.5,3,1,-1,0,2,3,2,2
"1871",2018-03-18,"Slate River Rd","w1718","Motorized",14,"Sun","weekend","sled","Slate River Rd","2","2","2",7.9,0.1,31,-1,24,25.5,3,1,-1,0,2,3,2,2
"1872",2018-03-18,"Slate River Rd","w1718","Hybrid",10,"Sun","weekend","sled","Slate River Rd","2","2","2",7.9,0.1,31,-1,24,25.5,3,1,-1,0,2,3,2,2
"1873",2018-03-19,"Slate River Rd","w1718","Non.motorized",15,"Mon","weekday","no_sled","Slate River Rd","2","2","1",8,0.1,32,1,19,25,-1,3,1,-1,0,3,4,3
"1874",2018-03-19,"Slate River Rd","w1718","Mechanized",0,"Mon","weekday","no_sled","Slate River Rd","2","2","1",8,0.1,32,1,19,25,-1,3,1,-1,0,3,4,3
"1875",2018-03-19,"Slate River Rd","w1718","Motorized",14,"Mon","weekday","sled","Slate River Rd","2","2","1",8,0.1,32,1,19,25,-1,3,1,-1,0,3,4,3
"1876",2018-03-19,"Slate River Rd","w1718","Hybrid",14,"Mon","weekday","sled","Slate River Rd","2","2","1",8,0.1,32,1,19,25,-1,3,1,-1,0,3,4,3
"1877",2018-03-20,"Slate River Rd","w1718","Non.motorized",40,"Tue","weekday","no_sled","Slate River Rd","2","2","1",8,0,30,-2,24,26.7,1,-1,3,1,-1,-2,1,2
"1878",2018-03-20,"Slate River Rd","w1718","Mechanized",0,"Tue","weekday","no_sled","Slate River Rd","2","2","1",8,0,30,-2,24,26.7,1,-1,3,1,-1,-2,1,2
"1879",2018-03-20,"Slate River Rd","w1718","Motorized",10,"Tue","weekday","sled","Slate River Rd","2","2","1",8,0,30,-2,24,26.7,1,-1,3,1,-1,-2,1,2
"1880",2018-03-20,"Slate River Rd","w1718","Hybrid",10,"Tue","weekday","sled","Slate River Rd","2","2","1",8,0,30,-2,24,26.7,1,-1,3,1,-1,-2,1,2
"1881",2018-03-21,"Slate River Rd","w1718","Non.motorized",16,"Wed","weekday","no_sled","Slate River Rd","1","1","1",8.1,0.1,32,2,30,25.3,-2,1,-1,3,0,1,0,3
"1882",2018-03-21,"Slate River Rd","w1718","Mechanized",1,"Wed","weekday","no_sled","Slate River Rd","1","1","1",8.1,0.1,32,2,30,25.3,-2,1,-1,3,0,1,0,3
"1883",2018-03-21,"Slate River Rd","w1718","Motorized",7,"Wed","weekday","sled","Slate River Rd","1","1","1",8.1,0.1,32,2,30,25.3,-2,1,-1,3,0,1,0,3
"1884",2018-03-21,"Slate River Rd","w1718","Hybrid",6,"Wed","weekday","sled","Slate River Rd","1","1","1",8.1,0.1,32,2,30,25.3,-2,1,-1,3,0,1,0,3
"1885",2018-03-22,"Slate River Rd","w1718","Non.motorized",43,"Thu","weekday","no_sled","Slate River Rd","1","1","1",8.1,0,30,-2,36,27,2,-2,1,-1,0,-2,-1,-2
"1886",2018-03-22,"Slate River Rd","w1718","Mechanized",0,"Thu","weekday","no_sled","Slate River Rd","1","1","1",8.1,0,30,-2,36,27,2,-2,1,-1,0,-2,-1,-2
"1887",2018-03-22,"Slate River Rd","w1718","Motorized",11,"Thu","weekday","sled","Slate River Rd","1","1","1",8.1,0,30,-2,36,27,2,-2,1,-1,0,-2,-1,-2
"1888",2018-03-22,"Slate River Rd","w1718","Hybrid",10,"Thu","weekday","sled","Slate River Rd","1","1","1",8.1,0,30,-2,36,27,2,-2,1,-1,0,-2,-1,-2
"1889",2018-03-23,"Slate River Rd","w1718","Non.motorized",9,"Fri","weekday","no_sled","Slate River Rd","2","2","3",8.2,0.1,29,-1,34,28.3,-2,2,-2,1,-3,-1,-3,-2
"1890",2018-03-23,"Slate River Rd","w1718","Mechanized",0,"Fri","weekday","no_sled","Slate River Rd","2","2","3",8.2,0.1,29,-1,34,28.3,-2,2,-2,1,-3,-1,-3,-2
"1891",2018-03-23,"Slate River Rd","w1718","Motorized",2,"Fri","weekday","sled","Slate River Rd","2","2","3",8.2,0.1,29,-1,34,28.3,-2,2,-2,1,-3,-1,-3,-2
"1892",2018-03-23,"Slate River Rd","w1718","Hybrid",2,"Fri","weekday","sled","Slate River Rd","2","2","3",8.2,0.1,29,-1,34,28.3,-2,2,-2,1,-3,-1,-3,-2
"1893",2018-03-24,"Slate River Rd","w1718","Non.motorized",43,"Sat","weekend","no_sled","Slate River Rd","2","2","1",8.9,0.7,34,5,32,26.2,-1,-2,2,-2,4,2,4,2
"1894",2018-03-24,"Slate River Rd","w1718","Mechanized",1,"Sat","weekend","no_sled","Slate River Rd","2","2","1",8.9,0.7,34,5,32,26.2,-1,-2,2,-2,4,2,4,2
"1895",2018-03-24,"Slate River Rd","w1718","Motorized",3,"Sat","weekend","sled","Slate River Rd","2","2","1",8.9,0.7,34,5,32,26.2,-1,-2,2,-2,4,2,4,2
"1896",2018-03-24,"Slate River Rd","w1718","Hybrid",3,"Sat","weekend","sled","Slate River Rd","2","2","1",8.9,0.7,34,5,32,26.2,-1,-2,2,-2,4,2,4,2
"1897",2018-03-25,"Slate River Rd","w1718","Non.motorized",44,"Sun","weekend","no_sled","Slate River Rd","2","2","1",8.9,0,35,1,35,25.4,5,-1,-2,2,6,5,3,5
"1898",2018-03-25,"Slate River Rd","w1718","Mechanized",0,"Sun","weekend","no_sled","Slate River Rd","2","2","1",8.9,0,35,1,35,25.4,5,-1,-2,2,6,5,3,5
"1899",2018-03-25,"Slate River Rd","w1718","Motorized",12,"Sun","weekend","sled","Slate River Rd","2","2","1",8.9,0,35,1,35,25.4,5,-1,-2,2,6,5,3,5
"1900",2018-03-25,"Slate River Rd","w1718","Hybrid",9,"Sun","weekend","sled","Slate River Rd","2","2","1",8.9,0,35,1,35,25.4,5,-1,-2,2,6,5,3,5
"1901",2018-03-26,"Slate River Rd","w1718","Non.motorized",29,"Mon","weekday","no_sled","Slate River Rd","1","1","1",8.9,0,34,-1,31,26.2,1,5,-1,-2,0,5,4,2
"1902",2018-03-26,"Slate River Rd","w1718","Non.motorized",29,"Mon","weekday","no_sled","Slate River Rd","2","1","1",8.9,0,34,-1,31,26.2,1,5,-1,-2,0,5,4,2
"1903",2018-03-26,"Slate River Rd","w1718","Mechanized",0,"Mon","weekday","no_sled","Slate River Rd","1","1","1",8.9,0,34,-1,31,26.2,1,5,-1,-2,0,5,4,2
"1904",2018-03-26,"Slate River Rd","w1718","Mechanized",0,"Mon","weekday","no_sled","Slate River Rd","2","1","1",8.9,0,34,-1,31,26.2,1,5,-1,-2,0,5,4,2
"1905",2018-03-26,"Slate River Rd","w1718","Motorized",1,"Mon","weekday","sled","Slate River Rd","1","1","1",8.9,0,34,-1,31,26.2,1,5,-1,-2,0,5,4,2
"1906",2018-03-26,"Slate River Rd","w1718","Motorized",1,"Mon","weekday","sled","Slate River Rd","2","1","1",8.9,0,34,-1,31,26.2,1,5,-1,-2,0,5,4,2
"1907",2018-03-26,"Slate River Rd","w1718","Hybrid",1,"Mon","weekday","sled","Slate River Rd","1","1","1",8.9,0,34,-1,31,26.2,1,5,-1,-2,0,5,4,2
"1908",2018-03-26,"Slate River Rd","w1718","Hybrid",1,"Mon","weekday","sled","Slate River Rd","2","1","1",8.9,0,34,-1,31,26.2,1,5,-1,-2,0,5,4,2
"1909",2018-03-27,"Slate River Rd","w1718","Non.motorized",30,"Tue","weekday","no_sled","Slate River Rd","1","1","1",8.9,0,33,-1,29,27,-1,1,5,-1,-2,-1,4,3
"1910",2018-03-27,"Slate River Rd","w1718","Mechanized",0,"Tue","weekday","no_sled","Slate River Rd","1","1","1",8.9,0,33,-1,29,27,-1,1,5,-1,-2,-1,4,3
"1911",2018-03-27,"Slate River Rd","w1718","Motorized",3,"Tue","weekday","sled","Slate River Rd","1","1","1",8.9,0,33,-1,29,27,-1,1,5,-1,-2,-1,4,3
"1912",2018-03-27,"Slate River Rd","w1718","Hybrid",1,"Tue","weekday","sled","Slate River Rd","1","1","1",8.9,0,33,-1,29,27,-1,1,5,-1,-2,-1,4,3
"1913",2018-03-28,"Slate River Rd","w1718","Non.motorized",21,"Wed","weekday","no_sled","Slate River Rd","1","1","1",8.9,0,33,0,27,27,-1,-1,1,5,-1,-2,-1,4
"1914",2018-03-28,"Slate River Rd","w1718","Mechanized",0,"Wed","weekday","no_sled","Slate River Rd","1","1","1",8.9,0,33,0,27,27,-1,-1,1,5,-1,-2,-1,4
"1915",2018-03-28,"Slate River Rd","w1718","Motorized",5,"Wed","weekday","sled","Slate River Rd","1","1","1",8.9,0,33,0,27,27,-1,-1,1,5,-1,-2,-1,4
"1916",2018-03-28,"Slate River Rd","w1718","Hybrid",5,"Wed","weekday","sled","Slate River Rd","1","1","1",8.9,0,33,0,27,27,-1,-1,1,5,-1,-2,-1,4
"1917",2018-03-29,"Slate River Rd","w1718","Non.motorized",33,"Thu","weekday","no_sled","Slate River Rd","1","1","1",8.9,0,33,0,27,27,0,-1,-1,1,0,-1,-2,-1
"1918",2018-03-29,"Slate River Rd","w1718","Mechanized",0,"Thu","weekday","no_sled","Slate River Rd","1","1","1",8.9,0,33,0,27,27,0,-1,-1,1,0,-1,-2,-1
"1919",2018-03-29,"Slate River Rd","w1718","Motorized",5,"Thu","weekday","sled","Slate River Rd","1","1","1",8.9,0,33,0,27,27,0,-1,-1,1,0,-1,-2,-1
"1920",2018-03-29,"Slate River Rd","w1718","Hybrid",5,"Thu","weekday","sled","Slate River Rd","1","1","1",8.9,0,33,0,27,27,0,-1,-1,1,0,-1,-2,-1
"1921",2018-03-30,"Slate River Rd","w1718","Non.motorized",22,"Fri","weekday","no_sled","Slate River Rd","1","1","1",8.9,0,32,-1,33,27.8,0,0,-1,-1,-1,-1,-2,-3
"1922",2018-03-30,"Slate River Rd","w1718","Mechanized",0,"Fri","weekday","no_sled","Slate River Rd","1","1","1",8.9,0,32,-1,33,27.8,0,0,-1,-1,-1,-1,-2,-3
"1923",2018-03-30,"Slate River Rd","w1718","Motorized",7,"Fri","weekday","sled","Slate River Rd","1","1","1",8.9,0,32,-1,33,27.8,0,0,-1,-1,-1,-1,-2,-3
"1924",2018-03-30,"Slate River Rd","w1718","Hybrid",7,"Fri","weekday","sled","Slate River Rd","1","1","1",8.9,0,32,-1,33,27.8,0,0,-1,-1,-1,-1,-2,-3
"1925",2018-03-31,"Slate River Rd","w1718","Non.motorized",34,"Sat","weekend","no_sled","Slate River Rd","1","1","1",8.9,0,32,0,39,27.8,-1,0,0,-1,-1,-1,-1,-2
"1926",2018-03-31,"Slate River Rd","w1718","Mechanized",0,"Sat","weekend","no_sled","Slate River Rd","1","1","1",8.9,0,32,0,39,27.8,-1,0,0,-1,-1,-1,-1,-2
"1927",2018-03-31,"Slate River Rd","w1718","Motorized",4,"Sat","weekend","sled","Slate River Rd","1","1","1",8.9,0,32,0,39,27.8,-1,0,0,-1,-1,-1,-1,-2
"1928",2018-03-31,"Slate River Rd","w1718","Hybrid",4,"Sat","weekend","sled","Slate River Rd","1","1","1",8.9,0,32,0,39,27.8,-1,0,0,-1,-1,-1,-1,-2
"1929",2018-04-01,"Slate River Rd","w1718","Non.motorized",12,"Sun","weekend","no_sled","Slate River Rd","1","1","1",8.8,-0.1,30,-2,41,29.3,0,-1,0,0,-2,-3,-3,-3
"1930",2018-04-01,"Slate River Rd","w1718","Mechanized",0,"Sun","weekend","no_sled","Slate River Rd","1","1","1",8.8,-0.1,30,-2,41,29.3,0,-1,0,0,-2,-3,-3,-3
"1931",2018-04-01,"Slate River Rd","w1718","Motorized",7,"Sun","weekend","sled","Slate River Rd","1","1","1",8.8,-0.1,30,-2,41,29.3,0,-1,0,0,-2,-3,-3,-3
"1932",2018-04-01,"Slate River Rd","w1718","Hybrid",7,"Sun","weekend","sled","Slate River Rd","1","1","1",8.8,-0.1,30,-2,41,29.3,0,-1,0,0,-2,-3,-3,-3
"1933",2018-04-02,"Slate River Rd","w1718","Non.motorized",9,"Mon","weekday","no_sled","Slate River Rd","1","1","1",8.7,-0.1,29,-1,39,30,-2,0,-1,0,-3,-3,-4,-4
"1934",2018-04-02,"Slate River Rd","w1718","Mechanized",0,"Mon","weekday","no_sled","Slate River Rd","1","1","1",8.7,-0.1,29,-1,39,30,-2,0,-1,0,-3,-3,-4,-4
"1935",2018-04-02,"Slate River Rd","w1718","Motorized",3,"Mon","weekday","sled","Slate River Rd","1","1","1",8.7,-0.1,29,-1,39,30,-2,0,-1,0,-3,-3,-4,-4
"1936",2018-04-02,"Slate River Rd","w1718","Hybrid",2,"Mon","weekday","sled","Slate River Rd","1","1","1",8.7,-0.1,29,-1,39,30,-2,0,-1,0,-3,-3,-4,-4
"1937",2018-04-03,"Slate River Rd","w1718","Non.motorized",7,"Tue","weekday","no_sled","Slate River Rd","1","1","1",8.8,0.1,30,1,27,29.3,-1,-2,0,-1,0,-2,-2,-3
"1938",2018-04-03,"Slate River Rd","w1718","Mechanized",0,"Tue","weekday","no_sled","Slate River Rd","1","1","1",8.8,0.1,30,1,27,29.3,-1,-2,0,-1,0,-2,-2,-3
"1939",2018-04-03,"Slate River Rd","w1718","Motorized",7,"Tue","weekday","sled","Slate River Rd","1","1","1",8.8,0.1,30,1,27,29.3,-1,-2,0,-1,0,-2,-2,-3
"1940",2018-04-03,"Slate River Rd","w1718","Hybrid",5,"Tue","weekday","sled","Slate River Rd","1","1","1",8.8,0.1,30,1,27,29.3,-1,-2,0,-1,0,-2,-2,-3
"1941",2018-04-04,"Slate River Rd","w1718","Non.motorized",6,"Wed","weekday","no_sled","Slate River Rd","1","2","2",8.9,0.1,28,-2,33,31.8,1,-1,-2,0,-1,-2,-4,-4
"1942",2018-04-04,"Slate River Rd","w1718","Mechanized",1,"Wed","weekday","no_sled","Slate River Rd","1","2","2",8.9,0.1,28,-2,33,31.8,1,-1,-2,0,-1,-2,-4,-4
"1943",2018-04-04,"Slate River Rd","w1718","Motorized",3,"Wed","weekday","sled","Slate River Rd","1","2","2",8.9,0.1,28,-2,33,31.8,1,-1,-2,0,-1,-2,-4,-4
"1944",2018-04-04,"Slate River Rd","w1718","Hybrid",2,"Wed","weekday","sled","Slate River Rd","1","2","2",8.9,0.1,28,-2,33,31.8,1,-1,-2,0,-1,-2,-4,-4
"1945",2018-04-05,"Slate River Rd","w1718","Non.motorized",11,"Thu","weekday","no_sled","Slate River Rd","1","2","2",8.9,0,27,-1,35,33,-2,1,-1,-2,-3,-2,-3,-5
"1946",2018-04-05,"Slate River Rd","w1718","Mechanized",0,"Thu","weekday","no_sled","Slate River Rd","1","2","2",8.9,0,27,-1,35,33,-2,1,-1,-2,-3,-2,-3,-5
"1947",2018-04-05,"Slate River Rd","w1718","Motorized",2,"Thu","weekday","sled","Slate River Rd","1","2","2",8.9,0,27,-1,35,33,-2,1,-1,-2,-3,-2,-3,-5
"1948",2018-04-05,"Slate River Rd","w1718","Hybrid",2,"Thu","weekday","sled","Slate River Rd","1","2","2",8.9,0,27,-1,35,33,-2,1,-1,-2,-3,-2,-3,-5
"1949",2018-04-06,"Slate River Rd","w1718","Non.motorized",7,"Fri","weekday","no_sled","Slate River Rd","1","2","2",8.9,0,25,-2,35,35.6,-1,-2,1,-1,-3,-5,-4,-5
"1950",2018-04-06,"Slate River Rd","w1718","Mechanized",0,"Fri","weekday","no_sled","Slate River Rd","1","2","2",8.9,0,25,-2,35,35.6,-1,-2,1,-1,-3,-5,-4,-5
"1951",2018-04-06,"Slate River Rd","w1718","Motorized",5,"Fri","weekday","sled","Slate River Rd","1","2","2",8.9,0,25,-2,35,35.6,-1,-2,1,-1,-3,-5,-4,-5
"1952",2018-04-06,"Slate River Rd","w1718","Hybrid",5,"Fri","weekday","sled","Slate River Rd","1","2","2",8.9,0,25,-2,35,35.6,-1,-2,1,-1,-3,-5,-4,-5
"1953",2018-04-07,"Slate River Rd","w1718","Non.motorized",10,"Sat","weekend","no_sled","Slate River Rd","2","2","2",9.2,0.3,31,6,37,29.7,-2,-1,-2,1,4,3,1,2
"1954",2018-04-07,"Slate River Rd","w1718","Mechanized",0,"Sat","weekend","no_sled","Slate River Rd","2","2","2",9.2,0.3,31,6,37,29.7,-2,-1,-2,1,4,3,1,2
"1955",2018-04-07,"Slate River Rd","w1718","Motorized",2,"Sat","weekend","sled","Slate River Rd","2","2","2",9.2,0.3,31,6,37,29.7,-2,-1,-2,1,4,3,1,2
"1956",2018-04-07,"Slate River Rd","w1718","Hybrid",2,"Sat","weekend","sled","Slate River Rd","2","2","2",9.2,0.3,31,6,37,29.7,-2,-1,-2,1,4,3,1,2
"1957",2018-04-08,"Slate River Rd","w1718","Non.motorized",7,"Sun","weekend","no_sled","Slate River Rd","3","3","3",10,0.8,33,2,33,30.3,6,-2,-1,-2,8,6,5,3
"1958",2018-04-08,"Slate River Rd","w1718","Mechanized",0,"Sun","weekend","no_sled","Slate River Rd","3","3","3",10,0.8,33,2,33,30.3,6,-2,-1,-2,8,6,5,3
"1959",2018-04-08,"Slate River Rd","w1718","Motorized",1,"Sun","weekend","sled","Slate River Rd","3","3","3",10,0.8,33,2,33,30.3,6,-2,-1,-2,8,6,5,3
"1960",2018-04-08,"Slate River Rd","w1718","Hybrid",1,"Sun","weekend","sled","Slate River Rd","3","3","3",10,0.8,33,2,33,30.3,6,-2,-1,-2,8,6,5,3
"1961",2018-04-09,"Slate River Rd","w1718","Non.motorized",7,"Mon","weekday","no_sled","Slate River Rd","1","1","1",10.1,0.1,33,0,31,30.6,2,6,-2,-1,2,8,6,5
"1962",2018-04-09,"Slate River Rd","w1718","Mechanized",0,"Mon","weekday","no_sled","Slate River Rd","1","1","1",10.1,0.1,33,0,31,30.6,2,6,-2,-1,2,8,6,5
"1963",2018-04-09,"Slate River Rd","w1718","Motorized",0,"Mon","weekday","sled","Slate River Rd","1","1","1",10.1,0.1,33,0,31,30.6,2,6,-2,-1,2,8,6,5
"1964",2018-04-09,"Slate River Rd","w1718","Hybrid",0,"Mon","weekday","sled","Slate River Rd","1","1","1",10.1,0.1,33,0,31,30.6,2,6,-2,-1,2,8,6,5
"1965",2018-04-10,"Slate River Rd","w1718","Non.motorized",10,"Tue","weekday","no_sled","Slate River Rd","1","1","1",10.1,0,31,-2,38,32.6,0,2,6,-2,-2,0,6,4
"1966",2018-04-10,"Slate River Rd","w1718","Mechanized",0,"Tue","weekday","no_sled","Slate River Rd","1","1","1",10.1,0,31,-2,38,32.6,0,2,6,-2,-2,0,6,4
"1967",2018-04-10,"Slate River Rd","w1718","Motorized",5,"Tue","weekday","sled","Slate River Rd","1","1","1",10.1,0,31,-2,38,32.6,0,2,6,-2,-2,0,6,4
"1968",2018-04-10,"Slate River Rd","w1718","Hybrid",3,"Tue","weekday","sled","Slate River Rd","1","1","1",10.1,0,31,-2,38,32.6,0,2,6,-2,-2,0,6,4
"1969",2018-04-11,"Slate River Rd","w1718","Non.motorized",11,"Wed","weekday","no_sled","Slate River Rd","2","2","2",9.9,-0.2,29,-2,45,34.1,-2,0,2,6,-4,-4,-2,4
"1970",2018-04-11,"Slate River Rd","w1718","Mechanized",0,"Wed","weekday","no_sled","Slate River Rd","2","2","2",9.9,-0.2,29,-2,45,34.1,-2,0,2,6,-4,-4,-2,4
"1971",2018-04-11,"Slate River Rd","w1718","Motorized",3,"Wed","weekday","sled","Slate River Rd","2","2","2",9.9,-0.2,29,-2,45,34.1,-2,0,2,6,-4,-4,-2,4
"1972",2018-04-11,"Slate River Rd","w1718","Hybrid",2,"Wed","weekday","sled","Slate River Rd","2","2","2",9.9,-0.2,29,-2,45,34.1,-2,0,2,6,-4,-4,-2,4
"1973",2018-04-12,"Slate River Rd","w1718","Non.motorized",1,"Thu","weekday","no_sled","Slate River Rd","1","2","2",9.5,-0.4,28,-1,40,33.9,-2,-2,0,2,-3,-5,-5,-3
"1974",2018-04-12,"Slate River Rd","w1718","Mechanized",0,"Thu","weekday","no_sled","Slate River Rd","1","2","2",9.5,-0.4,28,-1,40,33.9,-2,-2,0,2,-3,-5,-5,-3
"1975",2018-04-12,"Slate River Rd","w1718","Motorized",0,"Thu","weekday","sled","Slate River Rd","1","2","2",9.5,-0.4,28,-1,40,33.9,-2,-2,0,2,-3,-5,-5,-3
"1976",2018-04-12,"Slate River Rd","w1718","Hybrid",0,"Thu","weekday","sled","Slate River Rd","1","2","2",9.5,-0.4,28,-1,40,33.9,-2,-2,0,2,-3,-5,-5,-3
"1977",2018-04-13,"Slate River Rd","w1718","Non.motorized",9,"Fri","weekday","no_sled","Slate River Rd","2","2","1",9.4,-0.1,26,-2,23,36.2,-1,-2,-2,0,-3,-5,-7,-7
"1978",2018-04-13,"Slate River Rd","w1718","Mechanized",0,"Fri","weekday","no_sled","Slate River Rd","2","2","1",9.4,-0.1,26,-2,23,36.2,-1,-2,-2,0,-3,-5,-7,-7
"1979",2018-04-13,"Slate River Rd","w1718","Motorized",8,"Fri","weekday","sled","Slate River Rd","2","2","1",9.4,-0.1,26,-2,23,36.2,-1,-2,-2,0,-3,-5,-7,-7
"1980",2018-04-13,"Slate River Rd","w1718","Hybrid",0,"Fri","weekday","sled","Slate River Rd","2","2","1",9.4,-0.1,26,-2,23,36.2,-1,-2,-2,0,-3,-5,-7,-7
"1981",2018-04-14,"Slate River Rd","w1718","Non.motorized",20,"Sat","weekend","no_sled","Slate River Rd","2","2","1",9.4,0,28,2,28,33.6,-2,-1,-2,-2,0,-1,-3,-5
"1982",2018-04-14,"Slate River Rd","w1718","Mechanized",0,"Sat","weekend","no_sled","Slate River Rd","2","2","1",9.4,0,28,2,28,33.6,-2,-1,-2,-2,0,-1,-3,-5
"1983",2018-04-14,"Slate River Rd","w1718","Motorized",9,"Sat","weekend","sled","Slate River Rd","2","2","1",9.4,0,28,2,28,33.6,-2,-1,-2,-2,0,-1,-3,-5
"1984",2018-04-14,"Slate River Rd","w1718","Hybrid",5,"Sat","weekend","sled","Slate River Rd","2","2","1",9.4,0,28,2,28,33.6,-2,-1,-2,-2,0,-1,-3,-5
"1985",2018-04-15,"Slate River Rd","w1718","Non.motorized",10,"Sun","weekend","no_sled","Slate River Rd","2","2","1",9.2,-0.2,27,-1,37,34.1,2,-2,-1,-2,1,-1,-2,-4
"1986",2018-04-15,"Slate River Rd","w1718","Mechanized",2,"Sun","weekend","no_sled","Slate River Rd","2","2","1",9.2,-0.2,27,-1,37,34.1,2,-2,-1,-2,1,-1,-2,-4
"1987",2018-04-15,"Slate River Rd","w1718","Motorized",7,"Sun","weekend","sled","Slate River Rd","2","2","1",9.2,-0.2,27,-1,37,34.1,2,-2,-1,-2,1,-1,-2,-4
"1988",2018-04-15,"Slate River Rd","w1718","Hybrid",2,"Sun","weekend","sled","Slate River Rd","2","2","1",9.2,-0.2,27,-1,37,34.1,2,-2,-1,-2,1,-1,-2,-4
"1989",2018-04-16,"Slate River Rd","w1718","Non.motorized",5,"Mon","weekday","no_sled","Slate River Rd",NA,NA,NA,8.9,-0.3,24,-3,43,37.1,-1,2,-2,-1,-4,-2,-4,-5
"1990",2018-04-16,"Slate River Rd","w1718","Mechanized",0,"Mon","weekday","no_sled","Slate River Rd",NA,NA,NA,8.9,-0.3,24,-3,43,37.1,-1,2,-2,-1,-4,-2,-4,-5
"1991",2018-04-16,"Slate River Rd","w1718","Motorized",3,"Mon","weekday","sled","Slate River Rd",NA,NA,NA,8.9,-0.3,24,-3,43,37.1,-1,2,-2,-1,-4,-2,-4,-5
"1992",2018-04-16,"Slate River Rd","w1718","Hybrid",2,"Mon","weekday","sled","Slate River Rd",NA,NA,NA,8.9,-0.3,24,-3,43,37.1,-1,2,-2,-1,-4,-2,-4,-5
"1993",2017-12-22,"Snodgrass","w1718","Non.motorized",0,"Fri","weekday","no_sled","East River","2","2","1",2,0,11,3,17,18.2,0,0,0,0,3,3,3,3
"1994",2017-12-22,"Snodgrass","w1718","Mechanized",0,"Fri","weekday","no_sled","East River","2","2","1",2,0,11,3,17,18.2,0,0,0,0,3,3,3,3
"1995",2017-12-22,"Snodgrass","w1718","Motorized",0,"Fri","weekday","sled","East River","2","2","1",2,0,11,3,17,18.2,0,0,0,0,3,3,3,3
"1996",2017-12-22,"Snodgrass","w1718","Hybrid",NA,"Fri","weekday","sled","East River","2","2","1",2,0,11,3,17,18.2,0,0,0,0,3,3,3,3
"1997",2017-12-23,"Snodgrass","w1718","Non.motorized",0,"Sat","weekend","no_sled","East River","2","1","1",2.1,0.1,10,-1,21,21,3,0,0,0,2,2,2,2
"1998",2017-12-23,"Snodgrass","w1718","Mechanized",0,"Sat","weekend","no_sled","East River","2","1","1",2.1,0.1,10,-1,21,21,3,0,0,0,2,2,2,2
"1999",2017-12-23,"Snodgrass","w1718","Motorized",0,"Sat","weekend","sled","East River","2","1","1",2.1,0.1,10,-1,21,21,3,0,0,0,2,2,2,2
"2000",2017-12-23,"Snodgrass","w1718","Hybrid",NA,"Sat","weekend","sled","East River","2","1","1",2.1,0.1,10,-1,21,21,3,0,0,0,2,2,2,2
"2001",2017-12-24,"Snodgrass","w1718","Non.motorized",0,"Sun","weekend","no_sled","East River","1","1","1",2.4,0.3,14,4,19,17.1,-1,3,0,0,3,6,6,6
"2002",2017-12-24,"Snodgrass","w1718","Mechanized",0,"Sun","weekend","no_sled","East River","1","1","1",2.4,0.3,14,4,19,17.1,-1,3,0,0,3,6,6,6
"2003",2017-12-24,"Snodgrass","w1718","Motorized",0,"Sun","weekend","sled","East River","1","1","1",2.4,0.3,14,4,19,17.1,-1,3,0,0,3,6,6,6
"2004",2017-12-24,"Snodgrass","w1718","Hybrid",NA,"Sun","weekend","sled","East River","1","1","1",2.4,0.3,14,4,19,17.1,-1,3,0,0,3,6,6,6
"2005",2017-12-25,"Snodgrass","w1718","Non.motorized",40,"Mon","weekday","no_sled","East River","2","1","1",2.6,0.2,14,0,25,18.6,4,-1,3,0,4,3,6,6
"2006",2017-12-25,"Snodgrass","w1718","Mechanized",0,"Mon","weekday","no_sled","East River","2","1","1",2.6,0.2,14,0,25,18.6,4,-1,3,0,4,3,6,6
"2007",2017-12-25,"Snodgrass","w1718","Motorized",2,"Mon","weekday","sled","East River","2","1","1",2.6,0.2,14,0,25,18.6,4,-1,3,0,4,3,6,6
"2008",2017-12-25,"Snodgrass","w1718","Hybrid",NA,"Mon","weekday","sled","East River","2","1","1",2.6,0.2,14,0,25,18.6,4,-1,3,0,4,3,6,6
"2009",2017-12-26,"Snodgrass","w1718","Non.motorized",51,"Tue","weekday","no_sled","East River","1","1","1",3.1,0.5,20,6,25,15.5,0,4,-1,3,6,10,9,12
"2010",2017-12-26,"Snodgrass","w1718","Mechanized",0,"Tue","weekday","no_sled","East River","1","1","1",3.1,0.5,20,6,25,15.5,0,4,-1,3,6,10,9,12
"2011",2017-12-26,"Snodgrass","w1718","Motorized",4,"Tue","weekday","sled","East River","1","1","1",3.1,0.5,20,6,25,15.5,0,4,-1,3,6,10,9,12
"2012",2017-12-26,"Snodgrass","w1718","Hybrid",NA,"Tue","weekday","sled","East River","1","1","1",3.1,0.5,20,6,25,15.5,0,4,-1,3,6,10,9,12
"2013",2017-12-27,"Snodgrass","w1718","Non.motorized",97,"Wed","weekday","no_sled","East River","1","1","1",3.1,0,18,-2,27,17.2,6,0,4,-1,4,4,8,7
"2014",2017-12-27,"Snodgrass","w1718","Mechanized",1,"Wed","weekday","no_sled","East River","1","1","1",3.1,0,18,-2,27,17.2,6,0,4,-1,4,4,8,7
"2015",2017-12-27,"Snodgrass","w1718","Motorized",2,"Wed","weekday","sled","East River","1","1","1",3.1,0,18,-2,27,17.2,6,0,4,-1,4,4,8,7
"2016",2017-12-27,"Snodgrass","w1718","Hybrid",NA,"Wed","weekday","sled","East River","1","1","1",3.1,0,18,-2,27,17.2,6,0,4,-1,4,4,8,7
"2017",2017-12-28,"Snodgrass","w1718","Non.motorized",NA,"Thu","weekday","no_sled","East River","1","1","1",3.2,0.1,17,-1,31,18.8,-2,6,0,4,-3,3,3,7
"2018",2017-12-28,"Snodgrass","w1718","Mechanized",NA,"Thu","weekday","no_sled","East River","1","1","1",3.2,0.1,17,-1,31,18.8,-2,6,0,4,-3,3,3,7
"2019",2017-12-28,"Snodgrass","w1718","Motorized",NA,"Thu","weekday","sled","East River","1","1","1",3.2,0.1,17,-1,31,18.8,-2,6,0,4,-3,3,3,7
"2020",2017-12-28,"Snodgrass","w1718","Hybrid",NA,"Thu","weekday","sled","East River","1","1","1",3.2,0.1,17,-1,31,18.8,-2,6,0,4,-3,3,3,7
"2021",2017-12-29,"Snodgrass","w1718","Non.motorized",NA,"Fri","weekday","no_sled","East River","1","1","1",3.2,0,17,0,36,18.8,-1,-2,6,0,-1,-3,3,3
"2022",2017-12-29,"Snodgrass","w1718","Mechanized",NA,"Fri","weekday","no_sled","East River","1","1","1",3.2,0,17,0,36,18.8,-1,-2,6,0,-1,-3,3,3
"2023",2017-12-29,"Snodgrass","w1718","Motorized",NA,"Fri","weekday","sled","East River","1","1","1",3.2,0,17,0,36,18.8,-1,-2,6,0,-1,-3,3,3
"2024",2017-12-29,"Snodgrass","w1718","Hybrid",NA,"Fri","weekday","sled","East River","1","1","1",3.2,0,17,0,36,18.8,-1,-2,6,0,-1,-3,3,3
"2025",2017-12-30,"Snodgrass","w1718","Non.motorized",NA,"Sat","weekend","no_sled","East River","1","1","1",3.2,0,15,-2,37,21.3,0,-1,-2,6,-2,-3,-5,1
"2026",2017-12-30,"Snodgrass","w1718","Mechanized",NA,"Sat","weekend","no_sled","East River","1","1","1",3.2,0,15,-2,37,21.3,0,-1,-2,6,-2,-3,-5,1
"2027",2017-12-30,"Snodgrass","w1718","Motorized",NA,"Sat","weekend","sled","East River","1","1","1",3.2,0,15,-2,37,21.3,0,-1,-2,6,-2,-3,-5,1
"2028",2017-12-30,"Snodgrass","w1718","Hybrid",NA,"Sat","weekend","sled","East River","1","1","1",3.2,0,15,-2,37,21.3,0,-1,-2,6,-2,-3,-5,1
"2029",2017-12-31,"Snodgrass","w1718","Non.motorized",NA,"Sun","weekend","no_sled","East River","1","1","1",3.2,0,15,0,31,21.3,-2,0,-1,-2,-2,-2,-3,-5
"2030",2017-12-31,"Snodgrass","w1718","Mechanized",NA,"Sun","weekend","no_sled","East River","1","1","1",3.2,0,15,0,31,21.3,-2,0,-1,-2,-2,-2,-3,-5
"2031",2017-12-31,"Snodgrass","w1718","Motorized",NA,"Sun","weekend","sled","East River","1","1","1",3.2,0,15,0,31,21.3,-2,0,-1,-2,-2,-2,-3,-5
"2032",2017-12-31,"Snodgrass","w1718","Hybrid",NA,"Sun","weekend","sled","East River","1","1","1",3.2,0,15,0,31,21.3,-2,0,-1,-2,-2,-2,-3,-5
"2033",2018-01-01,"Snodgrass","w1718","Non.motorized",NA,"Mon","weekday","no_sled","East River","1","1","1",3.2,0,15,0,27,21.3,0,-2,0,-1,0,-2,-2,-3
"2034",2018-01-01,"Snodgrass","w1718","Mechanized",NA,"Mon","weekday","no_sled","East River","1","1","1",3.2,0,15,0,27,21.3,0,-2,0,-1,0,-2,-2,-3
"2035",2018-01-01,"Snodgrass","w1718","Motorized",NA,"Mon","weekday","sled","East River","1","1","1",3.2,0,15,0,27,21.3,0,-2,0,-1,0,-2,-2,-3
"2036",2018-01-01,"Snodgrass","w1718","Hybrid",NA,"Mon","weekday","sled","East River","1","1","1",3.2,0,15,0,27,21.3,0,-2,0,-1,0,-2,-2,-3
"2037",2018-01-02,"Snodgrass","w1718","Non.motorized",NA,"Tue","weekday","no_sled","East River","1","1","1",3.2,0,15,0,22,21.3,0,0,-2,0,0,0,-2,-2
"2038",2018-01-02,"Snodgrass","w1718","Mechanized",NA,"Tue","weekday","no_sled","East River","1","1","1",3.2,0,15,0,22,21.3,0,0,-2,0,0,0,-2,-2
"2039",2018-01-02,"Snodgrass","w1718","Motorized",NA,"Tue","weekday","sled","East River","1","1","1",3.2,0,15,0,22,21.3,0,0,-2,0,0,0,-2,-2
"2040",2018-01-02,"Snodgrass","w1718","Hybrid",NA,"Tue","weekday","sled","East River","1","1","1",3.2,0,15,0,22,21.3,0,0,-2,0,0,0,-2,-2
"2041",2018-01-03,"Snodgrass","w1718","Non.motorized",NA,"Wed","weekday","no_sled","East River","1","1","1",3.2,0,15,0,27,21.3,0,0,0,-2,0,0,0,-2
"2042",2018-01-03,"Snodgrass","w1718","Mechanized",NA,"Wed","weekday","no_sled","East River","1","1","1",3.2,0,15,0,27,21.3,0,0,0,-2,0,0,0,-2
"2043",2018-01-03,"Snodgrass","w1718","Motorized",NA,"Wed","weekday","sled","East River","1","1","1",3.2,0,15,0,27,21.3,0,0,0,-2,0,0,0,-2
"2044",2018-01-03,"Snodgrass","w1718","Hybrid",NA,"Wed","weekday","sled","East River","1","1","1",3.2,0,15,0,27,21.3,0,0,0,-2,0,0,0,-2
"2045",2018-01-04,"Snodgrass","w1718","Non.motorized",NA,"Thu","weekday","no_sled","East River","1","1","1",3.2,0,15,0,29,21.3,0,0,0,0,0,0,0,0
"2046",2018-01-04,"Snodgrass","w1718","Mechanized",NA,"Thu","weekday","no_sled","East River","1","1","1",3.2,0,15,0,29,21.3,0,0,0,0,0,0,0,0
"2047",2018-01-04,"Snodgrass","w1718","Motorized",NA,"Thu","weekday","sled","East River","1","1","1",3.2,0,15,0,29,21.3,0,0,0,0,0,0,0,0
"2048",2018-01-04,"Snodgrass","w1718","Hybrid",NA,"Thu","weekday","sled","East River","1","1","1",3.2,0,15,0,29,21.3,0,0,0,0,0,0,0,0
"2049",2018-01-05,"Snodgrass","w1718","Non.motorized",NA,"Fri","weekday","no_sled","East River","1","1","1",3.2,0,14,-1,32,22.9,0,0,0,0,-1,-1,-1,-1
"2050",2018-01-05,"Snodgrass","w1718","Mechanized",NA,"Fri","weekday","no_sled","East River","1","1","1",3.2,0,14,-1,32,22.9,0,0,0,0,-1,-1,-1,-1
"2051",2018-01-05,"Snodgrass","w1718","Motorized",NA,"Fri","weekday","sled","East River","1","1","1",3.2,0,14,-1,32,22.9,0,0,0,0,-1,-1,-1,-1
"2052",2018-01-05,"Snodgrass","w1718","Hybrid",NA,"Fri","weekday","sled","East River","1","1","1",3.2,0,14,-1,32,22.9,0,0,0,0,-1,-1,-1,-1
"2053",2018-01-06,"Snodgrass","w1718","Non.motorized",NA,"Sat","weekend","no_sled","East River","1","1","1",3.2,0,14,0,30,22.9,-1,0,0,0,-1,-1,-1,-1
"2054",2018-01-06,"Snodgrass","w1718","Mechanized",NA,"Sat","weekend","no_sled","East River","1","1","1",3.2,0,14,0,30,22.9,-1,0,0,0,-1,-1,-1,-1
"2055",2018-01-06,"Snodgrass","w1718","Motorized",NA,"Sat","weekend","sled","East River","1","1","1",3.2,0,14,0,30,22.9,-1,0,0,0,-1,-1,-1,-1
"2056",2018-01-06,"Snodgrass","w1718","Hybrid",NA,"Sat","weekend","sled","East River","1","1","1",3.2,0,14,0,30,22.9,-1,0,0,0,-1,-1,-1,-1
"2057",2018-01-07,"Snodgrass","w1718","Non.motorized",NA,"Sun","weekend","no_sled","East River","2","2","2",3.5,0.3,18,4,25,19.4,0,-1,0,0,4,3,3,3
"2058",2018-01-07,"Snodgrass","w1718","Mechanized",NA,"Sun","weekend","no_sled","East River","2","2","2",3.5,0.3,18,4,25,19.4,0,-1,0,0,4,3,3,3
"2059",2018-01-07,"Snodgrass","w1718","Motorized",NA,"Sun","weekend","sled","East River","2","2","2",3.5,0.3,18,4,25,19.4,0,-1,0,0,4,3,3,3
"2060",2018-01-07,"Snodgrass","w1718","Hybrid",NA,"Sun","weekend","sled","East River","2","2","2",3.5,0.3,18,4,25,19.4,0,-1,0,0,4,3,3,3
"2061",2018-01-08,"Snodgrass","w1718","Non.motorized",NA,"Mon","weekday","no_sled","East River","2","2","1",3.7,0.2,20,2,29,18.5,4,0,-1,0,6,6,5,5
"2062",2018-01-08,"Snodgrass","w1718","Mechanized",NA,"Mon","weekday","no_sled","East River","2","2","1",3.7,0.2,20,2,29,18.5,4,0,-1,0,6,6,5,5
"2063",2018-01-08,"Snodgrass","w1718","Motorized",NA,"Mon","weekday","sled","East River","2","2","1",3.7,0.2,20,2,29,18.5,4,0,-1,0,6,6,5,5
"2064",2018-01-08,"Snodgrass","w1718","Hybrid",NA,"Mon","weekday","sled","East River","2","2","1",3.7,0.2,20,2,29,18.5,4,0,-1,0,6,6,5,5
"2065",2018-01-09,"Snodgrass","w1718","Non.motorized",7,"Tue","weekday","no_sled","East River","2","2","1",3.8,0.1,21,1,34,18.1,2,4,0,-1,3,7,7,6
"2066",2018-01-09,"Snodgrass","w1718","Mechanized",0,"Tue","weekday","no_sled","East River","2","2","1",3.8,0.1,21,1,34,18.1,2,4,0,-1,3,7,7,6
"2067",2018-01-09,"Snodgrass","w1718","Motorized",0,"Tue","weekday","sled","East River","2","2","1",3.8,0.1,21,1,34,18.1,2,4,0,-1,3,7,7,6
"2068",2018-01-09,"Snodgrass","w1718","Hybrid",NA,"Tue","weekday","sled","East River","2","2","1",3.8,0.1,21,1,34,18.1,2,4,0,-1,3,7,7,6
"2069",2018-01-10,"Snodgrass","w1718","Non.motorized",73,"Wed","weekday","no_sled","East River","3","3","3",4,0.2,21,0,28,19,1,2,4,0,1,3,7,7
"2070",2018-01-10,"Snodgrass","w1718","Mechanized",0,"Wed","weekday","no_sled","East River","3","3","3",4,0.2,21,0,28,19,1,2,4,0,1,3,7,7
"2071",2018-01-10,"Snodgrass","w1718","Motorized",0,"Wed","weekday","sled","East River","3","3","3",4,0.2,21,0,28,19,1,2,4,0,1,3,7,7
"2072",2018-01-10,"Snodgrass","w1718","Hybrid",NA,"Wed","weekday","sled","East River","3","3","3",4,0.2,21,0,28,19,1,2,4,0,1,3,7,7
"2073",2018-01-11,"Snodgrass","w1718","Non.motorized",55,"Thu","weekday","no_sled","East River","3","3","3",4.1,0.1,26,5,17,15.8,0,1,2,4,5,6,8,12
"2074",2018-01-11,"Snodgrass","w1718","Mechanized",1,"Thu","weekday","no_sled","East River","3","3","3",4.1,0.1,26,5,17,15.8,0,1,2,4,5,6,8,12
"2075",2018-01-11,"Snodgrass","w1718","Motorized",0,"Thu","weekday","sled","East River","3","3","3",4.1,0.1,26,5,17,15.8,0,1,2,4,5,6,8,12
"2076",2018-01-11,"Snodgrass","w1718","Hybrid",NA,"Thu","weekday","sled","East River","3","3","3",4.1,0.1,26,5,17,15.8,0,1,2,4,5,6,8,12
"2077",2018-01-12,"Snodgrass","w1718","Non.motorized",29,"Fri","weekday","no_sled","East River","3","3","3",4.3,0.2,24,-2,22,17.9,5,0,1,2,3,3,4,6
"2078",2018-01-12,"Snodgrass","w1718","Mechanized",0,"Fri","weekday","no_sled","East River","3","3","3",4.3,0.2,24,-2,22,17.9,5,0,1,2,3,3,4,6
"2079",2018-01-12,"Snodgrass","w1718","Motorized",0,"Fri","weekday","sled","East River","3","3","3",4.3,0.2,24,-2,22,17.9,5,0,1,2,3,3,4,6
"2080",2018-01-12,"Snodgrass","w1718","Hybrid",NA,"Fri","weekday","sled","East River","3","3","3",4.3,0.2,24,-2,22,17.9,5,0,1,2,3,3,4,6
"2081",2018-01-13,"Snodgrass","w1718","Non.motorized",106,"Sat","weekend","no_sled","East River","3","3","3",4.4,0.1,24,0,24,18.3,-2,5,0,1,-2,3,3,4
"2082",2018-01-13,"Snodgrass","w1718","Mechanized",0,"Sat","weekend","no_sled","East River","3","3","3",4.4,0.1,24,0,24,18.3,-2,5,0,1,-2,3,3,4
"2083",2018-01-13,"Snodgrass","w1718","Motorized",3,"Sat","weekend","sled","East River","3","3","3",4.4,0.1,24,0,24,18.3,-2,5,0,1,-2,3,3,4
"2084",2018-01-13,"Snodgrass","w1718","Hybrid",NA,"Sat","weekend","sled","East River","3","3","3",4.4,0.1,24,0,24,18.3,-2,5,0,1,-2,3,3,4
"2085",2018-01-14,"Snodgrass","w1718","Non.motorized",151,"Sun","weekend","no_sled","East River","3","3","2",4.4,0,24,0,27,18.3,0,-2,5,0,0,-2,3,3
"2086",2018-01-14,"Snodgrass","w1718","Mechanized",2,"Sun","weekend","no_sled","East River","3","3","2",4.4,0,24,0,27,18.3,0,-2,5,0,0,-2,3,3
"2087",2018-01-14,"Snodgrass","w1718","Motorized",9,"Sun","weekend","sled","East River","3","3","2",4.4,0,24,0,27,18.3,0,-2,5,0,0,-2,3,3
"2088",2018-01-14,"Snodgrass","w1718","Hybrid",NA,"Sun","weekend","sled","East River","3","3","2",4.4,0,24,0,27,18.3,0,-2,5,0,0,-2,3,3
"2089",2018-01-15,"Snodgrass","w1718","Non.motorized",94,"Mon","weekday","no_sled","East River","3","3","2",4.4,0,23,-1,27,19.1,0,0,-2,5,-1,-1,-3,2
"2090",2018-01-15,"Snodgrass","w1718","Mechanized",0,"Mon","weekday","no_sled","East River","3","3","2",4.4,0,23,-1,27,19.1,0,0,-2,5,-1,-1,-3,2
"2091",2018-01-15,"Snodgrass","w1718","Motorized",0,"Mon","weekday","sled","East River","3","3","2",4.4,0,23,-1,27,19.1,0,0,-2,5,-1,-1,-3,2
"2092",2018-01-15,"Snodgrass","w1718","Hybrid",NA,"Mon","weekday","sled","East River","3","3","2",4.4,0,23,-1,27,19.1,0,0,-2,5,-1,-1,-3,2
"2093",2018-01-16,"Snodgrass","w1718","Non.motorized",32,"Tue","weekday","no_sled","East River","3","3","2",4.4,0,22,-1,20,20,-1,0,0,-2,-2,-2,-2,-4
"2094",2018-01-16,"Snodgrass","w1718","Mechanized",0,"Tue","weekday","no_sled","East River","3","3","2",4.4,0,22,-1,20,20,-1,0,0,-2,-2,-2,-2,-4
"2095",2018-01-16,"Snodgrass","w1718","Motorized",0,"Tue","weekday","sled","East River","3","3","2",4.4,0,22,-1,20,20,-1,0,0,-2,-2,-2,-2,-4
"2096",2018-01-16,"Snodgrass","w1718","Hybrid",NA,"Tue","weekday","sled","East River","3","3","2",4.4,0,22,-1,20,20,-1,0,0,-2,-2,-2,-2,-4
"2097",2018-01-17,"Snodgrass","w1718","Non.motorized",70,"Wed","weekday","no_sled","East River","2","2","2",4.4,0,22,0,24,20,-1,-1,0,0,-1,-2,-2,-2
"2098",2018-01-17,"Snodgrass","w1718","Mechanized",0,"Wed","weekday","no_sled","East River","2","2","2",4.4,0,22,0,24,20,-1,-1,0,0,-1,-2,-2,-2
"2099",2018-01-17,"Snodgrass","w1718","Motorized",1,"Wed","weekday","sled","East River","2","2","2",4.4,0,22,0,24,20,-1,-1,0,0,-1,-2,-2,-2
"2100",2018-01-17,"Snodgrass","w1718","Hybrid",NA,"Wed","weekday","sled","East River","2","2","2",4.4,0,22,0,24,20,-1,-1,0,0,-1,-2,-2,-2
"2101",2018-01-18,"Snodgrass","w1718","Non.motorized",88,"Thu","weekday","no_sled","East River","2","2","2",4.4,0,21,-1,29,21,0,-1,-1,0,-1,-2,-3,-3
"2102",2018-01-18,"Snodgrass","w1718","Mechanized",2,"Thu","weekday","no_sled","East River","2","2","2",4.4,0,21,-1,29,21,0,-1,-1,0,-1,-2,-3,-3
"2103",2018-01-18,"Snodgrass","w1718","Motorized",0,"Thu","weekday","sled","East River","2","2","2",4.4,0,21,-1,29,21,0,-1,-1,0,-1,-2,-3,-3
"2104",2018-01-18,"Snodgrass","w1718","Hybrid",NA,"Thu","weekday","sled","East River","2","2","2",4.4,0,21,-1,29,21,0,-1,-1,0,-1,-2,-3,-3
"2105",2018-01-19,"Snodgrass","w1718","Non.motorized",84,"Fri","weekday","no_sled","East River","2","2","2",4.5,0.1,21,0,34,21.4,-1,0,-1,-1,-1,-1,-2,-3
"2106",2018-01-19,"Snodgrass","w1718","Mechanized",1,"Fri","weekday","no_sled","East River","2","2","2",4.5,0.1,21,0,34,21.4,-1,0,-1,-1,-1,-1,-2,-3
"2107",2018-01-19,"Snodgrass","w1718","Motorized",4,"Fri","weekday","sled","East River","2","2","2",4.5,0.1,21,0,34,21.4,-1,0,-1,-1,-1,-1,-2,-3
"2108",2018-01-19,"Snodgrass","w1718","Hybrid",NA,"Fri","weekday","sled","East River","2","2","2",4.5,0.1,21,0,34,21.4,-1,0,-1,-1,-1,-1,-2,-3
"2109",2018-01-20,"Snodgrass","w1718","Non.motorized",118,"Sat","weekend","no_sled","East River","2","2","2",4.5,0,21,0,32,21.4,0,-1,0,-1,0,-1,-1,-2
"2110",2018-01-20,"Snodgrass","w1718","Mechanized",5,"Sat","weekend","no_sled","East River","2","2","2",4.5,0,21,0,32,21.4,0,-1,0,-1,0,-1,-1,-2
"2111",2018-01-20,"Snodgrass","w1718","Motorized",1,"Sat","weekend","sled","East River","2","2","2",4.5,0,21,0,32,21.4,0,-1,0,-1,0,-1,-1,-2
"2112",2018-01-20,"Snodgrass","w1718","Hybrid",NA,"Sat","weekend","sled","East River","2","2","2",4.5,0,21,0,32,21.4,0,-1,0,-1,0,-1,-1,-2
"2113",2018-01-21,"Snodgrass","w1718","Non.motorized",10,"Sun","weekend","no_sled","East River","3","3","3",4.6,0.1,23,2,15,20,0,0,-1,0,2,2,1,1
"2114",2018-01-21,"Snodgrass","w1718","Mechanized",2,"Sun","weekend","no_sled","East River","3","3","3",4.6,0.1,23,2,15,20,0,0,-1,0,2,2,1,1
"2115",2018-01-21,"Snodgrass","w1718","Motorized",1,"Sun","weekend","sled","East River","3","3","3",4.6,0.1,23,2,15,20,0,0,-1,0,2,2,1,1
"2116",2018-01-21,"Snodgrass","w1718","Hybrid",NA,"Sun","weekend","sled","East River","3","3","3",4.6,0.1,23,2,15,20,0,0,-1,0,2,2,1,1
"2117",2018-01-22,"Snodgrass","w1718","Non.motorized",55,"Mon","weekday","no_sled","East River","3","3","3",4.6,0,21,-2,12,21.9,2,0,0,-1,0,0,0,-1
"2118",2018-01-22,"Snodgrass","w1718","Mechanized",1,"Mon","weekday","no_sled","East River","3","3","3",4.6,0,21,-2,12,21.9,2,0,0,-1,0,0,0,-1
"2119",2018-01-22,"Snodgrass","w1718","Motorized",1,"Mon","weekday","sled","East River","3","3","3",4.6,0,21,-2,12,21.9,2,0,0,-1,0,0,0,-1
"2120",2018-01-22,"Snodgrass","w1718","Hybrid",NA,"Mon","weekday","sled","East River","3","3","3",4.6,0,21,-2,12,21.9,2,0,0,-1,0,0,0,-1
"2121",2018-01-23,"Snodgrass","w1718","Non.motorized",41,"Tue","weekday","no_sled","East River","3","3","3",4.6,0,22,1,16,20.9,-2,2,0,0,-1,1,1,1
"2122",2018-01-23,"Snodgrass","w1718","Mechanized",2,"Tue","weekday","no_sled","East River","3","3","3",4.6,0,22,1,16,20.9,-2,2,0,0,-1,1,1,1
"2123",2018-01-23,"Snodgrass","w1718","Motorized",6,"Tue","weekday","sled","East River","3","3","3",4.6,0,22,1,16,20.9,-2,2,0,0,-1,1,1,1
"2124",2018-01-23,"Snodgrass","w1718","Hybrid",NA,"Tue","weekday","sled","East River","3","3","3",4.6,0,22,1,16,20.9,-2,2,0,0,-1,1,1,1
"2125",2018-01-24,"Snodgrass","w1718","Non.motorized",62,"Wed","weekday","no_sled","East River","2","2","2",4.6,0,22,0,22,20.9,1,-2,2,0,1,-1,1,1
"2126",2018-01-24,"Snodgrass","w1718","Mechanized",1,"Wed","weekday","no_sled","East River","2","2","2",4.6,0,22,0,22,20.9,1,-2,2,0,1,-1,1,1
"2127",2018-01-24,"Snodgrass","w1718","Motorized",1,"Wed","weekday","sled","East River","2","2","2",4.6,0,22,0,22,20.9,1,-2,2,0,1,-1,1,1
"2128",2018-01-24,"Snodgrass","w1718","Hybrid",NA,"Wed","weekday","sled","East River","2","2","2",4.6,0,22,0,22,20.9,1,-2,2,0,1,-1,1,1
"2129",2018-01-25,"Snodgrass","w1718","Non.motorized",66,"Thu","weekday","no_sled","East River","2","2","2",4.6,0,22,0,28,20.9,0,1,-2,2,0,1,-1,1
"2130",2018-01-25,"Snodgrass","w1718","Mechanized",10,"Thu","weekday","no_sled","East River","2","2","2",4.6,0,22,0,28,20.9,0,1,-2,2,0,1,-1,1
"2131",2018-01-25,"Snodgrass","w1718","Motorized",1,"Thu","weekday","sled","East River","2","2","2",4.6,0,22,0,28,20.9,0,1,-2,2,0,1,-1,1
"2132",2018-01-25,"Snodgrass","w1718","Hybrid",NA,"Thu","weekday","sled","East River","2","2","2",4.6,0,22,0,28,20.9,0,1,-2,2,0,1,-1,1
"2133",2018-01-26,"Snodgrass","w1718","Non.motorized",29,"Fri","weekday","no_sled","East River","2","2","2",4.7,0.1,22,0,15,21.4,0,0,1,-2,0,0,1,-1
"2134",2018-01-26,"Snodgrass","w1718","Mechanized",7,"Fri","weekday","no_sled","East River","2","2","2",4.7,0.1,22,0,15,21.4,0,0,1,-2,0,0,1,-1
"2135",2018-01-26,"Snodgrass","w1718","Motorized",2,"Fri","weekday","sled","East River","2","2","2",4.7,0.1,22,0,15,21.4,0,0,1,-2,0,0,1,-1
"2136",2018-01-26,"Snodgrass","w1718","Hybrid",NA,"Fri","weekday","sled","East River","2","2","2",4.7,0.1,22,0,15,21.4,0,0,1,-2,0,0,1,-1
"2137",2018-01-27,"Snodgrass","w1718","Non.motorized",493,"Sat","weekend","no_sled","East River","2","2","2",4.7,0,23,1,16,20.4,0,0,0,1,1,1,1,2
"2138",2018-01-27,"Snodgrass","w1718","Mechanized",2,"Sat","weekend","no_sled","East River","2","2","2",4.7,0,23,1,16,20.4,0,0,0,1,1,1,1,2
"2139",2018-01-27,"Snodgrass","w1718","Motorized",0,"Sat","weekend","sled","East River","2","2","2",4.7,0,23,1,16,20.4,0,0,0,1,1,1,1,2
"2140",2018-01-27,"Snodgrass","w1718","Hybrid",NA,"Sat","weekend","sled","East River","2","2","2",4.7,0,23,1,16,20.4,0,0,0,1,1,1,1,2
"2141",2018-01-28,"Snodgrass","w1718","Non.motorized",109,"Sun","weekend","no_sled","East River","2","2","2",4.7,0,23,0,25,20.4,1,0,0,0,1,1,1,1
"2142",2018-01-28,"Snodgrass","w1718","Mechanized",13,"Sun","weekend","no_sled","East River","2","2","2",4.7,0,23,0,25,20.4,1,0,0,0,1,1,1,1
"2143",2018-01-28,"Snodgrass","w1718","Motorized",0,"Sun","weekend","sled","East River","2","2","2",4.7,0,23,0,25,20.4,1,0,0,0,1,1,1,1
"2144",2018-01-28,"Snodgrass","w1718","Hybrid",NA,"Sun","weekend","sled","East River","2","2","2",4.7,0,23,0,25,20.4,1,0,0,0,1,1,1,1
"2145",2018-01-29,"Snodgrass","w1718","Non.motorized",53,"Mon","weekday","no_sled","East River","2","2","2",4.8,0.1,22,-1,30,21.8,0,1,0,0,-1,0,0,0
"2146",2018-01-29,"Snodgrass","w1718","Mechanized",2,"Mon","weekday","no_sled","East River","2","2","2",4.8,0.1,22,-1,30,21.8,0,1,0,0,-1,0,0,0
"2147",2018-01-29,"Snodgrass","w1718","Motorized",0,"Mon","weekday","sled","East River","2","2","2",4.8,0.1,22,-1,30,21.8,0,1,0,0,-1,0,0,0
"2148",2018-01-29,"Snodgrass","w1718","Hybrid",NA,"Mon","weekday","sled","East River","2","2","2",4.8,0.1,22,-1,30,21.8,0,1,0,0,-1,0,0,0
"2149",2018-01-30,"Snodgrass","w1718","Non.motorized",50,"Tue","weekday","no_sled","East River","2","2","2",4.8,0,22,0,34,21.8,-1,0,1,0,-1,-1,0,0
"2150",2018-01-30,"Snodgrass","w1718","Mechanized",2,"Tue","weekday","no_sled","East River","2","2","2",4.8,0,22,0,34,21.8,-1,0,1,0,-1,-1,0,0
"2151",2018-01-30,"Snodgrass","w1718","Motorized",3,"Tue","weekday","sled","East River","2","2","2",4.8,0,22,0,34,21.8,-1,0,1,0,-1,-1,0,0
"2152",2018-01-30,"Snodgrass","w1718","Hybrid",NA,"Tue","weekday","sled","East River","2","2","2",4.8,0,22,0,34,21.8,-1,0,1,0,-1,-1,0,0
"2153",2018-01-31,"Snodgrass","w1718","Non.motorized",31,"Wed","weekday","no_sled","East River","2","2","2",4.8,0,22,0,34,21.8,0,-1,0,1,0,-1,-1,0
"2154",2018-01-31,"Snodgrass","w1718","Mechanized",4,"Wed","weekday","no_sled","East River","2","2","2",4.8,0,22,0,34,21.8,0,-1,0,1,0,-1,-1,0
"2155",2018-01-31,"Snodgrass","w1718","Motorized",1,"Wed","weekday","sled","East River","2","2","2",4.8,0,22,0,34,21.8,0,-1,0,1,0,-1,-1,0
"2156",2018-01-31,"Snodgrass","w1718","Hybrid",NA,"Wed","weekday","sled","East River","2","2","2",4.8,0,22,0,34,21.8,0,-1,0,1,0,-1,-1,0
"2157",2018-02-01,"Snodgrass","w1718","Non.motorized",45,"Thu","weekday","no_sled","East River","2","2","2",4.9,0.1,21,-1,32,23.3,0,0,-1,0,-1,-1,-2,-2
"2158",2018-02-01,"Snodgrass","w1718","Mechanized",4,"Thu","weekday","no_sled","East River","2","2","2",4.9,0.1,21,-1,32,23.3,0,0,-1,0,-1,-1,-2,-2
"2159",2018-02-01,"Snodgrass","w1718","Motorized",0,"Thu","weekday","sled","East River","2","2","2",4.9,0.1,21,-1,32,23.3,0,0,-1,0,-1,-1,-2,-2
"2160",2018-02-01,"Snodgrass","w1718","Hybrid",NA,"Thu","weekday","sled","East River","2","2","2",4.9,0.1,21,-1,32,23.3,0,0,-1,0,-1,-1,-2,-2
"2161",2018-02-02,"Snodgrass","w1718","Non.motorized",49,"Fri","weekday","no_sled","East River","2","2","2",4.9,0,20,-1,33,24.5,-1,0,0,-1,-2,-2,-2,-3
"2162",2018-02-02,"Snodgrass","w1718","Mechanized",4,"Fri","weekday","no_sled","East River","2","2","2",4.9,0,20,-1,33,24.5,-1,0,0,-1,-2,-2,-2,-3
"2163",2018-02-02,"Snodgrass","w1718","Motorized",0,"Fri","weekday","sled","East River","2","2","2",4.9,0,20,-1,33,24.5,-1,0,0,-1,-2,-2,-2,-3
"2164",2018-02-02,"Snodgrass","w1718","Hybrid",NA,"Fri","weekday","sled","East River","2","2","2",4.9,0,20,-1,33,24.5,-1,0,0,-1,-2,-2,-2,-3
"2165",2018-02-03,"Snodgrass","w1718","Non.motorized",97,"Sat","weekend","no_sled","East River","2","2","2",4.9,0,21,1,32,23.3,-1,-1,0,0,0,-1,-1,-1
"2166",2018-02-03,"Snodgrass","w1718","Mechanized",0,"Sat","weekend","no_sled","East River","2","2","2",4.9,0,21,1,32,23.3,-1,-1,0,0,0,-1,-1,-1
"2167",2018-02-03,"Snodgrass","w1718","Motorized",0,"Sat","weekend","sled","East River","2","2","2",4.9,0,21,1,32,23.3,-1,-1,0,0,0,-1,-1,-1
"2168",2018-02-03,"Snodgrass","w1718","Hybrid",NA,"Sat","weekend","sled","East River","2","2","2",4.9,0,21,1,32,23.3,-1,-1,0,0,0,-1,-1,-1
"2169",2018-02-04,"Snodgrass","w1718","Non.motorized",95,"Sun","weekend","no_sled","East River","2","2","2",4.9,0,19,-2,32,25.8,1,-1,-1,0,-1,-2,-3,-3
"2170",2018-02-04,"Snodgrass","w1718","Mechanized",2,"Sun","weekend","no_sled","East River","2","2","2",4.9,0,19,-2,32,25.8,1,-1,-1,0,-1,-2,-3,-3
"2171",2018-02-04,"Snodgrass","w1718","Motorized",1,"Sun","weekend","sled","East River","2","2","2",4.9,0,19,-2,32,25.8,1,-1,-1,0,-1,-2,-3,-3
"2172",2018-02-04,"Snodgrass","w1718","Hybrid",NA,"Sun","weekend","sled","East River","2","2","2",4.9,0,19,-2,32,25.8,1,-1,-1,0,-1,-2,-3,-3
"2173",2018-02-05,"Snodgrass","w1718","Non.motorized",29,"Mon","weekday","no_sled","East River","2","2","2",5,0.1,18,-1,29,27.8,-2,1,-1,-1,-3,-2,-3,-4
"2174",2018-02-05,"Snodgrass","w1718","Mechanized",0,"Mon","weekday","no_sled","East River","2","2","2",5,0.1,18,-1,29,27.8,-2,1,-1,-1,-3,-2,-3,-4
"2175",2018-02-05,"Snodgrass","w1718","Motorized",0,"Mon","weekday","sled","East River","2","2","2",5,0.1,18,-1,29,27.8,-2,1,-1,-1,-3,-2,-3,-4
"2176",2018-02-05,"Snodgrass","w1718","Hybrid",NA,"Mon","weekday","sled","East River","2","2","2",5,0.1,18,-1,29,27.8,-2,1,-1,-1,-3,-2,-3,-4
"2177",2018-02-06,"Snodgrass","w1718","Non.motorized",34,"Tue","weekday","no_sled","East River","2","2","2",5.2,0.2,23,5,22,22.6,-1,-2,1,-1,4,2,3,2
"2178",2018-02-06,"Snodgrass","w1718","Mechanized",0,"Tue","weekday","no_sled","East River","2","2","2",5.2,0.2,23,5,22,22.6,-1,-2,1,-1,4,2,3,2
"2179",2018-02-06,"Snodgrass","w1718","Motorized",0,"Tue","weekday","sled","East River","2","2","2",5.2,0.2,23,5,22,22.6,-1,-2,1,-1,4,2,3,2
"2180",2018-02-06,"Snodgrass","w1718","Hybrid",NA,"Tue","weekday","sled","East River","2","2","2",5.2,0.2,23,5,22,22.6,-1,-2,1,-1,4,2,3,2
"2181",2018-02-07,"Snodgrass","w1718","Non.motorized",62,"Wed","weekday","no_sled","East River","2","2","2",5.2,0,23,0,24,22.6,5,-1,-2,1,5,4,2,3
"2182",2018-02-07,"Snodgrass","w1718","Mechanized",0,"Wed","weekday","no_sled","East River","2","2","2",5.2,0,23,0,24,22.6,5,-1,-2,1,5,4,2,3
"2183",2018-02-07,"Snodgrass","w1718","Motorized",1,"Wed","weekday","sled","East River","2","2","2",5.2,0,23,0,24,22.6,5,-1,-2,1,5,4,2,3
"2184",2018-02-07,"Snodgrass","w1718","Hybrid",NA,"Wed","weekday","sled","East River","2","2","2",5.2,0,23,0,24,22.6,5,-1,-2,1,5,4,2,3
"2185",2018-02-08,"Snodgrass","w1718","Non.motorized",67,"Thu","weekday","no_sled","East River","2","2","1",5.3,0.1,25,2,28,21.2,0,5,-1,-2,2,7,6,4
"2186",2018-02-08,"Snodgrass","w1718","Mechanized",3,"Thu","weekday","no_sled","East River","2","2","1",5.3,0.1,25,2,28,21.2,0,5,-1,-2,2,7,6,4
"2187",2018-02-08,"Snodgrass","w1718","Motorized",1,"Thu","weekday","sled","East River","2","2","1",5.3,0.1,25,2,28,21.2,0,5,-1,-2,2,7,6,4
"2188",2018-02-08,"Snodgrass","w1718","Hybrid",NA,"Thu","weekday","sled","East River","2","2","1",5.3,0.1,25,2,28,21.2,0,5,-1,-2,2,7,6,4
"2189",2018-02-09,"Snodgrass","w1718","Non.motorized",55,"Fri","weekday","no_sled","East River","2","2","1",5.3,0,24,-1,33,22.1,2,0,5,-1,1,1,6,5
"2190",2018-02-09,"Snodgrass","w1718","Mechanized",1,"Fri","weekday","no_sled","East River","2","2","1",5.3,0,24,-1,33,22.1,2,0,5,-1,1,1,6,5
"2191",2018-02-09,"Snodgrass","w1718","Motorized",1,"Fri","weekday","sled","East River","2","2","1",5.3,0,24,-1,33,22.1,2,0,5,-1,1,1,6,5
"2192",2018-02-09,"Snodgrass","w1718","Hybrid",NA,"Fri","weekday","sled","East River","2","2","1",5.3,0,24,-1,33,22.1,2,0,5,-1,1,1,6,5
"2193",2018-02-10,"Snodgrass","w1718","Non.motorized",0,"Sat","weekend","no_sled","East River","3","3","2",5.3,0,24,0,24,22.1,-1,2,0,5,-1,1,1,6
"2194",2018-02-10,"Snodgrass","w1718","Mechanized",0,"Sat","weekend","no_sled","East River","3","3","2",5.3,0,24,0,24,22.1,-1,2,0,5,-1,1,1,6
"2195",2018-02-10,"Snodgrass","w1718","Motorized",0,"Sat","weekend","sled","East River","3","3","2",5.3,0,24,0,24,22.1,-1,2,0,5,-1,1,1,6
"2196",2018-02-10,"Snodgrass","w1718","Hybrid",NA,"Sat","weekend","sled","East River","3","3","2",5.3,0,24,0,24,22.1,-1,2,0,5,-1,1,1,6
"2197",2018-02-11,"Snodgrass","w1718","Non.motorized",87,"Sun","weekend","no_sled","East River","3","3","2",5.6,0.3,27,3,13,20.7,0,-1,2,0,3,2,4,4
"2198",2018-02-11,"Snodgrass","w1718","Mechanized",0,"Sun","weekend","no_sled","East River","3","3","2",5.6,0.3,27,3,13,20.7,0,-1,2,0,3,2,4,4
"2199",2018-02-11,"Snodgrass","w1718","Motorized",3,"Sun","weekend","sled","East River","3","3","2",5.6,0.3,27,3,13,20.7,0,-1,2,0,3,2,4,4
"2200",2018-02-11,"Snodgrass","w1718","Hybrid",NA,"Sun","weekend","sled","East River","3","3","2",5.6,0.3,27,3,13,20.7,0,-1,2,0,3,2,4,4
"2201",2018-02-12,"Snodgrass","w1718","Non.motorized",49,"Mon","weekday","no_sled","East River","3","3","3",5.7,0.1,27,0,23,21.1,3,0,-1,2,3,3,2,4
"2202",2018-02-12,"Snodgrass","w1718","Mechanized",0,"Mon","weekday","no_sled","East River","3","3","3",5.7,0.1,27,0,23,21.1,3,0,-1,2,3,3,2,4
"2203",2018-02-12,"Snodgrass","w1718","Motorized",0,"Mon","weekday","sled","East River","3","3","3",5.7,0.1,27,0,23,21.1,3,0,-1,2,3,3,2,4
"2204",2018-02-12,"Snodgrass","w1718","Hybrid",NA,"Mon","weekday","sled","East River","3","3","3",5.7,0.1,27,0,23,21.1,3,0,-1,2,3,3,2,4
"2205",2018-02-13,"Snodgrass","w1718","Non.motorized",35,"Tue","weekday","no_sled","East River","3","3","3",6.1,0.4,29,2,28,21,0,3,0,-1,2,5,5,4
"2206",2018-02-13,"Snodgrass","w1718","Mechanized",0,"Tue","weekday","no_sled","East River","3","3","3",6.1,0.4,29,2,28,21,0,3,0,-1,2,5,5,4
"2207",2018-02-13,"Snodgrass","w1718","Motorized",0,"Tue","weekday","sled","East River","3","3","3",6.1,0.4,29,2,28,21,0,3,0,-1,2,5,5,4
"2208",2018-02-13,"Snodgrass","w1718","Hybrid",NA,"Tue","weekday","sled","East River","3","3","3",6.1,0.4,29,2,28,21,0,3,0,-1,2,5,5,4
"2209",2018-02-14,"Snodgrass","w1718","Non.motorized",49,"Wed","weekday","no_sled","East River","3","3","3",6.2,0.1,30,1,30,20.7,2,0,3,0,3,3,6,6
"2210",2018-02-14,"Snodgrass","w1718","Mechanized",0,"Wed","weekday","no_sled","East River","3","3","3",6.2,0.1,30,1,30,20.7,2,0,3,0,3,3,6,6
"2211",2018-02-14,"Snodgrass","w1718","Motorized",2,"Wed","weekday","sled","East River","3","3","3",6.2,0.1,30,1,30,20.7,2,0,3,0,3,3,6,6
"2212",2018-02-14,"Snodgrass","w1718","Hybrid",NA,"Wed","weekday","sled","East River","3","3","3",6.2,0.1,30,1,30,20.7,2,0,3,0,3,3,6,6
"2213",2018-02-15,"Snodgrass","w1718","Non.motorized",29,"Thu","weekday","no_sled","East River","3","3","3",6.3,0.1,28,-2,24,22.5,1,2,0,3,-1,1,1,4
"2214",2018-02-15,"Snodgrass","w1718","Mechanized",0,"Thu","weekday","no_sled","East River","3","3","3",6.3,0.1,28,-2,24,22.5,1,2,0,3,-1,1,1,4
"2215",2018-02-15,"Snodgrass","w1718","Motorized",0,"Thu","weekday","sled","East River","3","3","3",6.3,0.1,28,-2,24,22.5,1,2,0,3,-1,1,1,4
"2216",2018-02-15,"Snodgrass","w1718","Hybrid",NA,"Thu","weekday","sled","East River","3","3","3",6.3,0.1,28,-2,24,22.5,1,2,0,3,-1,1,1,4
"2217",2018-02-16,"Snodgrass","w1718","Non.motorized",66,"Fri","weekday","no_sled","East River","3","3","3",6.7,0.4,32,4,18,20.9,-2,1,2,0,2,3,5,5
"2218",2018-02-16,"Snodgrass","w1718","Mechanized",0,"Fri","weekday","no_sled","East River","3","3","3",6.7,0.4,32,4,18,20.9,-2,1,2,0,2,3,5,5
"2219",2018-02-16,"Snodgrass","w1718","Motorized",9,"Fri","weekday","sled","East River","3","3","3",6.7,0.4,32,4,18,20.9,-2,1,2,0,2,3,5,5
"2220",2018-02-16,"Snodgrass","w1718","Hybrid",NA,"Fri","weekday","sled","East River","3","3","3",6.7,0.4,32,4,18,20.9,-2,1,2,0,2,3,5,5
"2221",2018-02-17,"Snodgrass","w1718","Non.motorized",180,"Sat","weekend","no_sled","East River","3","3","2",6.7,0,32,0,25,20.9,4,-2,1,2,4,2,3,5
"2222",2018-02-17,"Snodgrass","w1718","Mechanized",1,"Sat","weekend","no_sled","East River","3","3","2",6.7,0,32,0,25,20.9,4,-2,1,2,4,2,3,5
"2223",2018-02-17,"Snodgrass","w1718","Motorized",6,"Sat","weekend","sled","East River","3","3","2",6.7,0,32,0,25,20.9,4,-2,1,2,4,2,3,5
"2224",2018-02-17,"Snodgrass","w1718","Hybrid",NA,"Sat","weekend","sled","East River","3","3","2",6.7,0,32,0,25,20.9,4,-2,1,2,4,2,3,5
"2225",2018-02-18,"Snodgrass","w1718","Non.motorized",163,"Sun","weekend","no_sled","East River","2","2","2",6.7,0,31,-1,32,21.6,0,4,-2,1,-1,3,1,2
"2226",2018-02-18,"Snodgrass","w1718","Mechanized",2,"Sun","weekend","no_sled","East River","2","2","2",6.7,0,31,-1,32,21.6,0,4,-2,1,-1,3,1,2
"2227",2018-02-18,"Snodgrass","w1718","Motorized",0,"Sun","weekend","sled","East River","2","2","2",6.7,0,31,-1,32,21.6,0,4,-2,1,-1,3,1,2
"2228",2018-02-18,"Snodgrass","w1718","Hybrid",NA,"Sun","weekend","sled","East River","2","2","2",6.7,0,31,-1,32,21.6,0,4,-2,1,-1,3,1,2
"2229",2018-02-19,"Snodgrass","w1718","Non.motorized",59,"Mon","weekday","no_sled","East River","2","2","2",6.8,0.1,29,-2,24,23.4,-1,0,4,-2,-3,-3,1,-1
"2230",2018-02-19,"Snodgrass","w1718","Non.motorized",59,"Mon","weekday","no_sled","East River","3","3","3",6.8,0.1,29,-2,24,23.4,-1,0,4,-2,-3,-3,1,-1
"2231",2018-02-19,"Snodgrass","w1718","Mechanized",1,"Mon","weekday","no_sled","East River","2","2","2",6.8,0.1,29,-2,24,23.4,-1,0,4,-2,-3,-3,1,-1
"2232",2018-02-19,"Snodgrass","w1718","Mechanized",1,"Mon","weekday","no_sled","East River","3","3","3",6.8,0.1,29,-2,24,23.4,-1,0,4,-2,-3,-3,1,-1
"2233",2018-02-19,"Snodgrass","w1718","Motorized",0,"Mon","weekday","sled","East River","2","2","2",6.8,0.1,29,-2,24,23.4,-1,0,4,-2,-3,-3,1,-1
"2234",2018-02-19,"Snodgrass","w1718","Motorized",0,"Mon","weekday","sled","East River","3","3","3",6.8,0.1,29,-2,24,23.4,-1,0,4,-2,-3,-3,1,-1
"2235",2018-02-19,"Snodgrass","w1718","Hybrid",NA,"Mon","weekday","sled","East River","2","2","2",6.8,0.1,29,-2,24,23.4,-1,0,4,-2,-3,-3,1,-1
"2236",2018-02-19,"Snodgrass","w1718","Hybrid",NA,"Mon","weekday","sled","East River","3","3","3",6.8,0.1,29,-2,24,23.4,-1,0,4,-2,-3,-3,1,-1
"2237",2018-02-20,"Snodgrass","w1718","Non.motorized",26,"Tue","weekday","no_sled","East River","3","3","3",6.8,0,31,2,8,21.9,-2,-1,0,4,0,-1,-1,3
"2238",2018-02-20,"Snodgrass","w1718","Mechanized",0,"Tue","weekday","no_sled","East River","3","3","3",6.8,0,31,2,8,21.9,-2,-1,0,4,0,-1,-1,3
"2239",2018-02-20,"Snodgrass","w1718","Motorized",1,"Tue","weekday","sled","East River","3","3","3",6.8,0,31,2,8,21.9,-2,-1,0,4,0,-1,-1,3
"2240",2018-02-20,"Snodgrass","w1718","Hybrid",NA,"Tue","weekday","sled","East River","3","3","3",6.8,0,31,2,8,21.9,-2,-1,0,4,0,-1,-1,3
"2241",2018-02-21,"Snodgrass","w1718","Non.motorized",47,"Wed","weekday","no_sled","East River","3","3","3",6.8,0,31,0,11,21.9,2,-2,-1,0,2,0,-1,-1
"2242",2018-02-21,"Snodgrass","w1718","Mechanized",0,"Wed","weekday","no_sled","East River","3","3","3",6.8,0,31,0,11,21.9,2,-2,-1,0,2,0,-1,-1
"2243",2018-02-21,"Snodgrass","w1718","Motorized",0,"Wed","weekday","sled","East River","3","3","3",6.8,0,31,0,11,21.9,2,-2,-1,0,2,0,-1,-1
"2244",2018-02-21,"Snodgrass","w1718","Hybrid",NA,"Wed","weekday","sled","East River","3","3","3",6.8,0,31,0,11,21.9,2,-2,-1,0,2,0,-1,-1
"2245",2018-02-22,"Snodgrass","w1718","Non.motorized",28,"Thu","weekday","no_sled","East River","3","3","2",6.8,0,30,-1,16,22.7,0,2,-2,-1,-1,1,-1,-2
"2246",2018-02-22,"Snodgrass","w1718","Mechanized",1,"Thu","weekday","no_sled","East River","3","3","2",6.8,0,30,-1,16,22.7,0,2,-2,-1,-1,1,-1,-2
"2247",2018-02-22,"Snodgrass","w1718","Motorized",0,"Thu","weekday","sled","East River","3","3","2",6.8,0,30,-1,16,22.7,0,2,-2,-1,-1,1,-1,-2
"2248",2018-02-22,"Snodgrass","w1718","Hybrid",NA,"Thu","weekday","sled","East River","3","3","2",6.8,0,30,-1,16,22.7,0,2,-2,-1,-1,1,-1,-2
"2249",2018-02-23,"Snodgrass","w1718","Non.motorized",63,"Fri","weekday","no_sled","East River","3","3","2",6.9,0.1,30,0,15,23,-1,0,2,-2,-1,-1,1,-1
"2250",2018-02-23,"Snodgrass","w1718","Mechanized",0,"Fri","weekday","no_sled","East River","3","3","2",6.9,0.1,30,0,15,23,-1,0,2,-2,-1,-1,1,-1
"2251",2018-02-23,"Snodgrass","w1718","Motorized",0,"Fri","weekday","sled","East River","3","3","2",6.9,0.1,30,0,15,23,-1,0,2,-2,-1,-1,1,-1
"2252",2018-02-23,"Snodgrass","w1718","Hybrid",NA,"Fri","weekday","sled","East River","3","3","2",6.9,0.1,30,0,15,23,-1,0,2,-2,-1,-1,1,-1
"2253",2018-02-24,"Snodgrass","w1718","Non.motorized",56,"Sat","weekend","no_sled","East River","3","3","2",6.9,0,31,1,10,22.3,0,-1,0,2,1,0,0,2
"2254",2018-02-24,"Snodgrass","w1718","Mechanized",0,"Sat","weekend","no_sled","East River","3","3","2",6.9,0,31,1,10,22.3,0,-1,0,2,1,0,0,2
"2255",2018-02-24,"Snodgrass","w1718","Motorized",2,"Sat","weekend","sled","East River","3","3","2",6.9,0,31,1,10,22.3,0,-1,0,2,1,0,0,2
"2256",2018-02-24,"Snodgrass","w1718","Hybrid",NA,"Sat","weekend","sled","East River","3","3","2",6.9,0,31,1,10,22.3,0,-1,0,2,1,0,0,2
"2257",2018-02-25,"Snodgrass","w1718","Non.motorized",49,"Sun","weekend","no_sled","East River","3","3","2",7.1,0.2,32,1,11,22.2,1,0,-1,0,2,2,1,1
"2258",2018-02-25,"Snodgrass","w1718","Mechanized",5,"Sun","weekend","no_sled","East River","3","3","2",7.1,0.2,32,1,11,22.2,1,0,-1,0,2,2,1,1
"2259",2018-02-25,"Snodgrass","w1718","Motorized",0,"Sun","weekend","sled","East River","3","3","2",7.1,0.2,32,1,11,22.2,1,0,-1,0,2,2,1,1
"2260",2018-02-25,"Snodgrass","w1718","Hybrid",NA,"Sun","weekend","sled","East River","3","3","2",7.1,0.2,32,1,11,22.2,1,0,-1,0,2,2,1,1
"2261",2018-02-26,"Snodgrass","w1718","Non.motorized",48,"Mon","weekday","no_sled","East River","2","2","2",7.1,0,32,0,20,22.2,1,1,0,-1,1,2,2,1
"2262",2018-02-26,"Snodgrass","w1718","Mechanized",0,"Mon","weekday","no_sled","East River","2","2","2",7.1,0,32,0,20,22.2,1,1,0,-1,1,2,2,1
"2263",2018-02-26,"Snodgrass","w1718","Motorized",7,"Mon","weekday","sled","East River","2","2","2",7.1,0,32,0,20,22.2,1,1,0,-1,1,2,2,1
"2264",2018-02-26,"Snodgrass","w1718","Hybrid",NA,"Mon","weekday","sled","East River","2","2","2",7.1,0,32,0,20,22.2,1,1,0,-1,1,2,2,1
"2265",2018-02-27,"Snodgrass","w1718","Non.motorized",49,"Tue","weekday","no_sled","East River","2","2","2",7.2,0.1,32,0,26,22.5,0,1,1,0,0,1,2,2
"2266",2018-02-27,"Snodgrass","w1718","Mechanized",0,"Tue","weekday","no_sled","East River","2","2","2",7.2,0.1,32,0,26,22.5,0,1,1,0,0,1,2,2
"2267",2018-02-27,"Snodgrass","w1718","Motorized",1,"Tue","weekday","sled","East River","2","2","2",7.2,0.1,32,0,26,22.5,0,1,1,0,0,1,2,2
"2268",2018-02-27,"Snodgrass","w1718","Hybrid",NA,"Tue","weekday","sled","East River","2","2","2",7.2,0.1,32,0,26,22.5,0,1,1,0,0,1,2,2
"2269",2018-02-28,"Snodgrass","w1718","Non.motorized",37,"Wed","weekday","no_sled","East River","2","2","2",7.2,0,31,-1,23,23.2,0,0,1,1,-1,-1,0,1
"2270",2018-02-28,"Snodgrass","w1718","Mechanized",0,"Wed","weekday","no_sled","East River","2","2","2",7.2,0,31,-1,23,23.2,0,0,1,1,-1,-1,0,1
"2271",2018-02-28,"Snodgrass","w1718","Motorized",1,"Wed","weekday","sled","East River","2","2","2",7.2,0,31,-1,23,23.2,0,0,1,1,-1,-1,0,1
"2272",2018-02-28,"Snodgrass","w1718","Hybrid",NA,"Wed","weekday","sled","East River","2","2","2",7.2,0,31,-1,23,23.2,0,0,1,1,-1,-1,0,1
"2273",2018-03-01,"Snodgrass","w1718","Non.motorized",50,"Thu","weekday","no_sled","East River","2","2","2",7.2,0,31,0,24,23.2,-1,0,0,1,-1,-1,-1,0
"2274",2018-03-01,"Snodgrass","w1718","Mechanized",2,"Thu","weekday","no_sled","East River","2","2","2",7.2,0,31,0,24,23.2,-1,0,0,1,-1,-1,-1,0
"2275",2018-03-01,"Snodgrass","w1718","Motorized",1,"Thu","weekday","sled","East River","2","2","2",7.2,0,31,0,24,23.2,-1,0,0,1,-1,-1,-1,0
"2276",2018-03-01,"Snodgrass","w1718","Hybrid",NA,"Thu","weekday","sled","East River","2","2","2",7.2,0,31,0,24,23.2,-1,0,0,1,-1,-1,-1,0
"2277",2018-03-02,"Snodgrass","w1718","Non.motorized",75,"Fri","weekday","no_sled","East River","2","2","1",7.2,0,31,0,30,23.2,0,-1,0,0,0,-1,-1,-1
"2278",2018-03-02,"Snodgrass","w1718","Mechanized",1,"Fri","weekday","no_sled","East River","2","2","1",7.2,0,31,0,30,23.2,0,-1,0,0,0,-1,-1,-1
"2279",2018-03-02,"Snodgrass","w1718","Motorized",3,"Fri","weekday","sled","East River","2","2","1",7.2,0,31,0,30,23.2,0,-1,0,0,0,-1,-1,-1
"2280",2018-03-02,"Snodgrass","w1718","Hybrid",NA,"Fri","weekday","sled","East River","2","2","1",7.2,0,31,0,30,23.2,0,-1,0,0,0,-1,-1,-1
"2281",2018-03-03,"Snodgrass","w1718","Non.motorized",156,"Sat","weekend","no_sled","East River","2","2","1",7.3,0.1,30,-1,34,24.3,0,0,-1,0,-1,-1,-2,-2
"2282",2018-03-03,"Snodgrass","w1718","Mechanized",4,"Sat","weekend","no_sled","East River","2","2","1",7.3,0.1,30,-1,34,24.3,0,0,-1,0,-1,-1,-2,-2
"2283",2018-03-03,"Snodgrass","w1718","Motorized",5,"Sat","weekend","sled","East River","2","2","1",7.3,0.1,30,-1,34,24.3,0,0,-1,0,-1,-1,-2,-2
"2284",2018-03-03,"Snodgrass","w1718","Hybrid",NA,"Sat","weekend","sled","East River","2","2","1",7.3,0.1,30,-1,34,24.3,0,0,-1,0,-1,-1,-2,-2
"2285",2018-03-04,"Snodgrass","w1718","Non.motorized",77,"Sun","weekend","no_sled","East River","2","2","1",7.3,0,29,-1,24,25.2,-1,0,0,-1,-2,-2,-2,-3
"2286",2018-03-04,"Snodgrass","w1718","Mechanized",3,"Sun","weekend","no_sled","East River","2","2","1",7.3,0,29,-1,24,25.2,-1,0,0,-1,-2,-2,-2,-3
"2287",2018-03-04,"Snodgrass","w1718","Motorized",2,"Sun","weekend","sled","East River","2","2","1",7.3,0,29,-1,24,25.2,-1,0,0,-1,-2,-2,-2,-3
"2288",2018-03-04,"Snodgrass","w1718","Hybrid",NA,"Sun","weekend","sled","East River","2","2","1",7.3,0,29,-1,24,25.2,-1,0,0,-1,-2,-2,-2,-3
"2289",2018-03-05,"Snodgrass","w1718","Non.motorized",17,"Mon","weekday","no_sled","East River","2","2","1",7.3,0,31,2,13,23.5,-1,-1,0,0,1,0,0,0
"2290",2018-03-05,"Snodgrass","w1718","Mechanized",0,"Mon","weekday","no_sled","East River","2","2","1",7.3,0,31,2,13,23.5,-1,-1,0,0,1,0,0,0
"2291",2018-03-05,"Snodgrass","w1718","Motorized",0,"Mon","weekday","sled","East River","2","2","1",7.3,0,31,2,13,23.5,-1,-1,0,0,1,0,0,0
"2292",2018-03-05,"Snodgrass","w1718","Hybrid",NA,"Mon","weekday","sled","East River","2","2","1",7.3,0,31,2,13,23.5,-1,-1,0,0,1,0,0,0
"2293",2018-03-06,"Snodgrass","w1718","Non.motorized",50,"Tue","weekday","no_sled","East River","2","2","1",7.3,0,31,0,19,23.5,2,-1,-1,0,2,1,0,0
"2294",2018-03-06,"Snodgrass","w1718","Mechanized",0,"Tue","weekday","no_sled","East River","2","2","1",7.3,0,31,0,19,23.5,2,-1,-1,0,2,1,0,0
"2295",2018-03-06,"Snodgrass","w1718","Motorized",5,"Tue","weekday","sled","East River","2","2","1",7.3,0,31,0,19,23.5,2,-1,-1,0,2,1,0,0
"2296",2018-03-06,"Snodgrass","w1718","Hybrid",NA,"Tue","weekday","sled","East River","2","2","1",7.3,0,31,0,19,23.5,2,-1,-1,0,2,1,0,0
"2297",2018-03-07,"Snodgrass","w1718","Non.motorized",39,"Wed","weekday","no_sled","East River","2","2","1",7.4,0.1,31,0,27,23.9,0,2,-1,-1,0,2,1,0
"2298",2018-03-07,"Snodgrass","w1718","Mechanized",2,"Wed","weekday","no_sled","East River","2","2","1",7.4,0.1,31,0,27,23.9,0,2,-1,-1,0,2,1,0
"2299",2018-03-07,"Snodgrass","w1718","Motorized",0,"Wed","weekday","sled","East River","2","2","1",7.4,0.1,31,0,27,23.9,0,2,-1,-1,0,2,1,0
"2300",2018-03-07,"Snodgrass","w1718","Hybrid",NA,"Wed","weekday","sled","East River","2","2","1",7.4,0.1,31,0,27,23.9,0,2,-1,-1,0,2,1,0
"2301",2018-03-08,"Snodgrass","w1718","Non.motorized",39,"Thu","weekday","no_sled","East River","2","2","1",7.4,0,30,-1,33,24.7,0,0,2,-1,-1,-1,1,0
"2302",2018-03-08,"Snodgrass","w1718","Mechanized",0,"Thu","weekday","no_sled","East River","2","2","1",7.4,0,30,-1,33,24.7,0,0,2,-1,-1,-1,1,0
"2303",2018-03-08,"Snodgrass","w1718","Motorized",0,"Thu","weekday","sled","East River","2","2","1",7.4,0,30,-1,33,24.7,0,0,2,-1,-1,-1,1,0
"2304",2018-03-08,"Snodgrass","w1718","Hybrid",NA,"Thu","weekday","sled","East River","2","2","1",7.4,0,30,-1,33,24.7,0,0,2,-1,-1,-1,1,0
"2305",2018-03-09,"Snodgrass","w1718","Non.motorized",50,"Fri","weekday","no_sled","East River","2","2","1",7.4,0,30,0,34,24.7,-1,0,0,2,-1,-1,-1,1
"2306",2018-03-09,"Snodgrass","w1718","Mechanized",0,"Fri","weekday","no_sled","East River","2","2","1",7.4,0,30,0,34,24.7,-1,0,0,2,-1,-1,-1,1
"2307",2018-03-09,"Snodgrass","w1718","Motorized",1,"Fri","weekday","sled","East River","2","2","1",7.4,0,30,0,34,24.7,-1,0,0,2,-1,-1,-1,1
"2308",2018-03-09,"Snodgrass","w1718","Hybrid",NA,"Fri","weekday","sled","East River","2","2","1",7.4,0,30,0,34,24.7,-1,0,0,2,-1,-1,-1,1
"2309",2018-03-10,"Snodgrass","w1718","Non.motorized",64,"Sat","weekend","no_sled","East River","1","1","1",7.4,0,30,0,31,24.7,0,-1,0,0,0,-1,-1,-1
"2310",2018-03-10,"Snodgrass","w1718","Mechanized",3,"Sat","weekend","no_sled","East River","1","1","1",7.4,0,30,0,31,24.7,0,-1,0,0,0,-1,-1,-1
"2311",2018-03-10,"Snodgrass","w1718","Motorized",1,"Sat","weekend","sled","East River","1","1","1",7.4,0,30,0,31,24.7,0,-1,0,0,0,-1,-1,-1
"2312",2018-03-10,"Snodgrass","w1718","Hybrid",NA,"Sat","weekend","sled","East River","1","1","1",7.4,0,30,0,31,24.7,0,-1,0,0,0,-1,-1,-1
"2313",2018-03-11,"Snodgrass","w1718","Non.motorized",60,"Sun","weekend","no_sled","East River","1","1","1",7.4,0,29,-1,31,25.5,0,0,-1,0,-1,-1,-2,-2
"2314",2018-03-11,"Snodgrass","w1718","Mechanized",4,"Sun","weekend","no_sled","East River","1","1","1",7.4,0,29,-1,31,25.5,0,0,-1,0,-1,-1,-2,-2
"2315",2018-03-11,"Snodgrass","w1718","Motorized",13,"Sun","weekend","sled","East River","1","1","1",7.4,0,29,-1,31,25.5,0,0,-1,0,-1,-1,-2,-2
"2316",2018-03-11,"Snodgrass","w1718","Hybrid",NA,"Sun","weekend","sled","East River","1","1","1",7.4,0,29,-1,31,25.5,0,0,-1,0,-1,-1,-2,-2
"2317",2018-03-12,"Snodgrass","w1718","Non.motorized",46,"Mon","weekday","no_sled","East River","1","1","1",7.4,0,29,0,33,25.5,-1,0,0,-1,-1,-1,-1,-2
"2318",2018-03-12,"Snodgrass","w1718","Mechanized",1,"Mon","weekday","no_sled","East River","1","1","1",7.4,0,29,0,33,25.5,-1,0,0,-1,-1,-1,-1,-2
"2319",2018-03-12,"Snodgrass","w1718","Motorized",0,"Mon","weekday","sled","East River","1","1","1",7.4,0,29,0,33,25.5,-1,0,0,-1,-1,-1,-1,-2
"2320",2018-03-12,"Snodgrass","w1718","Hybrid",NA,"Mon","weekday","sled","East River","1","1","1",7.4,0,29,0,33,25.5,-1,0,0,-1,-1,-1,-1,-2
"2321",2018-03-13,"Snodgrass","w1718","Non.motorized",55,"Tue","weekday","no_sled","East River","1","1","1",7.4,0,29,0,34,25.5,0,-1,0,0,0,-1,-1,-1
"2322",2018-03-13,"Snodgrass","w1718","Mechanized",2,"Tue","weekday","no_sled","East River","1","1","1",7.4,0,29,0,34,25.5,0,-1,0,0,0,-1,-1,-1
"2323",2018-03-13,"Snodgrass","w1718","Motorized",12,"Tue","weekday","sled","East River","1","1","1",7.4,0,29,0,34,25.5,0,-1,0,0,0,-1,-1,-1
"2324",2018-03-13,"Snodgrass","w1718","Hybrid",NA,"Tue","weekday","sled","East River","1","1","1",7.4,0,29,0,34,25.5,0,-1,0,0,0,-1,-1,-1
"2325",2018-03-14,"Snodgrass","w1718","Non.motorized",41,"Wed","weekday","no_sled","East River","1","2","2",7.4,0,29,0,39,25.5,0,0,-1,0,0,0,-1,-1
"2326",2018-03-14,"Snodgrass","w1718","Mechanized",4,"Wed","weekday","no_sled","East River","1","2","2",7.4,0,29,0,39,25.5,0,0,-1,0,0,0,-1,-1
"2327",2018-03-14,"Snodgrass","w1718","Motorized",6,"Wed","weekday","sled","East River","1","2","2",7.4,0,29,0,39,25.5,0,0,-1,0,0,0,-1,-1
"2328",2018-03-14,"Snodgrass","w1718","Hybrid",NA,"Wed","weekday","sled","East River","1","2","2",7.4,0,29,0,39,25.5,0,0,-1,0,0,0,-1,-1
"2329",2018-03-15,"Snodgrass","w1718","Non.motorized",26,"Thu","weekday","no_sled","East River","2","2","2",7.5,0.1,28,-1,31,26.8,0,0,0,-1,-1,-1,-1,-2
"2330",2018-03-15,"Snodgrass","w1718","Mechanized",0,"Thu","weekday","no_sled","East River","2","2","2",7.5,0.1,28,-1,31,26.8,0,0,0,-1,-1,-1,-1,-2
"2331",2018-03-15,"Snodgrass","w1718","Motorized",2,"Thu","weekday","sled","East River","2","2","2",7.5,0.1,28,-1,31,26.8,0,0,0,-1,-1,-1,-1,-2
"2332",2018-03-15,"Snodgrass","w1718","Hybrid",NA,"Thu","weekday","sled","East River","2","2","2",7.5,0.1,28,-1,31,26.8,0,0,0,-1,-1,-1,-1,-2
"2333",2018-03-16,"Snodgrass","w1718","Non.motorized",49,"Fri","weekday","no_sled","East River","2","2","2",7.7,0.2,29,1,25,26.6,-1,0,0,0,0,0,0,0
"2334",2018-03-16,"Snodgrass","w1718","Mechanized",0,"Fri","weekday","no_sled","East River","2","2","2",7.7,0.2,29,1,25,26.6,-1,0,0,0,0,0,0,0
"2335",2018-03-16,"Snodgrass","w1718","Motorized",1,"Fri","weekday","sled","East River","2","2","2",7.7,0.2,29,1,25,26.6,-1,0,0,0,0,0,0,0
"2336",2018-03-16,"Snodgrass","w1718","Hybrid",NA,"Fri","weekday","sled","East River","2","2","2",7.7,0.2,29,1,25,26.6,-1,0,0,0,0,0,0,0
"2337",2018-03-17,"Snodgrass","w1718","Non.motorized",85,"Sat","weekend","no_sled","East River","2","2","2",7.8,0.1,32,3,29,24.4,1,-1,0,0,4,3,3,3
"2338",2018-03-17,"Snodgrass","w1718","Mechanized",0,"Sat","weekend","no_sled","East River","2","2","2",7.8,0.1,32,3,29,24.4,1,-1,0,0,4,3,3,3
"2339",2018-03-17,"Snodgrass","w1718","Motorized",0,"Sat","weekend","sled","East River","2","2","2",7.8,0.1,32,3,29,24.4,1,-1,0,0,4,3,3,3
"2340",2018-03-17,"Snodgrass","w1718","Hybrid",NA,"Sat","weekend","sled","East River","2","2","2",7.8,0.1,32,3,29,24.4,1,-1,0,0,4,3,3,3
"2341",2018-03-18,"Snodgrass","w1718","Non.motorized",48,"Sun","weekend","no_sled","East River","2","2","2",7.9,0.1,31,-1,24,25.5,3,1,-1,0,2,3,2,2
"2342",2018-03-18,"Snodgrass","w1718","Mechanized",0,"Sun","weekend","no_sled","East River","2","2","2",7.9,0.1,31,-1,24,25.5,3,1,-1,0,2,3,2,2
"2343",2018-03-18,"Snodgrass","w1718","Motorized",0,"Sun","weekend","sled","East River","2","2","2",7.9,0.1,31,-1,24,25.5,3,1,-1,0,2,3,2,2
"2344",2018-03-18,"Snodgrass","w1718","Hybrid",NA,"Sun","weekend","sled","East River","2","2","2",7.9,0.1,31,-1,24,25.5,3,1,-1,0,2,3,2,2
"2345",2018-03-19,"Snodgrass","w1718","Non.motorized",38,"Mon","weekday","no_sled","East River","2","2","1",8,0.1,32,1,19,25,-1,3,1,-1,0,3,4,3
"2346",2018-03-19,"Snodgrass","w1718","Mechanized",0,"Mon","weekday","no_sled","East River","2","2","1",8,0.1,32,1,19,25,-1,3,1,-1,0,3,4,3
"2347",2018-03-19,"Snodgrass","w1718","Motorized",1,"Mon","weekday","sled","East River","2","2","1",8,0.1,32,1,19,25,-1,3,1,-1,0,3,4,3
"2348",2018-03-19,"Snodgrass","w1718","Hybrid",NA,"Mon","weekday","sled","East River","2","2","1",8,0.1,32,1,19,25,-1,3,1,-1,0,3,4,3
"2349",2018-03-20,"Snodgrass","w1718","Non.motorized",42,"Tue","weekday","no_sled","East River","2","2","1",8,0,30,-2,24,26.7,1,-1,3,1,-1,-2,1,2
"2350",2018-03-20,"Snodgrass","w1718","Mechanized",0,"Tue","weekday","no_sled","East River","2","2","1",8,0,30,-2,24,26.7,1,-1,3,1,-1,-2,1,2
"2351",2018-03-20,"Snodgrass","w1718","Motorized",0,"Tue","weekday","sled","East River","2","2","1",8,0,30,-2,24,26.7,1,-1,3,1,-1,-2,1,2
"2352",2018-03-20,"Snodgrass","w1718","Hybrid",NA,"Tue","weekday","sled","East River","2","2","1",8,0,30,-2,24,26.7,1,-1,3,1,-1,-2,1,2
"2353",2018-03-21,"Snodgrass","w1718","Non.motorized",29,"Wed","weekday","no_sled","East River","1","1","1",8.1,0.1,32,2,30,25.3,-2,1,-1,3,0,1,0,3
"2354",2018-03-21,"Snodgrass","w1718","Mechanized",0,"Wed","weekday","no_sled","East River","1","1","1",8.1,0.1,32,2,30,25.3,-2,1,-1,3,0,1,0,3
"2355",2018-03-21,"Snodgrass","w1718","Motorized",0,"Wed","weekday","sled","East River","1","1","1",8.1,0.1,32,2,30,25.3,-2,1,-1,3,0,1,0,3
"2356",2018-03-21,"Snodgrass","w1718","Hybrid",NA,"Wed","weekday","sled","East River","1","1","1",8.1,0.1,32,2,30,25.3,-2,1,-1,3,0,1,0,3
"2357",2018-03-22,"Snodgrass","w1718","Non.motorized",37,"Thu","weekday","no_sled","East River","1","1","1",8.1,0,30,-2,36,27,2,-2,1,-1,0,-2,-1,-2
"2358",2018-03-22,"Snodgrass","w1718","Mechanized",0,"Thu","weekday","no_sled","East River","1","1","1",8.1,0,30,-2,36,27,2,-2,1,-1,0,-2,-1,-2
"2359",2018-03-22,"Snodgrass","w1718","Motorized",0,"Thu","weekday","sled","East River","1","1","1",8.1,0,30,-2,36,27,2,-2,1,-1,0,-2,-1,-2
"2360",2018-03-22,"Snodgrass","w1718","Hybrid",NA,"Thu","weekday","sled","East River","1","1","1",8.1,0,30,-2,36,27,2,-2,1,-1,0,-2,-1,-2
"2361",2018-03-23,"Snodgrass","w1718","Non.motorized",5,"Fri","weekday","no_sled","East River","2","2","3",8.2,0.1,29,-1,34,28.3,-2,2,-2,1,-3,-1,-3,-2
"2362",2018-03-23,"Snodgrass","w1718","Mechanized",0,"Fri","weekday","no_sled","East River","2","2","3",8.2,0.1,29,-1,34,28.3,-2,2,-2,1,-3,-1,-3,-2
"2363",2018-03-23,"Snodgrass","w1718","Motorized",0,"Fri","weekday","sled","East River","2","2","3",8.2,0.1,29,-1,34,28.3,-2,2,-2,1,-3,-1,-3,-2
"2364",2018-03-23,"Snodgrass","w1718","Hybrid",NA,"Fri","weekday","sled","East River","2","2","3",8.2,0.1,29,-1,34,28.3,-2,2,-2,1,-3,-1,-3,-2
"2365",2018-03-24,"Snodgrass","w1718","Non.motorized",75,"Sat","weekend","no_sled","East River","2","2","1",8.9,0.7,34,5,32,26.2,-1,-2,2,-2,4,2,4,2
"2366",2018-03-24,"Snodgrass","w1718","Mechanized",6,"Sat","weekend","no_sled","East River","2","2","1",8.9,0.7,34,5,32,26.2,-1,-2,2,-2,4,2,4,2
"2367",2018-03-24,"Snodgrass","w1718","Motorized",2,"Sat","weekend","sled","East River","2","2","1",8.9,0.7,34,5,32,26.2,-1,-2,2,-2,4,2,4,2
"2368",2018-03-24,"Snodgrass","w1718","Hybrid",NA,"Sat","weekend","sled","East River","2","2","1",8.9,0.7,34,5,32,26.2,-1,-2,2,-2,4,2,4,2
"2369",2018-03-25,"Snodgrass","w1718","Non.motorized",56,"Sun","weekend","no_sled","East River","2","2","1",8.9,0,35,1,35,25.4,5,-1,-2,2,6,5,3,5
"2370",2018-03-25,"Snodgrass","w1718","Mechanized",0,"Sun","weekend","no_sled","East River","2","2","1",8.9,0,35,1,35,25.4,5,-1,-2,2,6,5,3,5
"2371",2018-03-25,"Snodgrass","w1718","Motorized",4,"Sun","weekend","sled","East River","2","2","1",8.9,0,35,1,35,25.4,5,-1,-2,2,6,5,3,5
"2372",2018-03-25,"Snodgrass","w1718","Hybrid",NA,"Sun","weekend","sled","East River","2","2","1",8.9,0,35,1,35,25.4,5,-1,-2,2,6,5,3,5
"2373",2018-03-26,"Snodgrass","w1718","Non.motorized",44,"Mon","weekday","no_sled","East River","1","1","1",8.9,0,34,-1,31,26.2,1,5,-1,-2,0,5,4,2
"2374",2018-03-26,"Snodgrass","w1718","Non.motorized",44,"Mon","weekday","no_sled","East River","2","1","1",8.9,0,34,-1,31,26.2,1,5,-1,-2,0,5,4,2
"2375",2018-03-26,"Snodgrass","w1718","Mechanized",4,"Mon","weekday","no_sled","East River","1","1","1",8.9,0,34,-1,31,26.2,1,5,-1,-2,0,5,4,2
"2376",2018-03-26,"Snodgrass","w1718","Mechanized",4,"Mon","weekday","no_sled","East River","2","1","1",8.9,0,34,-1,31,26.2,1,5,-1,-2,0,5,4,2
"2377",2018-03-26,"Snodgrass","w1718","Motorized",2,"Mon","weekday","sled","East River","1","1","1",8.9,0,34,-1,31,26.2,1,5,-1,-2,0,5,4,2
"2378",2018-03-26,"Snodgrass","w1718","Motorized",2,"Mon","weekday","sled","East River","2","1","1",8.9,0,34,-1,31,26.2,1,5,-1,-2,0,5,4,2
"2379",2018-03-26,"Snodgrass","w1718","Hybrid",NA,"Mon","weekday","sled","East River","1","1","1",8.9,0,34,-1,31,26.2,1,5,-1,-2,0,5,4,2
"2380",2018-03-26,"Snodgrass","w1718","Hybrid",NA,"Mon","weekday","sled","East River","2","1","1",8.9,0,34,-1,31,26.2,1,5,-1,-2,0,5,4,2
"2381",2018-03-27,"Snodgrass","w1718","Non.motorized",24,"Tue","weekday","no_sled","East River","1","1","1",8.9,0,33,-1,29,27,-1,1,5,-1,-2,-1,4,3
"2382",2018-03-27,"Snodgrass","w1718","Mechanized",1,"Tue","weekday","no_sled","East River","1","1","1",8.9,0,33,-1,29,27,-1,1,5,-1,-2,-1,4,3
"2383",2018-03-27,"Snodgrass","w1718","Motorized",4,"Tue","weekday","sled","East River","1","1","1",8.9,0,33,-1,29,27,-1,1,5,-1,-2,-1,4,3
"2384",2018-03-27,"Snodgrass","w1718","Hybrid",NA,"Tue","weekday","sled","East River","1","1","1",8.9,0,33,-1,29,27,-1,1,5,-1,-2,-1,4,3
"2385",2018-03-28,"Snodgrass","w1718","Non.motorized",34,"Wed","weekday","no_sled","East River","1","1","1",8.9,0,33,0,27,27,-1,-1,1,5,-1,-2,-1,4
"2386",2018-03-28,"Snodgrass","w1718","Mechanized",0,"Wed","weekday","no_sled","East River","1","1","1",8.9,0,33,0,27,27,-1,-1,1,5,-1,-2,-1,4
"2387",2018-03-28,"Snodgrass","w1718","Motorized",0,"Wed","weekday","sled","East River","1","1","1",8.9,0,33,0,27,27,-1,-1,1,5,-1,-2,-1,4
"2388",2018-03-28,"Snodgrass","w1718","Hybrid",NA,"Wed","weekday","sled","East River","1","1","1",8.9,0,33,0,27,27,-1,-1,1,5,-1,-2,-1,4
"2389",2018-03-29,"Snodgrass","w1718","Non.motorized",33,"Thu","weekday","no_sled","East River","1","1","1",8.9,0,33,0,27,27,0,-1,-1,1,0,-1,-2,-1
"2390",2018-03-29,"Snodgrass","w1718","Mechanized",0,"Thu","weekday","no_sled","East River","1","1","1",8.9,0,33,0,27,27,0,-1,-1,1,0,-1,-2,-1
"2391",2018-03-29,"Snodgrass","w1718","Motorized",1,"Thu","weekday","sled","East River","1","1","1",8.9,0,33,0,27,27,0,-1,-1,1,0,-1,-2,-1
"2392",2018-03-29,"Snodgrass","w1718","Hybrid",NA,"Thu","weekday","sled","East River","1","1","1",8.9,0,33,0,27,27,0,-1,-1,1,0,-1,-2,-1
"2393",2018-03-30,"Snodgrass","w1718","Non.motorized",39,"Fri","weekday","no_sled","East River","1","1","1",8.9,0,32,-1,33,27.8,0,0,-1,-1,-1,-1,-2,-3
"2394",2018-03-30,"Snodgrass","w1718","Mechanized",0,"Fri","weekday","no_sled","East River","1","1","1",8.9,0,32,-1,33,27.8,0,0,-1,-1,-1,-1,-2,-3
"2395",2018-03-30,"Snodgrass","w1718","Motorized",2,"Fri","weekday","sled","East River","1","1","1",8.9,0,32,-1,33,27.8,0,0,-1,-1,-1,-1,-2,-3
"2396",2018-03-30,"Snodgrass","w1718","Hybrid",NA,"Fri","weekday","sled","East River","1","1","1",8.9,0,32,-1,33,27.8,0,0,-1,-1,-1,-1,-2,-3
"2397",2018-03-31,"Snodgrass","w1718","Non.motorized",63,"Sat","weekend","no_sled","East River","1","1","1",8.9,0,32,0,39,27.8,-1,0,0,-1,-1,-1,-1,-2
"2398",2018-03-31,"Snodgrass","w1718","Mechanized",0,"Sat","weekend","no_sled","East River","1","1","1",8.9,0,32,0,39,27.8,-1,0,0,-1,-1,-1,-1,-2
"2399",2018-03-31,"Snodgrass","w1718","Motorized",0,"Sat","weekend","sled","East River","1","1","1",8.9,0,32,0,39,27.8,-1,0,0,-1,-1,-1,-1,-2
"2400",2018-03-31,"Snodgrass","w1718","Hybrid",NA,"Sat","weekend","sled","East River","1","1","1",8.9,0,32,0,39,27.8,-1,0,0,-1,-1,-1,-1,-2
"2401",2018-04-01,"Snodgrass","w1718","Non.motorized",41,"Sun","weekend","no_sled","East River","1","1","1",8.8,-0.1,30,-2,41,29.3,0,-1,0,0,-2,-3,-3,-3
"2402",2018-04-01,"Snodgrass","w1718","Mechanized",1,"Sun","weekend","no_sled","East River","1","1","1",8.8,-0.1,30,-2,41,29.3,0,-1,0,0,-2,-3,-3,-3
"2403",2018-04-01,"Snodgrass","w1718","Motorized",2,"Sun","weekend","sled","East River","1","1","1",8.8,-0.1,30,-2,41,29.3,0,-1,0,0,-2,-3,-3,-3
"2404",2018-04-01,"Snodgrass","w1718","Hybrid",NA,"Sun","weekend","sled","East River","1","1","1",8.8,-0.1,30,-2,41,29.3,0,-1,0,0,-2,-3,-3,-3
"2405",2018-04-02,"Snodgrass","w1718","Non.motorized",10,"Mon","weekday","no_sled","East River","1","1","1",8.7,-0.1,29,-1,39,30,-2,0,-1,0,-3,-3,-4,-4
"2406",2018-04-02,"Snodgrass","w1718","Mechanized",0,"Mon","weekday","no_sled","East River","1","1","1",8.7,-0.1,29,-1,39,30,-2,0,-1,0,-3,-3,-4,-4
"2407",2018-04-02,"Snodgrass","w1718","Motorized",0,"Mon","weekday","sled","East River","1","1","1",8.7,-0.1,29,-1,39,30,-2,0,-1,0,-3,-3,-4,-4
"2408",2018-04-02,"Snodgrass","w1718","Hybrid",NA,"Mon","weekday","sled","East River","1","1","1",8.7,-0.1,29,-1,39,30,-2,0,-1,0,-3,-3,-4,-4
"2409",2018-04-03,"Snodgrass","w1718","Non.motorized",16,"Tue","weekday","no_sled","East River","1","1","1",8.8,0.1,30,1,27,29.3,-1,-2,0,-1,0,-2,-2,-3
"2410",2018-04-03,"Snodgrass","w1718","Mechanized",0,"Tue","weekday","no_sled","East River","1","1","1",8.8,0.1,30,1,27,29.3,-1,-2,0,-1,0,-2,-2,-3
"2411",2018-04-03,"Snodgrass","w1718","Motorized",0,"Tue","weekday","sled","East River","1","1","1",8.8,0.1,30,1,27,29.3,-1,-2,0,-1,0,-2,-2,-3
"2412",2018-04-03,"Snodgrass","w1718","Hybrid",NA,"Tue","weekday","sled","East River","1","1","1",8.8,0.1,30,1,27,29.3,-1,-2,0,-1,0,-2,-2,-3
"2413",2018-04-04,"Snodgrass","w1718","Non.motorized",27,"Wed","weekday","no_sled","East River","1","2","2",8.9,0.1,28,-2,33,31.8,1,-1,-2,0,-1,-2,-4,-4
"2414",2018-04-04,"Snodgrass","w1718","Mechanized",0,"Wed","weekday","no_sled","East River","1","2","2",8.9,0.1,28,-2,33,31.8,1,-1,-2,0,-1,-2,-4,-4
"2415",2018-04-04,"Snodgrass","w1718","Motorized",0,"Wed","weekday","sled","East River","1","2","2",8.9,0.1,28,-2,33,31.8,1,-1,-2,0,-1,-2,-4,-4
"2416",2018-04-04,"Snodgrass","w1718","Hybrid",NA,"Wed","weekday","sled","East River","1","2","2",8.9,0.1,28,-2,33,31.8,1,-1,-2,0,-1,-2,-4,-4
"2417",2018-04-05,"Snodgrass","w1718","Non.motorized",14,"Thu","weekday","no_sled","East River","1","2","2",8.9,0,27,-1,35,33,-2,1,-1,-2,-3,-2,-3,-5
"2418",2018-04-05,"Snodgrass","w1718","Mechanized",0,"Thu","weekday","no_sled","East River","1","2","2",8.9,0,27,-1,35,33,-2,1,-1,-2,-3,-2,-3,-5
"2419",2018-04-05,"Snodgrass","w1718","Motorized",0,"Thu","weekday","sled","East River","1","2","2",8.9,0,27,-1,35,33,-2,1,-1,-2,-3,-2,-3,-5
"2420",2018-04-05,"Snodgrass","w1718","Hybrid",NA,"Thu","weekday","sled","East River","1","2","2",8.9,0,27,-1,35,33,-2,1,-1,-2,-3,-2,-3,-5
"2421",2018-04-06,"Snodgrass","w1718","Non.motorized",11,"Fri","weekday","no_sled","East River","1","2","2",8.9,0,25,-2,35,35.6,-1,-2,1,-1,-3,-5,-4,-5
"2422",2018-04-06,"Snodgrass","w1718","Mechanized",0,"Fri","weekday","no_sled","East River","1","2","2",8.9,0,25,-2,35,35.6,-1,-2,1,-1,-3,-5,-4,-5
"2423",2018-04-06,"Snodgrass","w1718","Motorized",0,"Fri","weekday","sled","East River","1","2","2",8.9,0,25,-2,35,35.6,-1,-2,1,-1,-3,-5,-4,-5
"2424",2018-04-06,"Snodgrass","w1718","Hybrid",NA,"Fri","weekday","sled","East River","1","2","2",8.9,0,25,-2,35,35.6,-1,-2,1,-1,-3,-5,-4,-5
"2425",2018-04-07,"Snodgrass","w1718","Non.motorized",30,"Sat","weekend","no_sled","East River","2","2","2",9.2,0.3,31,6,37,29.7,-2,-1,-2,1,4,3,1,2
"2426",2018-04-07,"Snodgrass","w1718","Mechanized",0,"Sat","weekend","no_sled","East River","2","2","2",9.2,0.3,31,6,37,29.7,-2,-1,-2,1,4,3,1,2
"2427",2018-04-07,"Snodgrass","w1718","Motorized",1,"Sat","weekend","sled","East River","2","2","2",9.2,0.3,31,6,37,29.7,-2,-1,-2,1,4,3,1,2
"2428",2018-04-07,"Snodgrass","w1718","Hybrid",NA,"Sat","weekend","sled","East River","2","2","2",9.2,0.3,31,6,37,29.7,-2,-1,-2,1,4,3,1,2
"2429",2018-04-08,"Snodgrass","w1718","Non.motorized",7,"Sun","weekend","no_sled","East River","3","3","3",10,0.8,33,2,33,30.3,6,-2,-1,-2,8,6,5,3
"2430",2018-04-08,"Snodgrass","w1718","Mechanized",0,"Sun","weekend","no_sled","East River","3","3","3",10,0.8,33,2,33,30.3,6,-2,-1,-2,8,6,5,3
"2431",2018-04-08,"Snodgrass","w1718","Motorized",0,"Sun","weekend","sled","East River","3","3","3",10,0.8,33,2,33,30.3,6,-2,-1,-2,8,6,5,3
"2432",2018-04-08,"Snodgrass","w1718","Hybrid",NA,"Sun","weekend","sled","East River","3","3","3",10,0.8,33,2,33,30.3,6,-2,-1,-2,8,6,5,3
"2433",2018-04-09,"Snodgrass","w1718","Non.motorized",19,"Mon","weekday","no_sled","East River","1","1","1",10.1,0.1,33,0,31,30.6,2,6,-2,-1,2,8,6,5
"2434",2018-04-09,"Snodgrass","w1718","Mechanized",0,"Mon","weekday","no_sled","East River","1","1","1",10.1,0.1,33,0,31,30.6,2,6,-2,-1,2,8,6,5
"2435",2018-04-09,"Snodgrass","w1718","Motorized",0,"Mon","weekday","sled","East River","1","1","1",10.1,0.1,33,0,31,30.6,2,6,-2,-1,2,8,6,5
"2436",2018-04-09,"Snodgrass","w1718","Hybrid",NA,"Mon","weekday","sled","East River","1","1","1",10.1,0.1,33,0,31,30.6,2,6,-2,-1,2,8,6,5
"2437",2018-04-10,"Snodgrass","w1718","Non.motorized",9,"Tue","weekday","no_sled","East River","1","1","1",10.1,0,31,-2,38,32.6,0,2,6,-2,-2,0,6,4
"2438",2018-04-10,"Snodgrass","w1718","Mechanized",0,"Tue","weekday","no_sled","East River","1","1","1",10.1,0,31,-2,38,32.6,0,2,6,-2,-2,0,6,4
"2439",2018-04-10,"Snodgrass","w1718","Motorized",0,"Tue","weekday","sled","East River","1","1","1",10.1,0,31,-2,38,32.6,0,2,6,-2,-2,0,6,4
"2440",2018-04-10,"Snodgrass","w1718","Hybrid",NA,"Tue","weekday","sled","East River","1","1","1",10.1,0,31,-2,38,32.6,0,2,6,-2,-2,0,6,4
"2441",2018-04-11,"Snodgrass","w1718","Non.motorized",3,"Wed","weekday","no_sled","East River","2","2","2",9.9,-0.2,29,-2,45,34.1,-2,0,2,6,-4,-4,-2,4
"2442",2018-04-11,"Snodgrass","w1718","Mechanized",0,"Wed","weekday","no_sled","East River","2","2","2",9.9,-0.2,29,-2,45,34.1,-2,0,2,6,-4,-4,-2,4
"2443",2018-04-11,"Snodgrass","w1718","Motorized",0,"Wed","weekday","sled","East River","2","2","2",9.9,-0.2,29,-2,45,34.1,-2,0,2,6,-4,-4,-2,4
"2444",2018-04-11,"Snodgrass","w1718","Hybrid",NA,"Wed","weekday","sled","East River","2","2","2",9.9,-0.2,29,-2,45,34.1,-2,0,2,6,-4,-4,-2,4
"2445",2018-04-12,"Snodgrass","w1718","Non.motorized",3,"Thu","weekday","no_sled","East River","1","2","2",9.5,-0.4,28,-1,40,33.9,-2,-2,0,2,-3,-5,-5,-3
"2446",2018-04-12,"Snodgrass","w1718","Mechanized",0,"Thu","weekday","no_sled","East River","1","2","2",9.5,-0.4,28,-1,40,33.9,-2,-2,0,2,-3,-5,-5,-3
"2447",2018-04-12,"Snodgrass","w1718","Motorized",0,"Thu","weekday","sled","East River","1","2","2",9.5,-0.4,28,-1,40,33.9,-2,-2,0,2,-3,-5,-5,-3
"2448",2018-04-12,"Snodgrass","w1718","Hybrid",NA,"Thu","weekday","sled","East River","1","2","2",9.5,-0.4,28,-1,40,33.9,-2,-2,0,2,-3,-5,-5,-3
"2449",2018-04-13,"Snodgrass","w1718","Non.motorized",0,"Fri","weekday","no_sled","East River","2","2","1",9.4,-0.1,26,-2,23,36.2,-1,-2,-2,0,-3,-5,-7,-7
"2450",2018-04-13,"Snodgrass","w1718","Mechanized",0,"Fri","weekday","no_sled","East River","2","2","1",9.4,-0.1,26,-2,23,36.2,-1,-2,-2,0,-3,-5,-7,-7
"2451",2018-04-13,"Snodgrass","w1718","Motorized",0,"Fri","weekday","sled","East River","2","2","1",9.4,-0.1,26,-2,23,36.2,-1,-2,-2,0,-3,-5,-7,-7
"2452",2018-04-13,"Snodgrass","w1718","Hybrid",NA,"Fri","weekday","sled","East River","2","2","1",9.4,-0.1,26,-2,23,36.2,-1,-2,-2,0,-3,-5,-7,-7
"2453",2018-04-14,"Snodgrass","w1718","Non.motorized",13,"Sat","weekend","no_sled","East River","2","2","1",9.4,0,28,2,28,33.6,-2,-1,-2,-2,0,-1,-3,-5
"2454",2018-04-14,"Snodgrass","w1718","Mechanized",0,"Sat","weekend","no_sled","East River","2","2","1",9.4,0,28,2,28,33.6,-2,-1,-2,-2,0,-1,-3,-5
"2455",2018-04-14,"Snodgrass","w1718","Motorized",0,"Sat","weekend","sled","East River","2","2","1",9.4,0,28,2,28,33.6,-2,-1,-2,-2,0,-1,-3,-5
"2456",2018-04-14,"Snodgrass","w1718","Hybrid",NA,"Sat","weekend","sled","East River","2","2","1",9.4,0,28,2,28,33.6,-2,-1,-2,-2,0,-1,-3,-5
"2457",2018-04-15,"Snodgrass","w1718","Non.motorized",11,"Sun","weekend","no_sled","East River","2","2","1",9.2,-0.2,27,-1,37,34.1,2,-2,-1,-2,1,-1,-2,-4
"2458",2018-04-15,"Snodgrass","w1718","Mechanized",0,"Sun","weekend","no_sled","East River","2","2","1",9.2,-0.2,27,-1,37,34.1,2,-2,-1,-2,1,-1,-2,-4
"2459",2018-04-15,"Snodgrass","w1718","Motorized",0,"Sun","weekend","sled","East River","2","2","1",9.2,-0.2,27,-1,37,34.1,2,-2,-1,-2,1,-1,-2,-4
"2460",2018-04-15,"Snodgrass","w1718","Hybrid",NA,"Sun","weekend","sled","East River","2","2","1",9.2,-0.2,27,-1,37,34.1,2,-2,-1,-2,1,-1,-2,-4
"2461",2017-12-22,"Washington Gulch","w1718","Non.motorized",0,"Fri","weekday","no_sled","Washington Gulch","2","2","1",2,0,11,3,17,18.2,0,0,0,0,3,3,3,3
"2462",2017-12-22,"Washington Gulch","w1718","Mechanized",0,"Fri","weekday","no_sled","Washington Gulch","2","2","1",2,0,11,3,17,18.2,0,0,0,0,3,3,3,3
"2463",2017-12-22,"Washington Gulch","w1718","Motorized",1,"Fri","weekday","sled","Washington Gulch","2","2","1",2,0,11,3,17,18.2,0,0,0,0,3,3,3,3
"2464",2017-12-22,"Washington Gulch","w1718","Hybrid",0,"Fri","weekday","sled","Washington Gulch","2","2","1",2,0,11,3,17,18.2,0,0,0,0,3,3,3,3
"2465",2017-12-23,"Washington Gulch","w1718","Non.motorized",0,"Sat","weekend","no_sled","Washington Gulch","2","1","1",2.1,0.1,10,-1,21,21,3,0,0,0,2,2,2,2
"2466",2017-12-23,"Washington Gulch","w1718","Mechanized",0,"Sat","weekend","no_sled","Washington Gulch","2","1","1",2.1,0.1,10,-1,21,21,3,0,0,0,2,2,2,2
"2467",2017-12-23,"Washington Gulch","w1718","Motorized",0,"Sat","weekend","sled","Washington Gulch","2","1","1",2.1,0.1,10,-1,21,21,3,0,0,0,2,2,2,2
"2468",2017-12-23,"Washington Gulch","w1718","Hybrid",0,"Sat","weekend","sled","Washington Gulch","2","1","1",2.1,0.1,10,-1,21,21,3,0,0,0,2,2,2,2
"2469",2017-12-24,"Washington Gulch","w1718","Non.motorized",17,"Sun","weekend","no_sled","Washington Gulch","1","1","1",2.4,0.3,14,4,19,17.1,-1,3,0,0,3,6,6,6
"2470",2017-12-24,"Washington Gulch","w1718","Mechanized",2,"Sun","weekend","no_sled","Washington Gulch","1","1","1",2.4,0.3,14,4,19,17.1,-1,3,0,0,3,6,6,6
"2471",2017-12-24,"Washington Gulch","w1718","Motorized",7,"Sun","weekend","sled","Washington Gulch","1","1","1",2.4,0.3,14,4,19,17.1,-1,3,0,0,3,6,6,6
"2472",2017-12-24,"Washington Gulch","w1718","Hybrid",4,"Sun","weekend","sled","Washington Gulch","1","1","1",2.4,0.3,14,4,19,17.1,-1,3,0,0,3,6,6,6
"2473",2017-12-25,"Washington Gulch","w1718","Non.motorized",14,"Mon","weekday","no_sled","Washington Gulch","2","1","1",2.6,0.2,14,0,25,18.6,4,-1,3,0,4,3,6,6
"2474",2017-12-25,"Washington Gulch","w1718","Mechanized",2,"Mon","weekday","no_sled","Washington Gulch","2","1","1",2.6,0.2,14,0,25,18.6,4,-1,3,0,4,3,6,6
"2475",2017-12-25,"Washington Gulch","w1718","Motorized",1,"Mon","weekday","sled","Washington Gulch","2","1","1",2.6,0.2,14,0,25,18.6,4,-1,3,0,4,3,6,6
"2476",2017-12-25,"Washington Gulch","w1718","Hybrid",0,"Mon","weekday","sled","Washington Gulch","2","1","1",2.6,0.2,14,0,25,18.6,4,-1,3,0,4,3,6,6
"2477",2017-12-26,"Washington Gulch","w1718","Non.motorized",24,"Tue","weekday","no_sled","Washington Gulch","1","1","1",3.1,0.5,20,6,25,15.5,0,4,-1,3,6,10,9,12
"2478",2017-12-26,"Washington Gulch","w1718","Mechanized",0,"Tue","weekday","no_sled","Washington Gulch","1","1","1",3.1,0.5,20,6,25,15.5,0,4,-1,3,6,10,9,12
"2479",2017-12-26,"Washington Gulch","w1718","Motorized",3,"Tue","weekday","sled","Washington Gulch","1","1","1",3.1,0.5,20,6,25,15.5,0,4,-1,3,6,10,9,12
"2480",2017-12-26,"Washington Gulch","w1718","Hybrid",3,"Tue","weekday","sled","Washington Gulch","1","1","1",3.1,0.5,20,6,25,15.5,0,4,-1,3,6,10,9,12
"2481",2017-12-27,"Washington Gulch","w1718","Non.motorized",60,"Wed","weekday","no_sled","Washington Gulch","1","1","1",3.1,0,18,-2,27,17.2,6,0,4,-1,4,4,8,7
"2482",2017-12-27,"Washington Gulch","w1718","Mechanized",0,"Wed","weekday","no_sled","Washington Gulch","1","1","1",3.1,0,18,-2,27,17.2,6,0,4,-1,4,4,8,7
"2483",2017-12-27,"Washington Gulch","w1718","Motorized",2,"Wed","weekday","sled","Washington Gulch","1","1","1",3.1,0,18,-2,27,17.2,6,0,4,-1,4,4,8,7
"2484",2017-12-27,"Washington Gulch","w1718","Hybrid",2,"Wed","weekday","sled","Washington Gulch","1","1","1",3.1,0,18,-2,27,17.2,6,0,4,-1,4,4,8,7
"2485",2017-12-28,"Washington Gulch","w1718","Non.motorized",74,"Thu","weekday","no_sled","Washington Gulch","1","1","1",3.2,0.1,17,-1,31,18.8,-2,6,0,4,-3,3,3,7
"2486",2017-12-28,"Washington Gulch","w1718","Mechanized",2,"Thu","weekday","no_sled","Washington Gulch","1","1","1",3.2,0.1,17,-1,31,18.8,-2,6,0,4,-3,3,3,7
"2487",2017-12-28,"Washington Gulch","w1718","Motorized",4,"Thu","weekday","sled","Washington Gulch","1","1","1",3.2,0.1,17,-1,31,18.8,-2,6,0,4,-3,3,3,7
"2488",2017-12-28,"Washington Gulch","w1718","Hybrid",1,"Thu","weekday","sled","Washington Gulch","1","1","1",3.2,0.1,17,-1,31,18.8,-2,6,0,4,-3,3,3,7
"2489",2017-12-29,"Washington Gulch","w1718","Non.motorized",33,"Fri","weekday","no_sled","Washington Gulch","1","1","1",3.2,0,17,0,36,18.8,-1,-2,6,0,-1,-3,3,3
"2490",2017-12-29,"Washington Gulch","w1718","Mechanized",0,"Fri","weekday","no_sled","Washington Gulch","1","1","1",3.2,0,17,0,36,18.8,-1,-2,6,0,-1,-3,3,3
"2491",2017-12-29,"Washington Gulch","w1718","Motorized",13,"Fri","weekday","sled","Washington Gulch","1","1","1",3.2,0,17,0,36,18.8,-1,-2,6,0,-1,-3,3,3
"2492",2017-12-29,"Washington Gulch","w1718","Hybrid",8,"Fri","weekday","sled","Washington Gulch","1","1","1",3.2,0,17,0,36,18.8,-1,-2,6,0,-1,-3,3,3
"2493",2017-12-30,"Washington Gulch","w1718","Non.motorized",111,"Sat","weekend","no_sled","Washington Gulch","1","1","1",3.2,0,15,-2,37,21.3,0,-1,-2,6,-2,-3,-5,1
"2494",2017-12-30,"Washington Gulch","w1718","Mechanized",1,"Sat","weekend","no_sled","Washington Gulch","1","1","1",3.2,0,15,-2,37,21.3,0,-1,-2,6,-2,-3,-5,1
"2495",2017-12-30,"Washington Gulch","w1718","Motorized",2,"Sat","weekend","sled","Washington Gulch","1","1","1",3.2,0,15,-2,37,21.3,0,-1,-2,6,-2,-3,-5,1
"2496",2017-12-30,"Washington Gulch","w1718","Hybrid",0,"Sat","weekend","sled","Washington Gulch","1","1","1",3.2,0,15,-2,37,21.3,0,-1,-2,6,-2,-3,-5,1
"2497",2017-12-31,"Washington Gulch","w1718","Non.motorized",109,"Sun","weekend","no_sled","Washington Gulch","1","1","1",3.2,0,15,0,31,21.3,-2,0,-1,-2,-2,-2,-3,-5
"2498",2017-12-31,"Washington Gulch","w1718","Mechanized",0,"Sun","weekend","no_sled","Washington Gulch","1","1","1",3.2,0,15,0,31,21.3,-2,0,-1,-2,-2,-2,-3,-5
"2499",2017-12-31,"Washington Gulch","w1718","Motorized",6,"Sun","weekend","sled","Washington Gulch","1","1","1",3.2,0,15,0,31,21.3,-2,0,-1,-2,-2,-2,-3,-5
"2500",2017-12-31,"Washington Gulch","w1718","Hybrid",2,"Sun","weekend","sled","Washington Gulch","1","1","1",3.2,0,15,0,31,21.3,-2,0,-1,-2,-2,-2,-3,-5
"2501",2018-01-01,"Washington Gulch","w1718","Non.motorized",73,"Mon","weekday","no_sled","Washington Gulch","1","1","1",3.2,0,15,0,27,21.3,0,-2,0,-1,0,-2,-2,-3
"2502",2018-01-01,"Washington Gulch","w1718","Mechanized",2,"Mon","weekday","no_sled","Washington Gulch","1","1","1",3.2,0,15,0,27,21.3,0,-2,0,-1,0,-2,-2,-3
"2503",2018-01-01,"Washington Gulch","w1718","Motorized",16,"Mon","weekday","sled","Washington Gulch","1","1","1",3.2,0,15,0,27,21.3,0,-2,0,-1,0,-2,-2,-3
"2504",2018-01-01,"Washington Gulch","w1718","Hybrid",4,"Mon","weekday","sled","Washington Gulch","1","1","1",3.2,0,15,0,27,21.3,0,-2,0,-1,0,-2,-2,-3
"2505",2018-01-02,"Washington Gulch","w1718","Non.motorized",35,"Tue","weekday","no_sled","Washington Gulch","1","1","1",3.2,0,15,0,22,21.3,0,0,-2,0,0,0,-2,-2
"2506",2018-01-02,"Washington Gulch","w1718","Mechanized",0,"Tue","weekday","no_sled","Washington Gulch","1","1","1",3.2,0,15,0,22,21.3,0,0,-2,0,0,0,-2,-2
"2507",2018-01-02,"Washington Gulch","w1718","Motorized",1,"Tue","weekday","sled","Washington Gulch","1","1","1",3.2,0,15,0,22,21.3,0,0,-2,0,0,0,-2,-2
"2508",2018-01-02,"Washington Gulch","w1718","Hybrid",0,"Tue","weekday","sled","Washington Gulch","1","1","1",3.2,0,15,0,22,21.3,0,0,-2,0,0,0,-2,-2
"2509",2018-01-03,"Washington Gulch","w1718","Non.motorized",NA,"Wed","weekday","no_sled","Washington Gulch","1","1","1",3.2,0,15,0,27,21.3,0,0,0,-2,0,0,0,-2
"2510",2018-01-03,"Washington Gulch","w1718","Mechanized",NA,"Wed","weekday","no_sled","Washington Gulch","1","1","1",3.2,0,15,0,27,21.3,0,0,0,-2,0,0,0,-2
"2511",2018-01-03,"Washington Gulch","w1718","Motorized",NA,"Wed","weekday","sled","Washington Gulch","1","1","1",3.2,0,15,0,27,21.3,0,0,0,-2,0,0,0,-2
"2512",2018-01-03,"Washington Gulch","w1718","Hybrid",NA,"Wed","weekday","sled","Washington Gulch","1","1","1",3.2,0,15,0,27,21.3,0,0,0,-2,0,0,0,-2
"2513",2018-01-04,"Washington Gulch","w1718","Non.motorized",NA,"Thu","weekday","no_sled","Washington Gulch","1","1","1",3.2,0,15,0,29,21.3,0,0,0,0,0,0,0,0
"2514",2018-01-04,"Washington Gulch","w1718","Mechanized",NA,"Thu","weekday","no_sled","Washington Gulch","1","1","1",3.2,0,15,0,29,21.3,0,0,0,0,0,0,0,0
"2515",2018-01-04,"Washington Gulch","w1718","Motorized",NA,"Thu","weekday","sled","Washington Gulch","1","1","1",3.2,0,15,0,29,21.3,0,0,0,0,0,0,0,0
"2516",2018-01-04,"Washington Gulch","w1718","Hybrid",NA,"Thu","weekday","sled","Washington Gulch","1","1","1",3.2,0,15,0,29,21.3,0,0,0,0,0,0,0,0
"2517",2018-01-05,"Washington Gulch","w1718","Non.motorized",NA,"Fri","weekday","no_sled","Washington Gulch","1","1","1",3.2,0,14,-1,32,22.9,0,0,0,0,-1,-1,-1,-1
"2518",2018-01-05,"Washington Gulch","w1718","Mechanized",NA,"Fri","weekday","no_sled","Washington Gulch","1","1","1",3.2,0,14,-1,32,22.9,0,0,0,0,-1,-1,-1,-1
"2519",2018-01-05,"Washington Gulch","w1718","Motorized",NA,"Fri","weekday","sled","Washington Gulch","1","1","1",3.2,0,14,-1,32,22.9,0,0,0,0,-1,-1,-1,-1
"2520",2018-01-05,"Washington Gulch","w1718","Hybrid",NA,"Fri","weekday","sled","Washington Gulch","1","1","1",3.2,0,14,-1,32,22.9,0,0,0,0,-1,-1,-1,-1
"2521",2018-01-06,"Washington Gulch","w1718","Non.motorized",0,"Sat","weekend","no_sled","Washington Gulch","1","1","1",3.2,0,14,0,30,22.9,-1,0,0,0,-1,-1,-1,-1
"2522",2018-01-06,"Washington Gulch","w1718","Mechanized",1,"Sat","weekend","no_sled","Washington Gulch","1","1","1",3.2,0,14,0,30,22.9,-1,0,0,0,-1,-1,-1,-1
"2523",2018-01-06,"Washington Gulch","w1718","Motorized",0,"Sat","weekend","sled","Washington Gulch","1","1","1",3.2,0,14,0,30,22.9,-1,0,0,0,-1,-1,-1,-1
"2524",2018-01-06,"Washington Gulch","w1718","Hybrid",0,"Sat","weekend","sled","Washington Gulch","1","1","1",3.2,0,14,0,30,22.9,-1,0,0,0,-1,-1,-1,-1
"2525",2018-01-07,"Washington Gulch","w1718","Non.motorized",36,"Sun","weekend","no_sled","Washington Gulch","2","2","2",3.5,0.3,18,4,25,19.4,0,-1,0,0,4,3,3,3
"2526",2018-01-07,"Washington Gulch","w1718","Mechanized",0,"Sun","weekend","no_sled","Washington Gulch","2","2","2",3.5,0.3,18,4,25,19.4,0,-1,0,0,4,3,3,3
"2527",2018-01-07,"Washington Gulch","w1718","Motorized",8,"Sun","weekend","sled","Washington Gulch","2","2","2",3.5,0.3,18,4,25,19.4,0,-1,0,0,4,3,3,3
"2528",2018-01-07,"Washington Gulch","w1718","Hybrid",2,"Sun","weekend","sled","Washington Gulch","2","2","2",3.5,0.3,18,4,25,19.4,0,-1,0,0,4,3,3,3
"2529",2018-01-08,"Washington Gulch","w1718","Non.motorized",18,"Mon","weekday","no_sled","Washington Gulch","2","2","1",3.7,0.2,20,2,29,18.5,4,0,-1,0,6,6,5,5
"2530",2018-01-08,"Washington Gulch","w1718","Mechanized",0,"Mon","weekday","no_sled","Washington Gulch","2","2","1",3.7,0.2,20,2,29,18.5,4,0,-1,0,6,6,5,5
"2531",2018-01-08,"Washington Gulch","w1718","Motorized",4,"Mon","weekday","sled","Washington Gulch","2","2","1",3.7,0.2,20,2,29,18.5,4,0,-1,0,6,6,5,5
"2532",2018-01-08,"Washington Gulch","w1718","Hybrid",4,"Mon","weekday","sled","Washington Gulch","2","2","1",3.7,0.2,20,2,29,18.5,4,0,-1,0,6,6,5,5
"2533",2018-01-09,"Washington Gulch","w1718","Non.motorized",18,"Tue","weekday","no_sled","Washington Gulch","2","2","1",3.8,0.1,21,1,34,18.1,2,4,0,-1,3,7,7,6
"2534",2018-01-09,"Washington Gulch","w1718","Mechanized",0,"Tue","weekday","no_sled","Washington Gulch","2","2","1",3.8,0.1,21,1,34,18.1,2,4,0,-1,3,7,7,6
"2535",2018-01-09,"Washington Gulch","w1718","Motorized",3,"Tue","weekday","sled","Washington Gulch","2","2","1",3.8,0.1,21,1,34,18.1,2,4,0,-1,3,7,7,6
"2536",2018-01-09,"Washington Gulch","w1718","Hybrid",1,"Tue","weekday","sled","Washington Gulch","2","2","1",3.8,0.1,21,1,34,18.1,2,4,0,-1,3,7,7,6
"2537",2018-01-10,"Washington Gulch","w1718","Non.motorized",20,"Wed","weekday","no_sled","Washington Gulch","3","3","3",4,0.2,21,0,28,19,1,2,4,0,1,3,7,7
"2538",2018-01-10,"Washington Gulch","w1718","Mechanized",0,"Wed","weekday","no_sled","Washington Gulch","3","3","3",4,0.2,21,0,28,19,1,2,4,0,1,3,7,7
"2539",2018-01-10,"Washington Gulch","w1718","Motorized",0,"Wed","weekday","sled","Washington Gulch","3","3","3",4,0.2,21,0,28,19,1,2,4,0,1,3,7,7
"2540",2018-01-10,"Washington Gulch","w1718","Hybrid",0,"Wed","weekday","sled","Washington Gulch","3","3","3",4,0.2,21,0,28,19,1,2,4,0,1,3,7,7
"2541",2018-01-11,"Washington Gulch","w1718","Non.motorized",9,"Thu","weekday","no_sled","Washington Gulch","3","3","3",4.1,0.1,26,5,17,15.8,0,1,2,4,5,6,8,12
"2542",2018-01-11,"Washington Gulch","w1718","Mechanized",0,"Thu","weekday","no_sled","Washington Gulch","3","3","3",4.1,0.1,26,5,17,15.8,0,1,2,4,5,6,8,12
"2543",2018-01-11,"Washington Gulch","w1718","Motorized",7,"Thu","weekday","sled","Washington Gulch","3","3","3",4.1,0.1,26,5,17,15.8,0,1,2,4,5,6,8,12
"2544",2018-01-11,"Washington Gulch","w1718","Hybrid",7,"Thu","weekday","sled","Washington Gulch","3","3","3",4.1,0.1,26,5,17,15.8,0,1,2,4,5,6,8,12
"2545",2018-01-12,"Washington Gulch","w1718","Non.motorized",13,"Fri","weekday","no_sled","Washington Gulch","3","3","3",4.3,0.2,24,-2,22,17.9,5,0,1,2,3,3,4,6
"2546",2018-01-12,"Washington Gulch","w1718","Mechanized",0,"Fri","weekday","no_sled","Washington Gulch","3","3","3",4.3,0.2,24,-2,22,17.9,5,0,1,2,3,3,4,6
"2547",2018-01-12,"Washington Gulch","w1718","Motorized",0,"Fri","weekday","sled","Washington Gulch","3","3","3",4.3,0.2,24,-2,22,17.9,5,0,1,2,3,3,4,6
"2548",2018-01-12,"Washington Gulch","w1718","Hybrid",0,"Fri","weekday","sled","Washington Gulch","3","3","3",4.3,0.2,24,-2,22,17.9,5,0,1,2,3,3,4,6
"2549",2018-01-13,"Washington Gulch","w1718","Non.motorized",55,"Sat","weekend","no_sled","Washington Gulch","3","3","3",4.4,0.1,24,0,24,18.3,-2,5,0,1,-2,3,3,4
"2550",2018-01-13,"Washington Gulch","w1718","Mechanized",0,"Sat","weekend","no_sled","Washington Gulch","3","3","3",4.4,0.1,24,0,24,18.3,-2,5,0,1,-2,3,3,4
"2551",2018-01-13,"Washington Gulch","w1718","Motorized",5,"Sat","weekend","sled","Washington Gulch","3","3","3",4.4,0.1,24,0,24,18.3,-2,5,0,1,-2,3,3,4
"2552",2018-01-13,"Washington Gulch","w1718","Hybrid",3,"Sat","weekend","sled","Washington Gulch","3","3","3",4.4,0.1,24,0,24,18.3,-2,5,0,1,-2,3,3,4
"2553",2018-01-14,"Washington Gulch","w1718","Non.motorized",61,"Sun","weekend","no_sled","Washington Gulch","3","3","2",4.4,0,24,0,27,18.3,0,-2,5,0,0,-2,3,3
"2554",2018-01-14,"Washington Gulch","w1718","Mechanized",0,"Sun","weekend","no_sled","Washington Gulch","3","3","2",4.4,0,24,0,27,18.3,0,-2,5,0,0,-2,3,3
"2555",2018-01-14,"Washington Gulch","w1718","Motorized",11,"Sun","weekend","sled","Washington Gulch","3","3","2",4.4,0,24,0,27,18.3,0,-2,5,0,0,-2,3,3
"2556",2018-01-14,"Washington Gulch","w1718","Hybrid",10,"Sun","weekend","sled","Washington Gulch","3","3","2",4.4,0,24,0,27,18.3,0,-2,5,0,0,-2,3,3
"2557",2018-01-15,"Washington Gulch","w1718","Non.motorized",39,"Mon","weekday","no_sled","Washington Gulch","3","3","2",4.4,0,23,-1,27,19.1,0,0,-2,5,-1,-1,-3,2
"2558",2018-01-15,"Washington Gulch","w1718","Mechanized",0,"Mon","weekday","no_sled","Washington Gulch","3","3","2",4.4,0,23,-1,27,19.1,0,0,-2,5,-1,-1,-3,2
"2559",2018-01-15,"Washington Gulch","w1718","Motorized",4,"Mon","weekday","sled","Washington Gulch","3","3","2",4.4,0,23,-1,27,19.1,0,0,-2,5,-1,-1,-3,2
"2560",2018-01-15,"Washington Gulch","w1718","Hybrid",4,"Mon","weekday","sled","Washington Gulch","3","3","2",4.4,0,23,-1,27,19.1,0,0,-2,5,-1,-1,-3,2
"2561",2018-01-16,"Washington Gulch","w1718","Non.motorized",19,"Tue","weekday","no_sled","Washington Gulch","3","3","2",4.4,0,22,-1,20,20,-1,0,0,-2,-2,-2,-2,-4
"2562",2018-01-16,"Washington Gulch","w1718","Mechanized",3,"Tue","weekday","no_sled","Washington Gulch","3","3","2",4.4,0,22,-1,20,20,-1,0,0,-2,-2,-2,-2,-4
"2563",2018-01-16,"Washington Gulch","w1718","Motorized",5,"Tue","weekday","sled","Washington Gulch","3","3","2",4.4,0,22,-1,20,20,-1,0,0,-2,-2,-2,-2,-4
"2564",2018-01-16,"Washington Gulch","w1718","Hybrid",4,"Tue","weekday","sled","Washington Gulch","3","3","2",4.4,0,22,-1,20,20,-1,0,0,-2,-2,-2,-2,-4
"2565",2018-01-17,"Washington Gulch","w1718","Non.motorized",15,"Wed","weekday","no_sled","Washington Gulch","2","2","2",4.4,0,22,0,24,20,-1,-1,0,0,-1,-2,-2,-2
"2566",2018-01-17,"Washington Gulch","w1718","Mechanized",0,"Wed","weekday","no_sled","Washington Gulch","2","2","2",4.4,0,22,0,24,20,-1,-1,0,0,-1,-2,-2,-2
"2567",2018-01-17,"Washington Gulch","w1718","Motorized",8,"Wed","weekday","sled","Washington Gulch","2","2","2",4.4,0,22,0,24,20,-1,-1,0,0,-1,-2,-2,-2
"2568",2018-01-17,"Washington Gulch","w1718","Hybrid",5,"Wed","weekday","sled","Washington Gulch","2","2","2",4.4,0,22,0,24,20,-1,-1,0,0,-1,-2,-2,-2
"2569",2018-01-18,"Washington Gulch","w1718","Non.motorized",22,"Thu","weekday","no_sled","Washington Gulch","2","2","2",4.4,0,21,-1,29,21,0,-1,-1,0,-1,-2,-3,-3
"2570",2018-01-18,"Washington Gulch","w1718","Mechanized",0,"Thu","weekday","no_sled","Washington Gulch","2","2","2",4.4,0,21,-1,29,21,0,-1,-1,0,-1,-2,-3,-3
"2571",2018-01-18,"Washington Gulch","w1718","Motorized",0,"Thu","weekday","sled","Washington Gulch","2","2","2",4.4,0,21,-1,29,21,0,-1,-1,0,-1,-2,-3,-3
"2572",2018-01-18,"Washington Gulch","w1718","Hybrid",0,"Thu","weekday","sled","Washington Gulch","2","2","2",4.4,0,21,-1,29,21,0,-1,-1,0,-1,-2,-3,-3
"2573",2018-01-19,"Washington Gulch","w1718","Non.motorized",39,"Fri","weekday","no_sled","Washington Gulch","2","2","2",4.5,0.1,21,0,34,21.4,-1,0,-1,-1,-1,-1,-2,-3
"2574",2018-01-19,"Washington Gulch","w1718","Mechanized",0,"Fri","weekday","no_sled","Washington Gulch","2","2","2",4.5,0.1,21,0,34,21.4,-1,0,-1,-1,-1,-1,-2,-3
"2575",2018-01-19,"Washington Gulch","w1718","Motorized",5,"Fri","weekday","sled","Washington Gulch","2","2","2",4.5,0.1,21,0,34,21.4,-1,0,-1,-1,-1,-1,-2,-3
"2576",2018-01-19,"Washington Gulch","w1718","Hybrid",5,"Fri","weekday","sled","Washington Gulch","2","2","2",4.5,0.1,21,0,34,21.4,-1,0,-1,-1,-1,-1,-2,-3
"2577",2018-01-20,"Washington Gulch","w1718","Non.motorized",44,"Sat","weekend","no_sled","Washington Gulch","2","2","2",4.5,0,21,0,32,21.4,0,-1,0,-1,0,-1,-1,-2
"2578",2018-01-20,"Washington Gulch","w1718","Mechanized",1,"Sat","weekend","no_sled","Washington Gulch","2","2","2",4.5,0,21,0,32,21.4,0,-1,0,-1,0,-1,-1,-2
"2579",2018-01-20,"Washington Gulch","w1718","Motorized",5,"Sat","weekend","sled","Washington Gulch","2","2","2",4.5,0,21,0,32,21.4,0,-1,0,-1,0,-1,-1,-2
"2580",2018-01-20,"Washington Gulch","w1718","Hybrid",2,"Sat","weekend","sled","Washington Gulch","2","2","2",4.5,0,21,0,32,21.4,0,-1,0,-1,0,-1,-1,-2
"2581",2018-01-21,"Washington Gulch","w1718","Non.motorized",0,"Sun","weekend","no_sled","Washington Gulch","3","3","3",4.6,0.1,23,2,15,20,0,0,-1,0,2,2,1,1
"2582",2018-01-21,"Washington Gulch","w1718","Mechanized",0,"Sun","weekend","no_sled","Washington Gulch","3","3","3",4.6,0.1,23,2,15,20,0,0,-1,0,2,2,1,1
"2583",2018-01-21,"Washington Gulch","w1718","Motorized",0,"Sun","weekend","sled","Washington Gulch","3","3","3",4.6,0.1,23,2,15,20,0,0,-1,0,2,2,1,1
"2584",2018-01-21,"Washington Gulch","w1718","Hybrid",0,"Sun","weekend","sled","Washington Gulch","3","3","3",4.6,0.1,23,2,15,20,0,0,-1,0,2,2,1,1
"2585",2018-01-22,"Washington Gulch","w1718","Non.motorized",28,"Mon","weekday","no_sled","Washington Gulch","3","3","3",4.6,0,21,-2,12,21.9,2,0,0,-1,0,0,0,-1
"2586",2018-01-22,"Washington Gulch","w1718","Mechanized",0,"Mon","weekday","no_sled","Washington Gulch","3","3","3",4.6,0,21,-2,12,21.9,2,0,0,-1,0,0,0,-1
"2587",2018-01-22,"Washington Gulch","w1718","Motorized",6,"Mon","weekday","sled","Washington Gulch","3","3","3",4.6,0,21,-2,12,21.9,2,0,0,-1,0,0,0,-1
"2588",2018-01-22,"Washington Gulch","w1718","Hybrid",2,"Mon","weekday","sled","Washington Gulch","3","3","3",4.6,0,21,-2,12,21.9,2,0,0,-1,0,0,0,-1
"2589",2018-01-23,"Washington Gulch","w1718","Non.motorized",28,"Tue","weekday","no_sled","Washington Gulch","3","3","3",4.6,0,22,1,16,20.9,-2,2,0,0,-1,1,1,1
"2590",2018-01-23,"Washington Gulch","w1718","Mechanized",1,"Tue","weekday","no_sled","Washington Gulch","3","3","3",4.6,0,22,1,16,20.9,-2,2,0,0,-1,1,1,1
"2591",2018-01-23,"Washington Gulch","w1718","Motorized",6,"Tue","weekday","sled","Washington Gulch","3","3","3",4.6,0,22,1,16,20.9,-2,2,0,0,-1,1,1,1
"2592",2018-01-23,"Washington Gulch","w1718","Hybrid",6,"Tue","weekday","sled","Washington Gulch","3","3","3",4.6,0,22,1,16,20.9,-2,2,0,0,-1,1,1,1
"2593",2018-01-24,"Washington Gulch","w1718","Non.motorized",21,"Wed","weekday","no_sled","Washington Gulch","2","2","2",4.6,0,22,0,22,20.9,1,-2,2,0,1,-1,1,1
"2594",2018-01-24,"Washington Gulch","w1718","Mechanized",0,"Wed","weekday","no_sled","Washington Gulch","2","2","2",4.6,0,22,0,22,20.9,1,-2,2,0,1,-1,1,1
"2595",2018-01-24,"Washington Gulch","w1718","Motorized",10,"Wed","weekday","sled","Washington Gulch","2","2","2",4.6,0,22,0,22,20.9,1,-2,2,0,1,-1,1,1
"2596",2018-01-24,"Washington Gulch","w1718","Hybrid",9,"Wed","weekday","sled","Washington Gulch","2","2","2",4.6,0,22,0,22,20.9,1,-2,2,0,1,-1,1,1
"2597",2018-01-25,"Washington Gulch","w1718","Non.motorized",25,"Thu","weekday","no_sled","Washington Gulch","2","2","2",4.6,0,22,0,28,20.9,0,1,-2,2,0,1,-1,1
"2598",2018-01-25,"Washington Gulch","w1718","Mechanized",1,"Thu","weekday","no_sled","Washington Gulch","2","2","2",4.6,0,22,0,28,20.9,0,1,-2,2,0,1,-1,1
"2599",2018-01-25,"Washington Gulch","w1718","Motorized",13,"Thu","weekday","sled","Washington Gulch","2","2","2",4.6,0,22,0,28,20.9,0,1,-2,2,0,1,-1,1
"2600",2018-01-25,"Washington Gulch","w1718","Hybrid",8,"Thu","weekday","sled","Washington Gulch","2","2","2",4.6,0,22,0,28,20.9,0,1,-2,2,0,1,-1,1
"2601",2018-01-26,"Washington Gulch","w1718","Non.motorized",14,"Fri","weekday","no_sled","Washington Gulch","2","2","2",4.7,0.1,22,0,15,21.4,0,0,1,-2,0,0,1,-1
"2602",2018-01-26,"Washington Gulch","w1718","Mechanized",2,"Fri","weekday","no_sled","Washington Gulch","2","2","2",4.7,0.1,22,0,15,21.4,0,0,1,-2,0,0,1,-1
"2603",2018-01-26,"Washington Gulch","w1718","Motorized",3,"Fri","weekday","sled","Washington Gulch","2","2","2",4.7,0.1,22,0,15,21.4,0,0,1,-2,0,0,1,-1
"2604",2018-01-26,"Washington Gulch","w1718","Hybrid",1,"Fri","weekday","sled","Washington Gulch","2","2","2",4.7,0.1,22,0,15,21.4,0,0,1,-2,0,0,1,-1
"2605",2018-01-27,"Washington Gulch","w1718","Non.motorized",53,"Sat","weekend","no_sled","Washington Gulch","2","2","2",4.7,0,23,1,16,20.4,0,0,0,1,1,1,1,2
"2606",2018-01-27,"Washington Gulch","w1718","Mechanized",1,"Sat","weekend","no_sled","Washington Gulch","2","2","2",4.7,0,23,1,16,20.4,0,0,0,1,1,1,1,2
"2607",2018-01-27,"Washington Gulch","w1718","Motorized",9,"Sat","weekend","sled","Washington Gulch","2","2","2",4.7,0,23,1,16,20.4,0,0,0,1,1,1,1,2
"2608",2018-01-27,"Washington Gulch","w1718","Hybrid",9,"Sat","weekend","sled","Washington Gulch","2","2","2",4.7,0,23,1,16,20.4,0,0,0,1,1,1,1,2
"2609",2018-01-28,"Washington Gulch","w1718","Non.motorized",101,"Sun","weekend","no_sled","Washington Gulch","2","2","2",4.7,0,23,0,25,20.4,1,0,0,0,1,1,1,1
"2610",2018-01-28,"Washington Gulch","w1718","Mechanized",1,"Sun","weekend","no_sled","Washington Gulch","2","2","2",4.7,0,23,0,25,20.4,1,0,0,0,1,1,1,1
"2611",2018-01-28,"Washington Gulch","w1718","Motorized",18,"Sun","weekend","sled","Washington Gulch","2","2","2",4.7,0,23,0,25,20.4,1,0,0,0,1,1,1,1
"2612",2018-01-28,"Washington Gulch","w1718","Hybrid",12,"Sun","weekend","sled","Washington Gulch","2","2","2",4.7,0,23,0,25,20.4,1,0,0,0,1,1,1,1
"2613",2018-01-29,"Washington Gulch","w1718","Non.motorized",18,"Mon","weekday","no_sled","Washington Gulch","2","2","2",4.8,0.1,22,-1,30,21.8,0,1,0,0,-1,0,0,0
"2614",2018-01-29,"Washington Gulch","w1718","Mechanized",0,"Mon","weekday","no_sled","Washington Gulch","2","2","2",4.8,0.1,22,-1,30,21.8,0,1,0,0,-1,0,0,0
"2615",2018-01-29,"Washington Gulch","w1718","Motorized",4,"Mon","weekday","sled","Washington Gulch","2","2","2",4.8,0.1,22,-1,30,21.8,0,1,0,0,-1,0,0,0
"2616",2018-01-29,"Washington Gulch","w1718","Hybrid",4,"Mon","weekday","sled","Washington Gulch","2","2","2",4.8,0.1,22,-1,30,21.8,0,1,0,0,-1,0,0,0
"2617",2018-01-30,"Washington Gulch","w1718","Non.motorized",22,"Tue","weekday","no_sled","Washington Gulch","2","2","2",4.8,0,22,0,34,21.8,-1,0,1,0,-1,-1,0,0
"2618",2018-01-30,"Washington Gulch","w1718","Mechanized",1,"Tue","weekday","no_sled","Washington Gulch","2","2","2",4.8,0,22,0,34,21.8,-1,0,1,0,-1,-1,0,0
"2619",2018-01-30,"Washington Gulch","w1718","Motorized",6,"Tue","weekday","sled","Washington Gulch","2","2","2",4.8,0,22,0,34,21.8,-1,0,1,0,-1,-1,0,0
"2620",2018-01-30,"Washington Gulch","w1718","Hybrid",2,"Tue","weekday","sled","Washington Gulch","2","2","2",4.8,0,22,0,34,21.8,-1,0,1,0,-1,-1,0,0
"2621",2018-01-31,"Washington Gulch","w1718","Non.motorized",20,"Wed","weekday","no_sled","Washington Gulch","2","2","2",4.8,0,22,0,34,21.8,0,-1,0,1,0,-1,-1,0
"2622",2018-01-31,"Washington Gulch","w1718","Mechanized",0,"Wed","weekday","no_sled","Washington Gulch","2","2","2",4.8,0,22,0,34,21.8,0,-1,0,1,0,-1,-1,0
"2623",2018-01-31,"Washington Gulch","w1718","Motorized",3,"Wed","weekday","sled","Washington Gulch","2","2","2",4.8,0,22,0,34,21.8,0,-1,0,1,0,-1,-1,0
"2624",2018-01-31,"Washington Gulch","w1718","Hybrid",2,"Wed","weekday","sled","Washington Gulch","2","2","2",4.8,0,22,0,34,21.8,0,-1,0,1,0,-1,-1,0
"2625",2018-02-01,"Washington Gulch","w1718","Non.motorized",21,"Thu","weekday","no_sled","Washington Gulch","2","2","2",4.9,0.1,21,-1,32,23.3,0,0,-1,0,-1,-1,-2,-2
"2626",2018-02-01,"Washington Gulch","w1718","Mechanized",0,"Thu","weekday","no_sled","Washington Gulch","2","2","2",4.9,0.1,21,-1,32,23.3,0,0,-1,0,-1,-1,-2,-2
"2627",2018-02-01,"Washington Gulch","w1718","Motorized",5,"Thu","weekday","sled","Washington Gulch","2","2","2",4.9,0.1,21,-1,32,23.3,0,0,-1,0,-1,-1,-2,-2
"2628",2018-02-01,"Washington Gulch","w1718","Hybrid",2,"Thu","weekday","sled","Washington Gulch","2","2","2",4.9,0.1,21,-1,32,23.3,0,0,-1,0,-1,-1,-2,-2
"2629",2018-02-02,"Washington Gulch","w1718","Non.motorized",35,"Fri","weekday","no_sled","Washington Gulch","2","2","2",4.9,0,20,-1,33,24.5,-1,0,0,-1,-2,-2,-2,-3
"2630",2018-02-02,"Washington Gulch","w1718","Mechanized",0,"Fri","weekday","no_sled","Washington Gulch","2","2","2",4.9,0,20,-1,33,24.5,-1,0,0,-1,-2,-2,-2,-3
"2631",2018-02-02,"Washington Gulch","w1718","Motorized",4,"Fri","weekday","sled","Washington Gulch","2","2","2",4.9,0,20,-1,33,24.5,-1,0,0,-1,-2,-2,-2,-3
"2632",2018-02-02,"Washington Gulch","w1718","Hybrid",4,"Fri","weekday","sled","Washington Gulch","2","2","2",4.9,0,20,-1,33,24.5,-1,0,0,-1,-2,-2,-2,-3
"2633",2018-02-03,"Washington Gulch","w1718","Non.motorized",53,"Sat","weekend","no_sled","Washington Gulch","2","2","2",4.9,0,21,1,32,23.3,-1,-1,0,0,0,-1,-1,-1
"2634",2018-02-03,"Washington Gulch","w1718","Mechanized",0,"Sat","weekend","no_sled","Washington Gulch","2","2","2",4.9,0,21,1,32,23.3,-1,-1,0,0,0,-1,-1,-1
"2635",2018-02-03,"Washington Gulch","w1718","Motorized",3,"Sat","weekend","sled","Washington Gulch","2","2","2",4.9,0,21,1,32,23.3,-1,-1,0,0,0,-1,-1,-1
"2636",2018-02-03,"Washington Gulch","w1718","Hybrid",3,"Sat","weekend","sled","Washington Gulch","2","2","2",4.9,0,21,1,32,23.3,-1,-1,0,0,0,-1,-1,-1
"2637",2018-02-04,"Washington Gulch","w1718","Non.motorized",69,"Sun","weekend","no_sled","Washington Gulch","2","2","2",4.9,0,19,-2,32,25.8,1,-1,-1,0,-1,-2,-3,-3
"2638",2018-02-04,"Washington Gulch","w1718","Mechanized",2,"Sun","weekend","no_sled","Washington Gulch","2","2","2",4.9,0,19,-2,32,25.8,1,-1,-1,0,-1,-2,-3,-3
"2639",2018-02-04,"Washington Gulch","w1718","Motorized",11,"Sun","weekend","sled","Washington Gulch","2","2","2",4.9,0,19,-2,32,25.8,1,-1,-1,0,-1,-2,-3,-3
"2640",2018-02-04,"Washington Gulch","w1718","Hybrid",5,"Sun","weekend","sled","Washington Gulch","2","2","2",4.9,0,19,-2,32,25.8,1,-1,-1,0,-1,-2,-3,-3
"2641",2018-02-05,"Washington Gulch","w1718","Non.motorized",10,"Mon","weekday","no_sled","Washington Gulch","2","2","2",5,0.1,18,-1,29,27.8,-2,1,-1,-1,-3,-2,-3,-4
"2642",2018-02-05,"Washington Gulch","w1718","Mechanized",0,"Mon","weekday","no_sled","Washington Gulch","2","2","2",5,0.1,18,-1,29,27.8,-2,1,-1,-1,-3,-2,-3,-4
"2643",2018-02-05,"Washington Gulch","w1718","Motorized",2,"Mon","weekday","sled","Washington Gulch","2","2","2",5,0.1,18,-1,29,27.8,-2,1,-1,-1,-3,-2,-3,-4
"2644",2018-02-05,"Washington Gulch","w1718","Hybrid",0,"Mon","weekday","sled","Washington Gulch","2","2","2",5,0.1,18,-1,29,27.8,-2,1,-1,-1,-3,-2,-3,-4
"2645",2018-02-06,"Washington Gulch","w1718","Non.motorized",18,"Tue","weekday","no_sled","Washington Gulch","2","2","2",5.2,0.2,23,5,22,22.6,-1,-2,1,-1,4,2,3,2
"2646",2018-02-06,"Washington Gulch","w1718","Mechanized",0,"Tue","weekday","no_sled","Washington Gulch","2","2","2",5.2,0.2,23,5,22,22.6,-1,-2,1,-1,4,2,3,2
"2647",2018-02-06,"Washington Gulch","w1718","Motorized",8,"Tue","weekday","sled","Washington Gulch","2","2","2",5.2,0.2,23,5,22,22.6,-1,-2,1,-1,4,2,3,2
"2648",2018-02-06,"Washington Gulch","w1718","Hybrid",6,"Tue","weekday","sled","Washington Gulch","2","2","2",5.2,0.2,23,5,22,22.6,-1,-2,1,-1,4,2,3,2
"2649",2018-02-07,"Washington Gulch","w1718","Non.motorized",43,"Wed","weekday","no_sled","Washington Gulch","2","2","2",5.2,0,23,0,24,22.6,5,-1,-2,1,5,4,2,3
"2650",2018-02-07,"Washington Gulch","w1718","Mechanized",0,"Wed","weekday","no_sled","Washington Gulch","2","2","2",5.2,0,23,0,24,22.6,5,-1,-2,1,5,4,2,3
"2651",2018-02-07,"Washington Gulch","w1718","Motorized",6,"Wed","weekday","sled","Washington Gulch","2","2","2",5.2,0,23,0,24,22.6,5,-1,-2,1,5,4,2,3
"2652",2018-02-07,"Washington Gulch","w1718","Hybrid",4,"Wed","weekday","sled","Washington Gulch","2","2","2",5.2,0,23,0,24,22.6,5,-1,-2,1,5,4,2,3
"2653",2018-02-08,"Washington Gulch","w1718","Non.motorized",18,"Thu","weekday","no_sled","Washington Gulch","2","2","1",5.3,0.1,25,2,28,21.2,0,5,-1,-2,2,7,6,4
"2654",2018-02-08,"Washington Gulch","w1718","Mechanized",0,"Thu","weekday","no_sled","Washington Gulch","2","2","1",5.3,0.1,25,2,28,21.2,0,5,-1,-2,2,7,6,4
"2655",2018-02-08,"Washington Gulch","w1718","Motorized",10,"Thu","weekday","sled","Washington Gulch","2","2","1",5.3,0.1,25,2,28,21.2,0,5,-1,-2,2,7,6,4
"2656",2018-02-08,"Washington Gulch","w1718","Hybrid",8,"Thu","weekday","sled","Washington Gulch","2","2","1",5.3,0.1,25,2,28,21.2,0,5,-1,-2,2,7,6,4
"2657",2018-02-09,"Washington Gulch","w1718","Non.motorized",27,"Fri","weekday","no_sled","Washington Gulch","2","2","1",5.3,0,24,-1,33,22.1,2,0,5,-1,1,1,6,5
"2658",2018-02-09,"Washington Gulch","w1718","Mechanized",2,"Fri","weekday","no_sled","Washington Gulch","2","2","1",5.3,0,24,-1,33,22.1,2,0,5,-1,1,1,6,5
"2659",2018-02-09,"Washington Gulch","w1718","Motorized",4,"Fri","weekday","sled","Washington Gulch","2","2","1",5.3,0,24,-1,33,22.1,2,0,5,-1,1,1,6,5
"2660",2018-02-09,"Washington Gulch","w1718","Hybrid",3,"Fri","weekday","sled","Washington Gulch","2","2","1",5.3,0,24,-1,33,22.1,2,0,5,-1,1,1,6,5
"2661",2018-02-10,"Washington Gulch","w1718","Non.motorized",28,"Sat","weekend","no_sled","Washington Gulch","3","3","2",5.3,0,24,0,24,22.1,-1,2,0,5,-1,1,1,6
"2662",2018-02-10,"Washington Gulch","w1718","Mechanized",0,"Sat","weekend","no_sled","Washington Gulch","3","3","2",5.3,0,24,0,24,22.1,-1,2,0,5,-1,1,1,6
"2663",2018-02-10,"Washington Gulch","w1718","Motorized",3,"Sat","weekend","sled","Washington Gulch","3","3","2",5.3,0,24,0,24,22.1,-1,2,0,5,-1,1,1,6
"2664",2018-02-10,"Washington Gulch","w1718","Hybrid",2,"Sat","weekend","sled","Washington Gulch","3","3","2",5.3,0,24,0,24,22.1,-1,2,0,5,-1,1,1,6
"2665",2018-02-11,"Washington Gulch","w1718","Non.motorized",43,"Sun","weekend","no_sled","Washington Gulch","3","3","2",5.6,0.3,27,3,13,20.7,0,-1,2,0,3,2,4,4
"2666",2018-02-11,"Washington Gulch","w1718","Mechanized",1,"Sun","weekend","no_sled","Washington Gulch","3","3","2",5.6,0.3,27,3,13,20.7,0,-1,2,0,3,2,4,4
"2667",2018-02-11,"Washington Gulch","w1718","Motorized",13,"Sun","weekend","sled","Washington Gulch","3","3","2",5.6,0.3,27,3,13,20.7,0,-1,2,0,3,2,4,4
"2668",2018-02-11,"Washington Gulch","w1718","Hybrid",9,"Sun","weekend","sled","Washington Gulch","3","3","2",5.6,0.3,27,3,13,20.7,0,-1,2,0,3,2,4,4
"2669",2018-02-12,"Washington Gulch","w1718","Non.motorized",20,"Mon","weekday","no_sled","Washington Gulch","3","3","3",5.7,0.1,27,0,23,21.1,3,0,-1,2,3,3,2,4
"2670",2018-02-12,"Washington Gulch","w1718","Mechanized",0,"Mon","weekday","no_sled","Washington Gulch","3","3","3",5.7,0.1,27,0,23,21.1,3,0,-1,2,3,3,2,4
"2671",2018-02-12,"Washington Gulch","w1718","Motorized",2,"Mon","weekday","sled","Washington Gulch","3","3","3",5.7,0.1,27,0,23,21.1,3,0,-1,2,3,3,2,4
"2672",2018-02-12,"Washington Gulch","w1718","Hybrid",2,"Mon","weekday","sled","Washington Gulch","3","3","3",5.7,0.1,27,0,23,21.1,3,0,-1,2,3,3,2,4
"2673",2018-02-13,"Washington Gulch","w1718","Non.motorized",9,"Tue","weekday","no_sled","Washington Gulch","3","3","3",6.1,0.4,29,2,28,21,0,3,0,-1,2,5,5,4
"2674",2018-02-13,"Washington Gulch","w1718","Mechanized",0,"Tue","weekday","no_sled","Washington Gulch","3","3","3",6.1,0.4,29,2,28,21,0,3,0,-1,2,5,5,4
"2675",2018-02-13,"Washington Gulch","w1718","Motorized",1,"Tue","weekday","sled","Washington Gulch","3","3","3",6.1,0.4,29,2,28,21,0,3,0,-1,2,5,5,4
"2676",2018-02-13,"Washington Gulch","w1718","Hybrid",0,"Tue","weekday","sled","Washington Gulch","3","3","3",6.1,0.4,29,2,28,21,0,3,0,-1,2,5,5,4
"2677",2018-02-14,"Washington Gulch","w1718","Non.motorized",30,"Wed","weekday","no_sled","Washington Gulch","3","3","3",6.2,0.1,30,1,30,20.7,2,0,3,0,3,3,6,6
"2678",2018-02-14,"Washington Gulch","w1718","Mechanized",0,"Wed","weekday","no_sled","Washington Gulch","3","3","3",6.2,0.1,30,1,30,20.7,2,0,3,0,3,3,6,6
"2679",2018-02-14,"Washington Gulch","w1718","Motorized",2,"Wed","weekday","sled","Washington Gulch","3","3","3",6.2,0.1,30,1,30,20.7,2,0,3,0,3,3,6,6
"2680",2018-02-14,"Washington Gulch","w1718","Hybrid",0,"Wed","weekday","sled","Washington Gulch","3","3","3",6.2,0.1,30,1,30,20.7,2,0,3,0,3,3,6,6
"2681",2018-02-15,"Washington Gulch","w1718","Non.motorized",13,"Thu","weekday","no_sled","Washington Gulch","3","3","3",6.3,0.1,28,-2,24,22.5,1,2,0,3,-1,1,1,4
"2682",2018-02-15,"Washington Gulch","w1718","Mechanized",0,"Thu","weekday","no_sled","Washington Gulch","3","3","3",6.3,0.1,28,-2,24,22.5,1,2,0,3,-1,1,1,4
"2683",2018-02-15,"Washington Gulch","w1718","Motorized",3,"Thu","weekday","sled","Washington Gulch","3","3","3",6.3,0.1,28,-2,24,22.5,1,2,0,3,-1,1,1,4
"2684",2018-02-15,"Washington Gulch","w1718","Hybrid",3,"Thu","weekday","sled","Washington Gulch","3","3","3",6.3,0.1,28,-2,24,22.5,1,2,0,3,-1,1,1,4
"2685",2018-02-16,"Washington Gulch","w1718","Non.motorized",33,"Fri","weekday","no_sled","Washington Gulch","3","3","3",6.7,0.4,32,4,18,20.9,-2,1,2,0,2,3,5,5
"2686",2018-02-16,"Washington Gulch","w1718","Mechanized",0,"Fri","weekday","no_sled","Washington Gulch","3","3","3",6.7,0.4,32,4,18,20.9,-2,1,2,0,2,3,5,5
"2687",2018-02-16,"Washington Gulch","w1718","Motorized",4,"Fri","weekday","sled","Washington Gulch","3","3","3",6.7,0.4,32,4,18,20.9,-2,1,2,0,2,3,5,5
"2688",2018-02-16,"Washington Gulch","w1718","Hybrid",3,"Fri","weekday","sled","Washington Gulch","3","3","3",6.7,0.4,32,4,18,20.9,-2,1,2,0,2,3,5,5
"2689",2018-02-17,"Washington Gulch","w1718","Non.motorized",84,"Sat","weekend","no_sled","Washington Gulch","3","3","2",6.7,0,32,0,25,20.9,4,-2,1,2,4,2,3,5
"2690",2018-02-17,"Washington Gulch","w1718","Mechanized",1,"Sat","weekend","no_sled","Washington Gulch","3","3","2",6.7,0,32,0,25,20.9,4,-2,1,2,4,2,3,5
"2691",2018-02-17,"Washington Gulch","w1718","Motorized",18,"Sat","weekend","sled","Washington Gulch","3","3","2",6.7,0,32,0,25,20.9,4,-2,1,2,4,2,3,5
"2692",2018-02-17,"Washington Gulch","w1718","Hybrid",9,"Sat","weekend","sled","Washington Gulch","3","3","2",6.7,0,32,0,25,20.9,4,-2,1,2,4,2,3,5
"2693",2018-02-18,"Washington Gulch","w1718","Non.motorized",81,"Sun","weekend","no_sled","Washington Gulch","2","2","2",6.7,0,31,-1,32,21.6,0,4,-2,1,-1,3,1,2
"2694",2018-02-18,"Washington Gulch","w1718","Mechanized",0,"Sun","weekend","no_sled","Washington Gulch","2","2","2",6.7,0,31,-1,32,21.6,0,4,-2,1,-1,3,1,2
"2695",2018-02-18,"Washington Gulch","w1718","Motorized",14,"Sun","weekend","sled","Washington Gulch","2","2","2",6.7,0,31,-1,32,21.6,0,4,-2,1,-1,3,1,2
"2696",2018-02-18,"Washington Gulch","w1718","Hybrid",5,"Sun","weekend","sled","Washington Gulch","2","2","2",6.7,0,31,-1,32,21.6,0,4,-2,1,-1,3,1,2
"2697",2018-02-19,"Washington Gulch","w1718","Non.motorized",21,"Mon","weekday","no_sled","Washington Gulch","2","2","2",6.8,0.1,29,-2,24,23.4,-1,0,4,-2,-3,-3,1,-1
"2698",2018-02-19,"Washington Gulch","w1718","Non.motorized",21,"Mon","weekday","no_sled","Washington Gulch","3","3","3",6.8,0.1,29,-2,24,23.4,-1,0,4,-2,-3,-3,1,-1
"2699",2018-02-19,"Washington Gulch","w1718","Mechanized",0,"Mon","weekday","no_sled","Washington Gulch","2","2","2",6.8,0.1,29,-2,24,23.4,-1,0,4,-2,-3,-3,1,-1
"2700",2018-02-19,"Washington Gulch","w1718","Mechanized",0,"Mon","weekday","no_sled","Washington Gulch","3","3","3",6.8,0.1,29,-2,24,23.4,-1,0,4,-2,-3,-3,1,-1
"2701",2018-02-19,"Washington Gulch","w1718","Motorized",2,"Mon","weekday","sled","Washington Gulch","2","2","2",6.8,0.1,29,-2,24,23.4,-1,0,4,-2,-3,-3,1,-1
"2702",2018-02-19,"Washington Gulch","w1718","Motorized",2,"Mon","weekday","sled","Washington Gulch","3","3","3",6.8,0.1,29,-2,24,23.4,-1,0,4,-2,-3,-3,1,-1
"2703",2018-02-19,"Washington Gulch","w1718","Hybrid",0,"Mon","weekday","sled","Washington Gulch","2","2","2",6.8,0.1,29,-2,24,23.4,-1,0,4,-2,-3,-3,1,-1
"2704",2018-02-19,"Washington Gulch","w1718","Hybrid",0,"Mon","weekday","sled","Washington Gulch","3","3","3",6.8,0.1,29,-2,24,23.4,-1,0,4,-2,-3,-3,1,-1
"2705",2018-02-20,"Washington Gulch","w1718","Non.motorized",19,"Tue","weekday","no_sled","Washington Gulch","3","3","3",6.8,0,31,2,8,21.9,-2,-1,0,4,0,-1,-1,3
"2706",2018-02-20,"Washington Gulch","w1718","Mechanized",0,"Tue","weekday","no_sled","Washington Gulch","3","3","3",6.8,0,31,2,8,21.9,-2,-1,0,4,0,-1,-1,3
"2707",2018-02-20,"Washington Gulch","w1718","Motorized",2,"Tue","weekday","sled","Washington Gulch","3","3","3",6.8,0,31,2,8,21.9,-2,-1,0,4,0,-1,-1,3
"2708",2018-02-20,"Washington Gulch","w1718","Hybrid",0,"Tue","weekday","sled","Washington Gulch","3","3","3",6.8,0,31,2,8,21.9,-2,-1,0,4,0,-1,-1,3
"2709",2018-02-21,"Washington Gulch","w1718","Non.motorized",16,"Wed","weekday","no_sled","Washington Gulch","3","3","3",6.8,0,31,0,11,21.9,2,-2,-1,0,2,0,-1,-1
"2710",2018-02-21,"Washington Gulch","w1718","Mechanized",0,"Wed","weekday","no_sled","Washington Gulch","3","3","3",6.8,0,31,0,11,21.9,2,-2,-1,0,2,0,-1,-1
"2711",2018-02-21,"Washington Gulch","w1718","Motorized",4,"Wed","weekday","sled","Washington Gulch","3","3","3",6.8,0,31,0,11,21.9,2,-2,-1,0,2,0,-1,-1
"2712",2018-02-21,"Washington Gulch","w1718","Hybrid",2,"Wed","weekday","sled","Washington Gulch","3","3","3",6.8,0,31,0,11,21.9,2,-2,-1,0,2,0,-1,-1
"2713",2018-02-22,"Washington Gulch","w1718","Non.motorized",20,"Thu","weekday","no_sled","Washington Gulch","3","3","2",6.8,0,30,-1,16,22.7,0,2,-2,-1,-1,1,-1,-2
"2714",2018-02-22,"Washington Gulch","w1718","Mechanized",0,"Thu","weekday","no_sled","Washington Gulch","3","3","2",6.8,0,30,-1,16,22.7,0,2,-2,-1,-1,1,-1,-2
"2715",2018-02-22,"Washington Gulch","w1718","Motorized",0,"Thu","weekday","sled","Washington Gulch","3","3","2",6.8,0,30,-1,16,22.7,0,2,-2,-1,-1,1,-1,-2
"2716",2018-02-22,"Washington Gulch","w1718","Hybrid",0,"Thu","weekday","sled","Washington Gulch","3","3","2",6.8,0,30,-1,16,22.7,0,2,-2,-1,-1,1,-1,-2
"2717",2018-02-23,"Washington Gulch","w1718","Non.motorized",21,"Fri","weekday","no_sled","Washington Gulch","3","3","2",6.9,0.1,30,0,15,23,-1,0,2,-2,-1,-1,1,-1
"2718",2018-02-23,"Washington Gulch","w1718","Mechanized",0,"Fri","weekday","no_sled","Washington Gulch","3","3","2",6.9,0.1,30,0,15,23,-1,0,2,-2,-1,-1,1,-1
"2719",2018-02-23,"Washington Gulch","w1718","Motorized",5,"Fri","weekday","sled","Washington Gulch","3","3","2",6.9,0.1,30,0,15,23,-1,0,2,-2,-1,-1,1,-1
"2720",2018-02-23,"Washington Gulch","w1718","Hybrid",1,"Fri","weekday","sled","Washington Gulch","3","3","2",6.9,0.1,30,0,15,23,-1,0,2,-2,-1,-1,1,-1
"2721",2018-02-24,"Washington Gulch","w1718","Non.motorized",40,"Sat","weekend","no_sled","Washington Gulch","3","3","2",6.9,0,31,1,10,22.3,0,-1,0,2,1,0,0,2
"2722",2018-02-24,"Washington Gulch","w1718","Mechanized",0,"Sat","weekend","no_sled","Washington Gulch","3","3","2",6.9,0,31,1,10,22.3,0,-1,0,2,1,0,0,2
"2723",2018-02-24,"Washington Gulch","w1718","Motorized",20,"Sat","weekend","sled","Washington Gulch","3","3","2",6.9,0,31,1,10,22.3,0,-1,0,2,1,0,0,2
"2724",2018-02-24,"Washington Gulch","w1718","Hybrid",11,"Sat","weekend","sled","Washington Gulch","3","3","2",6.9,0,31,1,10,22.3,0,-1,0,2,1,0,0,2
"2725",2018-02-25,"Washington Gulch","w1718","Non.motorized",35,"Sun","weekend","no_sled","Washington Gulch","3","3","2",7.1,0.2,32,1,11,22.2,1,0,-1,0,2,2,1,1
"2726",2018-02-25,"Washington Gulch","w1718","Mechanized",0,"Sun","weekend","no_sled","Washington Gulch","3","3","2",7.1,0.2,32,1,11,22.2,1,0,-1,0,2,2,1,1
"2727",2018-02-25,"Washington Gulch","w1718","Motorized",11,"Sun","weekend","sled","Washington Gulch","3","3","2",7.1,0.2,32,1,11,22.2,1,0,-1,0,2,2,1,1
"2728",2018-02-25,"Washington Gulch","w1718","Hybrid",6,"Sun","weekend","sled","Washington Gulch","3","3","2",7.1,0.2,32,1,11,22.2,1,0,-1,0,2,2,1,1
"2729",2018-02-26,"Washington Gulch","w1718","Non.motorized",19,"Mon","weekday","no_sled","Washington Gulch","2","2","2",7.1,0,32,0,20,22.2,1,1,0,-1,1,2,2,1
"2730",2018-02-26,"Washington Gulch","w1718","Mechanized",0,"Mon","weekday","no_sled","Washington Gulch","2","2","2",7.1,0,32,0,20,22.2,1,1,0,-1,1,2,2,1
"2731",2018-02-26,"Washington Gulch","w1718","Motorized",13,"Mon","weekday","sled","Washington Gulch","2","2","2",7.1,0,32,0,20,22.2,1,1,0,-1,1,2,2,1
"2732",2018-02-26,"Washington Gulch","w1718","Hybrid",9,"Mon","weekday","sled","Washington Gulch","2","2","2",7.1,0,32,0,20,22.2,1,1,0,-1,1,2,2,1
"2733",2018-02-27,"Washington Gulch","w1718","Non.motorized",30,"Tue","weekday","no_sled","Washington Gulch","2","2","2",7.2,0.1,32,0,26,22.5,0,1,1,0,0,1,2,2
"2734",2018-02-27,"Washington Gulch","w1718","Mechanized",1,"Tue","weekday","no_sled","Washington Gulch","2","2","2",7.2,0.1,32,0,26,22.5,0,1,1,0,0,1,2,2
"2735",2018-02-27,"Washington Gulch","w1718","Motorized",10,"Tue","weekday","sled","Washington Gulch","2","2","2",7.2,0.1,32,0,26,22.5,0,1,1,0,0,1,2,2
"2736",2018-02-27,"Washington Gulch","w1718","Hybrid",5,"Tue","weekday","sled","Washington Gulch","2","2","2",7.2,0.1,32,0,26,22.5,0,1,1,0,0,1,2,2
"2737",2018-02-28,"Washington Gulch","w1718","Non.motorized",17,"Wed","weekday","no_sled","Washington Gulch","2","2","2",7.2,0,31,-1,23,23.2,0,0,1,1,-1,-1,0,1
"2738",2018-02-28,"Washington Gulch","w1718","Mechanized",0,"Wed","weekday","no_sled","Washington Gulch","2","2","2",7.2,0,31,-1,23,23.2,0,0,1,1,-1,-1,0,1
"2739",2018-02-28,"Washington Gulch","w1718","Motorized",7,"Wed","weekday","sled","Washington Gulch","2","2","2",7.2,0,31,-1,23,23.2,0,0,1,1,-1,-1,0,1
"2740",2018-02-28,"Washington Gulch","w1718","Hybrid",3,"Wed","weekday","sled","Washington Gulch","2","2","2",7.2,0,31,-1,23,23.2,0,0,1,1,-1,-1,0,1
"2741",2018-03-01,"Washington Gulch","w1718","Non.motorized",25,"Thu","weekday","no_sled","Washington Gulch","2","2","2",7.2,0,31,0,24,23.2,-1,0,0,1,-1,-1,-1,0
"2742",2018-03-01,"Washington Gulch","w1718","Mechanized",2,"Thu","weekday","no_sled","Washington Gulch","2","2","2",7.2,0,31,0,24,23.2,-1,0,0,1,-1,-1,-1,0
"2743",2018-03-01,"Washington Gulch","w1718","Motorized",8,"Thu","weekday","sled","Washington Gulch","2","2","2",7.2,0,31,0,24,23.2,-1,0,0,1,-1,-1,-1,0
"2744",2018-03-01,"Washington Gulch","w1718","Hybrid",4,"Thu","weekday","sled","Washington Gulch","2","2","2",7.2,0,31,0,24,23.2,-1,0,0,1,-1,-1,-1,0
"2745",2018-03-02,"Washington Gulch","w1718","Non.motorized",17,"Fri","weekday","no_sled","Washington Gulch","2","2","1",7.2,0,31,0,30,23.2,0,-1,0,0,0,-1,-1,-1
"2746",2018-03-02,"Washington Gulch","w1718","Mechanized",0,"Fri","weekday","no_sled","Washington Gulch","2","2","1",7.2,0,31,0,30,23.2,0,-1,0,0,0,-1,-1,-1
"2747",2018-03-02,"Washington Gulch","w1718","Motorized",11,"Fri","weekday","sled","Washington Gulch","2","2","1",7.2,0,31,0,30,23.2,0,-1,0,0,0,-1,-1,-1
"2748",2018-03-02,"Washington Gulch","w1718","Hybrid",6,"Fri","weekday","sled","Washington Gulch","2","2","1",7.2,0,31,0,30,23.2,0,-1,0,0,0,-1,-1,-1
"2749",2018-03-03,"Washington Gulch","w1718","Non.motorized",103,"Sat","weekend","no_sled","Washington Gulch","2","2","1",7.3,0.1,30,-1,34,24.3,0,0,-1,0,-1,-1,-2,-2
"2750",2018-03-03,"Washington Gulch","w1718","Mechanized",0,"Sat","weekend","no_sled","Washington Gulch","2","2","1",7.3,0.1,30,-1,34,24.3,0,0,-1,0,-1,-1,-2,-2
"2751",2018-03-03,"Washington Gulch","w1718","Motorized",21,"Sat","weekend","sled","Washington Gulch","2","2","1",7.3,0.1,30,-1,34,24.3,0,0,-1,0,-1,-1,-2,-2
"2752",2018-03-03,"Washington Gulch","w1718","Hybrid",5,"Sat","weekend","sled","Washington Gulch","2","2","1",7.3,0.1,30,-1,34,24.3,0,0,-1,0,-1,-1,-2,-2
"2753",2018-03-04,"Washington Gulch","w1718","Non.motorized",39,"Sun","weekend","no_sled","Washington Gulch","2","2","1",7.3,0,29,-1,24,25.2,-1,0,0,-1,-2,-2,-2,-3
"2754",2018-03-04,"Washington Gulch","w1718","Mechanized",2,"Sun","weekend","no_sled","Washington Gulch","2","2","1",7.3,0,29,-1,24,25.2,-1,0,0,-1,-2,-2,-2,-3
"2755",2018-03-04,"Washington Gulch","w1718","Motorized",6,"Sun","weekend","sled","Washington Gulch","2","2","1",7.3,0,29,-1,24,25.2,-1,0,0,-1,-2,-2,-2,-3
"2756",2018-03-04,"Washington Gulch","w1718","Hybrid",0,"Sun","weekend","sled","Washington Gulch","2","2","1",7.3,0,29,-1,24,25.2,-1,0,0,-1,-2,-2,-2,-3
"2757",2018-03-05,"Washington Gulch","w1718","Non.motorized",10,"Mon","weekday","no_sled","Washington Gulch","2","2","1",7.3,0,31,2,13,23.5,-1,-1,0,0,1,0,0,0
"2758",2018-03-05,"Washington Gulch","w1718","Mechanized",0,"Mon","weekday","no_sled","Washington Gulch","2","2","1",7.3,0,31,2,13,23.5,-1,-1,0,0,1,0,0,0
"2759",2018-03-05,"Washington Gulch","w1718","Motorized",5,"Mon","weekday","sled","Washington Gulch","2","2","1",7.3,0,31,2,13,23.5,-1,-1,0,0,1,0,0,0
"2760",2018-03-05,"Washington Gulch","w1718","Hybrid",0,"Mon","weekday","sled","Washington Gulch","2","2","1",7.3,0,31,2,13,23.5,-1,-1,0,0,1,0,0,0
"2761",2018-03-06,"Washington Gulch","w1718","Non.motorized",17,"Tue","weekday","no_sled","Washington Gulch","2","2","1",7.3,0,31,0,19,23.5,2,-1,-1,0,2,1,0,0
"2762",2018-03-06,"Washington Gulch","w1718","Mechanized",0,"Tue","weekday","no_sled","Washington Gulch","2","2","1",7.3,0,31,0,19,23.5,2,-1,-1,0,2,1,0,0
"2763",2018-03-06,"Washington Gulch","w1718","Motorized",10,"Tue","weekday","sled","Washington Gulch","2","2","1",7.3,0,31,0,19,23.5,2,-1,-1,0,2,1,0,0
"2764",2018-03-06,"Washington Gulch","w1718","Hybrid",6,"Tue","weekday","sled","Washington Gulch","2","2","1",7.3,0,31,0,19,23.5,2,-1,-1,0,2,1,0,0
"2765",2018-03-07,"Washington Gulch","w1718","Non.motorized",22,"Wed","weekday","no_sled","Washington Gulch","2","2","1",7.4,0.1,31,0,27,23.9,0,2,-1,-1,0,2,1,0
"2766",2018-03-07,"Washington Gulch","w1718","Mechanized",0,"Wed","weekday","no_sled","Washington Gulch","2","2","1",7.4,0.1,31,0,27,23.9,0,2,-1,-1,0,2,1,0
"2767",2018-03-07,"Washington Gulch","w1718","Motorized",2,"Wed","weekday","sled","Washington Gulch","2","2","1",7.4,0.1,31,0,27,23.9,0,2,-1,-1,0,2,1,0
"2768",2018-03-07,"Washington Gulch","w1718","Hybrid",2,"Wed","weekday","sled","Washington Gulch","2","2","1",7.4,0.1,31,0,27,23.9,0,2,-1,-1,0,2,1,0
"2769",2018-03-08,"Washington Gulch","w1718","Non.motorized",17,"Thu","weekday","no_sled","Washington Gulch","2","2","1",7.4,0,30,-1,33,24.7,0,0,2,-1,-1,-1,1,0
"2770",2018-03-08,"Washington Gulch","w1718","Mechanized",1,"Thu","weekday","no_sled","Washington Gulch","2","2","1",7.4,0,30,-1,33,24.7,0,0,2,-1,-1,-1,1,0
"2771",2018-03-08,"Washington Gulch","w1718","Motorized",15,"Thu","weekday","sled","Washington Gulch","2","2","1",7.4,0,30,-1,33,24.7,0,0,2,-1,-1,-1,1,0
"2772",2018-03-08,"Washington Gulch","w1718","Hybrid",8,"Thu","weekday","sled","Washington Gulch","2","2","1",7.4,0,30,-1,33,24.7,0,0,2,-1,-1,-1,1,0
"2773",2018-03-09,"Washington Gulch","w1718","Non.motorized",26,"Fri","weekday","no_sled","Washington Gulch","2","2","1",7.4,0,30,0,34,24.7,-1,0,0,2,-1,-1,-1,1
"2774",2018-03-09,"Washington Gulch","w1718","Mechanized",3,"Fri","weekday","no_sled","Washington Gulch","2","2","1",7.4,0,30,0,34,24.7,-1,0,0,2,-1,-1,-1,1
"2775",2018-03-09,"Washington Gulch","w1718","Motorized",3,"Fri","weekday","sled","Washington Gulch","2","2","1",7.4,0,30,0,34,24.7,-1,0,0,2,-1,-1,-1,1
"2776",2018-03-09,"Washington Gulch","w1718","Hybrid",2,"Fri","weekday","sled","Washington Gulch","2","2","1",7.4,0,30,0,34,24.7,-1,0,0,2,-1,-1,-1,1
"2777",2018-03-10,"Washington Gulch","w1718","Non.motorized",69,"Sat","weekend","no_sled","Washington Gulch","1","1","1",7.4,0,30,0,31,24.7,0,-1,0,0,0,-1,-1,-1
"2778",2018-03-10,"Washington Gulch","w1718","Mechanized",2,"Sat","weekend","no_sled","Washington Gulch","1","1","1",7.4,0,30,0,31,24.7,0,-1,0,0,0,-1,-1,-1
"2779",2018-03-10,"Washington Gulch","w1718","Motorized",4,"Sat","weekend","sled","Washington Gulch","1","1","1",7.4,0,30,0,31,24.7,0,-1,0,0,0,-1,-1,-1
"2780",2018-03-10,"Washington Gulch","w1718","Hybrid",3,"Sat","weekend","sled","Washington Gulch","1","1","1",7.4,0,30,0,31,24.7,0,-1,0,0,0,-1,-1,-1
"2781",2018-03-11,"Washington Gulch","w1718","Non.motorized",35,"Sun","weekend","no_sled","Washington Gulch","1","1","1",7.4,0,29,-1,31,25.5,0,0,-1,0,-1,-1,-2,-2
"2782",2018-03-11,"Washington Gulch","w1718","Mechanized",3,"Sun","weekend","no_sled","Washington Gulch","1","1","1",7.4,0,29,-1,31,25.5,0,0,-1,0,-1,-1,-2,-2
"2783",2018-03-11,"Washington Gulch","w1718","Motorized",15,"Sun","weekend","sled","Washington Gulch","1","1","1",7.4,0,29,-1,31,25.5,0,0,-1,0,-1,-1,-2,-2
"2784",2018-03-11,"Washington Gulch","w1718","Hybrid",10,"Sun","weekend","sled","Washington Gulch","1","1","1",7.4,0,29,-1,31,25.5,0,0,-1,0,-1,-1,-2,-2
"2785",2018-03-12,"Washington Gulch","w1718","Non.motorized",18,"Mon","weekday","no_sled","Washington Gulch","1","1","1",7.4,0,29,0,33,25.5,-1,0,0,-1,-1,-1,-1,-2
"2786",2018-03-12,"Washington Gulch","w1718","Mechanized",0,"Mon","weekday","no_sled","Washington Gulch","1","1","1",7.4,0,29,0,33,25.5,-1,0,0,-1,-1,-1,-1,-2
"2787",2018-03-12,"Washington Gulch","w1718","Motorized",12,"Mon","weekday","sled","Washington Gulch","1","1","1",7.4,0,29,0,33,25.5,-1,0,0,-1,-1,-1,-1,-2
"2788",2018-03-12,"Washington Gulch","w1718","Hybrid",9,"Mon","weekday","sled","Washington Gulch","1","1","1",7.4,0,29,0,33,25.5,-1,0,0,-1,-1,-1,-1,-2
"2789",2018-03-13,"Washington Gulch","w1718","Non.motorized",20,"Tue","weekday","no_sled","Washington Gulch","1","1","1",7.4,0,29,0,34,25.5,0,-1,0,0,0,-1,-1,-1
"2790",2018-03-13,"Washington Gulch","w1718","Mechanized",2,"Tue","weekday","no_sled","Washington Gulch","1","1","1",7.4,0,29,0,34,25.5,0,-1,0,0,0,-1,-1,-1
"2791",2018-03-13,"Washington Gulch","w1718","Motorized",7,"Tue","weekday","sled","Washington Gulch","1","1","1",7.4,0,29,0,34,25.5,0,-1,0,0,0,-1,-1,-1
"2792",2018-03-13,"Washington Gulch","w1718","Hybrid",6,"Tue","weekday","sled","Washington Gulch","1","1","1",7.4,0,29,0,34,25.5,0,-1,0,0,0,-1,-1,-1
"2793",2018-03-14,"Washington Gulch","w1718","Non.motorized",31,"Wed","weekday","no_sled","Washington Gulch","1","2","2",7.4,0,29,0,39,25.5,0,0,-1,0,0,0,-1,-1
"2794",2018-03-14,"Washington Gulch","w1718","Mechanized",1,"Wed","weekday","no_sled","Washington Gulch","1","2","2",7.4,0,29,0,39,25.5,0,0,-1,0,0,0,-1,-1
"2795",2018-03-14,"Washington Gulch","w1718","Motorized",9,"Wed","weekday","sled","Washington Gulch","1","2","2",7.4,0,29,0,39,25.5,0,0,-1,0,0,0,-1,-1
"2796",2018-03-14,"Washington Gulch","w1718","Hybrid",5,"Wed","weekday","sled","Washington Gulch","1","2","2",7.4,0,29,0,39,25.5,0,0,-1,0,0,0,-1,-1
"2797",2018-03-15,"Washington Gulch","w1718","Non.motorized",20,"Thu","weekday","no_sled","Washington Gulch","2","2","2",7.5,0.1,28,-1,31,26.8,0,0,0,-1,-1,-1,-1,-2
"2798",2018-03-15,"Washington Gulch","w1718","Mechanized",0,"Thu","weekday","no_sled","Washington Gulch","2","2","2",7.5,0.1,28,-1,31,26.8,0,0,0,-1,-1,-1,-1,-2
"2799",2018-03-15,"Washington Gulch","w1718","Motorized",16,"Thu","weekday","sled","Washington Gulch","2","2","2",7.5,0.1,28,-1,31,26.8,0,0,0,-1,-1,-1,-1,-2
"2800",2018-03-15,"Washington Gulch","w1718","Hybrid",7,"Thu","weekday","sled","Washington Gulch","2","2","2",7.5,0.1,28,-1,31,26.8,0,0,0,-1,-1,-1,-1,-2
"2801",2018-03-16,"Washington Gulch","w1718","Non.motorized",11,"Fri","weekday","no_sled","Washington Gulch","2","2","2",7.7,0.2,29,1,25,26.6,-1,0,0,0,0,0,0,0
"2802",2018-03-16,"Washington Gulch","w1718","Mechanized",0,"Fri","weekday","no_sled","Washington Gulch","2","2","2",7.7,0.2,29,1,25,26.6,-1,0,0,0,0,0,0,0
"2803",2018-03-16,"Washington Gulch","w1718","Motorized",24,"Fri","weekday","sled","Washington Gulch","2","2","2",7.7,0.2,29,1,25,26.6,-1,0,0,0,0,0,0,0
"2804",2018-03-16,"Washington Gulch","w1718","Hybrid",7,"Fri","weekday","sled","Washington Gulch","2","2","2",7.7,0.2,29,1,25,26.6,-1,0,0,0,0,0,0,0
"2805",2018-03-17,"Washington Gulch","w1718","Non.motorized",57,"Sat","weekend","no_sled","Washington Gulch","2","2","2",7.8,0.1,32,3,29,24.4,1,-1,0,0,4,3,3,3
"2806",2018-03-17,"Washington Gulch","w1718","Mechanized",2,"Sat","weekend","no_sled","Washington Gulch","2","2","2",7.8,0.1,32,3,29,24.4,1,-1,0,0,4,3,3,3
"2807",2018-03-17,"Washington Gulch","w1718","Motorized",24,"Sat","weekend","sled","Washington Gulch","2","2","2",7.8,0.1,32,3,29,24.4,1,-1,0,0,4,3,3,3
"2808",2018-03-17,"Washington Gulch","w1718","Hybrid",8,"Sat","weekend","sled","Washington Gulch","2","2","2",7.8,0.1,32,3,29,24.4,1,-1,0,0,4,3,3,3
"2809",2018-03-18,"Washington Gulch","w1718","Non.motorized",12,"Sun","weekend","no_sled","Washington Gulch","2","2","2",7.9,0.1,31,-1,24,25.5,3,1,-1,0,2,3,2,2
"2810",2018-03-18,"Washington Gulch","w1718","Mechanized",0,"Sun","weekend","no_sled","Washington Gulch","2","2","2",7.9,0.1,31,-1,24,25.5,3,1,-1,0,2,3,2,2
"2811",2018-03-18,"Washington Gulch","w1718","Motorized",11,"Sun","weekend","sled","Washington Gulch","2","2","2",7.9,0.1,31,-1,24,25.5,3,1,-1,0,2,3,2,2
"2812",2018-03-18,"Washington Gulch","w1718","Hybrid",6,"Sun","weekend","sled","Washington Gulch","2","2","2",7.9,0.1,31,-1,24,25.5,3,1,-1,0,2,3,2,2
"2813",2018-03-19,"Washington Gulch","w1718","Non.motorized",17,"Mon","weekday","no_sled","Washington Gulch","2","2","1",8,0.1,32,1,19,25,-1,3,1,-1,0,3,4,3
"2814",2018-03-19,"Washington Gulch","w1718","Mechanized",0,"Mon","weekday","no_sled","Washington Gulch","2","2","1",8,0.1,32,1,19,25,-1,3,1,-1,0,3,4,3
"2815",2018-03-19,"Washington Gulch","w1718","Motorized",5,"Mon","weekday","sled","Washington Gulch","2","2","1",8,0.1,32,1,19,25,-1,3,1,-1,0,3,4,3
"2816",2018-03-19,"Washington Gulch","w1718","Hybrid",1,"Mon","weekday","sled","Washington Gulch","2","2","1",8,0.1,32,1,19,25,-1,3,1,-1,0,3,4,3
"2817",2018-03-20,"Washington Gulch","w1718","Non.motorized",16,"Tue","weekday","no_sled","Washington Gulch","2","2","1",8,0,30,-2,24,26.7,1,-1,3,1,-1,-2,1,2
"2818",2018-03-20,"Washington Gulch","w1718","Mechanized",0,"Tue","weekday","no_sled","Washington Gulch","2","2","1",8,0,30,-2,24,26.7,1,-1,3,1,-1,-2,1,2
"2819",2018-03-20,"Washington Gulch","w1718","Motorized",9,"Tue","weekday","sled","Washington Gulch","2","2","1",8,0,30,-2,24,26.7,1,-1,3,1,-1,-2,1,2
"2820",2018-03-20,"Washington Gulch","w1718","Hybrid",4,"Tue","weekday","sled","Washington Gulch","2","2","1",8,0,30,-2,24,26.7,1,-1,3,1,-1,-2,1,2
"2821",2018-03-21,"Washington Gulch","w1718","Non.motorized",31,"Wed","weekday","no_sled","Washington Gulch","1","1","1",8.1,0.1,32,2,30,25.3,-2,1,-1,3,0,1,0,3
"2822",2018-03-21,"Washington Gulch","w1718","Mechanized",0,"Wed","weekday","no_sled","Washington Gulch","1","1","1",8.1,0.1,32,2,30,25.3,-2,1,-1,3,0,1,0,3
"2823",2018-03-21,"Washington Gulch","w1718","Motorized",2,"Wed","weekday","sled","Washington Gulch","1","1","1",8.1,0.1,32,2,30,25.3,-2,1,-1,3,0,1,0,3
"2824",2018-03-21,"Washington Gulch","w1718","Hybrid",2,"Wed","weekday","sled","Washington Gulch","1","1","1",8.1,0.1,32,2,30,25.3,-2,1,-1,3,0,1,0,3
"2825",2018-03-22,"Washington Gulch","w1718","Non.motorized",18,"Thu","weekday","no_sled","Washington Gulch","1","1","1",8.1,0,30,-2,36,27,2,-2,1,-1,0,-2,-1,-2
"2826",2018-03-22,"Washington Gulch","w1718","Mechanized",0,"Thu","weekday","no_sled","Washington Gulch","1","1","1",8.1,0,30,-2,36,27,2,-2,1,-1,0,-2,-1,-2
"2827",2018-03-22,"Washington Gulch","w1718","Motorized",2,"Thu","weekday","sled","Washington Gulch","1","1","1",8.1,0,30,-2,36,27,2,-2,1,-1,0,-2,-1,-2
"2828",2018-03-22,"Washington Gulch","w1718","Hybrid",0,"Thu","weekday","sled","Washington Gulch","1","1","1",8.1,0,30,-2,36,27,2,-2,1,-1,0,-2,-1,-2
"2829",2018-03-23,"Washington Gulch","w1718","Non.motorized",1,"Fri","weekday","no_sled","Washington Gulch","2","2","3",8.2,0.1,29,-1,34,28.3,-2,2,-2,1,-3,-1,-3,-2
"2830",2018-03-23,"Washington Gulch","w1718","Mechanized",0,"Fri","weekday","no_sled","Washington Gulch","2","2","3",8.2,0.1,29,-1,34,28.3,-2,2,-2,1,-3,-1,-3,-2
"2831",2018-03-23,"Washington Gulch","w1718","Motorized",0,"Fri","weekday","sled","Washington Gulch","2","2","3",8.2,0.1,29,-1,34,28.3,-2,2,-2,1,-3,-1,-3,-2
"2832",2018-03-23,"Washington Gulch","w1718","Hybrid",0,"Fri","weekday","sled","Washington Gulch","2","2","3",8.2,0.1,29,-1,34,28.3,-2,2,-2,1,-3,-1,-3,-2
"2833",2018-03-24,"Washington Gulch","w1718","Non.motorized",25,"Sat","weekend","no_sled","Washington Gulch","2","2","1",8.9,0.7,34,5,32,26.2,-1,-2,2,-2,4,2,4,2
"2834",2018-03-24,"Washington Gulch","w1718","Mechanized",0,"Sat","weekend","no_sled","Washington Gulch","2","2","1",8.9,0.7,34,5,32,26.2,-1,-2,2,-2,4,2,4,2
"2835",2018-03-24,"Washington Gulch","w1718","Motorized",16,"Sat","weekend","sled","Washington Gulch","2","2","1",8.9,0.7,34,5,32,26.2,-1,-2,2,-2,4,2,4,2
"2836",2018-03-24,"Washington Gulch","w1718","Hybrid",1,"Sat","weekend","sled","Washington Gulch","2","2","1",8.9,0.7,34,5,32,26.2,-1,-2,2,-2,4,2,4,2
"2837",2018-03-25,"Washington Gulch","w1718","Non.motorized",36,"Sun","weekend","no_sled","Washington Gulch","2","2","1",8.9,0,35,1,35,25.4,5,-1,-2,2,6,5,3,5
"2838",2018-03-25,"Washington Gulch","w1718","Mechanized",0,"Sun","weekend","no_sled","Washington Gulch","2","2","1",8.9,0,35,1,35,25.4,5,-1,-2,2,6,5,3,5
"2839",2018-03-25,"Washington Gulch","w1718","Motorized",10,"Sun","weekend","sled","Washington Gulch","2","2","1",8.9,0,35,1,35,25.4,5,-1,-2,2,6,5,3,5
"2840",2018-03-25,"Washington Gulch","w1718","Hybrid",6,"Sun","weekend","sled","Washington Gulch","2","2","1",8.9,0,35,1,35,25.4,5,-1,-2,2,6,5,3,5
"2841",2018-03-26,"Washington Gulch","w1718","Non.motorized",29,"Mon","weekday","no_sled","Washington Gulch","1","1","1",8.9,0,34,-1,31,26.2,1,5,-1,-2,0,5,4,2
"2842",2018-03-26,"Washington Gulch","w1718","Non.motorized",29,"Mon","weekday","no_sled","Washington Gulch","2","1","1",8.9,0,34,-1,31,26.2,1,5,-1,-2,0,5,4,2
"2843",2018-03-26,"Washington Gulch","w1718","Mechanized",0,"Mon","weekday","no_sled","Washington Gulch","1","1","1",8.9,0,34,-1,31,26.2,1,5,-1,-2,0,5,4,2
"2844",2018-03-26,"Washington Gulch","w1718","Mechanized",0,"Mon","weekday","no_sled","Washington Gulch","2","1","1",8.9,0,34,-1,31,26.2,1,5,-1,-2,0,5,4,2
"2845",2018-03-26,"Washington Gulch","w1718","Motorized",6,"Mon","weekday","sled","Washington Gulch","1","1","1",8.9,0,34,-1,31,26.2,1,5,-1,-2,0,5,4,2
"2846",2018-03-26,"Washington Gulch","w1718","Motorized",6,"Mon","weekday","sled","Washington Gulch","2","1","1",8.9,0,34,-1,31,26.2,1,5,-1,-2,0,5,4,2
"2847",2018-03-26,"Washington Gulch","w1718","Hybrid",3,"Mon","weekday","sled","Washington Gulch","1","1","1",8.9,0,34,-1,31,26.2,1,5,-1,-2,0,5,4,2
"2848",2018-03-26,"Washington Gulch","w1718","Hybrid",3,"Mon","weekday","sled","Washington Gulch","2","1","1",8.9,0,34,-1,31,26.2,1,5,-1,-2,0,5,4,2
"2849",2018-03-27,"Washington Gulch","w1718","Non.motorized",20,"Tue","weekday","no_sled","Washington Gulch","1","1","1",8.9,0,33,-1,29,27,-1,1,5,-1,-2,-1,4,3
"2850",2018-03-27,"Washington Gulch","w1718","Mechanized",0,"Tue","weekday","no_sled","Washington Gulch","1","1","1",8.9,0,33,-1,29,27,-1,1,5,-1,-2,-1,4,3
"2851",2018-03-27,"Washington Gulch","w1718","Motorized",10,"Tue","weekday","sled","Washington Gulch","1","1","1",8.9,0,33,-1,29,27,-1,1,5,-1,-2,-1,4,3
"2852",2018-03-27,"Washington Gulch","w1718","Hybrid",2,"Tue","weekday","sled","Washington Gulch","1","1","1",8.9,0,33,-1,29,27,-1,1,5,-1,-2,-1,4,3
"2853",2018-03-28,"Washington Gulch","w1718","Non.motorized",20,"Wed","weekday","no_sled","Washington Gulch","1","1","1",8.9,0,33,0,27,27,-1,-1,1,5,-1,-2,-1,4
"2854",2018-03-28,"Washington Gulch","w1718","Mechanized",0,"Wed","weekday","no_sled","Washington Gulch","1","1","1",8.9,0,33,0,27,27,-1,-1,1,5,-1,-2,-1,4
"2855",2018-03-28,"Washington Gulch","w1718","Motorized",3,"Wed","weekday","sled","Washington Gulch","1","1","1",8.9,0,33,0,27,27,-1,-1,1,5,-1,-2,-1,4
"2856",2018-03-28,"Washington Gulch","w1718","Hybrid",2,"Wed","weekday","sled","Washington Gulch","1","1","1",8.9,0,33,0,27,27,-1,-1,1,5,-1,-2,-1,4
"2857",2018-03-29,"Washington Gulch","w1718","Non.motorized",20,"Thu","weekday","no_sled","Washington Gulch","1","1","1",8.9,0,33,0,27,27,0,-1,-1,1,0,-1,-2,-1
"2858",2018-03-29,"Washington Gulch","w1718","Mechanized",0,"Thu","weekday","no_sled","Washington Gulch","1","1","1",8.9,0,33,0,27,27,0,-1,-1,1,0,-1,-2,-1
"2859",2018-03-29,"Washington Gulch","w1718","Motorized",3,"Thu","weekday","sled","Washington Gulch","1","1","1",8.9,0,33,0,27,27,0,-1,-1,1,0,-1,-2,-1
"2860",2018-03-29,"Washington Gulch","w1718","Hybrid",2,"Thu","weekday","sled","Washington Gulch","1","1","1",8.9,0,33,0,27,27,0,-1,-1,1,0,-1,-2,-1
"2861",2018-03-30,"Washington Gulch","w1718","Non.motorized",30,"Fri","weekday","no_sled","Washington Gulch","1","1","1",8.9,0,32,-1,33,27.8,0,0,-1,-1,-1,-1,-2,-3
"2862",2018-03-30,"Washington Gulch","w1718","Mechanized",0,"Fri","weekday","no_sled","Washington Gulch","1","1","1",8.9,0,32,-1,33,27.8,0,0,-1,-1,-1,-1,-2,-3
"2863",2018-03-30,"Washington Gulch","w1718","Motorized",3,"Fri","weekday","sled","Washington Gulch","1","1","1",8.9,0,32,-1,33,27.8,0,0,-1,-1,-1,-1,-2,-3
"2864",2018-03-30,"Washington Gulch","w1718","Hybrid",0,"Fri","weekday","sled","Washington Gulch","1","1","1",8.9,0,32,-1,33,27.8,0,0,-1,-1,-1,-1,-2,-3
"2865",2018-03-31,"Washington Gulch","w1718","Non.motorized",50,"Sat","weekend","no_sled","Washington Gulch","1","1","1",8.9,0,32,0,39,27.8,-1,0,0,-1,-1,-1,-1,-2
"2866",2018-03-31,"Washington Gulch","w1718","Mechanized",0,"Sat","weekend","no_sled","Washington Gulch","1","1","1",8.9,0,32,0,39,27.8,-1,0,0,-1,-1,-1,-1,-2
"2867",2018-03-31,"Washington Gulch","w1718","Motorized",10,"Sat","weekend","sled","Washington Gulch","1","1","1",8.9,0,32,0,39,27.8,-1,0,0,-1,-1,-1,-1,-2
"2868",2018-03-31,"Washington Gulch","w1718","Hybrid",5,"Sat","weekend","sled","Washington Gulch","1","1","1",8.9,0,32,0,39,27.8,-1,0,0,-1,-1,-1,-1,-2
"2869",2018-04-01,"Washington Gulch","w1718","Non.motorized",18,"Sun","weekend","no_sled","Washington Gulch","1","1","1",8.8,-0.1,30,-2,41,29.3,0,-1,0,0,-2,-3,-3,-3
"2870",2018-04-01,"Washington Gulch","w1718","Mechanized",0,"Sun","weekend","no_sled","Washington Gulch","1","1","1",8.8,-0.1,30,-2,41,29.3,0,-1,0,0,-2,-3,-3,-3
"2871",2018-04-01,"Washington Gulch","w1718","Motorized",19,"Sun","weekend","sled","Washington Gulch","1","1","1",8.8,-0.1,30,-2,41,29.3,0,-1,0,0,-2,-3,-3,-3
"2872",2018-04-01,"Washington Gulch","w1718","Hybrid",12,"Sun","weekend","sled","Washington Gulch","1","1","1",8.8,-0.1,30,-2,41,29.3,0,-1,0,0,-2,-3,-3,-3
"2873",2018-04-02,"Washington Gulch","w1718","Non.motorized",10,"Mon","weekday","no_sled","Washington Gulch","1","1","1",8.7,-0.1,29,-1,39,30,-2,0,-1,0,-3,-3,-4,-4
"2874",2018-04-02,"Washington Gulch","w1718","Mechanized",0,"Mon","weekday","no_sled","Washington Gulch","1","1","1",8.7,-0.1,29,-1,39,30,-2,0,-1,0,-3,-3,-4,-4
"2875",2018-04-02,"Washington Gulch","w1718","Motorized",0,"Mon","weekday","sled","Washington Gulch","1","1","1",8.7,-0.1,29,-1,39,30,-2,0,-1,0,-3,-3,-4,-4
"2876",2018-04-02,"Washington Gulch","w1718","Hybrid",0,"Mon","weekday","sled","Washington Gulch","1","1","1",8.7,-0.1,29,-1,39,30,-2,0,-1,0,-3,-3,-4,-4
"2877",2018-04-03,"Washington Gulch","w1718","Non.motorized",7,"Tue","weekday","no_sled","Washington Gulch","1","1","1",8.8,0.1,30,1,27,29.3,-1,-2,0,-1,0,-2,-2,-3
"2878",2018-04-03,"Washington Gulch","w1718","Mechanized",0,"Tue","weekday","no_sled","Washington Gulch","1","1","1",8.8,0.1,30,1,27,29.3,-1,-2,0,-1,0,-2,-2,-3
"2879",2018-04-03,"Washington Gulch","w1718","Motorized",0,"Tue","weekday","sled","Washington Gulch","1","1","1",8.8,0.1,30,1,27,29.3,-1,-2,0,-1,0,-2,-2,-3
"2880",2018-04-03,"Washington Gulch","w1718","Hybrid",0,"Tue","weekday","sled","Washington Gulch","1","1","1",8.8,0.1,30,1,27,29.3,-1,-2,0,-1,0,-2,-2,-3
"2881",2018-04-04,"Washington Gulch","w1718","Non.motorized",18,"Wed","weekday","no_sled","Washington Gulch","1","2","2",8.9,0.1,28,-2,33,31.8,1,-1,-2,0,-1,-2,-4,-4
"2882",2018-04-04,"Washington Gulch","w1718","Mechanized",0,"Wed","weekday","no_sled","Washington Gulch","1","2","2",8.9,0.1,28,-2,33,31.8,1,-1,-2,0,-1,-2,-4,-4
"2883",2018-04-04,"Washington Gulch","w1718","Motorized",0,"Wed","weekday","sled","Washington Gulch","1","2","2",8.9,0.1,28,-2,33,31.8,1,-1,-2,0,-1,-2,-4,-4
"2884",2018-04-04,"Washington Gulch","w1718","Hybrid",0,"Wed","weekday","sled","Washington Gulch","1","2","2",8.9,0.1,28,-2,33,31.8,1,-1,-2,0,-1,-2,-4,-4
"2885",2018-04-05,"Washington Gulch","w1718","Non.motorized",7,"Thu","weekday","no_sled","Washington Gulch","1","2","2",8.9,0,27,-1,35,33,-2,1,-1,-2,-3,-2,-3,-5
"2886",2018-04-05,"Washington Gulch","w1718","Mechanized",0,"Thu","weekday","no_sled","Washington Gulch","1","2","2",8.9,0,27,-1,35,33,-2,1,-1,-2,-3,-2,-3,-5
"2887",2018-04-05,"Washington Gulch","w1718","Motorized",8,"Thu","weekday","sled","Washington Gulch","1","2","2",8.9,0,27,-1,35,33,-2,1,-1,-2,-3,-2,-3,-5
"2888",2018-04-05,"Washington Gulch","w1718","Hybrid",8,"Thu","weekday","sled","Washington Gulch","1","2","2",8.9,0,27,-1,35,33,-2,1,-1,-2,-3,-2,-3,-5
"2889",2018-04-06,"Washington Gulch","w1718","Non.motorized",8,"Fri","weekday","no_sled","Washington Gulch","1","2","2",8.9,0,25,-2,35,35.6,-1,-2,1,-1,-3,-5,-4,-5
"2890",2018-04-06,"Washington Gulch","w1718","Mechanized",0,"Fri","weekday","no_sled","Washington Gulch","1","2","2",8.9,0,25,-2,35,35.6,-1,-2,1,-1,-3,-5,-4,-5
"2891",2018-04-06,"Washington Gulch","w1718","Motorized",0,"Fri","weekday","sled","Washington Gulch","1","2","2",8.9,0,25,-2,35,35.6,-1,-2,1,-1,-3,-5,-4,-5
"2892",2018-04-06,"Washington Gulch","w1718","Hybrid",0,"Fri","weekday","sled","Washington Gulch","1","2","2",8.9,0,25,-2,35,35.6,-1,-2,1,-1,-3,-5,-4,-5
"2893",2018-04-07,"Washington Gulch","w1718","Non.motorized",11,"Sat","weekend","no_sled","Washington Gulch","2","2","2",9.2,0.3,31,6,37,29.7,-2,-1,-2,1,4,3,1,2
"2894",2018-04-07,"Washington Gulch","w1718","Mechanized",0,"Sat","weekend","no_sled","Washington Gulch","2","2","2",9.2,0.3,31,6,37,29.7,-2,-1,-2,1,4,3,1,2
"2895",2018-04-07,"Washington Gulch","w1718","Motorized",5,"Sat","weekend","sled","Washington Gulch","2","2","2",9.2,0.3,31,6,37,29.7,-2,-1,-2,1,4,3,1,2
"2896",2018-04-07,"Washington Gulch","w1718","Hybrid",0,"Sat","weekend","sled","Washington Gulch","2","2","2",9.2,0.3,31,6,37,29.7,-2,-1,-2,1,4,3,1,2
"2897",2018-04-08,"Washington Gulch","w1718","Non.motorized",7,"Sun","weekend","no_sled","Washington Gulch","3","3","3",10,0.8,33,2,33,30.3,6,-2,-1,-2,8,6,5,3
"2898",2018-04-08,"Washington Gulch","w1718","Mechanized",1,"Sun","weekend","no_sled","Washington Gulch","3","3","3",10,0.8,33,2,33,30.3,6,-2,-1,-2,8,6,5,3
"2899",2018-04-08,"Washington Gulch","w1718","Motorized",5,"Sun","weekend","sled","Washington Gulch","3","3","3",10,0.8,33,2,33,30.3,6,-2,-1,-2,8,6,5,3
"2900",2018-04-08,"Washington Gulch","w1718","Hybrid",0,"Sun","weekend","sled","Washington Gulch","3","3","3",10,0.8,33,2,33,30.3,6,-2,-1,-2,8,6,5,3
"2901",2018-04-09,"Washington Gulch","w1718","Non.motorized",9,"Mon","weekday","no_sled","Washington Gulch","1","1","1",10.1,0.1,33,0,31,30.6,2,6,-2,-1,2,8,6,5
"2902",2018-04-09,"Washington Gulch","w1718","Mechanized",0,"Mon","weekday","no_sled","Washington Gulch","1","1","1",10.1,0.1,33,0,31,30.6,2,6,-2,-1,2,8,6,5
"2903",2018-04-09,"Washington Gulch","w1718","Motorized",1,"Mon","weekday","sled","Washington Gulch","1","1","1",10.1,0.1,33,0,31,30.6,2,6,-2,-1,2,8,6,5
"2904",2018-04-09,"Washington Gulch","w1718","Hybrid",0,"Mon","weekday","sled","Washington Gulch","1","1","1",10.1,0.1,33,0,31,30.6,2,6,-2,-1,2,8,6,5
"2905",2018-04-10,"Washington Gulch","w1718","Non.motorized",11,"Tue","weekday","no_sled","Washington Gulch","1","1","1",10.1,0,31,-2,38,32.6,0,2,6,-2,-2,0,6,4
"2906",2018-04-10,"Washington Gulch","w1718","Mechanized",0,"Tue","weekday","no_sled","Washington Gulch","1","1","1",10.1,0,31,-2,38,32.6,0,2,6,-2,-2,0,6,4
"2907",2018-04-10,"Washington Gulch","w1718","Motorized",6,"Tue","weekday","sled","Washington Gulch","1","1","1",10.1,0,31,-2,38,32.6,0,2,6,-2,-2,0,6,4
"2908",2018-04-10,"Washington Gulch","w1718","Hybrid",5,"Tue","weekday","sled","Washington Gulch","1","1","1",10.1,0,31,-2,38,32.6,0,2,6,-2,-2,0,6,4
"2909",2018-04-11,"Washington Gulch","w1718","Non.motorized",5,"Wed","weekday","no_sled","Washington Gulch","2","2","2",9.9,-0.2,29,-2,45,34.1,-2,0,2,6,-4,-4,-2,4
"2910",2018-04-11,"Washington Gulch","w1718","Mechanized",0,"Wed","weekday","no_sled","Washington Gulch","2","2","2",9.9,-0.2,29,-2,45,34.1,-2,0,2,6,-4,-4,-2,4
"2911",2018-04-11,"Washington Gulch","w1718","Motorized",6,"Wed","weekday","sled","Washington Gulch","2","2","2",9.9,-0.2,29,-2,45,34.1,-2,0,2,6,-4,-4,-2,4
"2912",2018-04-11,"Washington Gulch","w1718","Hybrid",5,"Wed","weekday","sled","Washington Gulch","2","2","2",9.9,-0.2,29,-2,45,34.1,-2,0,2,6,-4,-4,-2,4
"2913",2018-04-12,"Washington Gulch","w1718","Non.motorized",8,"Thu","weekday","no_sled","Washington Gulch","1","2","2",9.5,-0.4,28,-1,40,33.9,-2,-2,0,2,-3,-5,-5,-3
"2914",2018-04-12,"Washington Gulch","w1718","Mechanized",0,"Thu","weekday","no_sled","Washington Gulch","1","2","2",9.5,-0.4,28,-1,40,33.9,-2,-2,0,2,-3,-5,-5,-3
"2915",2018-04-12,"Washington Gulch","w1718","Motorized",5,"Thu","weekday","sled","Washington Gulch","1","2","2",9.5,-0.4,28,-1,40,33.9,-2,-2,0,2,-3,-5,-5,-3
"2916",2018-04-12,"Washington Gulch","w1718","Hybrid",3,"Thu","weekday","sled","Washington Gulch","1","2","2",9.5,-0.4,28,-1,40,33.9,-2,-2,0,2,-3,-5,-5,-3
"2917",2018-04-13,"Washington Gulch","w1718","Non.motorized",14,"Fri","weekday","no_sled","Washington Gulch","2","2","1",9.4,-0.1,26,-2,23,36.2,-1,-2,-2,0,-3,-5,-7,-7
"2918",2018-04-13,"Washington Gulch","w1718","Mechanized",0,"Fri","weekday","no_sled","Washington Gulch","2","2","1",9.4,-0.1,26,-2,23,36.2,-1,-2,-2,0,-3,-5,-7,-7
"2919",2018-04-13,"Washington Gulch","w1718","Motorized",1,"Fri","weekday","sled","Washington Gulch","2","2","1",9.4,-0.1,26,-2,23,36.2,-1,-2,-2,0,-3,-5,-7,-7
"2920",2018-04-13,"Washington Gulch","w1718","Hybrid",0,"Fri","weekday","sled","Washington Gulch","2","2","1",9.4,-0.1,26,-2,23,36.2,-1,-2,-2,0,-3,-5,-7,-7
"2921",2018-04-14,"Washington Gulch","w1718","Non.motorized",11,"Sat","weekend","no_sled","Washington Gulch","2","2","1",9.4,0,28,2,28,33.6,-2,-1,-2,-2,0,-1,-3,-5
"2922",2018-04-14,"Washington Gulch","w1718","Mechanized",0,"Sat","weekend","no_sled","Washington Gulch","2","2","1",9.4,0,28,2,28,33.6,-2,-1,-2,-2,0,-1,-3,-5
"2923",2018-04-14,"Washington Gulch","w1718","Motorized",6,"Sat","weekend","sled","Washington Gulch","2","2","1",9.4,0,28,2,28,33.6,-2,-1,-2,-2,0,-1,-3,-5
"2924",2018-04-14,"Washington Gulch","w1718","Hybrid",1,"Sat","weekend","sled","Washington Gulch","2","2","1",9.4,0,28,2,28,33.6,-2,-1,-2,-2,0,-1,-3,-5
"2925",2018-04-15,"Washington Gulch","w1718","Non.motorized",15,"Sun","weekend","no_sled","Washington Gulch","2","2","1",9.2,-0.2,27,-1,37,34.1,2,-2,-1,-2,1,-1,-2,-4
"2926",2018-04-15,"Washington Gulch","w1718","Mechanized",0,"Sun","weekend","no_sled","Washington Gulch","2","2","1",9.2,-0.2,27,-1,37,34.1,2,-2,-1,-2,1,-1,-2,-4
"2927",2018-04-15,"Washington Gulch","w1718","Motorized",4,"Sun","weekend","sled","Washington Gulch","2","2","1",9.2,-0.2,27,-1,37,34.1,2,-2,-1,-2,1,-1,-2,-4
"2928",2018-04-15,"Washington Gulch","w1718","Hybrid",1,"Sun","weekend","sled","Washington Gulch","2","2","1",9.2,-0.2,27,-1,37,34.1,2,-2,-1,-2,1,-1,-2,-4
"2929",2018-04-16,"Washington Gulch","w1718","Non.motorized",3,"Mon","weekday","no_sled","Washington Gulch",NA,NA,NA,8.9,-0.3,24,-3,43,37.1,-1,2,-2,-1,-4,-2,-4,-5
"2930",2018-04-16,"Washington Gulch","w1718","Mechanized",0,"Mon","weekday","no_sled","Washington Gulch",NA,NA,NA,8.9,-0.3,24,-3,43,37.1,-1,2,-2,-1,-4,-2,-4,-5
"2931",2018-04-16,"Washington Gulch","w1718","Motorized",1,"Mon","weekday","sled","Washington Gulch",NA,NA,NA,8.9,-0.3,24,-3,43,37.1,-1,2,-2,-1,-4,-2,-4,-5
"2932",2018-04-16,"Washington Gulch","w1718","Hybrid",0,"Mon","weekday","sled","Washington Gulch",NA,NA,NA,8.9,-0.3,24,-3,43,37.1,-1,2,-2,-1,-4,-2,-4,-5
"2933",2018-12-01,"Brush Creek Trailhead","w1819","Non.motorized",0,"Sat","weekend","no_sled","Brush/Cement","3","3","2",3.3,0.2,19,1,16,17.4,0,0,0,0,1,1,1,1
"2934",2018-12-01,"Brush Creek Trailhead","w1819","Mechanized",0,"Sat","weekend","no_sled","Brush/Cement","3","3","2",3.3,0.2,19,1,16,17.4,0,0,0,0,1,1,1,1
"2935",2018-12-01,"Brush Creek Trailhead","w1819","Motorized",0,"Sat","weekend","sled","Brush/Cement","3","3","2",3.3,0.2,19,1,16,17.4,0,0,0,0,1,1,1,1
"2936",2018-12-01,"Brush Creek Trailhead","w1819","Hybrid",0,"Sat","weekend","sled","Brush/Cement","3","3","2",3.3,0.2,19,1,16,17.4,0,0,0,0,1,1,1,1
"2937",2018-12-02,"Brush Creek Trailhead","w1819","Non.motorized",0,"Sun","weekend","no_sled","Brush/Cement","3","3","3",3.3,0,20,1,14,16.5,1,0,0,0,2,2,2,2
"2938",2018-12-02,"Brush Creek Trailhead","w1819","Mechanized",0,"Sun","weekend","no_sled","Brush/Cement","3","3","3",3.3,0,20,1,14,16.5,1,0,0,0,2,2,2,2
"2939",2018-12-02,"Brush Creek Trailhead","w1819","Motorized",0,"Sun","weekend","sled","Brush/Cement","3","3","3",3.3,0,20,1,14,16.5,1,0,0,0,2,2,2,2
"2940",2018-12-02,"Brush Creek Trailhead","w1819","Hybrid",0,"Sun","weekend","sled","Brush/Cement","3","3","3",3.3,0,20,1,14,16.5,1,0,0,0,2,2,2,2
"2941",2018-12-03,"Brush Creek Trailhead","w1819","Non.motorized",0,"Mon","weekday","no_sled","Brush/Cement","3","3","2",3.4,0.1,19,-1,13,17.9,1,1,0,0,0,1,1,1
"2942",2018-12-03,"Brush Creek Trailhead","w1819","Mechanized",0,"Mon","weekday","no_sled","Brush/Cement","3","3","2",3.4,0.1,19,-1,13,17.9,1,1,0,0,0,1,1,1
"2943",2018-12-03,"Brush Creek Trailhead","w1819","Motorized",0,"Mon","weekday","sled","Brush/Cement","3","3","2",3.4,0.1,19,-1,13,17.9,1,1,0,0,0,1,1,1
"2944",2018-12-03,"Brush Creek Trailhead","w1819","Hybrid",0,"Mon","weekday","sled","Brush/Cement","3","3","2",3.4,0.1,19,-1,13,17.9,1,1,0,0,0,1,1,1
"2945",2018-12-04,"Brush Creek Trailhead","w1819","Non.motorized",0,"Tue","weekday","no_sled","Brush/Cement","3","3","2",3.5,0.1,20,1,8,17.5,-1,1,1,0,0,1,2,2
"2946",2018-12-04,"Brush Creek Trailhead","w1819","Mechanized",0,"Tue","weekday","no_sled","Brush/Cement","3","3","2",3.5,0.1,20,1,8,17.5,-1,1,1,0,0,1,2,2
"2947",2018-12-04,"Brush Creek Trailhead","w1819","Motorized",0,"Tue","weekday","sled","Brush/Cement","3","3","2",3.5,0.1,20,1,8,17.5,-1,1,1,0,0,1,2,2
"2948",2018-12-04,"Brush Creek Trailhead","w1819","Hybrid",0,"Tue","weekday","sled","Brush/Cement","3","3","2",3.5,0.1,20,1,8,17.5,-1,1,1,0,0,1,2,2
"2949",2018-12-05,"Brush Creek Trailhead","w1819","Non.motorized",0,"Wed","weekday","no_sled","Brush/Cement","3","3","2",3.5,0,19,-1,21,18.4,1,-1,1,1,0,-1,0,1
"2950",2018-12-05,"Brush Creek Trailhead","w1819","Mechanized",0,"Wed","weekday","no_sled","Brush/Cement","3","3","2",3.5,0,19,-1,21,18.4,1,-1,1,1,0,-1,0,1
"2951",2018-12-05,"Brush Creek Trailhead","w1819","Motorized",0,"Wed","weekday","sled","Brush/Cement","3","3","2",3.5,0,19,-1,21,18.4,1,-1,1,1,0,-1,0,1
"2952",2018-12-05,"Brush Creek Trailhead","w1819","Hybrid",0,"Wed","weekday","sled","Brush/Cement","3","3","2",3.5,0,19,-1,21,18.4,1,-1,1,1,0,-1,0,1
"2953",2018-12-06,"Brush Creek Trailhead","w1819","Non.motorized",8,"Thu","weekday","no_sled","Brush/Cement","2","2","2",3.7,0.2,18,-1,25,20.6,-1,1,-1,1,-2,-1,-2,-1
"2954",2018-12-06,"Brush Creek Trailhead","w1819","Mechanized",0,"Thu","weekday","no_sled","Brush/Cement","2","2","2",3.7,0.2,18,-1,25,20.6,-1,1,-1,1,-2,-1,-2,-1
"2955",2018-12-06,"Brush Creek Trailhead","w1819","Motorized",0,"Thu","weekday","sled","Brush/Cement","2","2","2",3.7,0.2,18,-1,25,20.6,-1,1,-1,1,-2,-1,-2,-1
"2956",2018-12-06,"Brush Creek Trailhead","w1819","Hybrid",0,"Thu","weekday","sled","Brush/Cement","2","2","2",3.7,0.2,18,-1,25,20.6,-1,1,-1,1,-2,-1,-2,-1
"2957",2018-12-07,"Brush Creek Trailhead","w1819","Non.motorized",13,"Fri","weekday","no_sled","Brush/Cement","2","2","2",3.8,0.1,21,3,23,18.1,-1,-1,1,-1,2,1,2,1
"2958",2018-12-07,"Brush Creek Trailhead","w1819","Mechanized",0,"Fri","weekday","no_sled","Brush/Cement","2","2","2",3.8,0.1,21,3,23,18.1,-1,-1,1,-1,2,1,2,1
"2959",2018-12-07,"Brush Creek Trailhead","w1819","Motorized",0,"Fri","weekday","sled","Brush/Cement","2","2","2",3.8,0.1,21,3,23,18.1,-1,-1,1,-1,2,1,2,1
"2960",2018-12-07,"Brush Creek Trailhead","w1819","Hybrid",0,"Fri","weekday","sled","Brush/Cement","2","2","2",3.8,0.1,21,3,23,18.1,-1,-1,1,-1,2,1,2,1
"2961",2018-12-08,"Brush Creek Trailhead","w1819","Non.motorized",11,"Sat","weekend","no_sled","Brush/Cement","2","2","2",3.8,0,20,-1,23,19,3,-1,-1,1,2,1,0,1
"2962",2018-12-08,"Brush Creek Trailhead","w1819","Mechanized",0,"Sat","weekend","no_sled","Brush/Cement","2","2","2",3.8,0,20,-1,23,19,3,-1,-1,1,2,1,0,1
"2963",2018-12-08,"Brush Creek Trailhead","w1819","Motorized",0,"Sat","weekend","sled","Brush/Cement","2","2","2",3.8,0,20,-1,23,19,3,-1,-1,1,2,1,0,1
"2964",2018-12-08,"Brush Creek Trailhead","w1819","Hybrid",0,"Sat","weekend","sled","Brush/Cement","2","2","2",3.8,0,20,-1,23,19,3,-1,-1,1,2,1,0,1
"2965",2018-12-09,"Brush Creek Trailhead","w1819","Non.motorized",26,"Sun","weekend","no_sled","Brush/Cement","2","2","2",3.8,0,20,0,19,19,-1,3,-1,-1,-1,2,1,0
"2966",2018-12-09,"Brush Creek Trailhead","w1819","Mechanized",0,"Sun","weekend","no_sled","Brush/Cement","2","2","2",3.8,0,20,0,19,19,-1,3,-1,-1,-1,2,1,0
"2967",2018-12-09,"Brush Creek Trailhead","w1819","Motorized",0,"Sun","weekend","sled","Brush/Cement","2","2","2",3.8,0,20,0,19,19,-1,3,-1,-1,-1,2,1,0
"2968",2018-12-09,"Brush Creek Trailhead","w1819","Hybrid",0,"Sun","weekend","sled","Brush/Cement","2","2","2",3.8,0,20,0,19,19,-1,3,-1,-1,-1,2,1,0
"2969",2018-12-10,"Brush Creek Trailhead","w1819","Non.motorized",5,"Mon","weekday","no_sled","Brush/Cement","2","2","2",3.8,0,20,0,21,19,0,-1,3,-1,0,-1,2,1
"2970",2018-12-10,"Brush Creek Trailhead","w1819","Mechanized",0,"Mon","weekday","no_sled","Brush/Cement","2","2","2",3.8,0,20,0,21,19,0,-1,3,-1,0,-1,2,1
"2971",2018-12-10,"Brush Creek Trailhead","w1819","Motorized",0,"Mon","weekday","sled","Brush/Cement","2","2","2",3.8,0,20,0,21,19,0,-1,3,-1,0,-1,2,1
"2972",2018-12-10,"Brush Creek Trailhead","w1819","Hybrid",0,"Mon","weekday","sled","Brush/Cement","2","2","2",3.8,0,20,0,21,19,0,-1,3,-1,0,-1,2,1
"2973",2018-12-11,"Brush Creek Trailhead","w1819","Non.motorized",5,"Tue","weekday","no_sled","Brush/Cement","2","2","2",3.9,0.1,19,-1,27,20.5,0,0,-1,3,-1,-1,-2,1
"2974",2018-12-11,"Brush Creek Trailhead","w1819","Mechanized",0,"Tue","weekday","no_sled","Brush/Cement","2","2","2",3.9,0.1,19,-1,27,20.5,0,0,-1,3,-1,-1,-2,1
"2975",2018-12-11,"Brush Creek Trailhead","w1819","Motorized",0,"Tue","weekday","sled","Brush/Cement","2","2","2",3.9,0.1,19,-1,27,20.5,0,0,-1,3,-1,-1,-2,1
"2976",2018-12-11,"Brush Creek Trailhead","w1819","Hybrid",0,"Tue","weekday","sled","Brush/Cement","2","2","2",3.9,0.1,19,-1,27,20.5,0,0,-1,3,-1,-1,-2,1
"2977",2018-12-12,"Brush Creek Trailhead","w1819","Non.motorized",3,"Wed","weekday","no_sled","Brush/Cement","2","2","1",3.9,0,19,0,21,20.5,-1,0,0,-1,-1,-1,-1,-2
"2978",2018-12-12,"Brush Creek Trailhead","w1819","Mechanized",0,"Wed","weekday","no_sled","Brush/Cement","2","2","1",3.9,0,19,0,21,20.5,-1,0,0,-1,-1,-1,-1,-2
"2979",2018-12-12,"Brush Creek Trailhead","w1819","Motorized",0,"Wed","weekday","sled","Brush/Cement","2","2","1",3.9,0,19,0,21,20.5,-1,0,0,-1,-1,-1,-1,-2
"2980",2018-12-12,"Brush Creek Trailhead","w1819","Hybrid",0,"Wed","weekday","sled","Brush/Cement","2","2","1",3.9,0,19,0,21,20.5,-1,0,0,-1,-1,-1,-1,-2
"2981",2018-12-13,"Brush Creek Trailhead","w1819","Non.motorized",3,"Thu","weekday","no_sled","Brush/Cement","3","3","2",4,0.1,21,2,15,19,0,-1,0,0,2,1,1,1
"2982",2018-12-13,"Brush Creek Trailhead","w1819","Mechanized",0,"Thu","weekday","no_sled","Brush/Cement","3","3","2",4,0.1,21,2,15,19,0,-1,0,0,2,1,1,1
"2983",2018-12-13,"Brush Creek Trailhead","w1819","Motorized",0,"Thu","weekday","sled","Brush/Cement","3","3","2",4,0.1,21,2,15,19,0,-1,0,0,2,1,1,1
"2984",2018-12-13,"Brush Creek Trailhead","w1819","Hybrid",0,"Thu","weekday","sled","Brush/Cement","3","3","2",4,0.1,21,2,15,19,0,-1,0,0,2,1,1,1
"2985",2018-12-14,"Brush Creek Trailhead","w1819","Non.motorized",1,"Fri","weekday","no_sled","Brush/Cement","3","3","2",4,0,20,-1,24,20,2,0,-1,0,1,1,0,0
"2986",2018-12-14,"Brush Creek Trailhead","w1819","Mechanized",0,"Fri","weekday","no_sled","Brush/Cement","3","3","2",4,0,20,-1,24,20,2,0,-1,0,1,1,0,0
"2987",2018-12-14,"Brush Creek Trailhead","w1819","Motorized",0,"Fri","weekday","sled","Brush/Cement","3","3","2",4,0,20,-1,24,20,2,0,-1,0,1,1,0,0
"2988",2018-12-14,"Brush Creek Trailhead","w1819","Hybrid",0,"Fri","weekday","sled","Brush/Cement","3","3","2",4,0,20,-1,24,20,2,0,-1,0,1,1,0,0
"2989",2018-12-15,"Brush Creek Trailhead","w1819","Non.motorized",19,"Sat","weekend","no_sled","Brush/Cement","2","2","2",4,0,20,0,29,20,-1,2,0,-1,-1,1,1,0
"2990",2018-12-15,"Brush Creek Trailhead","w1819","Mechanized",1,"Sat","weekend","no_sled","Brush/Cement","2","2","2",4,0,20,0,29,20,-1,2,0,-1,-1,1,1,0
"2991",2018-12-15,"Brush Creek Trailhead","w1819","Motorized",0,"Sat","weekend","sled","Brush/Cement","2","2","2",4,0,20,0,29,20,-1,2,0,-1,-1,1,1,0
"2992",2018-12-15,"Brush Creek Trailhead","w1819","Hybrid",0,"Sat","weekend","sled","Brush/Cement","2","2","2",4,0,20,0,29,20,-1,2,0,-1,-1,1,1,0
"2993",2018-12-16,"Brush Creek Trailhead","w1819","Non.motorized",10,"Sun","weekend","no_sled","Brush/Cement","2","2","2",4.1,0.1,19,-1,28,21.6,0,-1,2,0,-1,-2,0,0
"2994",2018-12-16,"Brush Creek Trailhead","w1819","Mechanized",0,"Sun","weekend","no_sled","Brush/Cement","2","2","2",4.1,0.1,19,-1,28,21.6,0,-1,2,0,-1,-2,0,0
"2995",2018-12-16,"Brush Creek Trailhead","w1819","Motorized",0,"Sun","weekend","sled","Brush/Cement","2","2","2",4.1,0.1,19,-1,28,21.6,0,-1,2,0,-1,-2,0,0
"2996",2018-12-16,"Brush Creek Trailhead","w1819","Hybrid",0,"Sun","weekend","sled","Brush/Cement","2","2","2",4.1,0.1,19,-1,28,21.6,0,-1,2,0,-1,-2,0,0
"2997",2018-12-17,"Brush Creek Trailhead","w1819","Non.motorized",5,"Mon","weekday","no_sled","Brush/Cement","2","2","2",4.1,0,19,0,29,21.6,-1,0,-1,2,-1,-1,-2,0
"2998",2018-12-17,"Brush Creek Trailhead","w1819","Mechanized",0,"Mon","weekday","no_sled","Brush/Cement","2","2","2",4.1,0,19,0,29,21.6,-1,0,-1,2,-1,-1,-2,0
"2999",2018-12-17,"Brush Creek Trailhead","w1819","Motorized",0,"Mon","weekday","sled","Brush/Cement","2","2","2",4.1,0,19,0,29,21.6,-1,0,-1,2,-1,-1,-2,0
"3000",2018-12-17,"Brush Creek Trailhead","w1819","Hybrid",0,"Mon","weekday","sled","Brush/Cement","2","2","2",4.1,0,19,0,29,21.6,-1,0,-1,2,-1,-1,-2,0
"3001",2018-12-18,"Brush Creek Trailhead","w1819","Non.motorized",12,"Tue","weekday","no_sled","Brush/Cement","2","2","2",4.1,0,19,0,27,21.6,0,-1,0,-1,0,-1,-1,-2
"3002",2018-12-18,"Brush Creek Trailhead","w1819","Mechanized",1,"Tue","weekday","no_sled","Brush/Cement","2","2","2",4.1,0,19,0,27,21.6,0,-1,0,-1,0,-1,-1,-2
"3003",2018-12-18,"Brush Creek Trailhead","w1819","Motorized",0,"Tue","weekday","sled","Brush/Cement","2","2","2",4.1,0,19,0,27,21.6,0,-1,0,-1,0,-1,-1,-2
"3004",2018-12-18,"Brush Creek Trailhead","w1819","Hybrid",0,"Tue","weekday","sled","Brush/Cement","2","2","2",4.1,0,19,0,27,21.6,0,-1,0,-1,0,-1,-1,-2
"3005",2018-12-19,"Brush Creek Trailhead","w1819","Non.motorized",11,"Wed","weekday","no_sled","Brush/Cement","2","2","2",4.1,0,19,0,24,21.6,0,0,-1,0,0,0,-1,-1
"3006",2018-12-19,"Brush Creek Trailhead","w1819","Mechanized",0,"Wed","weekday","no_sled","Brush/Cement","2","2","2",4.1,0,19,0,24,21.6,0,0,-1,0,0,0,-1,-1
"3007",2018-12-19,"Brush Creek Trailhead","w1819","Motorized",0,"Wed","weekday","sled","Brush/Cement","2","2","2",4.1,0,19,0,24,21.6,0,0,-1,0,0,0,-1,-1
"3008",2018-12-19,"Brush Creek Trailhead","w1819","Hybrid",0,"Wed","weekday","sled","Brush/Cement","2","2","2",4.1,0,19,0,24,21.6,0,0,-1,0,0,0,-1,-1
"3009",2018-12-20,"Brush Creek Trailhead","w1819","Non.motorized",12,"Thu","weekday","no_sled","Brush/Cement","2","2","1",4.1,0,20,1,25,20.5,0,0,0,-1,1,1,1,0
"3010",2018-12-20,"Brush Creek Trailhead","w1819","Mechanized",0,"Thu","weekday","no_sled","Brush/Cement","2","2","1",4.1,0,20,1,25,20.5,0,0,0,-1,1,1,1,0
"3011",2018-12-20,"Brush Creek Trailhead","w1819","Motorized",0,"Thu","weekday","sled","Brush/Cement","2","2","1",4.1,0,20,1,25,20.5,0,0,0,-1,1,1,1,0
"3012",2018-12-20,"Brush Creek Trailhead","w1819","Hybrid",0,"Thu","weekday","sled","Brush/Cement","2","2","1",4.1,0,20,1,25,20.5,0,0,0,-1,1,1,1,0
"3013",2018-12-21,"Brush Creek Trailhead","w1819","Non.motorized",7,"Fri","weekday","no_sled","Brush/Cement","2","2","1",4.1,0,19,-1,28,21.6,1,0,0,0,0,0,0,0
"3014",2018-12-21,"Brush Creek Trailhead","w1819","Mechanized",0,"Fri","weekday","no_sled","Brush/Cement","2","2","1",4.1,0,19,-1,28,21.6,1,0,0,0,0,0,0,0
"3015",2018-12-21,"Brush Creek Trailhead","w1819","Motorized",0,"Fri","weekday","sled","Brush/Cement","2","2","1",4.1,0,19,-1,28,21.6,1,0,0,0,0,0,0,0
"3016",2018-12-21,"Brush Creek Trailhead","w1819","Hybrid",0,"Fri","weekday","sled","Brush/Cement","2","2","1",4.1,0,19,-1,28,21.6,1,0,0,0,0,0,0,0
"3017",2018-12-22,"Brush Creek Trailhead","w1819","Non.motorized",11,"Sat","weekend","no_sled","Brush/Cement","2","2","1",4.2,0.1,19,0,20,22.1,-1,1,0,0,-1,0,0,0
"3018",2018-12-22,"Brush Creek Trailhead","w1819","Mechanized",0,"Sat","weekend","no_sled","Brush/Cement","2","2","1",4.2,0.1,19,0,20,22.1,-1,1,0,0,-1,0,0,0
"3019",2018-12-22,"Brush Creek Trailhead","w1819","Motorized",0,"Sat","weekend","sled","Brush/Cement","2","2","1",4.2,0.1,19,0,20,22.1,-1,1,0,0,-1,0,0,0
"3020",2018-12-22,"Brush Creek Trailhead","w1819","Hybrid",0,"Sat","weekend","sled","Brush/Cement","2","2","1",4.2,0.1,19,0,20,22.1,-1,1,0,0,-1,0,0,0
"3021",2018-12-23,"Brush Creek Trailhead","w1819","Non.motorized",17,"Sun","weekend","no_sled","Brush/Cement","2","2","1",4.2,0,21,2,19,20,0,-1,1,0,2,1,2,2
"3022",2018-12-23,"Brush Creek Trailhead","w1819","Mechanized",0,"Sun","weekend","no_sled","Brush/Cement","2","2","1",4.2,0,21,2,19,20,0,-1,1,0,2,1,2,2
"3023",2018-12-23,"Brush Creek Trailhead","w1819","Motorized",0,"Sun","weekend","sled","Brush/Cement","2","2","1",4.2,0,21,2,19,20,0,-1,1,0,2,1,2,2
"3024",2018-12-23,"Brush Creek Trailhead","w1819","Hybrid",0,"Sun","weekend","sled","Brush/Cement","2","2","1",4.2,0,21,2,19,20,0,-1,1,0,2,1,2,2
"3025",2018-12-24,"Brush Creek Trailhead","w1819","Non.motorized",1,"Mon","weekday","no_sled","Brush/Cement","2","2","2",4.3,0.1,20,-1,21,21.5,2,0,-1,1,1,1,0,1
"3026",2018-12-24,"Brush Creek Trailhead","w1819","Mechanized",0,"Mon","weekday","no_sled","Brush/Cement","2","2","2",4.3,0.1,20,-1,21,21.5,2,0,-1,1,1,1,0,1
"3027",2018-12-24,"Brush Creek Trailhead","w1819","Motorized",0,"Mon","weekday","sled","Brush/Cement","2","2","2",4.3,0.1,20,-1,21,21.5,2,0,-1,1,1,1,0,1
"3028",2018-12-24,"Brush Creek Trailhead","w1819","Hybrid",0,"Mon","weekday","sled","Brush/Cement","2","2","2",4.3,0.1,20,-1,21,21.5,2,0,-1,1,1,1,0,1
"3029",2018-12-25,"Brush Creek Trailhead","w1819","Non.motorized",14,"Tue","weekday","no_sled","Brush/Cement","2","2","2",4.7,0.4,25,5,25,18.8,-1,2,0,-1,4,6,6,5
"3030",2018-12-25,"Brush Creek Trailhead","w1819","Mechanized",0,"Tue","weekday","no_sled","Brush/Cement","2","2","2",4.7,0.4,25,5,25,18.8,-1,2,0,-1,4,6,6,5
"3031",2018-12-25,"Brush Creek Trailhead","w1819","Motorized",0,"Tue","weekday","sled","Brush/Cement","2","2","2",4.7,0.4,25,5,25,18.8,-1,2,0,-1,4,6,6,5
"3032",2018-12-25,"Brush Creek Trailhead","w1819","Hybrid",0,"Tue","weekday","sled","Brush/Cement","2","2","2",4.7,0.4,25,5,25,18.8,-1,2,0,-1,4,6,6,5
"3033",2018-12-26,"Brush Creek Trailhead","w1819","Non.motorized",21,"Wed","weekday","no_sled","Brush/Cement","3","3","3",4.7,0,23,-2,24,20.4,5,-1,2,0,3,2,4,4
"3034",2018-12-26,"Brush Creek Trailhead","w1819","Mechanized",0,"Wed","weekday","no_sled","Brush/Cement","3","3","3",4.7,0,23,-2,24,20.4,5,-1,2,0,3,2,4,4
"3035",2018-12-26,"Brush Creek Trailhead","w1819","Motorized",0,"Wed","weekday","sled","Brush/Cement","3","3","3",4.7,0,23,-2,24,20.4,5,-1,2,0,3,2,4,4
"3036",2018-12-26,"Brush Creek Trailhead","w1819","Hybrid",0,"Wed","weekday","sled","Brush/Cement","3","3","3",4.7,0,23,-2,24,20.4,5,-1,2,0,3,2,4,4
"3037",2018-12-27,"Brush Creek Trailhead","w1819","Non.motorized",14,"Thu","weekday","no_sled","Brush/Cement","3","3","2",4.7,0,24,1,12,19.6,-2,5,-1,2,-1,4,3,5
"3038",2018-12-27,"Brush Creek Trailhead","w1819","Mechanized",0,"Thu","weekday","no_sled","Brush/Cement","3","3","2",4.7,0,24,1,12,19.6,-2,5,-1,2,-1,4,3,5
"3039",2018-12-27,"Brush Creek Trailhead","w1819","Motorized",0,"Thu","weekday","sled","Brush/Cement","3","3","2",4.7,0,24,1,12,19.6,-2,5,-1,2,-1,4,3,5
"3040",2018-12-27,"Brush Creek Trailhead","w1819","Hybrid",0,"Thu","weekday","sled","Brush/Cement","3","3","2",4.7,0,24,1,12,19.6,-2,5,-1,2,-1,4,3,5
"3041",2018-12-28,"Brush Creek Trailhead","w1819","Non.motorized",16,"Fri","weekday","no_sled","Brush/Cement","3","3","2",4.7,0,24,0,12,19.6,1,-2,5,-1,1,-1,4,3
"3042",2018-12-28,"Brush Creek Trailhead","w1819","Mechanized",0,"Fri","weekday","no_sled","Brush/Cement","3","3","2",4.7,0,24,0,12,19.6,1,-2,5,-1,1,-1,4,3
"3043",2018-12-28,"Brush Creek Trailhead","w1819","Motorized",0,"Fri","weekday","sled","Brush/Cement","3","3","2",4.7,0,24,0,12,19.6,1,-2,5,-1,1,-1,4,3
"3044",2018-12-28,"Brush Creek Trailhead","w1819","Hybrid",0,"Fri","weekday","sled","Brush/Cement","3","3","2",4.7,0,24,0,12,19.6,1,-2,5,-1,1,-1,4,3
"3045",2018-12-29,"Brush Creek Trailhead","w1819","Non.motorized",38,"Sat","weekend","no_sled","Brush/Cement","3","3","2",4.7,0,24,0,8,19.6,0,1,-2,5,0,1,-1,4
"3046",2018-12-29,"Brush Creek Trailhead","w1819","Mechanized",0,"Sat","weekend","no_sled","Brush/Cement","3","3","2",4.7,0,24,0,8,19.6,0,1,-2,5,0,1,-1,4
"3047",2018-12-29,"Brush Creek Trailhead","w1819","Motorized",0,"Sat","weekend","sled","Brush/Cement","3","3","2",4.7,0,24,0,8,19.6,0,1,-2,5,0,1,-1,4
"3048",2018-12-29,"Brush Creek Trailhead","w1819","Hybrid",0,"Sat","weekend","sled","Brush/Cement","3","3","2",4.7,0,24,0,8,19.6,0,1,-2,5,0,1,-1,4
"3049",2018-12-30,"Brush Creek Trailhead","w1819","Non.motorized",29,"Sun","weekend","no_sled","Brush/Cement","3","3","2",4.7,0,24,0,16,19.6,0,0,1,-2,0,0,1,-1
"3050",2018-12-30,"Brush Creek Trailhead","w1819","Mechanized",0,"Sun","weekend","no_sled","Brush/Cement","3","3","2",4.7,0,24,0,16,19.6,0,0,1,-2,0,0,1,-1
"3051",2018-12-30,"Brush Creek Trailhead","w1819","Motorized",0,"Sun","weekend","sled","Brush/Cement","3","3","2",4.7,0,24,0,16,19.6,0,0,1,-2,0,0,1,-1
"3052",2018-12-30,"Brush Creek Trailhead","w1819","Hybrid",0,"Sun","weekend","sled","Brush/Cement","3","3","2",4.7,0,24,0,16,19.6,0,0,1,-2,0,0,1,-1
"3053",2018-12-31,"Brush Creek Trailhead","w1819","Non.motorized",2,"Mon","weekday","no_sled","Brush/Cement","3","3","3",4.9,0.2,23,-1,14,21.3,0,0,0,1,-1,-1,-1,0
"3054",2018-12-31,"Brush Creek Trailhead","w1819","Mechanized",0,"Mon","weekday","no_sled","Brush/Cement","3","3","3",4.9,0.2,23,-1,14,21.3,0,0,0,1,-1,-1,-1,0
"3055",2018-12-31,"Brush Creek Trailhead","w1819","Motorized",0,"Mon","weekday","sled","Brush/Cement","3","3","3",4.9,0.2,23,-1,14,21.3,0,0,0,1,-1,-1,-1,0
"3056",2018-12-31,"Brush Creek Trailhead","w1819","Hybrid",0,"Mon","weekday","sled","Brush/Cement","3","3","3",4.9,0.2,23,-1,14,21.3,0,0,0,1,-1,-1,-1,0
"3057",2019-01-01,"Brush Creek Trailhead","w1819","Non.motorized",22,"Tue","weekday","no_sled","Brush/Cement","3","3","3",5.1,0.2,29,6,11,17.6,-1,0,0,0,5,5,5,5
"3058",2019-01-01,"Brush Creek Trailhead","w1819","Mechanized",0,"Tue","weekday","no_sled","Brush/Cement","3","3","3",5.1,0.2,29,6,11,17.6,-1,0,0,0,5,5,5,5
"3059",2019-01-01,"Brush Creek Trailhead","w1819","Motorized",0,"Tue","weekday","sled","Brush/Cement","3","3","3",5.1,0.2,29,6,11,17.6,-1,0,0,0,5,5,5,5
"3060",2019-01-01,"Brush Creek Trailhead","w1819","Hybrid",0,"Tue","weekday","sled","Brush/Cement","3","3","3",5.1,0.2,29,6,11,17.6,-1,0,0,0,5,5,5,5
"3061",2019-01-02,"Brush Creek Trailhead","w1819","Non.motorized",22,"Wed","weekday","no_sled","Brush/Cement","3","3","2",5.1,0,28,-1,10,18.2,6,-1,0,0,5,4,4,4
"3062",2019-01-02,"Brush Creek Trailhead","w1819","Mechanized",0,"Wed","weekday","no_sled","Brush/Cement","3","3","2",5.1,0,28,-1,10,18.2,6,-1,0,0,5,4,4,4
"3063",2019-01-02,"Brush Creek Trailhead","w1819","Motorized",0,"Wed","weekday","sled","Brush/Cement","3","3","2",5.1,0,28,-1,10,18.2,6,-1,0,0,5,4,4,4
"3064",2019-01-02,"Brush Creek Trailhead","w1819","Hybrid",0,"Wed","weekday","sled","Brush/Cement","3","3","2",5.1,0,28,-1,10,18.2,6,-1,0,0,5,4,4,4
"3065",2019-01-03,"Brush Creek Trailhead","w1819","Non.motorized",6,"Thu","weekday","no_sled","Brush/Cement","3","3","2",5.1,0,27,-1,22,18.9,-1,6,-1,0,-2,4,3,3
"3066",2019-01-03,"Brush Creek Trailhead","w1819","Mechanized",0,"Thu","weekday","no_sled","Brush/Cement","3","3","2",5.1,0,27,-1,22,18.9,-1,6,-1,0,-2,4,3,3
"3067",2019-01-03,"Brush Creek Trailhead","w1819","Motorized",0,"Thu","weekday","sled","Brush/Cement","3","3","2",5.1,0,27,-1,22,18.9,-1,6,-1,0,-2,4,3,3
"3068",2019-01-03,"Brush Creek Trailhead","w1819","Hybrid",0,"Thu","weekday","sled","Brush/Cement","3","3","2",5.1,0,27,-1,22,18.9,-1,6,-1,0,-2,4,3,3
"3069",2019-01-04,"Brush Creek Trailhead","w1819","Non.motorized",9,"Fri","weekday","no_sled","Brush/Cement","3","3","2",5.3,0.2,26,-1,29,20.4,-1,-1,6,-1,-2,-3,3,2
"3070",2019-01-04,"Brush Creek Trailhead","w1819","Mechanized",0,"Fri","weekday","no_sled","Brush/Cement","3","3","2",5.3,0.2,26,-1,29,20.4,-1,-1,6,-1,-2,-3,3,2
"3071",2019-01-04,"Brush Creek Trailhead","w1819","Motorized",0,"Fri","weekday","sled","Brush/Cement","3","3","2",5.3,0.2,26,-1,29,20.4,-1,-1,6,-1,-2,-3,3,2
"3072",2019-01-04,"Brush Creek Trailhead","w1819","Hybrid",0,"Fri","weekday","sled","Brush/Cement","3","3","2",5.3,0.2,26,-1,29,20.4,-1,-1,6,-1,-2,-3,3,2
"3073",2019-01-05,"Brush Creek Trailhead","w1819","Non.motorized",19,"Sat","weekend","no_sled","Brush/Cement","2","2","2",5.3,0,25,-1,30,21.2,-1,-1,-1,6,-2,-3,-4,2
"3074",2019-01-05,"Brush Creek Trailhead","w1819","Mechanized",0,"Sat","weekend","no_sled","Brush/Cement","2","2","2",5.3,0,25,-1,30,21.2,-1,-1,-1,6,-2,-3,-4,2
"3075",2019-01-05,"Brush Creek Trailhead","w1819","Motorized",0,"Sat","weekend","sled","Brush/Cement","2","2","2",5.3,0,25,-1,30,21.2,-1,-1,-1,6,-2,-3,-4,2
"3076",2019-01-05,"Brush Creek Trailhead","w1819","Hybrid",0,"Sat","weekend","sled","Brush/Cement","2","2","2",5.3,0,25,-1,30,21.2,-1,-1,-1,6,-2,-3,-4,2
"3077",2019-01-06,"Brush Creek Trailhead","w1819","Non.motorized",6,"Sun","weekend","no_sled","Brush/Cement","3","3","3",5.3,0,25,0,26,21.2,-1,-1,-1,-1,-1,-2,-3,-4
"3078",2019-01-06,"Brush Creek Trailhead","w1819","Mechanized",0,"Sun","weekend","no_sled","Brush/Cement","3","3","3",5.3,0,25,0,26,21.2,-1,-1,-1,-1,-1,-2,-3,-4
"3079",2019-01-06,"Brush Creek Trailhead","w1819","Motorized",0,"Sun","weekend","sled","Brush/Cement","3","3","3",5.3,0,25,0,26,21.2,-1,-1,-1,-1,-1,-2,-3,-4
"3080",2019-01-06,"Brush Creek Trailhead","w1819","Hybrid",0,"Sun","weekend","sled","Brush/Cement","3","3","3",5.3,0,25,0,26,21.2,-1,-1,-1,-1,-1,-2,-3,-4
"3081",2019-01-07,"Brush Creek Trailhead","w1819","Non.motorized",5,"Mon","weekday","no_sled","Brush/Cement","3","3","3",5.8,0.5,32,7,21,18.1,0,-1,-1,-1,7,6,5,4
"3082",2019-01-07,"Brush Creek Trailhead","w1819","Mechanized",0,"Mon","weekday","no_sled","Brush/Cement","3","3","3",5.8,0.5,32,7,21,18.1,0,-1,-1,-1,7,6,5,4
"3083",2019-01-07,"Brush Creek Trailhead","w1819","Motorized",0,"Mon","weekday","sled","Brush/Cement","3","3","3",5.8,0.5,32,7,21,18.1,0,-1,-1,-1,7,6,5,4
"3084",2019-01-07,"Brush Creek Trailhead","w1819","Hybrid",0,"Mon","weekday","sled","Brush/Cement","3","3","3",5.8,0.5,32,7,21,18.1,0,-1,-1,-1,7,6,5,4
"3085",2019-01-08,"Brush Creek Trailhead","w1819","Non.motorized",6,"Tue","weekday","no_sled","Brush/Cement","3","3","3",5.9,0.1,32,0,24,18.4,7,0,-1,-1,7,7,6,5
"3086",2019-01-08,"Brush Creek Trailhead","w1819","Mechanized",0,"Tue","weekday","no_sled","Brush/Cement","3","3","3",5.9,0.1,32,0,24,18.4,7,0,-1,-1,7,7,6,5
"3087",2019-01-08,"Brush Creek Trailhead","w1819","Motorized",0,"Tue","weekday","sled","Brush/Cement","3","3","3",5.9,0.1,32,0,24,18.4,7,0,-1,-1,7,7,6,5
"3088",2019-01-08,"Brush Creek Trailhead","w1819","Hybrid",0,"Tue","weekday","sled","Brush/Cement","3","3","3",5.9,0.1,32,0,24,18.4,7,0,-1,-1,7,7,6,5
"3089",2019-01-09,"Brush Creek Trailhead","w1819","Non.motorized",9,"Wed","weekday","no_sled","Brush/Cement","3","3","3",6,0.1,30,-2,29,20,0,7,0,-1,-2,5,5,4
"3090",2019-01-09,"Brush Creek Trailhead","w1819","Mechanized",0,"Wed","weekday","no_sled","Brush/Cement","3","3","3",6,0.1,30,-2,29,20,0,7,0,-1,-2,5,5,4
"3091",2019-01-09,"Brush Creek Trailhead","w1819","Motorized",0,"Wed","weekday","sled","Brush/Cement","3","3","3",6,0.1,30,-2,29,20,0,7,0,-1,-2,5,5,4
"3092",2019-01-09,"Brush Creek Trailhead","w1819","Hybrid",0,"Wed","weekday","sled","Brush/Cement","3","3","3",6,0.1,30,-2,29,20,0,7,0,-1,-2,5,5,4
"3093",2019-01-10,"Brush Creek Trailhead","w1819","Non.motorized",9,"Thu","weekday","no_sled","Brush/Cement","3","3","3",6,0,29,-1,29,20.7,-2,0,7,0,-3,-3,4,4
"3094",2019-01-10,"Brush Creek Trailhead","w1819","Mechanized",0,"Thu","weekday","no_sled","Brush/Cement","3","3","3",6,0,29,-1,29,20.7,-2,0,7,0,-3,-3,4,4
"3095",2019-01-10,"Brush Creek Trailhead","w1819","Motorized",0,"Thu","weekday","sled","Brush/Cement","3","3","3",6,0,29,-1,29,20.7,-2,0,7,0,-3,-3,4,4
"3096",2019-01-10,"Brush Creek Trailhead","w1819","Hybrid",0,"Thu","weekday","sled","Brush/Cement","3","3","3",6,0,29,-1,29,20.7,-2,0,7,0,-3,-3,4,4
"3097",2019-01-11,"Brush Creek Trailhead","w1819","Non.motorized",2,"Fri","weekday","no_sled","Brush/Cement","2","2","2",6.1,0.1,29,0,25,21,-1,-2,0,7,-1,-3,-3,4
"3098",2019-01-11,"Brush Creek Trailhead","w1819","Mechanized",0,"Fri","weekday","no_sled","Brush/Cement","2","2","2",6.1,0.1,29,0,25,21,-1,-2,0,7,-1,-3,-3,4
"3099",2019-01-11,"Brush Creek Trailhead","w1819","Motorized",0,"Fri","weekday","sled","Brush/Cement","2","2","2",6.1,0.1,29,0,25,21,-1,-2,0,7,-1,-3,-3,4
"3100",2019-01-11,"Brush Creek Trailhead","w1819","Hybrid",0,"Fri","weekday","sled","Brush/Cement","2","2","2",6.1,0.1,29,0,25,21,-1,-2,0,7,-1,-3,-3,4
"3101",2019-01-12,"Brush Creek Trailhead","w1819","Non.motorized",8,"Sat","weekend","no_sled","Brush/Cement","3","3","2",6.1,0,28,-1,21,21.8,0,-1,-2,0,-1,-2,-4,-4
"3102",2019-01-12,"Brush Creek Trailhead","w1819","Mechanized",0,"Sat","weekend","no_sled","Brush/Cement","3","3","2",6.1,0,28,-1,21,21.8,0,-1,-2,0,-1,-2,-4,-4
"3103",2019-01-12,"Brush Creek Trailhead","w1819","Motorized",0,"Sat","weekend","sled","Brush/Cement","3","3","2",6.1,0,28,-1,21,21.8,0,-1,-2,0,-1,-2,-4,-4
"3104",2019-01-12,"Brush Creek Trailhead","w1819","Hybrid",0,"Sat","weekend","sled","Brush/Cement","3","3","2",6.1,0,28,-1,21,21.8,0,-1,-2,0,-1,-2,-4,-4
"3105",2019-01-13,"Brush Creek Trailhead","w1819","Non.motorized",10,"Sun","weekend","no_sled","Brush/Cement","2","2","2",6.2,0.1,30,2,18,20.7,-1,0,-1,-2,1,1,0,-2
"3106",2019-01-13,"Brush Creek Trailhead","w1819","Mechanized",0,"Sun","weekend","no_sled","Brush/Cement","2","2","2",6.2,0.1,30,2,18,20.7,-1,0,-1,-2,1,1,0,-2
"3107",2019-01-13,"Brush Creek Trailhead","w1819","Motorized",0,"Sun","weekend","sled","Brush/Cement","2","2","2",6.2,0.1,30,2,18,20.7,-1,0,-1,-2,1,1,0,-2
"3108",2019-01-13,"Brush Creek Trailhead","w1819","Hybrid",0,"Sun","weekend","sled","Brush/Cement","2","2","2",6.2,0.1,30,2,18,20.7,-1,0,-1,-2,1,1,0,-2
"3109",2019-01-14,"Brush Creek Trailhead","w1819","Non.motorized",5,"Mon","weekday","no_sled","Brush/Cement","2","2","2",6.2,0,30,0,18,20.7,2,-1,0,-1,2,1,1,0
"3110",2019-01-14,"Brush Creek Trailhead","w1819","Mechanized",0,"Mon","weekday","no_sled","Brush/Cement","2","2","2",6.2,0,30,0,18,20.7,2,-1,0,-1,2,1,1,0
"3111",2019-01-14,"Brush Creek Trailhead","w1819","Motorized",0,"Mon","weekday","sled","Brush/Cement","2","2","2",6.2,0,30,0,18,20.7,2,-1,0,-1,2,1,1,0
"3112",2019-01-14,"Brush Creek Trailhead","w1819","Hybrid",0,"Mon","weekday","sled","Brush/Cement","2","2","2",6.2,0,30,0,18,20.7,2,-1,0,-1,2,1,1,0
"3113",2019-01-15,"Brush Creek Trailhead","w1819","Non.motorized",8,"Tue","weekday","no_sled","Brush/Cement","2","2","2",6.2,0,29,-1,24,21.4,0,2,-1,0,-1,1,0,0
"3114",2019-01-15,"Brush Creek Trailhead","w1819","Mechanized",0,"Tue","weekday","no_sled","Brush/Cement","2","2","2",6.2,0,29,-1,24,21.4,0,2,-1,0,-1,1,0,0
"3115",2019-01-15,"Brush Creek Trailhead","w1819","Motorized",0,"Tue","weekday","sled","Brush/Cement","2","2","2",6.2,0,29,-1,24,21.4,0,2,-1,0,-1,1,0,0
"3116",2019-01-15,"Brush Creek Trailhead","w1819","Hybrid",0,"Tue","weekday","sled","Brush/Cement","2","2","2",6.2,0,29,-1,24,21.4,0,2,-1,0,-1,1,0,0
"3117",2019-01-16,"Brush Creek Trailhead","w1819","Non.motorized",1,"Wed","weekday","no_sled","Brush/Cement","4","4","3",6.3,0.1,29,0,26,21.7,-1,0,2,-1,-1,-1,1,0
"3118",2019-01-16,"Brush Creek Trailhead","w1819","Mechanized",0,"Wed","weekday","no_sled","Brush/Cement","4","4","3",6.3,0.1,29,0,26,21.7,-1,0,2,-1,-1,-1,1,0
"3119",2019-01-16,"Brush Creek Trailhead","w1819","Motorized",0,"Wed","weekday","sled","Brush/Cement","4","4","3",6.3,0.1,29,0,26,21.7,-1,0,2,-1,-1,-1,1,0
"3120",2019-01-16,"Brush Creek Trailhead","w1819","Hybrid",0,"Wed","weekday","sled","Brush/Cement","4","4","3",6.3,0.1,29,0,26,21.7,-1,0,2,-1,-1,-1,1,0
"3121",2019-01-17,"Brush Creek Trailhead","w1819","Non.motorized",1,"Thu","weekday","no_sled","Brush/Cement","3","3","2",7,0.7,38,9,28,18.4,0,-1,0,2,9,8,8,10
"3122",2019-01-17,"Brush Creek Trailhead","w1819","Mechanized",0,"Thu","weekday","no_sled","Brush/Cement","3","3","2",7,0.7,38,9,28,18.4,0,-1,0,2,9,8,8,10
"3123",2019-01-17,"Brush Creek Trailhead","w1819","Motorized",0,"Thu","weekday","sled","Brush/Cement","3","3","2",7,0.7,38,9,28,18.4,0,-1,0,2,9,8,8,10
"3124",2019-01-17,"Brush Creek Trailhead","w1819","Hybrid",0,"Thu","weekday","sled","Brush/Cement","3","3","2",7,0.7,38,9,28,18.4,0,-1,0,2,9,8,8,10
"3125",2019-01-18,"Brush Creek Trailhead","w1819","Non.motorized",0,"Fri","weekday","no_sled","Brush/Cement","4","4","4",7.5,0.5,41,3,22,18.3,9,0,-1,0,12,12,11,11
"3126",2019-01-18,"Brush Creek Trailhead","w1819","Mechanized",0,"Fri","weekday","no_sled","Brush/Cement","4","4","4",7.5,0.5,41,3,22,18.3,9,0,-1,0,12,12,11,11
"3127",2019-01-18,"Brush Creek Trailhead","w1819","Motorized",0,"Fri","weekday","sled","Brush/Cement","4","4","4",7.5,0.5,41,3,22,18.3,9,0,-1,0,12,12,11,11
"3128",2019-01-18,"Brush Creek Trailhead","w1819","Hybrid",0,"Fri","weekday","sled","Brush/Cement","4","4","4",7.5,0.5,41,3,22,18.3,9,0,-1,0,12,12,11,11
"3129",2019-01-19,"Brush Creek Trailhead","w1819","Non.motorized",0,"Sat","weekend","no_sled","Brush/Cement","3","3","3",7.8,0.3,43,2,20,18.1,3,9,0,-1,5,14,14,13
"3130",2019-01-19,"Brush Creek Trailhead","w1819","Mechanized",0,"Sat","weekend","no_sled","Brush/Cement","3","3","3",7.8,0.3,43,2,20,18.1,3,9,0,-1,5,14,14,13
"3131",2019-01-19,"Brush Creek Trailhead","w1819","Motorized",0,"Sat","weekend","sled","Brush/Cement","3","3","3",7.8,0.3,43,2,20,18.1,3,9,0,-1,5,14,14,13
"3132",2019-01-19,"Brush Creek Trailhead","w1819","Hybrid",0,"Sat","weekend","sled","Brush/Cement","3","3","3",7.8,0.3,43,2,20,18.1,3,9,0,-1,5,14,14,13
"3133",2019-01-20,"Brush Creek Trailhead","w1819","Non.motorized",0,"Sun","weekend","no_sled","Brush/Cement","3","3","3",7.9,0.1,41,-2,27,19.3,2,3,9,0,0,3,12,12
"3134",2019-01-20,"Brush Creek Trailhead","w1819","Mechanized",0,"Sun","weekend","no_sled","Brush/Cement","3","3","3",7.9,0.1,41,-2,27,19.3,2,3,9,0,0,3,12,12
"3135",2019-01-20,"Brush Creek Trailhead","w1819","Motorized",0,"Sun","weekend","sled","Brush/Cement","3","3","3",7.9,0.1,41,-2,27,19.3,2,3,9,0,0,3,12,12
"3136",2019-01-20,"Brush Creek Trailhead","w1819","Hybrid",0,"Sun","weekend","sled","Brush/Cement","3","3","3",7.9,0.1,41,-2,27,19.3,2,3,9,0,0,3,12,12
"3137",2019-01-21,"Brush Creek Trailhead","w1819","Non.motorized",NA,"Mon","weekday","no_sled","Brush/Cement","3","3","3",7.9,0,39,-2,23,20.3,-2,2,3,9,-4,-2,1,10
"3138",2019-01-21,"Brush Creek Trailhead","w1819","Mechanized",NA,"Mon","weekday","no_sled","Brush/Cement","3","3","3",7.9,0,39,-2,23,20.3,-2,2,3,9,-4,-2,1,10
"3139",2019-01-21,"Brush Creek Trailhead","w1819","Motorized",NA,"Mon","weekday","sled","Brush/Cement","3","3","3",7.9,0,39,-2,23,20.3,-2,2,3,9,-4,-2,1,10
"3140",2019-01-21,"Brush Creek Trailhead","w1819","Hybrid",NA,"Mon","weekday","sled","Brush/Cement","3","3","3",7.9,0,39,-2,23,20.3,-2,2,3,9,-4,-2,1,10
"3141",2019-01-22,"Brush Creek Trailhead","w1819","Non.motorized",9,"Tue","weekday","no_sled","Brush/Cement","3","3","3",8,0.1,41,2,12,19.5,-2,-2,2,3,0,-2,0,3
"3142",2019-01-22,"Brush Creek Trailhead","w1819","Mechanized",0,"Tue","weekday","no_sled","Brush/Cement","3","3","3",8,0.1,41,2,12,19.5,-2,-2,2,3,0,-2,0,3
"3143",2019-01-22,"Brush Creek Trailhead","w1819","Motorized",0,"Tue","weekday","sled","Brush/Cement","3","3","3",8,0.1,41,2,12,19.5,-2,-2,2,3,0,-2,0,3
"3144",2019-01-22,"Brush Creek Trailhead","w1819","Hybrid",0,"Tue","weekday","sled","Brush/Cement","3","3","3",8,0.1,41,2,12,19.5,-2,-2,2,3,0,-2,0,3
"3145",2019-01-23,"Brush Creek Trailhead","w1819","Non.motorized",3,"Wed","weekday","no_sled","Brush/Cement","3","3","2",8,0,40,-1,14,20,2,-2,-2,2,1,-1,-3,-1
"3146",2019-01-23,"Brush Creek Trailhead","w1819","Mechanized",0,"Wed","weekday","no_sled","Brush/Cement","3","3","2",8,0,40,-1,14,20,2,-2,-2,2,1,-1,-3,-1
"3147",2019-01-23,"Brush Creek Trailhead","w1819","Motorized",0,"Wed","weekday","sled","Brush/Cement","3","3","2",8,0,40,-1,14,20,2,-2,-2,2,1,-1,-3,-1
"3148",2019-01-23,"Brush Creek Trailhead","w1819","Hybrid",0,"Wed","weekday","sled","Brush/Cement","3","3","2",8,0,40,-1,14,20,2,-2,-2,2,1,-1,-3,-1
"3149",2019-01-24,"Brush Creek Trailhead","w1819","Non.motorized",5,"Thu","weekday","no_sled","Brush/Cement","3","3","2",8.2,0.2,40,0,17,20.5,-1,2,-2,-2,-1,1,-1,-3
"3150",2019-01-24,"Brush Creek Trailhead","w1819","Mechanized",0,"Thu","weekday","no_sled","Brush/Cement","3","3","2",8.2,0.2,40,0,17,20.5,-1,2,-2,-2,-1,1,-1,-3
"3151",2019-01-24,"Brush Creek Trailhead","w1819","Motorized",0,"Thu","weekday","sled","Brush/Cement","3","3","2",8.2,0.2,40,0,17,20.5,-1,2,-2,-2,-1,1,-1,-3
"3152",2019-01-24,"Brush Creek Trailhead","w1819","Hybrid",0,"Thu","weekday","sled","Brush/Cement","3","3","2",8.2,0.2,40,0,17,20.5,-1,2,-2,-2,-1,1,-1,-3
"3153",2019-01-25,"Brush Creek Trailhead","w1819","Non.motorized",7,"Fri","weekday","no_sled","Brush/Cement","3","3","2",8.3,0.1,40,0,15,20.8,0,-1,2,-2,0,-1,1,-1
"3154",2019-01-25,"Brush Creek Trailhead","w1819","Mechanized",2,"Fri","weekday","no_sled","Brush/Cement","3","3","2",8.3,0.1,40,0,15,20.8,0,-1,2,-2,0,-1,1,-1
"3155",2019-01-25,"Brush Creek Trailhead","w1819","Motorized",0,"Fri","weekday","sled","Brush/Cement","3","3","2",8.3,0.1,40,0,15,20.8,0,-1,2,-2,0,-1,1,-1
"3156",2019-01-25,"Brush Creek Trailhead","w1819","Hybrid",0,"Fri","weekday","sled","Brush/Cement","3","3","2",8.3,0.1,40,0,15,20.8,0,-1,2,-2,0,-1,1,-1
"3157",2019-01-26,"Brush Creek Trailhead","w1819","Non.motorized",25,"Sat","weekend","no_sled","Brush/Cement","3","3","2",8.3,0,39,-1,19,21.3,0,0,-1,2,-1,-1,-2,0
"3158",2019-01-26,"Brush Creek Trailhead","w1819","Mechanized",1,"Sat","weekend","no_sled","Brush/Cement","3","3","2",8.3,0,39,-1,19,21.3,0,0,-1,2,-1,-1,-2,0
"3159",2019-01-26,"Brush Creek Trailhead","w1819","Motorized",0,"Sat","weekend","sled","Brush/Cement","3","3","2",8.3,0,39,-1,19,21.3,0,0,-1,2,-1,-1,-2,0
"3160",2019-01-26,"Brush Creek Trailhead","w1819","Hybrid",0,"Sat","weekend","sled","Brush/Cement","3","3","2",8.3,0,39,-1,19,21.3,0,0,-1,2,-1,-1,-2,0
"3161",2019-01-27,"Brush Creek Trailhead","w1819","Non.motorized",15,"Sun","weekend","no_sled","Brush/Cement","3","3","2",8.3,0,38,-1,24,21.8,-1,0,0,-1,-2,-2,-2,-3
"3162",2019-01-27,"Brush Creek Trailhead","w1819","Mechanized",0,"Sun","weekend","no_sled","Brush/Cement","3","3","2",8.3,0,38,-1,24,21.8,-1,0,0,-1,-2,-2,-2,-3
"3163",2019-01-27,"Brush Creek Trailhead","w1819","Motorized",0,"Sun","weekend","sled","Brush/Cement","3","3","2",8.3,0,38,-1,24,21.8,-1,0,0,-1,-2,-2,-2,-3
"3164",2019-01-27,"Brush Creek Trailhead","w1819","Hybrid",0,"Sun","weekend","sled","Brush/Cement","3","3","2",8.3,0,38,-1,24,21.8,-1,0,0,-1,-2,-2,-2,-3
"3165",2019-01-28,"Brush Creek Trailhead","w1819","Non.motorized",5,"Mon","weekday","no_sled","Brush/Cement","2","2","2",8.3,0,38,0,17,21.8,-1,-1,0,0,-1,-2,-2,-2
"3166",2019-01-28,"Brush Creek Trailhead","w1819","Mechanized",0,"Mon","weekday","no_sled","Brush/Cement","2","2","2",8.3,0,38,0,17,21.8,-1,-1,0,0,-1,-2,-2,-2
"3167",2019-01-28,"Brush Creek Trailhead","w1819","Motorized",0,"Mon","weekday","sled","Brush/Cement","2","2","2",8.3,0,38,0,17,21.8,-1,-1,0,0,-1,-2,-2,-2
"3168",2019-01-28,"Brush Creek Trailhead","w1819","Hybrid",0,"Mon","weekday","sled","Brush/Cement","2","2","2",8.3,0,38,0,17,21.8,-1,-1,0,0,-1,-2,-2,-2
"3169",2019-01-29,"Brush Creek Trailhead","w1819","Non.motorized",0,"Tue","weekday","no_sled","Brush/Cement","2","2","2",8.3,0,38,0,16,21.8,0,-1,-1,0,0,-1,-2,-2
"3170",2019-01-29,"Brush Creek Trailhead","w1819","Mechanized",0,"Tue","weekday","no_sled","Brush/Cement","2","2","2",8.3,0,38,0,16,21.8,0,-1,-1,0,0,-1,-2,-2
"3171",2019-01-29,"Brush Creek Trailhead","w1819","Motorized",0,"Tue","weekday","sled","Brush/Cement","2","2","2",8.3,0,38,0,16,21.8,0,-1,-1,0,0,-1,-2,-2
"3172",2019-01-29,"Brush Creek Trailhead","w1819","Hybrid",0,"Tue","weekday","sled","Brush/Cement","2","2","2",8.3,0,38,0,16,21.8,0,-1,-1,0,0,-1,-2,-2
"3173",2019-01-30,"Brush Creek Trailhead","w1819","Non.motorized",0,"Wed","weekday","no_sled","Brush/Cement","2","2","1",8.3,0,37,-1,20,22.4,0,0,-1,-1,-1,-1,-2,-3
"3174",2019-01-30,"Brush Creek Trailhead","w1819","Mechanized",0,"Wed","weekday","no_sled","Brush/Cement","2","2","1",8.3,0,37,-1,20,22.4,0,0,-1,-1,-1,-1,-2,-3
"3175",2019-01-30,"Brush Creek Trailhead","w1819","Motorized",0,"Wed","weekday","sled","Brush/Cement","2","2","1",8.3,0,37,-1,20,22.4,0,0,-1,-1,-1,-1,-2,-3
"3176",2019-01-30,"Brush Creek Trailhead","w1819","Hybrid",0,"Wed","weekday","sled","Brush/Cement","2","2","1",8.3,0,37,-1,20,22.4,0,0,-1,-1,-1,-1,-2,-3
"3177",2019-01-31,"Brush Creek Trailhead","w1819","Non.motorized",0,"Thu","weekday","no_sled","Brush/Cement","2","2","1",8.3,0,36,-1,24,23.1,-1,0,0,-1,-2,-2,-2,-3
"3178",2019-01-31,"Brush Creek Trailhead","w1819","Mechanized",0,"Thu","weekday","no_sled","Brush/Cement","2","2","1",8.3,0,36,-1,24,23.1,-1,0,0,-1,-2,-2,-2,-3
"3179",2019-01-31,"Brush Creek Trailhead","w1819","Motorized",0,"Thu","weekday","sled","Brush/Cement","2","2","1",8.3,0,36,-1,24,23.1,-1,0,0,-1,-2,-2,-2,-3
"3180",2019-01-31,"Brush Creek Trailhead","w1819","Hybrid",0,"Thu","weekday","sled","Brush/Cement","2","2","1",8.3,0,36,-1,24,23.1,-1,0,0,-1,-2,-2,-2,-3
"3181",2019-02-01,"Brush Creek Trailhead","w1819","Non.motorized",5,"Fri","weekday","no_sled","Brush/Cement","2","2","1",8.3,0,36,0,25,23.1,-1,-1,0,0,-1,-2,-2,-2
"3182",2019-02-01,"Brush Creek Trailhead","w1819","Mechanized",0,"Fri","weekday","no_sled","Brush/Cement","2","2","1",8.3,0,36,0,25,23.1,-1,-1,0,0,-1,-2,-2,-2
"3183",2019-02-01,"Brush Creek Trailhead","w1819","Motorized",0,"Fri","weekday","sled","Brush/Cement","2","2","1",8.3,0,36,0,25,23.1,-1,-1,0,0,-1,-2,-2,-2
"3184",2019-02-01,"Brush Creek Trailhead","w1819","Hybrid",0,"Fri","weekday","sled","Brush/Cement","2","2","1",8.3,0,36,0,25,23.1,-1,-1,0,0,-1,-2,-2,-2
"3185",2019-02-02,"Brush Creek Trailhead","w1819","Non.motorized",27,"Sat","weekend","no_sled","Brush/Cement","2","2","1",8.3,0,36,0,26,23.1,0,-1,-1,0,0,-1,-2,-2
"3186",2019-02-02,"Brush Creek Trailhead","w1819","Mechanized",2,"Sat","weekend","no_sled","Brush/Cement","2","2","1",8.3,0,36,0,26,23.1,0,-1,-1,0,0,-1,-2,-2
"3187",2019-02-02,"Brush Creek Trailhead","w1819","Motorized",0,"Sat","weekend","sled","Brush/Cement","2","2","1",8.3,0,36,0,26,23.1,0,-1,-1,0,0,-1,-2,-2
"3188",2019-02-02,"Brush Creek Trailhead","w1819","Hybrid",0,"Sat","weekend","sled","Brush/Cement","2","2","1",8.3,0,36,0,26,23.1,0,-1,-1,0,0,-1,-2,-2
"3189",2019-02-03,"Brush Creek Trailhead","w1819","Non.motorized",8,"Sun","weekend","no_sled","Brush/Cement","3","3","2",8.4,0.1,36,0,28,23.3,0,0,-1,-1,0,0,-1,-2
"3190",2019-02-03,"Brush Creek Trailhead","w1819","Mechanized",0,"Sun","weekend","no_sled","Brush/Cement","3","3","2",8.4,0.1,36,0,28,23.3,0,0,-1,-1,0,0,-1,-2
"3191",2019-02-03,"Brush Creek Trailhead","w1819","Motorized",0,"Sun","weekend","sled","Brush/Cement","3","3","2",8.4,0.1,36,0,28,23.3,0,0,-1,-1,0,0,-1,-2
"3192",2019-02-03,"Brush Creek Trailhead","w1819","Hybrid",0,"Sun","weekend","sled","Brush/Cement","3","3","2",8.4,0.1,36,0,28,23.3,0,0,-1,-1,0,0,-1,-2
"3193",2019-02-04,"Brush Creek Trailhead","w1819","Non.motorized",4,"Mon","weekday","no_sled","Brush/Cement","3","3","2",8.8,0.4,39,3,28,22.6,0,0,0,-1,3,3,3,2
"3194",2019-02-04,"Brush Creek Trailhead","w1819","Mechanized",0,"Mon","weekday","no_sled","Brush/Cement","3","3","2",8.8,0.4,39,3,28,22.6,0,0,0,-1,3,3,3,2
"3195",2019-02-04,"Brush Creek Trailhead","w1819","Motorized",0,"Mon","weekday","sled","Brush/Cement","3","3","2",8.8,0.4,39,3,28,22.6,0,0,0,-1,3,3,3,2
"3196",2019-02-04,"Brush Creek Trailhead","w1819","Hybrid",0,"Mon","weekday","sled","Brush/Cement","3","3","2",8.8,0.4,39,3,28,22.6,0,0,0,-1,3,3,3,2
"3197",2019-02-05,"Brush Creek Trailhead","w1819","Non.motorized",6,"Tue","weekday","no_sled","Brush/Cement","3","2","2",9,0.2,40,1,26,22.5,3,0,0,0,4,4,4,4
"3198",2019-02-05,"Brush Creek Trailhead","w1819","Mechanized",1,"Tue","weekday","no_sled","Brush/Cement","3","2","2",9,0.2,40,1,26,22.5,3,0,0,0,4,4,4,4
"3199",2019-02-05,"Brush Creek Trailhead","w1819","Motorized",0,"Tue","weekday","sled","Brush/Cement","3","2","2",9,0.2,40,1,26,22.5,3,0,0,0,4,4,4,4
"3200",2019-02-05,"Brush Creek Trailhead","w1819","Hybrid",0,"Tue","weekday","sled","Brush/Cement","3","2","2",9,0.2,40,1,26,22.5,3,0,0,0,4,4,4,4
"3201",2019-02-06,"Brush Creek Trailhead","w1819","Non.motorized",2,"Wed","weekday","no_sled","Brush/Cement","4","4","3",9,0,40,0,16,22.5,1,3,0,0,1,4,4,4
"3202",2019-02-06,"Brush Creek Trailhead","w1819","Mechanized",0,"Wed","weekday","no_sled","Brush/Cement","4","4","3",9,0,40,0,16,22.5,1,3,0,0,1,4,4,4
"3203",2019-02-06,"Brush Creek Trailhead","w1819","Motorized",0,"Wed","weekday","sled","Brush/Cement","4","4","3",9,0,40,0,16,22.5,1,3,0,0,1,4,4,4
"3204",2019-02-06,"Brush Creek Trailhead","w1819","Hybrid",0,"Wed","weekday","sled","Brush/Cement","4","4","3",9,0,40,0,16,22.5,1,3,0,0,1,4,4,4
"3205",2019-02-07,"Brush Creek Trailhead","w1819","Non.motorized",0,"Thu","weekday","no_sled","Brush/Cement","3","3","2",9.2,0.2,43,3,4,21.4,0,1,3,0,3,4,7,7
"3206",2019-02-07,"Brush Creek Trailhead","w1819","Mechanized",0,"Thu","weekday","no_sled","Brush/Cement","3","3","2",9.2,0.2,43,3,4,21.4,0,1,3,0,3,4,7,7
"3207",2019-02-07,"Brush Creek Trailhead","w1819","Motorized",0,"Thu","weekday","sled","Brush/Cement","3","3","2",9.2,0.2,43,3,4,21.4,0,1,3,0,3,4,7,7
"3208",2019-02-07,"Brush Creek Trailhead","w1819","Hybrid",0,"Thu","weekday","sled","Brush/Cement","3","3","2",9.2,0.2,43,3,4,21.4,0,1,3,0,3,4,7,7
"3209",2019-02-08,"Brush Creek Trailhead","w1819","Non.motorized",2,"Fri","weekday","no_sled","Brush/Cement","3","2","2",9.2,0,42,-1,10,21.9,3,0,1,3,2,2,3,6
"3210",2019-02-08,"Brush Creek Trailhead","w1819","Mechanized",0,"Fri","weekday","no_sled","Brush/Cement","3","2","2",9.2,0,42,-1,10,21.9,3,0,1,3,2,2,3,6
"3211",2019-02-08,"Brush Creek Trailhead","w1819","Motorized",0,"Fri","weekday","sled","Brush/Cement","3","2","2",9.2,0,42,-1,10,21.9,3,0,1,3,2,2,3,6
"3212",2019-02-08,"Brush Creek Trailhead","w1819","Hybrid",0,"Fri","weekday","sled","Brush/Cement","3","2","2",9.2,0,42,-1,10,21.9,3,0,1,3,2,2,3,6
"3213",2019-02-09,"Brush Creek Trailhead","w1819","Non.motorized",7,"Sat","weekend","no_sled","Brush/Cement","3","2","2",9.2,0,41,-1,20,22.4,-1,3,0,1,-2,1,1,2
"3214",2019-02-09,"Brush Creek Trailhead","w1819","Mechanized",0,"Sat","weekend","no_sled","Brush/Cement","3","2","2",9.2,0,41,-1,20,22.4,-1,3,0,1,-2,1,1,2
"3215",2019-02-09,"Brush Creek Trailhead","w1819","Motorized",0,"Sat","weekend","sled","Brush/Cement","3","2","2",9.2,0,41,-1,20,22.4,-1,3,0,1,-2,1,1,2
"3216",2019-02-09,"Brush Creek Trailhead","w1819","Hybrid",0,"Sat","weekend","sled","Brush/Cement","3","2","2",9.2,0,41,-1,20,22.4,-1,3,0,1,-2,1,1,2
"3217",2019-02-10,"Brush Creek Trailhead","w1819","Non.motorized",21,"Sun","weekend","no_sled","Brush/Cement","2","2","2",9.3,0.1,40,-1,20,23.2,-1,-1,3,0,-2,-3,0,0
"3218",2019-02-10,"Brush Creek Trailhead","w1819","Mechanized",0,"Sun","weekend","no_sled","Brush/Cement","2","2","2",9.3,0.1,40,-1,20,23.2,-1,-1,3,0,-2,-3,0,0
"3219",2019-02-10,"Brush Creek Trailhead","w1819","Motorized",0,"Sun","weekend","sled","Brush/Cement","2","2","2",9.3,0.1,40,-1,20,23.2,-1,-1,3,0,-2,-3,0,0
"3220",2019-02-10,"Brush Creek Trailhead","w1819","Hybrid",0,"Sun","weekend","sled","Brush/Cement","2","2","2",9.3,0.1,40,-1,20,23.2,-1,-1,3,0,-2,-3,0,0
"3221",2019-02-11,"Brush Creek Trailhead","w1819","Non.motorized",7,"Mon","weekday","no_sled","Brush/Cement","2","2","1",9.3,0,40,0,15,23.2,-1,-1,-1,3,-1,-2,-3,0
"3222",2019-02-11,"Brush Creek Trailhead","w1819","Mechanized",0,"Mon","weekday","no_sled","Brush/Cement","2","2","1",9.3,0,40,0,15,23.2,-1,-1,-1,3,-1,-2,-3,0
"3223",2019-02-11,"Brush Creek Trailhead","w1819","Motorized",0,"Mon","weekday","sled","Brush/Cement","2","2","1",9.3,0,40,0,15,23.2,-1,-1,-1,3,-1,-2,-3,0
"3224",2019-02-11,"Brush Creek Trailhead","w1819","Hybrid",0,"Mon","weekday","sled","Brush/Cement","2","2","1",9.3,0,40,0,15,23.2,-1,-1,-1,3,-1,-2,-3,0
"3225",2019-02-12,"Brush Creek Trailhead","w1819","Non.motorized",7,"Tue","weekday","no_sled","Brush/Cement","2","2","1",9.3,0,40,0,18,23.2,0,-1,-1,-1,0,-1,-2,-3
"3226",2019-02-12,"Brush Creek Trailhead","w1819","Mechanized",0,"Tue","weekday","no_sled","Brush/Cement","2","2","1",9.3,0,40,0,18,23.2,0,-1,-1,-1,0,-1,-2,-3
"3227",2019-02-12,"Brush Creek Trailhead","w1819","Motorized",0,"Tue","weekday","sled","Brush/Cement","2","2","1",9.3,0,40,0,18,23.2,0,-1,-1,-1,0,-1,-2,-3
"3228",2019-02-12,"Brush Creek Trailhead","w1819","Hybrid",0,"Tue","weekday","sled","Brush/Cement","2","2","1",9.3,0,40,0,18,23.2,0,-1,-1,-1,0,-1,-2,-3
"3229",2019-02-13,"Brush Creek Trailhead","w1819","Non.motorized",NA,"Wed","weekday","no_sled","Brush/Cement","2","2","1",9.4,0.1,40,0,26,23.5,0,0,-1,-1,0,0,-1,-2
"3230",2019-02-13,"Brush Creek Trailhead","w1819","Mechanized",NA,"Wed","weekday","no_sled","Brush/Cement","2","2","1",9.4,0.1,40,0,26,23.5,0,0,-1,-1,0,0,-1,-2
"3231",2019-02-13,"Brush Creek Trailhead","w1819","Motorized",NA,"Wed","weekday","sled","Brush/Cement","2","2","1",9.4,0.1,40,0,26,23.5,0,0,-1,-1,0,0,-1,-2
"3232",2019-02-13,"Brush Creek Trailhead","w1819","Hybrid",NA,"Wed","weekday","sled","Brush/Cement","2","2","1",9.4,0.1,40,0,26,23.5,0,0,-1,-1,0,0,-1,-2
"3233",2019-02-14,"Brush Creek Trailhead","w1819","Non.motorized",5,"Thu","weekday","no_sled","Brush/Cement","3","2","2",9.7,0.3,41,1,29,23.7,0,0,0,-1,1,1,1,0
"3234",2019-02-14,"Brush Creek Trailhead","w1819","Mechanized",0,"Thu","weekday","no_sled","Brush/Cement","3","2","2",9.7,0.3,41,1,29,23.7,0,0,0,-1,1,1,1,0
"3235",2019-02-14,"Brush Creek Trailhead","w1819","Motorized",0,"Thu","weekday","sled","Brush/Cement","3","2","2",9.7,0.3,41,1,29,23.7,0,0,0,-1,1,1,1,0
"3236",2019-02-14,"Brush Creek Trailhead","w1819","Hybrid",0,"Thu","weekday","sled","Brush/Cement","3","2","2",9.7,0.3,41,1,29,23.7,0,0,0,-1,1,1,1,0
"3237",2019-02-15,"Brush Creek Trailhead","w1819","Non.motorized",2,"Fri","weekday","no_sled","Brush/Cement","4","4","3",10.8,1.1,51,10,27,21.2,1,0,0,0,11,11,11,11
"3238",2019-02-15,"Brush Creek Trailhead","w1819","Mechanized",0,"Fri","weekday","no_sled","Brush/Cement","4","4","3",10.8,1.1,51,10,27,21.2,1,0,0,0,11,11,11,11
"3239",2019-02-15,"Brush Creek Trailhead","w1819","Motorized",0,"Fri","weekday","sled","Brush/Cement","4","4","3",10.8,1.1,51,10,27,21.2,1,0,0,0,11,11,11,11
"3240",2019-02-15,"Brush Creek Trailhead","w1819","Hybrid",0,"Fri","weekday","sled","Brush/Cement","4","4","3",10.8,1.1,51,10,27,21.2,1,0,0,0,11,11,11,11
"3241",2019-02-16,"Brush Creek Trailhead","w1819","Non.motorized",0,"Sat","weekend","no_sled","Brush/Cement","3","3","3",11.1,0.3,52,1,14,21.3,10,1,0,0,11,12,12,12
"3242",2019-02-16,"Brush Creek Trailhead","w1819","Mechanized",0,"Sat","weekend","no_sled","Brush/Cement","3","3","3",11.1,0.3,52,1,14,21.3,10,1,0,0,11,12,12,12
"3243",2019-02-16,"Brush Creek Trailhead","w1819","Motorized",0,"Sat","weekend","sled","Brush/Cement","3","3","3",11.1,0.3,52,1,14,21.3,10,1,0,0,11,12,12,12
"3244",2019-02-16,"Brush Creek Trailhead","w1819","Hybrid",0,"Sat","weekend","sled","Brush/Cement","3","3","3",11.1,0.3,52,1,14,21.3,10,1,0,0,11,12,12,12
"3245",2019-02-17,"Brush Creek Trailhead","w1819","Non.motorized",5,"Sun","weekend","no_sled","Brush/Cement","3","3","3",11.3,0.2,55,3,10,20.5,1,10,1,0,4,14,15,15
"3246",2019-02-17,"Brush Creek Trailhead","w1819","Mechanized",0,"Sun","weekend","no_sled","Brush/Cement","3","3","3",11.3,0.2,55,3,10,20.5,1,10,1,0,4,14,15,15
"3247",2019-02-17,"Brush Creek Trailhead","w1819","Motorized",0,"Sun","weekend","sled","Brush/Cement","3","3","3",11.3,0.2,55,3,10,20.5,1,10,1,0,4,14,15,15
"3248",2019-02-17,"Brush Creek Trailhead","w1819","Hybrid",0,"Sun","weekend","sled","Brush/Cement","3","3","3",11.3,0.2,55,3,10,20.5,1,10,1,0,4,14,15,15
"3249",2019-02-18,"Brush Creek Trailhead","w1819","Non.motorized",6,"Mon","weekday","no_sled","Brush/Cement","3","3","2",11.4,0.1,53,-2,13,21.5,3,1,10,1,1,2,12,13
"3250",2019-02-18,"Brush Creek Trailhead","w1819","Mechanized",0,"Mon","weekday","no_sled","Brush/Cement","3","3","2",11.4,0.1,53,-2,13,21.5,3,1,10,1,1,2,12,13
"3251",2019-02-18,"Brush Creek Trailhead","w1819","Motorized",0,"Mon","weekday","sled","Brush/Cement","3","3","2",11.4,0.1,53,-2,13,21.5,3,1,10,1,1,2,12,13
"3252",2019-02-18,"Brush Creek Trailhead","w1819","Hybrid",0,"Mon","weekday","sled","Brush/Cement","3","3","2",11.4,0.1,53,-2,13,21.5,3,1,10,1,1,2,12,13
"3253",2019-02-19,"Brush Creek Trailhead","w1819","Non.motorized",0,"Tue","weekday","no_sled","Brush/Cement","3","3","2",11.5,0.1,53,0,11,21.7,-2,3,1,10,-2,1,2,12
"3254",2019-02-19,"Brush Creek Trailhead","w1819","Mechanized",0,"Tue","weekday","no_sled","Brush/Cement","3","3","2",11.5,0.1,53,0,11,21.7,-2,3,1,10,-2,1,2,12
"3255",2019-02-19,"Brush Creek Trailhead","w1819","Motorized",0,"Tue","weekday","sled","Brush/Cement","3","3","2",11.5,0.1,53,0,11,21.7,-2,3,1,10,-2,1,2,12
"3256",2019-02-19,"Brush Creek Trailhead","w1819","Hybrid",0,"Tue","weekday","sled","Brush/Cement","3","3","2",11.5,0.1,53,0,11,21.7,-2,3,1,10,-2,1,2,12
"3257",2019-02-20,"Brush Creek Trailhead","w1819","Non.motorized",0,"Wed","weekday","no_sled","Brush/Cement","3","3","2",11.6,0.1,53,0,7,21.9,0,-2,3,1,0,-2,1,2
"3258",2019-02-20,"Brush Creek Trailhead","w1819","Mechanized",0,"Wed","weekday","no_sled","Brush/Cement","3","3","2",11.6,0.1,53,0,7,21.9,0,-2,3,1,0,-2,1,2
"3259",2019-02-20,"Brush Creek Trailhead","w1819","Motorized",0,"Wed","weekday","sled","Brush/Cement","3","3","2",11.6,0.1,53,0,7,21.9,0,-2,3,1,0,-2,1,2
"3260",2019-02-20,"Brush Creek Trailhead","w1819","Hybrid",0,"Wed","weekday","sled","Brush/Cement","3","3","2",11.6,0.1,53,0,7,21.9,0,-2,3,1,0,-2,1,2
"3261",2019-02-21,"Brush Creek Trailhead","w1819","Non.motorized",0,"Thu","weekday","no_sled","Brush/Cement","3","3","3",11.6,0,52,-1,15,22.3,0,0,-2,3,-1,-1,-3,0
"3262",2019-02-21,"Brush Creek Trailhead","w1819","Mechanized",0,"Thu","weekday","no_sled","Brush/Cement","3","3","3",11.6,0,52,-1,15,22.3,0,0,-2,3,-1,-1,-3,0
"3263",2019-02-21,"Brush Creek Trailhead","w1819","Motorized",0,"Thu","weekday","sled","Brush/Cement","3","3","3",11.6,0,52,-1,15,22.3,0,0,-2,3,-1,-1,-3,0
"3264",2019-02-21,"Brush Creek Trailhead","w1819","Hybrid",0,"Thu","weekday","sled","Brush/Cement","3","3","3",11.6,0,52,-1,15,22.3,0,0,-2,3,-1,-1,-3,0
"3265",2019-02-22,"Brush Creek Trailhead","w1819","Non.motorized",0,"Fri","weekday","no_sled","Brush/Cement","3","3","3",11.8,0.2,52,0,20,22.7,-1,0,0,-2,-1,-1,-1,-3
"3266",2019-02-22,"Brush Creek Trailhead","w1819","Mechanized",0,"Fri","weekday","no_sled","Brush/Cement","3","3","3",11.8,0.2,52,0,20,22.7,-1,0,0,-2,-1,-1,-1,-3
"3267",2019-02-22,"Brush Creek Trailhead","w1819","Motorized",0,"Fri","weekday","sled","Brush/Cement","3","3","3",11.8,0.2,52,0,20,22.7,-1,0,0,-2,-1,-1,-1,-3
"3268",2019-02-22,"Brush Creek Trailhead","w1819","Hybrid",0,"Fri","weekday","sled","Brush/Cement","3","3","3",11.8,0.2,52,0,20,22.7,-1,0,0,-2,-1,-1,-1,-3
"3269",2019-02-23,"Brush Creek Trailhead","w1819","Non.motorized",8,"Sat","weekend","no_sled","Brush/Cement","3","3","3",12.1,0.3,53,1,13,22.8,0,-1,0,0,1,0,0,0
"3270",2019-02-23,"Brush Creek Trailhead","w1819","Mechanized",0,"Sat","weekend","no_sled","Brush/Cement","3","3","3",12.1,0.3,53,1,13,22.8,0,-1,0,0,1,0,0,0
"3271",2019-02-23,"Brush Creek Trailhead","w1819","Motorized",0,"Sat","weekend","sled","Brush/Cement","3","3","3",12.1,0.3,53,1,13,22.8,0,-1,0,0,1,0,0,0
"3272",2019-02-23,"Brush Creek Trailhead","w1819","Hybrid",0,"Sat","weekend","sled","Brush/Cement","3","3","3",12.1,0.3,53,1,13,22.8,0,-1,0,0,1,0,0,0
"3273",2019-02-24,"Brush Creek Trailhead","w1819","Non.motorized",13,"Sun","weekend","no_sled","Brush/Cement","3","3","2",12.1,0,52,-1,14,23.3,1,0,-1,0,0,0,-1,-1
"3274",2019-02-24,"Brush Creek Trailhead","w1819","Mechanized",0,"Sun","weekend","no_sled","Brush/Cement","3","3","2",12.1,0,52,-1,14,23.3,1,0,-1,0,0,0,-1,-1
"3275",2019-02-24,"Brush Creek Trailhead","w1819","Motorized",0,"Sun","weekend","sled","Brush/Cement","3","3","2",12.1,0,52,-1,14,23.3,1,0,-1,0,0,0,-1,-1
"3276",2019-02-24,"Brush Creek Trailhead","w1819","Hybrid",0,"Sun","weekend","sled","Brush/Cement","3","3","2",12.1,0,52,-1,14,23.3,1,0,-1,0,0,0,-1,-1
"3277",2019-02-25,"Brush Creek Trailhead","w1819","Non.motorized",10,"Mon","weekday","no_sled","Brush/Cement","3","3","2",12.1,0,51,-1,22,23.7,-1,1,0,-1,-2,-1,-1,-2
"3278",2019-02-25,"Brush Creek Trailhead","w1819","Mechanized",0,"Mon","weekday","no_sled","Brush/Cement","3","3","2",12.1,0,51,-1,22,23.7,-1,1,0,-1,-2,-1,-1,-2
"3279",2019-02-25,"Brush Creek Trailhead","w1819","Motorized",0,"Mon","weekday","sled","Brush/Cement","3","3","2",12.1,0,51,-1,22,23.7,-1,1,0,-1,-2,-1,-1,-2
"3280",2019-02-25,"Brush Creek Trailhead","w1819","Hybrid",0,"Mon","weekday","sled","Brush/Cement","3","3","2",12.1,0,51,-1,22,23.7,-1,1,0,-1,-2,-1,-1,-2
"3281",2019-02-26,"Brush Creek Trailhead","w1819","Non.motorized",8,"Tue","weekday","no_sled","Brush/Cement","2","2","2",12.1,0,50,-1,27,24.2,-1,-1,1,0,-2,-3,-2,-2
"3282",2019-02-26,"Brush Creek Trailhead","w1819","Mechanized",0,"Tue","weekday","no_sled","Brush/Cement","2","2","2",12.1,0,50,-1,27,24.2,-1,-1,1,0,-2,-3,-2,-2
"3283",2019-02-26,"Brush Creek Trailhead","w1819","Motorized",0,"Tue","weekday","sled","Brush/Cement","2","2","2",12.1,0,50,-1,27,24.2,-1,-1,1,0,-2,-3,-2,-2
"3284",2019-02-26,"Brush Creek Trailhead","w1819","Hybrid",0,"Tue","weekday","sled","Brush/Cement","2","2","2",12.1,0,50,-1,27,24.2,-1,-1,1,0,-2,-3,-2,-2
"3285",2019-02-27,"Brush Creek Trailhead","w1819","Non.motorized",1,"Wed","weekday","no_sled","Brush/Cement","2","2","2",12.1,0,50,0,30,24.2,-1,-1,-1,1,-1,-2,-3,-2
"3286",2019-02-27,"Brush Creek Trailhead","w1819","Mechanized",0,"Wed","weekday","no_sled","Brush/Cement","2","2","2",12.1,0,50,0,30,24.2,-1,-1,-1,1,-1,-2,-3,-2
"3287",2019-02-27,"Brush Creek Trailhead","w1819","Motorized",0,"Wed","weekday","sled","Brush/Cement","2","2","2",12.1,0,50,0,30,24.2,-1,-1,-1,1,-1,-2,-3,-2
"3288",2019-02-27,"Brush Creek Trailhead","w1819","Hybrid",0,"Wed","weekday","sled","Brush/Cement","2","2","2",12.1,0,50,0,30,24.2,-1,-1,-1,1,-1,-2,-3,-2
"3289",2019-02-28,"Brush Creek Trailhead","w1819","Non.motorized",6,"Thu","weekday","no_sled","Brush/Cement","2","2","2",12.2,0.1,49,-1,30,24.9,0,-1,-1,-1,-1,-2,-3,-4
"3290",2019-02-28,"Brush Creek Trailhead","w1819","Mechanized",0,"Thu","weekday","no_sled","Brush/Cement","2","2","2",12.2,0.1,49,-1,30,24.9,0,-1,-1,-1,-1,-2,-3,-4
"3291",2019-02-28,"Brush Creek Trailhead","w1819","Motorized",0,"Thu","weekday","sled","Brush/Cement","2","2","2",12.2,0.1,49,-1,30,24.9,0,-1,-1,-1,-1,-2,-3,-4
"3292",2019-02-28,"Brush Creek Trailhead","w1819","Hybrid",0,"Thu","weekday","sled","Brush/Cement","2","2","2",12.2,0.1,49,-1,30,24.9,0,-1,-1,-1,-1,-2,-3,-4
"3293",2019-03-01,"Brush Creek Trailhead","w1819","Non.motorized",0,"Fri","weekday","no_sled","Brush/Cement","2","2","1",12.3,0.1,49,0,29,25.1,-1,0,-1,-1,-1,-1,-2,-3
"3294",2019-03-01,"Brush Creek Trailhead","w1819","Mechanized",0,"Fri","weekday","no_sled","Brush/Cement","2","2","1",12.3,0.1,49,0,29,25.1,-1,0,-1,-1,-1,-1,-2,-3
"3295",2019-03-01,"Brush Creek Trailhead","w1819","Motorized",0,"Fri","weekday","sled","Brush/Cement","2","2","1",12.3,0.1,49,0,29,25.1,-1,0,-1,-1,-1,-1,-2,-3
"3296",2019-03-01,"Brush Creek Trailhead","w1819","Hybrid",0,"Fri","weekday","sled","Brush/Cement","2","2","1",12.3,0.1,49,0,29,25.1,-1,0,-1,-1,-1,-1,-2,-3
"3297",2019-03-02,"Brush Creek Trailhead","w1819","Non.motorized",0,"Sat","weekend","no_sled","Brush/Cement","3","3","2",13,0.7,58,9,30,22.4,0,-1,0,-1,9,8,8,7
"3298",2019-03-02,"Brush Creek Trailhead","w1819","Mechanized",0,"Sat","weekend","no_sled","Brush/Cement","3","3","2",13,0.7,58,9,30,22.4,0,-1,0,-1,9,8,8,7
"3299",2019-03-02,"Brush Creek Trailhead","w1819","Motorized",0,"Sat","weekend","sled","Brush/Cement","3","3","2",13,0.7,58,9,30,22.4,0,-1,0,-1,9,8,8,7
"3300",2019-03-02,"Brush Creek Trailhead","w1819","Hybrid",0,"Sat","weekend","sled","Brush/Cement","3","3","2",13,0.7,58,9,30,22.4,0,-1,0,-1,9,8,8,7
"3301",2019-03-03,"Brush Creek Trailhead","w1819","Non.motorized",0,"Sun","weekend","no_sled","Brush/Cement","3","3","3",13.7,0.7,64,6,27,21.4,9,0,-1,0,15,15,14,14
"3302",2019-03-03,"Brush Creek Trailhead","w1819","Mechanized",0,"Sun","weekend","no_sled","Brush/Cement","3","3","3",13.7,0.7,64,6,27,21.4,9,0,-1,0,15,15,14,14
"3303",2019-03-03,"Brush Creek Trailhead","w1819","Motorized",0,"Sun","weekend","sled","Brush/Cement","3","3","3",13.7,0.7,64,6,27,21.4,9,0,-1,0,15,15,14,14
"3304",2019-03-03,"Brush Creek Trailhead","w1819","Hybrid",0,"Sun","weekend","sled","Brush/Cement","3","3","3",13.7,0.7,64,6,27,21.4,9,0,-1,0,15,15,14,14
"3305",2019-03-04,"Brush Creek Trailhead","w1819","Non.motorized",10,"Mon","weekday","no_sled","Brush/Cement","3","3","3",14.4,0.7,66,2,23,21.8,6,9,0,-1,8,17,17,16
"3306",2019-03-04,"Brush Creek Trailhead","w1819","Mechanized",0,"Mon","weekday","no_sled","Brush/Cement","3","3","3",14.4,0.7,66,2,23,21.8,6,9,0,-1,8,17,17,16
"3307",2019-03-04,"Brush Creek Trailhead","w1819","Motorized",0,"Mon","weekday","sled","Brush/Cement","3","3","3",14.4,0.7,66,2,23,21.8,6,9,0,-1,8,17,17,16
"3308",2019-03-04,"Brush Creek Trailhead","w1819","Hybrid",0,"Mon","weekday","sled","Brush/Cement","3","3","3",14.4,0.7,66,2,23,21.8,6,9,0,-1,8,17,17,16
"3309",2019-03-05,"Brush Creek Trailhead","w1819","Non.motorized",5,"Tue","weekday","no_sled","Brush/Cement","3","3","3",14.4,0,64,-2,24,22.5,2,6,9,0,0,6,15,15
"3310",2019-03-05,"Brush Creek Trailhead","w1819","Mechanized",0,"Tue","weekday","no_sled","Brush/Cement","3","3","3",14.4,0,64,-2,24,22.5,2,6,9,0,0,6,15,15
"3311",2019-03-05,"Brush Creek Trailhead","w1819","Motorized",0,"Tue","weekday","sled","Brush/Cement","3","3","3",14.4,0,64,-2,24,22.5,2,6,9,0,0,6,15,15
"3312",2019-03-05,"Brush Creek Trailhead","w1819","Hybrid",0,"Tue","weekday","sled","Brush/Cement","3","3","3",14.4,0,64,-2,24,22.5,2,6,9,0,0,6,15,15
"3313",2019-03-06,"Brush Creek Trailhead","w1819","Non.motorized",1,"Wed","weekday","no_sled","Brush/Cement","3","3","2",14.5,0.1,62,-2,31,23.4,-2,2,6,9,-4,-2,4,13
"3314",2019-03-06,"Brush Creek Trailhead","w1819","Non.motorized",1,"Wed","weekday","no_sled","Brush/Cement","4","4","3",14.5,0.1,62,-2,31,23.4,-2,2,6,9,-4,-2,4,13
"3315",2019-03-06,"Brush Creek Trailhead","w1819","Mechanized",0,"Wed","weekday","no_sled","Brush/Cement","3","3","2",14.5,0.1,62,-2,31,23.4,-2,2,6,9,-4,-2,4,13
"3316",2019-03-06,"Brush Creek Trailhead","w1819","Mechanized",0,"Wed","weekday","no_sled","Brush/Cement","4","4","3",14.5,0.1,62,-2,31,23.4,-2,2,6,9,-4,-2,4,13
"3317",2019-03-06,"Brush Creek Trailhead","w1819","Motorized",0,"Wed","weekday","sled","Brush/Cement","3","3","2",14.5,0.1,62,-2,31,23.4,-2,2,6,9,-4,-2,4,13
"3318",2019-03-06,"Brush Creek Trailhead","w1819","Motorized",0,"Wed","weekday","sled","Brush/Cement","4","4","3",14.5,0.1,62,-2,31,23.4,-2,2,6,9,-4,-2,4,13
"3319",2019-03-06,"Brush Creek Trailhead","w1819","Hybrid",0,"Wed","weekday","sled","Brush/Cement","3","3","2",14.5,0.1,62,-2,31,23.4,-2,2,6,9,-4,-2,4,13
"3320",2019-03-06,"Brush Creek Trailhead","w1819","Hybrid",0,"Wed","weekday","sled","Brush/Cement","4","4","3",14.5,0.1,62,-2,31,23.4,-2,2,6,9,-4,-2,4,13
"3321",2019-03-07,"Brush Creek Trailhead","w1819","Non.motorized",1,"Thu","weekday","no_sled","Brush/Cement","4","4","3",16.2,1.7,71,9,30,22.8,-2,-2,2,6,7,5,7,13
"3322",2019-03-07,"Brush Creek Trailhead","w1819","Mechanized",0,"Thu","weekday","no_sled","Brush/Cement","4","4","3",16.2,1.7,71,9,30,22.8,-2,-2,2,6,7,5,7,13
"3323",2019-03-07,"Brush Creek Trailhead","w1819","Motorized",0,"Thu","weekday","sled","Brush/Cement","4","4","3",16.2,1.7,71,9,30,22.8,-2,-2,2,6,7,5,7,13
"3324",2019-03-07,"Brush Creek Trailhead","w1819","Hybrid",0,"Thu","weekday","sled","Brush/Cement","4","4","3",16.2,1.7,71,9,30,22.8,-2,-2,2,6,7,5,7,13
"3325",2019-03-08,"Brush Creek Trailhead","w1819","Non.motorized",1,"Fri","weekday","no_sled","Brush/Cement","3","3","3",16.6,0.4,71,0,27,23.4,9,-2,-2,2,9,7,5,7
"3326",2019-03-08,"Brush Creek Trailhead","w1819","Mechanized",0,"Fri","weekday","no_sled","Brush/Cement","3","3","3",16.6,0.4,71,0,27,23.4,9,-2,-2,2,9,7,5,7
"3327",2019-03-08,"Brush Creek Trailhead","w1819","Motorized",0,"Fri","weekday","sled","Brush/Cement","3","3","3",16.6,0.4,71,0,27,23.4,9,-2,-2,2,9,7,5,7
"3328",2019-03-08,"Brush Creek Trailhead","w1819","Hybrid",0,"Fri","weekday","sled","Brush/Cement","3","3","3",16.6,0.4,71,0,27,23.4,9,-2,-2,2,9,7,5,7
"3329",2019-03-09,"Brush Creek Trailhead","w1819","Non.motorized",0,"Sat","weekend","no_sled","Brush/Cement","4","4","3",17.2,0.6,76,5,22,22.6,0,9,-2,-2,5,14,12,10
"3330",2019-03-09,"Brush Creek Trailhead","w1819","Mechanized",0,"Sat","weekend","no_sled","Brush/Cement","4","4","3",17.2,0.6,76,5,22,22.6,0,9,-2,-2,5,14,12,10
"3331",2019-03-09,"Brush Creek Trailhead","w1819","Motorized",0,"Sat","weekend","sled","Brush/Cement","4","4","3",17.2,0.6,76,5,22,22.6,0,9,-2,-2,5,14,12,10
"3332",2019-03-09,"Brush Creek Trailhead","w1819","Hybrid",0,"Sat","weekend","sled","Brush/Cement","4","4","3",17.2,0.6,76,5,22,22.6,0,9,-2,-2,5,14,12,10
"3333",2019-03-10,"Brush Creek Trailhead","w1819","Non.motorized",10,"Sun","weekend","no_sled","Brush/Cement","3","3","3",17.3,0.1,73,-3,25,23.7,5,0,9,-2,2,2,11,9
"3334",2019-03-10,"Brush Creek Trailhead","w1819","Mechanized",0,"Sun","weekend","no_sled","Brush/Cement","3","3","3",17.3,0.1,73,-3,25,23.7,5,0,9,-2,2,2,11,9
"3335",2019-03-10,"Brush Creek Trailhead","w1819","Motorized",2,"Sun","weekend","sled","Brush/Cement","3","3","3",17.3,0.1,73,-3,25,23.7,5,0,9,-2,2,2,11,9
"3336",2019-03-10,"Brush Creek Trailhead","w1819","Hybrid",0,"Sun","weekend","sled","Brush/Cement","3","3","3",17.3,0.1,73,-3,25,23.7,5,0,9,-2,2,2,11,9
"3337",2019-03-11,"Brush Creek Trailhead","w1819","Non.motorized",1,"Mon","weekday","no_sled","Brush/Cement","3","3","2",17.3,0,71,-2,29,24.4,-3,5,0,9,-5,0,0,9
"3338",2019-03-11,"Brush Creek Trailhead","w1819","Mechanized",0,"Mon","weekday","no_sled","Brush/Cement","3","3","2",17.3,0,71,-2,29,24.4,-3,5,0,9,-5,0,0,9
"3339",2019-03-11,"Brush Creek Trailhead","w1819","Motorized",0,"Mon","weekday","sled","Brush/Cement","3","3","2",17.3,0,71,-2,29,24.4,-3,5,0,9,-5,0,0,9
"3340",2019-03-11,"Brush Creek Trailhead","w1819","Hybrid",0,"Mon","weekday","sled","Brush/Cement","3","3","2",17.3,0,71,-2,29,24.4,-3,5,0,9,-5,0,0,9
"3341",2019-03-12,"Brush Creek Trailhead","w1819","Non.motorized",0,"Tue","weekday","no_sled","Brush/Cement","3","3","3",17.4,0.1,70,-1,32,24.9,-2,-3,5,0,-3,-6,-1,-1
"3342",2019-03-12,"Brush Creek Trailhead","w1819","Non.motorized",0,"Tue","weekday","no_sled","Brush/Cement","4","4","4",17.4,0.1,70,-1,32,24.9,-2,-3,5,0,-3,-6,-1,-1
"3343",2019-03-12,"Brush Creek Trailhead","w1819","Mechanized",0,"Tue","weekday","no_sled","Brush/Cement","3","3","3",17.4,0.1,70,-1,32,24.9,-2,-3,5,0,-3,-6,-1,-1
"3344",2019-03-12,"Brush Creek Trailhead","w1819","Mechanized",0,"Tue","weekday","no_sled","Brush/Cement","4","4","4",17.4,0.1,70,-1,32,24.9,-2,-3,5,0,-3,-6,-1,-1
"3345",2019-03-12,"Brush Creek Trailhead","w1819","Motorized",0,"Tue","weekday","sled","Brush/Cement","3","3","3",17.4,0.1,70,-1,32,24.9,-2,-3,5,0,-3,-6,-1,-1
"3346",2019-03-12,"Brush Creek Trailhead","w1819","Motorized",0,"Tue","weekday","sled","Brush/Cement","4","4","4",17.4,0.1,70,-1,32,24.9,-2,-3,5,0,-3,-6,-1,-1
"3347",2019-03-12,"Brush Creek Trailhead","w1819","Hybrid",0,"Tue","weekday","sled","Brush/Cement","3","3","3",17.4,0.1,70,-1,32,24.9,-2,-3,5,0,-3,-6,-1,-1
"3348",2019-03-12,"Brush Creek Trailhead","w1819","Hybrid",0,"Tue","weekday","sled","Brush/Cement","4","4","4",17.4,0.1,70,-1,32,24.9,-2,-3,5,0,-3,-6,-1,-1
"3349",2019-03-13,"Brush Creek Trailhead","w1819","Non.motorized",1,"Wed","weekday","no_sled","Brush/Cement","4","4","3",18.1,0.7,74,4,24,24.5,-1,-2,-3,5,3,1,-2,3
"3350",2019-03-13,"Brush Creek Trailhead","w1819","Mechanized",0,"Wed","weekday","no_sled","Brush/Cement","4","4","3",18.1,0.7,74,4,24,24.5,-1,-2,-3,5,3,1,-2,3
"3351",2019-03-13,"Brush Creek Trailhead","w1819","Motorized",0,"Wed","weekday","sled","Brush/Cement","4","4","3",18.1,0.7,74,4,24,24.5,-1,-2,-3,5,3,1,-2,3
"3352",2019-03-13,"Brush Creek Trailhead","w1819","Hybrid",0,"Wed","weekday","sled","Brush/Cement","4","4","3",18.1,0.7,74,4,24,24.5,-1,-2,-3,5,3,1,-2,3
"3353",2019-03-14,"Brush Creek Trailhead","w1819","Non.motorized",0,"Thu","weekday","no_sled","Brush/Cement","4","4","3",18.1,0,74,0,17,24.5,4,-1,-2,-3,4,3,1,-2
"3354",2019-03-14,"Brush Creek Trailhead","w1819","Mechanized",0,"Thu","weekday","no_sled","Brush/Cement","4","4","3",18.1,0,74,0,17,24.5,4,-1,-2,-3,4,3,1,-2
"3355",2019-03-14,"Brush Creek Trailhead","w1819","Motorized",0,"Thu","weekday","sled","Brush/Cement","4","4","3",18.1,0,74,0,17,24.5,4,-1,-2,-3,4,3,1,-2
"3356",2019-03-14,"Brush Creek Trailhead","w1819","Hybrid",0,"Thu","weekday","sled","Brush/Cement","4","4","3",18.1,0,74,0,17,24.5,4,-1,-2,-3,4,3,1,-2
"3357",2019-03-15,"Brush Creek Trailhead","w1819","Non.motorized",3,"Fri","weekday","no_sled","Brush/Cement","3","3","2",18.1,0,72,-2,18,25.1,0,4,-1,-2,-2,2,1,-1
"3358",2019-03-15,"Brush Creek Trailhead","w1819","Mechanized",0,"Fri","weekday","no_sled","Brush/Cement","3","3","2",18.1,0,72,-2,18,25.1,0,4,-1,-2,-2,2,1,-1
"3359",2019-03-15,"Brush Creek Trailhead","w1819","Motorized",0,"Fri","weekday","sled","Brush/Cement","3","3","2",18.1,0,72,-2,18,25.1,0,4,-1,-2,-2,2,1,-1
"3360",2019-03-15,"Brush Creek Trailhead","w1819","Hybrid",0,"Fri","weekday","sled","Brush/Cement","3","3","2",18.1,0,72,-2,18,25.1,0,4,-1,-2,-2,2,1,-1
"3361",2019-03-16,"Brush Creek Trailhead","w1819","Non.motorized",8,"Sat","weekend","no_sled","Brush/Cement","3","3","2",18.2,0.1,70,-2,26,26,-2,0,4,-1,-4,-4,0,-1
"3362",2019-03-16,"Brush Creek Trailhead","w1819","Mechanized",0,"Sat","weekend","no_sled","Brush/Cement","3","3","2",18.2,0.1,70,-2,26,26,-2,0,4,-1,-4,-4,0,-1
"3363",2019-03-16,"Brush Creek Trailhead","w1819","Motorized",0,"Sat","weekend","sled","Brush/Cement","3","3","2",18.2,0.1,70,-2,26,26,-2,0,4,-1,-4,-4,0,-1
"3364",2019-03-16,"Brush Creek Trailhead","w1819","Hybrid",0,"Sat","weekend","sled","Brush/Cement","3","3","2",18.2,0.1,70,-2,26,26,-2,0,4,-1,-4,-4,0,-1
"3365",2019-03-17,"Brush Creek Trailhead","w1819","Non.motorized",13,"Sun","weekend","no_sled","Brush/Cement","3","3","2",18.2,0,69,-1,28,26.4,-2,-2,0,4,-3,-5,-5,-1
"3366",2019-03-17,"Brush Creek Trailhead","w1819","Mechanized",0,"Sun","weekend","no_sled","Brush/Cement","3","3","2",18.2,0,69,-1,28,26.4,-2,-2,0,4,-3,-5,-5,-1
"3367",2019-03-17,"Brush Creek Trailhead","w1819","Motorized",0,"Sun","weekend","sled","Brush/Cement","3","3","2",18.2,0,69,-1,28,26.4,-2,-2,0,4,-3,-5,-5,-1
"3368",2019-03-17,"Brush Creek Trailhead","w1819","Hybrid",0,"Sun","weekend","sled","Brush/Cement","3","3","2",18.2,0,69,-1,28,26.4,-2,-2,0,4,-3,-5,-5,-1
"3369",2019-03-18,"Brush Creek Trailhead","w1819","Non.motorized",4,"Mon","weekday","no_sled","Brush/Cement","2","2","2",18.3,0.1,68,-1,29,26.9,-1,-2,-2,0,-2,-4,-6,-6
"3370",2019-03-18,"Brush Creek Trailhead","w1819","Mechanized",0,"Mon","weekday","no_sled","Brush/Cement","2","2","2",18.3,0.1,68,-1,29,26.9,-1,-2,-2,0,-2,-4,-6,-6
"3371",2019-03-18,"Brush Creek Trailhead","w1819","Motorized",0,"Mon","weekday","sled","Brush/Cement","2","2","2",18.3,0.1,68,-1,29,26.9,-1,-2,-2,0,-2,-4,-6,-6
"3372",2019-03-18,"Brush Creek Trailhead","w1819","Hybrid",0,"Mon","weekday","sled","Brush/Cement","2","2","2",18.3,0.1,68,-1,29,26.9,-1,-2,-2,0,-2,-4,-6,-6
"3373",2019-03-19,"Brush Creek Trailhead","w1819","Non.motorized",5,"Tue","weekday","no_sled","Brush/Cement","2","2","2",18.3,0,67,-1,28,27.3,-1,-1,-2,-2,-2,-3,-5,-7
"3374",2019-03-19,"Brush Creek Trailhead","w1819","Mechanized",0,"Tue","weekday","no_sled","Brush/Cement","2","2","2",18.3,0,67,-1,28,27.3,-1,-1,-2,-2,-2,-3,-5,-7
"3375",2019-03-19,"Brush Creek Trailhead","w1819","Motorized",0,"Tue","weekday","sled","Brush/Cement","2","2","2",18.3,0,67,-1,28,27.3,-1,-1,-2,-2,-2,-3,-5,-7
"3376",2019-03-19,"Brush Creek Trailhead","w1819","Hybrid",0,"Tue","weekday","sled","Brush/Cement","2","2","2",18.3,0,67,-1,28,27.3,-1,-1,-2,-2,-2,-3,-5,-7
"3377",2019-03-20,"Brush Creek Trailhead","w1819","Non.motorized",0,"Wed","weekday","no_sled","Brush/Cement","2","2","2",18.3,0,66,-1,30,27.7,-1,-1,-1,-2,-2,-3,-4,-6
"3378",2019-03-20,"Brush Creek Trailhead","w1819","Mechanized",0,"Wed","weekday","no_sled","Brush/Cement","2","2","2",18.3,0,66,-1,30,27.7,-1,-1,-1,-2,-2,-3,-4,-6
"3379",2019-03-20,"Brush Creek Trailhead","w1819","Motorized",0,"Wed","weekday","sled","Brush/Cement","2","2","2",18.3,0,66,-1,30,27.7,-1,-1,-1,-2,-2,-3,-4,-6
"3380",2019-03-20,"Brush Creek Trailhead","w1819","Hybrid",0,"Wed","weekday","sled","Brush/Cement","2","2","2",18.3,0,66,-1,30,27.7,-1,-1,-1,-2,-2,-3,-4,-6
"3381",2019-03-21,"Brush Creek Trailhead","w1819","Non.motorized",1,"Thu","weekday","no_sled","Brush/Cement","2","2","2",18.4,0.1,65,-1,33,28.3,-1,-1,-1,-1,-2,-3,-4,-5
"3382",2019-03-21,"Brush Creek Trailhead","w1819","Mechanized",0,"Thu","weekday","no_sled","Brush/Cement","2","2","2",18.4,0.1,65,-1,33,28.3,-1,-1,-1,-1,-2,-3,-4,-5
"3383",2019-03-21,"Brush Creek Trailhead","w1819","Motorized",0,"Thu","weekday","sled","Brush/Cement","2","2","2",18.4,0.1,65,-1,33,28.3,-1,-1,-1,-1,-2,-3,-4,-5
"3384",2019-03-21,"Brush Creek Trailhead","w1819","Hybrid",0,"Thu","weekday","sled","Brush/Cement","2","2","2",18.4,0.1,65,-1,33,28.3,-1,-1,-1,-1,-2,-3,-4,-5
"3385",2019-03-22,"Brush Creek Trailhead","w1819","Non.motorized",5,"Fri","weekday","no_sled","Brush/Cement","3","3","2",18.4,0,64,-1,28,28.8,-1,-1,-1,-1,-2,-3,-4,-5
"3386",2019-03-22,"Brush Creek Trailhead","w1819","Mechanized",0,"Fri","weekday","no_sled","Brush/Cement","3","3","2",18.4,0,64,-1,28,28.8,-1,-1,-1,-1,-2,-3,-4,-5
"3387",2019-03-22,"Brush Creek Trailhead","w1819","Motorized",1,"Fri","weekday","sled","Brush/Cement","3","3","2",18.4,0,64,-1,28,28.8,-1,-1,-1,-1,-2,-3,-4,-5
"3388",2019-03-22,"Brush Creek Trailhead","w1819","Hybrid",0,"Fri","weekday","sled","Brush/Cement","3","3","2",18.4,0,64,-1,28,28.8,-1,-1,-1,-1,-2,-3,-4,-5
"3389",2019-03-23,"Brush Creek Trailhead","w1819","Non.motorized",6,"Sat","weekend","no_sled","Brush/Cement","2","2","1",18.4,0,65,1,28,28.3,-1,-1,-1,-1,0,-1,-2,-3
"3390",2019-03-23,"Brush Creek Trailhead","w1819","Mechanized",0,"Sat","weekend","no_sled","Brush/Cement","2","2","1",18.4,0,65,1,28,28.3,-1,-1,-1,-1,0,-1,-2,-3
"3391",2019-03-23,"Brush Creek Trailhead","w1819","Motorized",0,"Sat","weekend","sled","Brush/Cement","2","2","1",18.4,0,65,1,28,28.3,-1,-1,-1,-1,0,-1,-2,-3
"3392",2019-03-23,"Brush Creek Trailhead","w1819","Hybrid",0,"Sat","weekend","sled","Brush/Cement","2","2","1",18.4,0,65,1,28,28.3,-1,-1,-1,-1,0,-1,-2,-3
"3393",2019-03-24,"Brush Creek Trailhead","w1819","Non.motorized",8,"Sun","weekend","no_sled","Brush/Cement","2","2","1",18.4,0,64,-1,29,28.8,1,-1,-1,-1,0,-1,-2,-3
"3394",2019-03-24,"Brush Creek Trailhead","w1819","Mechanized",0,"Sun","weekend","no_sled","Brush/Cement","2","2","1",18.4,0,64,-1,29,28.8,1,-1,-1,-1,0,-1,-2,-3
"3395",2019-03-24,"Brush Creek Trailhead","w1819","Motorized",0,"Sun","weekend","sled","Brush/Cement","2","2","1",18.4,0,64,-1,29,28.8,1,-1,-1,-1,0,-1,-2,-3
"3396",2019-03-24,"Brush Creek Trailhead","w1819","Hybrid",0,"Sun","weekend","sled","Brush/Cement","2","2","1",18.4,0,64,-1,29,28.8,1,-1,-1,-1,0,-1,-2,-3
"3397",2019-03-25,"Brush Creek Trailhead","w1819","Non.motorized",3,"Mon","weekday","no_sled","Brush/Cement","2","2","2",18.6,0.2,64,0,31,29.1,-1,1,-1,-1,-1,0,-1,-2
"3398",2019-03-25,"Brush Creek Trailhead","w1819","Mechanized",0,"Mon","weekday","no_sled","Brush/Cement","2","2","2",18.6,0.2,64,0,31,29.1,-1,1,-1,-1,-1,0,-1,-2
"3399",2019-03-25,"Brush Creek Trailhead","w1819","Motorized",0,"Mon","weekday","sled","Brush/Cement","2","2","2",18.6,0.2,64,0,31,29.1,-1,1,-1,-1,-1,0,-1,-2
"3400",2019-03-25,"Brush Creek Trailhead","w1819","Hybrid",0,"Mon","weekday","sled","Brush/Cement","2","2","2",18.6,0.2,64,0,31,29.1,-1,1,-1,-1,-1,0,-1,-2
"3401",2019-03-26,"Brush Creek Trailhead","w1819","Non.motorized",0,"Tue","weekday","no_sled","Brush/Cement","2","2","2",18.9,0.3,63,-1,36,30,0,-1,1,-1,-1,-2,-1,-2
"3402",2019-03-26,"Brush Creek Trailhead","w1819","Mechanized",0,"Tue","weekday","no_sled","Brush/Cement","2","2","2",18.9,0.3,63,-1,36,30,0,-1,1,-1,-1,-2,-1,-2
"3403",2019-03-26,"Brush Creek Trailhead","w1819","Motorized",0,"Tue","weekday","sled","Brush/Cement","2","2","2",18.9,0.3,63,-1,36,30,0,-1,1,-1,-1,-2,-1,-2
"3404",2019-03-26,"Brush Creek Trailhead","w1819","Hybrid",0,"Tue","weekday","sled","Brush/Cement","2","2","2",18.9,0.3,63,-1,36,30,0,-1,1,-1,-1,-2,-1,-2
"3405",2019-03-27,"Brush Creek Trailhead","w1819","Non.motorized",7,"Wed","weekday","no_sled","Brush/Cement","1","2","2",18.9,0,62,-1,42,30.5,-1,0,-1,1,-2,-2,-3,-2
"3406",2019-03-27,"Brush Creek Trailhead","w1819","Mechanized",0,"Wed","weekday","no_sled","Brush/Cement","1","2","2",18.9,0,62,-1,42,30.5,-1,0,-1,1,-2,-2,-3,-2
"3407",2019-03-27,"Brush Creek Trailhead","w1819","Motorized",0,"Wed","weekday","sled","Brush/Cement","1","2","2",18.9,0,62,-1,42,30.5,-1,0,-1,1,-2,-2,-3,-2
"3408",2019-03-27,"Brush Creek Trailhead","w1819","Hybrid",0,"Wed","weekday","sled","Brush/Cement","1","2","2",18.9,0,62,-1,42,30.5,-1,0,-1,1,-2,-2,-3,-2
"3409",2019-03-28,"Brush Creek Trailhead","w1819","Non.motorized",2,"Thu","weekday","no_sled","Brush/Cement","1","2","2",18.9,0,60,-2,40,31.5,-1,-1,0,-1,-3,-4,-4,-5
"3410",2019-03-28,"Brush Creek Trailhead","w1819","Mechanized",0,"Thu","weekday","no_sled","Brush/Cement","1","2","2",18.9,0,60,-2,40,31.5,-1,-1,0,-1,-3,-4,-4,-5
"3411",2019-03-28,"Brush Creek Trailhead","w1819","Motorized",0,"Thu","weekday","sled","Brush/Cement","1","2","2",18.9,0,60,-2,40,31.5,-1,-1,0,-1,-3,-4,-4,-5
"3412",2019-03-28,"Brush Creek Trailhead","w1819","Hybrid",0,"Thu","weekday","sled","Brush/Cement","1","2","2",18.9,0,60,-2,40,31.5,-1,-1,0,-1,-3,-4,-4,-5
"3413",2019-03-29,"Brush Creek Trailhead","w1819","Non.motorized",4,"Fri","weekday","no_sled","Brush/Cement","1","1","1",19,0.1,58,-2,26,32.8,-2,-1,-1,0,-4,-5,-6,-6
"3414",2019-03-29,"Brush Creek Trailhead","w1819","Mechanized",0,"Fri","weekday","no_sled","Brush/Cement","1","1","1",19,0.1,58,-2,26,32.8,-2,-1,-1,0,-4,-5,-6,-6
"3415",2019-03-29,"Brush Creek Trailhead","w1819","Motorized",0,"Fri","weekday","sled","Brush/Cement","1","1","1",19,0.1,58,-2,26,32.8,-2,-1,-1,0,-4,-5,-6,-6
"3416",2019-03-29,"Brush Creek Trailhead","w1819","Hybrid",0,"Fri","weekday","sled","Brush/Cement","1","1","1",19,0.1,58,-2,26,32.8,-2,-1,-1,0,-4,-5,-6,-6
"3417",2019-03-30,"Brush Creek Trailhead","w1819","Non.motorized",12,"Sat","weekend","no_sled","Brush/Cement","1","1","1",19.1,0.1,61,3,24,31.3,-2,-2,-1,-1,1,-1,-2,-3
"3418",2019-03-30,"Brush Creek Trailhead","w1819","Mechanized",0,"Sat","weekend","no_sled","Brush/Cement","1","1","1",19.1,0.1,61,3,24,31.3,-2,-2,-1,-1,1,-1,-2,-3
"3419",2019-03-30,"Brush Creek Trailhead","w1819","Motorized",0,"Sat","weekend","sled","Brush/Cement","1","1","1",19.1,0.1,61,3,24,31.3,-2,-2,-1,-1,1,-1,-2,-3
"3420",2019-03-30,"Brush Creek Trailhead","w1819","Hybrid",0,"Sat","weekend","sled","Brush/Cement","1","1","1",19.1,0.1,61,3,24,31.3,-2,-2,-1,-1,1,-1,-2,-3
"3421",2019-03-31,"Brush Creek Trailhead","w1819","Non.motorized",4,"Sun","weekend","no_sled","Brush/Cement","1","1","1",19.1,0,59,-2,24,32.4,3,-2,-2,-1,1,-1,-3,-4
"3422",2019-03-31,"Brush Creek Trailhead","w1819","Mechanized",0,"Sun","weekend","no_sled","Brush/Cement","1","1","1",19.1,0,59,-2,24,32.4,3,-2,-2,-1,1,-1,-3,-4
"3423",2019-03-31,"Brush Creek Trailhead","w1819","Motorized",0,"Sun","weekend","sled","Brush/Cement","1","1","1",19.1,0,59,-2,24,32.4,3,-2,-2,-1,1,-1,-3,-4
"3424",2019-03-31,"Brush Creek Trailhead","w1819","Hybrid",0,"Sun","weekend","sled","Brush/Cement","1","1","1",19.1,0,59,-2,24,32.4,3,-2,-2,-1,1,-1,-3,-4
"3425",2019-04-01,"Brush Creek Trailhead","w1819","Non.motorized",6,"Mon","weekday","no_sled","Brush/Cement","2","1","1",19.1,0,58,-1,29,32.9,-2,3,-2,-2,-3,0,-2,-4
"3426",2019-04-01,"Brush Creek Trailhead","w1819","Mechanized",0,"Mon","weekday","no_sled","Brush/Cement","2","1","1",19.1,0,58,-1,29,32.9,-2,3,-2,-2,-3,0,-2,-4
"3427",2019-04-01,"Brush Creek Trailhead","w1819","Motorized",2,"Mon","weekday","sled","Brush/Cement","2","1","1",19.1,0,58,-1,29,32.9,-2,3,-2,-2,-3,0,-2,-4
"3428",2019-04-01,"Brush Creek Trailhead","w1819","Hybrid",2,"Mon","weekday","sled","Brush/Cement","2","1","1",19.1,0,58,-1,29,32.9,-2,3,-2,-2,-3,0,-2,-4
"3429",2019-04-02,"Brush Creek Trailhead","w1819","Non.motorized",4,"Tue","weekday","no_sled","Brush/Cement","1","1","1",19.1,0,58,0,33,32.9,-1,-2,3,-2,-1,-3,0,-2
"3430",2019-04-02,"Brush Creek Trailhead","w1819","Mechanized",0,"Tue","weekday","no_sled","Brush/Cement","1","1","1",19.1,0,58,0,33,32.9,-1,-2,3,-2,-1,-3,0,-2
"3431",2019-04-02,"Brush Creek Trailhead","w1819","Motorized",0,"Tue","weekday","sled","Brush/Cement","1","1","1",19.1,0,58,0,33,32.9,-1,-2,3,-2,-1,-3,0,-2
"3432",2019-04-02,"Brush Creek Trailhead","w1819","Hybrid",0,"Tue","weekday","sled","Brush/Cement","1","1","1",19.1,0,58,0,33,32.9,-1,-2,3,-2,-1,-3,0,-2
"3433",2019-04-03,"Brush Creek Trailhead","w1819","Non.motorized",5,"Wed","weekday","no_sled","Brush/Cement","2","1","1",19.2,0.1,58,0,31,33.1,0,-1,-2,3,0,-1,-3,0
"3434",2019-04-03,"Brush Creek Trailhead","w1819","Mechanized",0,"Wed","weekday","no_sled","Brush/Cement","2","1","1",19.2,0.1,58,0,31,33.1,0,-1,-2,3,0,-1,-3,0
"3435",2019-04-03,"Brush Creek Trailhead","w1819","Motorized",0,"Wed","weekday","sled","Brush/Cement","2","1","1",19.2,0.1,58,0,31,33.1,0,-1,-2,3,0,-1,-3,0
"3436",2019-04-03,"Brush Creek Trailhead","w1819","Hybrid",0,"Wed","weekday","sled","Brush/Cement","2","1","1",19.2,0.1,58,0,31,33.1,0,-1,-2,3,0,-1,-3,0
"3437",2019-04-04,"Brush Creek Trailhead","w1819","Non.motorized",5,"Thu","weekday","no_sled","Brush/Cement","2","1","1",19.4,0.2,59,1,35,32.9,0,0,-1,-2,1,1,0,-2
"3438",2019-04-04,"Brush Creek Trailhead","w1819","Mechanized",0,"Thu","weekday","no_sled","Brush/Cement","2","1","1",19.4,0.2,59,1,35,32.9,0,0,-1,-2,1,1,0,-2
"3439",2019-04-04,"Brush Creek Trailhead","w1819","Motorized",0,"Thu","weekday","sled","Brush/Cement","2","1","1",19.4,0.2,59,1,35,32.9,0,0,-1,-2,1,1,0,-2
"3440",2019-04-04,"Brush Creek Trailhead","w1819","Hybrid",0,"Thu","weekday","sled","Brush/Cement","2","1","1",19.4,0.2,59,1,35,32.9,0,0,-1,-2,1,1,0,-2
"3441",2019-04-05,"Brush Creek Trailhead","w1819","Non.motorized",6,"Fri","weekday","no_sled","Brush/Cement","1","1","1",19.4,0,57,-2,38,34,1,0,0,-1,-1,-1,-1,-2
"3442",2019-04-05,"Brush Creek Trailhead","w1819","Mechanized",0,"Fri","weekday","no_sled","Brush/Cement","1","1","1",19.4,0,57,-2,38,34,1,0,0,-1,-1,-1,-1,-2
"3443",2019-04-05,"Brush Creek Trailhead","w1819","Motorized",0,"Fri","weekday","sled","Brush/Cement","1","1","1",19.4,0,57,-2,38,34,1,0,0,-1,-1,-1,-1,-2
"3444",2019-04-05,"Brush Creek Trailhead","w1819","Hybrid",0,"Fri","weekday","sled","Brush/Cement","1","1","1",19.4,0,57,-2,38,34,1,0,0,-1,-1,-1,-1,-2
"3445",2019-04-06,"Brush Creek Trailhead","w1819","Non.motorized",6,"Sat","weekend","no_sled","Brush/Cement","1","1","1",19.3,-0.1,57,0,35,33.9,-2,1,0,0,-2,-1,-1,-1
"3446",2019-04-06,"Brush Creek Trailhead","w1819","Mechanized",0,"Sat","weekend","no_sled","Brush/Cement","1","1","1",19.3,-0.1,57,0,35,33.9,-2,1,0,0,-2,-1,-1,-1
"3447",2019-04-06,"Brush Creek Trailhead","w1819","Motorized",1,"Sat","weekend","sled","Brush/Cement","1","1","1",19.3,-0.1,57,0,35,33.9,-2,1,0,0,-2,-1,-1,-1
"3448",2019-04-06,"Brush Creek Trailhead","w1819","Hybrid",1,"Sat","weekend","sled","Brush/Cement","1","1","1",19.3,-0.1,57,0,35,33.9,-2,1,0,0,-2,-1,-1,-1
"3449",2019-04-07,"Brush Creek Trailhead","w1819","Non.motorized",14,"Sun","weekend","no_sled","Brush/Cement","1","1","1",19.1,-0.2,57,0,37,33.5,0,-2,1,0,0,-2,-1,-1
"3450",2019-04-07,"Brush Creek Trailhead","w1819","Mechanized",0,"Sun","weekend","no_sled","Brush/Cement","1","1","1",19.1,-0.2,57,0,37,33.5,0,-2,1,0,0,-2,-1,-1
"3451",2019-04-07,"Brush Creek Trailhead","w1819","Motorized",1,"Sun","weekend","sled","Brush/Cement","1","1","1",19.1,-0.2,57,0,37,33.5,0,-2,1,0,0,-2,-1,-1
"3452",2019-04-07,"Brush Creek Trailhead","w1819","Hybrid",1,"Sun","weekend","sled","Brush/Cement","1","1","1",19.1,-0.2,57,0,37,33.5,0,-2,1,0,0,-2,-1,-1
"3453",2019-04-08,"Brush Creek Trailhead","w1819","Non.motorized",7,"Mon","weekday","no_sled","Brush/Cement","1","2","2",19.3,0.2,54,-3,41,35.7,0,0,-2,1,-3,-3,-5,-4
"3454",2019-04-08,"Brush Creek Trailhead","w1819","Mechanized",0,"Mon","weekday","no_sled","Brush/Cement","1","2","2",19.3,0.2,54,-3,41,35.7,0,0,-2,1,-3,-3,-5,-4
"3455",2019-04-08,"Brush Creek Trailhead","w1819","Motorized",3,"Mon","weekday","sled","Brush/Cement","1","2","2",19.3,0.2,54,-3,41,35.7,0,0,-2,1,-3,-3,-5,-4
"3456",2019-04-08,"Brush Creek Trailhead","w1819","Hybrid",2,"Mon","weekday","sled","Brush/Cement","1","2","2",19.3,0.2,54,-3,41,35.7,0,0,-2,1,-3,-3,-5,-4
"3457",2019-04-09,"Brush Creek Trailhead","w1819","Non.motorized",2,"Tue","weekday","no_sled","Brush/Cement","1","2","2",19.3,0,53,-1,43,36.4,-3,0,0,-2,-4,-4,-4,-6
"3458",2019-04-09,"Brush Creek Trailhead","w1819","Mechanized",0,"Tue","weekday","no_sled","Brush/Cement","1","2","2",19.3,0,53,-1,43,36.4,-3,0,0,-2,-4,-4,-4,-6
"3459",2019-04-09,"Brush Creek Trailhead","w1819","Motorized",0,"Tue","weekday","sled","Brush/Cement","1","2","2",19.3,0,53,-1,43,36.4,-3,0,0,-2,-4,-4,-4,-6
"3460",2019-04-09,"Brush Creek Trailhead","w1819","Hybrid",0,"Tue","weekday","sled","Brush/Cement","1","2","2",19.3,0,53,-1,43,36.4,-3,0,0,-2,-4,-4,-4,-6
"3461",2019-04-10,"Brush Creek Trailhead","w1819","Non.motorized",0,"Wed","weekday","no_sled","Brush/Cement","2","2","1",19,-0.3,51,-2,30,37.3,-1,-3,0,0,-3,-6,-6,-6
"3462",2019-04-10,"Brush Creek Trailhead","w1819","Mechanized",0,"Wed","weekday","no_sled","Brush/Cement","2","2","1",19,-0.3,51,-2,30,37.3,-1,-3,0,0,-3,-6,-6,-6
"3463",2019-04-10,"Brush Creek Trailhead","w1819","Motorized",0,"Wed","weekday","sled","Brush/Cement","2","2","1",19,-0.3,51,-2,30,37.3,-1,-3,0,0,-3,-6,-6,-6
"3464",2019-04-10,"Brush Creek Trailhead","w1819","Hybrid",0,"Wed","weekday","sled","Brush/Cement","2","2","1",19,-0.3,51,-2,30,37.3,-1,-3,0,0,-3,-6,-6,-6
"3465",2019-04-11,"Brush Creek Trailhead","w1819","Non.motorized",1,"Thu","weekday","no_sled","Brush/Cement","3","3","2",18.9,-0.1,53,2,20,35.7,-2,-1,-3,0,0,-1,-4,-4
"3466",2019-04-11,"Brush Creek Trailhead","w1819","Mechanized",0,"Thu","weekday","no_sled","Brush/Cement","3","3","2",18.9,-0.1,53,2,20,35.7,-2,-1,-3,0,0,-1,-4,-4
"3467",2019-04-11,"Brush Creek Trailhead","w1819","Motorized",0,"Thu","weekday","sled","Brush/Cement","3","3","2",18.9,-0.1,53,2,20,35.7,-2,-1,-3,0,0,-1,-4,-4
"3468",2019-04-11,"Brush Creek Trailhead","w1819","Hybrid",0,"Thu","weekday","sled","Brush/Cement","3","3","2",18.9,-0.1,53,2,20,35.7,-2,-1,-3,0,0,-1,-4,-4
"3469",2019-04-12,"Brush Creek Trailhead","w1819","Non.motorized",6,"Fri","weekday","no_sled","Brush/Cement","2","2","1",18.7,-0.2,53,0,24,35.3,2,-2,-1,-3,2,0,-1,-4
"3470",2019-04-12,"Brush Creek Trailhead","w1819","Mechanized",0,"Fri","weekday","no_sled","Brush/Cement","2","2","1",18.7,-0.2,53,0,24,35.3,2,-2,-1,-3,2,0,-1,-4
"3471",2019-04-12,"Brush Creek Trailhead","w1819","Motorized",0,"Fri","weekday","sled","Brush/Cement","2","2","1",18.7,-0.2,53,0,24,35.3,2,-2,-1,-3,2,0,-1,-4
"3472",2019-04-12,"Brush Creek Trailhead","w1819","Hybrid",0,"Fri","weekday","sled","Brush/Cement","2","2","1",18.7,-0.2,53,0,24,35.3,2,-2,-1,-3,2,0,-1,-4
"3473",2019-04-13,"Brush Creek Trailhead","w1819","Non.motorized",9,"Sat","weekend","no_sled","Brush/Cement","1","1","1",18.8,0.1,52,-1,27,36.2,0,2,-2,-1,-1,1,-1,-2
"3474",2019-04-13,"Brush Creek Trailhead","w1819","Mechanized",0,"Sat","weekend","no_sled","Brush/Cement","1","1","1",18.8,0.1,52,-1,27,36.2,0,2,-2,-1,-1,1,-1,-2
"3475",2019-04-13,"Brush Creek Trailhead","w1819","Motorized",0,"Sat","weekend","sled","Brush/Cement","1","1","1",18.8,0.1,52,-1,27,36.2,0,2,-2,-1,-1,1,-1,-2
"3476",2019-04-13,"Brush Creek Trailhead","w1819","Hybrid",0,"Sat","weekend","sled","Brush/Cement","1","1","1",18.8,0.1,52,-1,27,36.2,0,2,-2,-1,-1,1,-1,-2
"3477",2019-04-14,"Brush Creek Trailhead","w1819","Non.motorized",3,"Sun","weekend","no_sled","Brush/Cement","1","1","1",18.7,-0.1,51,-1,35,36.7,-1,0,2,-2,-2,-2,0,-2
"3478",2019-04-14,"Brush Creek Trailhead","w1819","Mechanized",1,"Sun","weekend","no_sled","Brush/Cement","1","1","1",18.7,-0.1,51,-1,35,36.7,-1,0,2,-2,-2,-2,0,-2
"3479",2019-04-14,"Brush Creek Trailhead","w1819","Motorized",0,"Sun","weekend","sled","Brush/Cement","1","1","1",18.7,-0.1,51,-1,35,36.7,-1,0,2,-2,-2,-2,0,-2
"3480",2019-04-14,"Brush Creek Trailhead","w1819","Hybrid",0,"Sun","weekend","sled","Brush/Cement","1","1","1",18.7,-0.1,51,-1,35,36.7,-1,0,2,-2,-2,-2,0,-2
"3481",2019-04-15,"Brush Creek Trailhead","w1819","Non.motorized",6,"Mon","weekday","no_sled","Brush/Cement",NA,NA,NA,18.6,-0.1,50,-1,41,37.2,-1,-1,0,2,-2,-3,-3,-1
"3482",2019-04-15,"Brush Creek Trailhead","w1819","Mechanized",0,"Mon","weekday","no_sled","Brush/Cement",NA,NA,NA,18.6,-0.1,50,-1,41,37.2,-1,-1,0,2,-2,-3,-3,-1
"3483",2019-04-15,"Brush Creek Trailhead","w1819","Motorized",0,"Mon","weekday","sled","Brush/Cement",NA,NA,NA,18.6,-0.1,50,-1,41,37.2,-1,-1,0,2,-2,-3,-3,-1
"3484",2019-04-15,"Brush Creek Trailhead","w1819","Hybrid",0,"Mon","weekday","sled","Brush/Cement",NA,NA,NA,18.6,-0.1,50,-1,41,37.2,-1,-1,0,2,-2,-3,-3,-1
"3485",2018-12-01,"Cement Creek","w1819","Non.motorized",0,"Sat","weekend","no_sled","Brush/Cement","3","3","2",3.3,0.2,19,1,16,17.4,0,0,0,0,1,1,1,1
"3486",2018-12-01,"Cement Creek","w1819","Mechanized",0,"Sat","weekend","no_sled","Brush/Cement","3","3","2",3.3,0.2,19,1,16,17.4,0,0,0,0,1,1,1,1
"3487",2018-12-01,"Cement Creek","w1819","Motorized",0,"Sat","weekend","sled","Brush/Cement","3","3","2",3.3,0.2,19,1,16,17.4,0,0,0,0,1,1,1,1
"3488",2018-12-01,"Cement Creek","w1819","Hybrid",0,"Sat","weekend","sled","Brush/Cement","3","3","2",3.3,0.2,19,1,16,17.4,0,0,0,0,1,1,1,1
"3489",2018-12-02,"Cement Creek","w1819","Non.motorized",0,"Sun","weekend","no_sled","Brush/Cement","3","3","3",3.3,0,20,1,14,16.5,1,0,0,0,2,2,2,2
"3490",2018-12-02,"Cement Creek","w1819","Mechanized",0,"Sun","weekend","no_sled","Brush/Cement","3","3","3",3.3,0,20,1,14,16.5,1,0,0,0,2,2,2,2
"3491",2018-12-02,"Cement Creek","w1819","Motorized",0,"Sun","weekend","sled","Brush/Cement","3","3","3",3.3,0,20,1,14,16.5,1,0,0,0,2,2,2,2
"3492",2018-12-02,"Cement Creek","w1819","Hybrid",0,"Sun","weekend","sled","Brush/Cement","3","3","3",3.3,0,20,1,14,16.5,1,0,0,0,2,2,2,2
"3493",2018-12-03,"Cement Creek","w1819","Non.motorized",0,"Mon","weekday","no_sled","Brush/Cement","3","3","2",3.4,0.1,19,-1,13,17.9,1,1,0,0,0,1,1,1
"3494",2018-12-03,"Cement Creek","w1819","Mechanized",0,"Mon","weekday","no_sled","Brush/Cement","3","3","2",3.4,0.1,19,-1,13,17.9,1,1,0,0,0,1,1,1
"3495",2018-12-03,"Cement Creek","w1819","Motorized",0,"Mon","weekday","sled","Brush/Cement","3","3","2",3.4,0.1,19,-1,13,17.9,1,1,0,0,0,1,1,1
"3496",2018-12-03,"Cement Creek","w1819","Hybrid",0,"Mon","weekday","sled","Brush/Cement","3","3","2",3.4,0.1,19,-1,13,17.9,1,1,0,0,0,1,1,1
"3497",2018-12-04,"Cement Creek","w1819","Non.motorized",0,"Tue","weekday","no_sled","Brush/Cement","3","3","2",3.5,0.1,20,1,8,17.5,-1,1,1,0,0,1,2,2
"3498",2018-12-04,"Cement Creek","w1819","Mechanized",0,"Tue","weekday","no_sled","Brush/Cement","3","3","2",3.5,0.1,20,1,8,17.5,-1,1,1,0,0,1,2,2
"3499",2018-12-04,"Cement Creek","w1819","Motorized",0,"Tue","weekday","sled","Brush/Cement","3","3","2",3.5,0.1,20,1,8,17.5,-1,1,1,0,0,1,2,2
"3500",2018-12-04,"Cement Creek","w1819","Hybrid",0,"Tue","weekday","sled","Brush/Cement","3","3","2",3.5,0.1,20,1,8,17.5,-1,1,1,0,0,1,2,2
"3501",2018-12-05,"Cement Creek","w1819","Non.motorized",17,"Wed","weekday","no_sled","Brush/Cement","3","3","2",3.5,0,19,-1,21,18.4,1,-1,1,1,0,-1,0,1
"3502",2018-12-05,"Cement Creek","w1819","Mechanized",0,"Wed","weekday","no_sled","Brush/Cement","3","3","2",3.5,0,19,-1,21,18.4,1,-1,1,1,0,-1,0,1
"3503",2018-12-05,"Cement Creek","w1819","Motorized",1,"Wed","weekday","sled","Brush/Cement","3","3","2",3.5,0,19,-1,21,18.4,1,-1,1,1,0,-1,0,1
"3504",2018-12-05,"Cement Creek","w1819","Hybrid",0,"Wed","weekday","sled","Brush/Cement","3","3","2",3.5,0,19,-1,21,18.4,1,-1,1,1,0,-1,0,1
"3505",2018-12-06,"Cement Creek","w1819","Non.motorized",3,"Thu","weekday","no_sled","Brush/Cement","2","2","2",3.7,0.2,18,-1,25,20.6,-1,1,-1,1,-2,-1,-2,-1
"3506",2018-12-06,"Cement Creek","w1819","Mechanized",0,"Thu","weekday","no_sled","Brush/Cement","2","2","2",3.7,0.2,18,-1,25,20.6,-1,1,-1,1,-2,-1,-2,-1
"3507",2018-12-06,"Cement Creek","w1819","Motorized",4,"Thu","weekday","sled","Brush/Cement","2","2","2",3.7,0.2,18,-1,25,20.6,-1,1,-1,1,-2,-1,-2,-1
"3508",2018-12-06,"Cement Creek","w1819","Hybrid",0,"Thu","weekday","sled","Brush/Cement","2","2","2",3.7,0.2,18,-1,25,20.6,-1,1,-1,1,-2,-1,-2,-1
"3509",2018-12-07,"Cement Creek","w1819","Non.motorized",6,"Fri","weekday","no_sled","Brush/Cement","2","2","2",3.8,0.1,21,3,23,18.1,-1,-1,1,-1,2,1,2,1
"3510",2018-12-07,"Cement Creek","w1819","Mechanized",4,"Fri","weekday","no_sled","Brush/Cement","2","2","2",3.8,0.1,21,3,23,18.1,-1,-1,1,-1,2,1,2,1
"3511",2018-12-07,"Cement Creek","w1819","Motorized",5,"Fri","weekday","sled","Brush/Cement","2","2","2",3.8,0.1,21,3,23,18.1,-1,-1,1,-1,2,1,2,1
"3512",2018-12-07,"Cement Creek","w1819","Hybrid",0,"Fri","weekday","sled","Brush/Cement","2","2","2",3.8,0.1,21,3,23,18.1,-1,-1,1,-1,2,1,2,1
"3513",2018-12-08,"Cement Creek","w1819","Non.motorized",20,"Sat","weekend","no_sled","Brush/Cement","2","2","2",3.8,0,20,-1,23,19,3,-1,-1,1,2,1,0,1
"3514",2018-12-08,"Cement Creek","w1819","Mechanized",3,"Sat","weekend","no_sled","Brush/Cement","2","2","2",3.8,0,20,-1,23,19,3,-1,-1,1,2,1,0,1
"3515",2018-12-08,"Cement Creek","w1819","Motorized",15,"Sat","weekend","sled","Brush/Cement","2","2","2",3.8,0,20,-1,23,19,3,-1,-1,1,2,1,0,1
"3516",2018-12-08,"Cement Creek","w1819","Hybrid",0,"Sat","weekend","sled","Brush/Cement","2","2","2",3.8,0,20,-1,23,19,3,-1,-1,1,2,1,0,1
"3517",2018-12-09,"Cement Creek","w1819","Non.motorized",32,"Sun","weekend","no_sled","Brush/Cement","2","2","2",3.8,0,20,0,19,19,-1,3,-1,-1,-1,2,1,0
"3518",2018-12-09,"Cement Creek","w1819","Mechanized",3,"Sun","weekend","no_sled","Brush/Cement","2","2","2",3.8,0,20,0,19,19,-1,3,-1,-1,-1,2,1,0
"3519",2018-12-09,"Cement Creek","w1819","Motorized",10,"Sun","weekend","sled","Brush/Cement","2","2","2",3.8,0,20,0,19,19,-1,3,-1,-1,-1,2,1,0
"3520",2018-12-09,"Cement Creek","w1819","Hybrid",2,"Sun","weekend","sled","Brush/Cement","2","2","2",3.8,0,20,0,19,19,-1,3,-1,-1,-1,2,1,0
"3521",2018-12-10,"Cement Creek","w1819","Non.motorized",10,"Mon","weekday","no_sled","Brush/Cement","2","2","2",3.8,0,20,0,21,19,0,-1,3,-1,0,-1,2,1
"3522",2018-12-10,"Cement Creek","w1819","Mechanized",0,"Mon","weekday","no_sled","Brush/Cement","2","2","2",3.8,0,20,0,21,19,0,-1,3,-1,0,-1,2,1
"3523",2018-12-10,"Cement Creek","w1819","Motorized",7,"Mon","weekday","sled","Brush/Cement","2","2","2",3.8,0,20,0,21,19,0,-1,3,-1,0,-1,2,1
"3524",2018-12-10,"Cement Creek","w1819","Hybrid",0,"Mon","weekday","sled","Brush/Cement","2","2","2",3.8,0,20,0,21,19,0,-1,3,-1,0,-1,2,1
"3525",2018-12-11,"Cement Creek","w1819","Non.motorized",10,"Tue","weekday","no_sled","Brush/Cement","2","2","2",3.9,0.1,19,-1,27,20.5,0,0,-1,3,-1,-1,-2,1
"3526",2018-12-11,"Cement Creek","w1819","Mechanized",0,"Tue","weekday","no_sled","Brush/Cement","2","2","2",3.9,0.1,19,-1,27,20.5,0,0,-1,3,-1,-1,-2,1
"3527",2018-12-11,"Cement Creek","w1819","Motorized",2,"Tue","weekday","sled","Brush/Cement","2","2","2",3.9,0.1,19,-1,27,20.5,0,0,-1,3,-1,-1,-2,1
"3528",2018-12-11,"Cement Creek","w1819","Hybrid",0,"Tue","weekday","sled","Brush/Cement","2","2","2",3.9,0.1,19,-1,27,20.5,0,0,-1,3,-1,-1,-2,1
"3529",2018-12-12,"Cement Creek","w1819","Non.motorized",20,"Wed","weekday","no_sled","Brush/Cement","2","2","1",3.9,0,19,0,21,20.5,-1,0,0,-1,-1,-1,-1,-2
"3530",2018-12-12,"Cement Creek","w1819","Mechanized",1,"Wed","weekday","no_sled","Brush/Cement","2","2","1",3.9,0,19,0,21,20.5,-1,0,0,-1,-1,-1,-1,-2
"3531",2018-12-12,"Cement Creek","w1819","Motorized",2,"Wed","weekday","sled","Brush/Cement","2","2","1",3.9,0,19,0,21,20.5,-1,0,0,-1,-1,-1,-1,-2
"3532",2018-12-12,"Cement Creek","w1819","Hybrid",0,"Wed","weekday","sled","Brush/Cement","2","2","1",3.9,0,19,0,21,20.5,-1,0,0,-1,-1,-1,-1,-2
"3533",2018-12-13,"Cement Creek","w1819","Non.motorized",7,"Thu","weekday","no_sled","Brush/Cement","3","3","2",4,0.1,21,2,15,19,0,-1,0,0,2,1,1,1
"3534",2018-12-13,"Cement Creek","w1819","Mechanized",0,"Thu","weekday","no_sled","Brush/Cement","3","3","2",4,0.1,21,2,15,19,0,-1,0,0,2,1,1,1
"3535",2018-12-13,"Cement Creek","w1819","Motorized",5,"Thu","weekday","sled","Brush/Cement","3","3","2",4,0.1,21,2,15,19,0,-1,0,0,2,1,1,1
"3536",2018-12-13,"Cement Creek","w1819","Hybrid",0,"Thu","weekday","sled","Brush/Cement","3","3","2",4,0.1,21,2,15,19,0,-1,0,0,2,1,1,1
"3537",2018-12-14,"Cement Creek","w1819","Non.motorized",3,"Fri","weekday","no_sled","Brush/Cement","3","3","2",4,0,20,-1,24,20,2,0,-1,0,1,1,0,0
"3538",2018-12-14,"Cement Creek","w1819","Mechanized",0,"Fri","weekday","no_sled","Brush/Cement","3","3","2",4,0,20,-1,24,20,2,0,-1,0,1,1,0,0
"3539",2018-12-14,"Cement Creek","w1819","Motorized",3,"Fri","weekday","sled","Brush/Cement","3","3","2",4,0,20,-1,24,20,2,0,-1,0,1,1,0,0
"3540",2018-12-14,"Cement Creek","w1819","Hybrid",0,"Fri","weekday","sled","Brush/Cement","3","3","2",4,0,20,-1,24,20,2,0,-1,0,1,1,0,0
"3541",2018-12-15,"Cement Creek","w1819","Non.motorized",45,"Sat","weekend","no_sled","Brush/Cement","2","2","2",4,0,20,0,29,20,-1,2,0,-1,-1,1,1,0
"3542",2018-12-15,"Cement Creek","w1819","Mechanized",1,"Sat","weekend","no_sled","Brush/Cement","2","2","2",4,0,20,0,29,20,-1,2,0,-1,-1,1,1,0
"3543",2018-12-15,"Cement Creek","w1819","Motorized",6,"Sat","weekend","sled","Brush/Cement","2","2","2",4,0,20,0,29,20,-1,2,0,-1,-1,1,1,0
"3544",2018-12-15,"Cement Creek","w1819","Hybrid",0,"Sat","weekend","sled","Brush/Cement","2","2","2",4,0,20,0,29,20,-1,2,0,-1,-1,1,1,0
"3545",2018-12-16,"Cement Creek","w1819","Non.motorized",12,"Sun","weekend","no_sled","Brush/Cement","2","2","2",4.1,0.1,19,-1,28,21.6,0,-1,2,0,-1,-2,0,0
"3546",2018-12-16,"Cement Creek","w1819","Mechanized",1,"Sun","weekend","no_sled","Brush/Cement","2","2","2",4.1,0.1,19,-1,28,21.6,0,-1,2,0,-1,-2,0,0
"3547",2018-12-16,"Cement Creek","w1819","Motorized",9,"Sun","weekend","sled","Brush/Cement","2","2","2",4.1,0.1,19,-1,28,21.6,0,-1,2,0,-1,-2,0,0
"3548",2018-12-16,"Cement Creek","w1819","Hybrid",0,"Sun","weekend","sled","Brush/Cement","2","2","2",4.1,0.1,19,-1,28,21.6,0,-1,2,0,-1,-2,0,0
"3549",2018-12-17,"Cement Creek","w1819","Non.motorized",4,"Mon","weekday","no_sled","Brush/Cement","2","2","2",4.1,0,19,0,29,21.6,-1,0,-1,2,-1,-1,-2,0
"3550",2018-12-17,"Cement Creek","w1819","Mechanized",3,"Mon","weekday","no_sled","Brush/Cement","2","2","2",4.1,0,19,0,29,21.6,-1,0,-1,2,-1,-1,-2,0
"3551",2018-12-17,"Cement Creek","w1819","Motorized",9,"Mon","weekday","sled","Brush/Cement","2","2","2",4.1,0,19,0,29,21.6,-1,0,-1,2,-1,-1,-2,0
"3552",2018-12-17,"Cement Creek","w1819","Hybrid",0,"Mon","weekday","sled","Brush/Cement","2","2","2",4.1,0,19,0,29,21.6,-1,0,-1,2,-1,-1,-2,0
"3553",2018-12-18,"Cement Creek","w1819","Non.motorized",10,"Tue","weekday","no_sled","Brush/Cement","2","2","2",4.1,0,19,0,27,21.6,0,-1,0,-1,0,-1,-1,-2
"3554",2018-12-18,"Cement Creek","w1819","Mechanized",1,"Tue","weekday","no_sled","Brush/Cement","2","2","2",4.1,0,19,0,27,21.6,0,-1,0,-1,0,-1,-1,-2
"3555",2018-12-18,"Cement Creek","w1819","Motorized",5,"Tue","weekday","sled","Brush/Cement","2","2","2",4.1,0,19,0,27,21.6,0,-1,0,-1,0,-1,-1,-2
"3556",2018-12-18,"Cement Creek","w1819","Hybrid",0,"Tue","weekday","sled","Brush/Cement","2","2","2",4.1,0,19,0,27,21.6,0,-1,0,-1,0,-1,-1,-2
"3557",2018-12-19,"Cement Creek","w1819","Non.motorized",9,"Wed","weekday","no_sled","Brush/Cement","2","2","2",4.1,0,19,0,24,21.6,0,0,-1,0,0,0,-1,-1
"3558",2018-12-19,"Cement Creek","w1819","Mechanized",0,"Wed","weekday","no_sled","Brush/Cement","2","2","2",4.1,0,19,0,24,21.6,0,0,-1,0,0,0,-1,-1
"3559",2018-12-19,"Cement Creek","w1819","Motorized",1,"Wed","weekday","sled","Brush/Cement","2","2","2",4.1,0,19,0,24,21.6,0,0,-1,0,0,0,-1,-1
"3560",2018-12-19,"Cement Creek","w1819","Hybrid",0,"Wed","weekday","sled","Brush/Cement","2","2","2",4.1,0,19,0,24,21.6,0,0,-1,0,0,0,-1,-1
"3561",2018-12-20,"Cement Creek","w1819","Non.motorized",14,"Thu","weekday","no_sled","Brush/Cement","2","2","1",4.1,0,20,1,25,20.5,0,0,0,-1,1,1,1,0
"3562",2018-12-20,"Cement Creek","w1819","Mechanized",2,"Thu","weekday","no_sled","Brush/Cement","2","2","1",4.1,0,20,1,25,20.5,0,0,0,-1,1,1,1,0
"3563",2018-12-20,"Cement Creek","w1819","Motorized",10,"Thu","weekday","sled","Brush/Cement","2","2","1",4.1,0,20,1,25,20.5,0,0,0,-1,1,1,1,0
"3564",2018-12-20,"Cement Creek","w1819","Hybrid",0,"Thu","weekday","sled","Brush/Cement","2","2","1",4.1,0,20,1,25,20.5,0,0,0,-1,1,1,1,0
"3565",2018-12-21,"Cement Creek","w1819","Non.motorized",14,"Fri","weekday","no_sled","Brush/Cement","2","2","1",4.1,0,19,-1,28,21.6,1,0,0,0,0,0,0,0
"3566",2018-12-21,"Cement Creek","w1819","Mechanized",1,"Fri","weekday","no_sled","Brush/Cement","2","2","1",4.1,0,19,-1,28,21.6,1,0,0,0,0,0,0,0
"3567",2018-12-21,"Cement Creek","w1819","Motorized",8,"Fri","weekday","sled","Brush/Cement","2","2","1",4.1,0,19,-1,28,21.6,1,0,0,0,0,0,0,0
"3568",2018-12-21,"Cement Creek","w1819","Hybrid",0,"Fri","weekday","sled","Brush/Cement","2","2","1",4.1,0,19,-1,28,21.6,1,0,0,0,0,0,0,0
"3569",2018-12-22,"Cement Creek","w1819","Non.motorized",10,"Sat","weekend","no_sled","Brush/Cement","2","2","1",4.2,0.1,19,0,20,22.1,-1,1,0,0,-1,0,0,0
"3570",2018-12-22,"Cement Creek","w1819","Mechanized",1,"Sat","weekend","no_sled","Brush/Cement","2","2","1",4.2,0.1,19,0,20,22.1,-1,1,0,0,-1,0,0,0
"3571",2018-12-22,"Cement Creek","w1819","Motorized",7,"Sat","weekend","sled","Brush/Cement","2","2","1",4.2,0.1,19,0,20,22.1,-1,1,0,0,-1,0,0,0
"3572",2018-12-22,"Cement Creek","w1819","Hybrid",0,"Sat","weekend","sled","Brush/Cement","2","2","1",4.2,0.1,19,0,20,22.1,-1,1,0,0,-1,0,0,0
"3573",2018-12-23,"Cement Creek","w1819","Non.motorized",67,"Sun","weekend","no_sled","Brush/Cement","2","2","1",4.2,0,21,2,19,20,0,-1,1,0,2,1,2,2
"3574",2018-12-23,"Cement Creek","w1819","Mechanized",4,"Sun","weekend","no_sled","Brush/Cement","2","2","1",4.2,0,21,2,19,20,0,-1,1,0,2,1,2,2
"3575",2018-12-23,"Cement Creek","w1819","Motorized",6,"Sun","weekend","sled","Brush/Cement","2","2","1",4.2,0,21,2,19,20,0,-1,1,0,2,1,2,2
"3576",2018-12-23,"Cement Creek","w1819","Hybrid",0,"Sun","weekend","sled","Brush/Cement","2","2","1",4.2,0,21,2,19,20,0,-1,1,0,2,1,2,2
"3577",2018-12-24,"Cement Creek","w1819","Non.motorized",23,"Mon","weekday","no_sled","Brush/Cement","2","2","2",4.3,0.1,20,-1,21,21.5,2,0,-1,1,1,1,0,1
"3578",2018-12-24,"Cement Creek","w1819","Mechanized",0,"Mon","weekday","no_sled","Brush/Cement","2","2","2",4.3,0.1,20,-1,21,21.5,2,0,-1,1,1,1,0,1
"3579",2018-12-24,"Cement Creek","w1819","Motorized",5,"Mon","weekday","sled","Brush/Cement","2","2","2",4.3,0.1,20,-1,21,21.5,2,0,-1,1,1,1,0,1
"3580",2018-12-24,"Cement Creek","w1819","Hybrid",0,"Mon","weekday","sled","Brush/Cement","2","2","2",4.3,0.1,20,-1,21,21.5,2,0,-1,1,1,1,0,1
"3581",2018-12-25,"Cement Creek","w1819","Non.motorized",40,"Tue","weekday","no_sled","Brush/Cement","2","2","2",4.7,0.4,25,5,25,18.8,-1,2,0,-1,4,6,6,5
"3582",2018-12-25,"Cement Creek","w1819","Mechanized",0,"Tue","weekday","no_sled","Brush/Cement","2","2","2",4.7,0.4,25,5,25,18.8,-1,2,0,-1,4,6,6,5
"3583",2018-12-25,"Cement Creek","w1819","Motorized",13,"Tue","weekday","sled","Brush/Cement","2","2","2",4.7,0.4,25,5,25,18.8,-1,2,0,-1,4,6,6,5
"3584",2018-12-25,"Cement Creek","w1819","Hybrid",0,"Tue","weekday","sled","Brush/Cement","2","2","2",4.7,0.4,25,5,25,18.8,-1,2,0,-1,4,6,6,5
"3585",2018-12-26,"Cement Creek","w1819","Non.motorized",24,"Wed","weekday","no_sled","Brush/Cement","3","3","3",4.7,0,23,-2,24,20.4,5,-1,2,0,3,2,4,4
"3586",2018-12-26,"Cement Creek","w1819","Mechanized",2,"Wed","weekday","no_sled","Brush/Cement","3","3","3",4.7,0,23,-2,24,20.4,5,-1,2,0,3,2,4,4
"3587",2018-12-26,"Cement Creek","w1819","Motorized",8,"Wed","weekday","sled","Brush/Cement","3","3","3",4.7,0,23,-2,24,20.4,5,-1,2,0,3,2,4,4
"3588",2018-12-26,"Cement Creek","w1819","Hybrid",0,"Wed","weekday","sled","Brush/Cement","3","3","3",4.7,0,23,-2,24,20.4,5,-1,2,0,3,2,4,4
"3589",2018-12-27,"Cement Creek","w1819","Non.motorized",26,"Thu","weekday","no_sled","Brush/Cement","3","3","2",4.7,0,24,1,12,19.6,-2,5,-1,2,-1,4,3,5
"3590",2018-12-27,"Cement Creek","w1819","Mechanized",0,"Thu","weekday","no_sled","Brush/Cement","3","3","2",4.7,0,24,1,12,19.6,-2,5,-1,2,-1,4,3,5
"3591",2018-12-27,"Cement Creek","w1819","Motorized",8,"Thu","weekday","sled","Brush/Cement","3","3","2",4.7,0,24,1,12,19.6,-2,5,-1,2,-1,4,3,5
"3592",2018-12-27,"Cement Creek","w1819","Hybrid",0,"Thu","weekday","sled","Brush/Cement","3","3","2",4.7,0,24,1,12,19.6,-2,5,-1,2,-1,4,3,5
"3593",2018-12-28,"Cement Creek","w1819","Non.motorized",38,"Fri","weekday","no_sled","Brush/Cement","3","3","2",4.7,0,24,0,12,19.6,1,-2,5,-1,1,-1,4,3
"3594",2018-12-28,"Cement Creek","w1819","Mechanized",4,"Fri","weekday","no_sled","Brush/Cement","3","3","2",4.7,0,24,0,12,19.6,1,-2,5,-1,1,-1,4,3
"3595",2018-12-28,"Cement Creek","w1819","Motorized",13,"Fri","weekday","sled","Brush/Cement","3","3","2",4.7,0,24,0,12,19.6,1,-2,5,-1,1,-1,4,3
"3596",2018-12-28,"Cement Creek","w1819","Hybrid",3,"Fri","weekday","sled","Brush/Cement","3","3","2",4.7,0,24,0,12,19.6,1,-2,5,-1,1,-1,4,3
"3597",2018-12-29,"Cement Creek","w1819","Non.motorized",39,"Sat","weekend","no_sled","Brush/Cement","3","3","2",4.7,0,24,0,8,19.6,0,1,-2,5,0,1,-1,4
"3598",2018-12-29,"Cement Creek","w1819","Mechanized",3,"Sat","weekend","no_sled","Brush/Cement","3","3","2",4.7,0,24,0,8,19.6,0,1,-2,5,0,1,-1,4
"3599",2018-12-29,"Cement Creek","w1819","Motorized",9,"Sat","weekend","sled","Brush/Cement","3","3","2",4.7,0,24,0,8,19.6,0,1,-2,5,0,1,-1,4
"3600",2018-12-29,"Cement Creek","w1819","Hybrid",2,"Sat","weekend","sled","Brush/Cement","3","3","2",4.7,0,24,0,8,19.6,0,1,-2,5,0,1,-1,4
"3601",2018-12-30,"Cement Creek","w1819","Non.motorized",29,"Sun","weekend","no_sled","Brush/Cement","3","3","2",4.7,0,24,0,16,19.6,0,0,1,-2,0,0,1,-1
"3602",2018-12-30,"Cement Creek","w1819","Mechanized",2,"Sun","weekend","no_sled","Brush/Cement","3","3","2",4.7,0,24,0,16,19.6,0,0,1,-2,0,0,1,-1
"3603",2018-12-30,"Cement Creek","w1819","Motorized",9,"Sun","weekend","sled","Brush/Cement","3","3","2",4.7,0,24,0,16,19.6,0,0,1,-2,0,0,1,-1
"3604",2018-12-30,"Cement Creek","w1819","Hybrid",0,"Sun","weekend","sled","Brush/Cement","3","3","2",4.7,0,24,0,16,19.6,0,0,1,-2,0,0,1,-1
"3605",2018-12-31,"Cement Creek","w1819","Non.motorized",33,"Mon","weekday","no_sled","Brush/Cement","3","3","3",4.9,0.2,23,-1,14,21.3,0,0,0,1,-1,-1,-1,0
"3606",2018-12-31,"Cement Creek","w1819","Mechanized",0,"Mon","weekday","no_sled","Brush/Cement","3","3","3",4.9,0.2,23,-1,14,21.3,0,0,0,1,-1,-1,-1,0
"3607",2018-12-31,"Cement Creek","w1819","Motorized",11,"Mon","weekday","sled","Brush/Cement","3","3","3",4.9,0.2,23,-1,14,21.3,0,0,0,1,-1,-1,-1,0
"3608",2018-12-31,"Cement Creek","w1819","Hybrid",0,"Mon","weekday","sled","Brush/Cement","3","3","3",4.9,0.2,23,-1,14,21.3,0,0,0,1,-1,-1,-1,0
"3609",2019-01-01,"Cement Creek","w1819","Non.motorized",20,"Tue","weekday","no_sled","Brush/Cement","3","3","3",5.1,0.2,29,6,11,17.6,-1,0,0,0,5,5,5,5
"3610",2019-01-01,"Cement Creek","w1819","Mechanized",1,"Tue","weekday","no_sled","Brush/Cement","3","3","3",5.1,0.2,29,6,11,17.6,-1,0,0,0,5,5,5,5
"3611",2019-01-01,"Cement Creek","w1819","Motorized",2,"Tue","weekday","sled","Brush/Cement","3","3","3",5.1,0.2,29,6,11,17.6,-1,0,0,0,5,5,5,5
"3612",2019-01-01,"Cement Creek","w1819","Hybrid",0,"Tue","weekday","sled","Brush/Cement","3","3","3",5.1,0.2,29,6,11,17.6,-1,0,0,0,5,5,5,5
"3613",2019-01-02,"Cement Creek","w1819","Non.motorized",13,"Wed","weekday","no_sled","Brush/Cement","3","3","2",5.1,0,28,-1,10,18.2,6,-1,0,0,5,4,4,4
"3614",2019-01-02,"Cement Creek","w1819","Mechanized",0,"Wed","weekday","no_sled","Brush/Cement","3","3","2",5.1,0,28,-1,10,18.2,6,-1,0,0,5,4,4,4
"3615",2019-01-02,"Cement Creek","w1819","Motorized",3,"Wed","weekday","sled","Brush/Cement","3","3","2",5.1,0,28,-1,10,18.2,6,-1,0,0,5,4,4,4
"3616",2019-01-02,"Cement Creek","w1819","Hybrid",0,"Wed","weekday","sled","Brush/Cement","3","3","2",5.1,0,28,-1,10,18.2,6,-1,0,0,5,4,4,4
"3617",2019-01-03,"Cement Creek","w1819","Non.motorized",19,"Thu","weekday","no_sled","Brush/Cement","3","3","2",5.1,0,27,-1,22,18.9,-1,6,-1,0,-2,4,3,3
"3618",2019-01-03,"Cement Creek","w1819","Mechanized",1,"Thu","weekday","no_sled","Brush/Cement","3","3","2",5.1,0,27,-1,22,18.9,-1,6,-1,0,-2,4,3,3
"3619",2019-01-03,"Cement Creek","w1819","Motorized",2,"Thu","weekday","sled","Brush/Cement","3","3","2",5.1,0,27,-1,22,18.9,-1,6,-1,0,-2,4,3,3
"3620",2019-01-03,"Cement Creek","w1819","Hybrid",0,"Thu","weekday","sled","Brush/Cement","3","3","2",5.1,0,27,-1,22,18.9,-1,6,-1,0,-2,4,3,3
"3621",2019-01-04,"Cement Creek","w1819","Non.motorized",30,"Fri","weekday","no_sled","Brush/Cement","3","3","2",5.3,0.2,26,-1,29,20.4,-1,-1,6,-1,-2,-3,3,2
"3622",2019-01-04,"Cement Creek","w1819","Mechanized",5,"Fri","weekday","no_sled","Brush/Cement","3","3","2",5.3,0.2,26,-1,29,20.4,-1,-1,6,-1,-2,-3,3,2
"3623",2019-01-04,"Cement Creek","w1819","Motorized",8,"Fri","weekday","sled","Brush/Cement","3","3","2",5.3,0.2,26,-1,29,20.4,-1,-1,6,-1,-2,-3,3,2
"3624",2019-01-04,"Cement Creek","w1819","Hybrid",0,"Fri","weekday","sled","Brush/Cement","3","3","2",5.3,0.2,26,-1,29,20.4,-1,-1,6,-1,-2,-3,3,2
"3625",2019-01-05,"Cement Creek","w1819","Non.motorized",32,"Sat","weekend","no_sled","Brush/Cement","2","2","2",5.3,0,25,-1,30,21.2,-1,-1,-1,6,-2,-3,-4,2
"3626",2019-01-05,"Cement Creek","w1819","Mechanized",0,"Sat","weekend","no_sled","Brush/Cement","2","2","2",5.3,0,25,-1,30,21.2,-1,-1,-1,6,-2,-3,-4,2
"3627",2019-01-05,"Cement Creek","w1819","Motorized",6,"Sat","weekend","sled","Brush/Cement","2","2","2",5.3,0,25,-1,30,21.2,-1,-1,-1,6,-2,-3,-4,2
"3628",2019-01-05,"Cement Creek","w1819","Hybrid",0,"Sat","weekend","sled","Brush/Cement","2","2","2",5.3,0,25,-1,30,21.2,-1,-1,-1,6,-2,-3,-4,2
"3629",2019-01-06,"Cement Creek","w1819","Non.motorized",22,"Sun","weekend","no_sled","Brush/Cement","3","3","3",5.3,0,25,0,26,21.2,-1,-1,-1,-1,-1,-2,-3,-4
"3630",2019-01-06,"Cement Creek","w1819","Mechanized",0,"Sun","weekend","no_sled","Brush/Cement","3","3","3",5.3,0,25,0,26,21.2,-1,-1,-1,-1,-1,-2,-3,-4
"3631",2019-01-06,"Cement Creek","w1819","Motorized",2,"Sun","weekend","sled","Brush/Cement","3","3","3",5.3,0,25,0,26,21.2,-1,-1,-1,-1,-1,-2,-3,-4
"3632",2019-01-06,"Cement Creek","w1819","Hybrid",0,"Sun","weekend","sled","Brush/Cement","3","3","3",5.3,0,25,0,26,21.2,-1,-1,-1,-1,-1,-2,-3,-4
"3633",2019-01-07,"Cement Creek","w1819","Non.motorized",7,"Mon","weekday","no_sled","Brush/Cement","3","3","3",5.8,0.5,32,7,21,18.1,0,-1,-1,-1,7,6,5,4
"3634",2019-01-07,"Cement Creek","w1819","Mechanized",0,"Mon","weekday","no_sled","Brush/Cement","3","3","3",5.8,0.5,32,7,21,18.1,0,-1,-1,-1,7,6,5,4
"3635",2019-01-07,"Cement Creek","w1819","Motorized",2,"Mon","weekday","sled","Brush/Cement","3","3","3",5.8,0.5,32,7,21,18.1,0,-1,-1,-1,7,6,5,4
"3636",2019-01-07,"Cement Creek","w1819","Hybrid",0,"Mon","weekday","sled","Brush/Cement","3","3","3",5.8,0.5,32,7,21,18.1,0,-1,-1,-1,7,6,5,4
"3637",2019-01-08,"Cement Creek","w1819","Non.motorized",9,"Tue","weekday","no_sled","Brush/Cement","3","3","3",5.9,0.1,32,0,24,18.4,7,0,-1,-1,7,7,6,5
"3638",2019-01-08,"Cement Creek","w1819","Mechanized",0,"Tue","weekday","no_sled","Brush/Cement","3","3","3",5.9,0.1,32,0,24,18.4,7,0,-1,-1,7,7,6,5
"3639",2019-01-08,"Cement Creek","w1819","Motorized",3,"Tue","weekday","sled","Brush/Cement","3","3","3",5.9,0.1,32,0,24,18.4,7,0,-1,-1,7,7,6,5
"3640",2019-01-08,"Cement Creek","w1819","Hybrid",0,"Tue","weekday","sled","Brush/Cement","3","3","3",5.9,0.1,32,0,24,18.4,7,0,-1,-1,7,7,6,5
"3641",2019-01-09,"Cement Creek","w1819","Non.motorized",8,"Wed","weekday","no_sled","Brush/Cement","3","3","3",6,0.1,30,-2,29,20,0,7,0,-1,-2,5,5,4
"3642",2019-01-09,"Cement Creek","w1819","Mechanized",3,"Wed","weekday","no_sled","Brush/Cement","3","3","3",6,0.1,30,-2,29,20,0,7,0,-1,-2,5,5,4
"3643",2019-01-09,"Cement Creek","w1819","Motorized",1,"Wed","weekday","sled","Brush/Cement","3","3","3",6,0.1,30,-2,29,20,0,7,0,-1,-2,5,5,4
"3644",2019-01-09,"Cement Creek","w1819","Hybrid",0,"Wed","weekday","sled","Brush/Cement","3","3","3",6,0.1,30,-2,29,20,0,7,0,-1,-2,5,5,4
"3645",2019-01-10,"Cement Creek","w1819","Non.motorized",10,"Thu","weekday","no_sled","Brush/Cement","3","3","3",6,0,29,-1,29,20.7,-2,0,7,0,-3,-3,4,4
"3646",2019-01-10,"Cement Creek","w1819","Mechanized",0,"Thu","weekday","no_sled","Brush/Cement","3","3","3",6,0,29,-1,29,20.7,-2,0,7,0,-3,-3,4,4
"3647",2019-01-10,"Cement Creek","w1819","Motorized",2,"Thu","weekday","sled","Brush/Cement","3","3","3",6,0,29,-1,29,20.7,-2,0,7,0,-3,-3,4,4
"3648",2019-01-10,"Cement Creek","w1819","Hybrid",0,"Thu","weekday","sled","Brush/Cement","3","3","3",6,0,29,-1,29,20.7,-2,0,7,0,-3,-3,4,4
"3649",2019-01-11,"Cement Creek","w1819","Non.motorized",18,"Fri","weekday","no_sled","Brush/Cement","2","2","2",6.1,0.1,29,0,25,21,-1,-2,0,7,-1,-3,-3,4
"3650",2019-01-11,"Cement Creek","w1819","Mechanized",2,"Fri","weekday","no_sled","Brush/Cement","2","2","2",6.1,0.1,29,0,25,21,-1,-2,0,7,-1,-3,-3,4
"3651",2019-01-11,"Cement Creek","w1819","Motorized",6,"Fri","weekday","sled","Brush/Cement","2","2","2",6.1,0.1,29,0,25,21,-1,-2,0,7,-1,-3,-3,4
"3652",2019-01-11,"Cement Creek","w1819","Hybrid",0,"Fri","weekday","sled","Brush/Cement","2","2","2",6.1,0.1,29,0,25,21,-1,-2,0,7,-1,-3,-3,4
"3653",2019-01-12,"Cement Creek","w1819","Non.motorized",32,"Sat","weekend","no_sled","Brush/Cement","3","3","2",6.1,0,28,-1,21,21.8,0,-1,-2,0,-1,-2,-4,-4
"3654",2019-01-12,"Cement Creek","w1819","Mechanized",0,"Sat","weekend","no_sled","Brush/Cement","3","3","2",6.1,0,28,-1,21,21.8,0,-1,-2,0,-1,-2,-4,-4
"3655",2019-01-12,"Cement Creek","w1819","Motorized",6,"Sat","weekend","sled","Brush/Cement","3","3","2",6.1,0,28,-1,21,21.8,0,-1,-2,0,-1,-2,-4,-4
"3656",2019-01-12,"Cement Creek","w1819","Hybrid",0,"Sat","weekend","sled","Brush/Cement","3","3","2",6.1,0,28,-1,21,21.8,0,-1,-2,0,-1,-2,-4,-4
"3657",2019-01-13,"Cement Creek","w1819","Non.motorized",32,"Sun","weekend","no_sled","Brush/Cement","2","2","2",6.2,0.1,30,2,18,20.7,-1,0,-1,-2,1,1,0,-2
"3658",2019-01-13,"Cement Creek","w1819","Mechanized",2,"Sun","weekend","no_sled","Brush/Cement","2","2","2",6.2,0.1,30,2,18,20.7,-1,0,-1,-2,1,1,0,-2
"3659",2019-01-13,"Cement Creek","w1819","Motorized",5,"Sun","weekend","sled","Brush/Cement","2","2","2",6.2,0.1,30,2,18,20.7,-1,0,-1,-2,1,1,0,-2
"3660",2019-01-13,"Cement Creek","w1819","Hybrid",0,"Sun","weekend","sled","Brush/Cement","2","2","2",6.2,0.1,30,2,18,20.7,-1,0,-1,-2,1,1,0,-2
"3661",2019-01-14,"Cement Creek","w1819","Non.motorized",7,"Mon","weekday","no_sled","Brush/Cement","2","2","2",6.2,0,30,0,18,20.7,2,-1,0,-1,2,1,1,0
"3662",2019-01-14,"Cement Creek","w1819","Mechanized",1,"Mon","weekday","no_sled","Brush/Cement","2","2","2",6.2,0,30,0,18,20.7,2,-1,0,-1,2,1,1,0
"3663",2019-01-14,"Cement Creek","w1819","Motorized",4,"Mon","weekday","sled","Brush/Cement","2","2","2",6.2,0,30,0,18,20.7,2,-1,0,-1,2,1,1,0
"3664",2019-01-14,"Cement Creek","w1819","Hybrid",0,"Mon","weekday","sled","Brush/Cement","2","2","2",6.2,0,30,0,18,20.7,2,-1,0,-1,2,1,1,0
"3665",2019-01-15,"Cement Creek","w1819","Non.motorized",13,"Tue","weekday","no_sled","Brush/Cement","2","2","2",6.2,0,29,-1,24,21.4,0,2,-1,0,-1,1,0,0
"3666",2019-01-15,"Cement Creek","w1819","Mechanized",1,"Tue","weekday","no_sled","Brush/Cement","2","2","2",6.2,0,29,-1,24,21.4,0,2,-1,0,-1,1,0,0
"3667",2019-01-15,"Cement Creek","w1819","Motorized",3,"Tue","weekday","sled","Brush/Cement","2","2","2",6.2,0,29,-1,24,21.4,0,2,-1,0,-1,1,0,0
"3668",2019-01-15,"Cement Creek","w1819","Hybrid",0,"Tue","weekday","sled","Brush/Cement","2","2","2",6.2,0,29,-1,24,21.4,0,2,-1,0,-1,1,0,0
"3669",2019-01-16,"Cement Creek","w1819","Non.motorized",0,"Wed","weekday","no_sled","Brush/Cement","4","4","3",6.3,0.1,29,0,26,21.7,-1,0,2,-1,-1,-1,1,0
"3670",2019-01-16,"Cement Creek","w1819","Mechanized",0,"Wed","weekday","no_sled","Brush/Cement","4","4","3",6.3,0.1,29,0,26,21.7,-1,0,2,-1,-1,-1,1,0
"3671",2019-01-16,"Cement Creek","w1819","Motorized",2,"Wed","weekday","sled","Brush/Cement","4","4","3",6.3,0.1,29,0,26,21.7,-1,0,2,-1,-1,-1,1,0
"3672",2019-01-16,"Cement Creek","w1819","Hybrid",0,"Wed","weekday","sled","Brush/Cement","4","4","3",6.3,0.1,29,0,26,21.7,-1,0,2,-1,-1,-1,1,0
"3673",2019-01-17,"Cement Creek","w1819","Non.motorized",0,"Thu","weekday","no_sled","Brush/Cement","3","3","2",7,0.7,38,9,28,18.4,0,-1,0,2,9,8,8,10
"3674",2019-01-17,"Cement Creek","w1819","Mechanized",0,"Thu","weekday","no_sled","Brush/Cement","3","3","2",7,0.7,38,9,28,18.4,0,-1,0,2,9,8,8,10
"3675",2019-01-17,"Cement Creek","w1819","Motorized",0,"Thu","weekday","sled","Brush/Cement","3","3","2",7,0.7,38,9,28,18.4,0,-1,0,2,9,8,8,10
"3676",2019-01-17,"Cement Creek","w1819","Hybrid",0,"Thu","weekday","sled","Brush/Cement","3","3","2",7,0.7,38,9,28,18.4,0,-1,0,2,9,8,8,10
"3677",2019-01-18,"Cement Creek","w1819","Non.motorized",0,"Fri","weekday","no_sled","Brush/Cement","4","4","4",7.5,0.5,41,3,22,18.3,9,0,-1,0,12,12,11,11
"3678",2019-01-18,"Cement Creek","w1819","Mechanized",0,"Fri","weekday","no_sled","Brush/Cement","4","4","4",7.5,0.5,41,3,22,18.3,9,0,-1,0,12,12,11,11
"3679",2019-01-18,"Cement Creek","w1819","Motorized",0,"Fri","weekday","sled","Brush/Cement","4","4","4",7.5,0.5,41,3,22,18.3,9,0,-1,0,12,12,11,11
"3680",2019-01-18,"Cement Creek","w1819","Hybrid",0,"Fri","weekday","sled","Brush/Cement","4","4","4",7.5,0.5,41,3,22,18.3,9,0,-1,0,12,12,11,11
"3681",2019-01-19,"Cement Creek","w1819","Non.motorized",0,"Sat","weekend","no_sled","Brush/Cement","3","3","3",7.8,0.3,43,2,20,18.1,3,9,0,-1,5,14,14,13
"3682",2019-01-19,"Cement Creek","w1819","Mechanized",0,"Sat","weekend","no_sled","Brush/Cement","3","3","3",7.8,0.3,43,2,20,18.1,3,9,0,-1,5,14,14,13
"3683",2019-01-19,"Cement Creek","w1819","Motorized",0,"Sat","weekend","sled","Brush/Cement","3","3","3",7.8,0.3,43,2,20,18.1,3,9,0,-1,5,14,14,13
"3684",2019-01-19,"Cement Creek","w1819","Hybrid",0,"Sat","weekend","sled","Brush/Cement","3","3","3",7.8,0.3,43,2,20,18.1,3,9,0,-1,5,14,14,13
"3685",2019-01-20,"Cement Creek","w1819","Non.motorized",0,"Sun","weekend","no_sled","Brush/Cement","3","3","3",7.9,0.1,41,-2,27,19.3,2,3,9,0,0,3,12,12
"3686",2019-01-20,"Cement Creek","w1819","Mechanized",0,"Sun","weekend","no_sled","Brush/Cement","3","3","3",7.9,0.1,41,-2,27,19.3,2,3,9,0,0,3,12,12
"3687",2019-01-20,"Cement Creek","w1819","Motorized",0,"Sun","weekend","sled","Brush/Cement","3","3","3",7.9,0.1,41,-2,27,19.3,2,3,9,0,0,3,12,12
"3688",2019-01-20,"Cement Creek","w1819","Hybrid",0,"Sun","weekend","sled","Brush/Cement","3","3","3",7.9,0.1,41,-2,27,19.3,2,3,9,0,0,3,12,12
"3689",2019-01-21,"Cement Creek","w1819","Non.motorized",1,"Mon","weekday","no_sled","Brush/Cement","3","3","3",7.9,0,39,-2,23,20.3,-2,2,3,9,-4,-2,1,10
"3690",2019-01-21,"Cement Creek","w1819","Mechanized",0,"Mon","weekday","no_sled","Brush/Cement","3","3","3",7.9,0,39,-2,23,20.3,-2,2,3,9,-4,-2,1,10
"3691",2019-01-21,"Cement Creek","w1819","Motorized",1,"Mon","weekday","sled","Brush/Cement","3","3","3",7.9,0,39,-2,23,20.3,-2,2,3,9,-4,-2,1,10
"3692",2019-01-21,"Cement Creek","w1819","Hybrid",0,"Mon","weekday","sled","Brush/Cement","3","3","3",7.9,0,39,-2,23,20.3,-2,2,3,9,-4,-2,1,10
"3693",2019-01-22,"Cement Creek","w1819","Non.motorized",6,"Tue","weekday","no_sled","Brush/Cement","3","3","3",8,0.1,41,2,12,19.5,-2,-2,2,3,0,-2,0,3
"3694",2019-01-22,"Cement Creek","w1819","Mechanized",0,"Tue","weekday","no_sled","Brush/Cement","3","3","3",8,0.1,41,2,12,19.5,-2,-2,2,3,0,-2,0,3
"3695",2019-01-22,"Cement Creek","w1819","Motorized",4,"Tue","weekday","sled","Brush/Cement","3","3","3",8,0.1,41,2,12,19.5,-2,-2,2,3,0,-2,0,3
"3696",2019-01-22,"Cement Creek","w1819","Hybrid",0,"Tue","weekday","sled","Brush/Cement","3","3","3",8,0.1,41,2,12,19.5,-2,-2,2,3,0,-2,0,3
"3697",2019-01-23,"Cement Creek","w1819","Non.motorized",12,"Wed","weekday","no_sled","Brush/Cement","3","3","2",8,0,40,-1,14,20,2,-2,-2,2,1,-1,-3,-1
"3698",2019-01-23,"Cement Creek","w1819","Mechanized",2,"Wed","weekday","no_sled","Brush/Cement","3","3","2",8,0,40,-1,14,20,2,-2,-2,2,1,-1,-3,-1
"3699",2019-01-23,"Cement Creek","w1819","Motorized",5,"Wed","weekday","sled","Brush/Cement","3","3","2",8,0,40,-1,14,20,2,-2,-2,2,1,-1,-3,-1
"3700",2019-01-23,"Cement Creek","w1819","Hybrid",0,"Wed","weekday","sled","Brush/Cement","3","3","2",8,0,40,-1,14,20,2,-2,-2,2,1,-1,-3,-1
"3701",2019-01-24,"Cement Creek","w1819","Non.motorized",7,"Thu","weekday","no_sled","Brush/Cement","3","3","2",8.2,0.2,40,0,17,20.5,-1,2,-2,-2,-1,1,-1,-3
"3702",2019-01-24,"Cement Creek","w1819","Mechanized",0,"Thu","weekday","no_sled","Brush/Cement","3","3","2",8.2,0.2,40,0,17,20.5,-1,2,-2,-2,-1,1,-1,-3
"3703",2019-01-24,"Cement Creek","w1819","Motorized",1,"Thu","weekday","sled","Brush/Cement","3","3","2",8.2,0.2,40,0,17,20.5,-1,2,-2,-2,-1,1,-1,-3
"3704",2019-01-24,"Cement Creek","w1819","Hybrid",0,"Thu","weekday","sled","Brush/Cement","3","3","2",8.2,0.2,40,0,17,20.5,-1,2,-2,-2,-1,1,-1,-3
"3705",2019-01-25,"Cement Creek","w1819","Non.motorized",15,"Fri","weekday","no_sled","Brush/Cement","3","3","2",8.3,0.1,40,0,15,20.8,0,-1,2,-2,0,-1,1,-1
"3706",2019-01-25,"Cement Creek","w1819","Mechanized",0,"Fri","weekday","no_sled","Brush/Cement","3","3","2",8.3,0.1,40,0,15,20.8,0,-1,2,-2,0,-1,1,-1
"3707",2019-01-25,"Cement Creek","w1819","Motorized",3,"Fri","weekday","sled","Brush/Cement","3","3","2",8.3,0.1,40,0,15,20.8,0,-1,2,-2,0,-1,1,-1
"3708",2019-01-25,"Cement Creek","w1819","Hybrid",0,"Fri","weekday","sled","Brush/Cement","3","3","2",8.3,0.1,40,0,15,20.8,0,-1,2,-2,0,-1,1,-1
"3709",2019-01-26,"Cement Creek","w1819","Non.motorized",41,"Sat","weekend","no_sled","Brush/Cement","3","3","2",8.3,0,39,-1,19,21.3,0,0,-1,2,-1,-1,-2,0
"3710",2019-01-26,"Cement Creek","w1819","Mechanized",0,"Sat","weekend","no_sled","Brush/Cement","3","3","2",8.3,0,39,-1,19,21.3,0,0,-1,2,-1,-1,-2,0
"3711",2019-01-26,"Cement Creek","w1819","Motorized",8,"Sat","weekend","sled","Brush/Cement","3","3","2",8.3,0,39,-1,19,21.3,0,0,-1,2,-1,-1,-2,0
"3712",2019-01-26,"Cement Creek","w1819","Hybrid",0,"Sat","weekend","sled","Brush/Cement","3","3","2",8.3,0,39,-1,19,21.3,0,0,-1,2,-1,-1,-2,0
"3713",2019-01-27,"Cement Creek","w1819","Non.motorized",27,"Sun","weekend","no_sled","Brush/Cement","3","3","2",8.3,0,38,-1,24,21.8,-1,0,0,-1,-2,-2,-2,-3
"3714",2019-01-27,"Cement Creek","w1819","Mechanized",2,"Sun","weekend","no_sled","Brush/Cement","3","3","2",8.3,0,38,-1,24,21.8,-1,0,0,-1,-2,-2,-2,-3
"3715",2019-01-27,"Cement Creek","w1819","Motorized",4,"Sun","weekend","sled","Brush/Cement","3","3","2",8.3,0,38,-1,24,21.8,-1,0,0,-1,-2,-2,-2,-3
"3716",2019-01-27,"Cement Creek","w1819","Hybrid",0,"Sun","weekend","sled","Brush/Cement","3","3","2",8.3,0,38,-1,24,21.8,-1,0,0,-1,-2,-2,-2,-3
"3717",2019-01-28,"Cement Creek","w1819","Non.motorized",8,"Mon","weekday","no_sled","Brush/Cement","2","2","2",8.3,0,38,0,17,21.8,-1,-1,0,0,-1,-2,-2,-2
"3718",2019-01-28,"Cement Creek","w1819","Mechanized",0,"Mon","weekday","no_sled","Brush/Cement","2","2","2",8.3,0,38,0,17,21.8,-1,-1,0,0,-1,-2,-2,-2
"3719",2019-01-28,"Cement Creek","w1819","Motorized",4,"Mon","weekday","sled","Brush/Cement","2","2","2",8.3,0,38,0,17,21.8,-1,-1,0,0,-1,-2,-2,-2
"3720",2019-01-28,"Cement Creek","w1819","Hybrid",0,"Mon","weekday","sled","Brush/Cement","2","2","2",8.3,0,38,0,17,21.8,-1,-1,0,0,-1,-2,-2,-2
"3721",2019-01-29,"Cement Creek","w1819","Non.motorized",12,"Tue","weekday","no_sled","Brush/Cement","2","2","2",8.3,0,38,0,16,21.8,0,-1,-1,0,0,-1,-2,-2
"3722",2019-01-29,"Cement Creek","w1819","Mechanized",1,"Tue","weekday","no_sled","Brush/Cement","2","2","2",8.3,0,38,0,16,21.8,0,-1,-1,0,0,-1,-2,-2
"3723",2019-01-29,"Cement Creek","w1819","Motorized",3,"Tue","weekday","sled","Brush/Cement","2","2","2",8.3,0,38,0,16,21.8,0,-1,-1,0,0,-1,-2,-2
"3724",2019-01-29,"Cement Creek","w1819","Hybrid",0,"Tue","weekday","sled","Brush/Cement","2","2","2",8.3,0,38,0,16,21.8,0,-1,-1,0,0,-1,-2,-2
"3725",2019-01-30,"Cement Creek","w1819","Non.motorized",11,"Wed","weekday","no_sled","Brush/Cement","2","2","1",8.3,0,37,-1,20,22.4,0,0,-1,-1,-1,-1,-2,-3
"3726",2019-01-30,"Cement Creek","w1819","Mechanized",1,"Wed","weekday","no_sled","Brush/Cement","2","2","1",8.3,0,37,-1,20,22.4,0,0,-1,-1,-1,-1,-2,-3
"3727",2019-01-30,"Cement Creek","w1819","Motorized",3,"Wed","weekday","sled","Brush/Cement","2","2","1",8.3,0,37,-1,20,22.4,0,0,-1,-1,-1,-1,-2,-3
"3728",2019-01-30,"Cement Creek","w1819","Hybrid",0,"Wed","weekday","sled","Brush/Cement","2","2","1",8.3,0,37,-1,20,22.4,0,0,-1,-1,-1,-1,-2,-3
"3729",2019-01-31,"Cement Creek","w1819","Non.motorized",9,"Thu","weekday","no_sled","Brush/Cement","2","2","1",8.3,0,36,-1,24,23.1,-1,0,0,-1,-2,-2,-2,-3
"3730",2019-01-31,"Cement Creek","w1819","Mechanized",0,"Thu","weekday","no_sled","Brush/Cement","2","2","1",8.3,0,36,-1,24,23.1,-1,0,0,-1,-2,-2,-2,-3
"3731",2019-01-31,"Cement Creek","w1819","Motorized",1,"Thu","weekday","sled","Brush/Cement","2","2","1",8.3,0,36,-1,24,23.1,-1,0,0,-1,-2,-2,-2,-3
"3732",2019-01-31,"Cement Creek","w1819","Hybrid",0,"Thu","weekday","sled","Brush/Cement","2","2","1",8.3,0,36,-1,24,23.1,-1,0,0,-1,-2,-2,-2,-3
"3733",2019-02-01,"Cement Creek","w1819","Non.motorized",23,"Fri","weekday","no_sled","Brush/Cement","2","2","1",8.3,0,36,0,25,23.1,-1,-1,0,0,-1,-2,-2,-2
"3734",2019-02-01,"Cement Creek","w1819","Mechanized",3,"Fri","weekday","no_sled","Brush/Cement","2","2","1",8.3,0,36,0,25,23.1,-1,-1,0,0,-1,-2,-2,-2
"3735",2019-02-01,"Cement Creek","w1819","Motorized",2,"Fri","weekday","sled","Brush/Cement","2","2","1",8.3,0,36,0,25,23.1,-1,-1,0,0,-1,-2,-2,-2
"3736",2019-02-01,"Cement Creek","w1819","Hybrid",0,"Fri","weekday","sled","Brush/Cement","2","2","1",8.3,0,36,0,25,23.1,-1,-1,0,0,-1,-2,-2,-2
"3737",2019-02-02,"Cement Creek","w1819","Non.motorized",33,"Sat","weekend","no_sled","Brush/Cement","2","2","1",8.3,0,36,0,26,23.1,0,-1,-1,0,0,-1,-2,-2
"3738",2019-02-02,"Cement Creek","w1819","Mechanized",5,"Sat","weekend","no_sled","Brush/Cement","2","2","1",8.3,0,36,0,26,23.1,0,-1,-1,0,0,-1,-2,-2
"3739",2019-02-02,"Cement Creek","w1819","Motorized",3,"Sat","weekend","sled","Brush/Cement","2","2","1",8.3,0,36,0,26,23.1,0,-1,-1,0,0,-1,-2,-2
"3740",2019-02-02,"Cement Creek","w1819","Hybrid",0,"Sat","weekend","sled","Brush/Cement","2","2","1",8.3,0,36,0,26,23.1,0,-1,-1,0,0,-1,-2,-2
"3741",2019-02-03,"Cement Creek","w1819","Non.motorized",24,"Sun","weekend","no_sled","Brush/Cement","3","3","2",8.4,0.1,36,0,28,23.3,0,0,-1,-1,0,0,-1,-2
"3742",2019-02-03,"Cement Creek","w1819","Mechanized",2,"Sun","weekend","no_sled","Brush/Cement","3","3","2",8.4,0.1,36,0,28,23.3,0,0,-1,-1,0,0,-1,-2
"3743",2019-02-03,"Cement Creek","w1819","Motorized",2,"Sun","weekend","sled","Brush/Cement","3","3","2",8.4,0.1,36,0,28,23.3,0,0,-1,-1,0,0,-1,-2
"3744",2019-02-03,"Cement Creek","w1819","Hybrid",0,"Sun","weekend","sled","Brush/Cement","3","3","2",8.4,0.1,36,0,28,23.3,0,0,-1,-1,0,0,-1,-2
"3745",2019-02-04,"Cement Creek","w1819","Non.motorized",10,"Mon","weekday","no_sled","Brush/Cement","3","3","2",8.8,0.4,39,3,28,22.6,0,0,0,-1,3,3,3,2
"3746",2019-02-04,"Cement Creek","w1819","Mechanized",1,"Mon","weekday","no_sled","Brush/Cement","3","3","2",8.8,0.4,39,3,28,22.6,0,0,0,-1,3,3,3,2
"3747",2019-02-04,"Cement Creek","w1819","Motorized",4,"Mon","weekday","sled","Brush/Cement","3","3","2",8.8,0.4,39,3,28,22.6,0,0,0,-1,3,3,3,2
"3748",2019-02-04,"Cement Creek","w1819","Hybrid",0,"Mon","weekday","sled","Brush/Cement","3","3","2",8.8,0.4,39,3,28,22.6,0,0,0,-1,3,3,3,2
"3749",2019-02-05,"Cement Creek","w1819","Non.motorized",15,"Tue","weekday","no_sled","Brush/Cement","3","2","2",9,0.2,40,1,26,22.5,3,0,0,0,4,4,4,4
"3750",2019-02-05,"Cement Creek","w1819","Mechanized",0,"Tue","weekday","no_sled","Brush/Cement","3","2","2",9,0.2,40,1,26,22.5,3,0,0,0,4,4,4,4
"3751",2019-02-05,"Cement Creek","w1819","Motorized",4,"Tue","weekday","sled","Brush/Cement","3","2","2",9,0.2,40,1,26,22.5,3,0,0,0,4,4,4,4
"3752",2019-02-05,"Cement Creek","w1819","Hybrid",0,"Tue","weekday","sled","Brush/Cement","3","2","2",9,0.2,40,1,26,22.5,3,0,0,0,4,4,4,4
"3753",2019-02-06,"Cement Creek","w1819","Non.motorized",7,"Wed","weekday","no_sled","Brush/Cement","4","4","3",9,0,40,0,16,22.5,1,3,0,0,1,4,4,4
"3754",2019-02-06,"Cement Creek","w1819","Mechanized",0,"Wed","weekday","no_sled","Brush/Cement","4","4","3",9,0,40,0,16,22.5,1,3,0,0,1,4,4,4
"3755",2019-02-06,"Cement Creek","w1819","Motorized",3,"Wed","weekday","sled","Brush/Cement","4","4","3",9,0,40,0,16,22.5,1,3,0,0,1,4,4,4
"3756",2019-02-06,"Cement Creek","w1819","Hybrid",0,"Wed","weekday","sled","Brush/Cement","4","4","3",9,0,40,0,16,22.5,1,3,0,0,1,4,4,4
"3757",2019-02-07,"Cement Creek","w1819","Non.motorized",4,"Thu","weekday","no_sled","Brush/Cement","3","3","2",9.2,0.2,43,3,4,21.4,0,1,3,0,3,4,7,7
"3758",2019-02-07,"Cement Creek","w1819","Mechanized",0,"Thu","weekday","no_sled","Brush/Cement","3","3","2",9.2,0.2,43,3,4,21.4,0,1,3,0,3,4,7,7
"3759",2019-02-07,"Cement Creek","w1819","Motorized",3,"Thu","weekday","sled","Brush/Cement","3","3","2",9.2,0.2,43,3,4,21.4,0,1,3,0,3,4,7,7
"3760",2019-02-07,"Cement Creek","w1819","Hybrid",0,"Thu","weekday","sled","Brush/Cement","3","3","2",9.2,0.2,43,3,4,21.4,0,1,3,0,3,4,7,7
"3761",2019-02-08,"Cement Creek","w1819","Non.motorized",20,"Fri","weekday","no_sled","Brush/Cement","3","2","2",9.2,0,42,-1,10,21.9,3,0,1,3,2,2,3,6
"3762",2019-02-08,"Cement Creek","w1819","Mechanized",0,"Fri","weekday","no_sled","Brush/Cement","3","2","2",9.2,0,42,-1,10,21.9,3,0,1,3,2,2,3,6
"3763",2019-02-08,"Cement Creek","w1819","Motorized",1,"Fri","weekday","sled","Brush/Cement","3","2","2",9.2,0,42,-1,10,21.9,3,0,1,3,2,2,3,6
"3764",2019-02-08,"Cement Creek","w1819","Hybrid",0,"Fri","weekday","sled","Brush/Cement","3","2","2",9.2,0,42,-1,10,21.9,3,0,1,3,2,2,3,6
"3765",2019-02-09,"Cement Creek","w1819","Non.motorized",25,"Sat","weekend","no_sled","Brush/Cement","3","2","2",9.2,0,41,-1,20,22.4,-1,3,0,1,-2,1,1,2
"3766",2019-02-09,"Cement Creek","w1819","Mechanized",0,"Sat","weekend","no_sled","Brush/Cement","3","2","2",9.2,0,41,-1,20,22.4,-1,3,0,1,-2,1,1,2
"3767",2019-02-09,"Cement Creek","w1819","Motorized",4,"Sat","weekend","sled","Brush/Cement","3","2","2",9.2,0,41,-1,20,22.4,-1,3,0,1,-2,1,1,2
"3768",2019-02-09,"Cement Creek","w1819","Hybrid",0,"Sat","weekend","sled","Brush/Cement","3","2","2",9.2,0,41,-1,20,22.4,-1,3,0,1,-2,1,1,2
"3769",2019-02-10,"Cement Creek","w1819","Non.motorized",0,"Sun","weekend","no_sled","Brush/Cement","2","2","2",9.3,0.1,40,-1,20,23.2,-1,-1,3,0,-2,-3,0,0
"3770",2019-02-10,"Cement Creek","w1819","Mechanized",0,"Sun","weekend","no_sled","Brush/Cement","2","2","2",9.3,0.1,40,-1,20,23.2,-1,-1,3,0,-2,-3,0,0
"3771",2019-02-10,"Cement Creek","w1819","Motorized",0,"Sun","weekend","sled","Brush/Cement","2","2","2",9.3,0.1,40,-1,20,23.2,-1,-1,3,0,-2,-3,0,0
"3772",2019-02-10,"Cement Creek","w1819","Hybrid",0,"Sun","weekend","sled","Brush/Cement","2","2","2",9.3,0.1,40,-1,20,23.2,-1,-1,3,0,-2,-3,0,0
"3773",2019-02-11,"Cement Creek","w1819","Non.motorized",5,"Mon","weekday","no_sled","Brush/Cement","2","2","1",9.3,0,40,0,15,23.2,-1,-1,-1,3,-1,-2,-3,0
"3774",2019-02-11,"Cement Creek","w1819","Mechanized",0,"Mon","weekday","no_sled","Brush/Cement","2","2","1",9.3,0,40,0,15,23.2,-1,-1,-1,3,-1,-2,-3,0
"3775",2019-02-11,"Cement Creek","w1819","Motorized",3,"Mon","weekday","sled","Brush/Cement","2","2","1",9.3,0,40,0,15,23.2,-1,-1,-1,3,-1,-2,-3,0
"3776",2019-02-11,"Cement Creek","w1819","Hybrid",0,"Mon","weekday","sled","Brush/Cement","2","2","1",9.3,0,40,0,15,23.2,-1,-1,-1,3,-1,-2,-3,0
"3777",2019-02-12,"Cement Creek","w1819","Non.motorized",17,"Tue","weekday","no_sled","Brush/Cement","2","2","1",9.3,0,40,0,18,23.2,0,-1,-1,-1,0,-1,-2,-3
"3778",2019-02-12,"Cement Creek","w1819","Mechanized",0,"Tue","weekday","no_sled","Brush/Cement","2","2","1",9.3,0,40,0,18,23.2,0,-1,-1,-1,0,-1,-2,-3
"3779",2019-02-12,"Cement Creek","w1819","Motorized",8,"Tue","weekday","sled","Brush/Cement","2","2","1",9.3,0,40,0,18,23.2,0,-1,-1,-1,0,-1,-2,-3
"3780",2019-02-12,"Cement Creek","w1819","Hybrid",0,"Tue","weekday","sled","Brush/Cement","2","2","1",9.3,0,40,0,18,23.2,0,-1,-1,-1,0,-1,-2,-3
"3781",2019-02-13,"Cement Creek","w1819","Non.motorized",16,"Wed","weekday","no_sled","Brush/Cement","2","2","1",9.4,0.1,40,0,26,23.5,0,0,-1,-1,0,0,-1,-2
"3782",2019-02-13,"Cement Creek","w1819","Mechanized",1,"Wed","weekday","no_sled","Brush/Cement","2","2","1",9.4,0.1,40,0,26,23.5,0,0,-1,-1,0,0,-1,-2
"3783",2019-02-13,"Cement Creek","w1819","Motorized",2,"Wed","weekday","sled","Brush/Cement","2","2","1",9.4,0.1,40,0,26,23.5,0,0,-1,-1,0,0,-1,-2
"3784",2019-02-13,"Cement Creek","w1819","Hybrid",0,"Wed","weekday","sled","Brush/Cement","2","2","1",9.4,0.1,40,0,26,23.5,0,0,-1,-1,0,0,-1,-2
"3785",2019-02-14,"Cement Creek","w1819","Non.motorized",4,"Thu","weekday","no_sled","Brush/Cement","3","2","2",9.7,0.3,41,1,29,23.7,0,0,0,-1,1,1,1,0
"3786",2019-02-14,"Cement Creek","w1819","Mechanized",0,"Thu","weekday","no_sled","Brush/Cement","3","2","2",9.7,0.3,41,1,29,23.7,0,0,0,-1,1,1,1,0
"3787",2019-02-14,"Cement Creek","w1819","Motorized",12,"Thu","weekday","sled","Brush/Cement","3","2","2",9.7,0.3,41,1,29,23.7,0,0,0,-1,1,1,1,0
"3788",2019-02-14,"Cement Creek","w1819","Hybrid",0,"Thu","weekday","sled","Brush/Cement","3","2","2",9.7,0.3,41,1,29,23.7,0,0,0,-1,1,1,1,0
"3789",2019-02-15,"Cement Creek","w1819","Non.motorized",18,"Fri","weekday","no_sled","Brush/Cement","4","4","3",10.8,1.1,51,10,27,21.2,1,0,0,0,11,11,11,11
"3790",2019-02-15,"Cement Creek","w1819","Mechanized",0,"Fri","weekday","no_sled","Brush/Cement","4","4","3",10.8,1.1,51,10,27,21.2,1,0,0,0,11,11,11,11
"3791",2019-02-15,"Cement Creek","w1819","Motorized",7,"Fri","weekday","sled","Brush/Cement","4","4","3",10.8,1.1,51,10,27,21.2,1,0,0,0,11,11,11,11
"3792",2019-02-15,"Cement Creek","w1819","Hybrid",0,"Fri","weekday","sled","Brush/Cement","4","4","3",10.8,1.1,51,10,27,21.2,1,0,0,0,11,11,11,11
"3793",2019-02-16,"Cement Creek","w1819","Non.motorized",0,"Sat","weekend","no_sled","Brush/Cement","3","3","3",11.1,0.3,52,1,14,21.3,10,1,0,0,11,12,12,12
"3794",2019-02-16,"Cement Creek","w1819","Mechanized",0,"Sat","weekend","no_sled","Brush/Cement","3","3","3",11.1,0.3,52,1,14,21.3,10,1,0,0,11,12,12,12
"3795",2019-02-16,"Cement Creek","w1819","Motorized",0,"Sat","weekend","sled","Brush/Cement","3","3","3",11.1,0.3,52,1,14,21.3,10,1,0,0,11,12,12,12
"3796",2019-02-16,"Cement Creek","w1819","Hybrid",0,"Sat","weekend","sled","Brush/Cement","3","3","3",11.1,0.3,52,1,14,21.3,10,1,0,0,11,12,12,12
"3797",2019-02-17,"Cement Creek","w1819","Non.motorized",21,"Sun","weekend","no_sled","Brush/Cement","3","3","3",11.3,0.2,55,3,10,20.5,1,10,1,0,4,14,15,15
"3798",2019-02-17,"Cement Creek","w1819","Mechanized",1,"Sun","weekend","no_sled","Brush/Cement","3","3","3",11.3,0.2,55,3,10,20.5,1,10,1,0,4,14,15,15
"3799",2019-02-17,"Cement Creek","w1819","Motorized",6,"Sun","weekend","sled","Brush/Cement","3","3","3",11.3,0.2,55,3,10,20.5,1,10,1,0,4,14,15,15
"3800",2019-02-17,"Cement Creek","w1819","Hybrid",0,"Sun","weekend","sled","Brush/Cement","3","3","3",11.3,0.2,55,3,10,20.5,1,10,1,0,4,14,15,15
"3801",2019-02-18,"Cement Creek","w1819","Non.motorized",9,"Mon","weekday","no_sled","Brush/Cement","3","3","2",11.4,0.1,53,-2,13,21.5,3,1,10,1,1,2,12,13
"3802",2019-02-18,"Cement Creek","w1819","Mechanized",0,"Mon","weekday","no_sled","Brush/Cement","3","3","2",11.4,0.1,53,-2,13,21.5,3,1,10,1,1,2,12,13
"3803",2019-02-18,"Cement Creek","w1819","Motorized",5,"Mon","weekday","sled","Brush/Cement","3","3","2",11.4,0.1,53,-2,13,21.5,3,1,10,1,1,2,12,13
"3804",2019-02-18,"Cement Creek","w1819","Hybrid",0,"Mon","weekday","sled","Brush/Cement","3","3","2",11.4,0.1,53,-2,13,21.5,3,1,10,1,1,2,12,13
"3805",2019-02-19,"Cement Creek","w1819","Non.motorized",0,"Tue","weekday","no_sled","Brush/Cement","3","3","2",11.5,0.1,53,0,11,21.7,-2,3,1,10,-2,1,2,12
"3806",2019-02-19,"Cement Creek","w1819","Mechanized",0,"Tue","weekday","no_sled","Brush/Cement","3","3","2",11.5,0.1,53,0,11,21.7,-2,3,1,10,-2,1,2,12
"3807",2019-02-19,"Cement Creek","w1819","Motorized",0,"Tue","weekday","sled","Brush/Cement","3","3","2",11.5,0.1,53,0,11,21.7,-2,3,1,10,-2,1,2,12
"3808",2019-02-19,"Cement Creek","w1819","Hybrid",0,"Tue","weekday","sled","Brush/Cement","3","3","2",11.5,0.1,53,0,11,21.7,-2,3,1,10,-2,1,2,12
"3809",2019-02-20,"Cement Creek","w1819","Non.motorized",0,"Wed","weekday","no_sled","Brush/Cement","3","3","2",11.6,0.1,53,0,7,21.9,0,-2,3,1,0,-2,1,2
"3810",2019-02-20,"Cement Creek","w1819","Mechanized",0,"Wed","weekday","no_sled","Brush/Cement","3","3","2",11.6,0.1,53,0,7,21.9,0,-2,3,1,0,-2,1,2
"3811",2019-02-20,"Cement Creek","w1819","Motorized",0,"Wed","weekday","sled","Brush/Cement","3","3","2",11.6,0.1,53,0,7,21.9,0,-2,3,1,0,-2,1,2
"3812",2019-02-20,"Cement Creek","w1819","Hybrid",0,"Wed","weekday","sled","Brush/Cement","3","3","2",11.6,0.1,53,0,7,21.9,0,-2,3,1,0,-2,1,2
"3813",2019-02-21,"Cement Creek","w1819","Non.motorized",0,"Thu","weekday","no_sled","Brush/Cement","3","3","3",11.6,0,52,-1,15,22.3,0,0,-2,3,-1,-1,-3,0
"3814",2019-02-21,"Cement Creek","w1819","Mechanized",0,"Thu","weekday","no_sled","Brush/Cement","3","3","3",11.6,0,52,-1,15,22.3,0,0,-2,3,-1,-1,-3,0
"3815",2019-02-21,"Cement Creek","w1819","Motorized",0,"Thu","weekday","sled","Brush/Cement","3","3","3",11.6,0,52,-1,15,22.3,0,0,-2,3,-1,-1,-3,0
"3816",2019-02-21,"Cement Creek","w1819","Hybrid",0,"Thu","weekday","sled","Brush/Cement","3","3","3",11.6,0,52,-1,15,22.3,0,0,-2,3,-1,-1,-3,0
"3817",2019-02-22,"Cement Creek","w1819","Non.motorized",2,"Fri","weekday","no_sled","Brush/Cement","3","3","3",11.8,0.2,52,0,20,22.7,-1,0,0,-2,-1,-1,-1,-3
"3818",2019-02-22,"Cement Creek","w1819","Mechanized",0,"Fri","weekday","no_sled","Brush/Cement","3","3","3",11.8,0.2,52,0,20,22.7,-1,0,0,-2,-1,-1,-1,-3
"3819",2019-02-22,"Cement Creek","w1819","Motorized",0,"Fri","weekday","sled","Brush/Cement","3","3","3",11.8,0.2,52,0,20,22.7,-1,0,0,-2,-1,-1,-1,-3
"3820",2019-02-22,"Cement Creek","w1819","Hybrid",0,"Fri","weekday","sled","Brush/Cement","3","3","3",11.8,0.2,52,0,20,22.7,-1,0,0,-2,-1,-1,-1,-3
"3821",2019-02-23,"Cement Creek","w1819","Non.motorized",29,"Sat","weekend","no_sled","Brush/Cement","3","3","3",12.1,0.3,53,1,13,22.8,0,-1,0,0,1,0,0,0
"3822",2019-02-23,"Cement Creek","w1819","Mechanized",0,"Sat","weekend","no_sled","Brush/Cement","3","3","3",12.1,0.3,53,1,13,22.8,0,-1,0,0,1,0,0,0
"3823",2019-02-23,"Cement Creek","w1819","Motorized",6,"Sat","weekend","sled","Brush/Cement","3","3","3",12.1,0.3,53,1,13,22.8,0,-1,0,0,1,0,0,0
"3824",2019-02-23,"Cement Creek","w1819","Hybrid",0,"Sat","weekend","sled","Brush/Cement","3","3","3",12.1,0.3,53,1,13,22.8,0,-1,0,0,1,0,0,0
"3825",2019-02-24,"Cement Creek","w1819","Non.motorized",29,"Sun","weekend","no_sled","Brush/Cement","3","3","2",12.1,0,52,-1,14,23.3,1,0,-1,0,0,0,-1,-1
"3826",2019-02-24,"Cement Creek","w1819","Mechanized",1,"Sun","weekend","no_sled","Brush/Cement","3","3","2",12.1,0,52,-1,14,23.3,1,0,-1,0,0,0,-1,-1
"3827",2019-02-24,"Cement Creek","w1819","Motorized",13,"Sun","weekend","sled","Brush/Cement","3","3","2",12.1,0,52,-1,14,23.3,1,0,-1,0,0,0,-1,-1
"3828",2019-02-24,"Cement Creek","w1819","Hybrid",0,"Sun","weekend","sled","Brush/Cement","3","3","2",12.1,0,52,-1,14,23.3,1,0,-1,0,0,0,-1,-1
"3829",2019-02-25,"Cement Creek","w1819","Non.motorized",13,"Mon","weekday","no_sled","Brush/Cement","3","3","2",12.1,0,51,-1,22,23.7,-1,1,0,-1,-2,-1,-1,-2
"3830",2019-02-25,"Cement Creek","w1819","Mechanized",5,"Mon","weekday","no_sled","Brush/Cement","3","3","2",12.1,0,51,-1,22,23.7,-1,1,0,-1,-2,-1,-1,-2
"3831",2019-02-25,"Cement Creek","w1819","Motorized",10,"Mon","weekday","sled","Brush/Cement","3","3","2",12.1,0,51,-1,22,23.7,-1,1,0,-1,-2,-1,-1,-2
"3832",2019-02-25,"Cement Creek","w1819","Hybrid",0,"Mon","weekday","sled","Brush/Cement","3","3","2",12.1,0,51,-1,22,23.7,-1,1,0,-1,-2,-1,-1,-2
"3833",2019-02-26,"Cement Creek","w1819","Non.motorized",13,"Tue","weekday","no_sled","Brush/Cement","2","2","2",12.1,0,50,-1,27,24.2,-1,-1,1,0,-2,-3,-2,-2
"3834",2019-02-26,"Cement Creek","w1819","Mechanized",0,"Tue","weekday","no_sled","Brush/Cement","2","2","2",12.1,0,50,-1,27,24.2,-1,-1,1,0,-2,-3,-2,-2
"3835",2019-02-26,"Cement Creek","w1819","Motorized",2,"Tue","weekday","sled","Brush/Cement","2","2","2",12.1,0,50,-1,27,24.2,-1,-1,1,0,-2,-3,-2,-2
"3836",2019-02-26,"Cement Creek","w1819","Hybrid",0,"Tue","weekday","sled","Brush/Cement","2","2","2",12.1,0,50,-1,27,24.2,-1,-1,1,0,-2,-3,-2,-2
"3837",2019-02-27,"Cement Creek","w1819","Non.motorized",10,"Wed","weekday","no_sled","Brush/Cement","2","2","2",12.1,0,50,0,30,24.2,-1,-1,-1,1,-1,-2,-3,-2
"3838",2019-02-27,"Cement Creek","w1819","Mechanized",1,"Wed","weekday","no_sled","Brush/Cement","2","2","2",12.1,0,50,0,30,24.2,-1,-1,-1,1,-1,-2,-3,-2
"3839",2019-02-27,"Cement Creek","w1819","Motorized",10,"Wed","weekday","sled","Brush/Cement","2","2","2",12.1,0,50,0,30,24.2,-1,-1,-1,1,-1,-2,-3,-2
"3840",2019-02-27,"Cement Creek","w1819","Hybrid",0,"Wed","weekday","sled","Brush/Cement","2","2","2",12.1,0,50,0,30,24.2,-1,-1,-1,1,-1,-2,-3,-2
"3841",2019-02-28,"Cement Creek","w1819","Non.motorized",20,"Thu","weekday","no_sled","Brush/Cement","2","2","2",12.2,0.1,49,-1,30,24.9,0,-1,-1,-1,-1,-2,-3,-4
"3842",2019-02-28,"Cement Creek","w1819","Mechanized",2,"Thu","weekday","no_sled","Brush/Cement","2","2","2",12.2,0.1,49,-1,30,24.9,0,-1,-1,-1,-1,-2,-3,-4
"3843",2019-02-28,"Cement Creek","w1819","Motorized",2,"Thu","weekday","sled","Brush/Cement","2","2","2",12.2,0.1,49,-1,30,24.9,0,-1,-1,-1,-1,-2,-3,-4
"3844",2019-02-28,"Cement Creek","w1819","Hybrid",0,"Thu","weekday","sled","Brush/Cement","2","2","2",12.2,0.1,49,-1,30,24.9,0,-1,-1,-1,-1,-2,-3,-4
"3845",2019-03-01,"Cement Creek","w1819","Non.motorized",0,"Fri","weekday","no_sled","Brush/Cement","2","2","1",12.3,0.1,49,0,29,25.1,-1,0,-1,-1,-1,-1,-2,-3
"3846",2019-03-01,"Cement Creek","w1819","Mechanized",0,"Fri","weekday","no_sled","Brush/Cement","2","2","1",12.3,0.1,49,0,29,25.1,-1,0,-1,-1,-1,-1,-2,-3
"3847",2019-03-01,"Cement Creek","w1819","Motorized",2,"Fri","weekday","sled","Brush/Cement","2","2","1",12.3,0.1,49,0,29,25.1,-1,0,-1,-1,-1,-1,-2,-3
"3848",2019-03-01,"Cement Creek","w1819","Hybrid",0,"Fri","weekday","sled","Brush/Cement","2","2","1",12.3,0.1,49,0,29,25.1,-1,0,-1,-1,-1,-1,-2,-3
"3849",2019-03-02,"Cement Creek","w1819","Non.motorized",12,"Sat","weekend","no_sled","Brush/Cement","3","3","2",13,0.7,58,9,30,22.4,0,-1,0,-1,9,8,8,7
"3850",2019-03-02,"Cement Creek","w1819","Mechanized",0,"Sat","weekend","no_sled","Brush/Cement","3","3","2",13,0.7,58,9,30,22.4,0,-1,0,-1,9,8,8,7
"3851",2019-03-02,"Cement Creek","w1819","Motorized",2,"Sat","weekend","sled","Brush/Cement","3","3","2",13,0.7,58,9,30,22.4,0,-1,0,-1,9,8,8,7
"3852",2019-03-02,"Cement Creek","w1819","Hybrid",0,"Sat","weekend","sled","Brush/Cement","3","3","2",13,0.7,58,9,30,22.4,0,-1,0,-1,9,8,8,7
"3853",2019-03-03,"Cement Creek","w1819","Non.motorized",3,"Sun","weekend","no_sled","Brush/Cement","3","3","3",13.7,0.7,64,6,27,21.4,9,0,-1,0,15,15,14,14
"3854",2019-03-03,"Cement Creek","w1819","Mechanized",0,"Sun","weekend","no_sled","Brush/Cement","3","3","3",13.7,0.7,64,6,27,21.4,9,0,-1,0,15,15,14,14
"3855",2019-03-03,"Cement Creek","w1819","Motorized",0,"Sun","weekend","sled","Brush/Cement","3","3","3",13.7,0.7,64,6,27,21.4,9,0,-1,0,15,15,14,14
"3856",2019-03-03,"Cement Creek","w1819","Hybrid",0,"Sun","weekend","sled","Brush/Cement","3","3","3",13.7,0.7,64,6,27,21.4,9,0,-1,0,15,15,14,14
"3857",2019-03-04,"Cement Creek","w1819","Non.motorized",9,"Mon","weekday","no_sled","Brush/Cement","3","3","3",14.4,0.7,66,2,23,21.8,6,9,0,-1,8,17,17,16
"3858",2019-03-04,"Cement Creek","w1819","Mechanized",0,"Mon","weekday","no_sled","Brush/Cement","3","3","3",14.4,0.7,66,2,23,21.8,6,9,0,-1,8,17,17,16
"3859",2019-03-04,"Cement Creek","w1819","Motorized",4,"Mon","weekday","sled","Brush/Cement","3","3","3",14.4,0.7,66,2,23,21.8,6,9,0,-1,8,17,17,16
"3860",2019-03-04,"Cement Creek","w1819","Hybrid",0,"Mon","weekday","sled","Brush/Cement","3","3","3",14.4,0.7,66,2,23,21.8,6,9,0,-1,8,17,17,16
"3861",2019-03-05,"Cement Creek","w1819","Non.motorized",13,"Tue","weekday","no_sled","Brush/Cement","3","3","3",14.4,0,64,-2,24,22.5,2,6,9,0,0,6,15,15
"3862",2019-03-05,"Cement Creek","w1819","Mechanized",0,"Tue","weekday","no_sled","Brush/Cement","3","3","3",14.4,0,64,-2,24,22.5,2,6,9,0,0,6,15,15
"3863",2019-03-05,"Cement Creek","w1819","Motorized",3,"Tue","weekday","sled","Brush/Cement","3","3","3",14.4,0,64,-2,24,22.5,2,6,9,0,0,6,15,15
"3864",2019-03-05,"Cement Creek","w1819","Hybrid",0,"Tue","weekday","sled","Brush/Cement","3","3","3",14.4,0,64,-2,24,22.5,2,6,9,0,0,6,15,15
"3865",2019-03-06,"Cement Creek","w1819","Non.motorized",0,"Wed","weekday","no_sled","Brush/Cement","3","3","2",14.5,0.1,62,-2,31,23.4,-2,2,6,9,-4,-2,4,13
"3866",2019-03-06,"Cement Creek","w1819","Non.motorized",0,"Wed","weekday","no_sled","Brush/Cement","4","4","3",14.5,0.1,62,-2,31,23.4,-2,2,6,9,-4,-2,4,13
"3867",2019-03-06,"Cement Creek","w1819","Mechanized",0,"Wed","weekday","no_sled","Brush/Cement","3","3","2",14.5,0.1,62,-2,31,23.4,-2,2,6,9,-4,-2,4,13
"3868",2019-03-06,"Cement Creek","w1819","Mechanized",0,"Wed","weekday","no_sled","Brush/Cement","4","4","3",14.5,0.1,62,-2,31,23.4,-2,2,6,9,-4,-2,4,13
"3869",2019-03-06,"Cement Creek","w1819","Motorized",0,"Wed","weekday","sled","Brush/Cement","3","3","2",14.5,0.1,62,-2,31,23.4,-2,2,6,9,-4,-2,4,13
"3870",2019-03-06,"Cement Creek","w1819","Motorized",0,"Wed","weekday","sled","Brush/Cement","4","4","3",14.5,0.1,62,-2,31,23.4,-2,2,6,9,-4,-2,4,13
"3871",2019-03-06,"Cement Creek","w1819","Hybrid",0,"Wed","weekday","sled","Brush/Cement","3","3","2",14.5,0.1,62,-2,31,23.4,-2,2,6,9,-4,-2,4,13
"3872",2019-03-06,"Cement Creek","w1819","Hybrid",0,"Wed","weekday","sled","Brush/Cement","4","4","3",14.5,0.1,62,-2,31,23.4,-2,2,6,9,-4,-2,4,13
"3873",2019-03-07,"Cement Creek","w1819","Non.motorized",0,"Thu","weekday","no_sled","Brush/Cement","4","4","3",16.2,1.7,71,9,30,22.8,-2,-2,2,6,7,5,7,13
"3874",2019-03-07,"Cement Creek","w1819","Mechanized",0,"Thu","weekday","no_sled","Brush/Cement","4","4","3",16.2,1.7,71,9,30,22.8,-2,-2,2,6,7,5,7,13
"3875",2019-03-07,"Cement Creek","w1819","Motorized",0,"Thu","weekday","sled","Brush/Cement","4","4","3",16.2,1.7,71,9,30,22.8,-2,-2,2,6,7,5,7,13
"3876",2019-03-07,"Cement Creek","w1819","Hybrid",0,"Thu","weekday","sled","Brush/Cement","4","4","3",16.2,1.7,71,9,30,22.8,-2,-2,2,6,7,5,7,13
"3877",2019-03-08,"Cement Creek","w1819","Non.motorized",0,"Fri","weekday","no_sled","Brush/Cement","3","3","3",16.6,0.4,71,0,27,23.4,9,-2,-2,2,9,7,5,7
"3878",2019-03-08,"Cement Creek","w1819","Mechanized",0,"Fri","weekday","no_sled","Brush/Cement","3","3","3",16.6,0.4,71,0,27,23.4,9,-2,-2,2,9,7,5,7
"3879",2019-03-08,"Cement Creek","w1819","Motorized",0,"Fri","weekday","sled","Brush/Cement","3","3","3",16.6,0.4,71,0,27,23.4,9,-2,-2,2,9,7,5,7
"3880",2019-03-08,"Cement Creek","w1819","Hybrid",0,"Fri","weekday","sled","Brush/Cement","3","3","3",16.6,0.4,71,0,27,23.4,9,-2,-2,2,9,7,5,7
"3881",2019-03-09,"Cement Creek","w1819","Non.motorized",0,"Sat","weekend","no_sled","Brush/Cement","4","4","3",17.2,0.6,76,5,22,22.6,0,9,-2,-2,5,14,12,10
"3882",2019-03-09,"Cement Creek","w1819","Mechanized",0,"Sat","weekend","no_sled","Brush/Cement","4","4","3",17.2,0.6,76,5,22,22.6,0,9,-2,-2,5,14,12,10
"3883",2019-03-09,"Cement Creek","w1819","Motorized",1,"Sat","weekend","sled","Brush/Cement","4","4","3",17.2,0.6,76,5,22,22.6,0,9,-2,-2,5,14,12,10
"3884",2019-03-09,"Cement Creek","w1819","Hybrid",0,"Sat","weekend","sled","Brush/Cement","4","4","3",17.2,0.6,76,5,22,22.6,0,9,-2,-2,5,14,12,10
"3885",2019-03-10,"Cement Creek","w1819","Non.motorized",11,"Sun","weekend","no_sled","Brush/Cement","3","3","3",17.3,0.1,73,-3,25,23.7,5,0,9,-2,2,2,11,9
"3886",2019-03-10,"Cement Creek","w1819","Mechanized",0,"Sun","weekend","no_sled","Brush/Cement","3","3","3",17.3,0.1,73,-3,25,23.7,5,0,9,-2,2,2,11,9
"3887",2019-03-10,"Cement Creek","w1819","Motorized",3,"Sun","weekend","sled","Brush/Cement","3","3","3",17.3,0.1,73,-3,25,23.7,5,0,9,-2,2,2,11,9
"3888",2019-03-10,"Cement Creek","w1819","Hybrid",0,"Sun","weekend","sled","Brush/Cement","3","3","3",17.3,0.1,73,-3,25,23.7,5,0,9,-2,2,2,11,9
"3889",2019-03-11,"Cement Creek","w1819","Non.motorized",6,"Mon","weekday","no_sled","Brush/Cement","3","3","2",17.3,0,71,-2,29,24.4,-3,5,0,9,-5,0,0,9
"3890",2019-03-11,"Cement Creek","w1819","Mechanized",1,"Mon","weekday","no_sled","Brush/Cement","3","3","2",17.3,0,71,-2,29,24.4,-3,5,0,9,-5,0,0,9
"3891",2019-03-11,"Cement Creek","w1819","Motorized",2,"Mon","weekday","sled","Brush/Cement","3","3","2",17.3,0,71,-2,29,24.4,-3,5,0,9,-5,0,0,9
"3892",2019-03-11,"Cement Creek","w1819","Hybrid",0,"Mon","weekday","sled","Brush/Cement","3","3","2",17.3,0,71,-2,29,24.4,-3,5,0,9,-5,0,0,9
"3893",2019-03-12,"Cement Creek","w1819","Non.motorized",1,"Tue","weekday","no_sled","Brush/Cement","3","3","3",17.4,0.1,70,-1,32,24.9,-2,-3,5,0,-3,-6,-1,-1
"3894",2019-03-12,"Cement Creek","w1819","Non.motorized",1,"Tue","weekday","no_sled","Brush/Cement","4","4","4",17.4,0.1,70,-1,32,24.9,-2,-3,5,0,-3,-6,-1,-1
"3895",2019-03-12,"Cement Creek","w1819","Mechanized",0,"Tue","weekday","no_sled","Brush/Cement","3","3","3",17.4,0.1,70,-1,32,24.9,-2,-3,5,0,-3,-6,-1,-1
"3896",2019-03-12,"Cement Creek","w1819","Mechanized",0,"Tue","weekday","no_sled","Brush/Cement","4","4","4",17.4,0.1,70,-1,32,24.9,-2,-3,5,0,-3,-6,-1,-1
"3897",2019-03-12,"Cement Creek","w1819","Motorized",2,"Tue","weekday","sled","Brush/Cement","3","3","3",17.4,0.1,70,-1,32,24.9,-2,-3,5,0,-3,-6,-1,-1
"3898",2019-03-12,"Cement Creek","w1819","Motorized",2,"Tue","weekday","sled","Brush/Cement","4","4","4",17.4,0.1,70,-1,32,24.9,-2,-3,5,0,-3,-6,-1,-1
"3899",2019-03-12,"Cement Creek","w1819","Hybrid",0,"Tue","weekday","sled","Brush/Cement","3","3","3",17.4,0.1,70,-1,32,24.9,-2,-3,5,0,-3,-6,-1,-1
"3900",2019-03-12,"Cement Creek","w1819","Hybrid",0,"Tue","weekday","sled","Brush/Cement","4","4","4",17.4,0.1,70,-1,32,24.9,-2,-3,5,0,-3,-6,-1,-1
"3901",2019-03-13,"Cement Creek","w1819","Non.motorized",0,"Wed","weekday","no_sled","Brush/Cement","4","4","3",18.1,0.7,74,4,24,24.5,-1,-2,-3,5,3,1,-2,3
"3902",2019-03-13,"Cement Creek","w1819","Mechanized",0,"Wed","weekday","no_sled","Brush/Cement","4","4","3",18.1,0.7,74,4,24,24.5,-1,-2,-3,5,3,1,-2,3
"3903",2019-03-13,"Cement Creek","w1819","Motorized",0,"Wed","weekday","sled","Brush/Cement","4","4","3",18.1,0.7,74,4,24,24.5,-1,-2,-3,5,3,1,-2,3
"3904",2019-03-13,"Cement Creek","w1819","Hybrid",0,"Wed","weekday","sled","Brush/Cement","4","4","3",18.1,0.7,74,4,24,24.5,-1,-2,-3,5,3,1,-2,3
"3905",2019-03-14,"Cement Creek","w1819","Non.motorized",3,"Thu","weekday","no_sled","Brush/Cement","4","4","3",18.1,0,74,0,17,24.5,4,-1,-2,-3,4,3,1,-2
"3906",2019-03-14,"Cement Creek","w1819","Mechanized",0,"Thu","weekday","no_sled","Brush/Cement","4","4","3",18.1,0,74,0,17,24.5,4,-1,-2,-3,4,3,1,-2
"3907",2019-03-14,"Cement Creek","w1819","Motorized",2,"Thu","weekday","sled","Brush/Cement","4","4","3",18.1,0,74,0,17,24.5,4,-1,-2,-3,4,3,1,-2
"3908",2019-03-14,"Cement Creek","w1819","Hybrid",0,"Thu","weekday","sled","Brush/Cement","4","4","3",18.1,0,74,0,17,24.5,4,-1,-2,-3,4,3,1,-2
"3909",2019-03-15,"Cement Creek","w1819","Non.motorized",13,"Fri","weekday","no_sled","Brush/Cement","3","3","2",18.1,0,72,-2,18,25.1,0,4,-1,-2,-2,2,1,-1
"3910",2019-03-15,"Cement Creek","w1819","Mechanized",1,"Fri","weekday","no_sled","Brush/Cement","3","3","2",18.1,0,72,-2,18,25.1,0,4,-1,-2,-2,2,1,-1
"3911",2019-03-15,"Cement Creek","w1819","Motorized",2,"Fri","weekday","sled","Brush/Cement","3","3","2",18.1,0,72,-2,18,25.1,0,4,-1,-2,-2,2,1,-1
"3912",2019-03-15,"Cement Creek","w1819","Hybrid",0,"Fri","weekday","sled","Brush/Cement","3","3","2",18.1,0,72,-2,18,25.1,0,4,-1,-2,-2,2,1,-1
"3913",2019-03-16,"Cement Creek","w1819","Non.motorized",37,"Sat","weekend","no_sled","Brush/Cement","3","3","2",18.2,0.1,70,-2,26,26,-2,0,4,-1,-4,-4,0,-1
"3914",2019-03-16,"Cement Creek","w1819","Mechanized",0,"Sat","weekend","no_sled","Brush/Cement","3","3","2",18.2,0.1,70,-2,26,26,-2,0,4,-1,-4,-4,0,-1
"3915",2019-03-16,"Cement Creek","w1819","Motorized",8,"Sat","weekend","sled","Brush/Cement","3","3","2",18.2,0.1,70,-2,26,26,-2,0,4,-1,-4,-4,0,-1
"3916",2019-03-16,"Cement Creek","w1819","Hybrid",0,"Sat","weekend","sled","Brush/Cement","3","3","2",18.2,0.1,70,-2,26,26,-2,0,4,-1,-4,-4,0,-1
"3917",2019-03-17,"Cement Creek","w1819","Non.motorized",30,"Sun","weekend","no_sled","Brush/Cement","3","3","2",18.2,0,69,-1,28,26.4,-2,-2,0,4,-3,-5,-5,-1
"3918",2019-03-17,"Cement Creek","w1819","Mechanized",0,"Sun","weekend","no_sled","Brush/Cement","3","3","2",18.2,0,69,-1,28,26.4,-2,-2,0,4,-3,-5,-5,-1
"3919",2019-03-17,"Cement Creek","w1819","Motorized",6,"Sun","weekend","sled","Brush/Cement","3","3","2",18.2,0,69,-1,28,26.4,-2,-2,0,4,-3,-5,-5,-1
"3920",2019-03-17,"Cement Creek","w1819","Hybrid",0,"Sun","weekend","sled","Brush/Cement","3","3","2",18.2,0,69,-1,28,26.4,-2,-2,0,4,-3,-5,-5,-1
"3921",2019-03-18,"Cement Creek","w1819","Non.motorized",14,"Mon","weekday","no_sled","Brush/Cement","2","2","2",18.3,0.1,68,-1,29,26.9,-1,-2,-2,0,-2,-4,-6,-6
"3922",2019-03-18,"Cement Creek","w1819","Mechanized",0,"Mon","weekday","no_sled","Brush/Cement","2","2","2",18.3,0.1,68,-1,29,26.9,-1,-2,-2,0,-2,-4,-6,-6
"3923",2019-03-18,"Cement Creek","w1819","Motorized",1,"Mon","weekday","sled","Brush/Cement","2","2","2",18.3,0.1,68,-1,29,26.9,-1,-2,-2,0,-2,-4,-6,-6
"3924",2019-03-18,"Cement Creek","w1819","Hybrid",0,"Mon","weekday","sled","Brush/Cement","2","2","2",18.3,0.1,68,-1,29,26.9,-1,-2,-2,0,-2,-4,-6,-6
"3925",2019-03-19,"Cement Creek","w1819","Non.motorized",12,"Tue","weekday","no_sled","Brush/Cement","2","2","2",18.3,0,67,-1,28,27.3,-1,-1,-2,-2,-2,-3,-5,-7
"3926",2019-03-19,"Cement Creek","w1819","Mechanized",1,"Tue","weekday","no_sled","Brush/Cement","2","2","2",18.3,0,67,-1,28,27.3,-1,-1,-2,-2,-2,-3,-5,-7
"3927",2019-03-19,"Cement Creek","w1819","Motorized",4,"Tue","weekday","sled","Brush/Cement","2","2","2",18.3,0,67,-1,28,27.3,-1,-1,-2,-2,-2,-3,-5,-7
"3928",2019-03-19,"Cement Creek","w1819","Hybrid",0,"Tue","weekday","sled","Brush/Cement","2","2","2",18.3,0,67,-1,28,27.3,-1,-1,-2,-2,-2,-3,-5,-7
"3929",2019-03-20,"Cement Creek","w1819","Non.motorized",6,"Wed","weekday","no_sled","Brush/Cement","2","2","2",18.3,0,66,-1,30,27.7,-1,-1,-1,-2,-2,-3,-4,-6
"3930",2019-03-20,"Cement Creek","w1819","Mechanized",0,"Wed","weekday","no_sled","Brush/Cement","2","2","2",18.3,0,66,-1,30,27.7,-1,-1,-1,-2,-2,-3,-4,-6
"3931",2019-03-20,"Cement Creek","w1819","Motorized",2,"Wed","weekday","sled","Brush/Cement","2","2","2",18.3,0,66,-1,30,27.7,-1,-1,-1,-2,-2,-3,-4,-6
"3932",2019-03-20,"Cement Creek","w1819","Hybrid",0,"Wed","weekday","sled","Brush/Cement","2","2","2",18.3,0,66,-1,30,27.7,-1,-1,-1,-2,-2,-3,-4,-6
"3933",2019-03-21,"Cement Creek","w1819","Non.motorized",6,"Thu","weekday","no_sled","Brush/Cement","2","2","2",18.4,0.1,65,-1,33,28.3,-1,-1,-1,-1,-2,-3,-4,-5
"3934",2019-03-21,"Cement Creek","w1819","Mechanized",0,"Thu","weekday","no_sled","Brush/Cement","2","2","2",18.4,0.1,65,-1,33,28.3,-1,-1,-1,-1,-2,-3,-4,-5
"3935",2019-03-21,"Cement Creek","w1819","Motorized",3,"Thu","weekday","sled","Brush/Cement","2","2","2",18.4,0.1,65,-1,33,28.3,-1,-1,-1,-1,-2,-3,-4,-5
"3936",2019-03-21,"Cement Creek","w1819","Hybrid",0,"Thu","weekday","sled","Brush/Cement","2","2","2",18.4,0.1,65,-1,33,28.3,-1,-1,-1,-1,-2,-3,-4,-5
"3937",2019-03-22,"Cement Creek","w1819","Non.motorized",13,"Fri","weekday","no_sled","Brush/Cement","3","3","2",18.4,0,64,-1,28,28.8,-1,-1,-1,-1,-2,-3,-4,-5
"3938",2019-03-22,"Cement Creek","w1819","Mechanized",0,"Fri","weekday","no_sled","Brush/Cement","3","3","2",18.4,0,64,-1,28,28.8,-1,-1,-1,-1,-2,-3,-4,-5
"3939",2019-03-22,"Cement Creek","w1819","Motorized",5,"Fri","weekday","sled","Brush/Cement","3","3","2",18.4,0,64,-1,28,28.8,-1,-1,-1,-1,-2,-3,-4,-5
"3940",2019-03-22,"Cement Creek","w1819","Hybrid",0,"Fri","weekday","sled","Brush/Cement","3","3","2",18.4,0,64,-1,28,28.8,-1,-1,-1,-1,-2,-3,-4,-5
"3941",2019-03-23,"Cement Creek","w1819","Non.motorized",35,"Sat","weekend","no_sled","Brush/Cement","2","2","1",18.4,0,65,1,28,28.3,-1,-1,-1,-1,0,-1,-2,-3
"3942",2019-03-23,"Cement Creek","w1819","Mechanized",0,"Sat","weekend","no_sled","Brush/Cement","2","2","1",18.4,0,65,1,28,28.3,-1,-1,-1,-1,0,-1,-2,-3
"3943",2019-03-23,"Cement Creek","w1819","Motorized",7,"Sat","weekend","sled","Brush/Cement","2","2","1",18.4,0,65,1,28,28.3,-1,-1,-1,-1,0,-1,-2,-3
"3944",2019-03-23,"Cement Creek","w1819","Hybrid",2,"Sat","weekend","sled","Brush/Cement","2","2","1",18.4,0,65,1,28,28.3,-1,-1,-1,-1,0,-1,-2,-3
"3945",2019-03-24,"Cement Creek","w1819","Non.motorized",28,"Sun","weekend","no_sled","Brush/Cement","2","2","1",18.4,0,64,-1,29,28.8,1,-1,-1,-1,0,-1,-2,-3
"3946",2019-03-24,"Cement Creek","w1819","Mechanized",4,"Sun","weekend","no_sled","Brush/Cement","2","2","1",18.4,0,64,-1,29,28.8,1,-1,-1,-1,0,-1,-2,-3
"3947",2019-03-24,"Cement Creek","w1819","Motorized",1,"Sun","weekend","sled","Brush/Cement","2","2","1",18.4,0,64,-1,29,28.8,1,-1,-1,-1,0,-1,-2,-3
"3948",2019-03-24,"Cement Creek","w1819","Hybrid",0,"Sun","weekend","sled","Brush/Cement","2","2","1",18.4,0,64,-1,29,28.8,1,-1,-1,-1,0,-1,-2,-3
"3949",2019-03-25,"Cement Creek","w1819","Non.motorized",13,"Mon","weekday","no_sled","Brush/Cement","2","2","2",18.6,0.2,64,0,31,29.1,-1,1,-1,-1,-1,0,-1,-2
"3950",2019-03-25,"Cement Creek","w1819","Mechanized",0,"Mon","weekday","no_sled","Brush/Cement","2","2","2",18.6,0.2,64,0,31,29.1,-1,1,-1,-1,-1,0,-1,-2
"3951",2019-03-25,"Cement Creek","w1819","Motorized",4,"Mon","weekday","sled","Brush/Cement","2","2","2",18.6,0.2,64,0,31,29.1,-1,1,-1,-1,-1,0,-1,-2
"3952",2019-03-25,"Cement Creek","w1819","Hybrid",0,"Mon","weekday","sled","Brush/Cement","2","2","2",18.6,0.2,64,0,31,29.1,-1,1,-1,-1,-1,0,-1,-2
"3953",2019-03-26,"Cement Creek","w1819","Non.motorized",6,"Tue","weekday","no_sled","Brush/Cement","2","2","2",18.9,0.3,63,-1,36,30,0,-1,1,-1,-1,-2,-1,-2
"3954",2019-03-26,"Cement Creek","w1819","Mechanized",0,"Tue","weekday","no_sled","Brush/Cement","2","2","2",18.9,0.3,63,-1,36,30,0,-1,1,-1,-1,-2,-1,-2
"3955",2019-03-26,"Cement Creek","w1819","Motorized",5,"Tue","weekday","sled","Brush/Cement","2","2","2",18.9,0.3,63,-1,36,30,0,-1,1,-1,-1,-2,-1,-2
"3956",2019-03-26,"Cement Creek","w1819","Hybrid",0,"Tue","weekday","sled","Brush/Cement","2","2","2",18.9,0.3,63,-1,36,30,0,-1,1,-1,-1,-2,-1,-2
"3957",2019-03-27,"Cement Creek","w1819","Non.motorized",20,"Wed","weekday","no_sled","Brush/Cement","1","2","2",18.9,0,62,-1,42,30.5,-1,0,-1,1,-2,-2,-3,-2
"3958",2019-03-27,"Cement Creek","w1819","Mechanized",0,"Wed","weekday","no_sled","Brush/Cement","1","2","2",18.9,0,62,-1,42,30.5,-1,0,-1,1,-2,-2,-3,-2
"3959",2019-03-27,"Cement Creek","w1819","Motorized",6,"Wed","weekday","sled","Brush/Cement","1","2","2",18.9,0,62,-1,42,30.5,-1,0,-1,1,-2,-2,-3,-2
"3960",2019-03-27,"Cement Creek","w1819","Hybrid",0,"Wed","weekday","sled","Brush/Cement","1","2","2",18.9,0,62,-1,42,30.5,-1,0,-1,1,-2,-2,-3,-2
"3961",2019-03-28,"Cement Creek","w1819","Non.motorized",17,"Thu","weekday","no_sled","Brush/Cement","1","2","2",18.9,0,60,-2,40,31.5,-1,-1,0,-1,-3,-4,-4,-5
"3962",2019-03-28,"Cement Creek","w1819","Mechanized",0,"Thu","weekday","no_sled","Brush/Cement","1","2","2",18.9,0,60,-2,40,31.5,-1,-1,0,-1,-3,-4,-4,-5
"3963",2019-03-28,"Cement Creek","w1819","Motorized",1,"Thu","weekday","sled","Brush/Cement","1","2","2",18.9,0,60,-2,40,31.5,-1,-1,0,-1,-3,-4,-4,-5
"3964",2019-03-28,"Cement Creek","w1819","Hybrid",0,"Thu","weekday","sled","Brush/Cement","1","2","2",18.9,0,60,-2,40,31.5,-1,-1,0,-1,-3,-4,-4,-5
"3965",2019-03-29,"Cement Creek","w1819","Non.motorized",19,"Fri","weekday","no_sled","Brush/Cement","1","1","1",19,0.1,58,-2,26,32.8,-2,-1,-1,0,-4,-5,-6,-6
"3966",2019-03-29,"Cement Creek","w1819","Mechanized",1,"Fri","weekday","no_sled","Brush/Cement","1","1","1",19,0.1,58,-2,26,32.8,-2,-1,-1,0,-4,-5,-6,-6
"3967",2019-03-29,"Cement Creek","w1819","Motorized",1,"Fri","weekday","sled","Brush/Cement","1","1","1",19,0.1,58,-2,26,32.8,-2,-1,-1,0,-4,-5,-6,-6
"3968",2019-03-29,"Cement Creek","w1819","Hybrid",0,"Fri","weekday","sled","Brush/Cement","1","1","1",19,0.1,58,-2,26,32.8,-2,-1,-1,0,-4,-5,-6,-6
"3969",2019-03-30,"Cement Creek","w1819","Non.motorized",35,"Sat","weekend","no_sled","Brush/Cement","1","1","1",19.1,0.1,61,3,24,31.3,-2,-2,-1,-1,1,-1,-2,-3
"3970",2019-03-30,"Cement Creek","w1819","Mechanized",0,"Sat","weekend","no_sled","Brush/Cement","1","1","1",19.1,0.1,61,3,24,31.3,-2,-2,-1,-1,1,-1,-2,-3
"3971",2019-03-30,"Cement Creek","w1819","Motorized",1,"Sat","weekend","sled","Brush/Cement","1","1","1",19.1,0.1,61,3,24,31.3,-2,-2,-1,-1,1,-1,-2,-3
"3972",2019-03-30,"Cement Creek","w1819","Hybrid",0,"Sat","weekend","sled","Brush/Cement","1","1","1",19.1,0.1,61,3,24,31.3,-2,-2,-1,-1,1,-1,-2,-3
"3973",2019-03-31,"Cement Creek","w1819","Non.motorized",13,"Sun","weekend","no_sled","Brush/Cement","1","1","1",19.1,0,59,-2,24,32.4,3,-2,-2,-1,1,-1,-3,-4
"3974",2019-03-31,"Cement Creek","w1819","Mechanized",3,"Sun","weekend","no_sled","Brush/Cement","1","1","1",19.1,0,59,-2,24,32.4,3,-2,-2,-1,1,-1,-3,-4
"3975",2019-03-31,"Cement Creek","w1819","Motorized",2,"Sun","weekend","sled","Brush/Cement","1","1","1",19.1,0,59,-2,24,32.4,3,-2,-2,-1,1,-1,-3,-4
"3976",2019-03-31,"Cement Creek","w1819","Hybrid",0,"Sun","weekend","sled","Brush/Cement","1","1","1",19.1,0,59,-2,24,32.4,3,-2,-2,-1,1,-1,-3,-4
"3977",2019-04-01,"Cement Creek","w1819","Non.motorized",13,"Mon","weekday","no_sled","Brush/Cement","2","1","1",19.1,0,58,-1,29,32.9,-2,3,-2,-2,-3,0,-2,-4
"3978",2019-04-01,"Cement Creek","w1819","Mechanized",0,"Mon","weekday","no_sled","Brush/Cement","2","1","1",19.1,0,58,-1,29,32.9,-2,3,-2,-2,-3,0,-2,-4
"3979",2019-04-01,"Cement Creek","w1819","Motorized",3,"Mon","weekday","sled","Brush/Cement","2","1","1",19.1,0,58,-1,29,32.9,-2,3,-2,-2,-3,0,-2,-4
"3980",2019-04-01,"Cement Creek","w1819","Hybrid",0,"Mon","weekday","sled","Brush/Cement","2","1","1",19.1,0,58,-1,29,32.9,-2,3,-2,-2,-3,0,-2,-4
"3981",2019-04-02,"Cement Creek","w1819","Non.motorized",9,"Tue","weekday","no_sled","Brush/Cement","1","1","1",19.1,0,58,0,33,32.9,-1,-2,3,-2,-1,-3,0,-2
"3982",2019-04-02,"Cement Creek","w1819","Mechanized",1,"Tue","weekday","no_sled","Brush/Cement","1","1","1",19.1,0,58,0,33,32.9,-1,-2,3,-2,-1,-3,0,-2
"3983",2019-04-02,"Cement Creek","w1819","Motorized",0,"Tue","weekday","sled","Brush/Cement","1","1","1",19.1,0,58,0,33,32.9,-1,-2,3,-2,-1,-3,0,-2
"3984",2019-04-02,"Cement Creek","w1819","Hybrid",0,"Tue","weekday","sled","Brush/Cement","1","1","1",19.1,0,58,0,33,32.9,-1,-2,3,-2,-1,-3,0,-2
"3985",2019-04-03,"Cement Creek","w1819","Non.motorized",10,"Wed","weekday","no_sled","Brush/Cement","2","1","1",19.2,0.1,58,0,31,33.1,0,-1,-2,3,0,-1,-3,0
"3986",2019-04-03,"Cement Creek","w1819","Mechanized",0,"Wed","weekday","no_sled","Brush/Cement","2","1","1",19.2,0.1,58,0,31,33.1,0,-1,-2,3,0,-1,-3,0
"3987",2019-04-03,"Cement Creek","w1819","Motorized",3,"Wed","weekday","sled","Brush/Cement","2","1","1",19.2,0.1,58,0,31,33.1,0,-1,-2,3,0,-1,-3,0
"3988",2019-04-03,"Cement Creek","w1819","Hybrid",0,"Wed","weekday","sled","Brush/Cement","2","1","1",19.2,0.1,58,0,31,33.1,0,-1,-2,3,0,-1,-3,0
"3989",2019-04-04,"Cement Creek","w1819","Non.motorized",8,"Thu","weekday","no_sled","Brush/Cement","2","1","1",19.4,0.2,59,1,35,32.9,0,0,-1,-2,1,1,0,-2
"3990",2019-04-04,"Cement Creek","w1819","Mechanized",0,"Thu","weekday","no_sled","Brush/Cement","2","1","1",19.4,0.2,59,1,35,32.9,0,0,-1,-2,1,1,0,-2
"3991",2019-04-04,"Cement Creek","w1819","Motorized",1,"Thu","weekday","sled","Brush/Cement","2","1","1",19.4,0.2,59,1,35,32.9,0,0,-1,-2,1,1,0,-2
"3992",2019-04-04,"Cement Creek","w1819","Hybrid",0,"Thu","weekday","sled","Brush/Cement","2","1","1",19.4,0.2,59,1,35,32.9,0,0,-1,-2,1,1,0,-2
"3993",2019-04-05,"Cement Creek","w1819","Non.motorized",11,"Fri","weekday","no_sled","Brush/Cement","1","1","1",19.4,0,57,-2,38,34,1,0,0,-1,-1,-1,-1,-2
"3994",2019-04-05,"Cement Creek","w1819","Mechanized",5,"Fri","weekday","no_sled","Brush/Cement","1","1","1",19.4,0,57,-2,38,34,1,0,0,-1,-1,-1,-1,-2
"3995",2019-04-05,"Cement Creek","w1819","Motorized",2,"Fri","weekday","sled","Brush/Cement","1","1","1",19.4,0,57,-2,38,34,1,0,0,-1,-1,-1,-1,-2
"3996",2019-04-05,"Cement Creek","w1819","Hybrid",0,"Fri","weekday","sled","Brush/Cement","1","1","1",19.4,0,57,-2,38,34,1,0,0,-1,-1,-1,-1,-2
"3997",2019-04-06,"Cement Creek","w1819","Non.motorized",27,"Sat","weekend","no_sled","Brush/Cement","1","1","1",19.3,-0.1,57,0,35,33.9,-2,1,0,0,-2,-1,-1,-1
"3998",2019-04-06,"Cement Creek","w1819","Mechanized",2,"Sat","weekend","no_sled","Brush/Cement","1","1","1",19.3,-0.1,57,0,35,33.9,-2,1,0,0,-2,-1,-1,-1
"3999",2019-04-06,"Cement Creek","w1819","Motorized",5,"Sat","weekend","sled","Brush/Cement","1","1","1",19.3,-0.1,57,0,35,33.9,-2,1,0,0,-2,-1,-1,-1
"4000",2019-04-06,"Cement Creek","w1819","Hybrid",0,"Sat","weekend","sled","Brush/Cement","1","1","1",19.3,-0.1,57,0,35,33.9,-2,1,0,0,-2,-1,-1,-1
"4001",2019-04-07,"Cement Creek","w1819","Non.motorized",12,"Sun","weekend","no_sled","Brush/Cement","1","1","1",19.1,-0.2,57,0,37,33.5,0,-2,1,0,0,-2,-1,-1
"4002",2019-04-07,"Cement Creek","w1819","Mechanized",2,"Sun","weekend","no_sled","Brush/Cement","1","1","1",19.1,-0.2,57,0,37,33.5,0,-2,1,0,0,-2,-1,-1
"4003",2019-04-07,"Cement Creek","w1819","Motorized",2,"Sun","weekend","sled","Brush/Cement","1","1","1",19.1,-0.2,57,0,37,33.5,0,-2,1,0,0,-2,-1,-1
"4004",2019-04-07,"Cement Creek","w1819","Hybrid",0,"Sun","weekend","sled","Brush/Cement","1","1","1",19.1,-0.2,57,0,37,33.5,0,-2,1,0,0,-2,-1,-1
"4005",2019-04-08,"Cement Creek","w1819","Non.motorized",14,"Mon","weekday","no_sled","Brush/Cement","1","2","2",19.3,0.2,54,-3,41,35.7,0,0,-2,1,-3,-3,-5,-4
"4006",2019-04-08,"Cement Creek","w1819","Mechanized",0,"Mon","weekday","no_sled","Brush/Cement","1","2","2",19.3,0.2,54,-3,41,35.7,0,0,-2,1,-3,-3,-5,-4
"4007",2019-04-08,"Cement Creek","w1819","Motorized",1,"Mon","weekday","sled","Brush/Cement","1","2","2",19.3,0.2,54,-3,41,35.7,0,0,-2,1,-3,-3,-5,-4
"4008",2019-04-08,"Cement Creek","w1819","Hybrid",0,"Mon","weekday","sled","Brush/Cement","1","2","2",19.3,0.2,54,-3,41,35.7,0,0,-2,1,-3,-3,-5,-4
"4009",2019-04-09,"Cement Creek","w1819","Non.motorized",6,"Tue","weekday","no_sled","Brush/Cement","1","2","2",19.3,0,53,-1,43,36.4,-3,0,0,-2,-4,-4,-4,-6
"4010",2019-04-09,"Cement Creek","w1819","Mechanized",0,"Tue","weekday","no_sled","Brush/Cement","1","2","2",19.3,0,53,-1,43,36.4,-3,0,0,-2,-4,-4,-4,-6
"4011",2019-04-09,"Cement Creek","w1819","Motorized",2,"Tue","weekday","sled","Brush/Cement","1","2","2",19.3,0,53,-1,43,36.4,-3,0,0,-2,-4,-4,-4,-6
"4012",2019-04-09,"Cement Creek","w1819","Hybrid",0,"Tue","weekday","sled","Brush/Cement","1","2","2",19.3,0,53,-1,43,36.4,-3,0,0,-2,-4,-4,-4,-6
"4013",2019-04-10,"Cement Creek","w1819","Non.motorized",2,"Wed","weekday","no_sled","Brush/Cement","2","2","1",19,-0.3,51,-2,30,37.3,-1,-3,0,0,-3,-6,-6,-6
"4014",2019-04-10,"Cement Creek","w1819","Mechanized",0,"Wed","weekday","no_sled","Brush/Cement","2","2","1",19,-0.3,51,-2,30,37.3,-1,-3,0,0,-3,-6,-6,-6
"4015",2019-04-10,"Cement Creek","w1819","Motorized",0,"Wed","weekday","sled","Brush/Cement","2","2","1",19,-0.3,51,-2,30,37.3,-1,-3,0,0,-3,-6,-6,-6
"4016",2019-04-10,"Cement Creek","w1819","Hybrid",0,"Wed","weekday","sled","Brush/Cement","2","2","1",19,-0.3,51,-2,30,37.3,-1,-3,0,0,-3,-6,-6,-6
"4017",2019-04-11,"Cement Creek","w1819","Non.motorized",4,"Thu","weekday","no_sled","Brush/Cement","3","3","2",18.9,-0.1,53,2,20,35.7,-2,-1,-3,0,0,-1,-4,-4
"4018",2019-04-11,"Cement Creek","w1819","Mechanized",0,"Thu","weekday","no_sled","Brush/Cement","3","3","2",18.9,-0.1,53,2,20,35.7,-2,-1,-3,0,0,-1,-4,-4
"4019",2019-04-11,"Cement Creek","w1819","Motorized",4,"Thu","weekday","sled","Brush/Cement","3","3","2",18.9,-0.1,53,2,20,35.7,-2,-1,-3,0,0,-1,-4,-4
"4020",2019-04-11,"Cement Creek","w1819","Hybrid",0,"Thu","weekday","sled","Brush/Cement","3","3","2",18.9,-0.1,53,2,20,35.7,-2,-1,-3,0,0,-1,-4,-4
"4021",2019-04-12,"Cement Creek","w1819","Non.motorized",13,"Fri","weekday","no_sled","Brush/Cement","2","2","1",18.7,-0.2,53,0,24,35.3,2,-2,-1,-3,2,0,-1,-4
"4022",2019-04-12,"Cement Creek","w1819","Mechanized",1,"Fri","weekday","no_sled","Brush/Cement","2","2","1",18.7,-0.2,53,0,24,35.3,2,-2,-1,-3,2,0,-1,-4
"4023",2019-04-12,"Cement Creek","w1819","Motorized",0,"Fri","weekday","sled","Brush/Cement","2","2","1",18.7,-0.2,53,0,24,35.3,2,-2,-1,-3,2,0,-1,-4
"4024",2019-04-12,"Cement Creek","w1819","Hybrid",0,"Fri","weekday","sled","Brush/Cement","2","2","1",18.7,-0.2,53,0,24,35.3,2,-2,-1,-3,2,0,-1,-4
"4025",2019-04-13,"Cement Creek","w1819","Non.motorized",17,"Sat","weekend","no_sled","Brush/Cement","1","1","1",18.8,0.1,52,-1,27,36.2,0,2,-2,-1,-1,1,-1,-2
"4026",2019-04-13,"Cement Creek","w1819","Mechanized",3,"Sat","weekend","no_sled","Brush/Cement","1","1","1",18.8,0.1,52,-1,27,36.2,0,2,-2,-1,-1,1,-1,-2
"4027",2019-04-13,"Cement Creek","w1819","Motorized",3,"Sat","weekend","sled","Brush/Cement","1","1","1",18.8,0.1,52,-1,27,36.2,0,2,-2,-1,-1,1,-1,-2
"4028",2019-04-13,"Cement Creek","w1819","Hybrid",1,"Sat","weekend","sled","Brush/Cement","1","1","1",18.8,0.1,52,-1,27,36.2,0,2,-2,-1,-1,1,-1,-2
"4029",2019-04-14,"Cement Creek","w1819","Non.motorized",10,"Sun","weekend","no_sled","Brush/Cement","1","1","1",18.7,-0.1,51,-1,35,36.7,-1,0,2,-2,-2,-2,0,-2
"4030",2019-04-14,"Cement Creek","w1819","Mechanized",1,"Sun","weekend","no_sled","Brush/Cement","1","1","1",18.7,-0.1,51,-1,35,36.7,-1,0,2,-2,-2,-2,0,-2
"4031",2019-04-14,"Cement Creek","w1819","Motorized",8,"Sun","weekend","sled","Brush/Cement","1","1","1",18.7,-0.1,51,-1,35,36.7,-1,0,2,-2,-2,-2,0,-2
"4032",2019-04-14,"Cement Creek","w1819","Hybrid",5,"Sun","weekend","sled","Brush/Cement","1","1","1",18.7,-0.1,51,-1,35,36.7,-1,0,2,-2,-2,-2,0,-2
"4033",2019-04-15,"Cement Creek","w1819","Non.motorized",6,"Mon","weekday","no_sled","Brush/Cement",NA,NA,NA,18.6,-0.1,50,-1,41,37.2,-1,-1,0,2,-2,-3,-3,-1
"4034",2019-04-15,"Cement Creek","w1819","Mechanized",0,"Mon","weekday","no_sled","Brush/Cement",NA,NA,NA,18.6,-0.1,50,-1,41,37.2,-1,-1,0,2,-2,-3,-3,-1
"4035",2019-04-15,"Cement Creek","w1819","Motorized",1,"Mon","weekday","sled","Brush/Cement",NA,NA,NA,18.6,-0.1,50,-1,41,37.2,-1,-1,0,2,-2,-3,-3,-1
"4036",2019-04-15,"Cement Creek","w1819","Hybrid",0,"Mon","weekday","sled","Brush/Cement",NA,NA,NA,18.6,-0.1,50,-1,41,37.2,-1,-1,0,2,-2,-3,-3,-1
"4037",2018-12-01,"Gothic Rd","w1819","Non.motorized",23,"Sat","weekend","no_sled","East River","3","3","2",3.3,0.2,19,1,16,17.4,0,0,0,0,1,1,1,1
"4038",2018-12-01,"Gothic Rd","w1819","Mechanized",1,"Sat","weekend","no_sled","East River","3","3","2",3.3,0.2,19,1,16,17.4,0,0,0,0,1,1,1,1
"4039",2018-12-01,"Gothic Rd","w1819","Motorized",0,"Sat","weekend","sled","East River","3","3","2",3.3,0.2,19,1,16,17.4,0,0,0,0,1,1,1,1
"4040",2018-12-01,"Gothic Rd","w1819","Hybrid",0,"Sat","weekend","sled","East River","3","3","2",3.3,0.2,19,1,16,17.4,0,0,0,0,1,1,1,1
"4041",2018-12-02,"Gothic Rd","w1819","Non.motorized",25,"Sun","weekend","no_sled","East River","3","3","3",3.3,0,20,1,14,16.5,1,0,0,0,2,2,2,2
"4042",2018-12-02,"Gothic Rd","w1819","Mechanized",0,"Sun","weekend","no_sled","East River","3","3","3",3.3,0,20,1,14,16.5,1,0,0,0,2,2,2,2
"4043",2018-12-02,"Gothic Rd","w1819","Motorized",0,"Sun","weekend","sled","East River","3","3","3",3.3,0,20,1,14,16.5,1,0,0,0,2,2,2,2
"4044",2018-12-02,"Gothic Rd","w1819","Hybrid",0,"Sun","weekend","sled","East River","3","3","3",3.3,0,20,1,14,16.5,1,0,0,0,2,2,2,2
"4045",2018-12-03,"Gothic Rd","w1819","Non.motorized",14,"Mon","weekday","no_sled","East River","3","3","2",3.4,0.1,19,-1,13,17.9,1,1,0,0,0,1,1,1
"4046",2018-12-03,"Gothic Rd","w1819","Mechanized",0,"Mon","weekday","no_sled","East River","3","3","2",3.4,0.1,19,-1,13,17.9,1,1,0,0,0,1,1,1
"4047",2018-12-03,"Gothic Rd","w1819","Motorized",1,"Mon","weekday","sled","East River","3","3","2",3.4,0.1,19,-1,13,17.9,1,1,0,0,0,1,1,1
"4048",2018-12-03,"Gothic Rd","w1819","Hybrid",0,"Mon","weekday","sled","East River","3","3","2",3.4,0.1,19,-1,13,17.9,1,1,0,0,0,1,1,1
"4049",2018-12-04,"Gothic Rd","w1819","Non.motorized",9,"Tue","weekday","no_sled","East River","3","3","2",3.5,0.1,20,1,8,17.5,-1,1,1,0,0,1,2,2
"4050",2018-12-04,"Gothic Rd","w1819","Mechanized",1,"Tue","weekday","no_sled","East River","3","3","2",3.5,0.1,20,1,8,17.5,-1,1,1,0,0,1,2,2
"4051",2018-12-04,"Gothic Rd","w1819","Motorized",1,"Tue","weekday","sled","East River","3","3","2",3.5,0.1,20,1,8,17.5,-1,1,1,0,0,1,2,2
"4052",2018-12-04,"Gothic Rd","w1819","Hybrid",1,"Tue","weekday","sled","East River","3","3","2",3.5,0.1,20,1,8,17.5,-1,1,1,0,0,1,2,2
"4053",2018-12-05,"Gothic Rd","w1819","Non.motorized",19,"Wed","weekday","no_sled","East River","3","3","2",3.5,0,19,-1,21,18.4,1,-1,1,1,0,-1,0,1
"4054",2018-12-05,"Gothic Rd","w1819","Mechanized",0,"Wed","weekday","no_sled","East River","3","3","2",3.5,0,19,-1,21,18.4,1,-1,1,1,0,-1,0,1
"4055",2018-12-05,"Gothic Rd","w1819","Motorized",0,"Wed","weekday","sled","East River","3","3","2",3.5,0,19,-1,21,18.4,1,-1,1,1,0,-1,0,1
"4056",2018-12-05,"Gothic Rd","w1819","Hybrid",0,"Wed","weekday","sled","East River","3","3","2",3.5,0,19,-1,21,18.4,1,-1,1,1,0,-1,0,1
"4057",2018-12-06,"Gothic Rd","w1819","Non.motorized",14,"Thu","weekday","no_sled","East River","2","2","2",3.7,0.2,18,-1,25,20.6,-1,1,-1,1,-2,-1,-2,-1
"4058",2018-12-06,"Gothic Rd","w1819","Mechanized",0,"Thu","weekday","no_sled","East River","2","2","2",3.7,0.2,18,-1,25,20.6,-1,1,-1,1,-2,-1,-2,-1
"4059",2018-12-06,"Gothic Rd","w1819","Motorized",2,"Thu","weekday","sled","East River","2","2","2",3.7,0.2,18,-1,25,20.6,-1,1,-1,1,-2,-1,-2,-1
"4060",2018-12-06,"Gothic Rd","w1819","Hybrid",2,"Thu","weekday","sled","East River","2","2","2",3.7,0.2,18,-1,25,20.6,-1,1,-1,1,-2,-1,-2,-1
"4061",2018-12-07,"Gothic Rd","w1819","Non.motorized",13,"Fri","weekday","no_sled","East River","2","2","2",3.8,0.1,21,3,23,18.1,-1,-1,1,-1,2,1,2,1
"4062",2018-12-07,"Gothic Rd","w1819","Mechanized",0,"Fri","weekday","no_sled","East River","2","2","2",3.8,0.1,21,3,23,18.1,-1,-1,1,-1,2,1,2,1
"4063",2018-12-07,"Gothic Rd","w1819","Motorized",1,"Fri","weekday","sled","East River","2","2","2",3.8,0.1,21,3,23,18.1,-1,-1,1,-1,2,1,2,1
"4064",2018-12-07,"Gothic Rd","w1819","Hybrid",0,"Fri","weekday","sled","East River","2","2","2",3.8,0.1,21,3,23,18.1,-1,-1,1,-1,2,1,2,1
"4065",2018-12-08,"Gothic Rd","w1819","Non.motorized",38,"Sat","weekend","no_sled","East River","2","2","2",3.8,0,20,-1,23,19,3,-1,-1,1,2,1,0,1
"4066",2018-12-08,"Gothic Rd","w1819","Mechanized",5,"Sat","weekend","no_sled","East River","2","2","2",3.8,0,20,-1,23,19,3,-1,-1,1,2,1,0,1
"4067",2018-12-08,"Gothic Rd","w1819","Motorized",1,"Sat","weekend","sled","East River","2","2","2",3.8,0,20,-1,23,19,3,-1,-1,1,2,1,0,1
"4068",2018-12-08,"Gothic Rd","w1819","Hybrid",0,"Sat","weekend","sled","East River","2","2","2",3.8,0,20,-1,23,19,3,-1,-1,1,2,1,0,1
"4069",2018-12-09,"Gothic Rd","w1819","Non.motorized",32,"Sun","weekend","no_sled","East River","2","2","2",3.8,0,20,0,19,19,-1,3,-1,-1,-1,2,1,0
"4070",2018-12-09,"Gothic Rd","w1819","Mechanized",6,"Sun","weekend","no_sled","East River","2","2","2",3.8,0,20,0,19,19,-1,3,-1,-1,-1,2,1,0
"4071",2018-12-09,"Gothic Rd","w1819","Motorized",0,"Sun","weekend","sled","East River","2","2","2",3.8,0,20,0,19,19,-1,3,-1,-1,-1,2,1,0
"4072",2018-12-09,"Gothic Rd","w1819","Hybrid",0,"Sun","weekend","sled","East River","2","2","2",3.8,0,20,0,19,19,-1,3,-1,-1,-1,2,1,0
"4073",2018-12-10,"Gothic Rd","w1819","Non.motorized",12,"Mon","weekday","no_sled","East River","2","2","2",3.8,0,20,0,21,19,0,-1,3,-1,0,-1,2,1
"4074",2018-12-10,"Gothic Rd","w1819","Mechanized",2,"Mon","weekday","no_sled","East River","2","2","2",3.8,0,20,0,21,19,0,-1,3,-1,0,-1,2,1
"4075",2018-12-10,"Gothic Rd","w1819","Motorized",2,"Mon","weekday","sled","East River","2","2","2",3.8,0,20,0,21,19,0,-1,3,-1,0,-1,2,1
"4076",2018-12-10,"Gothic Rd","w1819","Hybrid",0,"Mon","weekday","sled","East River","2","2","2",3.8,0,20,0,21,19,0,-1,3,-1,0,-1,2,1
"4077",2018-12-11,"Gothic Rd","w1819","Non.motorized",18,"Tue","weekday","no_sled","East River","2","2","2",3.9,0.1,19,-1,27,20.5,0,0,-1,3,-1,-1,-2,1
"4078",2018-12-11,"Gothic Rd","w1819","Mechanized",1,"Tue","weekday","no_sled","East River","2","2","2",3.9,0.1,19,-1,27,20.5,0,0,-1,3,-1,-1,-2,1
"4079",2018-12-11,"Gothic Rd","w1819","Motorized",1,"Tue","weekday","sled","East River","2","2","2",3.9,0.1,19,-1,27,20.5,0,0,-1,3,-1,-1,-2,1
"4080",2018-12-11,"Gothic Rd","w1819","Hybrid",0,"Tue","weekday","sled","East River","2","2","2",3.9,0.1,19,-1,27,20.5,0,0,-1,3,-1,-1,-2,1
"4081",2018-12-12,"Gothic Rd","w1819","Non.motorized",13,"Wed","weekday","no_sled","East River","2","2","1",3.9,0,19,0,21,20.5,-1,0,0,-1,-1,-1,-1,-2
"4082",2018-12-12,"Gothic Rd","w1819","Mechanized",1,"Wed","weekday","no_sled","East River","2","2","1",3.9,0,19,0,21,20.5,-1,0,0,-1,-1,-1,-1,-2
"4083",2018-12-12,"Gothic Rd","w1819","Motorized",0,"Wed","weekday","sled","East River","2","2","1",3.9,0,19,0,21,20.5,-1,0,0,-1,-1,-1,-1,-2
"4084",2018-12-12,"Gothic Rd","w1819","Hybrid",0,"Wed","weekday","sled","East River","2","2","1",3.9,0,19,0,21,20.5,-1,0,0,-1,-1,-1,-1,-2
"4085",2018-12-13,"Gothic Rd","w1819","Non.motorized",9,"Thu","weekday","no_sled","East River","3","3","2",4,0.1,21,2,15,19,0,-1,0,0,2,1,1,1
"4086",2018-12-13,"Gothic Rd","w1819","Mechanized",2,"Thu","weekday","no_sled","East River","3","3","2",4,0.1,21,2,15,19,0,-1,0,0,2,1,1,1
"4087",2018-12-13,"Gothic Rd","w1819","Motorized",0,"Thu","weekday","sled","East River","3","3","2",4,0.1,21,2,15,19,0,-1,0,0,2,1,1,1
"4088",2018-12-13,"Gothic Rd","w1819","Hybrid",0,"Thu","weekday","sled","East River","3","3","2",4,0.1,21,2,15,19,0,-1,0,0,2,1,1,1
"4089",2018-12-14,"Gothic Rd","w1819","Non.motorized",0,"Fri","weekday","no_sled","East River","3","3","2",4,0,20,-1,24,20,2,0,-1,0,1,1,0,0
"4090",2018-12-14,"Gothic Rd","w1819","Mechanized",0,"Fri","weekday","no_sled","East River","3","3","2",4,0,20,-1,24,20,2,0,-1,0,1,1,0,0
"4091",2018-12-14,"Gothic Rd","w1819","Motorized",0,"Fri","weekday","sled","East River","3","3","2",4,0,20,-1,24,20,2,0,-1,0,1,1,0,0
"4092",2018-12-14,"Gothic Rd","w1819","Hybrid",0,"Fri","weekday","sled","East River","3","3","2",4,0,20,-1,24,20,2,0,-1,0,1,1,0,0
"4093",2018-12-15,"Gothic Rd","w1819","Non.motorized",9,"Sat","weekend","no_sled","East River","2","2","2",4,0,20,0,29,20,-1,2,0,-1,-1,1,1,0
"4094",2018-12-15,"Gothic Rd","w1819","Mechanized",6,"Sat","weekend","no_sled","East River","2","2","2",4,0,20,0,29,20,-1,2,0,-1,-1,1,1,0
"4095",2018-12-15,"Gothic Rd","w1819","Motorized",1,"Sat","weekend","sled","East River","2","2","2",4,0,20,0,29,20,-1,2,0,-1,-1,1,1,0
"4096",2018-12-15,"Gothic Rd","w1819","Hybrid",1,"Sat","weekend","sled","East River","2","2","2",4,0,20,0,29,20,-1,2,0,-1,-1,1,1,0
"4097",2018-12-16,"Gothic Rd","w1819","Non.motorized",63,"Sun","weekend","no_sled","East River","2","2","2",4.1,0.1,19,-1,28,21.6,0,-1,2,0,-1,-2,0,0
"4098",2018-12-16,"Gothic Rd","w1819","Mechanized",6,"Sun","weekend","no_sled","East River","2","2","2",4.1,0.1,19,-1,28,21.6,0,-1,2,0,-1,-2,0,0
"4099",2018-12-16,"Gothic Rd","w1819","Motorized",0,"Sun","weekend","sled","East River","2","2","2",4.1,0.1,19,-1,28,21.6,0,-1,2,0,-1,-2,0,0
"4100",2018-12-16,"Gothic Rd","w1819","Hybrid",0,"Sun","weekend","sled","East River","2","2","2",4.1,0.1,19,-1,28,21.6,0,-1,2,0,-1,-2,0,0
"4101",2018-12-17,"Gothic Rd","w1819","Non.motorized",16,"Mon","weekday","no_sled","East River","2","2","2",4.1,0,19,0,29,21.6,-1,0,-1,2,-1,-1,-2,0
"4102",2018-12-17,"Gothic Rd","w1819","Mechanized",4,"Mon","weekday","no_sled","East River","2","2","2",4.1,0,19,0,29,21.6,-1,0,-1,2,-1,-1,-2,0
"4103",2018-12-17,"Gothic Rd","w1819","Motorized",0,"Mon","weekday","sled","East River","2","2","2",4.1,0,19,0,29,21.6,-1,0,-1,2,-1,-1,-2,0
"4104",2018-12-17,"Gothic Rd","w1819","Hybrid",0,"Mon","weekday","sled","East River","2","2","2",4.1,0,19,0,29,21.6,-1,0,-1,2,-1,-1,-2,0
"4105",2018-12-18,"Gothic Rd","w1819","Non.motorized",0,"Tue","weekday","no_sled","East River","2","2","2",4.1,0,19,0,27,21.6,0,-1,0,-1,0,-1,-1,-2
"4106",2018-12-18,"Gothic Rd","w1819","Mechanized",0,"Tue","weekday","no_sled","East River","2","2","2",4.1,0,19,0,27,21.6,0,-1,0,-1,0,-1,-1,-2
"4107",2018-12-18,"Gothic Rd","w1819","Motorized",0,"Tue","weekday","sled","East River","2","2","2",4.1,0,19,0,27,21.6,0,-1,0,-1,0,-1,-1,-2
"4108",2018-12-18,"Gothic Rd","w1819","Hybrid",0,"Tue","weekday","sled","East River","2","2","2",4.1,0,19,0,27,21.6,0,-1,0,-1,0,-1,-1,-2
"4109",2018-12-19,"Gothic Rd","w1819","Non.motorized",28,"Wed","weekday","no_sled","East River","2","2","2",4.1,0,19,0,24,21.6,0,0,-1,0,0,0,-1,-1
"4110",2018-12-19,"Gothic Rd","w1819","Mechanized",0,"Wed","weekday","no_sled","East River","2","2","2",4.1,0,19,0,24,21.6,0,0,-1,0,0,0,-1,-1
"4111",2018-12-19,"Gothic Rd","w1819","Motorized",0,"Wed","weekday","sled","East River","2","2","2",4.1,0,19,0,24,21.6,0,0,-1,0,0,0,-1,-1
"4112",2018-12-19,"Gothic Rd","w1819","Hybrid",0,"Wed","weekday","sled","East River","2","2","2",4.1,0,19,0,24,21.6,0,0,-1,0,0,0,-1,-1
"4113",2018-12-20,"Gothic Rd","w1819","Non.motorized",42,"Thu","weekday","no_sled","East River","2","2","1",4.1,0,20,1,25,20.5,0,0,0,-1,1,1,1,0
"4114",2018-12-20,"Gothic Rd","w1819","Mechanized",2,"Thu","weekday","no_sled","East River","2","2","1",4.1,0,20,1,25,20.5,0,0,0,-1,1,1,1,0
"4115",2018-12-20,"Gothic Rd","w1819","Motorized",1,"Thu","weekday","sled","East River","2","2","1",4.1,0,20,1,25,20.5,0,0,0,-1,1,1,1,0
"4116",2018-12-20,"Gothic Rd","w1819","Hybrid",0,"Thu","weekday","sled","East River","2","2","1",4.1,0,20,1,25,20.5,0,0,0,-1,1,1,1,0
"4117",2018-12-21,"Gothic Rd","w1819","Non.motorized",46,"Fri","weekday","no_sled","East River","2","2","1",4.1,0,19,-1,28,21.6,1,0,0,0,0,0,0,0
"4118",2018-12-21,"Gothic Rd","w1819","Mechanized",6,"Fri","weekday","no_sled","East River","2","2","1",4.1,0,19,-1,28,21.6,1,0,0,0,0,0,0,0
"4119",2018-12-21,"Gothic Rd","w1819","Motorized",0,"Fri","weekday","sled","East River","2","2","1",4.1,0,19,-1,28,21.6,1,0,0,0,0,0,0,0
"4120",2018-12-21,"Gothic Rd","w1819","Hybrid",0,"Fri","weekday","sled","East River","2","2","1",4.1,0,19,-1,28,21.6,1,0,0,0,0,0,0,0
"4121",2018-12-22,"Gothic Rd","w1819","Non.motorized",54,"Sat","weekend","no_sled","East River","2","2","1",4.2,0.1,19,0,20,22.1,-1,1,0,0,-1,0,0,0
"4122",2018-12-22,"Gothic Rd","w1819","Mechanized",0,"Sat","weekend","no_sled","East River","2","2","1",4.2,0.1,19,0,20,22.1,-1,1,0,0,-1,0,0,0
"4123",2018-12-22,"Gothic Rd","w1819","Motorized",0,"Sat","weekend","sled","East River","2","2","1",4.2,0.1,19,0,20,22.1,-1,1,0,0,-1,0,0,0
"4124",2018-12-22,"Gothic Rd","w1819","Hybrid",0,"Sat","weekend","sled","East River","2","2","1",4.2,0.1,19,0,20,22.1,-1,1,0,0,-1,0,0,0
"4125",2018-12-23,"Gothic Rd","w1819","Non.motorized",44,"Sun","weekend","no_sled","East River","2","2","1",4.2,0,21,2,19,20,0,-1,1,0,2,1,2,2
"4126",2018-12-23,"Gothic Rd","w1819","Mechanized",4,"Sun","weekend","no_sled","East River","2","2","1",4.2,0,21,2,19,20,0,-1,1,0,2,1,2,2
"4127",2018-12-23,"Gothic Rd","w1819","Motorized",0,"Sun","weekend","sled","East River","2","2","1",4.2,0,21,2,19,20,0,-1,1,0,2,1,2,2
"4128",2018-12-23,"Gothic Rd","w1819","Hybrid",0,"Sun","weekend","sled","East River","2","2","1",4.2,0,21,2,19,20,0,-1,1,0,2,1,2,2
"4129",2018-12-24,"Gothic Rd","w1819","Non.motorized",NA,"Mon","weekday","no_sled","East River","2","2","2",4.3,0.1,20,-1,21,21.5,2,0,-1,1,1,1,0,1
"4130",2018-12-24,"Gothic Rd","w1819","Mechanized",NA,"Mon","weekday","no_sled","East River","2","2","2",4.3,0.1,20,-1,21,21.5,2,0,-1,1,1,1,0,1
"4131",2018-12-24,"Gothic Rd","w1819","Motorized",NA,"Mon","weekday","sled","East River","2","2","2",4.3,0.1,20,-1,21,21.5,2,0,-1,1,1,1,0,1
"4132",2018-12-24,"Gothic Rd","w1819","Hybrid",NA,"Mon","weekday","sled","East River","2","2","2",4.3,0.1,20,-1,21,21.5,2,0,-1,1,1,1,0,1
"4133",2018-12-25,"Gothic Rd","w1819","Non.motorized",NA,"Tue","weekday","no_sled","East River","2","2","2",4.7,0.4,25,5,25,18.8,-1,2,0,-1,4,6,6,5
"4134",2018-12-25,"Gothic Rd","w1819","Mechanized",NA,"Tue","weekday","no_sled","East River","2","2","2",4.7,0.4,25,5,25,18.8,-1,2,0,-1,4,6,6,5
"4135",2018-12-25,"Gothic Rd","w1819","Motorized",NA,"Tue","weekday","sled","East River","2","2","2",4.7,0.4,25,5,25,18.8,-1,2,0,-1,4,6,6,5
"4136",2018-12-25,"Gothic Rd","w1819","Hybrid",NA,"Tue","weekday","sled","East River","2","2","2",4.7,0.4,25,5,25,18.8,-1,2,0,-1,4,6,6,5
"4137",2018-12-26,"Gothic Rd","w1819","Non.motorized",NA,"Wed","weekday","no_sled","East River","3","3","3",4.7,0,23,-2,24,20.4,5,-1,2,0,3,2,4,4
"4138",2018-12-26,"Gothic Rd","w1819","Mechanized",NA,"Wed","weekday","no_sled","East River","3","3","3",4.7,0,23,-2,24,20.4,5,-1,2,0,3,2,4,4
"4139",2018-12-26,"Gothic Rd","w1819","Motorized",NA,"Wed","weekday","sled","East River","3","3","3",4.7,0,23,-2,24,20.4,5,-1,2,0,3,2,4,4
"4140",2018-12-26,"Gothic Rd","w1819","Hybrid",NA,"Wed","weekday","sled","East River","3","3","3",4.7,0,23,-2,24,20.4,5,-1,2,0,3,2,4,4
"4141",2018-12-27,"Gothic Rd","w1819","Non.motorized",NA,"Thu","weekday","no_sled","East River","3","3","2",4.7,0,24,1,12,19.6,-2,5,-1,2,-1,4,3,5
"4142",2018-12-27,"Gothic Rd","w1819","Mechanized",NA,"Thu","weekday","no_sled","East River","3","3","2",4.7,0,24,1,12,19.6,-2,5,-1,2,-1,4,3,5
"4143",2018-12-27,"Gothic Rd","w1819","Motorized",NA,"Thu","weekday","sled","East River","3","3","2",4.7,0,24,1,12,19.6,-2,5,-1,2,-1,4,3,5
"4144",2018-12-27,"Gothic Rd","w1819","Hybrid",NA,"Thu","weekday","sled","East River","3","3","2",4.7,0,24,1,12,19.6,-2,5,-1,2,-1,4,3,5
"4145",2018-12-28,"Gothic Rd","w1819","Non.motorized",1,"Fri","weekday","no_sled","East River","3","3","2",4.7,0,24,0,12,19.6,1,-2,5,-1,1,-1,4,3
"4146",2018-12-28,"Gothic Rd","w1819","Mechanized",0,"Fri","weekday","no_sled","East River","3","3","2",4.7,0,24,0,12,19.6,1,-2,5,-1,1,-1,4,3
"4147",2018-12-28,"Gothic Rd","w1819","Motorized",0,"Fri","weekday","sled","East River","3","3","2",4.7,0,24,0,12,19.6,1,-2,5,-1,1,-1,4,3
"4148",2018-12-28,"Gothic Rd","w1819","Hybrid",0,"Fri","weekday","sled","East River","3","3","2",4.7,0,24,0,12,19.6,1,-2,5,-1,1,-1,4,3
"4149",2018-12-29,"Gothic Rd","w1819","Non.motorized",126,"Sat","weekend","no_sled","East River","3","3","2",4.7,0,24,0,8,19.6,0,1,-2,5,0,1,-1,4
"4150",2018-12-29,"Gothic Rd","w1819","Mechanized",6,"Sat","weekend","no_sled","East River","3","3","2",4.7,0,24,0,8,19.6,0,1,-2,5,0,1,-1,4
"4151",2018-12-29,"Gothic Rd","w1819","Motorized",8,"Sat","weekend","sled","East River","3","3","2",4.7,0,24,0,8,19.6,0,1,-2,5,0,1,-1,4
"4152",2018-12-29,"Gothic Rd","w1819","Hybrid",0,"Sat","weekend","sled","East River","3","3","2",4.7,0,24,0,8,19.6,0,1,-2,5,0,1,-1,4
"4153",2018-12-30,"Gothic Rd","w1819","Non.motorized",79,"Sun","weekend","no_sled","East River","3","3","2",4.7,0,24,0,16,19.6,0,0,1,-2,0,0,1,-1
"4154",2018-12-30,"Gothic Rd","w1819","Mechanized",13,"Sun","weekend","no_sled","East River","3","3","2",4.7,0,24,0,16,19.6,0,0,1,-2,0,0,1,-1
"4155",2018-12-30,"Gothic Rd","w1819","Motorized",0,"Sun","weekend","sled","East River","3","3","2",4.7,0,24,0,16,19.6,0,0,1,-2,0,0,1,-1
"4156",2018-12-30,"Gothic Rd","w1819","Hybrid",0,"Sun","weekend","sled","East River","3","3","2",4.7,0,24,0,16,19.6,0,0,1,-2,0,0,1,-1
"4157",2018-12-31,"Gothic Rd","w1819","Non.motorized",4,"Mon","weekday","no_sled","East River","3","3","3",4.9,0.2,23,-1,14,21.3,0,0,0,1,-1,-1,-1,0
"4158",2018-12-31,"Gothic Rd","w1819","Mechanized",0,"Mon","weekday","no_sled","East River","3","3","3",4.9,0.2,23,-1,14,21.3,0,0,0,1,-1,-1,-1,0
"4159",2018-12-31,"Gothic Rd","w1819","Motorized",0,"Mon","weekday","sled","East River","3","3","3",4.9,0.2,23,-1,14,21.3,0,0,0,1,-1,-1,-1,0
"4160",2018-12-31,"Gothic Rd","w1819","Hybrid",0,"Mon","weekday","sled","East River","3","3","3",4.9,0.2,23,-1,14,21.3,0,0,0,1,-1,-1,-1,0
"4161",2019-01-01,"Gothic Rd","w1819","Non.motorized",60,"Tue","weekday","no_sled","East River","3","3","3",5.1,0.2,29,6,11,17.6,-1,0,0,0,5,5,5,5
"4162",2019-01-01,"Gothic Rd","w1819","Mechanized",3,"Tue","weekday","no_sled","East River","3","3","3",5.1,0.2,29,6,11,17.6,-1,0,0,0,5,5,5,5
"4163",2019-01-01,"Gothic Rd","w1819","Motorized",0,"Tue","weekday","sled","East River","3","3","3",5.1,0.2,29,6,11,17.6,-1,0,0,0,5,5,5,5
"4164",2019-01-01,"Gothic Rd","w1819","Hybrid",0,"Tue","weekday","sled","East River","3","3","3",5.1,0.2,29,6,11,17.6,-1,0,0,0,5,5,5,5
"4165",2019-01-02,"Gothic Rd","w1819","Non.motorized",48,"Wed","weekday","no_sled","East River","3","3","2",5.1,0,28,-1,10,18.2,6,-1,0,0,5,4,4,4
"4166",2019-01-02,"Gothic Rd","w1819","Mechanized",1,"Wed","weekday","no_sled","East River","3","3","2",5.1,0,28,-1,10,18.2,6,-1,0,0,5,4,4,4
"4167",2019-01-02,"Gothic Rd","w1819","Motorized",1,"Wed","weekday","sled","East River","3","3","2",5.1,0,28,-1,10,18.2,6,-1,0,0,5,4,4,4
"4168",2019-01-02,"Gothic Rd","w1819","Hybrid",0,"Wed","weekday","sled","East River","3","3","2",5.1,0,28,-1,10,18.2,6,-1,0,0,5,4,4,4
"4169",2019-01-03,"Gothic Rd","w1819","Non.motorized",53,"Thu","weekday","no_sled","East River","3","3","2",5.1,0,27,-1,22,18.9,-1,6,-1,0,-2,4,3,3
"4170",2019-01-03,"Gothic Rd","w1819","Mechanized",0,"Thu","weekday","no_sled","East River","3","3","2",5.1,0,27,-1,22,18.9,-1,6,-1,0,-2,4,3,3
"4171",2019-01-03,"Gothic Rd","w1819","Motorized",0,"Thu","weekday","sled","East River","3","3","2",5.1,0,27,-1,22,18.9,-1,6,-1,0,-2,4,3,3
"4172",2019-01-03,"Gothic Rd","w1819","Hybrid",0,"Thu","weekday","sled","East River","3","3","2",5.1,0,27,-1,22,18.9,-1,6,-1,0,-2,4,3,3
"4173",2019-01-04,"Gothic Rd","w1819","Non.motorized",7,"Fri","weekday","no_sled","East River","3","3","2",5.3,0.2,26,-1,29,20.4,-1,-1,6,-1,-2,-3,3,2
"4174",2019-01-04,"Gothic Rd","w1819","Mechanized",2,"Fri","weekday","no_sled","East River","3","3","2",5.3,0.2,26,-1,29,20.4,-1,-1,6,-1,-2,-3,3,2
"4175",2019-01-04,"Gothic Rd","w1819","Motorized",0,"Fri","weekday","sled","East River","3","3","2",5.3,0.2,26,-1,29,20.4,-1,-1,6,-1,-2,-3,3,2
"4176",2019-01-04,"Gothic Rd","w1819","Hybrid",0,"Fri","weekday","sled","East River","3","3","2",5.3,0.2,26,-1,29,20.4,-1,-1,6,-1,-2,-3,3,2
"4177",2019-01-05,"Gothic Rd","w1819","Non.motorized",0,"Sat","weekend","no_sled","East River","2","2","2",5.3,0,25,-1,30,21.2,-1,-1,-1,6,-2,-3,-4,2
"4178",2019-01-05,"Gothic Rd","w1819","Mechanized",0,"Sat","weekend","no_sled","East River","2","2","2",5.3,0,25,-1,30,21.2,-1,-1,-1,6,-2,-3,-4,2
"4179",2019-01-05,"Gothic Rd","w1819","Motorized",0,"Sat","weekend","sled","East River","2","2","2",5.3,0,25,-1,30,21.2,-1,-1,-1,6,-2,-3,-4,2
"4180",2019-01-05,"Gothic Rd","w1819","Hybrid",0,"Sat","weekend","sled","East River","2","2","2",5.3,0,25,-1,30,21.2,-1,-1,-1,6,-2,-3,-4,2
"4181",2019-01-06,"Gothic Rd","w1819","Non.motorized",0,"Sun","weekend","no_sled","East River","3","3","3",5.3,0,25,0,26,21.2,-1,-1,-1,-1,-1,-2,-3,-4
"4182",2019-01-06,"Gothic Rd","w1819","Mechanized",0,"Sun","weekend","no_sled","East River","3","3","3",5.3,0,25,0,26,21.2,-1,-1,-1,-1,-1,-2,-3,-4
"4183",2019-01-06,"Gothic Rd","w1819","Motorized",0,"Sun","weekend","sled","East River","3","3","3",5.3,0,25,0,26,21.2,-1,-1,-1,-1,-1,-2,-3,-4
"4184",2019-01-06,"Gothic Rd","w1819","Hybrid",0,"Sun","weekend","sled","East River","3","3","3",5.3,0,25,0,26,21.2,-1,-1,-1,-1,-1,-2,-3,-4
"4185",2019-01-07,"Gothic Rd","w1819","Non.motorized",0,"Mon","weekday","no_sled","East River","3","3","3",5.8,0.5,32,7,21,18.1,0,-1,-1,-1,7,6,5,4
"4186",2019-01-07,"Gothic Rd","w1819","Mechanized",0,"Mon","weekday","no_sled","East River","3","3","3",5.8,0.5,32,7,21,18.1,0,-1,-1,-1,7,6,5,4
"4187",2019-01-07,"Gothic Rd","w1819","Motorized",0,"Mon","weekday","sled","East River","3","3","3",5.8,0.5,32,7,21,18.1,0,-1,-1,-1,7,6,5,4
"4188",2019-01-07,"Gothic Rd","w1819","Hybrid",0,"Mon","weekday","sled","East River","3","3","3",5.8,0.5,32,7,21,18.1,0,-1,-1,-1,7,6,5,4
"4189",2019-01-08,"Gothic Rd","w1819","Non.motorized",0,"Tue","weekday","no_sled","East River","3","3","3",5.9,0.1,32,0,24,18.4,7,0,-1,-1,7,7,6,5
"4190",2019-01-08,"Gothic Rd","w1819","Mechanized",0,"Tue","weekday","no_sled","East River","3","3","3",5.9,0.1,32,0,24,18.4,7,0,-1,-1,7,7,6,5
"4191",2019-01-08,"Gothic Rd","w1819","Motorized",0,"Tue","weekday","sled","East River","3","3","3",5.9,0.1,32,0,24,18.4,7,0,-1,-1,7,7,6,5
"4192",2019-01-08,"Gothic Rd","w1819","Hybrid",0,"Tue","weekday","sled","East River","3","3","3",5.9,0.1,32,0,24,18.4,7,0,-1,-1,7,7,6,5
"4193",2019-01-09,"Gothic Rd","w1819","Non.motorized",22,"Wed","weekday","no_sled","East River","3","3","3",6,0.1,30,-2,29,20,0,7,0,-1,-2,5,5,4
"4194",2019-01-09,"Gothic Rd","w1819","Mechanized",0,"Wed","weekday","no_sled","East River","3","3","3",6,0.1,30,-2,29,20,0,7,0,-1,-2,5,5,4
"4195",2019-01-09,"Gothic Rd","w1819","Motorized",0,"Wed","weekday","sled","East River","3","3","3",6,0.1,30,-2,29,20,0,7,0,-1,-2,5,5,4
"4196",2019-01-09,"Gothic Rd","w1819","Hybrid",0,"Wed","weekday","sled","East River","3","3","3",6,0.1,30,-2,29,20,0,7,0,-1,-2,5,5,4
"4197",2019-01-10,"Gothic Rd","w1819","Non.motorized",37,"Thu","weekday","no_sled","East River","3","3","3",6,0,29,-1,29,20.7,-2,0,7,0,-3,-3,4,4
"4198",2019-01-10,"Gothic Rd","w1819","Mechanized",3,"Thu","weekday","no_sled","East River","3","3","3",6,0,29,-1,29,20.7,-2,0,7,0,-3,-3,4,4
"4199",2019-01-10,"Gothic Rd","w1819","Motorized",0,"Thu","weekday","sled","East River","3","3","3",6,0,29,-1,29,20.7,-2,0,7,0,-3,-3,4,4
"4200",2019-01-10,"Gothic Rd","w1819","Hybrid",0,"Thu","weekday","sled","East River","3","3","3",6,0,29,-1,29,20.7,-2,0,7,0,-3,-3,4,4
"4201",2019-01-11,"Gothic Rd","w1819","Non.motorized",47,"Fri","weekday","no_sled","East River","2","2","2",6.1,0.1,29,0,25,21,-1,-2,0,7,-1,-3,-3,4
"4202",2019-01-11,"Gothic Rd","w1819","Mechanized",2,"Fri","weekday","no_sled","East River","2","2","2",6.1,0.1,29,0,25,21,-1,-2,0,7,-1,-3,-3,4
"4203",2019-01-11,"Gothic Rd","w1819","Motorized",0,"Fri","weekday","sled","East River","2","2","2",6.1,0.1,29,0,25,21,-1,-2,0,7,-1,-3,-3,4
"4204",2019-01-11,"Gothic Rd","w1819","Hybrid",0,"Fri","weekday","sled","East River","2","2","2",6.1,0.1,29,0,25,21,-1,-2,0,7,-1,-3,-3,4
"4205",2019-01-12,"Gothic Rd","w1819","Non.motorized",48,"Sat","weekend","no_sled","East River","3","3","2",6.1,0,28,-1,21,21.8,0,-1,-2,0,-1,-2,-4,-4
"4206",2019-01-12,"Gothic Rd","w1819","Mechanized",1,"Sat","weekend","no_sled","East River","3","3","2",6.1,0,28,-1,21,21.8,0,-1,-2,0,-1,-2,-4,-4
"4207",2019-01-12,"Gothic Rd","w1819","Motorized",0,"Sat","weekend","sled","East River","3","3","2",6.1,0,28,-1,21,21.8,0,-1,-2,0,-1,-2,-4,-4
"4208",2019-01-12,"Gothic Rd","w1819","Hybrid",0,"Sat","weekend","sled","East River","3","3","2",6.1,0,28,-1,21,21.8,0,-1,-2,0,-1,-2,-4,-4
"4209",2019-01-13,"Gothic Rd","w1819","Non.motorized",0,"Sun","weekend","no_sled","East River","2","2","2",6.2,0.1,30,2,18,20.7,-1,0,-1,-2,1,1,0,-2
"4210",2019-01-13,"Gothic Rd","w1819","Mechanized",0,"Sun","weekend","no_sled","East River","2","2","2",6.2,0.1,30,2,18,20.7,-1,0,-1,-2,1,1,0,-2
"4211",2019-01-13,"Gothic Rd","w1819","Motorized",0,"Sun","weekend","sled","East River","2","2","2",6.2,0.1,30,2,18,20.7,-1,0,-1,-2,1,1,0,-2
"4212",2019-01-13,"Gothic Rd","w1819","Hybrid",0,"Sun","weekend","sled","East River","2","2","2",6.2,0.1,30,2,18,20.7,-1,0,-1,-2,1,1,0,-2
"4213",2019-01-14,"Gothic Rd","w1819","Non.motorized",11,"Mon","weekday","no_sled","East River","2","2","2",6.2,0,30,0,18,20.7,2,-1,0,-1,2,1,1,0
"4214",2019-01-14,"Gothic Rd","w1819","Mechanized",0,"Mon","weekday","no_sled","East River","2","2","2",6.2,0,30,0,18,20.7,2,-1,0,-1,2,1,1,0
"4215",2019-01-14,"Gothic Rd","w1819","Motorized",1,"Mon","weekday","sled","East River","2","2","2",6.2,0,30,0,18,20.7,2,-1,0,-1,2,1,1,0
"4216",2019-01-14,"Gothic Rd","w1819","Hybrid",0,"Mon","weekday","sled","East River","2","2","2",6.2,0,30,0,18,20.7,2,-1,0,-1,2,1,1,0
"4217",2019-01-15,"Gothic Rd","w1819","Non.motorized",40,"Tue","weekday","no_sled","East River","2","2","2",6.2,0,29,-1,24,21.4,0,2,-1,0,-1,1,0,0
"4218",2019-01-15,"Gothic Rd","w1819","Mechanized",1,"Tue","weekday","no_sled","East River","2","2","2",6.2,0,29,-1,24,21.4,0,2,-1,0,-1,1,0,0
"4219",2019-01-15,"Gothic Rd","w1819","Motorized",0,"Tue","weekday","sled","East River","2","2","2",6.2,0,29,-1,24,21.4,0,2,-1,0,-1,1,0,0
"4220",2019-01-15,"Gothic Rd","w1819","Hybrid",0,"Tue","weekday","sled","East River","2","2","2",6.2,0,29,-1,24,21.4,0,2,-1,0,-1,1,0,0
"4221",2019-01-16,"Gothic Rd","w1819","Non.motorized",9,"Wed","weekday","no_sled","East River","4","4","3",6.3,0.1,29,0,26,21.7,-1,0,2,-1,-1,-1,1,0
"4222",2019-01-16,"Gothic Rd","w1819","Mechanized",0,"Wed","weekday","no_sled","East River","4","4","3",6.3,0.1,29,0,26,21.7,-1,0,2,-1,-1,-1,1,0
"4223",2019-01-16,"Gothic Rd","w1819","Motorized",0,"Wed","weekday","sled","East River","4","4","3",6.3,0.1,29,0,26,21.7,-1,0,2,-1,-1,-1,1,0
"4224",2019-01-16,"Gothic Rd","w1819","Hybrid",0,"Wed","weekday","sled","East River","4","4","3",6.3,0.1,29,0,26,21.7,-1,0,2,-1,-1,-1,1,0
"4225",2019-01-17,"Gothic Rd","w1819","Non.motorized",14,"Thu","weekday","no_sled","East River","3","3","2",7,0.7,38,9,28,18.4,0,-1,0,2,9,8,8,10
"4226",2019-01-17,"Gothic Rd","w1819","Mechanized",0,"Thu","weekday","no_sled","East River","3","3","2",7,0.7,38,9,28,18.4,0,-1,0,2,9,8,8,10
"4227",2019-01-17,"Gothic Rd","w1819","Motorized",0,"Thu","weekday","sled","East River","3","3","2",7,0.7,38,9,28,18.4,0,-1,0,2,9,8,8,10
"4228",2019-01-17,"Gothic Rd","w1819","Hybrid",0,"Thu","weekday","sled","East River","3","3","2",7,0.7,38,9,28,18.4,0,-1,0,2,9,8,8,10
"4229",2019-01-18,"Gothic Rd","w1819","Non.motorized",1,"Fri","weekday","no_sled","East River","4","4","4",7.5,0.5,41,3,22,18.3,9,0,-1,0,12,12,11,11
"4230",2019-01-18,"Gothic Rd","w1819","Mechanized",0,"Fri","weekday","no_sled","East River","4","4","4",7.5,0.5,41,3,22,18.3,9,0,-1,0,12,12,11,11
"4231",2019-01-18,"Gothic Rd","w1819","Motorized",0,"Fri","weekday","sled","East River","4","4","4",7.5,0.5,41,3,22,18.3,9,0,-1,0,12,12,11,11
"4232",2019-01-18,"Gothic Rd","w1819","Hybrid",0,"Fri","weekday","sled","East River","4","4","4",7.5,0.5,41,3,22,18.3,9,0,-1,0,12,12,11,11
"4233",2019-01-19,"Gothic Rd","w1819","Non.motorized",105,"Sat","weekend","no_sled","East River","3","3","3",7.8,0.3,43,2,20,18.1,3,9,0,-1,5,14,14,13
"4234",2019-01-19,"Gothic Rd","w1819","Mechanized",0,"Sat","weekend","no_sled","East River","3","3","3",7.8,0.3,43,2,20,18.1,3,9,0,-1,5,14,14,13
"4235",2019-01-19,"Gothic Rd","w1819","Motorized",2,"Sat","weekend","sled","East River","3","3","3",7.8,0.3,43,2,20,18.1,3,9,0,-1,5,14,14,13
"4236",2019-01-19,"Gothic Rd","w1819","Hybrid",0,"Sat","weekend","sled","East River","3","3","3",7.8,0.3,43,2,20,18.1,3,9,0,-1,5,14,14,13
"4237",2019-01-20,"Gothic Rd","w1819","Non.motorized",137,"Sun","weekend","no_sled","East River","3","3","3",7.9,0.1,41,-2,27,19.3,2,3,9,0,0,3,12,12
"4238",2019-01-20,"Gothic Rd","w1819","Mechanized",3,"Sun","weekend","no_sled","East River","3","3","3",7.9,0.1,41,-2,27,19.3,2,3,9,0,0,3,12,12
"4239",2019-01-20,"Gothic Rd","w1819","Motorized",12,"Sun","weekend","sled","East River","3","3","3",7.9,0.1,41,-2,27,19.3,2,3,9,0,0,3,12,12
"4240",2019-01-20,"Gothic Rd","w1819","Hybrid",0,"Sun","weekend","sled","East River","3","3","3",7.9,0.1,41,-2,27,19.3,2,3,9,0,0,3,12,12
"4241",2019-01-21,"Gothic Rd","w1819","Non.motorized",NA,"Mon","weekday","no_sled","East River","3","3","3",7.9,0,39,-2,23,20.3,-2,2,3,9,-4,-2,1,10
"4242",2019-01-21,"Gothic Rd","w1819","Mechanized",NA,"Mon","weekday","no_sled","East River","3","3","3",7.9,0,39,-2,23,20.3,-2,2,3,9,-4,-2,1,10
"4243",2019-01-21,"Gothic Rd","w1819","Motorized",NA,"Mon","weekday","sled","East River","3","3","3",7.9,0,39,-2,23,20.3,-2,2,3,9,-4,-2,1,10
"4244",2019-01-21,"Gothic Rd","w1819","Hybrid",NA,"Mon","weekday","sled","East River","3","3","3",7.9,0,39,-2,23,20.3,-2,2,3,9,-4,-2,1,10
"4245",2019-01-22,"Gothic Rd","w1819","Non.motorized",19,"Tue","weekday","no_sled","East River","3","3","3",8,0.1,41,2,12,19.5,-2,-2,2,3,0,-2,0,3
"4246",2019-01-22,"Gothic Rd","w1819","Mechanized",0,"Tue","weekday","no_sled","East River","3","3","3",8,0.1,41,2,12,19.5,-2,-2,2,3,0,-2,0,3
"4247",2019-01-22,"Gothic Rd","w1819","Motorized",2,"Tue","weekday","sled","East River","3","3","3",8,0.1,41,2,12,19.5,-2,-2,2,3,0,-2,0,3
"4248",2019-01-22,"Gothic Rd","w1819","Hybrid",0,"Tue","weekday","sled","East River","3","3","3",8,0.1,41,2,12,19.5,-2,-2,2,3,0,-2,0,3
"4249",2019-01-23,"Gothic Rd","w1819","Non.motorized",17,"Wed","weekday","no_sled","East River","3","3","2",8,0,40,-1,14,20,2,-2,-2,2,1,-1,-3,-1
"4250",2019-01-23,"Gothic Rd","w1819","Mechanized",0,"Wed","weekday","no_sled","East River","3","3","2",8,0,40,-1,14,20,2,-2,-2,2,1,-1,-3,-1
"4251",2019-01-23,"Gothic Rd","w1819","Motorized",0,"Wed","weekday","sled","East River","3","3","2",8,0,40,-1,14,20,2,-2,-2,2,1,-1,-3,-1
"4252",2019-01-23,"Gothic Rd","w1819","Hybrid",0,"Wed","weekday","sled","East River","3","3","2",8,0,40,-1,14,20,2,-2,-2,2,1,-1,-3,-1
"4253",2019-01-24,"Gothic Rd","w1819","Non.motorized",8,"Thu","weekday","no_sled","East River","3","3","2",8.2,0.2,40,0,17,20.5,-1,2,-2,-2,-1,1,-1,-3
"4254",2019-01-24,"Gothic Rd","w1819","Mechanized",12,"Thu","weekday","no_sled","East River","3","3","2",8.2,0.2,40,0,17,20.5,-1,2,-2,-2,-1,1,-1,-3
"4255",2019-01-24,"Gothic Rd","w1819","Motorized",1,"Thu","weekday","sled","East River","3","3","2",8.2,0.2,40,0,17,20.5,-1,2,-2,-2,-1,1,-1,-3
"4256",2019-01-24,"Gothic Rd","w1819","Hybrid",0,"Thu","weekday","sled","East River","3","3","2",8.2,0.2,40,0,17,20.5,-1,2,-2,-2,-1,1,-1,-3
"4257",2019-01-25,"Gothic Rd","w1819","Non.motorized",38,"Fri","weekday","no_sled","East River","3","3","2",8.3,0.1,40,0,15,20.8,0,-1,2,-2,0,-1,1,-1
"4258",2019-01-25,"Gothic Rd","w1819","Mechanized",50,"Fri","weekday","no_sled","East River","3","3","2",8.3,0.1,40,0,15,20.8,0,-1,2,-2,0,-1,1,-1
"4259",2019-01-25,"Gothic Rd","w1819","Motorized",0,"Fri","weekday","sled","East River","3","3","2",8.3,0.1,40,0,15,20.8,0,-1,2,-2,0,-1,1,-1
"4260",2019-01-25,"Gothic Rd","w1819","Hybrid",0,"Fri","weekday","sled","East River","3","3","2",8.3,0.1,40,0,15,20.8,0,-1,2,-2,0,-1,1,-1
"4261",2019-01-26,"Gothic Rd","w1819","Non.motorized",111,"Sat","weekend","no_sled","East River","3","3","2",8.3,0,39,-1,19,21.3,0,0,-1,2,-1,-1,-2,0
"4262",2019-01-26,"Gothic Rd","w1819","Mechanized",6,"Sat","weekend","no_sled","East River","3","3","2",8.3,0,39,-1,19,21.3,0,0,-1,2,-1,-1,-2,0
"4263",2019-01-26,"Gothic Rd","w1819","Motorized",3,"Sat","weekend","sled","East River","3","3","2",8.3,0,39,-1,19,21.3,0,0,-1,2,-1,-1,-2,0
"4264",2019-01-26,"Gothic Rd","w1819","Hybrid",0,"Sat","weekend","sled","East River","3","3","2",8.3,0,39,-1,19,21.3,0,0,-1,2,-1,-1,-2,0
"4265",2019-01-27,"Gothic Rd","w1819","Non.motorized",61,"Sun","weekend","no_sled","East River","3","3","2",8.3,0,38,-1,24,21.8,-1,0,0,-1,-2,-2,-2,-3
"4266",2019-01-27,"Gothic Rd","w1819","Mechanized",2,"Sun","weekend","no_sled","East River","3","3","2",8.3,0,38,-1,24,21.8,-1,0,0,-1,-2,-2,-2,-3
"4267",2019-01-27,"Gothic Rd","w1819","Motorized",0,"Sun","weekend","sled","East River","3","3","2",8.3,0,38,-1,24,21.8,-1,0,0,-1,-2,-2,-2,-3
"4268",2019-01-27,"Gothic Rd","w1819","Hybrid",0,"Sun","weekend","sled","East River","3","3","2",8.3,0,38,-1,24,21.8,-1,0,0,-1,-2,-2,-2,-3
"4269",2019-01-28,"Gothic Rd","w1819","Non.motorized",3,"Mon","weekday","no_sled","East River","2","2","2",8.3,0,38,0,17,21.8,-1,-1,0,0,-1,-2,-2,-2
"4270",2019-01-28,"Gothic Rd","w1819","Mechanized",0,"Mon","weekday","no_sled","East River","2","2","2",8.3,0,38,0,17,21.8,-1,-1,0,0,-1,-2,-2,-2
"4271",2019-01-28,"Gothic Rd","w1819","Motorized",0,"Mon","weekday","sled","East River","2","2","2",8.3,0,38,0,17,21.8,-1,-1,0,0,-1,-2,-2,-2
"4272",2019-01-28,"Gothic Rd","w1819","Hybrid",0,"Mon","weekday","sled","East River","2","2","2",8.3,0,38,0,17,21.8,-1,-1,0,0,-1,-2,-2,-2
"4273",2019-01-29,"Gothic Rd","w1819","Non.motorized",0,"Tue","weekday","no_sled","East River","2","2","2",8.3,0,38,0,16,21.8,0,-1,-1,0,0,-1,-2,-2
"4274",2019-01-29,"Gothic Rd","w1819","Mechanized",0,"Tue","weekday","no_sled","East River","2","2","2",8.3,0,38,0,16,21.8,0,-1,-1,0,0,-1,-2,-2
"4275",2019-01-29,"Gothic Rd","w1819","Motorized",0,"Tue","weekday","sled","East River","2","2","2",8.3,0,38,0,16,21.8,0,-1,-1,0,0,-1,-2,-2
"4276",2019-01-29,"Gothic Rd","w1819","Hybrid",0,"Tue","weekday","sled","East River","2","2","2",8.3,0,38,0,16,21.8,0,-1,-1,0,0,-1,-2,-2
"4277",2019-01-30,"Gothic Rd","w1819","Non.motorized",0,"Wed","weekday","no_sled","East River","2","2","1",8.3,0,37,-1,20,22.4,0,0,-1,-1,-1,-1,-2,-3
"4278",2019-01-30,"Gothic Rd","w1819","Mechanized",0,"Wed","weekday","no_sled","East River","2","2","1",8.3,0,37,-1,20,22.4,0,0,-1,-1,-1,-1,-2,-3
"4279",2019-01-30,"Gothic Rd","w1819","Motorized",0,"Wed","weekday","sled","East River","2","2","1",8.3,0,37,-1,20,22.4,0,0,-1,-1,-1,-1,-2,-3
"4280",2019-01-30,"Gothic Rd","w1819","Hybrid",0,"Wed","weekday","sled","East River","2","2","1",8.3,0,37,-1,20,22.4,0,0,-1,-1,-1,-1,-2,-3
"4281",2019-01-31,"Gothic Rd","w1819","Non.motorized",0,"Thu","weekday","no_sled","East River","2","2","1",8.3,0,36,-1,24,23.1,-1,0,0,-1,-2,-2,-2,-3
"4282",2019-01-31,"Gothic Rd","w1819","Mechanized",0,"Thu","weekday","no_sled","East River","2","2","1",8.3,0,36,-1,24,23.1,-1,0,0,-1,-2,-2,-2,-3
"4283",2019-01-31,"Gothic Rd","w1819","Motorized",0,"Thu","weekday","sled","East River","2","2","1",8.3,0,36,-1,24,23.1,-1,0,0,-1,-2,-2,-2,-3
"4284",2019-01-31,"Gothic Rd","w1819","Hybrid",0,"Thu","weekday","sled","East River","2","2","1",8.3,0,36,-1,24,23.1,-1,0,0,-1,-2,-2,-2,-3
"4285",2019-02-01,"Gothic Rd","w1819","Non.motorized",6,"Fri","weekday","no_sled","East River","2","2","1",8.3,0,36,0,25,23.1,-1,-1,0,0,-1,-2,-2,-2
"4286",2019-02-01,"Gothic Rd","w1819","Mechanized",1,"Fri","weekday","no_sled","East River","2","2","1",8.3,0,36,0,25,23.1,-1,-1,0,0,-1,-2,-2,-2
"4287",2019-02-01,"Gothic Rd","w1819","Motorized",0,"Fri","weekday","sled","East River","2","2","1",8.3,0,36,0,25,23.1,-1,-1,0,0,-1,-2,-2,-2
"4288",2019-02-01,"Gothic Rd","w1819","Hybrid",0,"Fri","weekday","sled","East River","2","2","1",8.3,0,36,0,25,23.1,-1,-1,0,0,-1,-2,-2,-2
"4289",2019-02-02,"Gothic Rd","w1819","Non.motorized",72,"Sat","weekend","no_sled","East River","2","2","1",8.3,0,36,0,26,23.1,0,-1,-1,0,0,-1,-2,-2
"4290",2019-02-02,"Gothic Rd","w1819","Mechanized",9,"Sat","weekend","no_sled","East River","2","2","1",8.3,0,36,0,26,23.1,0,-1,-1,0,0,-1,-2,-2
"4291",2019-02-02,"Gothic Rd","w1819","Motorized",0,"Sat","weekend","sled","East River","2","2","1",8.3,0,36,0,26,23.1,0,-1,-1,0,0,-1,-2,-2
"4292",2019-02-02,"Gothic Rd","w1819","Hybrid",0,"Sat","weekend","sled","East River","2","2","1",8.3,0,36,0,26,23.1,0,-1,-1,0,0,-1,-2,-2
"4293",2019-02-03,"Gothic Rd","w1819","Non.motorized",25,"Sun","weekend","no_sled","East River","3","3","2",8.4,0.1,36,0,28,23.3,0,0,-1,-1,0,0,-1,-2
"4294",2019-02-03,"Gothic Rd","w1819","Mechanized",2,"Sun","weekend","no_sled","East River","3","3","2",8.4,0.1,36,0,28,23.3,0,0,-1,-1,0,0,-1,-2
"4295",2019-02-03,"Gothic Rd","w1819","Motorized",0,"Sun","weekend","sled","East River","3","3","2",8.4,0.1,36,0,28,23.3,0,0,-1,-1,0,0,-1,-2
"4296",2019-02-03,"Gothic Rd","w1819","Hybrid",0,"Sun","weekend","sled","East River","3","3","2",8.4,0.1,36,0,28,23.3,0,0,-1,-1,0,0,-1,-2
"4297",2019-02-04,"Gothic Rd","w1819","Non.motorized",22,"Mon","weekday","no_sled","East River","3","3","2",8.8,0.4,39,3,28,22.6,0,0,0,-1,3,3,3,2
"4298",2019-02-04,"Gothic Rd","w1819","Mechanized",0,"Mon","weekday","no_sled","East River","3","3","2",8.8,0.4,39,3,28,22.6,0,0,0,-1,3,3,3,2
"4299",2019-02-04,"Gothic Rd","w1819","Motorized",0,"Mon","weekday","sled","East River","3","3","2",8.8,0.4,39,3,28,22.6,0,0,0,-1,3,3,3,2
"4300",2019-02-04,"Gothic Rd","w1819","Hybrid",0,"Mon","weekday","sled","East River","3","3","2",8.8,0.4,39,3,28,22.6,0,0,0,-1,3,3,3,2
"4301",2019-02-05,"Gothic Rd","w1819","Non.motorized",6,"Tue","weekday","no_sled","East River","3","2","2",9,0.2,40,1,26,22.5,3,0,0,0,4,4,4,4
"4302",2019-02-05,"Gothic Rd","w1819","Mechanized",0,"Tue","weekday","no_sled","East River","3","2","2",9,0.2,40,1,26,22.5,3,0,0,0,4,4,4,4
"4303",2019-02-05,"Gothic Rd","w1819","Motorized",0,"Tue","weekday","sled","East River","3","2","2",9,0.2,40,1,26,22.5,3,0,0,0,4,4,4,4
"4304",2019-02-05,"Gothic Rd","w1819","Hybrid",0,"Tue","weekday","sled","East River","3","2","2",9,0.2,40,1,26,22.5,3,0,0,0,4,4,4,4
"4305",2019-02-06,"Gothic Rd","w1819","Non.motorized",18,"Wed","weekday","no_sled","East River","4","4","3",9,0,40,0,16,22.5,1,3,0,0,1,4,4,4
"4306",2019-02-06,"Gothic Rd","w1819","Mechanized",0,"Wed","weekday","no_sled","East River","4","4","3",9,0,40,0,16,22.5,1,3,0,0,1,4,4,4
"4307",2019-02-06,"Gothic Rd","w1819","Motorized",0,"Wed","weekday","sled","East River","4","4","3",9,0,40,0,16,22.5,1,3,0,0,1,4,4,4
"4308",2019-02-06,"Gothic Rd","w1819","Hybrid",0,"Wed","weekday","sled","East River","4","4","3",9,0,40,0,16,22.5,1,3,0,0,1,4,4,4
"4309",2019-02-07,"Gothic Rd","w1819","Non.motorized",10,"Thu","weekday","no_sled","East River","3","3","2",9.2,0.2,43,3,4,21.4,0,1,3,0,3,4,7,7
"4310",2019-02-07,"Gothic Rd","w1819","Mechanized",0,"Thu","weekday","no_sled","East River","3","3","2",9.2,0.2,43,3,4,21.4,0,1,3,0,3,4,7,7
"4311",2019-02-07,"Gothic Rd","w1819","Motorized",0,"Thu","weekday","sled","East River","3","3","2",9.2,0.2,43,3,4,21.4,0,1,3,0,3,4,7,7
"4312",2019-02-07,"Gothic Rd","w1819","Hybrid",0,"Thu","weekday","sled","East River","3","3","2",9.2,0.2,43,3,4,21.4,0,1,3,0,3,4,7,7
"4313",2019-02-08,"Gothic Rd","w1819","Non.motorized",24,"Fri","weekday","no_sled","East River","3","2","2",9.2,0,42,-1,10,21.9,3,0,1,3,2,2,3,6
"4314",2019-02-08,"Gothic Rd","w1819","Mechanized",0,"Fri","weekday","no_sled","East River","3","2","2",9.2,0,42,-1,10,21.9,3,0,1,3,2,2,3,6
"4315",2019-02-08,"Gothic Rd","w1819","Motorized",0,"Fri","weekday","sled","East River","3","2","2",9.2,0,42,-1,10,21.9,3,0,1,3,2,2,3,6
"4316",2019-02-08,"Gothic Rd","w1819","Hybrid",0,"Fri","weekday","sled","East River","3","2","2",9.2,0,42,-1,10,21.9,3,0,1,3,2,2,3,6
"4317",2019-02-09,"Gothic Rd","w1819","Non.motorized",59,"Sat","weekend","no_sled","East River","3","2","2",9.2,0,41,-1,20,22.4,-1,3,0,1,-2,1,1,2
"4318",2019-02-09,"Gothic Rd","w1819","Mechanized",2,"Sat","weekend","no_sled","East River","3","2","2",9.2,0,41,-1,20,22.4,-1,3,0,1,-2,1,1,2
"4319",2019-02-09,"Gothic Rd","w1819","Motorized",0,"Sat","weekend","sled","East River","3","2","2",9.2,0,41,-1,20,22.4,-1,3,0,1,-2,1,1,2
"4320",2019-02-09,"Gothic Rd","w1819","Hybrid",0,"Sat","weekend","sled","East River","3","2","2",9.2,0,41,-1,20,22.4,-1,3,0,1,-2,1,1,2
"4321",2019-02-10,"Gothic Rd","w1819","Non.motorized",68,"Sun","weekend","no_sled","East River","2","2","2",9.3,0.1,40,-1,20,23.2,-1,-1,3,0,-2,-3,0,0
"4322",2019-02-10,"Gothic Rd","w1819","Mechanized",5,"Sun","weekend","no_sled","East River","2","2","2",9.3,0.1,40,-1,20,23.2,-1,-1,3,0,-2,-3,0,0
"4323",2019-02-10,"Gothic Rd","w1819","Motorized",0,"Sun","weekend","sled","East River","2","2","2",9.3,0.1,40,-1,20,23.2,-1,-1,3,0,-2,-3,0,0
"4324",2019-02-10,"Gothic Rd","w1819","Hybrid",0,"Sun","weekend","sled","East River","2","2","2",9.3,0.1,40,-1,20,23.2,-1,-1,3,0,-2,-3,0,0
"4325",2019-02-11,"Gothic Rd","w1819","Non.motorized",31,"Mon","weekday","no_sled","East River","2","2","1",9.3,0,40,0,15,23.2,-1,-1,-1,3,-1,-2,-3,0
"4326",2019-02-11,"Gothic Rd","w1819","Mechanized",0,"Mon","weekday","no_sled","East River","2","2","1",9.3,0,40,0,15,23.2,-1,-1,-1,3,-1,-2,-3,0
"4327",2019-02-11,"Gothic Rd","w1819","Motorized",0,"Mon","weekday","sled","East River","2","2","1",9.3,0,40,0,15,23.2,-1,-1,-1,3,-1,-2,-3,0
"4328",2019-02-11,"Gothic Rd","w1819","Hybrid",0,"Mon","weekday","sled","East River","2","2","1",9.3,0,40,0,15,23.2,-1,-1,-1,3,-1,-2,-3,0
"4329",2019-02-12,"Gothic Rd","w1819","Non.motorized",31,"Tue","weekday","no_sled","East River","2","2","1",9.3,0,40,0,18,23.2,0,-1,-1,-1,0,-1,-2,-3
"4330",2019-02-12,"Gothic Rd","w1819","Mechanized",3,"Tue","weekday","no_sled","East River","2","2","1",9.3,0,40,0,18,23.2,0,-1,-1,-1,0,-1,-2,-3
"4331",2019-02-12,"Gothic Rd","w1819","Motorized",0,"Tue","weekday","sled","East River","2","2","1",9.3,0,40,0,18,23.2,0,-1,-1,-1,0,-1,-2,-3
"4332",2019-02-12,"Gothic Rd","w1819","Hybrid",0,"Tue","weekday","sled","East River","2","2","1",9.3,0,40,0,18,23.2,0,-1,-1,-1,0,-1,-2,-3
"4333",2019-02-13,"Gothic Rd","w1819","Non.motorized",21,"Wed","weekday","no_sled","East River","2","2","1",9.4,0.1,40,0,26,23.5,0,0,-1,-1,0,0,-1,-2
"4334",2019-02-13,"Gothic Rd","w1819","Mechanized",2,"Wed","weekday","no_sled","East River","2","2","1",9.4,0.1,40,0,26,23.5,0,0,-1,-1,0,0,-1,-2
"4335",2019-02-13,"Gothic Rd","w1819","Motorized",0,"Wed","weekday","sled","East River","2","2","1",9.4,0.1,40,0,26,23.5,0,0,-1,-1,0,0,-1,-2
"4336",2019-02-13,"Gothic Rd","w1819","Hybrid",0,"Wed","weekday","sled","East River","2","2","1",9.4,0.1,40,0,26,23.5,0,0,-1,-1,0,0,-1,-2
"4337",2019-02-14,"Gothic Rd","w1819","Non.motorized",19,"Thu","weekday","no_sled","East River","3","2","2",9.7,0.3,41,1,29,23.7,0,0,0,-1,1,1,1,0
"4338",2019-02-14,"Gothic Rd","w1819","Mechanized",0,"Thu","weekday","no_sled","East River","3","2","2",9.7,0.3,41,1,29,23.7,0,0,0,-1,1,1,1,0
"4339",2019-02-14,"Gothic Rd","w1819","Motorized",0,"Thu","weekday","sled","East River","3","2","2",9.7,0.3,41,1,29,23.7,0,0,0,-1,1,1,1,0
"4340",2019-02-14,"Gothic Rd","w1819","Hybrid",0,"Thu","weekday","sled","East River","3","2","2",9.7,0.3,41,1,29,23.7,0,0,0,-1,1,1,1,0
"4341",2019-02-15,"Gothic Rd","w1819","Non.motorized",3,"Fri","weekday","no_sled","East River","4","4","3",10.8,1.1,51,10,27,21.2,1,0,0,0,11,11,11,11
"4342",2019-02-15,"Gothic Rd","w1819","Mechanized",0,"Fri","weekday","no_sled","East River","4","4","3",10.8,1.1,51,10,27,21.2,1,0,0,0,11,11,11,11
"4343",2019-02-15,"Gothic Rd","w1819","Motorized",0,"Fri","weekday","sled","East River","4","4","3",10.8,1.1,51,10,27,21.2,1,0,0,0,11,11,11,11
"4344",2019-02-15,"Gothic Rd","w1819","Hybrid",0,"Fri","weekday","sled","East River","4","4","3",10.8,1.1,51,10,27,21.2,1,0,0,0,11,11,11,11
"4345",2019-02-16,"Gothic Rd","w1819","Non.motorized",3,"Sat","weekend","no_sled","East River","3","3","3",11.1,0.3,52,1,14,21.3,10,1,0,0,11,12,12,12
"4346",2019-02-16,"Gothic Rd","w1819","Mechanized",0,"Sat","weekend","no_sled","East River","3","3","3",11.1,0.3,52,1,14,21.3,10,1,0,0,11,12,12,12
"4347",2019-02-16,"Gothic Rd","w1819","Motorized",0,"Sat","weekend","sled","East River","3","3","3",11.1,0.3,52,1,14,21.3,10,1,0,0,11,12,12,12
"4348",2019-02-16,"Gothic Rd","w1819","Hybrid",0,"Sat","weekend","sled","East River","3","3","3",11.1,0.3,52,1,14,21.3,10,1,0,0,11,12,12,12
"4349",2019-02-17,"Gothic Rd","w1819","Non.motorized",38,"Sun","weekend","no_sled","East River","3","3","3",11.3,0.2,55,3,10,20.5,1,10,1,0,4,14,15,15
"4350",2019-02-17,"Gothic Rd","w1819","Mechanized",2,"Sun","weekend","no_sled","East River","3","3","3",11.3,0.2,55,3,10,20.5,1,10,1,0,4,14,15,15
"4351",2019-02-17,"Gothic Rd","w1819","Motorized",0,"Sun","weekend","sled","East River","3","3","3",11.3,0.2,55,3,10,20.5,1,10,1,0,4,14,15,15
"4352",2019-02-17,"Gothic Rd","w1819","Hybrid",0,"Sun","weekend","sled","East River","3","3","3",11.3,0.2,55,3,10,20.5,1,10,1,0,4,14,15,15
"4353",2019-02-18,"Gothic Rd","w1819","Non.motorized",16,"Mon","weekday","no_sled","East River","3","3","2",11.4,0.1,53,-2,13,21.5,3,1,10,1,1,2,12,13
"4354",2019-02-18,"Gothic Rd","w1819","Mechanized",0,"Mon","weekday","no_sled","East River","3","3","2",11.4,0.1,53,-2,13,21.5,3,1,10,1,1,2,12,13
"4355",2019-02-18,"Gothic Rd","w1819","Motorized",0,"Mon","weekday","sled","East River","3","3","2",11.4,0.1,53,-2,13,21.5,3,1,10,1,1,2,12,13
"4356",2019-02-18,"Gothic Rd","w1819","Hybrid",0,"Mon","weekday","sled","East River","3","3","2",11.4,0.1,53,-2,13,21.5,3,1,10,1,1,2,12,13
"4357",2019-02-19,"Gothic Rd","w1819","Non.motorized",13,"Tue","weekday","no_sled","East River","3","3","2",11.5,0.1,53,0,11,21.7,-2,3,1,10,-2,1,2,12
"4358",2019-02-19,"Gothic Rd","w1819","Mechanized",0,"Tue","weekday","no_sled","East River","3","3","2",11.5,0.1,53,0,11,21.7,-2,3,1,10,-2,1,2,12
"4359",2019-02-19,"Gothic Rd","w1819","Motorized",1,"Tue","weekday","sled","East River","3","3","2",11.5,0.1,53,0,11,21.7,-2,3,1,10,-2,1,2,12
"4360",2019-02-19,"Gothic Rd","w1819","Hybrid",0,"Tue","weekday","sled","East River","3","3","2",11.5,0.1,53,0,11,21.7,-2,3,1,10,-2,1,2,12
"4361",2019-02-20,"Gothic Rd","w1819","Non.motorized",15,"Wed","weekday","no_sled","East River","3","3","2",11.6,0.1,53,0,7,21.9,0,-2,3,1,0,-2,1,2
"4362",2019-02-20,"Gothic Rd","w1819","Mechanized",0,"Wed","weekday","no_sled","East River","3","3","2",11.6,0.1,53,0,7,21.9,0,-2,3,1,0,-2,1,2
"4363",2019-02-20,"Gothic Rd","w1819","Motorized",0,"Wed","weekday","sled","East River","3","3","2",11.6,0.1,53,0,7,21.9,0,-2,3,1,0,-2,1,2
"4364",2019-02-20,"Gothic Rd","w1819","Hybrid",0,"Wed","weekday","sled","East River","3","3","2",11.6,0.1,53,0,7,21.9,0,-2,3,1,0,-2,1,2
"4365",2019-02-21,"Gothic Rd","w1819","Non.motorized",24,"Thu","weekday","no_sled","East River","3","3","3",11.6,0,52,-1,15,22.3,0,0,-2,3,-1,-1,-3,0
"4366",2019-02-21,"Gothic Rd","w1819","Mechanized",0,"Thu","weekday","no_sled","East River","3","3","3",11.6,0,52,-1,15,22.3,0,0,-2,3,-1,-1,-3,0
"4367",2019-02-21,"Gothic Rd","w1819","Motorized",0,"Thu","weekday","sled","East River","3","3","3",11.6,0,52,-1,15,22.3,0,0,-2,3,-1,-1,-3,0
"4368",2019-02-21,"Gothic Rd","w1819","Hybrid",0,"Thu","weekday","sled","East River","3","3","3",11.6,0,52,-1,15,22.3,0,0,-2,3,-1,-1,-3,0
"4369",2019-02-22,"Gothic Rd","w1819","Non.motorized",24,"Fri","weekday","no_sled","East River","3","3","3",11.8,0.2,52,0,20,22.7,-1,0,0,-2,-1,-1,-1,-3
"4370",2019-02-22,"Gothic Rd","w1819","Mechanized",0,"Fri","weekday","no_sled","East River","3","3","3",11.8,0.2,52,0,20,22.7,-1,0,0,-2,-1,-1,-1,-3
"4371",2019-02-22,"Gothic Rd","w1819","Motorized",0,"Fri","weekday","sled","East River","3","3","3",11.8,0.2,52,0,20,22.7,-1,0,0,-2,-1,-1,-1,-3
"4372",2019-02-22,"Gothic Rd","w1819","Hybrid",0,"Fri","weekday","sled","East River","3","3","3",11.8,0.2,52,0,20,22.7,-1,0,0,-2,-1,-1,-1,-3
"4373",2019-02-23,"Gothic Rd","w1819","Non.motorized",140,"Sat","weekend","no_sled","East River","3","3","3",12.1,0.3,53,1,13,22.8,0,-1,0,0,1,0,0,0
"4374",2019-02-23,"Gothic Rd","w1819","Mechanized",1,"Sat","weekend","no_sled","East River","3","3","3",12.1,0.3,53,1,13,22.8,0,-1,0,0,1,0,0,0
"4375",2019-02-23,"Gothic Rd","w1819","Motorized",0,"Sat","weekend","sled","East River","3","3","3",12.1,0.3,53,1,13,22.8,0,-1,0,0,1,0,0,0
"4376",2019-02-23,"Gothic Rd","w1819","Hybrid",0,"Sat","weekend","sled","East River","3","3","3",12.1,0.3,53,1,13,22.8,0,-1,0,0,1,0,0,0
"4377",2019-02-24,"Gothic Rd","w1819","Non.motorized",50,"Sun","weekend","no_sled","East River","3","3","2",12.1,0,52,-1,14,23.3,1,0,-1,0,0,0,-1,-1
"4378",2019-02-24,"Gothic Rd","w1819","Mechanized",1,"Sun","weekend","no_sled","East River","3","3","2",12.1,0,52,-1,14,23.3,1,0,-1,0,0,0,-1,-1
"4379",2019-02-24,"Gothic Rd","w1819","Motorized",1,"Sun","weekend","sled","East River","3","3","2",12.1,0,52,-1,14,23.3,1,0,-1,0,0,0,-1,-1
"4380",2019-02-24,"Gothic Rd","w1819","Hybrid",0,"Sun","weekend","sled","East River","3","3","2",12.1,0,52,-1,14,23.3,1,0,-1,0,0,0,-1,-1
"4381",2019-02-25,"Gothic Rd","w1819","Non.motorized",36,"Mon","weekday","no_sled","East River","3","3","2",12.1,0,51,-1,22,23.7,-1,1,0,-1,-2,-1,-1,-2
"4382",2019-02-25,"Gothic Rd","w1819","Mechanized",2,"Mon","weekday","no_sled","East River","3","3","2",12.1,0,51,-1,22,23.7,-1,1,0,-1,-2,-1,-1,-2
"4383",2019-02-25,"Gothic Rd","w1819","Motorized",0,"Mon","weekday","sled","East River","3","3","2",12.1,0,51,-1,22,23.7,-1,1,0,-1,-2,-1,-1,-2
"4384",2019-02-25,"Gothic Rd","w1819","Hybrid",0,"Mon","weekday","sled","East River","3","3","2",12.1,0,51,-1,22,23.7,-1,1,0,-1,-2,-1,-1,-2
"4385",2019-02-26,"Gothic Rd","w1819","Non.motorized",34,"Tue","weekday","no_sled","East River","2","2","2",12.1,0,50,-1,27,24.2,-1,-1,1,0,-2,-3,-2,-2
"4386",2019-02-26,"Gothic Rd","w1819","Mechanized",2,"Tue","weekday","no_sled","East River","2","2","2",12.1,0,50,-1,27,24.2,-1,-1,1,0,-2,-3,-2,-2
"4387",2019-02-26,"Gothic Rd","w1819","Motorized",0,"Tue","weekday","sled","East River","2","2","2",12.1,0,50,-1,27,24.2,-1,-1,1,0,-2,-3,-2,-2
"4388",2019-02-26,"Gothic Rd","w1819","Hybrid",0,"Tue","weekday","sled","East River","2","2","2",12.1,0,50,-1,27,24.2,-1,-1,1,0,-2,-3,-2,-2
"4389",2019-02-27,"Gothic Rd","w1819","Non.motorized",51,"Wed","weekday","no_sled","East River","2","2","2",12.1,0,50,0,30,24.2,-1,-1,-1,1,-1,-2,-3,-2
"4390",2019-02-27,"Gothic Rd","w1819","Mechanized",6,"Wed","weekday","no_sled","East River","2","2","2",12.1,0,50,0,30,24.2,-1,-1,-1,1,-1,-2,-3,-2
"4391",2019-02-27,"Gothic Rd","w1819","Motorized",0,"Wed","weekday","sled","East River","2","2","2",12.1,0,50,0,30,24.2,-1,-1,-1,1,-1,-2,-3,-2
"4392",2019-02-27,"Gothic Rd","w1819","Hybrid",0,"Wed","weekday","sled","East River","2","2","2",12.1,0,50,0,30,24.2,-1,-1,-1,1,-1,-2,-3,-2
"4393",2019-02-28,"Gothic Rd","w1819","Non.motorized",28,"Thu","weekday","no_sled","East River","2","2","2",12.2,0.1,49,-1,30,24.9,0,-1,-1,-1,-1,-2,-3,-4
"4394",2019-02-28,"Gothic Rd","w1819","Mechanized",0,"Thu","weekday","no_sled","East River","2","2","2",12.2,0.1,49,-1,30,24.9,0,-1,-1,-1,-1,-2,-3,-4
"4395",2019-02-28,"Gothic Rd","w1819","Motorized",0,"Thu","weekday","sled","East River","2","2","2",12.2,0.1,49,-1,30,24.9,0,-1,-1,-1,-1,-2,-3,-4
"4396",2019-02-28,"Gothic Rd","w1819","Hybrid",0,"Thu","weekday","sled","East River","2","2","2",12.2,0.1,49,-1,30,24.9,0,-1,-1,-1,-1,-2,-3,-4
"4397",2019-03-01,"Gothic Rd","w1819","Non.motorized",17,"Fri","weekday","no_sled","East River","2","2","1",12.3,0.1,49,0,29,25.1,-1,0,-1,-1,-1,-1,-2,-3
"4398",2019-03-01,"Gothic Rd","w1819","Mechanized",0,"Fri","weekday","no_sled","East River","2","2","1",12.3,0.1,49,0,29,25.1,-1,0,-1,-1,-1,-1,-2,-3
"4399",2019-03-01,"Gothic Rd","w1819","Motorized",0,"Fri","weekday","sled","East River","2","2","1",12.3,0.1,49,0,29,25.1,-1,0,-1,-1,-1,-1,-2,-3
"4400",2019-03-01,"Gothic Rd","w1819","Hybrid",0,"Fri","weekday","sled","East River","2","2","1",12.3,0.1,49,0,29,25.1,-1,0,-1,-1,-1,-1,-2,-3
"4401",2019-03-02,"Gothic Rd","w1819","Non.motorized",20,"Sat","weekend","no_sled","East River","3","3","2",13,0.7,58,9,30,22.4,0,-1,0,-1,9,8,8,7
"4402",2019-03-02,"Gothic Rd","w1819","Mechanized",0,"Sat","weekend","no_sled","East River","3","3","2",13,0.7,58,9,30,22.4,0,-1,0,-1,9,8,8,7
"4403",2019-03-02,"Gothic Rd","w1819","Motorized",0,"Sat","weekend","sled","East River","3","3","2",13,0.7,58,9,30,22.4,0,-1,0,-1,9,8,8,7
"4404",2019-03-02,"Gothic Rd","w1819","Hybrid",0,"Sat","weekend","sled","East River","3","3","2",13,0.7,58,9,30,22.4,0,-1,0,-1,9,8,8,7
"4405",2019-03-03,"Gothic Rd","w1819","Non.motorized",6,"Sun","weekend","no_sled","East River","3","3","3",13.7,0.7,64,6,27,21.4,9,0,-1,0,15,15,14,14
"4406",2019-03-03,"Gothic Rd","w1819","Mechanized",0,"Sun","weekend","no_sled","East River","3","3","3",13.7,0.7,64,6,27,21.4,9,0,-1,0,15,15,14,14
"4407",2019-03-03,"Gothic Rd","w1819","Motorized",0,"Sun","weekend","sled","East River","3","3","3",13.7,0.7,64,6,27,21.4,9,0,-1,0,15,15,14,14
"4408",2019-03-03,"Gothic Rd","w1819","Hybrid",0,"Sun","weekend","sled","East River","3","3","3",13.7,0.7,64,6,27,21.4,9,0,-1,0,15,15,14,14
"4409",2019-03-04,"Gothic Rd","w1819","Non.motorized",0,"Mon","weekday","no_sled","East River","3","3","3",14.4,0.7,66,2,23,21.8,6,9,0,-1,8,17,17,16
"4410",2019-03-04,"Gothic Rd","w1819","Mechanized",0,"Mon","weekday","no_sled","East River","3","3","3",14.4,0.7,66,2,23,21.8,6,9,0,-1,8,17,17,16
"4411",2019-03-04,"Gothic Rd","w1819","Motorized",0,"Mon","weekday","sled","East River","3","3","3",14.4,0.7,66,2,23,21.8,6,9,0,-1,8,17,17,16
"4412",2019-03-04,"Gothic Rd","w1819","Hybrid",0,"Mon","weekday","sled","East River","3","3","3",14.4,0.7,66,2,23,21.8,6,9,0,-1,8,17,17,16
"4413",2019-03-05,"Gothic Rd","w1819","Non.motorized",8,"Tue","weekday","no_sled","East River","3","3","3",14.4,0,64,-2,24,22.5,2,6,9,0,0,6,15,15
"4414",2019-03-05,"Gothic Rd","w1819","Mechanized",0,"Tue","weekday","no_sled","East River","3","3","3",14.4,0,64,-2,24,22.5,2,6,9,0,0,6,15,15
"4415",2019-03-05,"Gothic Rd","w1819","Motorized",0,"Tue","weekday","sled","East River","3","3","3",14.4,0,64,-2,24,22.5,2,6,9,0,0,6,15,15
"4416",2019-03-05,"Gothic Rd","w1819","Hybrid",0,"Tue","weekday","sled","East River","3","3","3",14.4,0,64,-2,24,22.5,2,6,9,0,0,6,15,15
"4417",2019-03-06,"Gothic Rd","w1819","Non.motorized",12,"Wed","weekday","no_sled","East River","3","3","2",14.5,0.1,62,-2,31,23.4,-2,2,6,9,-4,-2,4,13
"4418",2019-03-06,"Gothic Rd","w1819","Non.motorized",12,"Wed","weekday","no_sled","East River","4","4","3",14.5,0.1,62,-2,31,23.4,-2,2,6,9,-4,-2,4,13
"4419",2019-03-06,"Gothic Rd","w1819","Mechanized",0,"Wed","weekday","no_sled","East River","3","3","2",14.5,0.1,62,-2,31,23.4,-2,2,6,9,-4,-2,4,13
"4420",2019-03-06,"Gothic Rd","w1819","Mechanized",0,"Wed","weekday","no_sled","East River","4","4","3",14.5,0.1,62,-2,31,23.4,-2,2,6,9,-4,-2,4,13
"4421",2019-03-06,"Gothic Rd","w1819","Motorized",0,"Wed","weekday","sled","East River","3","3","2",14.5,0.1,62,-2,31,23.4,-2,2,6,9,-4,-2,4,13
"4422",2019-03-06,"Gothic Rd","w1819","Motorized",0,"Wed","weekday","sled","East River","4","4","3",14.5,0.1,62,-2,31,23.4,-2,2,6,9,-4,-2,4,13
"4423",2019-03-06,"Gothic Rd","w1819","Hybrid",0,"Wed","weekday","sled","East River","3","3","2",14.5,0.1,62,-2,31,23.4,-2,2,6,9,-4,-2,4,13
"4424",2019-03-06,"Gothic Rd","w1819","Hybrid",0,"Wed","weekday","sled","East River","4","4","3",14.5,0.1,62,-2,31,23.4,-2,2,6,9,-4,-2,4,13
"4425",2019-03-07,"Gothic Rd","w1819","Non.motorized",0,"Thu","weekday","no_sled","East River","4","4","3",16.2,1.7,71,9,30,22.8,-2,-2,2,6,7,5,7,13
"4426",2019-03-07,"Gothic Rd","w1819","Mechanized",0,"Thu","weekday","no_sled","East River","4","4","3",16.2,1.7,71,9,30,22.8,-2,-2,2,6,7,5,7,13
"4427",2019-03-07,"Gothic Rd","w1819","Motorized",0,"Thu","weekday","sled","East River","4","4","3",16.2,1.7,71,9,30,22.8,-2,-2,2,6,7,5,7,13
"4428",2019-03-07,"Gothic Rd","w1819","Hybrid",0,"Thu","weekday","sled","East River","4","4","3",16.2,1.7,71,9,30,22.8,-2,-2,2,6,7,5,7,13
"4429",2019-03-08,"Gothic Rd","w1819","Non.motorized",0,"Fri","weekday","no_sled","East River","3","3","3",16.6,0.4,71,0,27,23.4,9,-2,-2,2,9,7,5,7
"4430",2019-03-08,"Gothic Rd","w1819","Mechanized",0,"Fri","weekday","no_sled","East River","3","3","3",16.6,0.4,71,0,27,23.4,9,-2,-2,2,9,7,5,7
"4431",2019-03-08,"Gothic Rd","w1819","Motorized",0,"Fri","weekday","sled","East River","3","3","3",16.6,0.4,71,0,27,23.4,9,-2,-2,2,9,7,5,7
"4432",2019-03-08,"Gothic Rd","w1819","Hybrid",0,"Fri","weekday","sled","East River","3","3","3",16.6,0.4,71,0,27,23.4,9,-2,-2,2,9,7,5,7
"4433",2019-03-09,"Gothic Rd","w1819","Non.motorized",0,"Sat","weekend","no_sled","East River","4","4","3",17.2,0.6,76,5,22,22.6,0,9,-2,-2,5,14,12,10
"4434",2019-03-09,"Gothic Rd","w1819","Mechanized",0,"Sat","weekend","no_sled","East River","4","4","3",17.2,0.6,76,5,22,22.6,0,9,-2,-2,5,14,12,10
"4435",2019-03-09,"Gothic Rd","w1819","Motorized",0,"Sat","weekend","sled","East River","4","4","3",17.2,0.6,76,5,22,22.6,0,9,-2,-2,5,14,12,10
"4436",2019-03-09,"Gothic Rd","w1819","Hybrid",0,"Sat","weekend","sled","East River","4","4","3",17.2,0.6,76,5,22,22.6,0,9,-2,-2,5,14,12,10
"4437",2019-03-10,"Gothic Rd","w1819","Non.motorized",0,"Sun","weekend","no_sled","East River","3","3","3",17.3,0.1,73,-3,25,23.7,5,0,9,-2,2,2,11,9
"4438",2019-03-10,"Gothic Rd","w1819","Mechanized",0,"Sun","weekend","no_sled","East River","3","3","3",17.3,0.1,73,-3,25,23.7,5,0,9,-2,2,2,11,9
"4439",2019-03-10,"Gothic Rd","w1819","Motorized",0,"Sun","weekend","sled","East River","3","3","3",17.3,0.1,73,-3,25,23.7,5,0,9,-2,2,2,11,9
"4440",2019-03-10,"Gothic Rd","w1819","Hybrid",0,"Sun","weekend","sled","East River","3","3","3",17.3,0.1,73,-3,25,23.7,5,0,9,-2,2,2,11,9
"4441",2019-03-11,"Gothic Rd","w1819","Non.motorized",9,"Mon","weekday","no_sled","East River","3","3","2",17.3,0,71,-2,29,24.4,-3,5,0,9,-5,0,0,9
"4442",2019-03-11,"Gothic Rd","w1819","Mechanized",0,"Mon","weekday","no_sled","East River","3","3","2",17.3,0,71,-2,29,24.4,-3,5,0,9,-5,0,0,9
"4443",2019-03-11,"Gothic Rd","w1819","Motorized",0,"Mon","weekday","sled","East River","3","3","2",17.3,0,71,-2,29,24.4,-3,5,0,9,-5,0,0,9
"4444",2019-03-11,"Gothic Rd","w1819","Hybrid",0,"Mon","weekday","sled","East River","3","3","2",17.3,0,71,-2,29,24.4,-3,5,0,9,-5,0,0,9
"4445",2019-03-12,"Gothic Rd","w1819","Non.motorized",7,"Tue","weekday","no_sled","East River","3","3","3",17.4,0.1,70,-1,32,24.9,-2,-3,5,0,-3,-6,-1,-1
"4446",2019-03-12,"Gothic Rd","w1819","Non.motorized",7,"Tue","weekday","no_sled","East River","4","4","4",17.4,0.1,70,-1,32,24.9,-2,-3,5,0,-3,-6,-1,-1
"4447",2019-03-12,"Gothic Rd","w1819","Mechanized",1,"Tue","weekday","no_sled","East River","3","3","3",17.4,0.1,70,-1,32,24.9,-2,-3,5,0,-3,-6,-1,-1
"4448",2019-03-12,"Gothic Rd","w1819","Mechanized",1,"Tue","weekday","no_sled","East River","4","4","4",17.4,0.1,70,-1,32,24.9,-2,-3,5,0,-3,-6,-1,-1
"4449",2019-03-12,"Gothic Rd","w1819","Motorized",0,"Tue","weekday","sled","East River","3","3","3",17.4,0.1,70,-1,32,24.9,-2,-3,5,0,-3,-6,-1,-1
"4450",2019-03-12,"Gothic Rd","w1819","Motorized",0,"Tue","weekday","sled","East River","4","4","4",17.4,0.1,70,-1,32,24.9,-2,-3,5,0,-3,-6,-1,-1
"4451",2019-03-12,"Gothic Rd","w1819","Hybrid",0,"Tue","weekday","sled","East River","3","3","3",17.4,0.1,70,-1,32,24.9,-2,-3,5,0,-3,-6,-1,-1
"4452",2019-03-12,"Gothic Rd","w1819","Hybrid",0,"Tue","weekday","sled","East River","4","4","4",17.4,0.1,70,-1,32,24.9,-2,-3,5,0,-3,-6,-1,-1
"4453",2019-03-13,"Gothic Rd","w1819","Non.motorized",0,"Wed","weekday","no_sled","East River","4","4","3",18.1,0.7,74,4,24,24.5,-1,-2,-3,5,3,1,-2,3
"4454",2019-03-13,"Gothic Rd","w1819","Mechanized",0,"Wed","weekday","no_sled","East River","4","4","3",18.1,0.7,74,4,24,24.5,-1,-2,-3,5,3,1,-2,3
"4455",2019-03-13,"Gothic Rd","w1819","Motorized",0,"Wed","weekday","sled","East River","4","4","3",18.1,0.7,74,4,24,24.5,-1,-2,-3,5,3,1,-2,3
"4456",2019-03-13,"Gothic Rd","w1819","Hybrid",0,"Wed","weekday","sled","East River","4","4","3",18.1,0.7,74,4,24,24.5,-1,-2,-3,5,3,1,-2,3
"4457",2019-03-14,"Gothic Rd","w1819","Non.motorized",9,"Thu","weekday","no_sled","East River","4","4","3",18.1,0,74,0,17,24.5,4,-1,-2,-3,4,3,1,-2
"4458",2019-03-14,"Gothic Rd","w1819","Mechanized",0,"Thu","weekday","no_sled","East River","4","4","3",18.1,0,74,0,17,24.5,4,-1,-2,-3,4,3,1,-2
"4459",2019-03-14,"Gothic Rd","w1819","Motorized",0,"Thu","weekday","sled","East River","4","4","3",18.1,0,74,0,17,24.5,4,-1,-2,-3,4,3,1,-2
"4460",2019-03-14,"Gothic Rd","w1819","Hybrid",0,"Thu","weekday","sled","East River","4","4","3",18.1,0,74,0,17,24.5,4,-1,-2,-3,4,3,1,-2
"4461",2019-03-15,"Gothic Rd","w1819","Non.motorized",7,"Fri","weekday","no_sled","East River","3","3","2",18.1,0,72,-2,18,25.1,0,4,-1,-2,-2,2,1,-1
"4462",2019-03-15,"Gothic Rd","w1819","Mechanized",0,"Fri","weekday","no_sled","East River","3","3","2",18.1,0,72,-2,18,25.1,0,4,-1,-2,-2,2,1,-1
"4463",2019-03-15,"Gothic Rd","w1819","Motorized",0,"Fri","weekday","sled","East River","3","3","2",18.1,0,72,-2,18,25.1,0,4,-1,-2,-2,2,1,-1
"4464",2019-03-15,"Gothic Rd","w1819","Hybrid",0,"Fri","weekday","sled","East River","3","3","2",18.1,0,72,-2,18,25.1,0,4,-1,-2,-2,2,1,-1
"4465",2019-03-16,"Gothic Rd","w1819","Non.motorized",17,"Sat","weekend","no_sled","East River","3","3","2",18.2,0.1,70,-2,26,26,-2,0,4,-1,-4,-4,0,-1
"4466",2019-03-16,"Gothic Rd","w1819","Mechanized",1,"Sat","weekend","no_sled","East River","3","3","2",18.2,0.1,70,-2,26,26,-2,0,4,-1,-4,-4,0,-1
"4467",2019-03-16,"Gothic Rd","w1819","Motorized",0,"Sat","weekend","sled","East River","3","3","2",18.2,0.1,70,-2,26,26,-2,0,4,-1,-4,-4,0,-1
"4468",2019-03-16,"Gothic Rd","w1819","Hybrid",0,"Sat","weekend","sled","East River","3","3","2",18.2,0.1,70,-2,26,26,-2,0,4,-1,-4,-4,0,-1
"4469",2019-03-17,"Gothic Rd","w1819","Non.motorized",26,"Sun","weekend","no_sled","East River","3","3","2",18.2,0,69,-1,28,26.4,-2,-2,0,4,-3,-5,-5,-1
"4470",2019-03-17,"Gothic Rd","w1819","Mechanized",2,"Sun","weekend","no_sled","East River","3","3","2",18.2,0,69,-1,28,26.4,-2,-2,0,4,-3,-5,-5,-1
"4471",2019-03-17,"Gothic Rd","w1819","Motorized",0,"Sun","weekend","sled","East River","3","3","2",18.2,0,69,-1,28,26.4,-2,-2,0,4,-3,-5,-5,-1
"4472",2019-03-17,"Gothic Rd","w1819","Hybrid",0,"Sun","weekend","sled","East River","3","3","2",18.2,0,69,-1,28,26.4,-2,-2,0,4,-3,-5,-5,-1
"4473",2019-03-18,"Gothic Rd","w1819","Non.motorized",19,"Mon","weekday","no_sled","East River","2","2","2",18.3,0.1,68,-1,29,26.9,-1,-2,-2,0,-2,-4,-6,-6
"4474",2019-03-18,"Gothic Rd","w1819","Mechanized",0,"Mon","weekday","no_sled","East River","2","2","2",18.3,0.1,68,-1,29,26.9,-1,-2,-2,0,-2,-4,-6,-6
"4475",2019-03-18,"Gothic Rd","w1819","Motorized",1,"Mon","weekday","sled","East River","2","2","2",18.3,0.1,68,-1,29,26.9,-1,-2,-2,0,-2,-4,-6,-6
"4476",2019-03-18,"Gothic Rd","w1819","Hybrid",0,"Mon","weekday","sled","East River","2","2","2",18.3,0.1,68,-1,29,26.9,-1,-2,-2,0,-2,-4,-6,-6
"4477",2019-03-19,"Gothic Rd","w1819","Non.motorized",0,"Tue","weekday","no_sled","East River","2","2","2",18.3,0,67,-1,28,27.3,-1,-1,-2,-2,-2,-3,-5,-7
"4478",2019-03-19,"Gothic Rd","w1819","Mechanized",0,"Tue","weekday","no_sled","East River","2","2","2",18.3,0,67,-1,28,27.3,-1,-1,-2,-2,-2,-3,-5,-7
"4479",2019-03-19,"Gothic Rd","w1819","Motorized",0,"Tue","weekday","sled","East River","2","2","2",18.3,0,67,-1,28,27.3,-1,-1,-2,-2,-2,-3,-5,-7
"4480",2019-03-19,"Gothic Rd","w1819","Hybrid",0,"Tue","weekday","sled","East River","2","2","2",18.3,0,67,-1,28,27.3,-1,-1,-2,-2,-2,-3,-5,-7
"4481",2019-03-20,"Gothic Rd","w1819","Non.motorized",0,"Wed","weekday","no_sled","East River","2","2","2",18.3,0,66,-1,30,27.7,-1,-1,-1,-2,-2,-3,-4,-6
"4482",2019-03-20,"Gothic Rd","w1819","Mechanized",0,"Wed","weekday","no_sled","East River","2","2","2",18.3,0,66,-1,30,27.7,-1,-1,-1,-2,-2,-3,-4,-6
"4483",2019-03-20,"Gothic Rd","w1819","Motorized",0,"Wed","weekday","sled","East River","2","2","2",18.3,0,66,-1,30,27.7,-1,-1,-1,-2,-2,-3,-4,-6
"4484",2019-03-20,"Gothic Rd","w1819","Hybrid",0,"Wed","weekday","sled","East River","2","2","2",18.3,0,66,-1,30,27.7,-1,-1,-1,-2,-2,-3,-4,-6
"4485",2019-03-21,"Gothic Rd","w1819","Non.motorized",0,"Thu","weekday","no_sled","East River","2","2","2",18.4,0.1,65,-1,33,28.3,-1,-1,-1,-1,-2,-3,-4,-5
"4486",2019-03-21,"Gothic Rd","w1819","Mechanized",0,"Thu","weekday","no_sled","East River","2","2","2",18.4,0.1,65,-1,33,28.3,-1,-1,-1,-1,-2,-3,-4,-5
"4487",2019-03-21,"Gothic Rd","w1819","Motorized",0,"Thu","weekday","sled","East River","2","2","2",18.4,0.1,65,-1,33,28.3,-1,-1,-1,-1,-2,-3,-4,-5
"4488",2019-03-21,"Gothic Rd","w1819","Hybrid",0,"Thu","weekday","sled","East River","2","2","2",18.4,0.1,65,-1,33,28.3,-1,-1,-1,-1,-2,-3,-4,-5
"4489",2019-03-22,"Gothic Rd","w1819","Non.motorized",0,"Fri","weekday","no_sled","East River","3","3","2",18.4,0,64,-1,28,28.8,-1,-1,-1,-1,-2,-3,-4,-5
"4490",2019-03-22,"Gothic Rd","w1819","Mechanized",0,"Fri","weekday","no_sled","East River","3","3","2",18.4,0,64,-1,28,28.8,-1,-1,-1,-1,-2,-3,-4,-5
"4491",2019-03-22,"Gothic Rd","w1819","Motorized",0,"Fri","weekday","sled","East River","3","3","2",18.4,0,64,-1,28,28.8,-1,-1,-1,-1,-2,-3,-4,-5
"4492",2019-03-22,"Gothic Rd","w1819","Hybrid",0,"Fri","weekday","sled","East River","3","3","2",18.4,0,64,-1,28,28.8,-1,-1,-1,-1,-2,-3,-4,-5
"4493",2019-03-23,"Gothic Rd","w1819","Non.motorized",0,"Sat","weekend","no_sled","East River","2","2","1",18.4,0,65,1,28,28.3,-1,-1,-1,-1,0,-1,-2,-3
"4494",2019-03-23,"Gothic Rd","w1819","Mechanized",0,"Sat","weekend","no_sled","East River","2","2","1",18.4,0,65,1,28,28.3,-1,-1,-1,-1,0,-1,-2,-3
"4495",2019-03-23,"Gothic Rd","w1819","Motorized",0,"Sat","weekend","sled","East River","2","2","1",18.4,0,65,1,28,28.3,-1,-1,-1,-1,0,-1,-2,-3
"4496",2019-03-23,"Gothic Rd","w1819","Hybrid",0,"Sat","weekend","sled","East River","2","2","1",18.4,0,65,1,28,28.3,-1,-1,-1,-1,0,-1,-2,-3
"4497",2019-03-24,"Gothic Rd","w1819","Non.motorized",0,"Sun","weekend","no_sled","East River","2","2","1",18.4,0,64,-1,29,28.8,1,-1,-1,-1,0,-1,-2,-3
"4498",2019-03-24,"Gothic Rd","w1819","Mechanized",0,"Sun","weekend","no_sled","East River","2","2","1",18.4,0,64,-1,29,28.8,1,-1,-1,-1,0,-1,-2,-3
"4499",2019-03-24,"Gothic Rd","w1819","Motorized",0,"Sun","weekend","sled","East River","2","2","1",18.4,0,64,-1,29,28.8,1,-1,-1,-1,0,-1,-2,-3
"4500",2019-03-24,"Gothic Rd","w1819","Hybrid",0,"Sun","weekend","sled","East River","2","2","1",18.4,0,64,-1,29,28.8,1,-1,-1,-1,0,-1,-2,-3
"4501",2019-03-25,"Gothic Rd","w1819","Non.motorized",4,"Mon","weekday","no_sled","East River","2","2","2",18.6,0.2,64,0,31,29.1,-1,1,-1,-1,-1,0,-1,-2
"4502",2019-03-25,"Gothic Rd","w1819","Mechanized",0,"Mon","weekday","no_sled","East River","2","2","2",18.6,0.2,64,0,31,29.1,-1,1,-1,-1,-1,0,-1,-2
"4503",2019-03-25,"Gothic Rd","w1819","Motorized",0,"Mon","weekday","sled","East River","2","2","2",18.6,0.2,64,0,31,29.1,-1,1,-1,-1,-1,0,-1,-2
"4504",2019-03-25,"Gothic Rd","w1819","Hybrid",0,"Mon","weekday","sled","East River","2","2","2",18.6,0.2,64,0,31,29.1,-1,1,-1,-1,-1,0,-1,-2
"4505",2019-03-26,"Gothic Rd","w1819","Non.motorized",31,"Tue","weekday","no_sled","East River","2","2","2",18.9,0.3,63,-1,36,30,0,-1,1,-1,-1,-2,-1,-2
"4506",2019-03-26,"Gothic Rd","w1819","Mechanized",0,"Tue","weekday","no_sled","East River","2","2","2",18.9,0.3,63,-1,36,30,0,-1,1,-1,-1,-2,-1,-2
"4507",2019-03-26,"Gothic Rd","w1819","Motorized",0,"Tue","weekday","sled","East River","2","2","2",18.9,0.3,63,-1,36,30,0,-1,1,-1,-1,-2,-1,-2
"4508",2019-03-26,"Gothic Rd","w1819","Hybrid",0,"Tue","weekday","sled","East River","2","2","2",18.9,0.3,63,-1,36,30,0,-1,1,-1,-1,-2,-1,-2
"4509",2019-03-27,"Gothic Rd","w1819","Non.motorized",21,"Wed","weekday","no_sled","East River","1","2","2",18.9,0,62,-1,42,30.5,-1,0,-1,1,-2,-2,-3,-2
"4510",2019-03-27,"Gothic Rd","w1819","Mechanized",5,"Wed","weekday","no_sled","East River","1","2","2",18.9,0,62,-1,42,30.5,-1,0,-1,1,-2,-2,-3,-2
"4511",2019-03-27,"Gothic Rd","w1819","Motorized",0,"Wed","weekday","sled","East River","1","2","2",18.9,0,62,-1,42,30.5,-1,0,-1,1,-2,-2,-3,-2
"4512",2019-03-27,"Gothic Rd","w1819","Hybrid",0,"Wed","weekday","sled","East River","1","2","2",18.9,0,62,-1,42,30.5,-1,0,-1,1,-2,-2,-3,-2
"4513",2019-03-28,"Gothic Rd","w1819","Non.motorized",21,"Thu","weekday","no_sled","East River","1","2","2",18.9,0,60,-2,40,31.5,-1,-1,0,-1,-3,-4,-4,-5
"4514",2019-03-28,"Gothic Rd","w1819","Mechanized",1,"Thu","weekday","no_sled","East River","1","2","2",18.9,0,60,-2,40,31.5,-1,-1,0,-1,-3,-4,-4,-5
"4515",2019-03-28,"Gothic Rd","w1819","Motorized",0,"Thu","weekday","sled","East River","1","2","2",18.9,0,60,-2,40,31.5,-1,-1,0,-1,-3,-4,-4,-5
"4516",2019-03-28,"Gothic Rd","w1819","Hybrid",0,"Thu","weekday","sled","East River","1","2","2",18.9,0,60,-2,40,31.5,-1,-1,0,-1,-3,-4,-4,-5
"4517",2019-03-29,"Gothic Rd","w1819","Non.motorized",16,"Fri","weekday","no_sled","East River","1","1","1",19,0.1,58,-2,26,32.8,-2,-1,-1,0,-4,-5,-6,-6
"4518",2019-03-29,"Gothic Rd","w1819","Mechanized",1,"Fri","weekday","no_sled","East River","1","1","1",19,0.1,58,-2,26,32.8,-2,-1,-1,0,-4,-5,-6,-6
"4519",2019-03-29,"Gothic Rd","w1819","Motorized",0,"Fri","weekday","sled","East River","1","1","1",19,0.1,58,-2,26,32.8,-2,-1,-1,0,-4,-5,-6,-6
"4520",2019-03-29,"Gothic Rd","w1819","Hybrid",0,"Fri","weekday","sled","East River","1","1","1",19,0.1,58,-2,26,32.8,-2,-1,-1,0,-4,-5,-6,-6
"4521",2019-03-30,"Gothic Rd","w1819","Non.motorized",37,"Sat","weekend","no_sled","East River","1","1","1",19.1,0.1,61,3,24,31.3,-2,-2,-1,-1,1,-1,-2,-3
"4522",2019-03-30,"Gothic Rd","w1819","Mechanized",3,"Sat","weekend","no_sled","East River","1","1","1",19.1,0.1,61,3,24,31.3,-2,-2,-1,-1,1,-1,-2,-3
"4523",2019-03-30,"Gothic Rd","w1819","Motorized",0,"Sat","weekend","sled","East River","1","1","1",19.1,0.1,61,3,24,31.3,-2,-2,-1,-1,1,-1,-2,-3
"4524",2019-03-30,"Gothic Rd","w1819","Hybrid",0,"Sat","weekend","sled","East River","1","1","1",19.1,0.1,61,3,24,31.3,-2,-2,-1,-1,1,-1,-2,-3
"4525",2019-03-31,"Gothic Rd","w1819","Non.motorized",10,"Sun","weekend","no_sled","East River","1","1","1",19.1,0,59,-2,24,32.4,3,-2,-2,-1,1,-1,-3,-4
"4526",2019-03-31,"Gothic Rd","w1819","Mechanized",0,"Sun","weekend","no_sled","East River","1","1","1",19.1,0,59,-2,24,32.4,3,-2,-2,-1,1,-1,-3,-4
"4527",2019-03-31,"Gothic Rd","w1819","Motorized",0,"Sun","weekend","sled","East River","1","1","1",19.1,0,59,-2,24,32.4,3,-2,-2,-1,1,-1,-3,-4
"4528",2019-03-31,"Gothic Rd","w1819","Hybrid",0,"Sun","weekend","sled","East River","1","1","1",19.1,0,59,-2,24,32.4,3,-2,-2,-1,1,-1,-3,-4
"4529",2019-04-01,"Gothic Rd","w1819","Non.motorized",0,"Mon","weekday","no_sled","East River","2","1","1",19.1,0,58,-1,29,32.9,-2,3,-2,-2,-3,0,-2,-4
"4530",2019-04-01,"Gothic Rd","w1819","Mechanized",0,"Mon","weekday","no_sled","East River","2","1","1",19.1,0,58,-1,29,32.9,-2,3,-2,-2,-3,0,-2,-4
"4531",2019-04-01,"Gothic Rd","w1819","Motorized",0,"Mon","weekday","sled","East River","2","1","1",19.1,0,58,-1,29,32.9,-2,3,-2,-2,-3,0,-2,-4
"4532",2019-04-01,"Gothic Rd","w1819","Hybrid",0,"Mon","weekday","sled","East River","2","1","1",19.1,0,58,-1,29,32.9,-2,3,-2,-2,-3,0,-2,-4
"4533",2019-04-02,"Gothic Rd","w1819","Non.motorized",0,"Tue","weekday","no_sled","East River","1","1","1",19.1,0,58,0,33,32.9,-1,-2,3,-2,-1,-3,0,-2
"4534",2019-04-02,"Gothic Rd","w1819","Mechanized",0,"Tue","weekday","no_sled","East River","1","1","1",19.1,0,58,0,33,32.9,-1,-2,3,-2,-1,-3,0,-2
"4535",2019-04-02,"Gothic Rd","w1819","Motorized",0,"Tue","weekday","sled","East River","1","1","1",19.1,0,58,0,33,32.9,-1,-2,3,-2,-1,-3,0,-2
"4536",2019-04-02,"Gothic Rd","w1819","Hybrid",0,"Tue","weekday","sled","East River","1","1","1",19.1,0,58,0,33,32.9,-1,-2,3,-2,-1,-3,0,-2
"4537",2019-04-03,"Gothic Rd","w1819","Non.motorized",0,"Wed","weekday","no_sled","East River","2","1","1",19.2,0.1,58,0,31,33.1,0,-1,-2,3,0,-1,-3,0
"4538",2019-04-03,"Gothic Rd","w1819","Mechanized",0,"Wed","weekday","no_sled","East River","2","1","1",19.2,0.1,58,0,31,33.1,0,-1,-2,3,0,-1,-3,0
"4539",2019-04-03,"Gothic Rd","w1819","Motorized",0,"Wed","weekday","sled","East River","2","1","1",19.2,0.1,58,0,31,33.1,0,-1,-2,3,0,-1,-3,0
"4540",2019-04-03,"Gothic Rd","w1819","Hybrid",0,"Wed","weekday","sled","East River","2","1","1",19.2,0.1,58,0,31,33.1,0,-1,-2,3,0,-1,-3,0
"4541",2019-04-04,"Gothic Rd","w1819","Non.motorized",0,"Thu","weekday","no_sled","East River","2","1","1",19.4,0.2,59,1,35,32.9,0,0,-1,-2,1,1,0,-2
"4542",2019-04-04,"Gothic Rd","w1819","Mechanized",0,"Thu","weekday","no_sled","East River","2","1","1",19.4,0.2,59,1,35,32.9,0,0,-1,-2,1,1,0,-2
"4543",2019-04-04,"Gothic Rd","w1819","Motorized",0,"Thu","weekday","sled","East River","2","1","1",19.4,0.2,59,1,35,32.9,0,0,-1,-2,1,1,0,-2
"4544",2019-04-04,"Gothic Rd","w1819","Hybrid",0,"Thu","weekday","sled","East River","2","1","1",19.4,0.2,59,1,35,32.9,0,0,-1,-2,1,1,0,-2
"4545",2019-04-05,"Gothic Rd","w1819","Non.motorized",0,"Fri","weekday","no_sled","East River","1","1","1",19.4,0,57,-2,38,34,1,0,0,-1,-1,-1,-1,-2
"4546",2019-04-05,"Gothic Rd","w1819","Mechanized",0,"Fri","weekday","no_sled","East River","1","1","1",19.4,0,57,-2,38,34,1,0,0,-1,-1,-1,-1,-2
"4547",2019-04-05,"Gothic Rd","w1819","Motorized",0,"Fri","weekday","sled","East River","1","1","1",19.4,0,57,-2,38,34,1,0,0,-1,-1,-1,-1,-2
"4548",2019-04-05,"Gothic Rd","w1819","Hybrid",0,"Fri","weekday","sled","East River","1","1","1",19.4,0,57,-2,38,34,1,0,0,-1,-1,-1,-1,-2
"4549",2019-04-06,"Gothic Rd","w1819","Non.motorized",0,"Sat","weekend","no_sled","East River","1","1","1",19.3,-0.1,57,0,35,33.9,-2,1,0,0,-2,-1,-1,-1
"4550",2019-04-06,"Gothic Rd","w1819","Mechanized",0,"Sat","weekend","no_sled","East River","1","1","1",19.3,-0.1,57,0,35,33.9,-2,1,0,0,-2,-1,-1,-1
"4551",2019-04-06,"Gothic Rd","w1819","Motorized",0,"Sat","weekend","sled","East River","1","1","1",19.3,-0.1,57,0,35,33.9,-2,1,0,0,-2,-1,-1,-1
"4552",2019-04-06,"Gothic Rd","w1819","Hybrid",0,"Sat","weekend","sled","East River","1","1","1",19.3,-0.1,57,0,35,33.9,-2,1,0,0,-2,-1,-1,-1
"4553",2019-04-07,"Gothic Rd","w1819","Non.motorized",0,"Sun","weekend","no_sled","East River","1","1","1",19.1,-0.2,57,0,37,33.5,0,-2,1,0,0,-2,-1,-1
"4554",2019-04-07,"Gothic Rd","w1819","Mechanized",0,"Sun","weekend","no_sled","East River","1","1","1",19.1,-0.2,57,0,37,33.5,0,-2,1,0,0,-2,-1,-1
"4555",2019-04-07,"Gothic Rd","w1819","Motorized",0,"Sun","weekend","sled","East River","1","1","1",19.1,-0.2,57,0,37,33.5,0,-2,1,0,0,-2,-1,-1
"4556",2019-04-07,"Gothic Rd","w1819","Hybrid",0,"Sun","weekend","sled","East River","1","1","1",19.1,-0.2,57,0,37,33.5,0,-2,1,0,0,-2,-1,-1
"4557",2019-04-08,"Gothic Rd","w1819","Non.motorized",0,"Mon","weekday","no_sled","East River","1","2","2",19.3,0.2,54,-3,41,35.7,0,0,-2,1,-3,-3,-5,-4
"4558",2019-04-08,"Gothic Rd","w1819","Mechanized",0,"Mon","weekday","no_sled","East River","1","2","2",19.3,0.2,54,-3,41,35.7,0,0,-2,1,-3,-3,-5,-4
"4559",2019-04-08,"Gothic Rd","w1819","Motorized",0,"Mon","weekday","sled","East River","1","2","2",19.3,0.2,54,-3,41,35.7,0,0,-2,1,-3,-3,-5,-4
"4560",2019-04-08,"Gothic Rd","w1819","Hybrid",0,"Mon","weekday","sled","East River","1","2","2",19.3,0.2,54,-3,41,35.7,0,0,-2,1,-3,-3,-5,-4
"4561",2019-04-09,"Gothic Rd","w1819","Non.motorized",0,"Tue","weekday","no_sled","East River","1","2","2",19.3,0,53,-1,43,36.4,-3,0,0,-2,-4,-4,-4,-6
"4562",2019-04-09,"Gothic Rd","w1819","Mechanized",0,"Tue","weekday","no_sled","East River","1","2","2",19.3,0,53,-1,43,36.4,-3,0,0,-2,-4,-4,-4,-6
"4563",2019-04-09,"Gothic Rd","w1819","Motorized",0,"Tue","weekday","sled","East River","1","2","2",19.3,0,53,-1,43,36.4,-3,0,0,-2,-4,-4,-4,-6
"4564",2019-04-09,"Gothic Rd","w1819","Hybrid",0,"Tue","weekday","sled","East River","1","2","2",19.3,0,53,-1,43,36.4,-3,0,0,-2,-4,-4,-4,-6
"4565",2019-04-10,"Gothic Rd","w1819","Non.motorized",0,"Wed","weekday","no_sled","East River","2","2","1",19,-0.3,51,-2,30,37.3,-1,-3,0,0,-3,-6,-6,-6
"4566",2019-04-10,"Gothic Rd","w1819","Mechanized",0,"Wed","weekday","no_sled","East River","2","2","1",19,-0.3,51,-2,30,37.3,-1,-3,0,0,-3,-6,-6,-6
"4567",2019-04-10,"Gothic Rd","w1819","Motorized",0,"Wed","weekday","sled","East River","2","2","1",19,-0.3,51,-2,30,37.3,-1,-3,0,0,-3,-6,-6,-6
"4568",2019-04-10,"Gothic Rd","w1819","Hybrid",0,"Wed","weekday","sled","East River","2","2","1",19,-0.3,51,-2,30,37.3,-1,-3,0,0,-3,-6,-6,-6
"4569",2019-04-11,"Gothic Rd","w1819","Non.motorized",0,"Thu","weekday","no_sled","East River","3","3","2",18.9,-0.1,53,2,20,35.7,-2,-1,-3,0,0,-1,-4,-4
"4570",2019-04-11,"Gothic Rd","w1819","Mechanized",0,"Thu","weekday","no_sled","East River","3","3","2",18.9,-0.1,53,2,20,35.7,-2,-1,-3,0,0,-1,-4,-4
"4571",2019-04-11,"Gothic Rd","w1819","Motorized",0,"Thu","weekday","sled","East River","3","3","2",18.9,-0.1,53,2,20,35.7,-2,-1,-3,0,0,-1,-4,-4
"4572",2019-04-11,"Gothic Rd","w1819","Hybrid",0,"Thu","weekday","sled","East River","3","3","2",18.9,-0.1,53,2,20,35.7,-2,-1,-3,0,0,-1,-4,-4
"4573",2019-04-12,"Gothic Rd","w1819","Non.motorized",0,"Fri","weekday","no_sled","East River","2","2","1",18.7,-0.2,53,0,24,35.3,2,-2,-1,-3,2,0,-1,-4
"4574",2019-04-12,"Gothic Rd","w1819","Mechanized",0,"Fri","weekday","no_sled","East River","2","2","1",18.7,-0.2,53,0,24,35.3,2,-2,-1,-3,2,0,-1,-4
"4575",2019-04-12,"Gothic Rd","w1819","Motorized",0,"Fri","weekday","sled","East River","2","2","1",18.7,-0.2,53,0,24,35.3,2,-2,-1,-3,2,0,-1,-4
"4576",2019-04-12,"Gothic Rd","w1819","Hybrid",0,"Fri","weekday","sled","East River","2","2","1",18.7,-0.2,53,0,24,35.3,2,-2,-1,-3,2,0,-1,-4
"4577",2019-04-13,"Gothic Rd","w1819","Non.motorized",0,"Sat","weekend","no_sled","East River","1","1","1",18.8,0.1,52,-1,27,36.2,0,2,-2,-1,-1,1,-1,-2
"4578",2019-04-13,"Gothic Rd","w1819","Mechanized",0,"Sat","weekend","no_sled","East River","1","1","1",18.8,0.1,52,-1,27,36.2,0,2,-2,-1,-1,1,-1,-2
"4579",2019-04-13,"Gothic Rd","w1819","Motorized",0,"Sat","weekend","sled","East River","1","1","1",18.8,0.1,52,-1,27,36.2,0,2,-2,-1,-1,1,-1,-2
"4580",2019-04-13,"Gothic Rd","w1819","Hybrid",0,"Sat","weekend","sled","East River","1","1","1",18.8,0.1,52,-1,27,36.2,0,2,-2,-1,-1,1,-1,-2
"4581",2019-04-14,"Gothic Rd","w1819","Non.motorized",0,"Sun","weekend","no_sled","East River","1","1","1",18.7,-0.1,51,-1,35,36.7,-1,0,2,-2,-2,-2,0,-2
"4582",2019-04-14,"Gothic Rd","w1819","Mechanized",0,"Sun","weekend","no_sled","East River","1","1","1",18.7,-0.1,51,-1,35,36.7,-1,0,2,-2,-2,-2,0,-2
"4583",2019-04-14,"Gothic Rd","w1819","Motorized",0,"Sun","weekend","sled","East River","1","1","1",18.7,-0.1,51,-1,35,36.7,-1,0,2,-2,-2,-2,0,-2
"4584",2019-04-14,"Gothic Rd","w1819","Hybrid",0,"Sun","weekend","sled","East River","1","1","1",18.7,-0.1,51,-1,35,36.7,-1,0,2,-2,-2,-2,0,-2
"4585",2019-04-15,"Gothic Rd","w1819","Non.motorized",0,"Mon","weekday","no_sled","East River",NA,NA,NA,18.6,-0.1,50,-1,41,37.2,-1,-1,0,2,-2,-3,-3,-1
"4586",2019-04-15,"Gothic Rd","w1819","Mechanized",0,"Mon","weekday","no_sled","East River",NA,NA,NA,18.6,-0.1,50,-1,41,37.2,-1,-1,0,2,-2,-3,-3,-1
"4587",2019-04-15,"Gothic Rd","w1819","Motorized",0,"Mon","weekday","sled","East River",NA,NA,NA,18.6,-0.1,50,-1,41,37.2,-1,-1,0,2,-2,-3,-3,-1
"4588",2019-04-15,"Gothic Rd","w1819","Hybrid",0,"Mon","weekday","sled","East River",NA,NA,NA,18.6,-0.1,50,-1,41,37.2,-1,-1,0,2,-2,-3,-3,-1
"4589",2018-12-01,"Kebler","w1819","Non.motorized",NA,"Sat","weekend","no_sled","Kebler","3","3","2",3.3,0.2,19,1,16,17.4,0,0,0,0,1,1,1,1
"4590",2018-12-01,"Kebler","w1819","Mechanized",NA,"Sat","weekend","no_sled","Kebler","3","3","2",3.3,0.2,19,1,16,17.4,0,0,0,0,1,1,1,1
"4591",2018-12-01,"Kebler","w1819","Motorized",NA,"Sat","weekend","sled","Kebler","3","3","2",3.3,0.2,19,1,16,17.4,0,0,0,0,1,1,1,1
"4592",2018-12-01,"Kebler","w1819","Hybrid",NA,"Sat","weekend","sled","Kebler","3","3","2",3.3,0.2,19,1,16,17.4,0,0,0,0,1,1,1,1
"4593",2018-12-02,"Kebler","w1819","Non.motorized",NA,"Sun","weekend","no_sled","Kebler","3","3","3",3.3,0,20,1,14,16.5,1,0,0,0,2,2,2,2
"4594",2018-12-02,"Kebler","w1819","Mechanized",NA,"Sun","weekend","no_sled","Kebler","3","3","3",3.3,0,20,1,14,16.5,1,0,0,0,2,2,2,2
"4595",2018-12-02,"Kebler","w1819","Motorized",NA,"Sun","weekend","sled","Kebler","3","3","3",3.3,0,20,1,14,16.5,1,0,0,0,2,2,2,2
"4596",2018-12-02,"Kebler","w1819","Hybrid",NA,"Sun","weekend","sled","Kebler","3","3","3",3.3,0,20,1,14,16.5,1,0,0,0,2,2,2,2
"4597",2018-12-03,"Kebler","w1819","Non.motorized",NA,"Mon","weekday","no_sled","Kebler","3","3","2",3.4,0.1,19,-1,13,17.9,1,1,0,0,0,1,1,1
"4598",2018-12-03,"Kebler","w1819","Mechanized",NA,"Mon","weekday","no_sled","Kebler","3","3","2",3.4,0.1,19,-1,13,17.9,1,1,0,0,0,1,1,1
"4599",2018-12-03,"Kebler","w1819","Motorized",NA,"Mon","weekday","sled","Kebler","3","3","2",3.4,0.1,19,-1,13,17.9,1,1,0,0,0,1,1,1
"4600",2018-12-03,"Kebler","w1819","Hybrid",NA,"Mon","weekday","sled","Kebler","3","3","2",3.4,0.1,19,-1,13,17.9,1,1,0,0,0,1,1,1
"4601",2018-12-04,"Kebler","w1819","Non.motorized",NA,"Tue","weekday","no_sled","Kebler","3","3","2",3.5,0.1,20,1,8,17.5,-1,1,1,0,0,1,2,2
"4602",2018-12-04,"Kebler","w1819","Mechanized",NA,"Tue","weekday","no_sled","Kebler","3","3","2",3.5,0.1,20,1,8,17.5,-1,1,1,0,0,1,2,2
"4603",2018-12-04,"Kebler","w1819","Motorized",NA,"Tue","weekday","sled","Kebler","3","3","2",3.5,0.1,20,1,8,17.5,-1,1,1,0,0,1,2,2
"4604",2018-12-04,"Kebler","w1819","Hybrid",NA,"Tue","weekday","sled","Kebler","3","3","2",3.5,0.1,20,1,8,17.5,-1,1,1,0,0,1,2,2
"4605",2018-12-05,"Kebler","w1819","Non.motorized",0,"Wed","weekday","no_sled","Kebler","3","3","2",3.5,0,19,-1,21,18.4,1,-1,1,1,0,-1,0,1
"4606",2018-12-05,"Kebler","w1819","Mechanized",0,"Wed","weekday","no_sled","Kebler","3","3","2",3.5,0,19,-1,21,18.4,1,-1,1,1,0,-1,0,1
"4607",2018-12-05,"Kebler","w1819","Motorized",4,"Wed","weekday","sled","Kebler","3","3","2",3.5,0,19,-1,21,18.4,1,-1,1,1,0,-1,0,1
"4608",2018-12-05,"Kebler","w1819","Hybrid",0,"Wed","weekday","sled","Kebler","3","3","2",3.5,0,19,-1,21,18.4,1,-1,1,1,0,-1,0,1
"4609",2018-12-06,"Kebler","w1819","Non.motorized",0,"Thu","weekday","no_sled","Kebler","2","2","2",3.7,0.2,18,-1,25,20.6,-1,1,-1,1,-2,-1,-2,-1
"4610",2018-12-06,"Kebler","w1819","Mechanized",0,"Thu","weekday","no_sled","Kebler","2","2","2",3.7,0.2,18,-1,25,20.6,-1,1,-1,1,-2,-1,-2,-1
"4611",2018-12-06,"Kebler","w1819","Motorized",7,"Thu","weekday","sled","Kebler","2","2","2",3.7,0.2,18,-1,25,20.6,-1,1,-1,1,-2,-1,-2,-1
"4612",2018-12-06,"Kebler","w1819","Hybrid",0,"Thu","weekday","sled","Kebler","2","2","2",3.7,0.2,18,-1,25,20.6,-1,1,-1,1,-2,-1,-2,-1
"4613",2018-12-07,"Kebler","w1819","Non.motorized",4,"Fri","weekday","no_sled","Kebler","2","2","2",3.8,0.1,21,3,23,18.1,-1,-1,1,-1,2,1,2,1
"4614",2018-12-07,"Kebler","w1819","Mechanized",0,"Fri","weekday","no_sled","Kebler","2","2","2",3.8,0.1,21,3,23,18.1,-1,-1,1,-1,2,1,2,1
"4615",2018-12-07,"Kebler","w1819","Motorized",8,"Fri","weekday","sled","Kebler","2","2","2",3.8,0.1,21,3,23,18.1,-1,-1,1,-1,2,1,2,1
"4616",2018-12-07,"Kebler","w1819","Hybrid",0,"Fri","weekday","sled","Kebler","2","2","2",3.8,0.1,21,3,23,18.1,-1,-1,1,-1,2,1,2,1
"4617",2018-12-08,"Kebler","w1819","Non.motorized",9,"Sat","weekend","no_sled","Kebler","2","2","2",3.8,0,20,-1,23,19,3,-1,-1,1,2,1,0,1
"4618",2018-12-08,"Kebler","w1819","Mechanized",0,"Sat","weekend","no_sled","Kebler","2","2","2",3.8,0,20,-1,23,19,3,-1,-1,1,2,1,0,1
"4619",2018-12-08,"Kebler","w1819","Motorized",30,"Sat","weekend","sled","Kebler","2","2","2",3.8,0,20,-1,23,19,3,-1,-1,1,2,1,0,1
"4620",2018-12-08,"Kebler","w1819","Hybrid",0,"Sat","weekend","sled","Kebler","2","2","2",3.8,0,20,-1,23,19,3,-1,-1,1,2,1,0,1
"4621",2018-12-09,"Kebler","w1819","Non.motorized",0,"Sun","weekend","no_sled","Kebler","2","2","2",3.8,0,20,0,19,19,-1,3,-1,-1,-1,2,1,0
"4622",2018-12-09,"Kebler","w1819","Mechanized",1,"Sun","weekend","no_sled","Kebler","2","2","2",3.8,0,20,0,19,19,-1,3,-1,-1,-1,2,1,0
"4623",2018-12-09,"Kebler","w1819","Motorized",26,"Sun","weekend","sled","Kebler","2","2","2",3.8,0,20,0,19,19,-1,3,-1,-1,-1,2,1,0
"4624",2018-12-09,"Kebler","w1819","Hybrid",0,"Sun","weekend","sled","Kebler","2","2","2",3.8,0,20,0,19,19,-1,3,-1,-1,-1,2,1,0
"4625",2018-12-10,"Kebler","w1819","Non.motorized",0,"Mon","weekday","no_sled","Kebler","2","2","2",3.8,0,20,0,21,19,0,-1,3,-1,0,-1,2,1
"4626",2018-12-10,"Kebler","w1819","Mechanized",0,"Mon","weekday","no_sled","Kebler","2","2","2",3.8,0,20,0,21,19,0,-1,3,-1,0,-1,2,1
"4627",2018-12-10,"Kebler","w1819","Motorized",19,"Mon","weekday","sled","Kebler","2","2","2",3.8,0,20,0,21,19,0,-1,3,-1,0,-1,2,1
"4628",2018-12-10,"Kebler","w1819","Hybrid",0,"Mon","weekday","sled","Kebler","2","2","2",3.8,0,20,0,21,19,0,-1,3,-1,0,-1,2,1
"4629",2018-12-11,"Kebler","w1819","Non.motorized",1,"Tue","weekday","no_sled","Kebler","2","2","2",3.9,0.1,19,-1,27,20.5,0,0,-1,3,-1,-1,-2,1
"4630",2018-12-11,"Kebler","w1819","Mechanized",0,"Tue","weekday","no_sled","Kebler","2","2","2",3.9,0.1,19,-1,27,20.5,0,0,-1,3,-1,-1,-2,1
"4631",2018-12-11,"Kebler","w1819","Motorized",10,"Tue","weekday","sled","Kebler","2","2","2",3.9,0.1,19,-1,27,20.5,0,0,-1,3,-1,-1,-2,1
"4632",2018-12-11,"Kebler","w1819","Hybrid",0,"Tue","weekday","sled","Kebler","2","2","2",3.9,0.1,19,-1,27,20.5,0,0,-1,3,-1,-1,-2,1
"4633",2018-12-12,"Kebler","w1819","Non.motorized",3,"Wed","weekday","no_sled","Kebler","2","2","1",3.9,0,19,0,21,20.5,-1,0,0,-1,-1,-1,-1,-2
"4634",2018-12-12,"Kebler","w1819","Mechanized",0,"Wed","weekday","no_sled","Kebler","2","2","1",3.9,0,19,0,21,20.5,-1,0,0,-1,-1,-1,-1,-2
"4635",2018-12-12,"Kebler","w1819","Motorized",6,"Wed","weekday","sled","Kebler","2","2","1",3.9,0,19,0,21,20.5,-1,0,0,-1,-1,-1,-1,-2
"4636",2018-12-12,"Kebler","w1819","Hybrid",0,"Wed","weekday","sled","Kebler","2","2","1",3.9,0,19,0,21,20.5,-1,0,0,-1,-1,-1,-1,-2
"4637",2018-12-13,"Kebler","w1819","Non.motorized",0,"Thu","weekday","no_sled","Kebler","3","3","2",4,0.1,21,2,15,19,0,-1,0,0,2,1,1,1
"4638",2018-12-13,"Kebler","w1819","Mechanized",0,"Thu","weekday","no_sled","Kebler","3","3","2",4,0.1,21,2,15,19,0,-1,0,0,2,1,1,1
"4639",2018-12-13,"Kebler","w1819","Motorized",13,"Thu","weekday","sled","Kebler","3","3","2",4,0.1,21,2,15,19,0,-1,0,0,2,1,1,1
"4640",2018-12-13,"Kebler","w1819","Hybrid",0,"Thu","weekday","sled","Kebler","3","3","2",4,0.1,21,2,15,19,0,-1,0,0,2,1,1,1
"4641",2018-12-14,"Kebler","w1819","Non.motorized",1,"Fri","weekday","no_sled","Kebler","3","3","2",4,0,20,-1,24,20,2,0,-1,0,1,1,0,0
"4642",2018-12-14,"Kebler","w1819","Mechanized",0,"Fri","weekday","no_sled","Kebler","3","3","2",4,0,20,-1,24,20,2,0,-1,0,1,1,0,0
"4643",2018-12-14,"Kebler","w1819","Motorized",23,"Fri","weekday","sled","Kebler","3","3","2",4,0,20,-1,24,20,2,0,-1,0,1,1,0,0
"4644",2018-12-14,"Kebler","w1819","Hybrid",0,"Fri","weekday","sled","Kebler","3","3","2",4,0,20,-1,24,20,2,0,-1,0,1,1,0,0
"4645",2018-12-15,"Kebler","w1819","Non.motorized",1,"Sat","weekend","no_sled","Kebler","2","2","2",4,0,20,0,29,20,-1,2,0,-1,-1,1,1,0
"4646",2018-12-15,"Kebler","w1819","Mechanized",0,"Sat","weekend","no_sled","Kebler","2","2","2",4,0,20,0,29,20,-1,2,0,-1,-1,1,1,0
"4647",2018-12-15,"Kebler","w1819","Motorized",20,"Sat","weekend","sled","Kebler","2","2","2",4,0,20,0,29,20,-1,2,0,-1,-1,1,1,0
"4648",2018-12-15,"Kebler","w1819","Hybrid",0,"Sat","weekend","sled","Kebler","2","2","2",4,0,20,0,29,20,-1,2,0,-1,-1,1,1,0
"4649",2018-12-16,"Kebler","w1819","Non.motorized",6,"Sun","weekend","no_sled","Kebler","2","2","2",4.1,0.1,19,-1,28,21.6,0,-1,2,0,-1,-2,0,0
"4650",2018-12-16,"Kebler","w1819","Mechanized",0,"Sun","weekend","no_sled","Kebler","2","2","2",4.1,0.1,19,-1,28,21.6,0,-1,2,0,-1,-2,0,0
"4651",2018-12-16,"Kebler","w1819","Motorized",20,"Sun","weekend","sled","Kebler","2","2","2",4.1,0.1,19,-1,28,21.6,0,-1,2,0,-1,-2,0,0
"4652",2018-12-16,"Kebler","w1819","Hybrid",0,"Sun","weekend","sled","Kebler","2","2","2",4.1,0.1,19,-1,28,21.6,0,-1,2,0,-1,-2,0,0
"4653",2018-12-17,"Kebler","w1819","Non.motorized",1,"Mon","weekday","no_sled","Kebler","2","2","2",4.1,0,19,0,29,21.6,-1,0,-1,2,-1,-1,-2,0
"4654",2018-12-17,"Kebler","w1819","Mechanized",0,"Mon","weekday","no_sled","Kebler","2","2","2",4.1,0,19,0,29,21.6,-1,0,-1,2,-1,-1,-2,0
"4655",2018-12-17,"Kebler","w1819","Motorized",15,"Mon","weekday","sled","Kebler","2","2","2",4.1,0,19,0,29,21.6,-1,0,-1,2,-1,-1,-2,0
"4656",2018-12-17,"Kebler","w1819","Hybrid",0,"Mon","weekday","sled","Kebler","2","2","2",4.1,0,19,0,29,21.6,-1,0,-1,2,-1,-1,-2,0
"4657",2018-12-18,"Kebler","w1819","Non.motorized",1,"Tue","weekday","no_sled","Kebler","2","2","2",4.1,0,19,0,27,21.6,0,-1,0,-1,0,-1,-1,-2
"4658",2018-12-18,"Kebler","w1819","Mechanized",0,"Tue","weekday","no_sled","Kebler","2","2","2",4.1,0,19,0,27,21.6,0,-1,0,-1,0,-1,-1,-2
"4659",2018-12-18,"Kebler","w1819","Motorized",18,"Tue","weekday","sled","Kebler","2","2","2",4.1,0,19,0,27,21.6,0,-1,0,-1,0,-1,-1,-2
"4660",2018-12-18,"Kebler","w1819","Hybrid",0,"Tue","weekday","sled","Kebler","2","2","2",4.1,0,19,0,27,21.6,0,-1,0,-1,0,-1,-1,-2
"4661",2018-12-19,"Kebler","w1819","Non.motorized",0,"Wed","weekday","no_sled","Kebler","2","2","2",4.1,0,19,0,24,21.6,0,0,-1,0,0,0,-1,-1
"4662",2018-12-19,"Kebler","w1819","Mechanized",0,"Wed","weekday","no_sled","Kebler","2","2","2",4.1,0,19,0,24,21.6,0,0,-1,0,0,0,-1,-1
"4663",2018-12-19,"Kebler","w1819","Motorized",12,"Wed","weekday","sled","Kebler","2","2","2",4.1,0,19,0,24,21.6,0,0,-1,0,0,0,-1,-1
"4664",2018-12-19,"Kebler","w1819","Hybrid",0,"Wed","weekday","sled","Kebler","2","2","2",4.1,0,19,0,24,21.6,0,0,-1,0,0,0,-1,-1
"4665",2018-12-20,"Kebler","w1819","Non.motorized",0,"Thu","weekday","no_sled","Kebler","2","2","1",4.1,0,20,1,25,20.5,0,0,0,-1,1,1,1,0
"4666",2018-12-20,"Kebler","w1819","Mechanized",0,"Thu","weekday","no_sled","Kebler","2","2","1",4.1,0,20,1,25,20.5,0,0,0,-1,1,1,1,0
"4667",2018-12-20,"Kebler","w1819","Motorized",5,"Thu","weekday","sled","Kebler","2","2","1",4.1,0,20,1,25,20.5,0,0,0,-1,1,1,1,0
"4668",2018-12-20,"Kebler","w1819","Hybrid",0,"Thu","weekday","sled","Kebler","2","2","1",4.1,0,20,1,25,20.5,0,0,0,-1,1,1,1,0
"4669",2018-12-21,"Kebler","w1819","Non.motorized",6,"Fri","weekday","no_sled","Kebler","2","2","1",4.1,0,19,-1,28,21.6,1,0,0,0,0,0,0,0
"4670",2018-12-21,"Kebler","w1819","Mechanized",0,"Fri","weekday","no_sled","Kebler","2","2","1",4.1,0,19,-1,28,21.6,1,0,0,0,0,0,0,0
"4671",2018-12-21,"Kebler","w1819","Motorized",24,"Fri","weekday","sled","Kebler","2","2","1",4.1,0,19,-1,28,21.6,1,0,0,0,0,0,0,0
"4672",2018-12-21,"Kebler","w1819","Hybrid",0,"Fri","weekday","sled","Kebler","2","2","1",4.1,0,19,-1,28,21.6,1,0,0,0,0,0,0,0
"4673",2018-12-22,"Kebler","w1819","Non.motorized",NA,"Sat","weekend","no_sled","Kebler","2","2","1",4.2,0.1,19,0,20,22.1,-1,1,0,0,-1,0,0,0
"4674",2018-12-22,"Kebler","w1819","Mechanized",NA,"Sat","weekend","no_sled","Kebler","2","2","1",4.2,0.1,19,0,20,22.1,-1,1,0,0,-1,0,0,0
"4675",2018-12-22,"Kebler","w1819","Motorized",NA,"Sat","weekend","sled","Kebler","2","2","1",4.2,0.1,19,0,20,22.1,-1,1,0,0,-1,0,0,0
"4676",2018-12-22,"Kebler","w1819","Hybrid",NA,"Sat","weekend","sled","Kebler","2","2","1",4.2,0.1,19,0,20,22.1,-1,1,0,0,-1,0,0,0
"4677",2018-12-23,"Kebler","w1819","Non.motorized",18,"Sun","weekend","no_sled","Kebler","2","2","1",4.2,0,21,2,19,20,0,-1,1,0,2,1,2,2
"4678",2018-12-23,"Kebler","w1819","Mechanized",0,"Sun","weekend","no_sled","Kebler","2","2","1",4.2,0,21,2,19,20,0,-1,1,0,2,1,2,2
"4679",2018-12-23,"Kebler","w1819","Motorized",44,"Sun","weekend","sled","Kebler","2","2","1",4.2,0,21,2,19,20,0,-1,1,0,2,1,2,2
"4680",2018-12-23,"Kebler","w1819","Hybrid",0,"Sun","weekend","sled","Kebler","2","2","1",4.2,0,21,2,19,20,0,-1,1,0,2,1,2,2
"4681",2018-12-24,"Kebler","w1819","Non.motorized",0,"Mon","weekday","no_sled","Kebler","2","2","2",4.3,0.1,20,-1,21,21.5,2,0,-1,1,1,1,0,1
"4682",2018-12-24,"Kebler","w1819","Mechanized",1,"Mon","weekday","no_sled","Kebler","2","2","2",4.3,0.1,20,-1,21,21.5,2,0,-1,1,1,1,0,1
"4683",2018-12-24,"Kebler","w1819","Motorized",12,"Mon","weekday","sled","Kebler","2","2","2",4.3,0.1,20,-1,21,21.5,2,0,-1,1,1,1,0,1
"4684",2018-12-24,"Kebler","w1819","Hybrid",0,"Mon","weekday","sled","Kebler","2","2","2",4.3,0.1,20,-1,21,21.5,2,0,-1,1,1,1,0,1
"4685",2018-12-25,"Kebler","w1819","Non.motorized",0,"Tue","weekday","no_sled","Kebler","2","2","2",4.7,0.4,25,5,25,18.8,-1,2,0,-1,4,6,6,5
"4686",2018-12-25,"Kebler","w1819","Mechanized",0,"Tue","weekday","no_sled","Kebler","2","2","2",4.7,0.4,25,5,25,18.8,-1,2,0,-1,4,6,6,5
"4687",2018-12-25,"Kebler","w1819","Motorized",69,"Tue","weekday","sled","Kebler","2","2","2",4.7,0.4,25,5,25,18.8,-1,2,0,-1,4,6,6,5
"4688",2018-12-25,"Kebler","w1819","Hybrid",0,"Tue","weekday","sled","Kebler","2","2","2",4.7,0.4,25,5,25,18.8,-1,2,0,-1,4,6,6,5
"4689",2018-12-26,"Kebler","w1819","Non.motorized",2,"Wed","weekday","no_sled","Kebler","3","3","3",4.7,0,23,-2,24,20.4,5,-1,2,0,3,2,4,4
"4690",2018-12-26,"Kebler","w1819","Mechanized",0,"Wed","weekday","no_sled","Kebler","3","3","3",4.7,0,23,-2,24,20.4,5,-1,2,0,3,2,4,4
"4691",2018-12-26,"Kebler","w1819","Motorized",89,"Wed","weekday","sled","Kebler","3","3","3",4.7,0,23,-2,24,20.4,5,-1,2,0,3,2,4,4
"4692",2018-12-26,"Kebler","w1819","Hybrid",0,"Wed","weekday","sled","Kebler","3","3","3",4.7,0,23,-2,24,20.4,5,-1,2,0,3,2,4,4
"4693",2018-12-27,"Kebler","w1819","Non.motorized",6,"Thu","weekday","no_sled","Kebler","3","3","2",4.7,0,24,1,12,19.6,-2,5,-1,2,-1,4,3,5
"4694",2018-12-27,"Kebler","w1819","Mechanized",0,"Thu","weekday","no_sled","Kebler","3","3","2",4.7,0,24,1,12,19.6,-2,5,-1,2,-1,4,3,5
"4695",2018-12-27,"Kebler","w1819","Motorized",46,"Thu","weekday","sled","Kebler","3","3","2",4.7,0,24,1,12,19.6,-2,5,-1,2,-1,4,3,5
"4696",2018-12-27,"Kebler","w1819","Hybrid",0,"Thu","weekday","sled","Kebler","3","3","2",4.7,0,24,1,12,19.6,-2,5,-1,2,-1,4,3,5
"4697",2018-12-28,"Kebler","w1819","Non.motorized",3,"Fri","weekday","no_sled","Kebler","3","3","2",4.7,0,24,0,12,19.6,1,-2,5,-1,1,-1,4,3
"4698",2018-12-28,"Kebler","w1819","Mechanized",0,"Fri","weekday","no_sled","Kebler","3","3","2",4.7,0,24,0,12,19.6,1,-2,5,-1,1,-1,4,3
"4699",2018-12-28,"Kebler","w1819","Motorized",62,"Fri","weekday","sled","Kebler","3","3","2",4.7,0,24,0,12,19.6,1,-2,5,-1,1,-1,4,3
"4700",2018-12-28,"Kebler","w1819","Hybrid",0,"Fri","weekday","sled","Kebler","3","3","2",4.7,0,24,0,12,19.6,1,-2,5,-1,1,-1,4,3
"4701",2018-12-29,"Kebler","w1819","Non.motorized",6,"Sat","weekend","no_sled","Kebler","3","3","2",4.7,0,24,0,8,19.6,0,1,-2,5,0,1,-1,4
"4702",2018-12-29,"Kebler","w1819","Mechanized",0,"Sat","weekend","no_sled","Kebler","3","3","2",4.7,0,24,0,8,19.6,0,1,-2,5,0,1,-1,4
"4703",2018-12-29,"Kebler","w1819","Motorized",179,"Sat","weekend","sled","Kebler","3","3","2",4.7,0,24,0,8,19.6,0,1,-2,5,0,1,-1,4
"4704",2018-12-29,"Kebler","w1819","Hybrid",2,"Sat","weekend","sled","Kebler","3","3","2",4.7,0,24,0,8,19.6,0,1,-2,5,0,1,-1,4
"4705",2018-12-30,"Kebler","w1819","Non.motorized",13,"Sun","weekend","no_sled","Kebler","3","3","2",4.7,0,24,0,16,19.6,0,0,1,-2,0,0,1,-1
"4706",2018-12-30,"Kebler","w1819","Mechanized",0,"Sun","weekend","no_sled","Kebler","3","3","2",4.7,0,24,0,16,19.6,0,0,1,-2,0,0,1,-1
"4707",2018-12-30,"Kebler","w1819","Motorized",167,"Sun","weekend","sled","Kebler","3","3","2",4.7,0,24,0,16,19.6,0,0,1,-2,0,0,1,-1
"4708",2018-12-30,"Kebler","w1819","Hybrid",0,"Sun","weekend","sled","Kebler","3","3","2",4.7,0,24,0,16,19.6,0,0,1,-2,0,0,1,-1
"4709",2018-12-31,"Kebler","w1819","Non.motorized",1,"Mon","weekday","no_sled","Kebler","3","3","3",4.9,0.2,23,-1,14,21.3,0,0,0,1,-1,-1,-1,0
"4710",2018-12-31,"Kebler","w1819","Mechanized",0,"Mon","weekday","no_sled","Kebler","3","3","3",4.9,0.2,23,-1,14,21.3,0,0,0,1,-1,-1,-1,0
"4711",2018-12-31,"Kebler","w1819","Motorized",38,"Mon","weekday","sled","Kebler","3","3","3",4.9,0.2,23,-1,14,21.3,0,0,0,1,-1,-1,-1,0
"4712",2018-12-31,"Kebler","w1819","Hybrid",0,"Mon","weekday","sled","Kebler","3","3","3",4.9,0.2,23,-1,14,21.3,0,0,0,1,-1,-1,-1,0
"4713",2019-01-01,"Kebler","w1819","Non.motorized",2,"Tue","weekday","no_sled","Kebler","3","3","3",5.1,0.2,29,6,11,17.6,-1,0,0,0,5,5,5,5
"4714",2019-01-01,"Kebler","w1819","Mechanized",0,"Tue","weekday","no_sled","Kebler","3","3","3",5.1,0.2,29,6,11,17.6,-1,0,0,0,5,5,5,5
"4715",2019-01-01,"Kebler","w1819","Motorized",88,"Tue","weekday","sled","Kebler","3","3","3",5.1,0.2,29,6,11,17.6,-1,0,0,0,5,5,5,5
"4716",2019-01-01,"Kebler","w1819","Hybrid",0,"Tue","weekday","sled","Kebler","3","3","3",5.1,0.2,29,6,11,17.6,-1,0,0,0,5,5,5,5
"4717",2019-01-02,"Kebler","w1819","Non.motorized",2,"Wed","weekday","no_sled","Kebler","3","3","2",5.1,0,28,-1,10,18.2,6,-1,0,0,5,4,4,4
"4718",2019-01-02,"Kebler","w1819","Mechanized",0,"Wed","weekday","no_sled","Kebler","3","3","2",5.1,0,28,-1,10,18.2,6,-1,0,0,5,4,4,4
"4719",2019-01-02,"Kebler","w1819","Motorized",116,"Wed","weekday","sled","Kebler","3","3","2",5.1,0,28,-1,10,18.2,6,-1,0,0,5,4,4,4
"4720",2019-01-02,"Kebler","w1819","Hybrid",0,"Wed","weekday","sled","Kebler","3","3","2",5.1,0,28,-1,10,18.2,6,-1,0,0,5,4,4,4
"4721",2019-01-03,"Kebler","w1819","Non.motorized",0,"Thu","weekday","no_sled","Kebler","3","3","2",5.1,0,27,-1,22,18.9,-1,6,-1,0,-2,4,3,3
"4722",2019-01-03,"Kebler","w1819","Mechanized",0,"Thu","weekday","no_sled","Kebler","3","3","2",5.1,0,27,-1,22,18.9,-1,6,-1,0,-2,4,3,3
"4723",2019-01-03,"Kebler","w1819","Motorized",172,"Thu","weekday","sled","Kebler","3","3","2",5.1,0,27,-1,22,18.9,-1,6,-1,0,-2,4,3,3
"4724",2019-01-03,"Kebler","w1819","Hybrid",8,"Thu","weekday","sled","Kebler","3","3","2",5.1,0,27,-1,22,18.9,-1,6,-1,0,-2,4,3,3
"4725",2019-01-04,"Kebler","w1819","Non.motorized",0,"Fri","weekday","no_sled","Kebler","3","3","2",5.3,0.2,26,-1,29,20.4,-1,-1,6,-1,-2,-3,3,2
"4726",2019-01-04,"Kebler","w1819","Mechanized",0,"Fri","weekday","no_sled","Kebler","3","3","2",5.3,0.2,26,-1,29,20.4,-1,-1,6,-1,-2,-3,3,2
"4727",2019-01-04,"Kebler","w1819","Motorized",148,"Fri","weekday","sled","Kebler","3","3","2",5.3,0.2,26,-1,29,20.4,-1,-1,6,-1,-2,-3,3,2
"4728",2019-01-04,"Kebler","w1819","Hybrid",9,"Fri","weekday","sled","Kebler","3","3","2",5.3,0.2,26,-1,29,20.4,-1,-1,6,-1,-2,-3,3,2
"4729",2019-01-05,"Kebler","w1819","Non.motorized",5,"Sat","weekend","no_sled","Kebler","2","2","2",5.3,0,25,-1,30,21.2,-1,-1,-1,6,-2,-3,-4,2
"4730",2019-01-05,"Kebler","w1819","Mechanized",2,"Sat","weekend","no_sled","Kebler","2","2","2",5.3,0,25,-1,30,21.2,-1,-1,-1,6,-2,-3,-4,2
"4731",2019-01-05,"Kebler","w1819","Motorized",96,"Sat","weekend","sled","Kebler","2","2","2",5.3,0,25,-1,30,21.2,-1,-1,-1,6,-2,-3,-4,2
"4732",2019-01-05,"Kebler","w1819","Hybrid",3,"Sat","weekend","sled","Kebler","2","2","2",5.3,0,25,-1,30,21.2,-1,-1,-1,6,-2,-3,-4,2
"4733",2019-01-06,"Kebler","w1819","Non.motorized",NA,"Sun","weekend","no_sled","Kebler","3","3","3",5.3,0,25,0,26,21.2,-1,-1,-1,-1,-1,-2,-3,-4
"4734",2019-01-06,"Kebler","w1819","Mechanized",NA,"Sun","weekend","no_sled","Kebler","3","3","3",5.3,0,25,0,26,21.2,-1,-1,-1,-1,-1,-2,-3,-4
"4735",2019-01-06,"Kebler","w1819","Motorized",NA,"Sun","weekend","sled","Kebler","3","3","3",5.3,0,25,0,26,21.2,-1,-1,-1,-1,-1,-2,-3,-4
"4736",2019-01-06,"Kebler","w1819","Hybrid",NA,"Sun","weekend","sled","Kebler","3","3","3",5.3,0,25,0,26,21.2,-1,-1,-1,-1,-1,-2,-3,-4
"4737",2019-01-07,"Kebler","w1819","Non.motorized",NA,"Mon","weekday","no_sled","Kebler","3","3","3",5.8,0.5,32,7,21,18.1,0,-1,-1,-1,7,6,5,4
"4738",2019-01-07,"Kebler","w1819","Mechanized",NA,"Mon","weekday","no_sled","Kebler","3","3","3",5.8,0.5,32,7,21,18.1,0,-1,-1,-1,7,6,5,4
"4739",2019-01-07,"Kebler","w1819","Motorized",NA,"Mon","weekday","sled","Kebler","3","3","3",5.8,0.5,32,7,21,18.1,0,-1,-1,-1,7,6,5,4
"4740",2019-01-07,"Kebler","w1819","Hybrid",NA,"Mon","weekday","sled","Kebler","3","3","3",5.8,0.5,32,7,21,18.1,0,-1,-1,-1,7,6,5,4
"4741",2019-01-08,"Kebler","w1819","Non.motorized",3,"Tue","weekday","no_sled","Kebler","3","3","3",5.9,0.1,32,0,24,18.4,7,0,-1,-1,7,7,6,5
"4742",2019-01-08,"Kebler","w1819","Mechanized",0,"Tue","weekday","no_sled","Kebler","3","3","3",5.9,0.1,32,0,24,18.4,7,0,-1,-1,7,7,6,5
"4743",2019-01-08,"Kebler","w1819","Motorized",48,"Tue","weekday","sled","Kebler","3","3","3",5.9,0.1,32,0,24,18.4,7,0,-1,-1,7,7,6,5
"4744",2019-01-08,"Kebler","w1819","Hybrid",2,"Tue","weekday","sled","Kebler","3","3","3",5.9,0.1,32,0,24,18.4,7,0,-1,-1,7,7,6,5
"4745",2019-01-09,"Kebler","w1819","Non.motorized",7,"Wed","weekday","no_sled","Kebler","3","3","3",6,0.1,30,-2,29,20,0,7,0,-1,-2,5,5,4
"4746",2019-01-09,"Kebler","w1819","Mechanized",0,"Wed","weekday","no_sled","Kebler","3","3","3",6,0.1,30,-2,29,20,0,7,0,-1,-2,5,5,4
"4747",2019-01-09,"Kebler","w1819","Motorized",56,"Wed","weekday","sled","Kebler","3","3","3",6,0.1,30,-2,29,20,0,7,0,-1,-2,5,5,4
"4748",2019-01-09,"Kebler","w1819","Hybrid",7,"Wed","weekday","sled","Kebler","3","3","3",6,0.1,30,-2,29,20,0,7,0,-1,-2,5,5,4
"4749",2019-01-10,"Kebler","w1819","Non.motorized",4,"Thu","weekday","no_sled","Kebler","3","3","3",6,0,29,-1,29,20.7,-2,0,7,0,-3,-3,4,4
"4750",2019-01-10,"Kebler","w1819","Mechanized",4,"Thu","weekday","no_sled","Kebler","3","3","3",6,0,29,-1,29,20.7,-2,0,7,0,-3,-3,4,4
"4751",2019-01-10,"Kebler","w1819","Motorized",72,"Thu","weekday","sled","Kebler","3","3","3",6,0,29,-1,29,20.7,-2,0,7,0,-3,-3,4,4
"4752",2019-01-10,"Kebler","w1819","Hybrid",1,"Thu","weekday","sled","Kebler","3","3","3",6,0,29,-1,29,20.7,-2,0,7,0,-3,-3,4,4
"4753",2019-01-11,"Kebler","w1819","Non.motorized",0,"Fri","weekday","no_sled","Kebler","2","2","2",6.1,0.1,29,0,25,21,-1,-2,0,7,-1,-3,-3,4
"4754",2019-01-11,"Kebler","w1819","Mechanized",1,"Fri","weekday","no_sled","Kebler","2","2","2",6.1,0.1,29,0,25,21,-1,-2,0,7,-1,-3,-3,4
"4755",2019-01-11,"Kebler","w1819","Motorized",41,"Fri","weekday","sled","Kebler","2","2","2",6.1,0.1,29,0,25,21,-1,-2,0,7,-1,-3,-3,4
"4756",2019-01-11,"Kebler","w1819","Hybrid",2,"Fri","weekday","sled","Kebler","2","2","2",6.1,0.1,29,0,25,21,-1,-2,0,7,-1,-3,-3,4
"4757",2019-01-12,"Kebler","w1819","Non.motorized",0,"Sat","weekend","no_sled","Kebler","3","3","2",6.1,0,28,-1,21,21.8,0,-1,-2,0,-1,-2,-4,-4
"4758",2019-01-12,"Kebler","w1819","Mechanized",1,"Sat","weekend","no_sled","Kebler","3","3","2",6.1,0,28,-1,21,21.8,0,-1,-2,0,-1,-2,-4,-4
"4759",2019-01-12,"Kebler","w1819","Motorized",26,"Sat","weekend","sled","Kebler","3","3","2",6.1,0,28,-1,21,21.8,0,-1,-2,0,-1,-2,-4,-4
"4760",2019-01-12,"Kebler","w1819","Hybrid",2,"Sat","weekend","sled","Kebler","3","3","2",6.1,0,28,-1,21,21.8,0,-1,-2,0,-1,-2,-4,-4
"4761",2019-01-13,"Kebler","w1819","Non.motorized",2,"Sun","weekend","no_sled","Kebler","2","2","2",6.2,0.1,30,2,18,20.7,-1,0,-1,-2,1,1,0,-2
"4762",2019-01-13,"Kebler","w1819","Mechanized",1,"Sun","weekend","no_sled","Kebler","2","2","2",6.2,0.1,30,2,18,20.7,-1,0,-1,-2,1,1,0,-2
"4763",2019-01-13,"Kebler","w1819","Motorized",41,"Sun","weekend","sled","Kebler","2","2","2",6.2,0.1,30,2,18,20.7,-1,0,-1,-2,1,1,0,-2
"4764",2019-01-13,"Kebler","w1819","Hybrid",3,"Sun","weekend","sled","Kebler","2","2","2",6.2,0.1,30,2,18,20.7,-1,0,-1,-2,1,1,0,-2
"4765",2019-01-14,"Kebler","w1819","Non.motorized",0,"Mon","weekday","no_sled","Kebler","2","2","2",6.2,0,30,0,18,20.7,2,-1,0,-1,2,1,1,0
"4766",2019-01-14,"Kebler","w1819","Mechanized",0,"Mon","weekday","no_sled","Kebler","2","2","2",6.2,0,30,0,18,20.7,2,-1,0,-1,2,1,1,0
"4767",2019-01-14,"Kebler","w1819","Motorized",25,"Mon","weekday","sled","Kebler","2","2","2",6.2,0,30,0,18,20.7,2,-1,0,-1,2,1,1,0
"4768",2019-01-14,"Kebler","w1819","Hybrid",2,"Mon","weekday","sled","Kebler","2","2","2",6.2,0,30,0,18,20.7,2,-1,0,-1,2,1,1,0
"4769",2019-01-15,"Kebler","w1819","Non.motorized",8,"Tue","weekday","no_sled","Kebler","2","2","2",6.2,0,29,-1,24,21.4,0,2,-1,0,-1,1,0,0
"4770",2019-01-15,"Kebler","w1819","Mechanized",0,"Tue","weekday","no_sled","Kebler","2","2","2",6.2,0,29,-1,24,21.4,0,2,-1,0,-1,1,0,0
"4771",2019-01-15,"Kebler","w1819","Motorized",54,"Tue","weekday","sled","Kebler","2","2","2",6.2,0,29,-1,24,21.4,0,2,-1,0,-1,1,0,0
"4772",2019-01-15,"Kebler","w1819","Hybrid",7,"Tue","weekday","sled","Kebler","2","2","2",6.2,0,29,-1,24,21.4,0,2,-1,0,-1,1,0,0
"4773",2019-01-16,"Kebler","w1819","Non.motorized",NA,"Wed","weekday","no_sled","Kebler","4","4","3",6.3,0.1,29,0,26,21.7,-1,0,2,-1,-1,-1,1,0
"4774",2019-01-16,"Kebler","w1819","Mechanized",NA,"Wed","weekday","no_sled","Kebler","4","4","3",6.3,0.1,29,0,26,21.7,-1,0,2,-1,-1,-1,1,0
"4775",2019-01-16,"Kebler","w1819","Motorized",NA,"Wed","weekday","sled","Kebler","4","4","3",6.3,0.1,29,0,26,21.7,-1,0,2,-1,-1,-1,1,0
"4776",2019-01-16,"Kebler","w1819","Hybrid",NA,"Wed","weekday","sled","Kebler","4","4","3",6.3,0.1,29,0,26,21.7,-1,0,2,-1,-1,-1,1,0
"4777",2019-01-17,"Kebler","w1819","Non.motorized",5,"Thu","weekday","no_sled","Kebler","3","3","2",7,0.7,38,9,28,18.4,0,-1,0,2,9,8,8,10
"4778",2019-01-17,"Kebler","w1819","Mechanized",0,"Thu","weekday","no_sled","Kebler","3","3","2",7,0.7,38,9,28,18.4,0,-1,0,2,9,8,8,10
"4779",2019-01-17,"Kebler","w1819","Motorized",19,"Thu","weekday","sled","Kebler","3","3","2",7,0.7,38,9,28,18.4,0,-1,0,2,9,8,8,10
"4780",2019-01-17,"Kebler","w1819","Hybrid",5,"Thu","weekday","sled","Kebler","3","3","2",7,0.7,38,9,28,18.4,0,-1,0,2,9,8,8,10
"4781",2019-01-18,"Kebler","w1819","Non.motorized",9,"Fri","weekday","no_sled","Kebler","4","4","4",7.5,0.5,41,3,22,18.3,9,0,-1,0,12,12,11,11
"4782",2019-01-18,"Kebler","w1819","Mechanized",0,"Fri","weekday","no_sled","Kebler","4","4","4",7.5,0.5,41,3,22,18.3,9,0,-1,0,12,12,11,11
"4783",2019-01-18,"Kebler","w1819","Motorized",8,"Fri","weekday","sled","Kebler","4","4","4",7.5,0.5,41,3,22,18.3,9,0,-1,0,12,12,11,11
"4784",2019-01-18,"Kebler","w1819","Hybrid",0,"Fri","weekday","sled","Kebler","4","4","4",7.5,0.5,41,3,22,18.3,9,0,-1,0,12,12,11,11
"4785",2019-01-19,"Kebler","w1819","Non.motorized",14,"Sat","weekend","no_sled","Kebler","3","3","3",7.8,0.3,43,2,20,18.1,3,9,0,-1,5,14,14,13
"4786",2019-01-19,"Kebler","w1819","Mechanized",0,"Sat","weekend","no_sled","Kebler","3","3","3",7.8,0.3,43,2,20,18.1,3,9,0,-1,5,14,14,13
"4787",2019-01-19,"Kebler","w1819","Motorized",81,"Sat","weekend","sled","Kebler","3","3","3",7.8,0.3,43,2,20,18.1,3,9,0,-1,5,14,14,13
"4788",2019-01-19,"Kebler","w1819","Hybrid",6,"Sat","weekend","sled","Kebler","3","3","3",7.8,0.3,43,2,20,18.1,3,9,0,-1,5,14,14,13
"4789",2019-01-20,"Kebler","w1819","Non.motorized",5,"Sun","weekend","no_sled","Kebler","3","3","3",7.9,0.1,41,-2,27,19.3,2,3,9,0,0,3,12,12
"4790",2019-01-20,"Kebler","w1819","Mechanized",0,"Sun","weekend","no_sled","Kebler","3","3","3",7.9,0.1,41,-2,27,19.3,2,3,9,0,0,3,12,12
"4791",2019-01-20,"Kebler","w1819","Motorized",98,"Sun","weekend","sled","Kebler","3","3","3",7.9,0.1,41,-2,27,19.3,2,3,9,0,0,3,12,12
"4792",2019-01-20,"Kebler","w1819","Hybrid",8,"Sun","weekend","sled","Kebler","3","3","3",7.9,0.1,41,-2,27,19.3,2,3,9,0,0,3,12,12
"4793",2019-01-21,"Kebler","w1819","Non.motorized",0,"Mon","weekday","no_sled","Kebler","3","3","3",7.9,0,39,-2,23,20.3,-2,2,3,9,-4,-2,1,10
"4794",2019-01-21,"Kebler","w1819","Mechanized",0,"Mon","weekday","no_sled","Kebler","3","3","3",7.9,0,39,-2,23,20.3,-2,2,3,9,-4,-2,1,10
"4795",2019-01-21,"Kebler","w1819","Motorized",12,"Mon","weekday","sled","Kebler","3","3","3",7.9,0,39,-2,23,20.3,-2,2,3,9,-4,-2,1,10
"4796",2019-01-21,"Kebler","w1819","Hybrid",0,"Mon","weekday","sled","Kebler","3","3","3",7.9,0,39,-2,23,20.3,-2,2,3,9,-4,-2,1,10
"4797",2019-01-22,"Kebler","w1819","Non.motorized",NA,"Tue","weekday","no_sled","Kebler","3","3","3",8,0.1,41,2,12,19.5,-2,-2,2,3,0,-2,0,3
"4798",2019-01-22,"Kebler","w1819","Mechanized",NA,"Tue","weekday","no_sled","Kebler","3","3","3",8,0.1,41,2,12,19.5,-2,-2,2,3,0,-2,0,3
"4799",2019-01-22,"Kebler","w1819","Motorized",NA,"Tue","weekday","sled","Kebler","3","3","3",8,0.1,41,2,12,19.5,-2,-2,2,3,0,-2,0,3
"4800",2019-01-22,"Kebler","w1819","Hybrid",NA,"Tue","weekday","sled","Kebler","3","3","3",8,0.1,41,2,12,19.5,-2,-2,2,3,0,-2,0,3
"4801",2019-01-23,"Kebler","w1819","Non.motorized",NA,"Wed","weekday","no_sled","Kebler","3","3","2",8,0,40,-1,14,20,2,-2,-2,2,1,-1,-3,-1
"4802",2019-01-23,"Kebler","w1819","Mechanized",NA,"Wed","weekday","no_sled","Kebler","3","3","2",8,0,40,-1,14,20,2,-2,-2,2,1,-1,-3,-1
"4803",2019-01-23,"Kebler","w1819","Motorized",NA,"Wed","weekday","sled","Kebler","3","3","2",8,0,40,-1,14,20,2,-2,-2,2,1,-1,-3,-1
"4804",2019-01-23,"Kebler","w1819","Hybrid",NA,"Wed","weekday","sled","Kebler","3","3","2",8,0,40,-1,14,20,2,-2,-2,2,1,-1,-3,-1
"4805",2019-01-24,"Kebler","w1819","Non.motorized",NA,"Thu","weekday","no_sled","Kebler","3","3","2",8.2,0.2,40,0,17,20.5,-1,2,-2,-2,-1,1,-1,-3
"4806",2019-01-24,"Kebler","w1819","Mechanized",NA,"Thu","weekday","no_sled","Kebler","3","3","2",8.2,0.2,40,0,17,20.5,-1,2,-2,-2,-1,1,-1,-3
"4807",2019-01-24,"Kebler","w1819","Motorized",NA,"Thu","weekday","sled","Kebler","3","3","2",8.2,0.2,40,0,17,20.5,-1,2,-2,-2,-1,1,-1,-3
"4808",2019-01-24,"Kebler","w1819","Hybrid",NA,"Thu","weekday","sled","Kebler","3","3","2",8.2,0.2,40,0,17,20.5,-1,2,-2,-2,-1,1,-1,-3
"4809",2019-01-25,"Kebler","w1819","Non.motorized",NA,"Fri","weekday","no_sled","Kebler","3","3","2",8.3,0.1,40,0,15,20.8,0,-1,2,-2,0,-1,1,-1
"4810",2019-01-25,"Kebler","w1819","Mechanized",NA,"Fri","weekday","no_sled","Kebler","3","3","2",8.3,0.1,40,0,15,20.8,0,-1,2,-2,0,-1,1,-1
"4811",2019-01-25,"Kebler","w1819","Motorized",NA,"Fri","weekday","sled","Kebler","3","3","2",8.3,0.1,40,0,15,20.8,0,-1,2,-2,0,-1,1,-1
"4812",2019-01-25,"Kebler","w1819","Hybrid",NA,"Fri","weekday","sled","Kebler","3","3","2",8.3,0.1,40,0,15,20.8,0,-1,2,-2,0,-1,1,-1
"4813",2019-01-26,"Kebler","w1819","Non.motorized",NA,"Sat","weekend","no_sled","Kebler","3","3","2",8.3,0,39,-1,19,21.3,0,0,-1,2,-1,-1,-2,0
"4814",2019-01-26,"Kebler","w1819","Mechanized",NA,"Sat","weekend","no_sled","Kebler","3","3","2",8.3,0,39,-1,19,21.3,0,0,-1,2,-1,-1,-2,0
"4815",2019-01-26,"Kebler","w1819","Motorized",NA,"Sat","weekend","sled","Kebler","3","3","2",8.3,0,39,-1,19,21.3,0,0,-1,2,-1,-1,-2,0
"4816",2019-01-26,"Kebler","w1819","Hybrid",NA,"Sat","weekend","sled","Kebler","3","3","2",8.3,0,39,-1,19,21.3,0,0,-1,2,-1,-1,-2,0
"4817",2019-01-27,"Kebler","w1819","Non.motorized",NA,"Sun","weekend","no_sled","Kebler","3","3","2",8.3,0,38,-1,24,21.8,-1,0,0,-1,-2,-2,-2,-3
"4818",2019-01-27,"Kebler","w1819","Mechanized",NA,"Sun","weekend","no_sled","Kebler","3","3","2",8.3,0,38,-1,24,21.8,-1,0,0,-1,-2,-2,-2,-3
"4819",2019-01-27,"Kebler","w1819","Motorized",NA,"Sun","weekend","sled","Kebler","3","3","2",8.3,0,38,-1,24,21.8,-1,0,0,-1,-2,-2,-2,-3
"4820",2019-01-27,"Kebler","w1819","Hybrid",NA,"Sun","weekend","sled","Kebler","3","3","2",8.3,0,38,-1,24,21.8,-1,0,0,-1,-2,-2,-2,-3
"4821",2019-01-28,"Kebler","w1819","Non.motorized",NA,"Mon","weekday","no_sled","Kebler","2","2","2",8.3,0,38,0,17,21.8,-1,-1,0,0,-1,-2,-2,-2
"4822",2019-01-28,"Kebler","w1819","Mechanized",NA,"Mon","weekday","no_sled","Kebler","2","2","2",8.3,0,38,0,17,21.8,-1,-1,0,0,-1,-2,-2,-2
"4823",2019-01-28,"Kebler","w1819","Motorized",NA,"Mon","weekday","sled","Kebler","2","2","2",8.3,0,38,0,17,21.8,-1,-1,0,0,-1,-2,-2,-2
"4824",2019-01-28,"Kebler","w1819","Hybrid",NA,"Mon","weekday","sled","Kebler","2","2","2",8.3,0,38,0,17,21.8,-1,-1,0,0,-1,-2,-2,-2
"4825",2019-01-29,"Kebler","w1819","Non.motorized",0,"Tue","weekday","no_sled","Kebler","2","2","2",8.3,0,38,0,16,21.8,0,-1,-1,0,0,-1,-2,-2
"4826",2019-01-29,"Kebler","w1819","Mechanized",0,"Tue","weekday","no_sled","Kebler","2","2","2",8.3,0,38,0,16,21.8,0,-1,-1,0,0,-1,-2,-2
"4827",2019-01-29,"Kebler","w1819","Motorized",79,"Tue","weekday","sled","Kebler","2","2","2",8.3,0,38,0,16,21.8,0,-1,-1,0,0,-1,-2,-2
"4828",2019-01-29,"Kebler","w1819","Hybrid",0,"Tue","weekday","sled","Kebler","2","2","2",8.3,0,38,0,16,21.8,0,-1,-1,0,0,-1,-2,-2
"4829",2019-01-30,"Kebler","w1819","Non.motorized",4,"Wed","weekday","no_sled","Kebler","2","2","1",8.3,0,37,-1,20,22.4,0,0,-1,-1,-1,-1,-2,-3
"4830",2019-01-30,"Kebler","w1819","Mechanized",0,"Wed","weekday","no_sled","Kebler","2","2","1",8.3,0,37,-1,20,22.4,0,0,-1,-1,-1,-1,-2,-3
"4831",2019-01-30,"Kebler","w1819","Motorized",74,"Wed","weekday","sled","Kebler","2","2","1",8.3,0,37,-1,20,22.4,0,0,-1,-1,-1,-1,-2,-3
"4832",2019-01-30,"Kebler","w1819","Hybrid",12,"Wed","weekday","sled","Kebler","2","2","1",8.3,0,37,-1,20,22.4,0,0,-1,-1,-1,-1,-2,-3
"4833",2019-01-31,"Kebler","w1819","Non.motorized",3,"Thu","weekday","no_sled","Kebler","2","2","1",8.3,0,36,-1,24,23.1,-1,0,0,-1,-2,-2,-2,-3
"4834",2019-01-31,"Kebler","w1819","Mechanized",0,"Thu","weekday","no_sled","Kebler","2","2","1",8.3,0,36,-1,24,23.1,-1,0,0,-1,-2,-2,-2,-3
"4835",2019-01-31,"Kebler","w1819","Motorized",91,"Thu","weekday","sled","Kebler","2","2","1",8.3,0,36,-1,24,23.1,-1,0,0,-1,-2,-2,-2,-3
"4836",2019-01-31,"Kebler","w1819","Hybrid",20,"Thu","weekday","sled","Kebler","2","2","1",8.3,0,36,-1,24,23.1,-1,0,0,-1,-2,-2,-2,-3
"4837",2019-02-01,"Kebler","w1819","Non.motorized",0,"Fri","weekday","no_sled","Kebler","2","2","1",8.3,0,36,0,25,23.1,-1,-1,0,0,-1,-2,-2,-2
"4838",2019-02-01,"Kebler","w1819","Mechanized",1,"Fri","weekday","no_sled","Kebler","2","2","1",8.3,0,36,0,25,23.1,-1,-1,0,0,-1,-2,-2,-2
"4839",2019-02-01,"Kebler","w1819","Motorized",99,"Fri","weekday","sled","Kebler","2","2","1",8.3,0,36,0,25,23.1,-1,-1,0,0,-1,-2,-2,-2
"4840",2019-02-01,"Kebler","w1819","Hybrid",8,"Fri","weekday","sled","Kebler","2","2","1",8.3,0,36,0,25,23.1,-1,-1,0,0,-1,-2,-2,-2
"4841",2019-02-02,"Kebler","w1819","Non.motorized",1,"Sat","weekend","no_sled","Kebler","2","2","1",8.3,0,36,0,26,23.1,0,-1,-1,0,0,-1,-2,-2
"4842",2019-02-02,"Kebler","w1819","Mechanized",0,"Sat","weekend","no_sled","Kebler","2","2","1",8.3,0,36,0,26,23.1,0,-1,-1,0,0,-1,-2,-2
"4843",2019-02-02,"Kebler","w1819","Motorized",113,"Sat","weekend","sled","Kebler","2","2","1",8.3,0,36,0,26,23.1,0,-1,-1,0,0,-1,-2,-2
"4844",2019-02-02,"Kebler","w1819","Hybrid",10,"Sat","weekend","sled","Kebler","2","2","1",8.3,0,36,0,26,23.1,0,-1,-1,0,0,-1,-2,-2
"4845",2019-02-03,"Kebler","w1819","Non.motorized",2,"Sun","weekend","no_sled","Kebler","3","3","2",8.4,0.1,36,0,28,23.3,0,0,-1,-1,0,0,-1,-2
"4846",2019-02-03,"Kebler","w1819","Mechanized",0,"Sun","weekend","no_sled","Kebler","3","3","2",8.4,0.1,36,0,28,23.3,0,0,-1,-1,0,0,-1,-2
"4847",2019-02-03,"Kebler","w1819","Motorized",64,"Sun","weekend","sled","Kebler","3","3","2",8.4,0.1,36,0,28,23.3,0,0,-1,-1,0,0,-1,-2
"4848",2019-02-03,"Kebler","w1819","Hybrid",2,"Sun","weekend","sled","Kebler","3","3","2",8.4,0.1,36,0,28,23.3,0,0,-1,-1,0,0,-1,-2
"4849",2019-02-04,"Kebler","w1819","Non.motorized",2,"Mon","weekday","no_sled","Kebler","3","3","2",8.8,0.4,39,3,28,22.6,0,0,0,-1,3,3,3,2
"4850",2019-02-04,"Kebler","w1819","Mechanized",0,"Mon","weekday","no_sled","Kebler","3","3","2",8.8,0.4,39,3,28,22.6,0,0,0,-1,3,3,3,2
"4851",2019-02-04,"Kebler","w1819","Motorized",77,"Mon","weekday","sled","Kebler","3","3","2",8.8,0.4,39,3,28,22.6,0,0,0,-1,3,3,3,2
"4852",2019-02-04,"Kebler","w1819","Hybrid",11,"Mon","weekday","sled","Kebler","3","3","2",8.8,0.4,39,3,28,22.6,0,0,0,-1,3,3,3,2
"4853",2019-02-05,"Kebler","w1819","Non.motorized",1,"Tue","weekday","no_sled","Kebler","3","2","2",9,0.2,40,1,26,22.5,3,0,0,0,4,4,4,4
"4854",2019-02-05,"Kebler","w1819","Mechanized",0,"Tue","weekday","no_sled","Kebler","3","2","2",9,0.2,40,1,26,22.5,3,0,0,0,4,4,4,4
"4855",2019-02-05,"Kebler","w1819","Motorized",49,"Tue","weekday","sled","Kebler","3","2","2",9,0.2,40,1,26,22.5,3,0,0,0,4,4,4,4
"4856",2019-02-05,"Kebler","w1819","Hybrid",6,"Tue","weekday","sled","Kebler","3","2","2",9,0.2,40,1,26,22.5,3,0,0,0,4,4,4,4
"4857",2019-02-06,"Kebler","w1819","Non.motorized",0,"Wed","weekday","no_sled","Kebler","4","4","3",9,0,40,0,16,22.5,1,3,0,0,1,4,4,4
"4858",2019-02-06,"Kebler","w1819","Mechanized",0,"Wed","weekday","no_sled","Kebler","4","4","3",9,0,40,0,16,22.5,1,3,0,0,1,4,4,4
"4859",2019-02-06,"Kebler","w1819","Motorized",0,"Wed","weekday","sled","Kebler","4","4","3",9,0,40,0,16,22.5,1,3,0,0,1,4,4,4
"4860",2019-02-06,"Kebler","w1819","Hybrid",0,"Wed","weekday","sled","Kebler","4","4","3",9,0,40,0,16,22.5,1,3,0,0,1,4,4,4
"4861",2019-02-07,"Kebler","w1819","Non.motorized",0,"Thu","weekday","no_sled","Kebler","3","3","2",9.2,0.2,43,3,4,21.4,0,1,3,0,3,4,7,7
"4862",2019-02-07,"Kebler","w1819","Mechanized",0,"Thu","weekday","no_sled","Kebler","3","3","2",9.2,0.2,43,3,4,21.4,0,1,3,0,3,4,7,7
"4863",2019-02-07,"Kebler","w1819","Motorized",25,"Thu","weekday","sled","Kebler","3","3","2",9.2,0.2,43,3,4,21.4,0,1,3,0,3,4,7,7
"4864",2019-02-07,"Kebler","w1819","Hybrid",3,"Thu","weekday","sled","Kebler","3","3","2",9.2,0.2,43,3,4,21.4,0,1,3,0,3,4,7,7
"4865",2019-02-08,"Kebler","w1819","Non.motorized",0,"Fri","weekday","no_sled","Kebler","3","2","2",9.2,0,42,-1,10,21.9,3,0,1,3,2,2,3,6
"4866",2019-02-08,"Kebler","w1819","Mechanized",0,"Fri","weekday","no_sled","Kebler","3","2","2",9.2,0,42,-1,10,21.9,3,0,1,3,2,2,3,6
"4867",2019-02-08,"Kebler","w1819","Motorized",59,"Fri","weekday","sled","Kebler","3","2","2",9.2,0,42,-1,10,21.9,3,0,1,3,2,2,3,6
"4868",2019-02-08,"Kebler","w1819","Hybrid",5,"Fri","weekday","sled","Kebler","3","2","2",9.2,0,42,-1,10,21.9,3,0,1,3,2,2,3,6
"4869",2019-02-09,"Kebler","w1819","Non.motorized",0,"Sat","weekend","no_sled","Kebler","3","2","2",9.2,0,41,-1,20,22.4,-1,3,0,1,-2,1,1,2
"4870",2019-02-09,"Kebler","w1819","Mechanized",0,"Sat","weekend","no_sled","Kebler","3","2","2",9.2,0,41,-1,20,22.4,-1,3,0,1,-2,1,1,2
"4871",2019-02-09,"Kebler","w1819","Motorized",0,"Sat","weekend","sled","Kebler","3","2","2",9.2,0,41,-1,20,22.4,-1,3,0,1,-2,1,1,2
"4872",2019-02-09,"Kebler","w1819","Hybrid",0,"Sat","weekend","sled","Kebler","3","2","2",9.2,0,41,-1,20,22.4,-1,3,0,1,-2,1,1,2
"4873",2019-02-10,"Kebler","w1819","Non.motorized",0,"Sun","weekend","no_sled","Kebler","2","2","2",9.3,0.1,40,-1,20,23.2,-1,-1,3,0,-2,-3,0,0
"4874",2019-02-10,"Kebler","w1819","Mechanized",0,"Sun","weekend","no_sled","Kebler","2","2","2",9.3,0.1,40,-1,20,23.2,-1,-1,3,0,-2,-3,0,0
"4875",2019-02-10,"Kebler","w1819","Motorized",0,"Sun","weekend","sled","Kebler","2","2","2",9.3,0.1,40,-1,20,23.2,-1,-1,3,0,-2,-3,0,0
"4876",2019-02-10,"Kebler","w1819","Hybrid",0,"Sun","weekend","sled","Kebler","2","2","2",9.3,0.1,40,-1,20,23.2,-1,-1,3,0,-2,-3,0,0
"4877",2019-02-11,"Kebler","w1819","Non.motorized",0,"Mon","weekday","no_sled","Kebler","2","2","1",9.3,0,40,0,15,23.2,-1,-1,-1,3,-1,-2,-3,0
"4878",2019-02-11,"Kebler","w1819","Mechanized",0,"Mon","weekday","no_sled","Kebler","2","2","1",9.3,0,40,0,15,23.2,-1,-1,-1,3,-1,-2,-3,0
"4879",2019-02-11,"Kebler","w1819","Motorized",7,"Mon","weekday","sled","Kebler","2","2","1",9.3,0,40,0,15,23.2,-1,-1,-1,3,-1,-2,-3,0
"4880",2019-02-11,"Kebler","w1819","Hybrid",0,"Mon","weekday","sled","Kebler","2","2","1",9.3,0,40,0,15,23.2,-1,-1,-1,3,-1,-2,-3,0
"4881",2019-02-12,"Kebler","w1819","Non.motorized",1,"Tue","weekday","no_sled","Kebler","2","2","1",9.3,0,40,0,18,23.2,0,-1,-1,-1,0,-1,-2,-3
"4882",2019-02-12,"Kebler","w1819","Mechanized",0,"Tue","weekday","no_sled","Kebler","2","2","1",9.3,0,40,0,18,23.2,0,-1,-1,-1,0,-1,-2,-3
"4883",2019-02-12,"Kebler","w1819","Motorized",21,"Tue","weekday","sled","Kebler","2","2","1",9.3,0,40,0,18,23.2,0,-1,-1,-1,0,-1,-2,-3
"4884",2019-02-12,"Kebler","w1819","Hybrid",0,"Tue","weekday","sled","Kebler","2","2","1",9.3,0,40,0,18,23.2,0,-1,-1,-1,0,-1,-2,-3
"4885",2019-02-13,"Kebler","w1819","Non.motorized",0,"Wed","weekday","no_sled","Kebler","2","2","1",9.4,0.1,40,0,26,23.5,0,0,-1,-1,0,0,-1,-2
"4886",2019-02-13,"Kebler","w1819","Mechanized",0,"Wed","weekday","no_sled","Kebler","2","2","1",9.4,0.1,40,0,26,23.5,0,0,-1,-1,0,0,-1,-2
"4887",2019-02-13,"Kebler","w1819","Motorized",45,"Wed","weekday","sled","Kebler","2","2","1",9.4,0.1,40,0,26,23.5,0,0,-1,-1,0,0,-1,-2
"4888",2019-02-13,"Kebler","w1819","Hybrid",0,"Wed","weekday","sled","Kebler","2","2","1",9.4,0.1,40,0,26,23.5,0,0,-1,-1,0,0,-1,-2
"4889",2019-02-14,"Kebler","w1819","Non.motorized",1,"Thu","weekday","no_sled","Kebler","3","2","2",9.7,0.3,41,1,29,23.7,0,0,0,-1,1,1,1,0
"4890",2019-02-14,"Kebler","w1819","Mechanized",0,"Thu","weekday","no_sled","Kebler","3","2","2",9.7,0.3,41,1,29,23.7,0,0,0,-1,1,1,1,0
"4891",2019-02-14,"Kebler","w1819","Motorized",7,"Thu","weekday","sled","Kebler","3","2","2",9.7,0.3,41,1,29,23.7,0,0,0,-1,1,1,1,0
"4892",2019-02-14,"Kebler","w1819","Hybrid",0,"Thu","weekday","sled","Kebler","3","2","2",9.7,0.3,41,1,29,23.7,0,0,0,-1,1,1,1,0
"4893",2019-02-15,"Kebler","w1819","Non.motorized",1,"Fri","weekday","no_sled","Kebler","4","4","3",10.8,1.1,51,10,27,21.2,1,0,0,0,11,11,11,11
"4894",2019-02-15,"Kebler","w1819","Mechanized",0,"Fri","weekday","no_sled","Kebler","4","4","3",10.8,1.1,51,10,27,21.2,1,0,0,0,11,11,11,11
"4895",2019-02-15,"Kebler","w1819","Motorized",38,"Fri","weekday","sled","Kebler","4","4","3",10.8,1.1,51,10,27,21.2,1,0,0,0,11,11,11,11
"4896",2019-02-15,"Kebler","w1819","Hybrid",0,"Fri","weekday","sled","Kebler","4","4","3",10.8,1.1,51,10,27,21.2,1,0,0,0,11,11,11,11
"4897",2019-02-16,"Kebler","w1819","Non.motorized",0,"Sat","weekend","no_sled","Kebler","3","3","3",11.1,0.3,52,1,14,21.3,10,1,0,0,11,12,12,12
"4898",2019-02-16,"Kebler","w1819","Mechanized",0,"Sat","weekend","no_sled","Kebler","3","3","3",11.1,0.3,52,1,14,21.3,10,1,0,0,11,12,12,12
"4899",2019-02-16,"Kebler","w1819","Motorized",0,"Sat","weekend","sled","Kebler","3","3","3",11.1,0.3,52,1,14,21.3,10,1,0,0,11,12,12,12
"4900",2019-02-16,"Kebler","w1819","Hybrid",0,"Sat","weekend","sled","Kebler","3","3","3",11.1,0.3,52,1,14,21.3,10,1,0,0,11,12,12,12
"4901",2019-02-17,"Kebler","w1819","Non.motorized",9,"Sun","weekend","no_sled","Kebler","3","3","3",11.3,0.2,55,3,10,20.5,1,10,1,0,4,14,15,15
"4902",2019-02-17,"Kebler","w1819","Mechanized",0,"Sun","weekend","no_sled","Kebler","3","3","3",11.3,0.2,55,3,10,20.5,1,10,1,0,4,14,15,15
"4903",2019-02-17,"Kebler","w1819","Motorized",117,"Sun","weekend","sled","Kebler","3","3","3",11.3,0.2,55,3,10,20.5,1,10,1,0,4,14,15,15
"4904",2019-02-17,"Kebler","w1819","Hybrid",5,"Sun","weekend","sled","Kebler","3","3","3",11.3,0.2,55,3,10,20.5,1,10,1,0,4,14,15,15
"4905",2019-02-18,"Kebler","w1819","Non.motorized",6,"Mon","weekday","no_sled","Kebler","3","3","2",11.4,0.1,53,-2,13,21.5,3,1,10,1,1,2,12,13
"4906",2019-02-18,"Kebler","w1819","Mechanized",0,"Mon","weekday","no_sled","Kebler","3","3","2",11.4,0.1,53,-2,13,21.5,3,1,10,1,1,2,12,13
"4907",2019-02-18,"Kebler","w1819","Motorized",75,"Mon","weekday","sled","Kebler","3","3","2",11.4,0.1,53,-2,13,21.5,3,1,10,1,1,2,12,13
"4908",2019-02-18,"Kebler","w1819","Hybrid",5,"Mon","weekday","sled","Kebler","3","3","2",11.4,0.1,53,-2,13,21.5,3,1,10,1,1,2,12,13
"4909",2019-02-19,"Kebler","w1819","Non.motorized",0,"Tue","weekday","no_sled","Kebler","3","3","2",11.5,0.1,53,0,11,21.7,-2,3,1,10,-2,1,2,12
"4910",2019-02-19,"Kebler","w1819","Mechanized",0,"Tue","weekday","no_sled","Kebler","3","3","2",11.5,0.1,53,0,11,21.7,-2,3,1,10,-2,1,2,12
"4911",2019-02-19,"Kebler","w1819","Motorized",0,"Tue","weekday","sled","Kebler","3","3","2",11.5,0.1,53,0,11,21.7,-2,3,1,10,-2,1,2,12
"4912",2019-02-19,"Kebler","w1819","Hybrid",0,"Tue","weekday","sled","Kebler","3","3","2",11.5,0.1,53,0,11,21.7,-2,3,1,10,-2,1,2,12
"4913",2019-02-20,"Kebler","w1819","Non.motorized",0,"Wed","weekday","no_sled","Kebler","3","3","2",11.6,0.1,53,0,7,21.9,0,-2,3,1,0,-2,1,2
"4914",2019-02-20,"Kebler","w1819","Mechanized",0,"Wed","weekday","no_sled","Kebler","3","3","2",11.6,0.1,53,0,7,21.9,0,-2,3,1,0,-2,1,2
"4915",2019-02-20,"Kebler","w1819","Motorized",0,"Wed","weekday","sled","Kebler","3","3","2",11.6,0.1,53,0,7,21.9,0,-2,3,1,0,-2,1,2
"4916",2019-02-20,"Kebler","w1819","Hybrid",0,"Wed","weekday","sled","Kebler","3","3","2",11.6,0.1,53,0,7,21.9,0,-2,3,1,0,-2,1,2
"4917",2019-02-21,"Kebler","w1819","Non.motorized",0,"Thu","weekday","no_sled","Kebler","3","3","3",11.6,0,52,-1,15,22.3,0,0,-2,3,-1,-1,-3,0
"4918",2019-02-21,"Kebler","w1819","Mechanized",0,"Thu","weekday","no_sled","Kebler","3","3","3",11.6,0,52,-1,15,22.3,0,0,-2,3,-1,-1,-3,0
"4919",2019-02-21,"Kebler","w1819","Motorized",0,"Thu","weekday","sled","Kebler","3","3","3",11.6,0,52,-1,15,22.3,0,0,-2,3,-1,-1,-3,0
"4920",2019-02-21,"Kebler","w1819","Hybrid",0,"Thu","weekday","sled","Kebler","3","3","3",11.6,0,52,-1,15,22.3,0,0,-2,3,-1,-1,-3,0
"4921",2019-02-22,"Kebler","w1819","Non.motorized",0,"Fri","weekday","no_sled","Kebler","3","3","3",11.8,0.2,52,0,20,22.7,-1,0,0,-2,-1,-1,-1,-3
"4922",2019-02-22,"Kebler","w1819","Mechanized",0,"Fri","weekday","no_sled","Kebler","3","3","3",11.8,0.2,52,0,20,22.7,-1,0,0,-2,-1,-1,-1,-3
"4923",2019-02-22,"Kebler","w1819","Motorized",0,"Fri","weekday","sled","Kebler","3","3","3",11.8,0.2,52,0,20,22.7,-1,0,0,-2,-1,-1,-1,-3
"4924",2019-02-22,"Kebler","w1819","Hybrid",0,"Fri","weekday","sled","Kebler","3","3","3",11.8,0.2,52,0,20,22.7,-1,0,0,-2,-1,-1,-1,-3
"4925",2019-02-23,"Kebler","w1819","Non.motorized",1,"Sat","weekend","no_sled","Kebler","3","3","3",12.1,0.3,53,1,13,22.8,0,-1,0,0,1,0,0,0
"4926",2019-02-23,"Kebler","w1819","Mechanized",0,"Sat","weekend","no_sled","Kebler","3","3","3",12.1,0.3,53,1,13,22.8,0,-1,0,0,1,0,0,0
"4927",2019-02-23,"Kebler","w1819","Motorized",66,"Sat","weekend","sled","Kebler","3","3","3",12.1,0.3,53,1,13,22.8,0,-1,0,0,1,0,0,0
"4928",2019-02-23,"Kebler","w1819","Hybrid",4,"Sat","weekend","sled","Kebler","3","3","3",12.1,0.3,53,1,13,22.8,0,-1,0,0,1,0,0,0
"4929",2019-02-24,"Kebler","w1819","Non.motorized",0,"Sun","weekend","no_sled","Kebler","3","3","2",12.1,0,52,-1,14,23.3,1,0,-1,0,0,0,-1,-1
"4930",2019-02-24,"Kebler","w1819","Mechanized",0,"Sun","weekend","no_sled","Kebler","3","3","2",12.1,0,52,-1,14,23.3,1,0,-1,0,0,0,-1,-1
"4931",2019-02-24,"Kebler","w1819","Motorized",0,"Sun","weekend","sled","Kebler","3","3","2",12.1,0,52,-1,14,23.3,1,0,-1,0,0,0,-1,-1
"4932",2019-02-24,"Kebler","w1819","Hybrid",0,"Sun","weekend","sled","Kebler","3","3","2",12.1,0,52,-1,14,23.3,1,0,-1,0,0,0,-1,-1
"4933",2019-02-25,"Kebler","w1819","Non.motorized",0,"Mon","weekday","no_sled","Kebler","3","3","2",12.1,0,51,-1,22,23.7,-1,1,0,-1,-2,-1,-1,-2
"4934",2019-02-25,"Kebler","w1819","Mechanized",0,"Mon","weekday","no_sled","Kebler","3","3","2",12.1,0,51,-1,22,23.7,-1,1,0,-1,-2,-1,-1,-2
"4935",2019-02-25,"Kebler","w1819","Motorized",22,"Mon","weekday","sled","Kebler","3","3","2",12.1,0,51,-1,22,23.7,-1,1,0,-1,-2,-1,-1,-2
"4936",2019-02-25,"Kebler","w1819","Hybrid",2,"Mon","weekday","sled","Kebler","3","3","2",12.1,0,51,-1,22,23.7,-1,1,0,-1,-2,-1,-1,-2
"4937",2019-02-26,"Kebler","w1819","Non.motorized",1,"Tue","weekday","no_sled","Kebler","2","2","2",12.1,0,50,-1,27,24.2,-1,-1,1,0,-2,-3,-2,-2
"4938",2019-02-26,"Kebler","w1819","Mechanized",0,"Tue","weekday","no_sled","Kebler","2","2","2",12.1,0,50,-1,27,24.2,-1,-1,1,0,-2,-3,-2,-2
"4939",2019-02-26,"Kebler","w1819","Motorized",77,"Tue","weekday","sled","Kebler","2","2","2",12.1,0,50,-1,27,24.2,-1,-1,1,0,-2,-3,-2,-2
"4940",2019-02-26,"Kebler","w1819","Hybrid",10,"Tue","weekday","sled","Kebler","2","2","2",12.1,0,50,-1,27,24.2,-1,-1,1,0,-2,-3,-2,-2
"4941",2019-02-27,"Kebler","w1819","Non.motorized",2,"Wed","weekday","no_sled","Kebler","2","2","2",12.1,0,50,0,30,24.2,-1,-1,-1,1,-1,-2,-3,-2
"4942",2019-02-27,"Kebler","w1819","Mechanized",0,"Wed","weekday","no_sled","Kebler","2","2","2",12.1,0,50,0,30,24.2,-1,-1,-1,1,-1,-2,-3,-2
"4943",2019-02-27,"Kebler","w1819","Motorized",102,"Wed","weekday","sled","Kebler","2","2","2",12.1,0,50,0,30,24.2,-1,-1,-1,1,-1,-2,-3,-2
"4944",2019-02-27,"Kebler","w1819","Hybrid",5,"Wed","weekday","sled","Kebler","2","2","2",12.1,0,50,0,30,24.2,-1,-1,-1,1,-1,-2,-3,-2
"4945",2019-02-28,"Kebler","w1819","Non.motorized",1,"Thu","weekday","no_sled","Kebler","2","2","2",12.2,0.1,49,-1,30,24.9,0,-1,-1,-1,-1,-2,-3,-4
"4946",2019-02-28,"Kebler","w1819","Mechanized",0,"Thu","weekday","no_sled","Kebler","2","2","2",12.2,0.1,49,-1,30,24.9,0,-1,-1,-1,-1,-2,-3,-4
"4947",2019-02-28,"Kebler","w1819","Motorized",60,"Thu","weekday","sled","Kebler","2","2","2",12.2,0.1,49,-1,30,24.9,0,-1,-1,-1,-1,-2,-3,-4
"4948",2019-02-28,"Kebler","w1819","Hybrid",6,"Thu","weekday","sled","Kebler","2","2","2",12.2,0.1,49,-1,30,24.9,0,-1,-1,-1,-1,-2,-3,-4
"4949",2019-03-01,"Kebler","w1819","Non.motorized",0,"Fri","weekday","no_sled","Kebler","2","2","1",12.3,0.1,49,0,29,25.1,-1,0,-1,-1,-1,-1,-2,-3
"4950",2019-03-01,"Kebler","w1819","Mechanized",1,"Fri","weekday","no_sled","Kebler","2","2","1",12.3,0.1,49,0,29,25.1,-1,0,-1,-1,-1,-1,-2,-3
"4951",2019-03-01,"Kebler","w1819","Motorized",34,"Fri","weekday","sled","Kebler","2","2","1",12.3,0.1,49,0,29,25.1,-1,0,-1,-1,-1,-1,-2,-3
"4952",2019-03-01,"Kebler","w1819","Hybrid",1,"Fri","weekday","sled","Kebler","2","2","1",12.3,0.1,49,0,29,25.1,-1,0,-1,-1,-1,-1,-2,-3
"4953",2019-03-02,"Kebler","w1819","Non.motorized",4,"Sat","weekend","no_sled","Kebler","3","3","2",13,0.7,58,9,30,22.4,0,-1,0,-1,9,8,8,7
"4954",2019-03-02,"Kebler","w1819","Mechanized",0,"Sat","weekend","no_sled","Kebler","3","3","2",13,0.7,58,9,30,22.4,0,-1,0,-1,9,8,8,7
"4955",2019-03-02,"Kebler","w1819","Motorized",113,"Sat","weekend","sled","Kebler","3","3","2",13,0.7,58,9,30,22.4,0,-1,0,-1,9,8,8,7
"4956",2019-03-02,"Kebler","w1819","Hybrid",0,"Sat","weekend","sled","Kebler","3","3","2",13,0.7,58,9,30,22.4,0,-1,0,-1,9,8,8,7
"4957",2019-03-03,"Kebler","w1819","Non.motorized",0,"Sun","weekend","no_sled","Kebler","3","3","3",13.7,0.7,64,6,27,21.4,9,0,-1,0,15,15,14,14
"4958",2019-03-03,"Kebler","w1819","Mechanized",0,"Sun","weekend","no_sled","Kebler","3","3","3",13.7,0.7,64,6,27,21.4,9,0,-1,0,15,15,14,14
"4959",2019-03-03,"Kebler","w1819","Motorized",49,"Sun","weekend","sled","Kebler","3","3","3",13.7,0.7,64,6,27,21.4,9,0,-1,0,15,15,14,14
"4960",2019-03-03,"Kebler","w1819","Hybrid",0,"Sun","weekend","sled","Kebler","3","3","3",13.7,0.7,64,6,27,21.4,9,0,-1,0,15,15,14,14
"4961",2019-03-04,"Kebler","w1819","Non.motorized",0,"Mon","weekday","no_sled","Kebler","3","3","3",14.4,0.7,66,2,23,21.8,6,9,0,-1,8,17,17,16
"4962",2019-03-04,"Kebler","w1819","Mechanized",0,"Mon","weekday","no_sled","Kebler","3","3","3",14.4,0.7,66,2,23,21.8,6,9,0,-1,8,17,17,16
"4963",2019-03-04,"Kebler","w1819","Motorized",27,"Mon","weekday","sled","Kebler","3","3","3",14.4,0.7,66,2,23,21.8,6,9,0,-1,8,17,17,16
"4964",2019-03-04,"Kebler","w1819","Hybrid",0,"Mon","weekday","sled","Kebler","3","3","3",14.4,0.7,66,2,23,21.8,6,9,0,-1,8,17,17,16
"4965",2019-03-05,"Kebler","w1819","Non.motorized",3,"Tue","weekday","no_sled","Kebler","3","3","3",14.4,0,64,-2,24,22.5,2,6,9,0,0,6,15,15
"4966",2019-03-05,"Kebler","w1819","Mechanized",1,"Tue","weekday","no_sled","Kebler","3","3","3",14.4,0,64,-2,24,22.5,2,6,9,0,0,6,15,15
"4967",2019-03-05,"Kebler","w1819","Motorized",96,"Tue","weekday","sled","Kebler","3","3","3",14.4,0,64,-2,24,22.5,2,6,9,0,0,6,15,15
"4968",2019-03-05,"Kebler","w1819","Hybrid",5,"Tue","weekday","sled","Kebler","3","3","3",14.4,0,64,-2,24,22.5,2,6,9,0,0,6,15,15
"4969",2019-03-06,"Kebler","w1819","Non.motorized",0,"Wed","weekday","no_sled","Kebler","3","3","2",14.5,0.1,62,-2,31,23.4,-2,2,6,9,-4,-2,4,13
"4970",2019-03-06,"Kebler","w1819","Non.motorized",0,"Wed","weekday","no_sled","Kebler","4","4","3",14.5,0.1,62,-2,31,23.4,-2,2,6,9,-4,-2,4,13
"4971",2019-03-06,"Kebler","w1819","Mechanized",0,"Wed","weekday","no_sled","Kebler","3","3","2",14.5,0.1,62,-2,31,23.4,-2,2,6,9,-4,-2,4,13
"4972",2019-03-06,"Kebler","w1819","Mechanized",0,"Wed","weekday","no_sled","Kebler","4","4","3",14.5,0.1,62,-2,31,23.4,-2,2,6,9,-4,-2,4,13
"4973",2019-03-06,"Kebler","w1819","Motorized",82,"Wed","weekday","sled","Kebler","3","3","2",14.5,0.1,62,-2,31,23.4,-2,2,6,9,-4,-2,4,13
"4974",2019-03-06,"Kebler","w1819","Motorized",82,"Wed","weekday","sled","Kebler","4","4","3",14.5,0.1,62,-2,31,23.4,-2,2,6,9,-4,-2,4,13
"4975",2019-03-06,"Kebler","w1819","Hybrid",5,"Wed","weekday","sled","Kebler","3","3","2",14.5,0.1,62,-2,31,23.4,-2,2,6,9,-4,-2,4,13
"4976",2019-03-06,"Kebler","w1819","Hybrid",5,"Wed","weekday","sled","Kebler","4","4","3",14.5,0.1,62,-2,31,23.4,-2,2,6,9,-4,-2,4,13
"4977",2019-03-07,"Kebler","w1819","Non.motorized",0,"Thu","weekday","no_sled","Kebler","4","4","3",16.2,1.7,71,9,30,22.8,-2,-2,2,6,7,5,7,13
"4978",2019-03-07,"Kebler","w1819","Mechanized",0,"Thu","weekday","no_sled","Kebler","4","4","3",16.2,1.7,71,9,30,22.8,-2,-2,2,6,7,5,7,13
"4979",2019-03-07,"Kebler","w1819","Motorized",0,"Thu","weekday","sled","Kebler","4","4","3",16.2,1.7,71,9,30,22.8,-2,-2,2,6,7,5,7,13
"4980",2019-03-07,"Kebler","w1819","Hybrid",0,"Thu","weekday","sled","Kebler","4","4","3",16.2,1.7,71,9,30,22.8,-2,-2,2,6,7,5,7,13
"4981",2019-03-08,"Kebler","w1819","Non.motorized",0,"Fri","weekday","no_sled","Kebler","3","3","3",16.6,0.4,71,0,27,23.4,9,-2,-2,2,9,7,5,7
"4982",2019-03-08,"Kebler","w1819","Mechanized",0,"Fri","weekday","no_sled","Kebler","3","3","3",16.6,0.4,71,0,27,23.4,9,-2,-2,2,9,7,5,7
"4983",2019-03-08,"Kebler","w1819","Motorized",10,"Fri","weekday","sled","Kebler","3","3","3",16.6,0.4,71,0,27,23.4,9,-2,-2,2,9,7,5,7
"4984",2019-03-08,"Kebler","w1819","Hybrid",0,"Fri","weekday","sled","Kebler","3","3","3",16.6,0.4,71,0,27,23.4,9,-2,-2,2,9,7,5,7
"4985",2019-03-09,"Kebler","w1819","Non.motorized",2,"Sat","weekend","no_sled","Kebler","4","4","3",17.2,0.6,76,5,22,22.6,0,9,-2,-2,5,14,12,10
"4986",2019-03-09,"Kebler","w1819","Mechanized",0,"Sat","weekend","no_sled","Kebler","4","4","3",17.2,0.6,76,5,22,22.6,0,9,-2,-2,5,14,12,10
"4987",2019-03-09,"Kebler","w1819","Motorized",29,"Sat","weekend","sled","Kebler","4","4","3",17.2,0.6,76,5,22,22.6,0,9,-2,-2,5,14,12,10
"4988",2019-03-09,"Kebler","w1819","Hybrid",0,"Sat","weekend","sled","Kebler","4","4","3",17.2,0.6,76,5,22,22.6,0,9,-2,-2,5,14,12,10
"4989",2019-03-10,"Kebler","w1819","Non.motorized",7,"Sun","weekend","no_sled","Kebler","3","3","3",17.3,0.1,73,-3,25,23.7,5,0,9,-2,2,2,11,9
"4990",2019-03-10,"Kebler","w1819","Mechanized",0,"Sun","weekend","no_sled","Kebler","3","3","3",17.3,0.1,73,-3,25,23.7,5,0,9,-2,2,2,11,9
"4991",2019-03-10,"Kebler","w1819","Motorized",64,"Sun","weekend","sled","Kebler","3","3","3",17.3,0.1,73,-3,25,23.7,5,0,9,-2,2,2,11,9
"4992",2019-03-10,"Kebler","w1819","Hybrid",6,"Sun","weekend","sled","Kebler","3","3","3",17.3,0.1,73,-3,25,23.7,5,0,9,-2,2,2,11,9
"4993",2019-03-11,"Kebler","w1819","Non.motorized",0,"Mon","weekday","no_sled","Kebler","3","3","2",17.3,0,71,-2,29,24.4,-3,5,0,9,-5,0,0,9
"4994",2019-03-11,"Kebler","w1819","Mechanized",0,"Mon","weekday","no_sled","Kebler","3","3","2",17.3,0,71,-2,29,24.4,-3,5,0,9,-5,0,0,9
"4995",2019-03-11,"Kebler","w1819","Motorized",89,"Mon","weekday","sled","Kebler","3","3","2",17.3,0,71,-2,29,24.4,-3,5,0,9,-5,0,0,9
"4996",2019-03-11,"Kebler","w1819","Hybrid",1,"Mon","weekday","sled","Kebler","3","3","2",17.3,0,71,-2,29,24.4,-3,5,0,9,-5,0,0,9
"4997",2019-03-12,"Kebler","w1819","Non.motorized",0,"Tue","weekday","no_sled","Kebler","3","3","3",17.4,0.1,70,-1,32,24.9,-2,-3,5,0,-3,-6,-1,-1
"4998",2019-03-12,"Kebler","w1819","Non.motorized",0,"Tue","weekday","no_sled","Kebler","4","4","4",17.4,0.1,70,-1,32,24.9,-2,-3,5,0,-3,-6,-1,-1
"4999",2019-03-12,"Kebler","w1819","Mechanized",0,"Tue","weekday","no_sled","Kebler","3","3","3",17.4,0.1,70,-1,32,24.9,-2,-3,5,0,-3,-6,-1,-1
"5000",2019-03-12,"Kebler","w1819","Mechanized",0,"Tue","weekday","no_sled","Kebler","4","4","4",17.4,0.1,70,-1,32,24.9,-2,-3,5,0,-3,-6,-1,-1
"5001",2019-03-12,"Kebler","w1819","Motorized",70,"Tue","weekday","sled","Kebler","3","3","3",17.4,0.1,70,-1,32,24.9,-2,-3,5,0,-3,-6,-1,-1
"5002",2019-03-12,"Kebler","w1819","Motorized",70,"Tue","weekday","sled","Kebler","4","4","4",17.4,0.1,70,-1,32,24.9,-2,-3,5,0,-3,-6,-1,-1
"5003",2019-03-12,"Kebler","w1819","Hybrid",1,"Tue","weekday","sled","Kebler","3","3","3",17.4,0.1,70,-1,32,24.9,-2,-3,5,0,-3,-6,-1,-1
"5004",2019-03-12,"Kebler","w1819","Hybrid",1,"Tue","weekday","sled","Kebler","4","4","4",17.4,0.1,70,-1,32,24.9,-2,-3,5,0,-3,-6,-1,-1
"5005",2019-03-13,"Kebler","w1819","Non.motorized",0,"Wed","weekday","no_sled","Kebler","4","4","3",18.1,0.7,74,4,24,24.5,-1,-2,-3,5,3,1,-2,3
"5006",2019-03-13,"Kebler","w1819","Mechanized",0,"Wed","weekday","no_sled","Kebler","4","4","3",18.1,0.7,74,4,24,24.5,-1,-2,-3,5,3,1,-2,3
"5007",2019-03-13,"Kebler","w1819","Motorized",0,"Wed","weekday","sled","Kebler","4","4","3",18.1,0.7,74,4,24,24.5,-1,-2,-3,5,3,1,-2,3
"5008",2019-03-13,"Kebler","w1819","Hybrid",0,"Wed","weekday","sled","Kebler","4","4","3",18.1,0.7,74,4,24,24.5,-1,-2,-3,5,3,1,-2,3
"5009",2019-03-14,"Kebler","w1819","Non.motorized",0,"Thu","weekday","no_sled","Kebler","4","4","3",18.1,0,74,0,17,24.5,4,-1,-2,-3,4,3,1,-2
"5010",2019-03-14,"Kebler","w1819","Mechanized",0,"Thu","weekday","no_sled","Kebler","4","4","3",18.1,0,74,0,17,24.5,4,-1,-2,-3,4,3,1,-2
"5011",2019-03-14,"Kebler","w1819","Motorized",2,"Thu","weekday","sled","Kebler","4","4","3",18.1,0,74,0,17,24.5,4,-1,-2,-3,4,3,1,-2
"5012",2019-03-14,"Kebler","w1819","Hybrid",0,"Thu","weekday","sled","Kebler","4","4","3",18.1,0,74,0,17,24.5,4,-1,-2,-3,4,3,1,-2
"5013",2019-03-15,"Kebler","w1819","Non.motorized",0,"Fri","weekday","no_sled","Kebler","3","3","2",18.1,0,72,-2,18,25.1,0,4,-1,-2,-2,2,1,-1
"5014",2019-03-15,"Kebler","w1819","Mechanized",0,"Fri","weekday","no_sled","Kebler","3","3","2",18.1,0,72,-2,18,25.1,0,4,-1,-2,-2,2,1,-1
"5015",2019-03-15,"Kebler","w1819","Motorized",36,"Fri","weekday","sled","Kebler","3","3","2",18.1,0,72,-2,18,25.1,0,4,-1,-2,-2,2,1,-1
"5016",2019-03-15,"Kebler","w1819","Hybrid",1,"Fri","weekday","sled","Kebler","3","3","2",18.1,0,72,-2,18,25.1,0,4,-1,-2,-2,2,1,-1
"5017",2019-03-16,"Kebler","w1819","Non.motorized",1,"Sat","weekend","no_sled","Kebler","3","3","2",18.2,0.1,70,-2,26,26,-2,0,4,-1,-4,-4,0,-1
"5018",2019-03-16,"Kebler","w1819","Mechanized",0,"Sat","weekend","no_sled","Kebler","3","3","2",18.2,0.1,70,-2,26,26,-2,0,4,-1,-4,-4,0,-1
"5019",2019-03-16,"Kebler","w1819","Motorized",103,"Sat","weekend","sled","Kebler","3","3","2",18.2,0.1,70,-2,26,26,-2,0,4,-1,-4,-4,0,-1
"5020",2019-03-16,"Kebler","w1819","Hybrid",0,"Sat","weekend","sled","Kebler","3","3","2",18.2,0.1,70,-2,26,26,-2,0,4,-1,-4,-4,0,-1
"5021",2019-03-17,"Kebler","w1819","Non.motorized",7,"Sun","weekend","no_sled","Kebler","3","3","2",18.2,0,69,-1,28,26.4,-2,-2,0,4,-3,-5,-5,-1
"5022",2019-03-17,"Kebler","w1819","Mechanized",1,"Sun","weekend","no_sled","Kebler","3","3","2",18.2,0,69,-1,28,26.4,-2,-2,0,4,-3,-5,-5,-1
"5023",2019-03-17,"Kebler","w1819","Motorized",103,"Sun","weekend","sled","Kebler","3","3","2",18.2,0,69,-1,28,26.4,-2,-2,0,4,-3,-5,-5,-1
"5024",2019-03-17,"Kebler","w1819","Hybrid",0,"Sun","weekend","sled","Kebler","3","3","2",18.2,0,69,-1,28,26.4,-2,-2,0,4,-3,-5,-5,-1
"5025",2019-03-18,"Kebler","w1819","Non.motorized",0,"Mon","weekday","no_sled","Kebler","2","2","2",18.3,0.1,68,-1,29,26.9,-1,-2,-2,0,-2,-4,-6,-6
"5026",2019-03-18,"Kebler","w1819","Mechanized",0,"Mon","weekday","no_sled","Kebler","2","2","2",18.3,0.1,68,-1,29,26.9,-1,-2,-2,0,-2,-4,-6,-6
"5027",2019-03-18,"Kebler","w1819","Motorized",85,"Mon","weekday","sled","Kebler","2","2","2",18.3,0.1,68,-1,29,26.9,-1,-2,-2,0,-2,-4,-6,-6
"5028",2019-03-18,"Kebler","w1819","Hybrid",2,"Mon","weekday","sled","Kebler","2","2","2",18.3,0.1,68,-1,29,26.9,-1,-2,-2,0,-2,-4,-6,-6
"5029",2019-03-19,"Kebler","w1819","Non.motorized",2,"Tue","weekday","no_sled","Kebler","2","2","2",18.3,0,67,-1,28,27.3,-1,-1,-2,-2,-2,-3,-5,-7
"5030",2019-03-19,"Kebler","w1819","Mechanized",0,"Tue","weekday","no_sled","Kebler","2","2","2",18.3,0,67,-1,28,27.3,-1,-1,-2,-2,-2,-3,-5,-7
"5031",2019-03-19,"Kebler","w1819","Motorized",138,"Tue","weekday","sled","Kebler","2","2","2",18.3,0,67,-1,28,27.3,-1,-1,-2,-2,-2,-3,-5,-7
"5032",2019-03-19,"Kebler","w1819","Hybrid",2,"Tue","weekday","sled","Kebler","2","2","2",18.3,0,67,-1,28,27.3,-1,-1,-2,-2,-2,-3,-5,-7
"5033",2019-03-20,"Kebler","w1819","Non.motorized",2,"Wed","weekday","no_sled","Kebler","2","2","2",18.3,0,66,-1,30,27.7,-1,-1,-1,-2,-2,-3,-4,-6
"5034",2019-03-20,"Kebler","w1819","Mechanized",0,"Wed","weekday","no_sled","Kebler","2","2","2",18.3,0,66,-1,30,27.7,-1,-1,-1,-2,-2,-3,-4,-6
"5035",2019-03-20,"Kebler","w1819","Motorized",194,"Wed","weekday","sled","Kebler","2","2","2",18.3,0,66,-1,30,27.7,-1,-1,-1,-2,-2,-3,-4,-6
"5036",2019-03-20,"Kebler","w1819","Hybrid",2,"Wed","weekday","sled","Kebler","2","2","2",18.3,0,66,-1,30,27.7,-1,-1,-1,-2,-2,-3,-4,-6
"5037",2019-03-21,"Kebler","w1819","Non.motorized",3,"Thu","weekday","no_sled","Kebler","2","2","2",18.4,0.1,65,-1,33,28.3,-1,-1,-1,-1,-2,-3,-4,-5
"5038",2019-03-21,"Kebler","w1819","Mechanized",2,"Thu","weekday","no_sled","Kebler","2","2","2",18.4,0.1,65,-1,33,28.3,-1,-1,-1,-1,-2,-3,-4,-5
"5039",2019-03-21,"Kebler","w1819","Motorized",167,"Thu","weekday","sled","Kebler","2","2","2",18.4,0.1,65,-1,33,28.3,-1,-1,-1,-1,-2,-3,-4,-5
"5040",2019-03-21,"Kebler","w1819","Hybrid",7,"Thu","weekday","sled","Kebler","2","2","2",18.4,0.1,65,-1,33,28.3,-1,-1,-1,-1,-2,-3,-4,-5
"5041",2019-03-22,"Kebler","w1819","Non.motorized",1,"Fri","weekday","no_sled","Kebler","3","3","2",18.4,0,64,-1,28,28.8,-1,-1,-1,-1,-2,-3,-4,-5
"5042",2019-03-22,"Kebler","w1819","Mechanized",1,"Fri","weekday","no_sled","Kebler","3","3","2",18.4,0,64,-1,28,28.8,-1,-1,-1,-1,-2,-3,-4,-5
"5043",2019-03-22,"Kebler","w1819","Motorized",46,"Fri","weekday","sled","Kebler","3","3","2",18.4,0,64,-1,28,28.8,-1,-1,-1,-1,-2,-3,-4,-5
"5044",2019-03-22,"Kebler","w1819","Hybrid",9,"Fri","weekday","sled","Kebler","3","3","2",18.4,0,64,-1,28,28.8,-1,-1,-1,-1,-2,-3,-4,-5
"5045",2019-03-23,"Kebler","w1819","Non.motorized",3,"Sat","weekend","no_sled","Kebler","2","2","1",18.4,0,65,1,28,28.3,-1,-1,-1,-1,0,-1,-2,-3
"5046",2019-03-23,"Kebler","w1819","Mechanized",0,"Sat","weekend","no_sled","Kebler","2","2","1",18.4,0,65,1,28,28.3,-1,-1,-1,-1,0,-1,-2,-3
"5047",2019-03-23,"Kebler","w1819","Motorized",128,"Sat","weekend","sled","Kebler","2","2","1",18.4,0,65,1,28,28.3,-1,-1,-1,-1,0,-1,-2,-3
"5048",2019-03-23,"Kebler","w1819","Hybrid",12,"Sat","weekend","sled","Kebler","2","2","1",18.4,0,65,1,28,28.3,-1,-1,-1,-1,0,-1,-2,-3
"5049",2019-03-24,"Kebler","w1819","Non.motorized",4,"Sun","weekend","no_sled","Kebler","2","2","1",18.4,0,64,-1,29,28.8,1,-1,-1,-1,0,-1,-2,-3
"5050",2019-03-24,"Kebler","w1819","Mechanized",2,"Sun","weekend","no_sled","Kebler","2","2","1",18.4,0,64,-1,29,28.8,1,-1,-1,-1,0,-1,-2,-3
"5051",2019-03-24,"Kebler","w1819","Motorized",63,"Sun","weekend","sled","Kebler","2","2","1",18.4,0,64,-1,29,28.8,1,-1,-1,-1,0,-1,-2,-3
"5052",2019-03-24,"Kebler","w1819","Hybrid",7,"Sun","weekend","sled","Kebler","2","2","1",18.4,0,64,-1,29,28.8,1,-1,-1,-1,0,-1,-2,-3
"5053",2019-03-25,"Kebler","w1819","Non.motorized",2,"Mon","weekday","no_sled","Kebler","2","2","2",18.6,0.2,64,0,31,29.1,-1,1,-1,-1,-1,0,-1,-2
"5054",2019-03-25,"Kebler","w1819","Mechanized",2,"Mon","weekday","no_sled","Kebler","2","2","2",18.6,0.2,64,0,31,29.1,-1,1,-1,-1,-1,0,-1,-2
"5055",2019-03-25,"Kebler","w1819","Motorized",110,"Mon","weekday","sled","Kebler","2","2","2",18.6,0.2,64,0,31,29.1,-1,1,-1,-1,-1,0,-1,-2
"5056",2019-03-25,"Kebler","w1819","Hybrid",17,"Mon","weekday","sled","Kebler","2","2","2",18.6,0.2,64,0,31,29.1,-1,1,-1,-1,-1,0,-1,-2
"5057",2019-03-26,"Kebler","w1819","Non.motorized",4,"Tue","weekday","no_sled","Kebler","2","2","2",18.9,0.3,63,-1,36,30,0,-1,1,-1,-1,-2,-1,-2
"5058",2019-03-26,"Kebler","w1819","Mechanized",0,"Tue","weekday","no_sled","Kebler","2","2","2",18.9,0.3,63,-1,36,30,0,-1,1,-1,-1,-2,-1,-2
"5059",2019-03-26,"Kebler","w1819","Motorized",67,"Tue","weekday","sled","Kebler","2","2","2",18.9,0.3,63,-1,36,30,0,-1,1,-1,-1,-2,-1,-2
"5060",2019-03-26,"Kebler","w1819","Hybrid",0,"Tue","weekday","sled","Kebler","2","2","2",18.9,0.3,63,-1,36,30,0,-1,1,-1,-1,-2,-1,-2
"5061",2019-03-27,"Kebler","w1819","Non.motorized",9,"Wed","weekday","no_sled","Kebler","1","2","2",18.9,0,62,-1,42,30.5,-1,0,-1,1,-2,-2,-3,-2
"5062",2019-03-27,"Kebler","w1819","Mechanized",0,"Wed","weekday","no_sled","Kebler","1","2","2",18.9,0,62,-1,42,30.5,-1,0,-1,1,-2,-2,-3,-2
"5063",2019-03-27,"Kebler","w1819","Motorized",82,"Wed","weekday","sled","Kebler","1","2","2",18.9,0,62,-1,42,30.5,-1,0,-1,1,-2,-2,-3,-2
"5064",2019-03-27,"Kebler","w1819","Hybrid",0,"Wed","weekday","sled","Kebler","1","2","2",18.9,0,62,-1,42,30.5,-1,0,-1,1,-2,-2,-3,-2
"5065",2019-03-28,"Kebler","w1819","Non.motorized",2,"Thu","weekday","no_sled","Kebler","1","2","2",18.9,0,60,-2,40,31.5,-1,-1,0,-1,-3,-4,-4,-5
"5066",2019-03-28,"Kebler","w1819","Mechanized",0,"Thu","weekday","no_sled","Kebler","1","2","2",18.9,0,60,-2,40,31.5,-1,-1,0,-1,-3,-4,-4,-5
"5067",2019-03-28,"Kebler","w1819","Motorized",91,"Thu","weekday","sled","Kebler","1","2","2",18.9,0,60,-2,40,31.5,-1,-1,0,-1,-3,-4,-4,-5
"5068",2019-03-28,"Kebler","w1819","Hybrid",2,"Thu","weekday","sled","Kebler","1","2","2",18.9,0,60,-2,40,31.5,-1,-1,0,-1,-3,-4,-4,-5
"5069",2019-03-29,"Kebler","w1819","Non.motorized",0,"Fri","weekday","no_sled","Kebler","1","1","1",19,0.1,58,-2,26,32.8,-2,-1,-1,0,-4,-5,-6,-6
"5070",2019-03-29,"Kebler","w1819","Mechanized",0,"Fri","weekday","no_sled","Kebler","1","1","1",19,0.1,58,-2,26,32.8,-2,-1,-1,0,-4,-5,-6,-6
"5071",2019-03-29,"Kebler","w1819","Motorized",19,"Fri","weekday","sled","Kebler","1","1","1",19,0.1,58,-2,26,32.8,-2,-1,-1,0,-4,-5,-6,-6
"5072",2019-03-29,"Kebler","w1819","Hybrid",2,"Fri","weekday","sled","Kebler","1","1","1",19,0.1,58,-2,26,32.8,-2,-1,-1,0,-4,-5,-6,-6
"5073",2019-03-30,"Kebler","w1819","Non.motorized",1,"Sat","weekend","no_sled","Kebler","1","1","1",19.1,0.1,61,3,24,31.3,-2,-2,-1,-1,1,-1,-2,-3
"5074",2019-03-30,"Kebler","w1819","Mechanized",0,"Sat","weekend","no_sled","Kebler","1","1","1",19.1,0.1,61,3,24,31.3,-2,-2,-1,-1,1,-1,-2,-3
"5075",2019-03-30,"Kebler","w1819","Motorized",81,"Sat","weekend","sled","Kebler","1","1","1",19.1,0.1,61,3,24,31.3,-2,-2,-1,-1,1,-1,-2,-3
"5076",2019-03-30,"Kebler","w1819","Hybrid",2,"Sat","weekend","sled","Kebler","1","1","1",19.1,0.1,61,3,24,31.3,-2,-2,-1,-1,1,-1,-2,-3
"5077",2019-03-31,"Kebler","w1819","Non.motorized",4,"Sun","weekend","no_sled","Kebler","1","1","1",19.1,0,59,-2,24,32.4,3,-2,-2,-1,1,-1,-3,-4
"5078",2019-03-31,"Kebler","w1819","Mechanized",2,"Sun","weekend","no_sled","Kebler","1","1","1",19.1,0,59,-2,24,32.4,3,-2,-2,-1,1,-1,-3,-4
"5079",2019-03-31,"Kebler","w1819","Motorized",94,"Sun","weekend","sled","Kebler","1","1","1",19.1,0,59,-2,24,32.4,3,-2,-2,-1,1,-1,-3,-4
"5080",2019-03-31,"Kebler","w1819","Hybrid",16,"Sun","weekend","sled","Kebler","1","1","1",19.1,0,59,-2,24,32.4,3,-2,-2,-1,1,-1,-3,-4
"5081",2019-04-01,"Kebler","w1819","Non.motorized",0,"Mon","weekday","no_sled","Kebler","2","1","1",19.1,0,58,-1,29,32.9,-2,3,-2,-2,-3,0,-2,-4
"5082",2019-04-01,"Kebler","w1819","Mechanized",0,"Mon","weekday","no_sled","Kebler","2","1","1",19.1,0,58,-1,29,32.9,-2,3,-2,-2,-3,0,-2,-4
"5083",2019-04-01,"Kebler","w1819","Motorized",59,"Mon","weekday","sled","Kebler","2","1","1",19.1,0,58,-1,29,32.9,-2,3,-2,-2,-3,0,-2,-4
"5084",2019-04-01,"Kebler","w1819","Hybrid",17,"Mon","weekday","sled","Kebler","2","1","1",19.1,0,58,-1,29,32.9,-2,3,-2,-2,-3,0,-2,-4
"5085",2019-04-02,"Kebler","w1819","Non.motorized",0,"Tue","weekday","no_sled","Kebler","1","1","1",19.1,0,58,0,33,32.9,-1,-2,3,-2,-1,-3,0,-2
"5086",2019-04-02,"Kebler","w1819","Mechanized",0,"Tue","weekday","no_sled","Kebler","1","1","1",19.1,0,58,0,33,32.9,-1,-2,3,-2,-1,-3,0,-2
"5087",2019-04-02,"Kebler","w1819","Motorized",42,"Tue","weekday","sled","Kebler","1","1","1",19.1,0,58,0,33,32.9,-1,-2,3,-2,-1,-3,0,-2
"5088",2019-04-02,"Kebler","w1819","Hybrid",13,"Tue","weekday","sled","Kebler","1","1","1",19.1,0,58,0,33,32.9,-1,-2,3,-2,-1,-3,0,-2
"5089",2019-04-03,"Kebler","w1819","Non.motorized",3,"Wed","weekday","no_sled","Kebler","2","1","1",19.2,0.1,58,0,31,33.1,0,-1,-2,3,0,-1,-3,0
"5090",2019-04-03,"Kebler","w1819","Mechanized",0,"Wed","weekday","no_sled","Kebler","2","1","1",19.2,0.1,58,0,31,33.1,0,-1,-2,3,0,-1,-3,0
"5091",2019-04-03,"Kebler","w1819","Motorized",46,"Wed","weekday","sled","Kebler","2","1","1",19.2,0.1,58,0,31,33.1,0,-1,-2,3,0,-1,-3,0
"5092",2019-04-03,"Kebler","w1819","Hybrid",21,"Wed","weekday","sled","Kebler","2","1","1",19.2,0.1,58,0,31,33.1,0,-1,-2,3,0,-1,-3,0
"5093",2019-04-04,"Kebler","w1819","Non.motorized",1,"Thu","weekday","no_sled","Kebler","2","1","1",19.4,0.2,59,1,35,32.9,0,0,-1,-2,1,1,0,-2
"5094",2019-04-04,"Kebler","w1819","Mechanized",0,"Thu","weekday","no_sled","Kebler","2","1","1",19.4,0.2,59,1,35,32.9,0,0,-1,-2,1,1,0,-2
"5095",2019-04-04,"Kebler","w1819","Motorized",45,"Thu","weekday","sled","Kebler","2","1","1",19.4,0.2,59,1,35,32.9,0,0,-1,-2,1,1,0,-2
"5096",2019-04-04,"Kebler","w1819","Hybrid",6,"Thu","weekday","sled","Kebler","2","1","1",19.4,0.2,59,1,35,32.9,0,0,-1,-2,1,1,0,-2
"5097",2019-04-05,"Kebler","w1819","Non.motorized",0,"Fri","weekday","no_sled","Kebler","1","1","1",19.4,0,57,-2,38,34,1,0,0,-1,-1,-1,-1,-2
"5098",2019-04-05,"Kebler","w1819","Mechanized",0,"Fri","weekday","no_sled","Kebler","1","1","1",19.4,0,57,-2,38,34,1,0,0,-1,-1,-1,-1,-2
"5099",2019-04-05,"Kebler","w1819","Motorized",47,"Fri","weekday","sled","Kebler","1","1","1",19.4,0,57,-2,38,34,1,0,0,-1,-1,-1,-1,-2
"5100",2019-04-05,"Kebler","w1819","Hybrid",7,"Fri","weekday","sled","Kebler","1","1","1",19.4,0,57,-2,38,34,1,0,0,-1,-1,-1,-1,-2
"5101",2019-04-06,"Kebler","w1819","Non.motorized",1,"Sat","weekend","no_sled","Kebler","1","1","1",19.3,-0.1,57,0,35,33.9,-2,1,0,0,-2,-1,-1,-1
"5102",2019-04-06,"Kebler","w1819","Mechanized",0,"Sat","weekend","no_sled","Kebler","1","1","1",19.3,-0.1,57,0,35,33.9,-2,1,0,0,-2,-1,-1,-1
"5103",2019-04-06,"Kebler","w1819","Motorized",55,"Sat","weekend","sled","Kebler","1","1","1",19.3,-0.1,57,0,35,33.9,-2,1,0,0,-2,-1,-1,-1
"5104",2019-04-06,"Kebler","w1819","Hybrid",16,"Sat","weekend","sled","Kebler","1","1","1",19.3,-0.1,57,0,35,33.9,-2,1,0,0,-2,-1,-1,-1
"5105",2019-04-07,"Kebler","w1819","Non.motorized",0,"Sun","weekend","no_sled","Kebler","1","1","1",19.1,-0.2,57,0,37,33.5,0,-2,1,0,0,-2,-1,-1
"5106",2019-04-07,"Kebler","w1819","Mechanized",0,"Sun","weekend","no_sled","Kebler","1","1","1",19.1,-0.2,57,0,37,33.5,0,-2,1,0,0,-2,-1,-1
"5107",2019-04-07,"Kebler","w1819","Motorized",31,"Sun","weekend","sled","Kebler","1","1","1",19.1,-0.2,57,0,37,33.5,0,-2,1,0,0,-2,-1,-1
"5108",2019-04-07,"Kebler","w1819","Hybrid",0,"Sun","weekend","sled","Kebler","1","1","1",19.1,-0.2,57,0,37,33.5,0,-2,1,0,0,-2,-1,-1
"5109",2019-04-08,"Kebler","w1819","Non.motorized",3,"Mon","weekday","no_sled","Kebler","1","2","2",19.3,0.2,54,-3,41,35.7,0,0,-2,1,-3,-3,-5,-4
"5110",2019-04-08,"Kebler","w1819","Mechanized",3,"Mon","weekday","no_sled","Kebler","1","2","2",19.3,0.2,54,-3,41,35.7,0,0,-2,1,-3,-3,-5,-4
"5111",2019-04-08,"Kebler","w1819","Motorized",32,"Mon","weekday","sled","Kebler","1","2","2",19.3,0.2,54,-3,41,35.7,0,0,-2,1,-3,-3,-5,-4
"5112",2019-04-08,"Kebler","w1819","Hybrid",7,"Mon","weekday","sled","Kebler","1","2","2",19.3,0.2,54,-3,41,35.7,0,0,-2,1,-3,-3,-5,-4
"5113",2019-04-09,"Kebler","w1819","Non.motorized",0,"Tue","weekday","no_sled","Kebler","1","2","2",19.3,0,53,-1,43,36.4,-3,0,0,-2,-4,-4,-4,-6
"5114",2019-04-09,"Kebler","w1819","Mechanized",1,"Tue","weekday","no_sled","Kebler","1","2","2",19.3,0,53,-1,43,36.4,-3,0,0,-2,-4,-4,-4,-6
"5115",2019-04-09,"Kebler","w1819","Motorized",32,"Tue","weekday","sled","Kebler","1","2","2",19.3,0,53,-1,43,36.4,-3,0,0,-2,-4,-4,-4,-6
"5116",2019-04-09,"Kebler","w1819","Hybrid",2,"Tue","weekday","sled","Kebler","1","2","2",19.3,0,53,-1,43,36.4,-3,0,0,-2,-4,-4,-4,-6
"5117",2019-04-10,"Kebler","w1819","Non.motorized",0,"Wed","weekday","no_sled","Kebler","2","2","1",19,-0.3,51,-2,30,37.3,-1,-3,0,0,-3,-6,-6,-6
"5118",2019-04-10,"Kebler","w1819","Mechanized",0,"Wed","weekday","no_sled","Kebler","2","2","1",19,-0.3,51,-2,30,37.3,-1,-3,0,0,-3,-6,-6,-6
"5119",2019-04-10,"Kebler","w1819","Motorized",7,"Wed","weekday","sled","Kebler","2","2","1",19,-0.3,51,-2,30,37.3,-1,-3,0,0,-3,-6,-6,-6
"5120",2019-04-10,"Kebler","w1819","Hybrid",0,"Wed","weekday","sled","Kebler","2","2","1",19,-0.3,51,-2,30,37.3,-1,-3,0,0,-3,-6,-6,-6
"5121",2019-04-11,"Kebler","w1819","Non.motorized",0,"Thu","weekday","no_sled","Kebler","3","3","2",18.9,-0.1,53,2,20,35.7,-2,-1,-3,0,0,-1,-4,-4
"5122",2019-04-11,"Kebler","w1819","Mechanized",0,"Thu","weekday","no_sled","Kebler","3","3","2",18.9,-0.1,53,2,20,35.7,-2,-1,-3,0,0,-1,-4,-4
"5123",2019-04-11,"Kebler","w1819","Motorized",0,"Thu","weekday","sled","Kebler","3","3","2",18.9,-0.1,53,2,20,35.7,-2,-1,-3,0,0,-1,-4,-4
"5124",2019-04-11,"Kebler","w1819","Hybrid",0,"Thu","weekday","sled","Kebler","3","3","2",18.9,-0.1,53,2,20,35.7,-2,-1,-3,0,0,-1,-4,-4
"5125",2019-04-12,"Kebler","w1819","Non.motorized",0,"Fri","weekday","no_sled","Kebler","2","2","1",18.7,-0.2,53,0,24,35.3,2,-2,-1,-3,2,0,-1,-4
"5126",2019-04-12,"Kebler","w1819","Mechanized",0,"Fri","weekday","no_sled","Kebler","2","2","1",18.7,-0.2,53,0,24,35.3,2,-2,-1,-3,2,0,-1,-4
"5127",2019-04-12,"Kebler","w1819","Motorized",31,"Fri","weekday","sled","Kebler","2","2","1",18.7,-0.2,53,0,24,35.3,2,-2,-1,-3,2,0,-1,-4
"5128",2019-04-12,"Kebler","w1819","Hybrid",4,"Fri","weekday","sled","Kebler","2","2","1",18.7,-0.2,53,0,24,35.3,2,-2,-1,-3,2,0,-1,-4
"5129",2019-04-13,"Kebler","w1819","Non.motorized",4,"Sat","weekend","no_sled","Kebler","1","1","1",18.8,0.1,52,-1,27,36.2,0,2,-2,-1,-1,1,-1,-2
"5130",2019-04-13,"Kebler","w1819","Mechanized",0,"Sat","weekend","no_sled","Kebler","1","1","1",18.8,0.1,52,-1,27,36.2,0,2,-2,-1,-1,1,-1,-2
"5131",2019-04-13,"Kebler","w1819","Motorized",61,"Sat","weekend","sled","Kebler","1","1","1",18.8,0.1,52,-1,27,36.2,0,2,-2,-1,-1,1,-1,-2
"5132",2019-04-13,"Kebler","w1819","Hybrid",29,"Sat","weekend","sled","Kebler","1","1","1",18.8,0.1,52,-1,27,36.2,0,2,-2,-1,-1,1,-1,-2
"5133",2019-04-14,"Kebler","w1819","Non.motorized",1,"Sun","weekend","no_sled","Kebler","1","1","1",18.7,-0.1,51,-1,35,36.7,-1,0,2,-2,-2,-2,0,-2
"5134",2019-04-14,"Kebler","w1819","Mechanized",0,"Sun","weekend","no_sled","Kebler","1","1","1",18.7,-0.1,51,-1,35,36.7,-1,0,2,-2,-2,-2,0,-2
"5135",2019-04-14,"Kebler","w1819","Motorized",45,"Sun","weekend","sled","Kebler","1","1","1",18.7,-0.1,51,-1,35,36.7,-1,0,2,-2,-2,-2,0,-2
"5136",2019-04-14,"Kebler","w1819","Hybrid",14,"Sun","weekend","sled","Kebler","1","1","1",18.7,-0.1,51,-1,35,36.7,-1,0,2,-2,-2,-2,0,-2
"5137",2019-04-15,"Kebler","w1819","Non.motorized",2,"Mon","weekday","no_sled","Kebler",NA,NA,NA,18.6,-0.1,50,-1,41,37.2,-1,-1,0,2,-2,-3,-3,-1
"5138",2019-04-15,"Kebler","w1819","Mechanized",0,"Mon","weekday","no_sled","Kebler",NA,NA,NA,18.6,-0.1,50,-1,41,37.2,-1,-1,0,2,-2,-3,-3,-1
"5139",2019-04-15,"Kebler","w1819","Motorized",16,"Mon","weekday","sled","Kebler",NA,NA,NA,18.6,-0.1,50,-1,41,37.2,-1,-1,0,2,-2,-3,-3,-1
"5140",2019-04-15,"Kebler","w1819","Hybrid",5,"Mon","weekday","sled","Kebler",NA,NA,NA,18.6,-0.1,50,-1,41,37.2,-1,-1,0,2,-2,-3,-3,-1
"5141",2018-12-01,"Slate River Rd","w1819","Non.motorized",NA,"Sat","weekend","no_sled","Slate River Rd","3","3","2",3.3,0.2,19,1,16,17.4,0,0,0,0,1,1,1,1
"5142",2018-12-01,"Slate River Rd","w1819","Mechanized",NA,"Sat","weekend","no_sled","Slate River Rd","3","3","2",3.3,0.2,19,1,16,17.4,0,0,0,0,1,1,1,1
"5143",2018-12-01,"Slate River Rd","w1819","Motorized",NA,"Sat","weekend","sled","Slate River Rd","3","3","2",3.3,0.2,19,1,16,17.4,0,0,0,0,1,1,1,1
"5144",2018-12-01,"Slate River Rd","w1819","Hybrid",NA,"Sat","weekend","sled","Slate River Rd","3","3","2",3.3,0.2,19,1,16,17.4,0,0,0,0,1,1,1,1
"5145",2018-12-02,"Slate River Rd","w1819","Non.motorized",NA,"Sun","weekend","no_sled","Slate River Rd","3","3","3",3.3,0,20,1,14,16.5,1,0,0,0,2,2,2,2
"5146",2018-12-02,"Slate River Rd","w1819","Mechanized",NA,"Sun","weekend","no_sled","Slate River Rd","3","3","3",3.3,0,20,1,14,16.5,1,0,0,0,2,2,2,2
"5147",2018-12-02,"Slate River Rd","w1819","Motorized",NA,"Sun","weekend","sled","Slate River Rd","3","3","3",3.3,0,20,1,14,16.5,1,0,0,0,2,2,2,2
"5148",2018-12-02,"Slate River Rd","w1819","Hybrid",NA,"Sun","weekend","sled","Slate River Rd","3","3","3",3.3,0,20,1,14,16.5,1,0,0,0,2,2,2,2
"5149",2018-12-03,"Slate River Rd","w1819","Non.motorized",NA,"Mon","weekday","no_sled","Slate River Rd","3","3","2",3.4,0.1,19,-1,13,17.9,1,1,0,0,0,1,1,1
"5150",2018-12-03,"Slate River Rd","w1819","Mechanized",NA,"Mon","weekday","no_sled","Slate River Rd","3","3","2",3.4,0.1,19,-1,13,17.9,1,1,0,0,0,1,1,1
"5151",2018-12-03,"Slate River Rd","w1819","Motorized",NA,"Mon","weekday","sled","Slate River Rd","3","3","2",3.4,0.1,19,-1,13,17.9,1,1,0,0,0,1,1,1
"5152",2018-12-03,"Slate River Rd","w1819","Hybrid",NA,"Mon","weekday","sled","Slate River Rd","3","3","2",3.4,0.1,19,-1,13,17.9,1,1,0,0,0,1,1,1
"5153",2018-12-04,"Slate River Rd","w1819","Non.motorized",NA,"Tue","weekday","no_sled","Slate River Rd","3","3","2",3.5,0.1,20,1,8,17.5,-1,1,1,0,0,1,2,2
"5154",2018-12-04,"Slate River Rd","w1819","Mechanized",NA,"Tue","weekday","no_sled","Slate River Rd","3","3","2",3.5,0.1,20,1,8,17.5,-1,1,1,0,0,1,2,2
"5155",2018-12-04,"Slate River Rd","w1819","Motorized",NA,"Tue","weekday","sled","Slate River Rd","3","3","2",3.5,0.1,20,1,8,17.5,-1,1,1,0,0,1,2,2
"5156",2018-12-04,"Slate River Rd","w1819","Hybrid",NA,"Tue","weekday","sled","Slate River Rd","3","3","2",3.5,0.1,20,1,8,17.5,-1,1,1,0,0,1,2,2
"5157",2018-12-05,"Slate River Rd","w1819","Non.motorized",14,"Wed","weekday","no_sled","Slate River Rd","3","3","2",3.5,0,19,-1,21,18.4,1,-1,1,1,0,-1,0,1
"5158",2018-12-05,"Slate River Rd","w1819","Mechanized",0,"Wed","weekday","no_sled","Slate River Rd","3","3","2",3.5,0,19,-1,21,18.4,1,-1,1,1,0,-1,0,1
"5159",2018-12-05,"Slate River Rd","w1819","Motorized",10,"Wed","weekday","sled","Slate River Rd","3","3","2",3.5,0,19,-1,21,18.4,1,-1,1,1,0,-1,0,1
"5160",2018-12-05,"Slate River Rd","w1819","Hybrid",10,"Wed","weekday","sled","Slate River Rd","3","3","2",3.5,0,19,-1,21,18.4,1,-1,1,1,0,-1,0,1
"5161",2018-12-06,"Slate River Rd","w1819","Non.motorized",5,"Thu","weekday","no_sled","Slate River Rd","2","2","2",3.7,0.2,18,-1,25,20.6,-1,1,-1,1,-2,-1,-2,-1
"5162",2018-12-06,"Slate River Rd","w1819","Mechanized",0,"Thu","weekday","no_sled","Slate River Rd","2","2","2",3.7,0.2,18,-1,25,20.6,-1,1,-1,1,-2,-1,-2,-1
"5163",2018-12-06,"Slate River Rd","w1819","Motorized",6,"Thu","weekday","sled","Slate River Rd","2","2","2",3.7,0.2,18,-1,25,20.6,-1,1,-1,1,-2,-1,-2,-1
"5164",2018-12-06,"Slate River Rd","w1819","Hybrid",6,"Thu","weekday","sled","Slate River Rd","2","2","2",3.7,0.2,18,-1,25,20.6,-1,1,-1,1,-2,-1,-2,-1
"5165",2018-12-07,"Slate River Rd","w1819","Non.motorized",11,"Fri","weekday","no_sled","Slate River Rd","2","2","2",3.8,0.1,21,3,23,18.1,-1,-1,1,-1,2,1,2,1
"5166",2018-12-07,"Slate River Rd","w1819","Mechanized",0,"Fri","weekday","no_sled","Slate River Rd","2","2","2",3.8,0.1,21,3,23,18.1,-1,-1,1,-1,2,1,2,1
"5167",2018-12-07,"Slate River Rd","w1819","Motorized",13,"Fri","weekday","sled","Slate River Rd","2","2","2",3.8,0.1,21,3,23,18.1,-1,-1,1,-1,2,1,2,1
"5168",2018-12-07,"Slate River Rd","w1819","Hybrid",13,"Fri","weekday","sled","Slate River Rd","2","2","2",3.8,0.1,21,3,23,18.1,-1,-1,1,-1,2,1,2,1
"5169",2018-12-08,"Slate River Rd","w1819","Non.motorized",24,"Sat","weekend","no_sled","Slate River Rd","2","2","2",3.8,0,20,-1,23,19,3,-1,-1,1,2,1,0,1
"5170",2018-12-08,"Slate River Rd","w1819","Mechanized",0,"Sat","weekend","no_sled","Slate River Rd","2","2","2",3.8,0,20,-1,23,19,3,-1,-1,1,2,1,0,1
"5171",2018-12-08,"Slate River Rd","w1819","Motorized",23,"Sat","weekend","sled","Slate River Rd","2","2","2",3.8,0,20,-1,23,19,3,-1,-1,1,2,1,0,1
"5172",2018-12-08,"Slate River Rd","w1819","Hybrid",22,"Sat","weekend","sled","Slate River Rd","2","2","2",3.8,0,20,-1,23,19,3,-1,-1,1,2,1,0,1
"5173",2018-12-09,"Slate River Rd","w1819","Non.motorized",39,"Sun","weekend","no_sled","Slate River Rd","2","2","2",3.8,0,20,0,19,19,-1,3,-1,-1,-1,2,1,0
"5174",2018-12-09,"Slate River Rd","w1819","Mechanized",0,"Sun","weekend","no_sled","Slate River Rd","2","2","2",3.8,0,20,0,19,19,-1,3,-1,-1,-1,2,1,0
"5175",2018-12-09,"Slate River Rd","w1819","Motorized",10,"Sun","weekend","sled","Slate River Rd","2","2","2",3.8,0,20,0,19,19,-1,3,-1,-1,-1,2,1,0
"5176",2018-12-09,"Slate River Rd","w1819","Hybrid",10,"Sun","weekend","sled","Slate River Rd","2","2","2",3.8,0,20,0,19,19,-1,3,-1,-1,-1,2,1,0
"5177",2018-12-10,"Slate River Rd","w1819","Non.motorized",10,"Mon","weekday","no_sled","Slate River Rd","2","2","2",3.8,0,20,0,21,19,0,-1,3,-1,0,-1,2,1
"5178",2018-12-10,"Slate River Rd","w1819","Mechanized",0,"Mon","weekday","no_sled","Slate River Rd","2","2","2",3.8,0,20,0,21,19,0,-1,3,-1,0,-1,2,1
"5179",2018-12-10,"Slate River Rd","w1819","Motorized",10,"Mon","weekday","sled","Slate River Rd","2","2","2",3.8,0,20,0,21,19,0,-1,3,-1,0,-1,2,1
"5180",2018-12-10,"Slate River Rd","w1819","Hybrid",10,"Mon","weekday","sled","Slate River Rd","2","2","2",3.8,0,20,0,21,19,0,-1,3,-1,0,-1,2,1
"5181",2018-12-11,"Slate River Rd","w1819","Non.motorized",8,"Tue","weekday","no_sled","Slate River Rd","2","2","2",3.9,0.1,19,-1,27,20.5,0,0,-1,3,-1,-1,-2,1
"5182",2018-12-11,"Slate River Rd","w1819","Mechanized",0,"Tue","weekday","no_sled","Slate River Rd","2","2","2",3.9,0.1,19,-1,27,20.5,0,0,-1,3,-1,-1,-2,1
"5183",2018-12-11,"Slate River Rd","w1819","Motorized",7,"Tue","weekday","sled","Slate River Rd","2","2","2",3.9,0.1,19,-1,27,20.5,0,0,-1,3,-1,-1,-2,1
"5184",2018-12-11,"Slate River Rd","w1819","Hybrid",7,"Tue","weekday","sled","Slate River Rd","2","2","2",3.9,0.1,19,-1,27,20.5,0,0,-1,3,-1,-1,-2,1
"5185",2018-12-12,"Slate River Rd","w1819","Non.motorized",6,"Wed","weekday","no_sled","Slate River Rd","2","2","1",3.9,0,19,0,21,20.5,-1,0,0,-1,-1,-1,-1,-2
"5186",2018-12-12,"Slate River Rd","w1819","Mechanized",0,"Wed","weekday","no_sled","Slate River Rd","2","2","1",3.9,0,19,0,21,20.5,-1,0,0,-1,-1,-1,-1,-2
"5187",2018-12-12,"Slate River Rd","w1819","Motorized",4,"Wed","weekday","sled","Slate River Rd","2","2","1",3.9,0,19,0,21,20.5,-1,0,0,-1,-1,-1,-1,-2
"5188",2018-12-12,"Slate River Rd","w1819","Hybrid",4,"Wed","weekday","sled","Slate River Rd","2","2","1",3.9,0,19,0,21,20.5,-1,0,0,-1,-1,-1,-1,-2
"5189",2018-12-13,"Slate River Rd","w1819","Non.motorized",0,"Thu","weekday","no_sled","Slate River Rd","3","3","2",4,0.1,21,2,15,19,0,-1,0,0,2,1,1,1
"5190",2018-12-13,"Slate River Rd","w1819","Mechanized",0,"Thu","weekday","no_sled","Slate River Rd","3","3","2",4,0.1,21,2,15,19,0,-1,0,0,2,1,1,1
"5191",2018-12-13,"Slate River Rd","w1819","Motorized",0,"Thu","weekday","sled","Slate River Rd","3","3","2",4,0.1,21,2,15,19,0,-1,0,0,2,1,1,1
"5192",2018-12-13,"Slate River Rd","w1819","Hybrid",0,"Thu","weekday","sled","Slate River Rd","3","3","2",4,0.1,21,2,15,19,0,-1,0,0,2,1,1,1
"5193",2018-12-14,"Slate River Rd","w1819","Non.motorized",12,"Fri","weekday","no_sled","Slate River Rd","3","3","2",4,0,20,-1,24,20,2,0,-1,0,1,1,0,0
"5194",2018-12-14,"Slate River Rd","w1819","Mechanized",0,"Fri","weekday","no_sled","Slate River Rd","3","3","2",4,0,20,-1,24,20,2,0,-1,0,1,1,0,0
"5195",2018-12-14,"Slate River Rd","w1819","Motorized",6,"Fri","weekday","sled","Slate River Rd","3","3","2",4,0,20,-1,24,20,2,0,-1,0,1,1,0,0
"5196",2018-12-14,"Slate River Rd","w1819","Hybrid",6,"Fri","weekday","sled","Slate River Rd","3","3","2",4,0,20,-1,24,20,2,0,-1,0,1,1,0,0
"5197",2018-12-15,"Slate River Rd","w1819","Non.motorized",42,"Sat","weekend","no_sled","Slate River Rd","2","2","2",4,0,20,0,29,20,-1,2,0,-1,-1,1,1,0
"5198",2018-12-15,"Slate River Rd","w1819","Mechanized",0,"Sat","weekend","no_sled","Slate River Rd","2","2","2",4,0,20,0,29,20,-1,2,0,-1,-1,1,1,0
"5199",2018-12-15,"Slate River Rd","w1819","Motorized",14,"Sat","weekend","sled","Slate River Rd","2","2","2",4,0,20,0,29,20,-1,2,0,-1,-1,1,1,0
"5200",2018-12-15,"Slate River Rd","w1819","Hybrid",8,"Sat","weekend","sled","Slate River Rd","2","2","2",4,0,20,0,29,20,-1,2,0,-1,-1,1,1,0
"5201",2018-12-16,"Slate River Rd","w1819","Non.motorized",29,"Sun","weekend","no_sled","Slate River Rd","2","2","2",4.1,0.1,19,-1,28,21.6,0,-1,2,0,-1,-2,0,0
"5202",2018-12-16,"Slate River Rd","w1819","Mechanized",0,"Sun","weekend","no_sled","Slate River Rd","2","2","2",4.1,0.1,19,-1,28,21.6,0,-1,2,0,-1,-2,0,0
"5203",2018-12-16,"Slate River Rd","w1819","Motorized",21,"Sun","weekend","sled","Slate River Rd","2","2","2",4.1,0.1,19,-1,28,21.6,0,-1,2,0,-1,-2,0,0
"5204",2018-12-16,"Slate River Rd","w1819","Hybrid",21,"Sun","weekend","sled","Slate River Rd","2","2","2",4.1,0.1,19,-1,28,21.6,0,-1,2,0,-1,-2,0,0
"5205",2018-12-17,"Slate River Rd","w1819","Non.motorized",14,"Mon","weekday","no_sled","Slate River Rd","2","2","2",4.1,0,19,0,29,21.6,-1,0,-1,2,-1,-1,-2,0
"5206",2018-12-17,"Slate River Rd","w1819","Mechanized",0,"Mon","weekday","no_sled","Slate River Rd","2","2","2",4.1,0,19,0,29,21.6,-1,0,-1,2,-1,-1,-2,0
"5207",2018-12-17,"Slate River Rd","w1819","Motorized",2,"Mon","weekday","sled","Slate River Rd","2","2","2",4.1,0,19,0,29,21.6,-1,0,-1,2,-1,-1,-2,0
"5208",2018-12-17,"Slate River Rd","w1819","Hybrid",2,"Mon","weekday","sled","Slate River Rd","2","2","2",4.1,0,19,0,29,21.6,-1,0,-1,2,-1,-1,-2,0
"5209",2018-12-18,"Slate River Rd","w1819","Non.motorized",21,"Tue","weekday","no_sled","Slate River Rd","2","2","2",4.1,0,19,0,27,21.6,0,-1,0,-1,0,-1,-1,-2
"5210",2018-12-18,"Slate River Rd","w1819","Mechanized",0,"Tue","weekday","no_sled","Slate River Rd","2","2","2",4.1,0,19,0,27,21.6,0,-1,0,-1,0,-1,-1,-2
"5211",2018-12-18,"Slate River Rd","w1819","Motorized",7,"Tue","weekday","sled","Slate River Rd","2","2","2",4.1,0,19,0,27,21.6,0,-1,0,-1,0,-1,-1,-2
"5212",2018-12-18,"Slate River Rd","w1819","Hybrid",7,"Tue","weekday","sled","Slate River Rd","2","2","2",4.1,0,19,0,27,21.6,0,-1,0,-1,0,-1,-1,-2
"5213",2018-12-19,"Slate River Rd","w1819","Non.motorized",10,"Wed","weekday","no_sled","Slate River Rd","2","2","2",4.1,0,19,0,24,21.6,0,0,-1,0,0,0,-1,-1
"5214",2018-12-19,"Slate River Rd","w1819","Mechanized",0,"Wed","weekday","no_sled","Slate River Rd","2","2","2",4.1,0,19,0,24,21.6,0,0,-1,0,0,0,-1,-1
"5215",2018-12-19,"Slate River Rd","w1819","Motorized",3,"Wed","weekday","sled","Slate River Rd","2","2","2",4.1,0,19,0,24,21.6,0,0,-1,0,0,0,-1,-1
"5216",2018-12-19,"Slate River Rd","w1819","Hybrid",3,"Wed","weekday","sled","Slate River Rd","2","2","2",4.1,0,19,0,24,21.6,0,0,-1,0,0,0,-1,-1
"5217",2018-12-20,"Slate River Rd","w1819","Non.motorized",24,"Thu","weekday","no_sled","Slate River Rd","2","2","1",4.1,0,20,1,25,20.5,0,0,0,-1,1,1,1,0
"5218",2018-12-20,"Slate River Rd","w1819","Mechanized",0,"Thu","weekday","no_sled","Slate River Rd","2","2","1",4.1,0,20,1,25,20.5,0,0,0,-1,1,1,1,0
"5219",2018-12-20,"Slate River Rd","w1819","Motorized",7,"Thu","weekday","sled","Slate River Rd","2","2","1",4.1,0,20,1,25,20.5,0,0,0,-1,1,1,1,0
"5220",2018-12-20,"Slate River Rd","w1819","Hybrid",7,"Thu","weekday","sled","Slate River Rd","2","2","1",4.1,0,20,1,25,20.5,0,0,0,-1,1,1,1,0
"5221",2018-12-21,"Slate River Rd","w1819","Non.motorized",9,"Fri","weekday","no_sled","Slate River Rd","2","2","1",4.1,0,19,-1,28,21.6,1,0,0,0,0,0,0,0
"5222",2018-12-21,"Slate River Rd","w1819","Mechanized",0,"Fri","weekday","no_sled","Slate River Rd","2","2","1",4.1,0,19,-1,28,21.6,1,0,0,0,0,0,0,0
"5223",2018-12-21,"Slate River Rd","w1819","Motorized",6,"Fri","weekday","sled","Slate River Rd","2","2","1",4.1,0,19,-1,28,21.6,1,0,0,0,0,0,0,0
"5224",2018-12-21,"Slate River Rd","w1819","Hybrid",6,"Fri","weekday","sled","Slate River Rd","2","2","1",4.1,0,19,-1,28,21.6,1,0,0,0,0,0,0,0
"5225",2018-12-22,"Slate River Rd","w1819","Non.motorized",29,"Sat","weekend","no_sled","Slate River Rd","2","2","1",4.2,0.1,19,0,20,22.1,-1,1,0,0,-1,0,0,0
"5226",2018-12-22,"Slate River Rd","w1819","Mechanized",0,"Sat","weekend","no_sled","Slate River Rd","2","2","1",4.2,0.1,19,0,20,22.1,-1,1,0,0,-1,0,0,0
"5227",2018-12-22,"Slate River Rd","w1819","Motorized",8,"Sat","weekend","sled","Slate River Rd","2","2","1",4.2,0.1,19,0,20,22.1,-1,1,0,0,-1,0,0,0
"5228",2018-12-22,"Slate River Rd","w1819","Hybrid",8,"Sat","weekend","sled","Slate River Rd","2","2","1",4.2,0.1,19,0,20,22.1,-1,1,0,0,-1,0,0,0
"5229",2018-12-23,"Slate River Rd","w1819","Non.motorized",39,"Sun","weekend","no_sled","Slate River Rd","2","2","1",4.2,0,21,2,19,20,0,-1,1,0,2,1,2,2
"5230",2018-12-23,"Slate River Rd","w1819","Mechanized",0,"Sun","weekend","no_sled","Slate River Rd","2","2","1",4.2,0,21,2,19,20,0,-1,1,0,2,1,2,2
"5231",2018-12-23,"Slate River Rd","w1819","Motorized",16,"Sun","weekend","sled","Slate River Rd","2","2","1",4.2,0,21,2,19,20,0,-1,1,0,2,1,2,2
"5232",2018-12-23,"Slate River Rd","w1819","Hybrid",16,"Sun","weekend","sled","Slate River Rd","2","2","1",4.2,0,21,2,19,20,0,-1,1,0,2,1,2,2
"5233",2018-12-24,"Slate River Rd","w1819","Non.motorized",37,"Mon","weekday","no_sled","Slate River Rd","2","2","2",4.3,0.1,20,-1,21,21.5,2,0,-1,1,1,1,0,1
"5234",2018-12-24,"Slate River Rd","w1819","Mechanized",1,"Mon","weekday","no_sled","Slate River Rd","2","2","2",4.3,0.1,20,-1,21,21.5,2,0,-1,1,1,1,0,1
"5235",2018-12-24,"Slate River Rd","w1819","Motorized",11,"Mon","weekday","sled","Slate River Rd","2","2","2",4.3,0.1,20,-1,21,21.5,2,0,-1,1,1,1,0,1
"5236",2018-12-24,"Slate River Rd","w1819","Hybrid",11,"Mon","weekday","sled","Slate River Rd","2","2","2",4.3,0.1,20,-1,21,21.5,2,0,-1,1,1,1,0,1
"5237",2018-12-25,"Slate River Rd","w1819","Non.motorized",61,"Tue","weekday","no_sled","Slate River Rd","2","2","2",4.7,0.4,25,5,25,18.8,-1,2,0,-1,4,6,6,5
"5238",2018-12-25,"Slate River Rd","w1819","Mechanized",0,"Tue","weekday","no_sled","Slate River Rd","2","2","2",4.7,0.4,25,5,25,18.8,-1,2,0,-1,4,6,6,5
"5239",2018-12-25,"Slate River Rd","w1819","Motorized",15,"Tue","weekday","sled","Slate River Rd","2","2","2",4.7,0.4,25,5,25,18.8,-1,2,0,-1,4,6,6,5
"5240",2018-12-25,"Slate River Rd","w1819","Hybrid",15,"Tue","weekday","sled","Slate River Rd","2","2","2",4.7,0.4,25,5,25,18.8,-1,2,0,-1,4,6,6,5
"5241",2018-12-26,"Slate River Rd","w1819","Non.motorized",35,"Wed","weekday","no_sled","Slate River Rd","3","3","3",4.7,0,23,-2,24,20.4,5,-1,2,0,3,2,4,4
"5242",2018-12-26,"Slate River Rd","w1819","Mechanized",0,"Wed","weekday","no_sled","Slate River Rd","3","3","3",4.7,0,23,-2,24,20.4,5,-1,2,0,3,2,4,4
"5243",2018-12-26,"Slate River Rd","w1819","Motorized",16,"Wed","weekday","sled","Slate River Rd","3","3","3",4.7,0,23,-2,24,20.4,5,-1,2,0,3,2,4,4
"5244",2018-12-26,"Slate River Rd","w1819","Hybrid",11,"Wed","weekday","sled","Slate River Rd","3","3","3",4.7,0,23,-2,24,20.4,5,-1,2,0,3,2,4,4
"5245",2018-12-27,"Slate River Rd","w1819","Non.motorized",19,"Thu","weekday","no_sled","Slate River Rd","3","3","2",4.7,0,24,1,12,19.6,-2,5,-1,2,-1,4,3,5
"5246",2018-12-27,"Slate River Rd","w1819","Mechanized",1,"Thu","weekday","no_sled","Slate River Rd","3","3","2",4.7,0,24,1,12,19.6,-2,5,-1,2,-1,4,3,5
"5247",2018-12-27,"Slate River Rd","w1819","Motorized",7,"Thu","weekday","sled","Slate River Rd","3","3","2",4.7,0,24,1,12,19.6,-2,5,-1,2,-1,4,3,5
"5248",2018-12-27,"Slate River Rd","w1819","Hybrid",5,"Thu","weekday","sled","Slate River Rd","3","3","2",4.7,0,24,1,12,19.6,-2,5,-1,2,-1,4,3,5
"5249",2018-12-28,"Slate River Rd","w1819","Non.motorized",60,"Fri","weekday","no_sled","Slate River Rd","3","3","2",4.7,0,24,0,12,19.6,1,-2,5,-1,1,-1,4,3
"5250",2018-12-28,"Slate River Rd","w1819","Mechanized",0,"Fri","weekday","no_sled","Slate River Rd","3","3","2",4.7,0,24,0,12,19.6,1,-2,5,-1,1,-1,4,3
"5251",2018-12-28,"Slate River Rd","w1819","Motorized",10,"Fri","weekday","sled","Slate River Rd","3","3","2",4.7,0,24,0,12,19.6,1,-2,5,-1,1,-1,4,3
"5252",2018-12-28,"Slate River Rd","w1819","Hybrid",8,"Fri","weekday","sled","Slate River Rd","3","3","2",4.7,0,24,0,12,19.6,1,-2,5,-1,1,-1,4,3
"5253",2018-12-29,"Slate River Rd","w1819","Non.motorized",50,"Sat","weekend","no_sled","Slate River Rd","3","3","2",4.7,0,24,0,8,19.6,0,1,-2,5,0,1,-1,4
"5254",2018-12-29,"Slate River Rd","w1819","Mechanized",2,"Sat","weekend","no_sled","Slate River Rd","3","3","2",4.7,0,24,0,8,19.6,0,1,-2,5,0,1,-1,4
"5255",2018-12-29,"Slate River Rd","w1819","Motorized",51,"Sat","weekend","sled","Slate River Rd","3","3","2",4.7,0,24,0,8,19.6,0,1,-2,5,0,1,-1,4
"5256",2018-12-29,"Slate River Rd","w1819","Hybrid",10,"Sat","weekend","sled","Slate River Rd","3","3","2",4.7,0,24,0,8,19.6,0,1,-2,5,0,1,-1,4
"5257",2018-12-30,"Slate River Rd","w1819","Non.motorized",54,"Sun","weekend","no_sled","Slate River Rd","3","3","2",4.7,0,24,0,16,19.6,0,0,1,-2,0,0,1,-1
"5258",2018-12-30,"Slate River Rd","w1819","Mechanized",1,"Sun","weekend","no_sled","Slate River Rd","3","3","2",4.7,0,24,0,16,19.6,0,0,1,-2,0,0,1,-1
"5259",2018-12-30,"Slate River Rd","w1819","Motorized",26,"Sun","weekend","sled","Slate River Rd","3","3","2",4.7,0,24,0,16,19.6,0,0,1,-2,0,0,1,-1
"5260",2018-12-30,"Slate River Rd","w1819","Hybrid",20,"Sun","weekend","sled","Slate River Rd","3","3","2",4.7,0,24,0,16,19.6,0,0,1,-2,0,0,1,-1
"5261",2018-12-31,"Slate River Rd","w1819","Non.motorized",36,"Mon","weekday","no_sled","Slate River Rd","3","3","3",4.9,0.2,23,-1,14,21.3,0,0,0,1,-1,-1,-1,0
"5262",2018-12-31,"Slate River Rd","w1819","Mechanized",0,"Mon","weekday","no_sled","Slate River Rd","3","3","3",4.9,0.2,23,-1,14,21.3,0,0,0,1,-1,-1,-1,0
"5263",2018-12-31,"Slate River Rd","w1819","Motorized",6,"Mon","weekday","sled","Slate River Rd","3","3","3",4.9,0.2,23,-1,14,21.3,0,0,0,1,-1,-1,-1,0
"5264",2018-12-31,"Slate River Rd","w1819","Hybrid",6,"Mon","weekday","sled","Slate River Rd","3","3","3",4.9,0.2,23,-1,14,21.3,0,0,0,1,-1,-1,-1,0
"5265",2019-01-01,"Slate River Rd","w1819","Non.motorized",29,"Tue","weekday","no_sled","Slate River Rd","3","3","3",5.1,0.2,29,6,11,17.6,-1,0,0,0,5,5,5,5
"5266",2019-01-01,"Slate River Rd","w1819","Mechanized",2,"Tue","weekday","no_sled","Slate River Rd","3","3","3",5.1,0.2,29,6,11,17.6,-1,0,0,0,5,5,5,5
"5267",2019-01-01,"Slate River Rd","w1819","Motorized",23,"Tue","weekday","sled","Slate River Rd","3","3","3",5.1,0.2,29,6,11,17.6,-1,0,0,0,5,5,5,5
"5268",2019-01-01,"Slate River Rd","w1819","Hybrid",23,"Tue","weekday","sled","Slate River Rd","3","3","3",5.1,0.2,29,6,11,17.6,-1,0,0,0,5,5,5,5
"5269",2019-01-02,"Slate River Rd","w1819","Non.motorized",25,"Wed","weekday","no_sled","Slate River Rd","3","3","2",5.1,0,28,-1,10,18.2,6,-1,0,0,5,4,4,4
"5270",2019-01-02,"Slate River Rd","w1819","Mechanized",0,"Wed","weekday","no_sled","Slate River Rd","3","3","2",5.1,0,28,-1,10,18.2,6,-1,0,0,5,4,4,4
"5271",2019-01-02,"Slate River Rd","w1819","Motorized",4,"Wed","weekday","sled","Slate River Rd","3","3","2",5.1,0,28,-1,10,18.2,6,-1,0,0,5,4,4,4
"5272",2019-01-02,"Slate River Rd","w1819","Hybrid",4,"Wed","weekday","sled","Slate River Rd","3","3","2",5.1,0,28,-1,10,18.2,6,-1,0,0,5,4,4,4
"5273",2019-01-03,"Slate River Rd","w1819","Non.motorized",45,"Thu","weekday","no_sled","Slate River Rd","3","3","2",5.1,0,27,-1,22,18.9,-1,6,-1,0,-2,4,3,3
"5274",2019-01-03,"Slate River Rd","w1819","Mechanized",1,"Thu","weekday","no_sled","Slate River Rd","3","3","2",5.1,0,27,-1,22,18.9,-1,6,-1,0,-2,4,3,3
"5275",2019-01-03,"Slate River Rd","w1819","Motorized",2,"Thu","weekday","sled","Slate River Rd","3","3","2",5.1,0,27,-1,22,18.9,-1,6,-1,0,-2,4,3,3
"5276",2019-01-03,"Slate River Rd","w1819","Hybrid",1,"Thu","weekday","sled","Slate River Rd","3","3","2",5.1,0,27,-1,22,18.9,-1,6,-1,0,-2,4,3,3
"5277",2019-01-04,"Slate River Rd","w1819","Non.motorized",18,"Fri","weekday","no_sled","Slate River Rd","3","3","2",5.3,0.2,26,-1,29,20.4,-1,-1,6,-1,-2,-3,3,2
"5278",2019-01-04,"Slate River Rd","w1819","Mechanized",1,"Fri","weekday","no_sled","Slate River Rd","3","3","2",5.3,0.2,26,-1,29,20.4,-1,-1,6,-1,-2,-3,3,2
"5279",2019-01-04,"Slate River Rd","w1819","Motorized",8,"Fri","weekday","sled","Slate River Rd","3","3","2",5.3,0.2,26,-1,29,20.4,-1,-1,6,-1,-2,-3,3,2
"5280",2019-01-04,"Slate River Rd","w1819","Hybrid",8,"Fri","weekday","sled","Slate River Rd","3","3","2",5.3,0.2,26,-1,29,20.4,-1,-1,6,-1,-2,-3,3,2
"5281",2019-01-05,"Slate River Rd","w1819","Non.motorized",49,"Sat","weekend","no_sled","Slate River Rd","2","2","2",5.3,0,25,-1,30,21.2,-1,-1,-1,6,-2,-3,-4,2
"5282",2019-01-05,"Slate River Rd","w1819","Mechanized",4,"Sat","weekend","no_sled","Slate River Rd","2","2","2",5.3,0,25,-1,30,21.2,-1,-1,-1,6,-2,-3,-4,2
"5283",2019-01-05,"Slate River Rd","w1819","Motorized",16,"Sat","weekend","sled","Slate River Rd","2","2","2",5.3,0,25,-1,30,21.2,-1,-1,-1,6,-2,-3,-4,2
"5284",2019-01-05,"Slate River Rd","w1819","Hybrid",16,"Sat","weekend","sled","Slate River Rd","2","2","2",5.3,0,25,-1,30,21.2,-1,-1,-1,6,-2,-3,-4,2
"5285",2019-01-06,"Slate River Rd","w1819","Non.motorized",23,"Sun","weekend","no_sled","Slate River Rd","3","3","3",5.3,0,25,0,26,21.2,-1,-1,-1,-1,-1,-2,-3,-4
"5286",2019-01-06,"Slate River Rd","w1819","Mechanized",0,"Sun","weekend","no_sled","Slate River Rd","3","3","3",5.3,0,25,0,26,21.2,-1,-1,-1,-1,-1,-2,-3,-4
"5287",2019-01-06,"Slate River Rd","w1819","Motorized",10,"Sun","weekend","sled","Slate River Rd","3","3","3",5.3,0,25,0,26,21.2,-1,-1,-1,-1,-1,-2,-3,-4
"5288",2019-01-06,"Slate River Rd","w1819","Hybrid",8,"Sun","weekend","sled","Slate River Rd","3","3","3",5.3,0,25,0,26,21.2,-1,-1,-1,-1,-1,-2,-3,-4
"5289",2019-01-07,"Slate River Rd","w1819","Non.motorized",5,"Mon","weekday","no_sled","Slate River Rd","3","3","3",5.8,0.5,32,7,21,18.1,0,-1,-1,-1,7,6,5,4
"5290",2019-01-07,"Slate River Rd","w1819","Mechanized",0,"Mon","weekday","no_sled","Slate River Rd","3","3","3",5.8,0.5,32,7,21,18.1,0,-1,-1,-1,7,6,5,4
"5291",2019-01-07,"Slate River Rd","w1819","Motorized",7,"Mon","weekday","sled","Slate River Rd","3","3","3",5.8,0.5,32,7,21,18.1,0,-1,-1,-1,7,6,5,4
"5292",2019-01-07,"Slate River Rd","w1819","Hybrid",7,"Mon","weekday","sled","Slate River Rd","3","3","3",5.8,0.5,32,7,21,18.1,0,-1,-1,-1,7,6,5,4
"5293",2019-01-08,"Slate River Rd","w1819","Non.motorized",17,"Tue","weekday","no_sled","Slate River Rd","3","3","3",5.9,0.1,32,0,24,18.4,7,0,-1,-1,7,7,6,5
"5294",2019-01-08,"Slate River Rd","w1819","Mechanized",0,"Tue","weekday","no_sled","Slate River Rd","3","3","3",5.9,0.1,32,0,24,18.4,7,0,-1,-1,7,7,6,5
"5295",2019-01-08,"Slate River Rd","w1819","Motorized",3,"Tue","weekday","sled","Slate River Rd","3","3","3",5.9,0.1,32,0,24,18.4,7,0,-1,-1,7,7,6,5
"5296",2019-01-08,"Slate River Rd","w1819","Hybrid",3,"Tue","weekday","sled","Slate River Rd","3","3","3",5.9,0.1,32,0,24,18.4,7,0,-1,-1,7,7,6,5
"5297",2019-01-09,"Slate River Rd","w1819","Non.motorized",25,"Wed","weekday","no_sled","Slate River Rd","3","3","3",6,0.1,30,-2,29,20,0,7,0,-1,-2,5,5,4
"5298",2019-01-09,"Slate River Rd","w1819","Mechanized",0,"Wed","weekday","no_sled","Slate River Rd","3","3","3",6,0.1,30,-2,29,20,0,7,0,-1,-2,5,5,4
"5299",2019-01-09,"Slate River Rd","w1819","Motorized",7,"Wed","weekday","sled","Slate River Rd","3","3","3",6,0.1,30,-2,29,20,0,7,0,-1,-2,5,5,4
"5300",2019-01-09,"Slate River Rd","w1819","Hybrid",7,"Wed","weekday","sled","Slate River Rd","3","3","3",6,0.1,30,-2,29,20,0,7,0,-1,-2,5,5,4
"5301",2019-01-10,"Slate River Rd","w1819","Non.motorized",20,"Thu","weekday","no_sled","Slate River Rd","3","3","3",6,0,29,-1,29,20.7,-2,0,7,0,-3,-3,4,4
"5302",2019-01-10,"Slate River Rd","w1819","Mechanized",0,"Thu","weekday","no_sled","Slate River Rd","3","3","3",6,0,29,-1,29,20.7,-2,0,7,0,-3,-3,4,4
"5303",2019-01-10,"Slate River Rd","w1819","Motorized",10,"Thu","weekday","sled","Slate River Rd","3","3","3",6,0,29,-1,29,20.7,-2,0,7,0,-3,-3,4,4
"5304",2019-01-10,"Slate River Rd","w1819","Hybrid",10,"Thu","weekday","sled","Slate River Rd","3","3","3",6,0,29,-1,29,20.7,-2,0,7,0,-3,-3,4,4
"5305",2019-01-11,"Slate River Rd","w1819","Non.motorized",17,"Fri","weekday","no_sled","Slate River Rd","2","2","2",6.1,0.1,29,0,25,21,-1,-2,0,7,-1,-3,-3,4
"5306",2019-01-11,"Slate River Rd","w1819","Mechanized",0,"Fri","weekday","no_sled","Slate River Rd","2","2","2",6.1,0.1,29,0,25,21,-1,-2,0,7,-1,-3,-3,4
"5307",2019-01-11,"Slate River Rd","w1819","Motorized",13,"Fri","weekday","sled","Slate River Rd","2","2","2",6.1,0.1,29,0,25,21,-1,-2,0,7,-1,-3,-3,4
"5308",2019-01-11,"Slate River Rd","w1819","Hybrid",12,"Fri","weekday","sled","Slate River Rd","2","2","2",6.1,0.1,29,0,25,21,-1,-2,0,7,-1,-3,-3,4
"5309",2019-01-12,"Slate River Rd","w1819","Non.motorized",14,"Sat","weekend","no_sled","Slate River Rd","3","3","2",6.1,0,28,-1,21,21.8,0,-1,-2,0,-1,-2,-4,-4
"5310",2019-01-12,"Slate River Rd","w1819","Mechanized",0,"Sat","weekend","no_sled","Slate River Rd","3","3","2",6.1,0,28,-1,21,21.8,0,-1,-2,0,-1,-2,-4,-4
"5311",2019-01-12,"Slate River Rd","w1819","Motorized",14,"Sat","weekend","sled","Slate River Rd","3","3","2",6.1,0,28,-1,21,21.8,0,-1,-2,0,-1,-2,-4,-4
"5312",2019-01-12,"Slate River Rd","w1819","Hybrid",14,"Sat","weekend","sled","Slate River Rd","3","3","2",6.1,0,28,-1,21,21.8,0,-1,-2,0,-1,-2,-4,-4
"5313",2019-01-13,"Slate River Rd","w1819","Non.motorized",23,"Sun","weekend","no_sled","Slate River Rd","2","2","2",6.2,0.1,30,2,18,20.7,-1,0,-1,-2,1,1,0,-2
"5314",2019-01-13,"Slate River Rd","w1819","Mechanized",0,"Sun","weekend","no_sled","Slate River Rd","2","2","2",6.2,0.1,30,2,18,20.7,-1,0,-1,-2,1,1,0,-2
"5315",2019-01-13,"Slate River Rd","w1819","Motorized",6,"Sun","weekend","sled","Slate River Rd","2","2","2",6.2,0.1,30,2,18,20.7,-1,0,-1,-2,1,1,0,-2
"5316",2019-01-13,"Slate River Rd","w1819","Hybrid",6,"Sun","weekend","sled","Slate River Rd","2","2","2",6.2,0.1,30,2,18,20.7,-1,0,-1,-2,1,1,0,-2
"5317",2019-01-14,"Slate River Rd","w1819","Non.motorized",22,"Mon","weekday","no_sled","Slate River Rd","2","2","2",6.2,0,30,0,18,20.7,2,-1,0,-1,2,1,1,0
"5318",2019-01-14,"Slate River Rd","w1819","Mechanized",0,"Mon","weekday","no_sled","Slate River Rd","2","2","2",6.2,0,30,0,18,20.7,2,-1,0,-1,2,1,1,0
"5319",2019-01-14,"Slate River Rd","w1819","Motorized",9,"Mon","weekday","sled","Slate River Rd","2","2","2",6.2,0,30,0,18,20.7,2,-1,0,-1,2,1,1,0
"5320",2019-01-14,"Slate River Rd","w1819","Hybrid",8,"Mon","weekday","sled","Slate River Rd","2","2","2",6.2,0,30,0,18,20.7,2,-1,0,-1,2,1,1,0
"5321",2019-01-15,"Slate River Rd","w1819","Non.motorized",18,"Tue","weekday","no_sled","Slate River Rd","2","2","2",6.2,0,29,-1,24,21.4,0,2,-1,0,-1,1,0,0
"5322",2019-01-15,"Slate River Rd","w1819","Mechanized",0,"Tue","weekday","no_sled","Slate River Rd","2","2","2",6.2,0,29,-1,24,21.4,0,2,-1,0,-1,1,0,0
"5323",2019-01-15,"Slate River Rd","w1819","Motorized",4,"Tue","weekday","sled","Slate River Rd","2","2","2",6.2,0,29,-1,24,21.4,0,2,-1,0,-1,1,0,0
"5324",2019-01-15,"Slate River Rd","w1819","Hybrid",4,"Tue","weekday","sled","Slate River Rd","2","2","2",6.2,0,29,-1,24,21.4,0,2,-1,0,-1,1,0,0
"5325",2019-01-16,"Slate River Rd","w1819","Non.motorized",3,"Wed","weekday","no_sled","Slate River Rd","4","4","3",6.3,0.1,29,0,26,21.7,-1,0,2,-1,-1,-1,1,0
"5326",2019-01-16,"Slate River Rd","w1819","Mechanized",0,"Wed","weekday","no_sled","Slate River Rd","4","4","3",6.3,0.1,29,0,26,21.7,-1,0,2,-1,-1,-1,1,0
"5327",2019-01-16,"Slate River Rd","w1819","Motorized",0,"Wed","weekday","sled","Slate River Rd","4","4","3",6.3,0.1,29,0,26,21.7,-1,0,2,-1,-1,-1,1,0
"5328",2019-01-16,"Slate River Rd","w1819","Hybrid",0,"Wed","weekday","sled","Slate River Rd","4","4","3",6.3,0.1,29,0,26,21.7,-1,0,2,-1,-1,-1,1,0
"5329",2019-01-17,"Slate River Rd","w1819","Non.motorized",8,"Thu","weekday","no_sled","Slate River Rd","3","3","2",7,0.7,38,9,28,18.4,0,-1,0,2,9,8,8,10
"5330",2019-01-17,"Slate River Rd","w1819","Mechanized",0,"Thu","weekday","no_sled","Slate River Rd","3","3","2",7,0.7,38,9,28,18.4,0,-1,0,2,9,8,8,10
"5331",2019-01-17,"Slate River Rd","w1819","Motorized",4,"Thu","weekday","sled","Slate River Rd","3","3","2",7,0.7,38,9,28,18.4,0,-1,0,2,9,8,8,10
"5332",2019-01-17,"Slate River Rd","w1819","Hybrid",3,"Thu","weekday","sled","Slate River Rd","3","3","2",7,0.7,38,9,28,18.4,0,-1,0,2,9,8,8,10
"5333",2019-01-18,"Slate River Rd","w1819","Non.motorized",10,"Fri","weekday","no_sled","Slate River Rd","4","4","4",7.5,0.5,41,3,22,18.3,9,0,-1,0,12,12,11,11
"5334",2019-01-18,"Slate River Rd","w1819","Mechanized",0,"Fri","weekday","no_sled","Slate River Rd","4","4","4",7.5,0.5,41,3,22,18.3,9,0,-1,0,12,12,11,11
"5335",2019-01-18,"Slate River Rd","w1819","Motorized",1,"Fri","weekday","sled","Slate River Rd","4","4","4",7.5,0.5,41,3,22,18.3,9,0,-1,0,12,12,11,11
"5336",2019-01-18,"Slate River Rd","w1819","Hybrid",1,"Fri","weekday","sled","Slate River Rd","4","4","4",7.5,0.5,41,3,22,18.3,9,0,-1,0,12,12,11,11
"5337",2019-01-19,"Slate River Rd","w1819","Non.motorized",0,"Sat","weekend","no_sled","Slate River Rd","3","3","3",7.8,0.3,43,2,20,18.1,3,9,0,-1,5,14,14,13
"5338",2019-01-19,"Slate River Rd","w1819","Mechanized",0,"Sat","weekend","no_sled","Slate River Rd","3","3","3",7.8,0.3,43,2,20,18.1,3,9,0,-1,5,14,14,13
"5339",2019-01-19,"Slate River Rd","w1819","Motorized",0,"Sat","weekend","sled","Slate River Rd","3","3","3",7.8,0.3,43,2,20,18.1,3,9,0,-1,5,14,14,13
"5340",2019-01-19,"Slate River Rd","w1819","Hybrid",0,"Sat","weekend","sled","Slate River Rd","3","3","3",7.8,0.3,43,2,20,18.1,3,9,0,-1,5,14,14,13
"5341",2019-01-20,"Slate River Rd","w1819","Non.motorized",0,"Sun","weekend","no_sled","Slate River Rd","3","3","3",7.9,0.1,41,-2,27,19.3,2,3,9,0,0,3,12,12
"5342",2019-01-20,"Slate River Rd","w1819","Mechanized",0,"Sun","weekend","no_sled","Slate River Rd","3","3","3",7.9,0.1,41,-2,27,19.3,2,3,9,0,0,3,12,12
"5343",2019-01-20,"Slate River Rd","w1819","Motorized",0,"Sun","weekend","sled","Slate River Rd","3","3","3",7.9,0.1,41,-2,27,19.3,2,3,9,0,0,3,12,12
"5344",2019-01-20,"Slate River Rd","w1819","Hybrid",0,"Sun","weekend","sled","Slate River Rd","3","3","3",7.9,0.1,41,-2,27,19.3,2,3,9,0,0,3,12,12
"5345",2019-01-21,"Slate River Rd","w1819","Non.motorized",1,"Mon","weekday","no_sled","Slate River Rd","3","3","3",7.9,0,39,-2,23,20.3,-2,2,3,9,-4,-2,1,10
"5346",2019-01-21,"Slate River Rd","w1819","Mechanized",0,"Mon","weekday","no_sled","Slate River Rd","3","3","3",7.9,0,39,-2,23,20.3,-2,2,3,9,-4,-2,1,10
"5347",2019-01-21,"Slate River Rd","w1819","Motorized",2,"Mon","weekday","sled","Slate River Rd","3","3","3",7.9,0,39,-2,23,20.3,-2,2,3,9,-4,-2,1,10
"5348",2019-01-21,"Slate River Rd","w1819","Hybrid",0,"Mon","weekday","sled","Slate River Rd","3","3","3",7.9,0,39,-2,23,20.3,-2,2,3,9,-4,-2,1,10
"5349",2019-01-22,"Slate River Rd","w1819","Non.motorized",28,"Tue","weekday","no_sled","Slate River Rd","3","3","3",8,0.1,41,2,12,19.5,-2,-2,2,3,0,-2,0,3
"5350",2019-01-22,"Slate River Rd","w1819","Mechanized",0,"Tue","weekday","no_sled","Slate River Rd","3","3","3",8,0.1,41,2,12,19.5,-2,-2,2,3,0,-2,0,3
"5351",2019-01-22,"Slate River Rd","w1819","Motorized",4,"Tue","weekday","sled","Slate River Rd","3","3","3",8,0.1,41,2,12,19.5,-2,-2,2,3,0,-2,0,3
"5352",2019-01-22,"Slate River Rd","w1819","Hybrid",0,"Tue","weekday","sled","Slate River Rd","3","3","3",8,0.1,41,2,12,19.5,-2,-2,2,3,0,-2,0,3
"5353",2019-01-23,"Slate River Rd","w1819","Non.motorized",9,"Wed","weekday","no_sled","Slate River Rd","3","3","2",8,0,40,-1,14,20,2,-2,-2,2,1,-1,-3,-1
"5354",2019-01-23,"Slate River Rd","w1819","Mechanized",0,"Wed","weekday","no_sled","Slate River Rd","3","3","2",8,0,40,-1,14,20,2,-2,-2,2,1,-1,-3,-1
"5355",2019-01-23,"Slate River Rd","w1819","Motorized",5,"Wed","weekday","sled","Slate River Rd","3","3","2",8,0,40,-1,14,20,2,-2,-2,2,1,-1,-3,-1
"5356",2019-01-23,"Slate River Rd","w1819","Hybrid",0,"Wed","weekday","sled","Slate River Rd","3","3","2",8,0,40,-1,14,20,2,-2,-2,2,1,-1,-3,-1
"5357",2019-01-24,"Slate River Rd","w1819","Non.motorized",21,"Thu","weekday","no_sled","Slate River Rd","3","3","2",8.2,0.2,40,0,17,20.5,-1,2,-2,-2,-1,1,-1,-3
"5358",2019-01-24,"Slate River Rd","w1819","Mechanized",0,"Thu","weekday","no_sled","Slate River Rd","3","3","2",8.2,0.2,40,0,17,20.5,-1,2,-2,-2,-1,1,-1,-3
"5359",2019-01-24,"Slate River Rd","w1819","Motorized",0,"Thu","weekday","sled","Slate River Rd","3","3","2",8.2,0.2,40,0,17,20.5,-1,2,-2,-2,-1,1,-1,-3
"5360",2019-01-24,"Slate River Rd","w1819","Hybrid",0,"Thu","weekday","sled","Slate River Rd","3","3","2",8.2,0.2,40,0,17,20.5,-1,2,-2,-2,-1,1,-1,-3
"5361",2019-01-25,"Slate River Rd","w1819","Non.motorized",28,"Fri","weekday","no_sled","Slate River Rd","3","3","2",8.3,0.1,40,0,15,20.8,0,-1,2,-2,0,-1,1,-1
"5362",2019-01-25,"Slate River Rd","w1819","Mechanized",0,"Fri","weekday","no_sled","Slate River Rd","3","3","2",8.3,0.1,40,0,15,20.8,0,-1,2,-2,0,-1,1,-1
"5363",2019-01-25,"Slate River Rd","w1819","Motorized",5,"Fri","weekday","sled","Slate River Rd","3","3","2",8.3,0.1,40,0,15,20.8,0,-1,2,-2,0,-1,1,-1
"5364",2019-01-25,"Slate River Rd","w1819","Hybrid",0,"Fri","weekday","sled","Slate River Rd","3","3","2",8.3,0.1,40,0,15,20.8,0,-1,2,-2,0,-1,1,-1
"5365",2019-01-26,"Slate River Rd","w1819","Non.motorized",45,"Sat","weekend","no_sled","Slate River Rd","3","3","2",8.3,0,39,-1,19,21.3,0,0,-1,2,-1,-1,-2,0
"5366",2019-01-26,"Slate River Rd","w1819","Mechanized",0,"Sat","weekend","no_sled","Slate River Rd","3","3","2",8.3,0,39,-1,19,21.3,0,0,-1,2,-1,-1,-2,0
"5367",2019-01-26,"Slate River Rd","w1819","Motorized",13,"Sat","weekend","sled","Slate River Rd","3","3","2",8.3,0,39,-1,19,21.3,0,0,-1,2,-1,-1,-2,0
"5368",2019-01-26,"Slate River Rd","w1819","Hybrid",13,"Sat","weekend","sled","Slate River Rd","3","3","2",8.3,0,39,-1,19,21.3,0,0,-1,2,-1,-1,-2,0
"5369",2019-01-27,"Slate River Rd","w1819","Non.motorized",16,"Sun","weekend","no_sled","Slate River Rd","3","3","2",8.3,0,38,-1,24,21.8,-1,0,0,-1,-2,-2,-2,-3
"5370",2019-01-27,"Slate River Rd","w1819","Mechanized",3,"Sun","weekend","no_sled","Slate River Rd","3","3","2",8.3,0,38,-1,24,21.8,-1,0,0,-1,-2,-2,-2,-3
"5371",2019-01-27,"Slate River Rd","w1819","Motorized",5,"Sun","weekend","sled","Slate River Rd","3","3","2",8.3,0,38,-1,24,21.8,-1,0,0,-1,-2,-2,-2,-3
"5372",2019-01-27,"Slate River Rd","w1819","Hybrid",5,"Sun","weekend","sled","Slate River Rd","3","3","2",8.3,0,38,-1,24,21.8,-1,0,0,-1,-2,-2,-2,-3
"5373",2019-01-28,"Slate River Rd","w1819","Non.motorized",2,"Mon","weekday","no_sled","Slate River Rd","2","2","2",8.3,0,38,0,17,21.8,-1,-1,0,0,-1,-2,-2,-2
"5374",2019-01-28,"Slate River Rd","w1819","Mechanized",0,"Mon","weekday","no_sled","Slate River Rd","2","2","2",8.3,0,38,0,17,21.8,-1,-1,0,0,-1,-2,-2,-2
"5375",2019-01-28,"Slate River Rd","w1819","Motorized",1,"Mon","weekday","sled","Slate River Rd","2","2","2",8.3,0,38,0,17,21.8,-1,-1,0,0,-1,-2,-2,-2
"5376",2019-01-28,"Slate River Rd","w1819","Hybrid",1,"Mon","weekday","sled","Slate River Rd","2","2","2",8.3,0,38,0,17,21.8,-1,-1,0,0,-1,-2,-2,-2
"5377",2019-01-29,"Slate River Rd","w1819","Non.motorized",0,"Tue","weekday","no_sled","Slate River Rd","2","2","2",8.3,0,38,0,16,21.8,0,-1,-1,0,0,-1,-2,-2
"5378",2019-01-29,"Slate River Rd","w1819","Mechanized",0,"Tue","weekday","no_sled","Slate River Rd","2","2","2",8.3,0,38,0,16,21.8,0,-1,-1,0,0,-1,-2,-2
"5379",2019-01-29,"Slate River Rd","w1819","Motorized",0,"Tue","weekday","sled","Slate River Rd","2","2","2",8.3,0,38,0,16,21.8,0,-1,-1,0,0,-1,-2,-2
"5380",2019-01-29,"Slate River Rd","w1819","Hybrid",0,"Tue","weekday","sled","Slate River Rd","2","2","2",8.3,0,38,0,16,21.8,0,-1,-1,0,0,-1,-2,-2
"5381",2019-01-30,"Slate River Rd","w1819","Non.motorized",0,"Wed","weekday","no_sled","Slate River Rd","2","2","1",8.3,0,37,-1,20,22.4,0,0,-1,-1,-1,-1,-2,-3
"5382",2019-01-30,"Slate River Rd","w1819","Mechanized",0,"Wed","weekday","no_sled","Slate River Rd","2","2","1",8.3,0,37,-1,20,22.4,0,0,-1,-1,-1,-1,-2,-3
"5383",2019-01-30,"Slate River Rd","w1819","Motorized",0,"Wed","weekday","sled","Slate River Rd","2","2","1",8.3,0,37,-1,20,22.4,0,0,-1,-1,-1,-1,-2,-3
"5384",2019-01-30,"Slate River Rd","w1819","Hybrid",0,"Wed","weekday","sled","Slate River Rd","2","2","1",8.3,0,37,-1,20,22.4,0,0,-1,-1,-1,-1,-2,-3
"5385",2019-01-31,"Slate River Rd","w1819","Non.motorized",0,"Thu","weekday","no_sled","Slate River Rd","2","2","1",8.3,0,36,-1,24,23.1,-1,0,0,-1,-2,-2,-2,-3
"5386",2019-01-31,"Slate River Rd","w1819","Mechanized",0,"Thu","weekday","no_sled","Slate River Rd","2","2","1",8.3,0,36,-1,24,23.1,-1,0,0,-1,-2,-2,-2,-3
"5387",2019-01-31,"Slate River Rd","w1819","Motorized",0,"Thu","weekday","sled","Slate River Rd","2","2","1",8.3,0,36,-1,24,23.1,-1,0,0,-1,-2,-2,-2,-3
"5388",2019-01-31,"Slate River Rd","w1819","Hybrid",0,"Thu","weekday","sled","Slate River Rd","2","2","1",8.3,0,36,-1,24,23.1,-1,0,0,-1,-2,-2,-2,-3
"5389",2019-02-01,"Slate River Rd","w1819","Non.motorized",12,"Fri","weekday","no_sled","Slate River Rd","2","2","1",8.3,0,36,0,25,23.1,-1,-1,0,0,-1,-2,-2,-2
"5390",2019-02-01,"Slate River Rd","w1819","Mechanized",0,"Fri","weekday","no_sled","Slate River Rd","2","2","1",8.3,0,36,0,25,23.1,-1,-1,0,0,-1,-2,-2,-2
"5391",2019-02-01,"Slate River Rd","w1819","Motorized",0,"Fri","weekday","sled","Slate River Rd","2","2","1",8.3,0,36,0,25,23.1,-1,-1,0,0,-1,-2,-2,-2
"5392",2019-02-01,"Slate River Rd","w1819","Hybrid",0,"Fri","weekday","sled","Slate River Rd","2","2","1",8.3,0,36,0,25,23.1,-1,-1,0,0,-1,-2,-2,-2
"5393",2019-02-02,"Slate River Rd","w1819","Non.motorized",45,"Sat","weekend","no_sled","Slate River Rd","2","2","1",8.3,0,36,0,26,23.1,0,-1,-1,0,0,-1,-2,-2
"5394",2019-02-02,"Slate River Rd","w1819","Mechanized",0,"Sat","weekend","no_sled","Slate River Rd","2","2","1",8.3,0,36,0,26,23.1,0,-1,-1,0,0,-1,-2,-2
"5395",2019-02-02,"Slate River Rd","w1819","Motorized",15,"Sat","weekend","sled","Slate River Rd","2","2","1",8.3,0,36,0,26,23.1,0,-1,-1,0,0,-1,-2,-2
"5396",2019-02-02,"Slate River Rd","w1819","Hybrid",11,"Sat","weekend","sled","Slate River Rd","2","2","1",8.3,0,36,0,26,23.1,0,-1,-1,0,0,-1,-2,-2
"5397",2019-02-03,"Slate River Rd","w1819","Non.motorized",11,"Sun","weekend","no_sled","Slate River Rd","3","3","2",8.4,0.1,36,0,28,23.3,0,0,-1,-1,0,0,-1,-2
"5398",2019-02-03,"Slate River Rd","w1819","Mechanized",0,"Sun","weekend","no_sled","Slate River Rd","3","3","2",8.4,0.1,36,0,28,23.3,0,0,-1,-1,0,0,-1,-2
"5399",2019-02-03,"Slate River Rd","w1819","Motorized",5,"Sun","weekend","sled","Slate River Rd","3","3","2",8.4,0.1,36,0,28,23.3,0,0,-1,-1,0,0,-1,-2
"5400",2019-02-03,"Slate River Rd","w1819","Hybrid",5,"Sun","weekend","sled","Slate River Rd","3","3","2",8.4,0.1,36,0,28,23.3,0,0,-1,-1,0,0,-1,-2
"5401",2019-02-04,"Slate River Rd","w1819","Non.motorized",15,"Mon","weekday","no_sled","Slate River Rd","3","3","2",8.8,0.4,39,3,28,22.6,0,0,0,-1,3,3,3,2
"5402",2019-02-04,"Slate River Rd","w1819","Mechanized",0,"Mon","weekday","no_sled","Slate River Rd","3","3","2",8.8,0.4,39,3,28,22.6,0,0,0,-1,3,3,3,2
"5403",2019-02-04,"Slate River Rd","w1819","Motorized",3,"Mon","weekday","sled","Slate River Rd","3","3","2",8.8,0.4,39,3,28,22.6,0,0,0,-1,3,3,3,2
"5404",2019-02-04,"Slate River Rd","w1819","Hybrid",3,"Mon","weekday","sled","Slate River Rd","3","3","2",8.8,0.4,39,3,28,22.6,0,0,0,-1,3,3,3,2
"5405",2019-02-05,"Slate River Rd","w1819","Non.motorized",15,"Tue","weekday","no_sled","Slate River Rd","3","2","2",9,0.2,40,1,26,22.5,3,0,0,0,4,4,4,4
"5406",2019-02-05,"Slate River Rd","w1819","Mechanized",0,"Tue","weekday","no_sled","Slate River Rd","3","2","2",9,0.2,40,1,26,22.5,3,0,0,0,4,4,4,4
"5407",2019-02-05,"Slate River Rd","w1819","Motorized",4,"Tue","weekday","sled","Slate River Rd","3","2","2",9,0.2,40,1,26,22.5,3,0,0,0,4,4,4,4
"5408",2019-02-05,"Slate River Rd","w1819","Hybrid",4,"Tue","weekday","sled","Slate River Rd","3","2","2",9,0.2,40,1,26,22.5,3,0,0,0,4,4,4,4
"5409",2019-02-06,"Slate River Rd","w1819","Non.motorized",3,"Wed","weekday","no_sled","Slate River Rd","4","4","3",9,0,40,0,16,22.5,1,3,0,0,1,4,4,4
"5410",2019-02-06,"Slate River Rd","w1819","Mechanized",0,"Wed","weekday","no_sled","Slate River Rd","4","4","3",9,0,40,0,16,22.5,1,3,0,0,1,4,4,4
"5411",2019-02-06,"Slate River Rd","w1819","Motorized",3,"Wed","weekday","sled","Slate River Rd","4","4","3",9,0,40,0,16,22.5,1,3,0,0,1,4,4,4
"5412",2019-02-06,"Slate River Rd","w1819","Hybrid",3,"Wed","weekday","sled","Slate River Rd","4","4","3",9,0,40,0,16,22.5,1,3,0,0,1,4,4,4
"5413",2019-02-07,"Slate River Rd","w1819","Non.motorized",0,"Thu","weekday","no_sled","Slate River Rd","3","3","2",9.2,0.2,43,3,4,21.4,0,1,3,0,3,4,7,7
"5414",2019-02-07,"Slate River Rd","w1819","Mechanized",0,"Thu","weekday","no_sled","Slate River Rd","3","3","2",9.2,0.2,43,3,4,21.4,0,1,3,0,3,4,7,7
"5415",2019-02-07,"Slate River Rd","w1819","Motorized",0,"Thu","weekday","sled","Slate River Rd","3","3","2",9.2,0.2,43,3,4,21.4,0,1,3,0,3,4,7,7
"5416",2019-02-07,"Slate River Rd","w1819","Hybrid",0,"Thu","weekday","sled","Slate River Rd","3","3","2",9.2,0.2,43,3,4,21.4,0,1,3,0,3,4,7,7
"5417",2019-02-08,"Slate River Rd","w1819","Non.motorized",20,"Fri","weekday","no_sled","Slate River Rd","3","2","2",9.2,0,42,-1,10,21.9,3,0,1,3,2,2,3,6
"5418",2019-02-08,"Slate River Rd","w1819","Mechanized",0,"Fri","weekday","no_sled","Slate River Rd","3","2","2",9.2,0,42,-1,10,21.9,3,0,1,3,2,2,3,6
"5419",2019-02-08,"Slate River Rd","w1819","Motorized",4,"Fri","weekday","sled","Slate River Rd","3","2","2",9.2,0,42,-1,10,21.9,3,0,1,3,2,2,3,6
"5420",2019-02-08,"Slate River Rd","w1819","Hybrid",4,"Fri","weekday","sled","Slate River Rd","3","2","2",9.2,0,42,-1,10,21.9,3,0,1,3,2,2,3,6
"5421",2019-02-09,"Slate River Rd","w1819","Non.motorized",38,"Sat","weekend","no_sled","Slate River Rd","3","2","2",9.2,0,41,-1,20,22.4,-1,3,0,1,-2,1,1,2
"5422",2019-02-09,"Slate River Rd","w1819","Mechanized",0,"Sat","weekend","no_sled","Slate River Rd","3","2","2",9.2,0,41,-1,20,22.4,-1,3,0,1,-2,1,1,2
"5423",2019-02-09,"Slate River Rd","w1819","Motorized",13,"Sat","weekend","sled","Slate River Rd","3","2","2",9.2,0,41,-1,20,22.4,-1,3,0,1,-2,1,1,2
"5424",2019-02-09,"Slate River Rd","w1819","Hybrid",10,"Sat","weekend","sled","Slate River Rd","3","2","2",9.2,0,41,-1,20,22.4,-1,3,0,1,-2,1,1,2
"5425",2019-02-10,"Slate River Rd","w1819","Non.motorized",35,"Sun","weekend","no_sled","Slate River Rd","2","2","2",9.3,0.1,40,-1,20,23.2,-1,-1,3,0,-2,-3,0,0
"5426",2019-02-10,"Slate River Rd","w1819","Mechanized",0,"Sun","weekend","no_sled","Slate River Rd","2","2","2",9.3,0.1,40,-1,20,23.2,-1,-1,3,0,-2,-3,0,0
"5427",2019-02-10,"Slate River Rd","w1819","Motorized",19,"Sun","weekend","sled","Slate River Rd","2","2","2",9.3,0.1,40,-1,20,23.2,-1,-1,3,0,-2,-3,0,0
"5428",2019-02-10,"Slate River Rd","w1819","Hybrid",17,"Sun","weekend","sled","Slate River Rd","2","2","2",9.3,0.1,40,-1,20,23.2,-1,-1,3,0,-2,-3,0,0
"5429",2019-02-11,"Slate River Rd","w1819","Non.motorized",13,"Mon","weekday","no_sled","Slate River Rd","2","2","1",9.3,0,40,0,15,23.2,-1,-1,-1,3,-1,-2,-3,0
"5430",2019-02-11,"Slate River Rd","w1819","Mechanized",1,"Mon","weekday","no_sled","Slate River Rd","2","2","1",9.3,0,40,0,15,23.2,-1,-1,-1,3,-1,-2,-3,0
"5431",2019-02-11,"Slate River Rd","w1819","Motorized",1,"Mon","weekday","sled","Slate River Rd","2","2","1",9.3,0,40,0,15,23.2,-1,-1,-1,3,-1,-2,-3,0
"5432",2019-02-11,"Slate River Rd","w1819","Hybrid",1,"Mon","weekday","sled","Slate River Rd","2","2","1",9.3,0,40,0,15,23.2,-1,-1,-1,3,-1,-2,-3,0
"5433",2019-02-12,"Slate River Rd","w1819","Non.motorized",18,"Tue","weekday","no_sled","Slate River Rd","2","2","1",9.3,0,40,0,18,23.2,0,-1,-1,-1,0,-1,-2,-3
"5434",2019-02-12,"Slate River Rd","w1819","Mechanized",0,"Tue","weekday","no_sled","Slate River Rd","2","2","1",9.3,0,40,0,18,23.2,0,-1,-1,-1,0,-1,-2,-3
"5435",2019-02-12,"Slate River Rd","w1819","Motorized",3,"Tue","weekday","sled","Slate River Rd","2","2","1",9.3,0,40,0,18,23.2,0,-1,-1,-1,0,-1,-2,-3
"5436",2019-02-12,"Slate River Rd","w1819","Hybrid",0,"Tue","weekday","sled","Slate River Rd","2","2","1",9.3,0,40,0,18,23.2,0,-1,-1,-1,0,-1,-2,-3
"5437",2019-02-13,"Slate River Rd","w1819","Non.motorized",21,"Wed","weekday","no_sled","Slate River Rd","2","2","1",9.4,0.1,40,0,26,23.5,0,0,-1,-1,0,0,-1,-2
"5438",2019-02-13,"Slate River Rd","w1819","Mechanized",0,"Wed","weekday","no_sled","Slate River Rd","2","2","1",9.4,0.1,40,0,26,23.5,0,0,-1,-1,0,0,-1,-2
"5439",2019-02-13,"Slate River Rd","w1819","Motorized",8,"Wed","weekday","sled","Slate River Rd","2","2","1",9.4,0.1,40,0,26,23.5,0,0,-1,-1,0,0,-1,-2
"5440",2019-02-13,"Slate River Rd","w1819","Hybrid",0,"Wed","weekday","sled","Slate River Rd","2","2","1",9.4,0.1,40,0,26,23.5,0,0,-1,-1,0,0,-1,-2
"5441",2019-02-14,"Slate River Rd","w1819","Non.motorized",16,"Thu","weekday","no_sled","Slate River Rd","3","2","2",9.7,0.3,41,1,29,23.7,0,0,0,-1,1,1,1,0
"5442",2019-02-14,"Slate River Rd","w1819","Mechanized",0,"Thu","weekday","no_sled","Slate River Rd","3","2","2",9.7,0.3,41,1,29,23.7,0,0,0,-1,1,1,1,0
"5443",2019-02-14,"Slate River Rd","w1819","Motorized",3,"Thu","weekday","sled","Slate River Rd","3","2","2",9.7,0.3,41,1,29,23.7,0,0,0,-1,1,1,1,0
"5444",2019-02-14,"Slate River Rd","w1819","Hybrid",0,"Thu","weekday","sled","Slate River Rd","3","2","2",9.7,0.3,41,1,29,23.7,0,0,0,-1,1,1,1,0
"5445",2019-02-15,"Slate River Rd","w1819","Non.motorized",6,"Fri","weekday","no_sled","Slate River Rd","4","4","3",10.8,1.1,51,10,27,21.2,1,0,0,0,11,11,11,11
"5446",2019-02-15,"Slate River Rd","w1819","Mechanized",0,"Fri","weekday","no_sled","Slate River Rd","4","4","3",10.8,1.1,51,10,27,21.2,1,0,0,0,11,11,11,11
"5447",2019-02-15,"Slate River Rd","w1819","Motorized",0,"Fri","weekday","sled","Slate River Rd","4","4","3",10.8,1.1,51,10,27,21.2,1,0,0,0,11,11,11,11
"5448",2019-02-15,"Slate River Rd","w1819","Hybrid",0,"Fri","weekday","sled","Slate River Rd","4","4","3",10.8,1.1,51,10,27,21.2,1,0,0,0,11,11,11,11
"5449",2019-02-16,"Slate River Rd","w1819","Non.motorized",0,"Sat","weekend","no_sled","Slate River Rd","3","3","3",11.1,0.3,52,1,14,21.3,10,1,0,0,11,12,12,12
"5450",2019-02-16,"Slate River Rd","w1819","Mechanized",0,"Sat","weekend","no_sled","Slate River Rd","3","3","3",11.1,0.3,52,1,14,21.3,10,1,0,0,11,12,12,12
"5451",2019-02-16,"Slate River Rd","w1819","Motorized",0,"Sat","weekend","sled","Slate River Rd","3","3","3",11.1,0.3,52,1,14,21.3,10,1,0,0,11,12,12,12
"5452",2019-02-16,"Slate River Rd","w1819","Hybrid",0,"Sat","weekend","sled","Slate River Rd","3","3","3",11.1,0.3,52,1,14,21.3,10,1,0,0,11,12,12,12
"5453",2019-02-17,"Slate River Rd","w1819","Non.motorized",0,"Sun","weekend","no_sled","Slate River Rd","3","3","3",11.3,0.2,55,3,10,20.5,1,10,1,0,4,14,15,15
"5454",2019-02-17,"Slate River Rd","w1819","Mechanized",0,"Sun","weekend","no_sled","Slate River Rd","3","3","3",11.3,0.2,55,3,10,20.5,1,10,1,0,4,14,15,15
"5455",2019-02-17,"Slate River Rd","w1819","Motorized",0,"Sun","weekend","sled","Slate River Rd","3","3","3",11.3,0.2,55,3,10,20.5,1,10,1,0,4,14,15,15
"5456",2019-02-17,"Slate River Rd","w1819","Hybrid",0,"Sun","weekend","sled","Slate River Rd","3","3","3",11.3,0.2,55,3,10,20.5,1,10,1,0,4,14,15,15
"5457",2019-02-18,"Slate River Rd","w1819","Non.motorized",0,"Mon","weekday","no_sled","Slate River Rd","3","3","2",11.4,0.1,53,-2,13,21.5,3,1,10,1,1,2,12,13
"5458",2019-02-18,"Slate River Rd","w1819","Mechanized",0,"Mon","weekday","no_sled","Slate River Rd","3","3","2",11.4,0.1,53,-2,13,21.5,3,1,10,1,1,2,12,13
"5459",2019-02-18,"Slate River Rd","w1819","Motorized",0,"Mon","weekday","sled","Slate River Rd","3","3","2",11.4,0.1,53,-2,13,21.5,3,1,10,1,1,2,12,13
"5460",2019-02-18,"Slate River Rd","w1819","Hybrid",0,"Mon","weekday","sled","Slate River Rd","3","3","2",11.4,0.1,53,-2,13,21.5,3,1,10,1,1,2,12,13
"5461",2019-02-19,"Slate River Rd","w1819","Non.motorized",0,"Tue","weekday","no_sled","Slate River Rd","3","3","2",11.5,0.1,53,0,11,21.7,-2,3,1,10,-2,1,2,12
"5462",2019-02-19,"Slate River Rd","w1819","Mechanized",0,"Tue","weekday","no_sled","Slate River Rd","3","3","2",11.5,0.1,53,0,11,21.7,-2,3,1,10,-2,1,2,12
"5463",2019-02-19,"Slate River Rd","w1819","Motorized",0,"Tue","weekday","sled","Slate River Rd","3","3","2",11.5,0.1,53,0,11,21.7,-2,3,1,10,-2,1,2,12
"5464",2019-02-19,"Slate River Rd","w1819","Hybrid",0,"Tue","weekday","sled","Slate River Rd","3","3","2",11.5,0.1,53,0,11,21.7,-2,3,1,10,-2,1,2,12
"5465",2019-02-20,"Slate River Rd","w1819","Non.motorized",0,"Wed","weekday","no_sled","Slate River Rd","3","3","2",11.6,0.1,53,0,7,21.9,0,-2,3,1,0,-2,1,2
"5466",2019-02-20,"Slate River Rd","w1819","Mechanized",0,"Wed","weekday","no_sled","Slate River Rd","3","3","2",11.6,0.1,53,0,7,21.9,0,-2,3,1,0,-2,1,2
"5467",2019-02-20,"Slate River Rd","w1819","Motorized",0,"Wed","weekday","sled","Slate River Rd","3","3","2",11.6,0.1,53,0,7,21.9,0,-2,3,1,0,-2,1,2
"5468",2019-02-20,"Slate River Rd","w1819","Hybrid",0,"Wed","weekday","sled","Slate River Rd","3","3","2",11.6,0.1,53,0,7,21.9,0,-2,3,1,0,-2,1,2
"5469",2019-02-21,"Slate River Rd","w1819","Non.motorized",0,"Thu","weekday","no_sled","Slate River Rd","3","3","3",11.6,0,52,-1,15,22.3,0,0,-2,3,-1,-1,-3,0
"5470",2019-02-21,"Slate River Rd","w1819","Mechanized",0,"Thu","weekday","no_sled","Slate River Rd","3","3","3",11.6,0,52,-1,15,22.3,0,0,-2,3,-1,-1,-3,0
"5471",2019-02-21,"Slate River Rd","w1819","Motorized",0,"Thu","weekday","sled","Slate River Rd","3","3","3",11.6,0,52,-1,15,22.3,0,0,-2,3,-1,-1,-3,0
"5472",2019-02-21,"Slate River Rd","w1819","Hybrid",0,"Thu","weekday","sled","Slate River Rd","3","3","3",11.6,0,52,-1,15,22.3,0,0,-2,3,-1,-1,-3,0
"5473",2019-02-22,"Slate River Rd","w1819","Non.motorized",3,"Fri","weekday","no_sled","Slate River Rd","3","3","3",11.8,0.2,52,0,20,22.7,-1,0,0,-2,-1,-1,-1,-3
"5474",2019-02-22,"Slate River Rd","w1819","Mechanized",0,"Fri","weekday","no_sled","Slate River Rd","3","3","3",11.8,0.2,52,0,20,22.7,-1,0,0,-2,-1,-1,-1,-3
"5475",2019-02-22,"Slate River Rd","w1819","Motorized",5,"Fri","weekday","sled","Slate River Rd","3","3","3",11.8,0.2,52,0,20,22.7,-1,0,0,-2,-1,-1,-1,-3
"5476",2019-02-22,"Slate River Rd","w1819","Hybrid",5,"Fri","weekday","sled","Slate River Rd","3","3","3",11.8,0.2,52,0,20,22.7,-1,0,0,-2,-1,-1,-1,-3
"5477",2019-02-23,"Slate River Rd","w1819","Non.motorized",38,"Sat","weekend","no_sled","Slate River Rd","3","3","3",12.1,0.3,53,1,13,22.8,0,-1,0,0,1,0,0,0
"5478",2019-02-23,"Slate River Rd","w1819","Mechanized",3,"Sat","weekend","no_sled","Slate River Rd","3","3","3",12.1,0.3,53,1,13,22.8,0,-1,0,0,1,0,0,0
"5479",2019-02-23,"Slate River Rd","w1819","Motorized",9,"Sat","weekend","sled","Slate River Rd","3","3","3",12.1,0.3,53,1,13,22.8,0,-1,0,0,1,0,0,0
"5480",2019-02-23,"Slate River Rd","w1819","Hybrid",9,"Sat","weekend","sled","Slate River Rd","3","3","3",12.1,0.3,53,1,13,22.8,0,-1,0,0,1,0,0,0
"5481",2019-02-24,"Slate River Rd","w1819","Non.motorized",22,"Sun","weekend","no_sled","Slate River Rd","3","3","2",12.1,0,52,-1,14,23.3,1,0,-1,0,0,0,-1,-1
"5482",2019-02-24,"Slate River Rd","w1819","Mechanized",0,"Sun","weekend","no_sled","Slate River Rd","3","3","2",12.1,0,52,-1,14,23.3,1,0,-1,0,0,0,-1,-1
"5483",2019-02-24,"Slate River Rd","w1819","Motorized",7,"Sun","weekend","sled","Slate River Rd","3","3","2",12.1,0,52,-1,14,23.3,1,0,-1,0,0,0,-1,-1
"5484",2019-02-24,"Slate River Rd","w1819","Hybrid",7,"Sun","weekend","sled","Slate River Rd","3","3","2",12.1,0,52,-1,14,23.3,1,0,-1,0,0,0,-1,-1
"5485",2019-02-25,"Slate River Rd","w1819","Non.motorized",12,"Mon","weekday","no_sled","Slate River Rd","3","3","2",12.1,0,51,-1,22,23.7,-1,1,0,-1,-2,-1,-1,-2
"5486",2019-02-25,"Slate River Rd","w1819","Mechanized",0,"Mon","weekday","no_sled","Slate River Rd","3","3","2",12.1,0,51,-1,22,23.7,-1,1,0,-1,-2,-1,-1,-2
"5487",2019-02-25,"Slate River Rd","w1819","Motorized",0,"Mon","weekday","sled","Slate River Rd","3","3","2",12.1,0,51,-1,22,23.7,-1,1,0,-1,-2,-1,-1,-2
"5488",2019-02-25,"Slate River Rd","w1819","Hybrid",0,"Mon","weekday","sled","Slate River Rd","3","3","2",12.1,0,51,-1,22,23.7,-1,1,0,-1,-2,-1,-1,-2
"5489",2019-02-26,"Slate River Rd","w1819","Non.motorized",30,"Tue","weekday","no_sled","Slate River Rd","2","2","2",12.1,0,50,-1,27,24.2,-1,-1,1,0,-2,-3,-2,-2
"5490",2019-02-26,"Slate River Rd","w1819","Mechanized",0,"Tue","weekday","no_sled","Slate River Rd","2","2","2",12.1,0,50,-1,27,24.2,-1,-1,1,0,-2,-3,-2,-2
"5491",2019-02-26,"Slate River Rd","w1819","Motorized",8,"Tue","weekday","sled","Slate River Rd","2","2","2",12.1,0,50,-1,27,24.2,-1,-1,1,0,-2,-3,-2,-2
"5492",2019-02-26,"Slate River Rd","w1819","Hybrid",7,"Tue","weekday","sled","Slate River Rd","2","2","2",12.1,0,50,-1,27,24.2,-1,-1,1,0,-2,-3,-2,-2
"5493",2019-02-27,"Slate River Rd","w1819","Non.motorized",20,"Wed","weekday","no_sled","Slate River Rd","2","2","2",12.1,0,50,0,30,24.2,-1,-1,-1,1,-1,-2,-3,-2
"5494",2019-02-27,"Slate River Rd","w1819","Mechanized",0,"Wed","weekday","no_sled","Slate River Rd","2","2","2",12.1,0,50,0,30,24.2,-1,-1,-1,1,-1,-2,-3,-2
"5495",2019-02-27,"Slate River Rd","w1819","Motorized",4,"Wed","weekday","sled","Slate River Rd","2","2","2",12.1,0,50,0,30,24.2,-1,-1,-1,1,-1,-2,-3,-2
"5496",2019-02-27,"Slate River Rd","w1819","Hybrid",4,"Wed","weekday","sled","Slate River Rd","2","2","2",12.1,0,50,0,30,24.2,-1,-1,-1,1,-1,-2,-3,-2
"5497",2019-02-28,"Slate River Rd","w1819","Non.motorized",20,"Thu","weekday","no_sled","Slate River Rd","2","2","2",12.2,0.1,49,-1,30,24.9,0,-1,-1,-1,-1,-2,-3,-4
"5498",2019-02-28,"Slate River Rd","w1819","Mechanized",0,"Thu","weekday","no_sled","Slate River Rd","2","2","2",12.2,0.1,49,-1,30,24.9,0,-1,-1,-1,-1,-2,-3,-4
"5499",2019-02-28,"Slate River Rd","w1819","Motorized",2,"Thu","weekday","sled","Slate River Rd","2","2","2",12.2,0.1,49,-1,30,24.9,0,-1,-1,-1,-1,-2,-3,-4
"5500",2019-02-28,"Slate River Rd","w1819","Hybrid",2,"Thu","weekday","sled","Slate River Rd","2","2","2",12.2,0.1,49,-1,30,24.9,0,-1,-1,-1,-1,-2,-3,-4
"5501",2019-03-01,"Slate River Rd","w1819","Non.motorized",13,"Fri","weekday","no_sled","Slate River Rd","2","2","1",12.3,0.1,49,0,29,25.1,-1,0,-1,-1,-1,-1,-2,-3
"5502",2019-03-01,"Slate River Rd","w1819","Mechanized",0,"Fri","weekday","no_sled","Slate River Rd","2","2","1",12.3,0.1,49,0,29,25.1,-1,0,-1,-1,-1,-1,-2,-3
"5503",2019-03-01,"Slate River Rd","w1819","Motorized",1,"Fri","weekday","sled","Slate River Rd","2","2","1",12.3,0.1,49,0,29,25.1,-1,0,-1,-1,-1,-1,-2,-3
"5504",2019-03-01,"Slate River Rd","w1819","Hybrid",0,"Fri","weekday","sled","Slate River Rd","2","2","1",12.3,0.1,49,0,29,25.1,-1,0,-1,-1,-1,-1,-2,-3
"5505",2019-03-02,"Slate River Rd","w1819","Non.motorized",11,"Sat","weekend","no_sled","Slate River Rd","3","3","2",13,0.7,58,9,30,22.4,0,-1,0,-1,9,8,8,7
"5506",2019-03-02,"Slate River Rd","w1819","Mechanized",0,"Sat","weekend","no_sled","Slate River Rd","3","3","2",13,0.7,58,9,30,22.4,0,-1,0,-1,9,8,8,7
"5507",2019-03-02,"Slate River Rd","w1819","Motorized",5,"Sat","weekend","sled","Slate River Rd","3","3","2",13,0.7,58,9,30,22.4,0,-1,0,-1,9,8,8,7
"5508",2019-03-02,"Slate River Rd","w1819","Hybrid",4,"Sat","weekend","sled","Slate River Rd","3","3","2",13,0.7,58,9,30,22.4,0,-1,0,-1,9,8,8,7
"5509",2019-03-03,"Slate River Rd","w1819","Non.motorized",5,"Sun","weekend","no_sled","Slate River Rd","3","3","3",13.7,0.7,64,6,27,21.4,9,0,-1,0,15,15,14,14
"5510",2019-03-03,"Slate River Rd","w1819","Mechanized",0,"Sun","weekend","no_sled","Slate River Rd","3","3","3",13.7,0.7,64,6,27,21.4,9,0,-1,0,15,15,14,14
"5511",2019-03-03,"Slate River Rd","w1819","Motorized",0,"Sun","weekend","sled","Slate River Rd","3","3","3",13.7,0.7,64,6,27,21.4,9,0,-1,0,15,15,14,14
"5512",2019-03-03,"Slate River Rd","w1819","Hybrid",0,"Sun","weekend","sled","Slate River Rd","3","3","3",13.7,0.7,64,6,27,21.4,9,0,-1,0,15,15,14,14
"5513",2019-03-04,"Slate River Rd","w1819","Non.motorized",9,"Mon","weekday","no_sled","Slate River Rd","3","3","3",14.4,0.7,66,2,23,21.8,6,9,0,-1,8,17,17,16
"5514",2019-03-04,"Slate River Rd","w1819","Mechanized",0,"Mon","weekday","no_sled","Slate River Rd","3","3","3",14.4,0.7,66,2,23,21.8,6,9,0,-1,8,17,17,16
"5515",2019-03-04,"Slate River Rd","w1819","Motorized",0,"Mon","weekday","sled","Slate River Rd","3","3","3",14.4,0.7,66,2,23,21.8,6,9,0,-1,8,17,17,16
"5516",2019-03-04,"Slate River Rd","w1819","Hybrid",0,"Mon","weekday","sled","Slate River Rd","3","3","3",14.4,0.7,66,2,23,21.8,6,9,0,-1,8,17,17,16
"5517",2019-03-05,"Slate River Rd","w1819","Non.motorized",4,"Tue","weekday","no_sled","Slate River Rd","3","3","3",14.4,0,64,-2,24,22.5,2,6,9,0,0,6,15,15
"5518",2019-03-05,"Slate River Rd","w1819","Mechanized",0,"Tue","weekday","no_sled","Slate River Rd","3","3","3",14.4,0,64,-2,24,22.5,2,6,9,0,0,6,15,15
"5519",2019-03-05,"Slate River Rd","w1819","Motorized",0,"Tue","weekday","sled","Slate River Rd","3","3","3",14.4,0,64,-2,24,22.5,2,6,9,0,0,6,15,15
"5520",2019-03-05,"Slate River Rd","w1819","Hybrid",0,"Tue","weekday","sled","Slate River Rd","3","3","3",14.4,0,64,-2,24,22.5,2,6,9,0,0,6,15,15
"5521",2019-03-06,"Slate River Rd","w1819","Non.motorized",5,"Wed","weekday","no_sled","Slate River Rd","3","3","2",14.5,0.1,62,-2,31,23.4,-2,2,6,9,-4,-2,4,13
"5522",2019-03-06,"Slate River Rd","w1819","Non.motorized",5,"Wed","weekday","no_sled","Slate River Rd","4","4","3",14.5,0.1,62,-2,31,23.4,-2,2,6,9,-4,-2,4,13
"5523",2019-03-06,"Slate River Rd","w1819","Mechanized",0,"Wed","weekday","no_sled","Slate River Rd","3","3","2",14.5,0.1,62,-2,31,23.4,-2,2,6,9,-4,-2,4,13
"5524",2019-03-06,"Slate River Rd","w1819","Mechanized",0,"Wed","weekday","no_sled","Slate River Rd","4","4","3",14.5,0.1,62,-2,31,23.4,-2,2,6,9,-4,-2,4,13
"5525",2019-03-06,"Slate River Rd","w1819","Motorized",0,"Wed","weekday","sled","Slate River Rd","3","3","2",14.5,0.1,62,-2,31,23.4,-2,2,6,9,-4,-2,4,13
"5526",2019-03-06,"Slate River Rd","w1819","Motorized",0,"Wed","weekday","sled","Slate River Rd","4","4","3",14.5,0.1,62,-2,31,23.4,-2,2,6,9,-4,-2,4,13
"5527",2019-03-06,"Slate River Rd","w1819","Hybrid",0,"Wed","weekday","sled","Slate River Rd","3","3","2",14.5,0.1,62,-2,31,23.4,-2,2,6,9,-4,-2,4,13
"5528",2019-03-06,"Slate River Rd","w1819","Hybrid",0,"Wed","weekday","sled","Slate River Rd","4","4","3",14.5,0.1,62,-2,31,23.4,-2,2,6,9,-4,-2,4,13
"5529",2019-03-07,"Slate River Rd","w1819","Non.motorized",5,"Thu","weekday","no_sled","Slate River Rd","4","4","3",16.2,1.7,71,9,30,22.8,-2,-2,2,6,7,5,7,13
"5530",2019-03-07,"Slate River Rd","w1819","Mechanized",0,"Thu","weekday","no_sled","Slate River Rd","4","4","3",16.2,1.7,71,9,30,22.8,-2,-2,2,6,7,5,7,13
"5531",2019-03-07,"Slate River Rd","w1819","Motorized",0,"Thu","weekday","sled","Slate River Rd","4","4","3",16.2,1.7,71,9,30,22.8,-2,-2,2,6,7,5,7,13
"5532",2019-03-07,"Slate River Rd","w1819","Hybrid",0,"Thu","weekday","sled","Slate River Rd","4","4","3",16.2,1.7,71,9,30,22.8,-2,-2,2,6,7,5,7,13
"5533",2019-03-08,"Slate River Rd","w1819","Non.motorized",3,"Fri","weekday","no_sled","Slate River Rd","3","3","3",16.6,0.4,71,0,27,23.4,9,-2,-2,2,9,7,5,7
"5534",2019-03-08,"Slate River Rd","w1819","Mechanized",0,"Fri","weekday","no_sled","Slate River Rd","3","3","3",16.6,0.4,71,0,27,23.4,9,-2,-2,2,9,7,5,7
"5535",2019-03-08,"Slate River Rd","w1819","Motorized",0,"Fri","weekday","sled","Slate River Rd","3","3","3",16.6,0.4,71,0,27,23.4,9,-2,-2,2,9,7,5,7
"5536",2019-03-08,"Slate River Rd","w1819","Hybrid",0,"Fri","weekday","sled","Slate River Rd","3","3","3",16.6,0.4,71,0,27,23.4,9,-2,-2,2,9,7,5,7
"5537",2019-03-09,"Slate River Rd","w1819","Non.motorized",12,"Sat","weekend","no_sled","Slate River Rd","4","4","3",17.2,0.6,76,5,22,22.6,0,9,-2,-2,5,14,12,10
"5538",2019-03-09,"Slate River Rd","w1819","Mechanized",0,"Sat","weekend","no_sled","Slate River Rd","4","4","3",17.2,0.6,76,5,22,22.6,0,9,-2,-2,5,14,12,10
"5539",2019-03-09,"Slate River Rd","w1819","Motorized",0,"Sat","weekend","sled","Slate River Rd","4","4","3",17.2,0.6,76,5,22,22.6,0,9,-2,-2,5,14,12,10
"5540",2019-03-09,"Slate River Rd","w1819","Hybrid",0,"Sat","weekend","sled","Slate River Rd","4","4","3",17.2,0.6,76,5,22,22.6,0,9,-2,-2,5,14,12,10
"5541",2019-03-10,"Slate River Rd","w1819","Non.motorized",18,"Sun","weekend","no_sled","Slate River Rd","3","3","3",17.3,0.1,73,-3,25,23.7,5,0,9,-2,2,2,11,9
"5542",2019-03-10,"Slate River Rd","w1819","Mechanized",0,"Sun","weekend","no_sled","Slate River Rd","3","3","3",17.3,0.1,73,-3,25,23.7,5,0,9,-2,2,2,11,9
"5543",2019-03-10,"Slate River Rd","w1819","Motorized",0,"Sun","weekend","sled","Slate River Rd","3","3","3",17.3,0.1,73,-3,25,23.7,5,0,9,-2,2,2,11,9
"5544",2019-03-10,"Slate River Rd","w1819","Hybrid",0,"Sun","weekend","sled","Slate River Rd","3","3","3",17.3,0.1,73,-3,25,23.7,5,0,9,-2,2,2,11,9
"5545",2019-03-11,"Slate River Rd","w1819","Non.motorized",6,"Mon","weekday","no_sled","Slate River Rd","3","3","2",17.3,0,71,-2,29,24.4,-3,5,0,9,-5,0,0,9
"5546",2019-03-11,"Slate River Rd","w1819","Mechanized",0,"Mon","weekday","no_sled","Slate River Rd","3","3","2",17.3,0,71,-2,29,24.4,-3,5,0,9,-5,0,0,9
"5547",2019-03-11,"Slate River Rd","w1819","Motorized",0,"Mon","weekday","sled","Slate River Rd","3","3","2",17.3,0,71,-2,29,24.4,-3,5,0,9,-5,0,0,9
"5548",2019-03-11,"Slate River Rd","w1819","Hybrid",0,"Mon","weekday","sled","Slate River Rd","3","3","2",17.3,0,71,-2,29,24.4,-3,5,0,9,-5,0,0,9
"5549",2019-03-12,"Slate River Rd","w1819","Non.motorized",27,"Tue","weekday","no_sled","Slate River Rd","3","3","3",17.4,0.1,70,-1,32,24.9,-2,-3,5,0,-3,-6,-1,-1
"5550",2019-03-12,"Slate River Rd","w1819","Non.motorized",27,"Tue","weekday","no_sled","Slate River Rd","4","4","4",17.4,0.1,70,-1,32,24.9,-2,-3,5,0,-3,-6,-1,-1
"5551",2019-03-12,"Slate River Rd","w1819","Mechanized",0,"Tue","weekday","no_sled","Slate River Rd","3","3","3",17.4,0.1,70,-1,32,24.9,-2,-3,5,0,-3,-6,-1,-1
"5552",2019-03-12,"Slate River Rd","w1819","Mechanized",0,"Tue","weekday","no_sled","Slate River Rd","4","4","4",17.4,0.1,70,-1,32,24.9,-2,-3,5,0,-3,-6,-1,-1
"5553",2019-03-12,"Slate River Rd","w1819","Motorized",3,"Tue","weekday","sled","Slate River Rd","3","3","3",17.4,0.1,70,-1,32,24.9,-2,-3,5,0,-3,-6,-1,-1
"5554",2019-03-12,"Slate River Rd","w1819","Motorized",3,"Tue","weekday","sled","Slate River Rd","4","4","4",17.4,0.1,70,-1,32,24.9,-2,-3,5,0,-3,-6,-1,-1
"5555",2019-03-12,"Slate River Rd","w1819","Hybrid",0,"Tue","weekday","sled","Slate River Rd","3","3","3",17.4,0.1,70,-1,32,24.9,-2,-3,5,0,-3,-6,-1,-1
"5556",2019-03-12,"Slate River Rd","w1819","Hybrid",0,"Tue","weekday","sled","Slate River Rd","4","4","4",17.4,0.1,70,-1,32,24.9,-2,-3,5,0,-3,-6,-1,-1
"5557",2019-03-13,"Slate River Rd","w1819","Non.motorized",0,"Wed","weekday","no_sled","Slate River Rd","4","4","3",18.1,0.7,74,4,24,24.5,-1,-2,-3,5,3,1,-2,3
"5558",2019-03-13,"Slate River Rd","w1819","Mechanized",0,"Wed","weekday","no_sled","Slate River Rd","4","4","3",18.1,0.7,74,4,24,24.5,-1,-2,-3,5,3,1,-2,3
"5559",2019-03-13,"Slate River Rd","w1819","Motorized",0,"Wed","weekday","sled","Slate River Rd","4","4","3",18.1,0.7,74,4,24,24.5,-1,-2,-3,5,3,1,-2,3
"5560",2019-03-13,"Slate River Rd","w1819","Hybrid",0,"Wed","weekday","sled","Slate River Rd","4","4","3",18.1,0.7,74,4,24,24.5,-1,-2,-3,5,3,1,-2,3
"5561",2019-03-14,"Slate River Rd","w1819","Non.motorized",5,"Thu","weekday","no_sled","Slate River Rd","4","4","3",18.1,0,74,0,17,24.5,4,-1,-2,-3,4,3,1,-2
"5562",2019-03-14,"Slate River Rd","w1819","Mechanized",0,"Thu","weekday","no_sled","Slate River Rd","4","4","3",18.1,0,74,0,17,24.5,4,-1,-2,-3,4,3,1,-2
"5563",2019-03-14,"Slate River Rd","w1819","Motorized",0,"Thu","weekday","sled","Slate River Rd","4","4","3",18.1,0,74,0,17,24.5,4,-1,-2,-3,4,3,1,-2
"5564",2019-03-14,"Slate River Rd","w1819","Hybrid",0,"Thu","weekday","sled","Slate River Rd","4","4","3",18.1,0,74,0,17,24.5,4,-1,-2,-3,4,3,1,-2
"5565",2019-03-15,"Slate River Rd","w1819","Non.motorized",7,"Fri","weekday","no_sled","Slate River Rd","3","3","2",18.1,0,72,-2,18,25.1,0,4,-1,-2,-2,2,1,-1
"5566",2019-03-15,"Slate River Rd","w1819","Mechanized",0,"Fri","weekday","no_sled","Slate River Rd","3","3","2",18.1,0,72,-2,18,25.1,0,4,-1,-2,-2,2,1,-1
"5567",2019-03-15,"Slate River Rd","w1819","Motorized",1,"Fri","weekday","sled","Slate River Rd","3","3","2",18.1,0,72,-2,18,25.1,0,4,-1,-2,-2,2,1,-1
"5568",2019-03-15,"Slate River Rd","w1819","Hybrid",0,"Fri","weekday","sled","Slate River Rd","3","3","2",18.1,0,72,-2,18,25.1,0,4,-1,-2,-2,2,1,-1
"5569",2019-03-16,"Slate River Rd","w1819","Non.motorized",33,"Sat","weekend","no_sled","Slate River Rd","3","3","2",18.2,0.1,70,-2,26,26,-2,0,4,-1,-4,-4,0,-1
"5570",2019-03-16,"Slate River Rd","w1819","Mechanized",0,"Sat","weekend","no_sled","Slate River Rd","3","3","2",18.2,0.1,70,-2,26,26,-2,0,4,-1,-4,-4,0,-1
"5571",2019-03-16,"Slate River Rd","w1819","Motorized",12,"Sat","weekend","sled","Slate River Rd","3","3","2",18.2,0.1,70,-2,26,26,-2,0,4,-1,-4,-4,0,-1
"5572",2019-03-16,"Slate River Rd","w1819","Hybrid",0,"Sat","weekend","sled","Slate River Rd","3","3","2",18.2,0.1,70,-2,26,26,-2,0,4,-1,-4,-4,0,-1
"5573",2019-03-17,"Slate River Rd","w1819","Non.motorized",28,"Sun","weekend","no_sled","Slate River Rd","3","3","2",18.2,0,69,-1,28,26.4,-2,-2,0,4,-3,-5,-5,-1
"5574",2019-03-17,"Slate River Rd","w1819","Mechanized",1,"Sun","weekend","no_sled","Slate River Rd","3","3","2",18.2,0,69,-1,28,26.4,-2,-2,0,4,-3,-5,-5,-1
"5575",2019-03-17,"Slate River Rd","w1819","Motorized",6,"Sun","weekend","sled","Slate River Rd","3","3","2",18.2,0,69,-1,28,26.4,-2,-2,0,4,-3,-5,-5,-1
"5576",2019-03-17,"Slate River Rd","w1819","Hybrid",0,"Sun","weekend","sled","Slate River Rd","3","3","2",18.2,0,69,-1,28,26.4,-2,-2,0,4,-3,-5,-5,-1
"5577",2019-03-18,"Slate River Rd","w1819","Non.motorized",17,"Mon","weekday","no_sled","Slate River Rd","2","2","2",18.3,0.1,68,-1,29,26.9,-1,-2,-2,0,-2,-4,-6,-6
"5578",2019-03-18,"Slate River Rd","w1819","Mechanized",0,"Mon","weekday","no_sled","Slate River Rd","2","2","2",18.3,0.1,68,-1,29,26.9,-1,-2,-2,0,-2,-4,-6,-6
"5579",2019-03-18,"Slate River Rd","w1819","Motorized",4,"Mon","weekday","sled","Slate River Rd","2","2","2",18.3,0.1,68,-1,29,26.9,-1,-2,-2,0,-2,-4,-6,-6
"5580",2019-03-18,"Slate River Rd","w1819","Hybrid",0,"Mon","weekday","sled","Slate River Rd","2","2","2",18.3,0.1,68,-1,29,26.9,-1,-2,-2,0,-2,-4,-6,-6
"5581",2019-03-19,"Slate River Rd","w1819","Non.motorized",13,"Tue","weekday","no_sled","Slate River Rd","2","2","2",18.3,0,67,-1,28,27.3,-1,-1,-2,-2,-2,-3,-5,-7
"5582",2019-03-19,"Slate River Rd","w1819","Mechanized",0,"Tue","weekday","no_sled","Slate River Rd","2","2","2",18.3,0,67,-1,28,27.3,-1,-1,-2,-2,-2,-3,-5,-7
"5583",2019-03-19,"Slate River Rd","w1819","Motorized",0,"Tue","weekday","sled","Slate River Rd","2","2","2",18.3,0,67,-1,28,27.3,-1,-1,-2,-2,-2,-3,-5,-7
"5584",2019-03-19,"Slate River Rd","w1819","Hybrid",0,"Tue","weekday","sled","Slate River Rd","2","2","2",18.3,0,67,-1,28,27.3,-1,-1,-2,-2,-2,-3,-5,-7
"5585",2019-03-20,"Slate River Rd","w1819","Non.motorized",27,"Wed","weekday","no_sled","Slate River Rd","2","2","2",18.3,0,66,-1,30,27.7,-1,-1,-1,-2,-2,-3,-4,-6
"5586",2019-03-20,"Slate River Rd","w1819","Mechanized",0,"Wed","weekday","no_sled","Slate River Rd","2","2","2",18.3,0,66,-1,30,27.7,-1,-1,-1,-2,-2,-3,-4,-6
"5587",2019-03-20,"Slate River Rd","w1819","Motorized",1,"Wed","weekday","sled","Slate River Rd","2","2","2",18.3,0,66,-1,30,27.7,-1,-1,-1,-2,-2,-3,-4,-6
"5588",2019-03-20,"Slate River Rd","w1819","Hybrid",0,"Wed","weekday","sled","Slate River Rd","2","2","2",18.3,0,66,-1,30,27.7,-1,-1,-1,-2,-2,-3,-4,-6
"5589",2019-03-21,"Slate River Rd","w1819","Non.motorized",16,"Thu","weekday","no_sled","Slate River Rd","2","2","2",18.4,0.1,65,-1,33,28.3,-1,-1,-1,-1,-2,-3,-4,-5
"5590",2019-03-21,"Slate River Rd","w1819","Mechanized",0,"Thu","weekday","no_sled","Slate River Rd","2","2","2",18.4,0.1,65,-1,33,28.3,-1,-1,-1,-1,-2,-3,-4,-5
"5591",2019-03-21,"Slate River Rd","w1819","Motorized",0,"Thu","weekday","sled","Slate River Rd","2","2","2",18.4,0.1,65,-1,33,28.3,-1,-1,-1,-1,-2,-3,-4,-5
"5592",2019-03-21,"Slate River Rd","w1819","Hybrid",0,"Thu","weekday","sled","Slate River Rd","2","2","2",18.4,0.1,65,-1,33,28.3,-1,-1,-1,-1,-2,-3,-4,-5
"5593",2019-03-22,"Slate River Rd","w1819","Non.motorized",16,"Fri","weekday","no_sled","Slate River Rd","3","3","2",18.4,0,64,-1,28,28.8,-1,-1,-1,-1,-2,-3,-4,-5
"5594",2019-03-22,"Slate River Rd","w1819","Mechanized",0,"Fri","weekday","no_sled","Slate River Rd","3","3","2",18.4,0,64,-1,28,28.8,-1,-1,-1,-1,-2,-3,-4,-5
"5595",2019-03-22,"Slate River Rd","w1819","Motorized",1,"Fri","weekday","sled","Slate River Rd","3","3","2",18.4,0,64,-1,28,28.8,-1,-1,-1,-1,-2,-3,-4,-5
"5596",2019-03-22,"Slate River Rd","w1819","Hybrid",1,"Fri","weekday","sled","Slate River Rd","3","3","2",18.4,0,64,-1,28,28.8,-1,-1,-1,-1,-2,-3,-4,-5
"5597",2019-03-23,"Slate River Rd","w1819","Non.motorized",43,"Sat","weekend","no_sled","Slate River Rd","2","2","1",18.4,0,65,1,28,28.3,-1,-1,-1,-1,0,-1,-2,-3
"5598",2019-03-23,"Slate River Rd","w1819","Mechanized",0,"Sat","weekend","no_sled","Slate River Rd","2","2","1",18.4,0,65,1,28,28.3,-1,-1,-1,-1,0,-1,-2,-3
"5599",2019-03-23,"Slate River Rd","w1819","Motorized",6,"Sat","weekend","sled","Slate River Rd","2","2","1",18.4,0,65,1,28,28.3,-1,-1,-1,-1,0,-1,-2,-3
"5600",2019-03-23,"Slate River Rd","w1819","Hybrid",6,"Sat","weekend","sled","Slate River Rd","2","2","1",18.4,0,65,1,28,28.3,-1,-1,-1,-1,0,-1,-2,-3
"5601",2019-03-24,"Slate River Rd","w1819","Non.motorized",20,"Sun","weekend","no_sled","Slate River Rd","2","2","1",18.4,0,64,-1,29,28.8,1,-1,-1,-1,0,-1,-2,-3
"5602",2019-03-24,"Slate River Rd","w1819","Mechanized",0,"Sun","weekend","no_sled","Slate River Rd","2","2","1",18.4,0,64,-1,29,28.8,1,-1,-1,-1,0,-1,-2,-3
"5603",2019-03-24,"Slate River Rd","w1819","Motorized",7,"Sun","weekend","sled","Slate River Rd","2","2","1",18.4,0,64,-1,29,28.8,1,-1,-1,-1,0,-1,-2,-3
"5604",2019-03-24,"Slate River Rd","w1819","Hybrid",7,"Sun","weekend","sled","Slate River Rd","2","2","1",18.4,0,64,-1,29,28.8,1,-1,-1,-1,0,-1,-2,-3
"5605",2019-03-25,"Slate River Rd","w1819","Non.motorized",28,"Mon","weekday","no_sled","Slate River Rd","2","2","2",18.6,0.2,64,0,31,29.1,-1,1,-1,-1,-1,0,-1,-2
"5606",2019-03-25,"Slate River Rd","w1819","Mechanized",0,"Mon","weekday","no_sled","Slate River Rd","2","2","2",18.6,0.2,64,0,31,29.1,-1,1,-1,-1,-1,0,-1,-2
"5607",2019-03-25,"Slate River Rd","w1819","Motorized",9,"Mon","weekday","sled","Slate River Rd","2","2","2",18.6,0.2,64,0,31,29.1,-1,1,-1,-1,-1,0,-1,-2
"5608",2019-03-25,"Slate River Rd","w1819","Hybrid",7,"Mon","weekday","sled","Slate River Rd","2","2","2",18.6,0.2,64,0,31,29.1,-1,1,-1,-1,-1,0,-1,-2
"5609",2019-03-26,"Slate River Rd","w1819","Non.motorized",38,"Tue","weekday","no_sled","Slate River Rd","2","2","2",18.9,0.3,63,-1,36,30,0,-1,1,-1,-1,-2,-1,-2
"5610",2019-03-26,"Slate River Rd","w1819","Mechanized",0,"Tue","weekday","no_sled","Slate River Rd","2","2","2",18.9,0.3,63,-1,36,30,0,-1,1,-1,-1,-2,-1,-2
"5611",2019-03-26,"Slate River Rd","w1819","Motorized",8,"Tue","weekday","sled","Slate River Rd","2","2","2",18.9,0.3,63,-1,36,30,0,-1,1,-1,-1,-2,-1,-2
"5612",2019-03-26,"Slate River Rd","w1819","Hybrid",0,"Tue","weekday","sled","Slate River Rd","2","2","2",18.9,0.3,63,-1,36,30,0,-1,1,-1,-1,-2,-1,-2
"5613",2019-03-27,"Slate River Rd","w1819","Non.motorized",17,"Wed","weekday","no_sled","Slate River Rd","1","2","2",18.9,0,62,-1,42,30.5,-1,0,-1,1,-2,-2,-3,-2
"5614",2019-03-27,"Slate River Rd","w1819","Mechanized",0,"Wed","weekday","no_sled","Slate River Rd","1","2","2",18.9,0,62,-1,42,30.5,-1,0,-1,1,-2,-2,-3,-2
"5615",2019-03-27,"Slate River Rd","w1819","Motorized",0,"Wed","weekday","sled","Slate River Rd","1","2","2",18.9,0,62,-1,42,30.5,-1,0,-1,1,-2,-2,-3,-2
"5616",2019-03-27,"Slate River Rd","w1819","Hybrid",0,"Wed","weekday","sled","Slate River Rd","1","2","2",18.9,0,62,-1,42,30.5,-1,0,-1,1,-2,-2,-3,-2
"5617",2019-03-28,"Slate River Rd","w1819","Non.motorized",13,"Thu","weekday","no_sled","Slate River Rd","1","2","2",18.9,0,60,-2,40,31.5,-1,-1,0,-1,-3,-4,-4,-5
"5618",2019-03-28,"Slate River Rd","w1819","Mechanized",0,"Thu","weekday","no_sled","Slate River Rd","1","2","2",18.9,0,60,-2,40,31.5,-1,-1,0,-1,-3,-4,-4,-5
"5619",2019-03-28,"Slate River Rd","w1819","Motorized",6,"Thu","weekday","sled","Slate River Rd","1","2","2",18.9,0,60,-2,40,31.5,-1,-1,0,-1,-3,-4,-4,-5
"5620",2019-03-28,"Slate River Rd","w1819","Hybrid",0,"Thu","weekday","sled","Slate River Rd","1","2","2",18.9,0,60,-2,40,31.5,-1,-1,0,-1,-3,-4,-4,-5
"5621",2019-03-29,"Slate River Rd","w1819","Non.motorized",34,"Fri","weekday","no_sled","Slate River Rd","1","1","1",19,0.1,58,-2,26,32.8,-2,-1,-1,0,-4,-5,-6,-6
"5622",2019-03-29,"Slate River Rd","w1819","Mechanized",0,"Fri","weekday","no_sled","Slate River Rd","1","1","1",19,0.1,58,-2,26,32.8,-2,-1,-1,0,-4,-5,-6,-6
"5623",2019-03-29,"Slate River Rd","w1819","Motorized",8,"Fri","weekday","sled","Slate River Rd","1","1","1",19,0.1,58,-2,26,32.8,-2,-1,-1,0,-4,-5,-6,-6
"5624",2019-03-29,"Slate River Rd","w1819","Hybrid",0,"Fri","weekday","sled","Slate River Rd","1","1","1",19,0.1,58,-2,26,32.8,-2,-1,-1,0,-4,-5,-6,-6
"5625",2019-03-30,"Slate River Rd","w1819","Non.motorized",42,"Sat","weekend","no_sled","Slate River Rd","1","1","1",19.1,0.1,61,3,24,31.3,-2,-2,-1,-1,1,-1,-2,-3
"5626",2019-03-30,"Slate River Rd","w1819","Mechanized",0,"Sat","weekend","no_sled","Slate River Rd","1","1","1",19.1,0.1,61,3,24,31.3,-2,-2,-1,-1,1,-1,-2,-3
"5627",2019-03-30,"Slate River Rd","w1819","Motorized",18,"Sat","weekend","sled","Slate River Rd","1","1","1",19.1,0.1,61,3,24,31.3,-2,-2,-1,-1,1,-1,-2,-3
"5628",2019-03-30,"Slate River Rd","w1819","Hybrid",17,"Sat","weekend","sled","Slate River Rd","1","1","1",19.1,0.1,61,3,24,31.3,-2,-2,-1,-1,1,-1,-2,-3
"5629",2019-03-31,"Slate River Rd","w1819","Non.motorized",25,"Sun","weekend","no_sled","Slate River Rd","1","1","1",19.1,0,59,-2,24,32.4,3,-2,-2,-1,1,-1,-3,-4
"5630",2019-03-31,"Slate River Rd","w1819","Mechanized",2,"Sun","weekend","no_sled","Slate River Rd","1","1","1",19.1,0,59,-2,24,32.4,3,-2,-2,-1,1,-1,-3,-4
"5631",2019-03-31,"Slate River Rd","w1819","Motorized",4,"Sun","weekend","sled","Slate River Rd","1","1","1",19.1,0,59,-2,24,32.4,3,-2,-2,-1,1,-1,-3,-4
"5632",2019-03-31,"Slate River Rd","w1819","Hybrid",4,"Sun","weekend","sled","Slate River Rd","1","1","1",19.1,0,59,-2,24,32.4,3,-2,-2,-1,1,-1,-3,-4
"5633",2019-04-01,"Slate River Rd","w1819","Non.motorized",15,"Mon","weekday","no_sled","Slate River Rd","2","1","1",19.1,0,58,-1,29,32.9,-2,3,-2,-2,-3,0,-2,-4
"5634",2019-04-01,"Slate River Rd","w1819","Mechanized",0,"Mon","weekday","no_sled","Slate River Rd","2","1","1",19.1,0,58,-1,29,32.9,-2,3,-2,-2,-3,0,-2,-4
"5635",2019-04-01,"Slate River Rd","w1819","Motorized",10,"Mon","weekday","sled","Slate River Rd","2","1","1",19.1,0,58,-1,29,32.9,-2,3,-2,-2,-3,0,-2,-4
"5636",2019-04-01,"Slate River Rd","w1819","Hybrid",10,"Mon","weekday","sled","Slate River Rd","2","1","1",19.1,0,58,-1,29,32.9,-2,3,-2,-2,-3,0,-2,-4
"5637",2019-04-02,"Slate River Rd","w1819","Non.motorized",10,"Tue","weekday","no_sled","Slate River Rd","1","1","1",19.1,0,58,0,33,32.9,-1,-2,3,-2,-1,-3,0,-2
"5638",2019-04-02,"Slate River Rd","w1819","Mechanized",0,"Tue","weekday","no_sled","Slate River Rd","1","1","1",19.1,0,58,0,33,32.9,-1,-2,3,-2,-1,-3,0,-2
"5639",2019-04-02,"Slate River Rd","w1819","Motorized",0,"Tue","weekday","sled","Slate River Rd","1","1","1",19.1,0,58,0,33,32.9,-1,-2,3,-2,-1,-3,0,-2
"5640",2019-04-02,"Slate River Rd","w1819","Hybrid",0,"Tue","weekday","sled","Slate River Rd","1","1","1",19.1,0,58,0,33,32.9,-1,-2,3,-2,-1,-3,0,-2
"5641",2019-04-03,"Slate River Rd","w1819","Non.motorized",12,"Wed","weekday","no_sled","Slate River Rd","2","1","1",19.2,0.1,58,0,31,33.1,0,-1,-2,3,0,-1,-3,0
"5642",2019-04-03,"Slate River Rd","w1819","Mechanized",0,"Wed","weekday","no_sled","Slate River Rd","2","1","1",19.2,0.1,58,0,31,33.1,0,-1,-2,3,0,-1,-3,0
"5643",2019-04-03,"Slate River Rd","w1819","Motorized",1,"Wed","weekday","sled","Slate River Rd","2","1","1",19.2,0.1,58,0,31,33.1,0,-1,-2,3,0,-1,-3,0
"5644",2019-04-03,"Slate River Rd","w1819","Hybrid",0,"Wed","weekday","sled","Slate River Rd","2","1","1",19.2,0.1,58,0,31,33.1,0,-1,-2,3,0,-1,-3,0
"5645",2019-04-04,"Slate River Rd","w1819","Non.motorized",27,"Thu","weekday","no_sled","Slate River Rd","2","1","1",19.4,0.2,59,1,35,32.9,0,0,-1,-2,1,1,0,-2
"5646",2019-04-04,"Slate River Rd","w1819","Mechanized",0,"Thu","weekday","no_sled","Slate River Rd","2","1","1",19.4,0.2,59,1,35,32.9,0,0,-1,-2,1,1,0,-2
"5647",2019-04-04,"Slate River Rd","w1819","Motorized",5,"Thu","weekday","sled","Slate River Rd","2","1","1",19.4,0.2,59,1,35,32.9,0,0,-1,-2,1,1,0,-2
"5648",2019-04-04,"Slate River Rd","w1819","Hybrid",4,"Thu","weekday","sled","Slate River Rd","2","1","1",19.4,0.2,59,1,35,32.9,0,0,-1,-2,1,1,0,-2
"5649",2019-04-05,"Slate River Rd","w1819","Non.motorized",20,"Fri","weekday","no_sled","Slate River Rd","1","1","1",19.4,0,57,-2,38,34,1,0,0,-1,-1,-1,-1,-2
"5650",2019-04-05,"Slate River Rd","w1819","Mechanized",0,"Fri","weekday","no_sled","Slate River Rd","1","1","1",19.4,0,57,-2,38,34,1,0,0,-1,-1,-1,-1,-2
"5651",2019-04-05,"Slate River Rd","w1819","Motorized",1,"Fri","weekday","sled","Slate River Rd","1","1","1",19.4,0,57,-2,38,34,1,0,0,-1,-1,-1,-1,-2
"5652",2019-04-05,"Slate River Rd","w1819","Hybrid",1,"Fri","weekday","sled","Slate River Rd","1","1","1",19.4,0,57,-2,38,34,1,0,0,-1,-1,-1,-1,-2
"5653",2019-04-06,"Slate River Rd","w1819","Non.motorized",17,"Sat","weekend","no_sled","Slate River Rd","1","1","1",19.3,-0.1,57,0,35,33.9,-2,1,0,0,-2,-1,-1,-1
"5654",2019-04-06,"Slate River Rd","w1819","Mechanized",1,"Sat","weekend","no_sled","Slate River Rd","1","1","1",19.3,-0.1,57,0,35,33.9,-2,1,0,0,-2,-1,-1,-1
"5655",2019-04-06,"Slate River Rd","w1819","Motorized",6,"Sat","weekend","sled","Slate River Rd","1","1","1",19.3,-0.1,57,0,35,33.9,-2,1,0,0,-2,-1,-1,-1
"5656",2019-04-06,"Slate River Rd","w1819","Hybrid",4,"Sat","weekend","sled","Slate River Rd","1","1","1",19.3,-0.1,57,0,35,33.9,-2,1,0,0,-2,-1,-1,-1
"5657",2019-04-07,"Slate River Rd","w1819","Non.motorized",21,"Sun","weekend","no_sled","Slate River Rd","1","1","1",19.1,-0.2,57,0,37,33.5,0,-2,1,0,0,-2,-1,-1
"5658",2019-04-07,"Slate River Rd","w1819","Mechanized",0,"Sun","weekend","no_sled","Slate River Rd","1","1","1",19.1,-0.2,57,0,37,33.5,0,-2,1,0,0,-2,-1,-1
"5659",2019-04-07,"Slate River Rd","w1819","Motorized",15,"Sun","weekend","sled","Slate River Rd","1","1","1",19.1,-0.2,57,0,37,33.5,0,-2,1,0,0,-2,-1,-1
"5660",2019-04-07,"Slate River Rd","w1819","Hybrid",7,"Sun","weekend","sled","Slate River Rd","1","1","1",19.1,-0.2,57,0,37,33.5,0,-2,1,0,0,-2,-1,-1
"5661",2019-04-08,"Slate River Rd","w1819","Non.motorized",7,"Mon","weekday","no_sled","Slate River Rd","1","2","2",19.3,0.2,54,-3,41,35.7,0,0,-2,1,-3,-3,-5,-4
"5662",2019-04-08,"Slate River Rd","w1819","Mechanized",0,"Mon","weekday","no_sled","Slate River Rd","1","2","2",19.3,0.2,54,-3,41,35.7,0,0,-2,1,-3,-3,-5,-4
"5663",2019-04-08,"Slate River Rd","w1819","Motorized",3,"Mon","weekday","sled","Slate River Rd","1","2","2",19.3,0.2,54,-3,41,35.7,0,0,-2,1,-3,-3,-5,-4
"5664",2019-04-08,"Slate River Rd","w1819","Hybrid",3,"Mon","weekday","sled","Slate River Rd","1","2","2",19.3,0.2,54,-3,41,35.7,0,0,-2,1,-3,-3,-5,-4
"5665",2019-04-09,"Slate River Rd","w1819","Non.motorized",9,"Tue","weekday","no_sled","Slate River Rd","1","2","2",19.3,0,53,-1,43,36.4,-3,0,0,-2,-4,-4,-4,-6
"5666",2019-04-09,"Slate River Rd","w1819","Mechanized",0,"Tue","weekday","no_sled","Slate River Rd","1","2","2",19.3,0,53,-1,43,36.4,-3,0,0,-2,-4,-4,-4,-6
"5667",2019-04-09,"Slate River Rd","w1819","Motorized",5,"Tue","weekday","sled","Slate River Rd","1","2","2",19.3,0,53,-1,43,36.4,-3,0,0,-2,-4,-4,-4,-6
"5668",2019-04-09,"Slate River Rd","w1819","Hybrid",2,"Tue","weekday","sled","Slate River Rd","1","2","2",19.3,0,53,-1,43,36.4,-3,0,0,-2,-4,-4,-4,-6
"5669",2019-04-10,"Slate River Rd","w1819","Non.motorized",9,"Wed","weekday","no_sled","Slate River Rd","2","2","1",19,-0.3,51,-2,30,37.3,-1,-3,0,0,-3,-6,-6,-6
"5670",2019-04-10,"Slate River Rd","w1819","Mechanized",0,"Wed","weekday","no_sled","Slate River Rd","2","2","1",19,-0.3,51,-2,30,37.3,-1,-3,0,0,-3,-6,-6,-6
"5671",2019-04-10,"Slate River Rd","w1819","Motorized",2,"Wed","weekday","sled","Slate River Rd","2","2","1",19,-0.3,51,-2,30,37.3,-1,-3,0,0,-3,-6,-6,-6
"5672",2019-04-10,"Slate River Rd","w1819","Hybrid",2,"Wed","weekday","sled","Slate River Rd","2","2","1",19,-0.3,51,-2,30,37.3,-1,-3,0,0,-3,-6,-6,-6
"5673",2019-04-11,"Slate River Rd","w1819","Non.motorized",5,"Thu","weekday","no_sled","Slate River Rd","3","3","2",18.9,-0.1,53,2,20,35.7,-2,-1,-3,0,0,-1,-4,-4
"5674",2019-04-11,"Slate River Rd","w1819","Mechanized",0,"Thu","weekday","no_sled","Slate River Rd","3","3","2",18.9,-0.1,53,2,20,35.7,-2,-1,-3,0,0,-1,-4,-4
"5675",2019-04-11,"Slate River Rd","w1819","Motorized",2,"Thu","weekday","sled","Slate River Rd","3","3","2",18.9,-0.1,53,2,20,35.7,-2,-1,-3,0,0,-1,-4,-4
"5676",2019-04-11,"Slate River Rd","w1819","Hybrid",1,"Thu","weekday","sled","Slate River Rd","3","3","2",18.9,-0.1,53,2,20,35.7,-2,-1,-3,0,0,-1,-4,-4
"5677",2019-04-12,"Slate River Rd","w1819","Non.motorized",13,"Fri","weekday","no_sled","Slate River Rd","2","2","1",18.7,-0.2,53,0,24,35.3,2,-2,-1,-3,2,0,-1,-4
"5678",2019-04-12,"Slate River Rd","w1819","Mechanized",1,"Fri","weekday","no_sled","Slate River Rd","2","2","1",18.7,-0.2,53,0,24,35.3,2,-2,-1,-3,2,0,-1,-4
"5679",2019-04-12,"Slate River Rd","w1819","Motorized",6,"Fri","weekday","sled","Slate River Rd","2","2","1",18.7,-0.2,53,0,24,35.3,2,-2,-1,-3,2,0,-1,-4
"5680",2019-04-12,"Slate River Rd","w1819","Hybrid",4,"Fri","weekday","sled","Slate River Rd","2","2","1",18.7,-0.2,53,0,24,35.3,2,-2,-1,-3,2,0,-1,-4
"5681",2019-04-13,"Slate River Rd","w1819","Non.motorized",17,"Sat","weekend","no_sled","Slate River Rd","1","1","1",18.8,0.1,52,-1,27,36.2,0,2,-2,-1,-1,1,-1,-2
"5682",2019-04-13,"Slate River Rd","w1819","Mechanized",0,"Sat","weekend","no_sled","Slate River Rd","1","1","1",18.8,0.1,52,-1,27,36.2,0,2,-2,-1,-1,1,-1,-2
"5683",2019-04-13,"Slate River Rd","w1819","Motorized",9,"Sat","weekend","sled","Slate River Rd","1","1","1",18.8,0.1,52,-1,27,36.2,0,2,-2,-1,-1,1,-1,-2
"5684",2019-04-13,"Slate River Rd","w1819","Hybrid",8,"Sat","weekend","sled","Slate River Rd","1","1","1",18.8,0.1,52,-1,27,36.2,0,2,-2,-1,-1,1,-1,-2
"5685",2019-04-14,"Slate River Rd","w1819","Non.motorized",9,"Sun","weekend","no_sled","Slate River Rd","1","1","1",18.7,-0.1,51,-1,35,36.7,-1,0,2,-2,-2,-2,0,-2
"5686",2019-04-14,"Slate River Rd","w1819","Mechanized",0,"Sun","weekend","no_sled","Slate River Rd","1","1","1",18.7,-0.1,51,-1,35,36.7,-1,0,2,-2,-2,-2,0,-2
"5687",2019-04-14,"Slate River Rd","w1819","Motorized",5,"Sun","weekend","sled","Slate River Rd","1","1","1",18.7,-0.1,51,-1,35,36.7,-1,0,2,-2,-2,-2,0,-2
"5688",2019-04-14,"Slate River Rd","w1819","Hybrid",5,"Sun","weekend","sled","Slate River Rd","1","1","1",18.7,-0.1,51,-1,35,36.7,-1,0,2,-2,-2,-2,0,-2
"5689",2019-04-15,"Slate River Rd","w1819","Non.motorized",4,"Mon","weekday","no_sled","Slate River Rd",NA,NA,NA,18.6,-0.1,50,-1,41,37.2,-1,-1,0,2,-2,-3,-3,-1
"5690",2019-04-15,"Slate River Rd","w1819","Mechanized",0,"Mon","weekday","no_sled","Slate River Rd",NA,NA,NA,18.6,-0.1,50,-1,41,37.2,-1,-1,0,2,-2,-3,-3,-1
"5691",2019-04-15,"Slate River Rd","w1819","Motorized",4,"Mon","weekday","sled","Slate River Rd",NA,NA,NA,18.6,-0.1,50,-1,41,37.2,-1,-1,0,2,-2,-3,-3,-1
"5692",2019-04-15,"Slate River Rd","w1819","Hybrid",4,"Mon","weekday","sled","Slate River Rd",NA,NA,NA,18.6,-0.1,50,-1,41,37.2,-1,-1,0,2,-2,-3,-3,-1
"5693",2018-12-01,"Snodgrass","w1819","Non.motorized",81,"Sat","weekend","no_sled","East River","3","3","2",3.3,0.2,19,1,16,17.4,0,0,0,0,1,1,1,1
"5694",2018-12-01,"Snodgrass","w1819","Mechanized",0,"Sat","weekend","no_sled","East River","3","3","2",3.3,0.2,19,1,16,17.4,0,0,0,0,1,1,1,1
"5695",2018-12-01,"Snodgrass","w1819","Motorized",0,"Sat","weekend","sled","East River","3","3","2",3.3,0.2,19,1,16,17.4,0,0,0,0,1,1,1,1
"5696",2018-12-01,"Snodgrass","w1819","Hybrid",0,"Sat","weekend","sled","East River","3","3","2",3.3,0.2,19,1,16,17.4,0,0,0,0,1,1,1,1
"5697",2018-12-02,"Snodgrass","w1819","Non.motorized",0,"Sun","weekend","no_sled","East River","3","3","3",3.3,0,20,1,14,16.5,1,0,0,0,2,2,2,2
"5698",2018-12-02,"Snodgrass","w1819","Mechanized",0,"Sun","weekend","no_sled","East River","3","3","3",3.3,0,20,1,14,16.5,1,0,0,0,2,2,2,2
"5699",2018-12-02,"Snodgrass","w1819","Motorized",0,"Sun","weekend","sled","East River","3","3","3",3.3,0,20,1,14,16.5,1,0,0,0,2,2,2,2
"5700",2018-12-02,"Snodgrass","w1819","Hybrid",0,"Sun","weekend","sled","East River","3","3","3",3.3,0,20,1,14,16.5,1,0,0,0,2,2,2,2
"5701",2018-12-03,"Snodgrass","w1819","Non.motorized",0,"Mon","weekday","no_sled","East River","3","3","2",3.4,0.1,19,-1,13,17.9,1,1,0,0,0,1,1,1
"5702",2018-12-03,"Snodgrass","w1819","Mechanized",0,"Mon","weekday","no_sled","East River","3","3","2",3.4,0.1,19,-1,13,17.9,1,1,0,0,0,1,1,1
"5703",2018-12-03,"Snodgrass","w1819","Motorized",0,"Mon","weekday","sled","East River","3","3","2",3.4,0.1,19,-1,13,17.9,1,1,0,0,0,1,1,1
"5704",2018-12-03,"Snodgrass","w1819","Hybrid",0,"Mon","weekday","sled","East River","3","3","2",3.4,0.1,19,-1,13,17.9,1,1,0,0,0,1,1,1
"5705",2018-12-04,"Snodgrass","w1819","Non.motorized",0,"Tue","weekday","no_sled","East River","3","3","2",3.5,0.1,20,1,8,17.5,-1,1,1,0,0,1,2,2
"5706",2018-12-04,"Snodgrass","w1819","Mechanized",0,"Tue","weekday","no_sled","East River","3","3","2",3.5,0.1,20,1,8,17.5,-1,1,1,0,0,1,2,2
"5707",2018-12-04,"Snodgrass","w1819","Motorized",0,"Tue","weekday","sled","East River","3","3","2",3.5,0.1,20,1,8,17.5,-1,1,1,0,0,1,2,2
"5708",2018-12-04,"Snodgrass","w1819","Hybrid",0,"Tue","weekday","sled","East River","3","3","2",3.5,0.1,20,1,8,17.5,-1,1,1,0,0,1,2,2
"5709",2018-12-05,"Snodgrass","w1819","Non.motorized",0,"Wed","weekday","no_sled","East River","3","3","2",3.5,0,19,-1,21,18.4,1,-1,1,1,0,-1,0,1
"5710",2018-12-05,"Snodgrass","w1819","Mechanized",0,"Wed","weekday","no_sled","East River","3","3","2",3.5,0,19,-1,21,18.4,1,-1,1,1,0,-1,0,1
"5711",2018-12-05,"Snodgrass","w1819","Motorized",0,"Wed","weekday","sled","East River","3","3","2",3.5,0,19,-1,21,18.4,1,-1,1,1,0,-1,0,1
"5712",2018-12-05,"Snodgrass","w1819","Hybrid",0,"Wed","weekday","sled","East River","3","3","2",3.5,0,19,-1,21,18.4,1,-1,1,1,0,-1,0,1
"5713",2018-12-06,"Snodgrass","w1819","Non.motorized",0,"Thu","weekday","no_sled","East River","2","2","2",3.7,0.2,18,-1,25,20.6,-1,1,-1,1,-2,-1,-2,-1
"5714",2018-12-06,"Snodgrass","w1819","Mechanized",0,"Thu","weekday","no_sled","East River","2","2","2",3.7,0.2,18,-1,25,20.6,-1,1,-1,1,-2,-1,-2,-1
"5715",2018-12-06,"Snodgrass","w1819","Motorized",0,"Thu","weekday","sled","East River","2","2","2",3.7,0.2,18,-1,25,20.6,-1,1,-1,1,-2,-1,-2,-1
"5716",2018-12-06,"Snodgrass","w1819","Hybrid",0,"Thu","weekday","sled","East River","2","2","2",3.7,0.2,18,-1,25,20.6,-1,1,-1,1,-2,-1,-2,-1
"5717",2018-12-07,"Snodgrass","w1819","Non.motorized",0,"Fri","weekday","no_sled","East River","2","2","2",3.8,0.1,21,3,23,18.1,-1,-1,1,-1,2,1,2,1
"5718",2018-12-07,"Snodgrass","w1819","Mechanized",0,"Fri","weekday","no_sled","East River","2","2","2",3.8,0.1,21,3,23,18.1,-1,-1,1,-1,2,1,2,1
"5719",2018-12-07,"Snodgrass","w1819","Motorized",0,"Fri","weekday","sled","East River","2","2","2",3.8,0.1,21,3,23,18.1,-1,-1,1,-1,2,1,2,1
"5720",2018-12-07,"Snodgrass","w1819","Hybrid",0,"Fri","weekday","sled","East River","2","2","2",3.8,0.1,21,3,23,18.1,-1,-1,1,-1,2,1,2,1
"5721",2018-12-08,"Snodgrass","w1819","Non.motorized",0,"Sat","weekend","no_sled","East River","2","2","2",3.8,0,20,-1,23,19,3,-1,-1,1,2,1,0,1
"5722",2018-12-08,"Snodgrass","w1819","Mechanized",0,"Sat","weekend","no_sled","East River","2","2","2",3.8,0,20,-1,23,19,3,-1,-1,1,2,1,0,1
"5723",2018-12-08,"Snodgrass","w1819","Motorized",0,"Sat","weekend","sled","East River","2","2","2",3.8,0,20,-1,23,19,3,-1,-1,1,2,1,0,1
"5724",2018-12-08,"Snodgrass","w1819","Hybrid",0,"Sat","weekend","sled","East River","2","2","2",3.8,0,20,-1,23,19,3,-1,-1,1,2,1,0,1
"5725",2018-12-09,"Snodgrass","w1819","Non.motorized",0,"Sun","weekend","no_sled","East River","2","2","2",3.8,0,20,0,19,19,-1,3,-1,-1,-1,2,1,0
"5726",2018-12-09,"Snodgrass","w1819","Mechanized",0,"Sun","weekend","no_sled","East River","2","2","2",3.8,0,20,0,19,19,-1,3,-1,-1,-1,2,1,0
"5727",2018-12-09,"Snodgrass","w1819","Motorized",0,"Sun","weekend","sled","East River","2","2","2",3.8,0,20,0,19,19,-1,3,-1,-1,-1,2,1,0
"5728",2018-12-09,"Snodgrass","w1819","Hybrid",0,"Sun","weekend","sled","East River","2","2","2",3.8,0,20,0,19,19,-1,3,-1,-1,-1,2,1,0
"5729",2018-12-10,"Snodgrass","w1819","Non.motorized",0,"Mon","weekday","no_sled","East River","2","2","2",3.8,0,20,0,21,19,0,-1,3,-1,0,-1,2,1
"5730",2018-12-10,"Snodgrass","w1819","Mechanized",0,"Mon","weekday","no_sled","East River","2","2","2",3.8,0,20,0,21,19,0,-1,3,-1,0,-1,2,1
"5731",2018-12-10,"Snodgrass","w1819","Motorized",0,"Mon","weekday","sled","East River","2","2","2",3.8,0,20,0,21,19,0,-1,3,-1,0,-1,2,1
"5732",2018-12-10,"Snodgrass","w1819","Hybrid",0,"Mon","weekday","sled","East River","2","2","2",3.8,0,20,0,21,19,0,-1,3,-1,0,-1,2,1
"5733",2018-12-11,"Snodgrass","w1819","Non.motorized",0,"Tue","weekday","no_sled","East River","2","2","2",3.9,0.1,19,-1,27,20.5,0,0,-1,3,-1,-1,-2,1
"5734",2018-12-11,"Snodgrass","w1819","Mechanized",0,"Tue","weekday","no_sled","East River","2","2","2",3.9,0.1,19,-1,27,20.5,0,0,-1,3,-1,-1,-2,1
"5735",2018-12-11,"Snodgrass","w1819","Motorized",0,"Tue","weekday","sled","East River","2","2","2",3.9,0.1,19,-1,27,20.5,0,0,-1,3,-1,-1,-2,1
"5736",2018-12-11,"Snodgrass","w1819","Hybrid",0,"Tue","weekday","sled","East River","2","2","2",3.9,0.1,19,-1,27,20.5,0,0,-1,3,-1,-1,-2,1
"5737",2018-12-12,"Snodgrass","w1819","Non.motorized",0,"Wed","weekday","no_sled","East River","2","2","1",3.9,0,19,0,21,20.5,-1,0,0,-1,-1,-1,-1,-2
"5738",2018-12-12,"Snodgrass","w1819","Mechanized",0,"Wed","weekday","no_sled","East River","2","2","1",3.9,0,19,0,21,20.5,-1,0,0,-1,-1,-1,-1,-2
"5739",2018-12-12,"Snodgrass","w1819","Motorized",0,"Wed","weekday","sled","East River","2","2","1",3.9,0,19,0,21,20.5,-1,0,0,-1,-1,-1,-1,-2
"5740",2018-12-12,"Snodgrass","w1819","Hybrid",0,"Wed","weekday","sled","East River","2","2","1",3.9,0,19,0,21,20.5,-1,0,0,-1,-1,-1,-1,-2
"5741",2018-12-13,"Snodgrass","w1819","Non.motorized",0,"Thu","weekday","no_sled","East River","3","3","2",4,0.1,21,2,15,19,0,-1,0,0,2,1,1,1
"5742",2018-12-13,"Snodgrass","w1819","Mechanized",0,"Thu","weekday","no_sled","East River","3","3","2",4,0.1,21,2,15,19,0,-1,0,0,2,1,1,1
"5743",2018-12-13,"Snodgrass","w1819","Motorized",0,"Thu","weekday","sled","East River","3","3","2",4,0.1,21,2,15,19,0,-1,0,0,2,1,1,1
"5744",2018-12-13,"Snodgrass","w1819","Hybrid",0,"Thu","weekday","sled","East River","3","3","2",4,0.1,21,2,15,19,0,-1,0,0,2,1,1,1
"5745",2018-12-14,"Snodgrass","w1819","Non.motorized",0,"Fri","weekday","no_sled","East River","3","3","2",4,0,20,-1,24,20,2,0,-1,0,1,1,0,0
"5746",2018-12-14,"Snodgrass","w1819","Mechanized",0,"Fri","weekday","no_sled","East River","3","3","2",4,0,20,-1,24,20,2,0,-1,0,1,1,0,0
"5747",2018-12-14,"Snodgrass","w1819","Motorized",0,"Fri","weekday","sled","East River","3","3","2",4,0,20,-1,24,20,2,0,-1,0,1,1,0,0
"5748",2018-12-14,"Snodgrass","w1819","Hybrid",0,"Fri","weekday","sled","East River","3","3","2",4,0,20,-1,24,20,2,0,-1,0,1,1,0,0
"5749",2018-12-15,"Snodgrass","w1819","Non.motorized",0,"Sat","weekend","no_sled","East River","2","2","2",4,0,20,0,29,20,-1,2,0,-1,-1,1,1,0
"5750",2018-12-15,"Snodgrass","w1819","Mechanized",0,"Sat","weekend","no_sled","East River","2","2","2",4,0,20,0,29,20,-1,2,0,-1,-1,1,1,0
"5751",2018-12-15,"Snodgrass","w1819","Motorized",0,"Sat","weekend","sled","East River","2","2","2",4,0,20,0,29,20,-1,2,0,-1,-1,1,1,0
"5752",2018-12-15,"Snodgrass","w1819","Hybrid",0,"Sat","weekend","sled","East River","2","2","2",4,0,20,0,29,20,-1,2,0,-1,-1,1,1,0
"5753",2018-12-16,"Snodgrass","w1819","Non.motorized",0,"Sun","weekend","no_sled","East River","2","2","2",4.1,0.1,19,-1,28,21.6,0,-1,2,0,-1,-2,0,0
"5754",2018-12-16,"Snodgrass","w1819","Mechanized",0,"Sun","weekend","no_sled","East River","2","2","2",4.1,0.1,19,-1,28,21.6,0,-1,2,0,-1,-2,0,0
"5755",2018-12-16,"Snodgrass","w1819","Motorized",0,"Sun","weekend","sled","East River","2","2","2",4.1,0.1,19,-1,28,21.6,0,-1,2,0,-1,-2,0,0
"5756",2018-12-16,"Snodgrass","w1819","Hybrid",0,"Sun","weekend","sled","East River","2","2","2",4.1,0.1,19,-1,28,21.6,0,-1,2,0,-1,-2,0,0
"5757",2018-12-17,"Snodgrass","w1819","Non.motorized",0,"Mon","weekday","no_sled","East River","2","2","2",4.1,0,19,0,29,21.6,-1,0,-1,2,-1,-1,-2,0
"5758",2018-12-17,"Snodgrass","w1819","Mechanized",0,"Mon","weekday","no_sled","East River","2","2","2",4.1,0,19,0,29,21.6,-1,0,-1,2,-1,-1,-2,0
"5759",2018-12-17,"Snodgrass","w1819","Motorized",0,"Mon","weekday","sled","East River","2","2","2",4.1,0,19,0,29,21.6,-1,0,-1,2,-1,-1,-2,0
"5760",2018-12-17,"Snodgrass","w1819","Hybrid",0,"Mon","weekday","sled","East River","2","2","2",4.1,0,19,0,29,21.6,-1,0,-1,2,-1,-1,-2,0
"5761",2018-12-18,"Snodgrass","w1819","Non.motorized",0,"Tue","weekday","no_sled","East River","2","2","2",4.1,0,19,0,27,21.6,0,-1,0,-1,0,-1,-1,-2
"5762",2018-12-18,"Snodgrass","w1819","Mechanized",0,"Tue","weekday","no_sled","East River","2","2","2",4.1,0,19,0,27,21.6,0,-1,0,-1,0,-1,-1,-2
"5763",2018-12-18,"Snodgrass","w1819","Motorized",0,"Tue","weekday","sled","East River","2","2","2",4.1,0,19,0,27,21.6,0,-1,0,-1,0,-1,-1,-2
"5764",2018-12-18,"Snodgrass","w1819","Hybrid",0,"Tue","weekday","sled","East River","2","2","2",4.1,0,19,0,27,21.6,0,-1,0,-1,0,-1,-1,-2
"5765",2018-12-19,"Snodgrass","w1819","Non.motorized",0,"Wed","weekday","no_sled","East River","2","2","2",4.1,0,19,0,24,21.6,0,0,-1,0,0,0,-1,-1
"5766",2018-12-19,"Snodgrass","w1819","Mechanized",0,"Wed","weekday","no_sled","East River","2","2","2",4.1,0,19,0,24,21.6,0,0,-1,0,0,0,-1,-1
"5767",2018-12-19,"Snodgrass","w1819","Motorized",0,"Wed","weekday","sled","East River","2","2","2",4.1,0,19,0,24,21.6,0,0,-1,0,0,0,-1,-1
"5768",2018-12-19,"Snodgrass","w1819","Hybrid",0,"Wed","weekday","sled","East River","2","2","2",4.1,0,19,0,24,21.6,0,0,-1,0,0,0,-1,-1
"5769",2018-12-20,"Snodgrass","w1819","Non.motorized",0,"Thu","weekday","no_sled","East River","2","2","1",4.1,0,20,1,25,20.5,0,0,0,-1,1,1,1,0
"5770",2018-12-20,"Snodgrass","w1819","Mechanized",0,"Thu","weekday","no_sled","East River","2","2","1",4.1,0,20,1,25,20.5,0,0,0,-1,1,1,1,0
"5771",2018-12-20,"Snodgrass","w1819","Motorized",0,"Thu","weekday","sled","East River","2","2","1",4.1,0,20,1,25,20.5,0,0,0,-1,1,1,1,0
"5772",2018-12-20,"Snodgrass","w1819","Hybrid",0,"Thu","weekday","sled","East River","2","2","1",4.1,0,20,1,25,20.5,0,0,0,-1,1,1,1,0
"5773",2018-12-21,"Snodgrass","w1819","Non.motorized",0,"Fri","weekday","no_sled","East River","2","2","1",4.1,0,19,-1,28,21.6,1,0,0,0,0,0,0,0
"5774",2018-12-21,"Snodgrass","w1819","Mechanized",0,"Fri","weekday","no_sled","East River","2","2","1",4.1,0,19,-1,28,21.6,1,0,0,0,0,0,0,0
"5775",2018-12-21,"Snodgrass","w1819","Motorized",0,"Fri","weekday","sled","East River","2","2","1",4.1,0,19,-1,28,21.6,1,0,0,0,0,0,0,0
"5776",2018-12-21,"Snodgrass","w1819","Hybrid",0,"Fri","weekday","sled","East River","2","2","1",4.1,0,19,-1,28,21.6,1,0,0,0,0,0,0,0
"5777",2018-12-22,"Snodgrass","w1819","Non.motorized",0,"Sat","weekend","no_sled","East River","2","2","1",4.2,0.1,19,0,20,22.1,-1,1,0,0,-1,0,0,0
"5778",2018-12-22,"Snodgrass","w1819","Mechanized",0,"Sat","weekend","no_sled","East River","2","2","1",4.2,0.1,19,0,20,22.1,-1,1,0,0,-1,0,0,0
"5779",2018-12-22,"Snodgrass","w1819","Motorized",0,"Sat","weekend","sled","East River","2","2","1",4.2,0.1,19,0,20,22.1,-1,1,0,0,-1,0,0,0
"5780",2018-12-22,"Snodgrass","w1819","Hybrid",0,"Sat","weekend","sled","East River","2","2","1",4.2,0.1,19,0,20,22.1,-1,1,0,0,-1,0,0,0
"5781",2018-12-23,"Snodgrass","w1819","Non.motorized",0,"Sun","weekend","no_sled","East River","2","2","1",4.2,0,21,2,19,20,0,-1,1,0,2,1,2,2
"5782",2018-12-23,"Snodgrass","w1819","Mechanized",0,"Sun","weekend","no_sled","East River","2","2","1",4.2,0,21,2,19,20,0,-1,1,0,2,1,2,2
"5783",2018-12-23,"Snodgrass","w1819","Motorized",0,"Sun","weekend","sled","East River","2","2","1",4.2,0,21,2,19,20,0,-1,1,0,2,1,2,2
"5784",2018-12-23,"Snodgrass","w1819","Hybrid",0,"Sun","weekend","sled","East River","2","2","1",4.2,0,21,2,19,20,0,-1,1,0,2,1,2,2
"5785",2018-12-24,"Snodgrass","w1819","Non.motorized",0,"Mon","weekday","no_sled","East River","2","2","2",4.3,0.1,20,-1,21,21.5,2,0,-1,1,1,1,0,1
"5786",2018-12-24,"Snodgrass","w1819","Mechanized",0,"Mon","weekday","no_sled","East River","2","2","2",4.3,0.1,20,-1,21,21.5,2,0,-1,1,1,1,0,1
"5787",2018-12-24,"Snodgrass","w1819","Motorized",0,"Mon","weekday","sled","East River","2","2","2",4.3,0.1,20,-1,21,21.5,2,0,-1,1,1,1,0,1
"5788",2018-12-24,"Snodgrass","w1819","Hybrid",0,"Mon","weekday","sled","East River","2","2","2",4.3,0.1,20,-1,21,21.5,2,0,-1,1,1,1,0,1
"5789",2018-12-25,"Snodgrass","w1819","Non.motorized",0,"Tue","weekday","no_sled","East River","2","2","2",4.7,0.4,25,5,25,18.8,-1,2,0,-1,4,6,6,5
"5790",2018-12-25,"Snodgrass","w1819","Mechanized",0,"Tue","weekday","no_sled","East River","2","2","2",4.7,0.4,25,5,25,18.8,-1,2,0,-1,4,6,6,5
"5791",2018-12-25,"Snodgrass","w1819","Motorized",0,"Tue","weekday","sled","East River","2","2","2",4.7,0.4,25,5,25,18.8,-1,2,0,-1,4,6,6,5
"5792",2018-12-25,"Snodgrass","w1819","Hybrid",0,"Tue","weekday","sled","East River","2","2","2",4.7,0.4,25,5,25,18.8,-1,2,0,-1,4,6,6,5
"5793",2018-12-26,"Snodgrass","w1819","Non.motorized",0,"Wed","weekday","no_sled","East River","3","3","3",4.7,0,23,-2,24,20.4,5,-1,2,0,3,2,4,4
"5794",2018-12-26,"Snodgrass","w1819","Mechanized",0,"Wed","weekday","no_sled","East River","3","3","3",4.7,0,23,-2,24,20.4,5,-1,2,0,3,2,4,4
"5795",2018-12-26,"Snodgrass","w1819","Motorized",0,"Wed","weekday","sled","East River","3","3","3",4.7,0,23,-2,24,20.4,5,-1,2,0,3,2,4,4
"5796",2018-12-26,"Snodgrass","w1819","Hybrid",0,"Wed","weekday","sled","East River","3","3","3",4.7,0,23,-2,24,20.4,5,-1,2,0,3,2,4,4
"5797",2018-12-27,"Snodgrass","w1819","Non.motorized",0,"Thu","weekday","no_sled","East River","3","3","2",4.7,0,24,1,12,19.6,-2,5,-1,2,-1,4,3,5
"5798",2018-12-27,"Snodgrass","w1819","Mechanized",0,"Thu","weekday","no_sled","East River","3","3","2",4.7,0,24,1,12,19.6,-2,5,-1,2,-1,4,3,5
"5799",2018-12-27,"Snodgrass","w1819","Motorized",0,"Thu","weekday","sled","East River","3","3","2",4.7,0,24,1,12,19.6,-2,5,-1,2,-1,4,3,5
"5800",2018-12-27,"Snodgrass","w1819","Hybrid",0,"Thu","weekday","sled","East River","3","3","2",4.7,0,24,1,12,19.6,-2,5,-1,2,-1,4,3,5
"5801",2018-12-28,"Snodgrass","w1819","Non.motorized",0,"Fri","weekday","no_sled","East River","3","3","2",4.7,0,24,0,12,19.6,1,-2,5,-1,1,-1,4,3
"5802",2018-12-28,"Snodgrass","w1819","Mechanized",0,"Fri","weekday","no_sled","East River","3","3","2",4.7,0,24,0,12,19.6,1,-2,5,-1,1,-1,4,3
"5803",2018-12-28,"Snodgrass","w1819","Motorized",0,"Fri","weekday","sled","East River","3","3","2",4.7,0,24,0,12,19.6,1,-2,5,-1,1,-1,4,3
"5804",2018-12-28,"Snodgrass","w1819","Hybrid",0,"Fri","weekday","sled","East River","3","3","2",4.7,0,24,0,12,19.6,1,-2,5,-1,1,-1,4,3
"5805",2018-12-29,"Snodgrass","w1819","Non.motorized",0,"Sat","weekend","no_sled","East River","3","3","2",4.7,0,24,0,8,19.6,0,1,-2,5,0,1,-1,4
"5806",2018-12-29,"Snodgrass","w1819","Mechanized",0,"Sat","weekend","no_sled","East River","3","3","2",4.7,0,24,0,8,19.6,0,1,-2,5,0,1,-1,4
"5807",2018-12-29,"Snodgrass","w1819","Motorized",0,"Sat","weekend","sled","East River","3","3","2",4.7,0,24,0,8,19.6,0,1,-2,5,0,1,-1,4
"5808",2018-12-29,"Snodgrass","w1819","Hybrid",0,"Sat","weekend","sled","East River","3","3","2",4.7,0,24,0,8,19.6,0,1,-2,5,0,1,-1,4
"5809",2018-12-30,"Snodgrass","w1819","Non.motorized",0,"Sun","weekend","no_sled","East River","3","3","2",4.7,0,24,0,16,19.6,0,0,1,-2,0,0,1,-1
"5810",2018-12-30,"Snodgrass","w1819","Mechanized",0,"Sun","weekend","no_sled","East River","3","3","2",4.7,0,24,0,16,19.6,0,0,1,-2,0,0,1,-1
"5811",2018-12-30,"Snodgrass","w1819","Motorized",0,"Sun","weekend","sled","East River","3","3","2",4.7,0,24,0,16,19.6,0,0,1,-2,0,0,1,-1
"5812",2018-12-30,"Snodgrass","w1819","Hybrid",0,"Sun","weekend","sled","East River","3","3","2",4.7,0,24,0,16,19.6,0,0,1,-2,0,0,1,-1
"5813",2018-12-31,"Snodgrass","w1819","Non.motorized",0,"Mon","weekday","no_sled","East River","3","3","3",4.9,0.2,23,-1,14,21.3,0,0,0,1,-1,-1,-1,0
"5814",2018-12-31,"Snodgrass","w1819","Mechanized",0,"Mon","weekday","no_sled","East River","3","3","3",4.9,0.2,23,-1,14,21.3,0,0,0,1,-1,-1,-1,0
"5815",2018-12-31,"Snodgrass","w1819","Motorized",0,"Mon","weekday","sled","East River","3","3","3",4.9,0.2,23,-1,14,21.3,0,0,0,1,-1,-1,-1,0
"5816",2018-12-31,"Snodgrass","w1819","Hybrid",0,"Mon","weekday","sled","East River","3","3","3",4.9,0.2,23,-1,14,21.3,0,0,0,1,-1,-1,-1,0
"5817",2019-01-01,"Snodgrass","w1819","Non.motorized",0,"Tue","weekday","no_sled","East River","3","3","3",5.1,0.2,29,6,11,17.6,-1,0,0,0,5,5,5,5
"5818",2019-01-01,"Snodgrass","w1819","Mechanized",0,"Tue","weekday","no_sled","East River","3","3","3",5.1,0.2,29,6,11,17.6,-1,0,0,0,5,5,5,5
"5819",2019-01-01,"Snodgrass","w1819","Motorized",0,"Tue","weekday","sled","East River","3","3","3",5.1,0.2,29,6,11,17.6,-1,0,0,0,5,5,5,5
"5820",2019-01-01,"Snodgrass","w1819","Hybrid",0,"Tue","weekday","sled","East River","3","3","3",5.1,0.2,29,6,11,17.6,-1,0,0,0,5,5,5,5
"5821",2019-01-02,"Snodgrass","w1819","Non.motorized",5,"Wed","weekday","no_sled","East River","3","3","2",5.1,0,28,-1,10,18.2,6,-1,0,0,5,4,4,4
"5822",2019-01-02,"Snodgrass","w1819","Mechanized",0,"Wed","weekday","no_sled","East River","3","3","2",5.1,0,28,-1,10,18.2,6,-1,0,0,5,4,4,4
"5823",2019-01-02,"Snodgrass","w1819","Motorized",1,"Wed","weekday","sled","East River","3","3","2",5.1,0,28,-1,10,18.2,6,-1,0,0,5,4,4,4
"5824",2019-01-02,"Snodgrass","w1819","Hybrid",0,"Wed","weekday","sled","East River","3","3","2",5.1,0,28,-1,10,18.2,6,-1,0,0,5,4,4,4
"5825",2019-01-03,"Snodgrass","w1819","Non.motorized",94,"Thu","weekday","no_sled","East River","3","3","2",5.1,0,27,-1,22,18.9,-1,6,-1,0,-2,4,3,3
"5826",2019-01-03,"Snodgrass","w1819","Mechanized",0,"Thu","weekday","no_sled","East River","3","3","2",5.1,0,27,-1,22,18.9,-1,6,-1,0,-2,4,3,3
"5827",2019-01-03,"Snodgrass","w1819","Motorized",7,"Thu","weekday","sled","East River","3","3","2",5.1,0,27,-1,22,18.9,-1,6,-1,0,-2,4,3,3
"5828",2019-01-03,"Snodgrass","w1819","Hybrid",0,"Thu","weekday","sled","East River","3","3","2",5.1,0,27,-1,22,18.9,-1,6,-1,0,-2,4,3,3
"5829",2019-01-04,"Snodgrass","w1819","Non.motorized",119,"Fri","weekday","no_sled","East River","3","3","2",5.3,0.2,26,-1,29,20.4,-1,-1,6,-1,-2,-3,3,2
"5830",2019-01-04,"Snodgrass","w1819","Mechanized",11,"Fri","weekday","no_sled","East River","3","3","2",5.3,0.2,26,-1,29,20.4,-1,-1,6,-1,-2,-3,3,2
"5831",2019-01-04,"Snodgrass","w1819","Motorized",9,"Fri","weekday","sled","East River","3","3","2",5.3,0.2,26,-1,29,20.4,-1,-1,6,-1,-2,-3,3,2
"5832",2019-01-04,"Snodgrass","w1819","Hybrid",0,"Fri","weekday","sled","East River","3","3","2",5.3,0.2,26,-1,29,20.4,-1,-1,6,-1,-2,-3,3,2
"5833",2019-01-05,"Snodgrass","w1819","Non.motorized",123,"Sat","weekend","no_sled","East River","2","2","2",5.3,0,25,-1,30,21.2,-1,-1,-1,6,-2,-3,-4,2
"5834",2019-01-05,"Snodgrass","w1819","Mechanized",9,"Sat","weekend","no_sled","East River","2","2","2",5.3,0,25,-1,30,21.2,-1,-1,-1,6,-2,-3,-4,2
"5835",2019-01-05,"Snodgrass","w1819","Motorized",2,"Sat","weekend","sled","East River","2","2","2",5.3,0,25,-1,30,21.2,-1,-1,-1,6,-2,-3,-4,2
"5836",2019-01-05,"Snodgrass","w1819","Hybrid",0,"Sat","weekend","sled","East River","2","2","2",5.3,0,25,-1,30,21.2,-1,-1,-1,6,-2,-3,-4,2
"5837",2019-01-06,"Snodgrass","w1819","Non.motorized",69,"Sun","weekend","no_sled","East River","3","3","3",5.3,0,25,0,26,21.2,-1,-1,-1,-1,-1,-2,-3,-4
"5838",2019-01-06,"Snodgrass","w1819","Mechanized",0,"Sun","weekend","no_sled","East River","3","3","3",5.3,0,25,0,26,21.2,-1,-1,-1,-1,-1,-2,-3,-4
"5839",2019-01-06,"Snodgrass","w1819","Motorized",1,"Sun","weekend","sled","East River","3","3","3",5.3,0,25,0,26,21.2,-1,-1,-1,-1,-1,-2,-3,-4
"5840",2019-01-06,"Snodgrass","w1819","Hybrid",0,"Sun","weekend","sled","East River","3","3","3",5.3,0,25,0,26,21.2,-1,-1,-1,-1,-1,-2,-3,-4
"5841",2019-01-07,"Snodgrass","w1819","Non.motorized",0,"Mon","weekday","no_sled","East River","3","3","3",5.8,0.5,32,7,21,18.1,0,-1,-1,-1,7,6,5,4
"5842",2019-01-07,"Snodgrass","w1819","Mechanized",0,"Mon","weekday","no_sled","East River","3","3","3",5.8,0.5,32,7,21,18.1,0,-1,-1,-1,7,6,5,4
"5843",2019-01-07,"Snodgrass","w1819","Motorized",0,"Mon","weekday","sled","East River","3","3","3",5.8,0.5,32,7,21,18.1,0,-1,-1,-1,7,6,5,4
"5844",2019-01-07,"Snodgrass","w1819","Hybrid",0,"Mon","weekday","sled","East River","3","3","3",5.8,0.5,32,7,21,18.1,0,-1,-1,-1,7,6,5,4
"5845",2019-01-08,"Snodgrass","w1819","Non.motorized",68,"Tue","weekday","no_sled","East River","3","3","3",5.9,0.1,32,0,24,18.4,7,0,-1,-1,7,7,6,5
"5846",2019-01-08,"Snodgrass","w1819","Mechanized",1,"Tue","weekday","no_sled","East River","3","3","3",5.9,0.1,32,0,24,18.4,7,0,-1,-1,7,7,6,5
"5847",2019-01-08,"Snodgrass","w1819","Motorized",0,"Tue","weekday","sled","East River","3","3","3",5.9,0.1,32,0,24,18.4,7,0,-1,-1,7,7,6,5
"5848",2019-01-08,"Snodgrass","w1819","Hybrid",0,"Tue","weekday","sled","East River","3","3","3",5.9,0.1,32,0,24,18.4,7,0,-1,-1,7,7,6,5
"5849",2019-01-09,"Snodgrass","w1819","Non.motorized",62,"Wed","weekday","no_sled","East River","3","3","3",6,0.1,30,-2,29,20,0,7,0,-1,-2,5,5,4
"5850",2019-01-09,"Snodgrass","w1819","Mechanized",1,"Wed","weekday","no_sled","East River","3","3","3",6,0.1,30,-2,29,20,0,7,0,-1,-2,5,5,4
"5851",2019-01-09,"Snodgrass","w1819","Motorized",0,"Wed","weekday","sled","East River","3","3","3",6,0.1,30,-2,29,20,0,7,0,-1,-2,5,5,4
"5852",2019-01-09,"Snodgrass","w1819","Hybrid",0,"Wed","weekday","sled","East River","3","3","3",6,0.1,30,-2,29,20,0,7,0,-1,-2,5,5,4
"5853",2019-01-10,"Snodgrass","w1819","Non.motorized",78,"Thu","weekday","no_sled","East River","3","3","3",6,0,29,-1,29,20.7,-2,0,7,0,-3,-3,4,4
"5854",2019-01-10,"Snodgrass","w1819","Mechanized",7,"Thu","weekday","no_sled","East River","3","3","3",6,0,29,-1,29,20.7,-2,0,7,0,-3,-3,4,4
"5855",2019-01-10,"Snodgrass","w1819","Motorized",0,"Thu","weekday","sled","East River","3","3","3",6,0,29,-1,29,20.7,-2,0,7,0,-3,-3,4,4
"5856",2019-01-10,"Snodgrass","w1819","Hybrid",0,"Thu","weekday","sled","East River","3","3","3",6,0,29,-1,29,20.7,-2,0,7,0,-3,-3,4,4
"5857",2019-01-11,"Snodgrass","w1819","Non.motorized",47,"Fri","weekday","no_sled","East River","2","2","2",6.1,0.1,29,0,25,21,-1,-2,0,7,-1,-3,-3,4
"5858",2019-01-11,"Snodgrass","w1819","Mechanized",0,"Fri","weekday","no_sled","East River","2","2","2",6.1,0.1,29,0,25,21,-1,-2,0,7,-1,-3,-3,4
"5859",2019-01-11,"Snodgrass","w1819","Motorized",1,"Fri","weekday","sled","East River","2","2","2",6.1,0.1,29,0,25,21,-1,-2,0,7,-1,-3,-3,4
"5860",2019-01-11,"Snodgrass","w1819","Hybrid",0,"Fri","weekday","sled","East River","2","2","2",6.1,0.1,29,0,25,21,-1,-2,0,7,-1,-3,-3,4
"5861",2019-01-12,"Snodgrass","w1819","Non.motorized",88,"Sat","weekend","no_sled","East River","3","3","2",6.1,0,28,-1,21,21.8,0,-1,-2,0,-1,-2,-4,-4
"5862",2019-01-12,"Snodgrass","w1819","Mechanized",6,"Sat","weekend","no_sled","East River","3","3","2",6.1,0,28,-1,21,21.8,0,-1,-2,0,-1,-2,-4,-4
"5863",2019-01-12,"Snodgrass","w1819","Motorized",2,"Sat","weekend","sled","East River","3","3","2",6.1,0,28,-1,21,21.8,0,-1,-2,0,-1,-2,-4,-4
"5864",2019-01-12,"Snodgrass","w1819","Hybrid",0,"Sat","weekend","sled","East River","3","3","2",6.1,0,28,-1,21,21.8,0,-1,-2,0,-1,-2,-4,-4
"5865",2019-01-13,"Snodgrass","w1819","Non.motorized",112,"Sun","weekend","no_sled","East River","2","2","2",6.2,0.1,30,2,18,20.7,-1,0,-1,-2,1,1,0,-2
"5866",2019-01-13,"Snodgrass","w1819","Mechanized",2,"Sun","weekend","no_sled","East River","2","2","2",6.2,0.1,30,2,18,20.7,-1,0,-1,-2,1,1,0,-2
"5867",2019-01-13,"Snodgrass","w1819","Motorized",4,"Sun","weekend","sled","East River","2","2","2",6.2,0.1,30,2,18,20.7,-1,0,-1,-2,1,1,0,-2
"5868",2019-01-13,"Snodgrass","w1819","Hybrid",0,"Sun","weekend","sled","East River","2","2","2",6.2,0.1,30,2,18,20.7,-1,0,-1,-2,1,1,0,-2
"5869",2019-01-14,"Snodgrass","w1819","Non.motorized",47,"Mon","weekday","no_sled","East River","2","2","2",6.2,0,30,0,18,20.7,2,-1,0,-1,2,1,1,0
"5870",2019-01-14,"Snodgrass","w1819","Mechanized",0,"Mon","weekday","no_sled","East River","2","2","2",6.2,0,30,0,18,20.7,2,-1,0,-1,2,1,1,0
"5871",2019-01-14,"Snodgrass","w1819","Motorized",1,"Mon","weekday","sled","East River","2","2","2",6.2,0,30,0,18,20.7,2,-1,0,-1,2,1,1,0
"5872",2019-01-14,"Snodgrass","w1819","Hybrid",0,"Mon","weekday","sled","East River","2","2","2",6.2,0,30,0,18,20.7,2,-1,0,-1,2,1,1,0
"5873",2019-01-15,"Snodgrass","w1819","Non.motorized",41,"Tue","weekday","no_sled","East River","2","2","2",6.2,0,29,-1,24,21.4,0,2,-1,0,-1,1,0,0
"5874",2019-01-15,"Snodgrass","w1819","Mechanized",0,"Tue","weekday","no_sled","East River","2","2","2",6.2,0,29,-1,24,21.4,0,2,-1,0,-1,1,0,0
"5875",2019-01-15,"Snodgrass","w1819","Motorized",0,"Tue","weekday","sled","East River","2","2","2",6.2,0,29,-1,24,21.4,0,2,-1,0,-1,1,0,0
"5876",2019-01-15,"Snodgrass","w1819","Hybrid",0,"Tue","weekday","sled","East River","2","2","2",6.2,0,29,-1,24,21.4,0,2,-1,0,-1,1,0,0
"5877",2019-01-16,"Snodgrass","w1819","Non.motorized",22,"Wed","weekday","no_sled","East River","4","4","3",6.3,0.1,29,0,26,21.7,-1,0,2,-1,-1,-1,1,0
"5878",2019-01-16,"Snodgrass","w1819","Mechanized",0,"Wed","weekday","no_sled","East River","4","4","3",6.3,0.1,29,0,26,21.7,-1,0,2,-1,-1,-1,1,0
"5879",2019-01-16,"Snodgrass","w1819","Motorized",0,"Wed","weekday","sled","East River","4","4","3",6.3,0.1,29,0,26,21.7,-1,0,2,-1,-1,-1,1,0
"5880",2019-01-16,"Snodgrass","w1819","Hybrid",0,"Wed","weekday","sled","East River","4","4","3",6.3,0.1,29,0,26,21.7,-1,0,2,-1,-1,-1,1,0
"5881",2019-01-17,"Snodgrass","w1819","Non.motorized",35,"Thu","weekday","no_sled","East River","3","3","2",7,0.7,38,9,28,18.4,0,-1,0,2,9,8,8,10
"5882",2019-01-17,"Snodgrass","w1819","Mechanized",0,"Thu","weekday","no_sled","East River","3","3","2",7,0.7,38,9,28,18.4,0,-1,0,2,9,8,8,10
"5883",2019-01-17,"Snodgrass","w1819","Motorized",0,"Thu","weekday","sled","East River","3","3","2",7,0.7,38,9,28,18.4,0,-1,0,2,9,8,8,10
"5884",2019-01-17,"Snodgrass","w1819","Hybrid",0,"Thu","weekday","sled","East River","3","3","2",7,0.7,38,9,28,18.4,0,-1,0,2,9,8,8,10
"5885",2019-01-18,"Snodgrass","w1819","Non.motorized",4,"Fri","weekday","no_sled","East River","4","4","4",7.5,0.5,41,3,22,18.3,9,0,-1,0,12,12,11,11
"5886",2019-01-18,"Snodgrass","w1819","Mechanized",0,"Fri","weekday","no_sled","East River","4","4","4",7.5,0.5,41,3,22,18.3,9,0,-1,0,12,12,11,11
"5887",2019-01-18,"Snodgrass","w1819","Motorized",0,"Fri","weekday","sled","East River","4","4","4",7.5,0.5,41,3,22,18.3,9,0,-1,0,12,12,11,11
"5888",2019-01-18,"Snodgrass","w1819","Hybrid",0,"Fri","weekday","sled","East River","4","4","4",7.5,0.5,41,3,22,18.3,9,0,-1,0,12,12,11,11
"5889",2019-01-19,"Snodgrass","w1819","Non.motorized",0,"Sat","weekend","no_sled","East River","3","3","3",7.8,0.3,43,2,20,18.1,3,9,0,-1,5,14,14,13
"5890",2019-01-19,"Snodgrass","w1819","Mechanized",0,"Sat","weekend","no_sled","East River","3","3","3",7.8,0.3,43,2,20,18.1,3,9,0,-1,5,14,14,13
"5891",2019-01-19,"Snodgrass","w1819","Motorized",0,"Sat","weekend","sled","East River","3","3","3",7.8,0.3,43,2,20,18.1,3,9,0,-1,5,14,14,13
"5892",2019-01-19,"Snodgrass","w1819","Hybrid",0,"Sat","weekend","sled","East River","3","3","3",7.8,0.3,43,2,20,18.1,3,9,0,-1,5,14,14,13
"5893",2019-01-20,"Snodgrass","w1819","Non.motorized",0,"Sun","weekend","no_sled","East River","3","3","3",7.9,0.1,41,-2,27,19.3,2,3,9,0,0,3,12,12
"5894",2019-01-20,"Snodgrass","w1819","Mechanized",0,"Sun","weekend","no_sled","East River","3","3","3",7.9,0.1,41,-2,27,19.3,2,3,9,0,0,3,12,12
"5895",2019-01-20,"Snodgrass","w1819","Motorized",0,"Sun","weekend","sled","East River","3","3","3",7.9,0.1,41,-2,27,19.3,2,3,9,0,0,3,12,12
"5896",2019-01-20,"Snodgrass","w1819","Hybrid",0,"Sun","weekend","sled","East River","3","3","3",7.9,0.1,41,-2,27,19.3,2,3,9,0,0,3,12,12
"5897",2019-01-21,"Snodgrass","w1819","Non.motorized",NA,"Mon","weekday","no_sled","East River","3","3","3",7.9,0,39,-2,23,20.3,-2,2,3,9,-4,-2,1,10
"5898",2019-01-21,"Snodgrass","w1819","Mechanized",NA,"Mon","weekday","no_sled","East River","3","3","3",7.9,0,39,-2,23,20.3,-2,2,3,9,-4,-2,1,10
"5899",2019-01-21,"Snodgrass","w1819","Motorized",NA,"Mon","weekday","sled","East River","3","3","3",7.9,0,39,-2,23,20.3,-2,2,3,9,-4,-2,1,10
"5900",2019-01-21,"Snodgrass","w1819","Hybrid",NA,"Mon","weekday","sled","East River","3","3","3",7.9,0,39,-2,23,20.3,-2,2,3,9,-4,-2,1,10
"5901",2019-01-22,"Snodgrass","w1819","Non.motorized",47,"Tue","weekday","no_sled","East River","3","3","3",8,0.1,41,2,12,19.5,-2,-2,2,3,0,-2,0,3
"5902",2019-01-22,"Snodgrass","w1819","Mechanized",1,"Tue","weekday","no_sled","East River","3","3","3",8,0.1,41,2,12,19.5,-2,-2,2,3,0,-2,0,3
"5903",2019-01-22,"Snodgrass","w1819","Motorized",2,"Tue","weekday","sled","East River","3","3","3",8,0.1,41,2,12,19.5,-2,-2,2,3,0,-2,0,3
"5904",2019-01-22,"Snodgrass","w1819","Hybrid",0,"Tue","weekday","sled","East River","3","3","3",8,0.1,41,2,12,19.5,-2,-2,2,3,0,-2,0,3
"5905",2019-01-23,"Snodgrass","w1819","Non.motorized",42,"Wed","weekday","no_sled","East River","3","3","2",8,0,40,-1,14,20,2,-2,-2,2,1,-1,-3,-1
"5906",2019-01-23,"Snodgrass","w1819","Mechanized",1,"Wed","weekday","no_sled","East River","3","3","2",8,0,40,-1,14,20,2,-2,-2,2,1,-1,-3,-1
"5907",2019-01-23,"Snodgrass","w1819","Motorized",0,"Wed","weekday","sled","East River","3","3","2",8,0,40,-1,14,20,2,-2,-2,2,1,-1,-3,-1
"5908",2019-01-23,"Snodgrass","w1819","Hybrid",0,"Wed","weekday","sled","East River","3","3","2",8,0,40,-1,14,20,2,-2,-2,2,1,-1,-3,-1
"5909",2019-01-24,"Snodgrass","w1819","Non.motorized",19,"Thu","weekday","no_sled","East River","3","3","2",8.2,0.2,40,0,17,20.5,-1,2,-2,-2,-1,1,-1,-3
"5910",2019-01-24,"Snodgrass","w1819","Mechanized",0,"Thu","weekday","no_sled","East River","3","3","2",8.2,0.2,40,0,17,20.5,-1,2,-2,-2,-1,1,-1,-3
"5911",2019-01-24,"Snodgrass","w1819","Motorized",1,"Thu","weekday","sled","East River","3","3","2",8.2,0.2,40,0,17,20.5,-1,2,-2,-2,-1,1,-1,-3
"5912",2019-01-24,"Snodgrass","w1819","Hybrid",0,"Thu","weekday","sled","East River","3","3","2",8.2,0.2,40,0,17,20.5,-1,2,-2,-2,-1,1,-1,-3
"5913",2019-01-25,"Snodgrass","w1819","Non.motorized",71,"Fri","weekday","no_sled","East River","3","3","2",8.3,0.1,40,0,15,20.8,0,-1,2,-2,0,-1,1,-1
"5914",2019-01-25,"Snodgrass","w1819","Mechanized",4,"Fri","weekday","no_sled","East River","3","3","2",8.3,0.1,40,0,15,20.8,0,-1,2,-2,0,-1,1,-1
"5915",2019-01-25,"Snodgrass","w1819","Motorized",9,"Fri","weekday","sled","East River","3","3","2",8.3,0.1,40,0,15,20.8,0,-1,2,-2,0,-1,1,-1
"5916",2019-01-25,"Snodgrass","w1819","Hybrid",0,"Fri","weekday","sled","East River","3","3","2",8.3,0.1,40,0,15,20.8,0,-1,2,-2,0,-1,1,-1
"5917",2019-01-26,"Snodgrass","w1819","Non.motorized",102,"Sat","weekend","no_sled","East River","3","3","2",8.3,0,39,-1,19,21.3,0,0,-1,2,-1,-1,-2,0
"5918",2019-01-26,"Snodgrass","w1819","Mechanized",7,"Sat","weekend","no_sled","East River","3","3","2",8.3,0,39,-1,19,21.3,0,0,-1,2,-1,-1,-2,0
"5919",2019-01-26,"Snodgrass","w1819","Motorized",3,"Sat","weekend","sled","East River","3","3","2",8.3,0,39,-1,19,21.3,0,0,-1,2,-1,-1,-2,0
"5920",2019-01-26,"Snodgrass","w1819","Hybrid",0,"Sat","weekend","sled","East River","3","3","2",8.3,0,39,-1,19,21.3,0,0,-1,2,-1,-1,-2,0
"5921",2019-01-27,"Snodgrass","w1819","Non.motorized",85,"Sun","weekend","no_sled","East River","3","3","2",8.3,0,38,-1,24,21.8,-1,0,0,-1,-2,-2,-2,-3
"5922",2019-01-27,"Snodgrass","w1819","Mechanized",2,"Sun","weekend","no_sled","East River","3","3","2",8.3,0,38,-1,24,21.8,-1,0,0,-1,-2,-2,-2,-3
"5923",2019-01-27,"Snodgrass","w1819","Motorized",0,"Sun","weekend","sled","East River","3","3","2",8.3,0,38,-1,24,21.8,-1,0,0,-1,-2,-2,-2,-3
"5924",2019-01-27,"Snodgrass","w1819","Hybrid",0,"Sun","weekend","sled","East River","3","3","2",8.3,0,38,-1,24,21.8,-1,0,0,-1,-2,-2,-2,-3
"5925",2019-01-28,"Snodgrass","w1819","Non.motorized",13,"Mon","weekday","no_sled","East River","2","2","2",8.3,0,38,0,17,21.8,-1,-1,0,0,-1,-2,-2,-2
"5926",2019-01-28,"Snodgrass","w1819","Mechanized",0,"Mon","weekday","no_sled","East River","2","2","2",8.3,0,38,0,17,21.8,-1,-1,0,0,-1,-2,-2,-2
"5927",2019-01-28,"Snodgrass","w1819","Motorized",0,"Mon","weekday","sled","East River","2","2","2",8.3,0,38,0,17,21.8,-1,-1,0,0,-1,-2,-2,-2
"5928",2019-01-28,"Snodgrass","w1819","Hybrid",0,"Mon","weekday","sled","East River","2","2","2",8.3,0,38,0,17,21.8,-1,-1,0,0,-1,-2,-2,-2
"5929",2019-01-29,"Snodgrass","w1819","Non.motorized",39,"Tue","weekday","no_sled","East River","2","2","2",8.3,0,38,0,16,21.8,0,-1,-1,0,0,-1,-2,-2
"5930",2019-01-29,"Snodgrass","w1819","Mechanized",1,"Tue","weekday","no_sled","East River","2","2","2",8.3,0,38,0,16,21.8,0,-1,-1,0,0,-1,-2,-2
"5931",2019-01-29,"Snodgrass","w1819","Motorized",0,"Tue","weekday","sled","East River","2","2","2",8.3,0,38,0,16,21.8,0,-1,-1,0,0,-1,-2,-2
"5932",2019-01-29,"Snodgrass","w1819","Hybrid",0,"Tue","weekday","sled","East River","2","2","2",8.3,0,38,0,16,21.8,0,-1,-1,0,0,-1,-2,-2
"5933",2019-01-30,"Snodgrass","w1819","Non.motorized",41,"Wed","weekday","no_sled","East River","2","2","1",8.3,0,37,-1,20,22.4,0,0,-1,-1,-1,-1,-2,-3
"5934",2019-01-30,"Snodgrass","w1819","Mechanized",0,"Wed","weekday","no_sled","East River","2","2","1",8.3,0,37,-1,20,22.4,0,0,-1,-1,-1,-1,-2,-3
"5935",2019-01-30,"Snodgrass","w1819","Motorized",2,"Wed","weekday","sled","East River","2","2","1",8.3,0,37,-1,20,22.4,0,0,-1,-1,-1,-1,-2,-3
"5936",2019-01-30,"Snodgrass","w1819","Hybrid",0,"Wed","weekday","sled","East River","2","2","1",8.3,0,37,-1,20,22.4,0,0,-1,-1,-1,-1,-2,-3
"5937",2019-01-31,"Snodgrass","w1819","Non.motorized",49,"Thu","weekday","no_sled","East River","2","2","1",8.3,0,36,-1,24,23.1,-1,0,0,-1,-2,-2,-2,-3
"5938",2019-01-31,"Snodgrass","w1819","Mechanized",1,"Thu","weekday","no_sled","East River","2","2","1",8.3,0,36,-1,24,23.1,-1,0,0,-1,-2,-2,-2,-3
"5939",2019-01-31,"Snodgrass","w1819","Motorized",0,"Thu","weekday","sled","East River","2","2","1",8.3,0,36,-1,24,23.1,-1,0,0,-1,-2,-2,-2,-3
"5940",2019-01-31,"Snodgrass","w1819","Hybrid",0,"Thu","weekday","sled","East River","2","2","1",8.3,0,36,-1,24,23.1,-1,0,0,-1,-2,-2,-2,-3
"5941",2019-02-01,"Snodgrass","w1819","Non.motorized",67,"Fri","weekday","no_sled","East River","2","2","1",8.3,0,36,0,25,23.1,-1,-1,0,0,-1,-2,-2,-2
"5942",2019-02-01,"Snodgrass","w1819","Mechanized",0,"Fri","weekday","no_sled","East River","2","2","1",8.3,0,36,0,25,23.1,-1,-1,0,0,-1,-2,-2,-2
"5943",2019-02-01,"Snodgrass","w1819","Motorized",0,"Fri","weekday","sled","East River","2","2","1",8.3,0,36,0,25,23.1,-1,-1,0,0,-1,-2,-2,-2
"5944",2019-02-01,"Snodgrass","w1819","Hybrid",0,"Fri","weekday","sled","East River","2","2","1",8.3,0,36,0,25,23.1,-1,-1,0,0,-1,-2,-2,-2
"5945",2019-02-02,"Snodgrass","w1819","Non.motorized",141,"Sat","weekend","no_sled","East River","2","2","1",8.3,0,36,0,26,23.1,0,-1,-1,0,0,-1,-2,-2
"5946",2019-02-02,"Snodgrass","w1819","Mechanized",4,"Sat","weekend","no_sled","East River","2","2","1",8.3,0,36,0,26,23.1,0,-1,-1,0,0,-1,-2,-2
"5947",2019-02-02,"Snodgrass","w1819","Motorized",1,"Sat","weekend","sled","East River","2","2","1",8.3,0,36,0,26,23.1,0,-1,-1,0,0,-1,-2,-2
"5948",2019-02-02,"Snodgrass","w1819","Hybrid",0,"Sat","weekend","sled","East River","2","2","1",8.3,0,36,0,26,23.1,0,-1,-1,0,0,-1,-2,-2
"5949",2019-02-03,"Snodgrass","w1819","Non.motorized",56,"Sun","weekend","no_sled","East River","3","3","2",8.4,0.1,36,0,28,23.3,0,0,-1,-1,0,0,-1,-2
"5950",2019-02-03,"Snodgrass","w1819","Mechanized",0,"Sun","weekend","no_sled","East River","3","3","2",8.4,0.1,36,0,28,23.3,0,0,-1,-1,0,0,-1,-2
"5951",2019-02-03,"Snodgrass","w1819","Motorized",0,"Sun","weekend","sled","East River","3","3","2",8.4,0.1,36,0,28,23.3,0,0,-1,-1,0,0,-1,-2
"5952",2019-02-03,"Snodgrass","w1819","Hybrid",0,"Sun","weekend","sled","East River","3","3","2",8.4,0.1,36,0,28,23.3,0,0,-1,-1,0,0,-1,-2
"5953",2019-02-04,"Snodgrass","w1819","Non.motorized",51,"Mon","weekday","no_sled","East River","3","3","2",8.8,0.4,39,3,28,22.6,0,0,0,-1,3,3,3,2
"5954",2019-02-04,"Snodgrass","w1819","Mechanized",0,"Mon","weekday","no_sled","East River","3","3","2",8.8,0.4,39,3,28,22.6,0,0,0,-1,3,3,3,2
"5955",2019-02-04,"Snodgrass","w1819","Motorized",0,"Mon","weekday","sled","East River","3","3","2",8.8,0.4,39,3,28,22.6,0,0,0,-1,3,3,3,2
"5956",2019-02-04,"Snodgrass","w1819","Hybrid",0,"Mon","weekday","sled","East River","3","3","2",8.8,0.4,39,3,28,22.6,0,0,0,-1,3,3,3,2
"5957",2019-02-05,"Snodgrass","w1819","Non.motorized",48,"Tue","weekday","no_sled","East River","3","2","2",9,0.2,40,1,26,22.5,3,0,0,0,4,4,4,4
"5958",2019-02-05,"Snodgrass","w1819","Mechanized",0,"Tue","weekday","no_sled","East River","3","2","2",9,0.2,40,1,26,22.5,3,0,0,0,4,4,4,4
"5959",2019-02-05,"Snodgrass","w1819","Motorized",0,"Tue","weekday","sled","East River","3","2","2",9,0.2,40,1,26,22.5,3,0,0,0,4,4,4,4
"5960",2019-02-05,"Snodgrass","w1819","Hybrid",0,"Tue","weekday","sled","East River","3","2","2",9,0.2,40,1,26,22.5,3,0,0,0,4,4,4,4
"5961",2019-02-06,"Snodgrass","w1819","Non.motorized",18,"Wed","weekday","no_sled","East River","4","4","3",9,0,40,0,16,22.5,1,3,0,0,1,4,4,4
"5962",2019-02-06,"Snodgrass","w1819","Mechanized",0,"Wed","weekday","no_sled","East River","4","4","3",9,0,40,0,16,22.5,1,3,0,0,1,4,4,4
"5963",2019-02-06,"Snodgrass","w1819","Motorized",0,"Wed","weekday","sled","East River","4","4","3",9,0,40,0,16,22.5,1,3,0,0,1,4,4,4
"5964",2019-02-06,"Snodgrass","w1819","Hybrid",0,"Wed","weekday","sled","East River","4","4","3",9,0,40,0,16,22.5,1,3,0,0,1,4,4,4
"5965",2019-02-07,"Snodgrass","w1819","Non.motorized",32,"Thu","weekday","no_sled","East River","3","3","2",9.2,0.2,43,3,4,21.4,0,1,3,0,3,4,7,7
"5966",2019-02-07,"Snodgrass","w1819","Mechanized",0,"Thu","weekday","no_sled","East River","3","3","2",9.2,0.2,43,3,4,21.4,0,1,3,0,3,4,7,7
"5967",2019-02-07,"Snodgrass","w1819","Motorized",0,"Thu","weekday","sled","East River","3","3","2",9.2,0.2,43,3,4,21.4,0,1,3,0,3,4,7,7
"5968",2019-02-07,"Snodgrass","w1819","Hybrid",0,"Thu","weekday","sled","East River","3","3","2",9.2,0.2,43,3,4,21.4,0,1,3,0,3,4,7,7
"5969",2019-02-08,"Snodgrass","w1819","Non.motorized",59,"Fri","weekday","no_sled","East River","3","2","2",9.2,0,42,-1,10,21.9,3,0,1,3,2,2,3,6
"5970",2019-02-08,"Snodgrass","w1819","Mechanized",0,"Fri","weekday","no_sled","East River","3","2","2",9.2,0,42,-1,10,21.9,3,0,1,3,2,2,3,6
"5971",2019-02-08,"Snodgrass","w1819","Motorized",0,"Fri","weekday","sled","East River","3","2","2",9.2,0,42,-1,10,21.9,3,0,1,3,2,2,3,6
"5972",2019-02-08,"Snodgrass","w1819","Hybrid",0,"Fri","weekday","sled","East River","3","2","2",9.2,0,42,-1,10,21.9,3,0,1,3,2,2,3,6
"5973",2019-02-09,"Snodgrass","w1819","Non.motorized",108,"Sat","weekend","no_sled","East River","3","2","2",9.2,0,41,-1,20,22.4,-1,3,0,1,-2,1,1,2
"5974",2019-02-09,"Snodgrass","w1819","Mechanized",3,"Sat","weekend","no_sled","East River","3","2","2",9.2,0,41,-1,20,22.4,-1,3,0,1,-2,1,1,2
"5975",2019-02-09,"Snodgrass","w1819","Motorized",0,"Sat","weekend","sled","East River","3","2","2",9.2,0,41,-1,20,22.4,-1,3,0,1,-2,1,1,2
"5976",2019-02-09,"Snodgrass","w1819","Hybrid",0,"Sat","weekend","sled","East River","3","2","2",9.2,0,41,-1,20,22.4,-1,3,0,1,-2,1,1,2
"5977",2019-02-10,"Snodgrass","w1819","Non.motorized",99,"Sun","weekend","no_sled","East River","2","2","2",9.3,0.1,40,-1,20,23.2,-1,-1,3,0,-2,-3,0,0
"5978",2019-02-10,"Snodgrass","w1819","Mechanized",2,"Sun","weekend","no_sled","East River","2","2","2",9.3,0.1,40,-1,20,23.2,-1,-1,3,0,-2,-3,0,0
"5979",2019-02-10,"Snodgrass","w1819","Motorized",0,"Sun","weekend","sled","East River","2","2","2",9.3,0.1,40,-1,20,23.2,-1,-1,3,0,-2,-3,0,0
"5980",2019-02-10,"Snodgrass","w1819","Hybrid",0,"Sun","weekend","sled","East River","2","2","2",9.3,0.1,40,-1,20,23.2,-1,-1,3,0,-2,-3,0,0
"5981",2019-02-11,"Snodgrass","w1819","Non.motorized",31,"Mon","weekday","no_sled","East River","2","2","1",9.3,0,40,0,15,23.2,-1,-1,-1,3,-1,-2,-3,0
"5982",2019-02-11,"Snodgrass","w1819","Mechanized",1,"Mon","weekday","no_sled","East River","2","2","1",9.3,0,40,0,15,23.2,-1,-1,-1,3,-1,-2,-3,0
"5983",2019-02-11,"Snodgrass","w1819","Motorized",0,"Mon","weekday","sled","East River","2","2","1",9.3,0,40,0,15,23.2,-1,-1,-1,3,-1,-2,-3,0
"5984",2019-02-11,"Snodgrass","w1819","Hybrid",0,"Mon","weekday","sled","East River","2","2","1",9.3,0,40,0,15,23.2,-1,-1,-1,3,-1,-2,-3,0
"5985",2019-02-12,"Snodgrass","w1819","Non.motorized",54,"Tue","weekday","no_sled","East River","2","2","1",9.3,0,40,0,18,23.2,0,-1,-1,-1,0,-1,-2,-3
"5986",2019-02-12,"Snodgrass","w1819","Mechanized",2,"Tue","weekday","no_sled","East River","2","2","1",9.3,0,40,0,18,23.2,0,-1,-1,-1,0,-1,-2,-3
"5987",2019-02-12,"Snodgrass","w1819","Motorized",0,"Tue","weekday","sled","East River","2","2","1",9.3,0,40,0,18,23.2,0,-1,-1,-1,0,-1,-2,-3
"5988",2019-02-12,"Snodgrass","w1819","Hybrid",0,"Tue","weekday","sled","East River","2","2","1",9.3,0,40,0,18,23.2,0,-1,-1,-1,0,-1,-2,-3
"5989",2019-02-13,"Snodgrass","w1819","Non.motorized",36,"Wed","weekday","no_sled","East River","2","2","1",9.4,0.1,40,0,26,23.5,0,0,-1,-1,0,0,-1,-2
"5990",2019-02-13,"Snodgrass","w1819","Mechanized",4,"Wed","weekday","no_sled","East River","2","2","1",9.4,0.1,40,0,26,23.5,0,0,-1,-1,0,0,-1,-2
"5991",2019-02-13,"Snodgrass","w1819","Motorized",0,"Wed","weekday","sled","East River","2","2","1",9.4,0.1,40,0,26,23.5,0,0,-1,-1,0,0,-1,-2
"5992",2019-02-13,"Snodgrass","w1819","Hybrid",0,"Wed","weekday","sled","East River","2","2","1",9.4,0.1,40,0,26,23.5,0,0,-1,-1,0,0,-1,-2
"5993",2019-02-14,"Snodgrass","w1819","Non.motorized",15,"Thu","weekday","no_sled","East River","3","2","2",9.7,0.3,41,1,29,23.7,0,0,0,-1,1,1,1,0
"5994",2019-02-14,"Snodgrass","w1819","Mechanized",4,"Thu","weekday","no_sled","East River","3","2","2",9.7,0.3,41,1,29,23.7,0,0,0,-1,1,1,1,0
"5995",2019-02-14,"Snodgrass","w1819","Motorized",0,"Thu","weekday","sled","East River","3","2","2",9.7,0.3,41,1,29,23.7,0,0,0,-1,1,1,1,0
"5996",2019-02-14,"Snodgrass","w1819","Hybrid",0,"Thu","weekday","sled","East River","3","2","2",9.7,0.3,41,1,29,23.7,0,0,0,-1,1,1,1,0
"5997",2019-02-15,"Snodgrass","w1819","Non.motorized",49,"Fri","weekday","no_sled","East River","4","4","3",10.8,1.1,51,10,27,21.2,1,0,0,0,11,11,11,11
"5998",2019-02-15,"Snodgrass","w1819","Mechanized",0,"Fri","weekday","no_sled","East River","4","4","3",10.8,1.1,51,10,27,21.2,1,0,0,0,11,11,11,11
"5999",2019-02-15,"Snodgrass","w1819","Motorized",1,"Fri","weekday","sled","East River","4","4","3",10.8,1.1,51,10,27,21.2,1,0,0,0,11,11,11,11
"6000",2019-02-15,"Snodgrass","w1819","Hybrid",0,"Fri","weekday","sled","East River","4","4","3",10.8,1.1,51,10,27,21.2,1,0,0,0,11,11,11,11
"6001",2019-02-16,"Snodgrass","w1819","Non.motorized",0,"Sat","weekend","no_sled","East River","3","3","3",11.1,0.3,52,1,14,21.3,10,1,0,0,11,12,12,12
"6002",2019-02-16,"Snodgrass","w1819","Mechanized",0,"Sat","weekend","no_sled","East River","3","3","3",11.1,0.3,52,1,14,21.3,10,1,0,0,11,12,12,12
"6003",2019-02-16,"Snodgrass","w1819","Motorized",0,"Sat","weekend","sled","East River","3","3","3",11.1,0.3,52,1,14,21.3,10,1,0,0,11,12,12,12
"6004",2019-02-16,"Snodgrass","w1819","Hybrid",0,"Sat","weekend","sled","East River","3","3","3",11.1,0.3,52,1,14,21.3,10,1,0,0,11,12,12,12
"6005",2019-02-17,"Snodgrass","w1819","Non.motorized",0,"Sun","weekend","no_sled","East River","3","3","3",11.3,0.2,55,3,10,20.5,1,10,1,0,4,14,15,15
"6006",2019-02-17,"Snodgrass","w1819","Mechanized",0,"Sun","weekend","no_sled","East River","3","3","3",11.3,0.2,55,3,10,20.5,1,10,1,0,4,14,15,15
"6007",2019-02-17,"Snodgrass","w1819","Motorized",0,"Sun","weekend","sled","East River","3","3","3",11.3,0.2,55,3,10,20.5,1,10,1,0,4,14,15,15
"6008",2019-02-17,"Snodgrass","w1819","Hybrid",0,"Sun","weekend","sled","East River","3","3","3",11.3,0.2,55,3,10,20.5,1,10,1,0,4,14,15,15
"6009",2019-02-18,"Snodgrass","w1819","Non.motorized",0,"Mon","weekday","no_sled","East River","3","3","2",11.4,0.1,53,-2,13,21.5,3,1,10,1,1,2,12,13
"6010",2019-02-18,"Snodgrass","w1819","Mechanized",0,"Mon","weekday","no_sled","East River","3","3","2",11.4,0.1,53,-2,13,21.5,3,1,10,1,1,2,12,13
"6011",2019-02-18,"Snodgrass","w1819","Motorized",0,"Mon","weekday","sled","East River","3","3","2",11.4,0.1,53,-2,13,21.5,3,1,10,1,1,2,12,13
"6012",2019-02-18,"Snodgrass","w1819","Hybrid",0,"Mon","weekday","sled","East River","3","3","2",11.4,0.1,53,-2,13,21.5,3,1,10,1,1,2,12,13
"6013",2019-02-19,"Snodgrass","w1819","Non.motorized",0,"Tue","weekday","no_sled","East River","3","3","2",11.5,0.1,53,0,11,21.7,-2,3,1,10,-2,1,2,12
"6014",2019-02-19,"Snodgrass","w1819","Mechanized",0,"Tue","weekday","no_sled","East River","3","3","2",11.5,0.1,53,0,11,21.7,-2,3,1,10,-2,1,2,12
"6015",2019-02-19,"Snodgrass","w1819","Motorized",0,"Tue","weekday","sled","East River","3","3","2",11.5,0.1,53,0,11,21.7,-2,3,1,10,-2,1,2,12
"6016",2019-02-19,"Snodgrass","w1819","Hybrid",0,"Tue","weekday","sled","East River","3","3","2",11.5,0.1,53,0,11,21.7,-2,3,1,10,-2,1,2,12
"6017",2019-02-20,"Snodgrass","w1819","Non.motorized",0,"Wed","weekday","no_sled","East River","3","3","2",11.6,0.1,53,0,7,21.9,0,-2,3,1,0,-2,1,2
"6018",2019-02-20,"Snodgrass","w1819","Mechanized",0,"Wed","weekday","no_sled","East River","3","3","2",11.6,0.1,53,0,7,21.9,0,-2,3,1,0,-2,1,2
"6019",2019-02-20,"Snodgrass","w1819","Motorized",0,"Wed","weekday","sled","East River","3","3","2",11.6,0.1,53,0,7,21.9,0,-2,3,1,0,-2,1,2
"6020",2019-02-20,"Snodgrass","w1819","Hybrid",0,"Wed","weekday","sled","East River","3","3","2",11.6,0.1,53,0,7,21.9,0,-2,3,1,0,-2,1,2
"6021",2019-02-21,"Snodgrass","w1819","Non.motorized",0,"Thu","weekday","no_sled","East River","3","3","3",11.6,0,52,-1,15,22.3,0,0,-2,3,-1,-1,-3,0
"6022",2019-02-21,"Snodgrass","w1819","Mechanized",0,"Thu","weekday","no_sled","East River","3","3","3",11.6,0,52,-1,15,22.3,0,0,-2,3,-1,-1,-3,0
"6023",2019-02-21,"Snodgrass","w1819","Motorized",0,"Thu","weekday","sled","East River","3","3","3",11.6,0,52,-1,15,22.3,0,0,-2,3,-1,-1,-3,0
"6024",2019-02-21,"Snodgrass","w1819","Hybrid",0,"Thu","weekday","sled","East River","3","3","3",11.6,0,52,-1,15,22.3,0,0,-2,3,-1,-1,-3,0
"6025",2019-02-22,"Snodgrass","w1819","Non.motorized",21,"Fri","weekday","no_sled","East River","3","3","3",11.8,0.2,52,0,20,22.7,-1,0,0,-2,-1,-1,-1,-3
"6026",2019-02-22,"Snodgrass","w1819","Mechanized",0,"Fri","weekday","no_sled","East River","3","3","3",11.8,0.2,52,0,20,22.7,-1,0,0,-2,-1,-1,-1,-3
"6027",2019-02-22,"Snodgrass","w1819","Motorized",0,"Fri","weekday","sled","East River","3","3","3",11.8,0.2,52,0,20,22.7,-1,0,0,-2,-1,-1,-1,-3
"6028",2019-02-22,"Snodgrass","w1819","Hybrid",0,"Fri","weekday","sled","East River","3","3","3",11.8,0.2,52,0,20,22.7,-1,0,0,-2,-1,-1,-1,-3
"6029",2019-02-23,"Snodgrass","w1819","Non.motorized",218,"Sat","weekend","no_sled","East River","3","3","3",12.1,0.3,53,1,13,22.8,0,-1,0,0,1,0,0,0
"6030",2019-02-23,"Snodgrass","w1819","Mechanized",0,"Sat","weekend","no_sled","East River","3","3","3",12.1,0.3,53,1,13,22.8,0,-1,0,0,1,0,0,0
"6031",2019-02-23,"Snodgrass","w1819","Motorized",6,"Sat","weekend","sled","East River","3","3","3",12.1,0.3,53,1,13,22.8,0,-1,0,0,1,0,0,0
"6032",2019-02-23,"Snodgrass","w1819","Hybrid",0,"Sat","weekend","sled","East River","3","3","3",12.1,0.3,53,1,13,22.8,0,-1,0,0,1,0,0,0
"6033",2019-02-24,"Snodgrass","w1819","Non.motorized",92,"Sun","weekend","no_sled","East River","3","3","2",12.1,0,52,-1,14,23.3,1,0,-1,0,0,0,-1,-1
"6034",2019-02-24,"Snodgrass","w1819","Mechanized",0,"Sun","weekend","no_sled","East River","3","3","2",12.1,0,52,-1,14,23.3,1,0,-1,0,0,0,-1,-1
"6035",2019-02-24,"Snodgrass","w1819","Motorized",0,"Sun","weekend","sled","East River","3","3","2",12.1,0,52,-1,14,23.3,1,0,-1,0,0,0,-1,-1
"6036",2019-02-24,"Snodgrass","w1819","Hybrid",0,"Sun","weekend","sled","East River","3","3","2",12.1,0,52,-1,14,23.3,1,0,-1,0,0,0,-1,-1
"6037",2019-02-25,"Snodgrass","w1819","Non.motorized",45,"Mon","weekday","no_sled","East River","3","3","2",12.1,0,51,-1,22,23.7,-1,1,0,-1,-2,-1,-1,-2
"6038",2019-02-25,"Snodgrass","w1819","Mechanized",0,"Mon","weekday","no_sled","East River","3","3","2",12.1,0,51,-1,22,23.7,-1,1,0,-1,-2,-1,-1,-2
"6039",2019-02-25,"Snodgrass","w1819","Motorized",0,"Mon","weekday","sled","East River","3","3","2",12.1,0,51,-1,22,23.7,-1,1,0,-1,-2,-1,-1,-2
"6040",2019-02-25,"Snodgrass","w1819","Hybrid",0,"Mon","weekday","sled","East River","3","3","2",12.1,0,51,-1,22,23.7,-1,1,0,-1,-2,-1,-1,-2
"6041",2019-02-26,"Snodgrass","w1819","Non.motorized",54,"Tue","weekday","no_sled","East River","2","2","2",12.1,0,50,-1,27,24.2,-1,-1,1,0,-2,-3,-2,-2
"6042",2019-02-26,"Snodgrass","w1819","Mechanized",2,"Tue","weekday","no_sled","East River","2","2","2",12.1,0,50,-1,27,24.2,-1,-1,1,0,-2,-3,-2,-2
"6043",2019-02-26,"Snodgrass","w1819","Motorized",0,"Tue","weekday","sled","East River","2","2","2",12.1,0,50,-1,27,24.2,-1,-1,1,0,-2,-3,-2,-2
"6044",2019-02-26,"Snodgrass","w1819","Hybrid",0,"Tue","weekday","sled","East River","2","2","2",12.1,0,50,-1,27,24.2,-1,-1,1,0,-2,-3,-2,-2
"6045",2019-02-27,"Snodgrass","w1819","Non.motorized",43,"Wed","weekday","no_sled","East River","2","2","2",12.1,0,50,0,30,24.2,-1,-1,-1,1,-1,-2,-3,-2
"6046",2019-02-27,"Snodgrass","w1819","Mechanized",9,"Wed","weekday","no_sled","East River","2","2","2",12.1,0,50,0,30,24.2,-1,-1,-1,1,-1,-2,-3,-2
"6047",2019-02-27,"Snodgrass","w1819","Motorized",0,"Wed","weekday","sled","East River","2","2","2",12.1,0,50,0,30,24.2,-1,-1,-1,1,-1,-2,-3,-2
"6048",2019-02-27,"Snodgrass","w1819","Hybrid",0,"Wed","weekday","sled","East River","2","2","2",12.1,0,50,0,30,24.2,-1,-1,-1,1,-1,-2,-3,-2
"6049",2019-02-28,"Snodgrass","w1819","Non.motorized",84,"Thu","weekday","no_sled","East River","2","2","2",12.2,0.1,49,-1,30,24.9,0,-1,-1,-1,-1,-2,-3,-4
"6050",2019-02-28,"Snodgrass","w1819","Mechanized",0,"Thu","weekday","no_sled","East River","2","2","2",12.2,0.1,49,-1,30,24.9,0,-1,-1,-1,-1,-2,-3,-4
"6051",2019-02-28,"Snodgrass","w1819","Motorized",0,"Thu","weekday","sled","East River","2","2","2",12.2,0.1,49,-1,30,24.9,0,-1,-1,-1,-1,-2,-3,-4
"6052",2019-02-28,"Snodgrass","w1819","Hybrid",0,"Thu","weekday","sled","East River","2","2","2",12.2,0.1,49,-1,30,24.9,0,-1,-1,-1,-1,-2,-3,-4
"6053",2019-03-01,"Snodgrass","w1819","Non.motorized",22,"Fri","weekday","no_sled","East River","2","2","1",12.3,0.1,49,0,29,25.1,-1,0,-1,-1,-1,-1,-2,-3
"6054",2019-03-01,"Snodgrass","w1819","Mechanized",0,"Fri","weekday","no_sled","East River","2","2","1",12.3,0.1,49,0,29,25.1,-1,0,-1,-1,-1,-1,-2,-3
"6055",2019-03-01,"Snodgrass","w1819","Motorized",0,"Fri","weekday","sled","East River","2","2","1",12.3,0.1,49,0,29,25.1,-1,0,-1,-1,-1,-1,-2,-3
"6056",2019-03-01,"Snodgrass","w1819","Hybrid",0,"Fri","weekday","sled","East River","2","2","1",12.3,0.1,49,0,29,25.1,-1,0,-1,-1,-1,-1,-2,-3
"6057",2019-03-02,"Snodgrass","w1819","Non.motorized",64,"Sat","weekend","no_sled","East River","3","3","2",13,0.7,58,9,30,22.4,0,-1,0,-1,9,8,8,7
"6058",2019-03-02,"Snodgrass","w1819","Mechanized",0,"Sat","weekend","no_sled","East River","3","3","2",13,0.7,58,9,30,22.4,0,-1,0,-1,9,8,8,7
"6059",2019-03-02,"Snodgrass","w1819","Motorized",0,"Sat","weekend","sled","East River","3","3","2",13,0.7,58,9,30,22.4,0,-1,0,-1,9,8,8,7
"6060",2019-03-02,"Snodgrass","w1819","Hybrid",0,"Sat","weekend","sled","East River","3","3","2",13,0.7,58,9,30,22.4,0,-1,0,-1,9,8,8,7
"6061",2019-03-03,"Snodgrass","w1819","Non.motorized",8,"Sun","weekend","no_sled","East River","3","3","3",13.7,0.7,64,6,27,21.4,9,0,-1,0,15,15,14,14
"6062",2019-03-03,"Snodgrass","w1819","Mechanized",0,"Sun","weekend","no_sled","East River","3","3","3",13.7,0.7,64,6,27,21.4,9,0,-1,0,15,15,14,14
"6063",2019-03-03,"Snodgrass","w1819","Motorized",0,"Sun","weekend","sled","East River","3","3","3",13.7,0.7,64,6,27,21.4,9,0,-1,0,15,15,14,14
"6064",2019-03-03,"Snodgrass","w1819","Hybrid",0,"Sun","weekend","sled","East River","3","3","3",13.7,0.7,64,6,27,21.4,9,0,-1,0,15,15,14,14
"6065",2019-03-04,"Snodgrass","w1819","Non.motorized",10,"Mon","weekday","no_sled","East River","3","3","3",14.4,0.7,66,2,23,21.8,6,9,0,-1,8,17,17,16
"6066",2019-03-04,"Snodgrass","w1819","Mechanized",0,"Mon","weekday","no_sled","East River","3","3","3",14.4,0.7,66,2,23,21.8,6,9,0,-1,8,17,17,16
"6067",2019-03-04,"Snodgrass","w1819","Motorized",0,"Mon","weekday","sled","East River","3","3","3",14.4,0.7,66,2,23,21.8,6,9,0,-1,8,17,17,16
"6068",2019-03-04,"Snodgrass","w1819","Hybrid",0,"Mon","weekday","sled","East River","3","3","3",14.4,0.7,66,2,23,21.8,6,9,0,-1,8,17,17,16
"6069",2019-03-05,"Snodgrass","w1819","Non.motorized",42,"Tue","weekday","no_sled","East River","3","3","3",14.4,0,64,-2,24,22.5,2,6,9,0,0,6,15,15
"6070",2019-03-05,"Snodgrass","w1819","Mechanized",0,"Tue","weekday","no_sled","East River","3","3","3",14.4,0,64,-2,24,22.5,2,6,9,0,0,6,15,15
"6071",2019-03-05,"Snodgrass","w1819","Motorized",0,"Tue","weekday","sled","East River","3","3","3",14.4,0,64,-2,24,22.5,2,6,9,0,0,6,15,15
"6072",2019-03-05,"Snodgrass","w1819","Hybrid",0,"Tue","weekday","sled","East River","3","3","3",14.4,0,64,-2,24,22.5,2,6,9,0,0,6,15,15
"6073",2019-03-06,"Snodgrass","w1819","Non.motorized",6,"Wed","weekday","no_sled","East River","3","3","2",14.5,0.1,62,-2,31,23.4,-2,2,6,9,-4,-2,4,13
"6074",2019-03-06,"Snodgrass","w1819","Non.motorized",6,"Wed","weekday","no_sled","East River","4","4","3",14.5,0.1,62,-2,31,23.4,-2,2,6,9,-4,-2,4,13
"6075",2019-03-06,"Snodgrass","w1819","Mechanized",0,"Wed","weekday","no_sled","East River","3","3","2",14.5,0.1,62,-2,31,23.4,-2,2,6,9,-4,-2,4,13
"6076",2019-03-06,"Snodgrass","w1819","Mechanized",0,"Wed","weekday","no_sled","East River","4","4","3",14.5,0.1,62,-2,31,23.4,-2,2,6,9,-4,-2,4,13
"6077",2019-03-06,"Snodgrass","w1819","Motorized",0,"Wed","weekday","sled","East River","3","3","2",14.5,0.1,62,-2,31,23.4,-2,2,6,9,-4,-2,4,13
"6078",2019-03-06,"Snodgrass","w1819","Motorized",0,"Wed","weekday","sled","East River","4","4","3",14.5,0.1,62,-2,31,23.4,-2,2,6,9,-4,-2,4,13
"6079",2019-03-06,"Snodgrass","w1819","Hybrid",0,"Wed","weekday","sled","East River","3","3","2",14.5,0.1,62,-2,31,23.4,-2,2,6,9,-4,-2,4,13
"6080",2019-03-06,"Snodgrass","w1819","Hybrid",0,"Wed","weekday","sled","East River","4","4","3",14.5,0.1,62,-2,31,23.4,-2,2,6,9,-4,-2,4,13
"6081",2019-03-07,"Snodgrass","w1819","Non.motorized",3,"Thu","weekday","no_sled","East River","4","4","3",16.2,1.7,71,9,30,22.8,-2,-2,2,6,7,5,7,13
"6082",2019-03-07,"Snodgrass","w1819","Mechanized",0,"Thu","weekday","no_sled","East River","4","4","3",16.2,1.7,71,9,30,22.8,-2,-2,2,6,7,5,7,13
"6083",2019-03-07,"Snodgrass","w1819","Motorized",0,"Thu","weekday","sled","East River","4","4","3",16.2,1.7,71,9,30,22.8,-2,-2,2,6,7,5,7,13
"6084",2019-03-07,"Snodgrass","w1819","Hybrid",0,"Thu","weekday","sled","East River","4","4","3",16.2,1.7,71,9,30,22.8,-2,-2,2,6,7,5,7,13
"6085",2019-03-08,"Snodgrass","w1819","Non.motorized",29,"Fri","weekday","no_sled","East River","3","3","3",16.6,0.4,71,0,27,23.4,9,-2,-2,2,9,7,5,7
"6086",2019-03-08,"Snodgrass","w1819","Mechanized",0,"Fri","weekday","no_sled","East River","3","3","3",16.6,0.4,71,0,27,23.4,9,-2,-2,2,9,7,5,7
"6087",2019-03-08,"Snodgrass","w1819","Motorized",0,"Fri","weekday","sled","East River","3","3","3",16.6,0.4,71,0,27,23.4,9,-2,-2,2,9,7,5,7
"6088",2019-03-08,"Snodgrass","w1819","Hybrid",0,"Fri","weekday","sled","East River","3","3","3",16.6,0.4,71,0,27,23.4,9,-2,-2,2,9,7,5,7
"6089",2019-03-09,"Snodgrass","w1819","Non.motorized",10,"Sat","weekend","no_sled","East River","4","4","3",17.2,0.6,76,5,22,22.6,0,9,-2,-2,5,14,12,10
"6090",2019-03-09,"Snodgrass","w1819","Mechanized",0,"Sat","weekend","no_sled","East River","4","4","3",17.2,0.6,76,5,22,22.6,0,9,-2,-2,5,14,12,10
"6091",2019-03-09,"Snodgrass","w1819","Motorized",0,"Sat","weekend","sled","East River","4","4","3",17.2,0.6,76,5,22,22.6,0,9,-2,-2,5,14,12,10
"6092",2019-03-09,"Snodgrass","w1819","Hybrid",0,"Sat","weekend","sled","East River","4","4","3",17.2,0.6,76,5,22,22.6,0,9,-2,-2,5,14,12,10
"6093",2019-03-10,"Snodgrass","w1819","Non.motorized",40,"Sun","weekend","no_sled","East River","3","3","3",17.3,0.1,73,-3,25,23.7,5,0,9,-2,2,2,11,9
"6094",2019-03-10,"Snodgrass","w1819","Mechanized",0,"Sun","weekend","no_sled","East River","3","3","3",17.3,0.1,73,-3,25,23.7,5,0,9,-2,2,2,11,9
"6095",2019-03-10,"Snodgrass","w1819","Motorized",0,"Sun","weekend","sled","East River","3","3","3",17.3,0.1,73,-3,25,23.7,5,0,9,-2,2,2,11,9
"6096",2019-03-10,"Snodgrass","w1819","Hybrid",0,"Sun","weekend","sled","East River","3","3","3",17.3,0.1,73,-3,25,23.7,5,0,9,-2,2,2,11,9
"6097",2019-03-11,"Snodgrass","w1819","Non.motorized",41,"Mon","weekday","no_sled","East River","3","3","2",17.3,0,71,-2,29,24.4,-3,5,0,9,-5,0,0,9
"6098",2019-03-11,"Snodgrass","w1819","Mechanized",0,"Mon","weekday","no_sled","East River","3","3","2",17.3,0,71,-2,29,24.4,-3,5,0,9,-5,0,0,9
"6099",2019-03-11,"Snodgrass","w1819","Motorized",0,"Mon","weekday","sled","East River","3","3","2",17.3,0,71,-2,29,24.4,-3,5,0,9,-5,0,0,9
"6100",2019-03-11,"Snodgrass","w1819","Hybrid",0,"Mon","weekday","sled","East River","3","3","2",17.3,0,71,-2,29,24.4,-3,5,0,9,-5,0,0,9
"6101",2019-03-12,"Snodgrass","w1819","Non.motorized",35,"Tue","weekday","no_sled","East River","3","3","3",17.4,0.1,70,-1,32,24.9,-2,-3,5,0,-3,-6,-1,-1
"6102",2019-03-12,"Snodgrass","w1819","Non.motorized",35,"Tue","weekday","no_sled","East River","4","4","4",17.4,0.1,70,-1,32,24.9,-2,-3,5,0,-3,-6,-1,-1
"6103",2019-03-12,"Snodgrass","w1819","Mechanized",1,"Tue","weekday","no_sled","East River","3","3","3",17.4,0.1,70,-1,32,24.9,-2,-3,5,0,-3,-6,-1,-1
"6104",2019-03-12,"Snodgrass","w1819","Mechanized",1,"Tue","weekday","no_sled","East River","4","4","4",17.4,0.1,70,-1,32,24.9,-2,-3,5,0,-3,-6,-1,-1
"6105",2019-03-12,"Snodgrass","w1819","Motorized",0,"Tue","weekday","sled","East River","3","3","3",17.4,0.1,70,-1,32,24.9,-2,-3,5,0,-3,-6,-1,-1
"6106",2019-03-12,"Snodgrass","w1819","Motorized",0,"Tue","weekday","sled","East River","4","4","4",17.4,0.1,70,-1,32,24.9,-2,-3,5,0,-3,-6,-1,-1
"6107",2019-03-12,"Snodgrass","w1819","Hybrid",0,"Tue","weekday","sled","East River","3","3","3",17.4,0.1,70,-1,32,24.9,-2,-3,5,0,-3,-6,-1,-1
"6108",2019-03-12,"Snodgrass","w1819","Hybrid",0,"Tue","weekday","sled","East River","4","4","4",17.4,0.1,70,-1,32,24.9,-2,-3,5,0,-3,-6,-1,-1
"6109",2019-03-13,"Snodgrass","w1819","Non.motorized",21,"Wed","weekday","no_sled","East River","4","4","3",18.1,0.7,74,4,24,24.5,-1,-2,-3,5,3,1,-2,3
"6110",2019-03-13,"Snodgrass","w1819","Mechanized",0,"Wed","weekday","no_sled","East River","4","4","3",18.1,0.7,74,4,24,24.5,-1,-2,-3,5,3,1,-2,3
"6111",2019-03-13,"Snodgrass","w1819","Motorized",0,"Wed","weekday","sled","East River","4","4","3",18.1,0.7,74,4,24,24.5,-1,-2,-3,5,3,1,-2,3
"6112",2019-03-13,"Snodgrass","w1819","Hybrid",0,"Wed","weekday","sled","East River","4","4","3",18.1,0.7,74,4,24,24.5,-1,-2,-3,5,3,1,-2,3
"6113",2019-03-14,"Snodgrass","w1819","Non.motorized",31,"Thu","weekday","no_sled","East River","4","4","3",18.1,0,74,0,17,24.5,4,-1,-2,-3,4,3,1,-2
"6114",2019-03-14,"Snodgrass","w1819","Mechanized",0,"Thu","weekday","no_sled","East River","4","4","3",18.1,0,74,0,17,24.5,4,-1,-2,-3,4,3,1,-2
"6115",2019-03-14,"Snodgrass","w1819","Motorized",3,"Thu","weekday","sled","East River","4","4","3",18.1,0,74,0,17,24.5,4,-1,-2,-3,4,3,1,-2
"6116",2019-03-14,"Snodgrass","w1819","Hybrid",0,"Thu","weekday","sled","East River","4","4","3",18.1,0,74,0,17,24.5,4,-1,-2,-3,4,3,1,-2
"6117",2019-03-15,"Snodgrass","w1819","Non.motorized",65,"Fri","weekday","no_sled","East River","3","3","2",18.1,0,72,-2,18,25.1,0,4,-1,-2,-2,2,1,-1
"6118",2019-03-15,"Snodgrass","w1819","Mechanized",0,"Fri","weekday","no_sled","East River","3","3","2",18.1,0,72,-2,18,25.1,0,4,-1,-2,-2,2,1,-1
"6119",2019-03-15,"Snodgrass","w1819","Motorized",0,"Fri","weekday","sled","East River","3","3","2",18.1,0,72,-2,18,25.1,0,4,-1,-2,-2,2,1,-1
"6120",2019-03-15,"Snodgrass","w1819","Hybrid",0,"Fri","weekday","sled","East River","3","3","2",18.1,0,72,-2,18,25.1,0,4,-1,-2,-2,2,1,-1
"6121",2019-03-16,"Snodgrass","w1819","Non.motorized",114,"Sat","weekend","no_sled","East River","3","3","2",18.2,0.1,70,-2,26,26,-2,0,4,-1,-4,-4,0,-1
"6122",2019-03-16,"Snodgrass","w1819","Mechanized",1,"Sat","weekend","no_sled","East River","3","3","2",18.2,0.1,70,-2,26,26,-2,0,4,-1,-4,-4,0,-1
"6123",2019-03-16,"Snodgrass","w1819","Motorized",4,"Sat","weekend","sled","East River","3","3","2",18.2,0.1,70,-2,26,26,-2,0,4,-1,-4,-4,0,-1
"6124",2019-03-16,"Snodgrass","w1819","Hybrid",0,"Sat","weekend","sled","East River","3","3","2",18.2,0.1,70,-2,26,26,-2,0,4,-1,-4,-4,0,-1
"6125",2019-03-17,"Snodgrass","w1819","Non.motorized",106,"Sun","weekend","no_sled","East River","3","3","2",18.2,0,69,-1,28,26.4,-2,-2,0,4,-3,-5,-5,-1
"6126",2019-03-17,"Snodgrass","w1819","Mechanized",11,"Sun","weekend","no_sled","East River","3","3","2",18.2,0,69,-1,28,26.4,-2,-2,0,4,-3,-5,-5,-1
"6127",2019-03-17,"Snodgrass","w1819","Motorized",1,"Sun","weekend","sled","East River","3","3","2",18.2,0,69,-1,28,26.4,-2,-2,0,4,-3,-5,-5,-1
"6128",2019-03-17,"Snodgrass","w1819","Hybrid",0,"Sun","weekend","sled","East River","3","3","2",18.2,0,69,-1,28,26.4,-2,-2,0,4,-3,-5,-5,-1
"6129",2019-03-18,"Snodgrass","w1819","Non.motorized",47,"Mon","weekday","no_sled","East River","2","2","2",18.3,0.1,68,-1,29,26.9,-1,-2,-2,0,-2,-4,-6,-6
"6130",2019-03-18,"Snodgrass","w1819","Mechanized",0,"Mon","weekday","no_sled","East River","2","2","2",18.3,0.1,68,-1,29,26.9,-1,-2,-2,0,-2,-4,-6,-6
"6131",2019-03-18,"Snodgrass","w1819","Motorized",0,"Mon","weekday","sled","East River","2","2","2",18.3,0.1,68,-1,29,26.9,-1,-2,-2,0,-2,-4,-6,-6
"6132",2019-03-18,"Snodgrass","w1819","Hybrid",0,"Mon","weekday","sled","East River","2","2","2",18.3,0.1,68,-1,29,26.9,-1,-2,-2,0,-2,-4,-6,-6
"6133",2019-03-19,"Snodgrass","w1819","Non.motorized",39,"Tue","weekday","no_sled","East River","2","2","2",18.3,0,67,-1,28,27.3,-1,-1,-2,-2,-2,-3,-5,-7
"6134",2019-03-19,"Snodgrass","w1819","Mechanized",3,"Tue","weekday","no_sled","East River","2","2","2",18.3,0,67,-1,28,27.3,-1,-1,-2,-2,-2,-3,-5,-7
"6135",2019-03-19,"Snodgrass","w1819","Motorized",3,"Tue","weekday","sled","East River","2","2","2",18.3,0,67,-1,28,27.3,-1,-1,-2,-2,-2,-3,-5,-7
"6136",2019-03-19,"Snodgrass","w1819","Hybrid",0,"Tue","weekday","sled","East River","2","2","2",18.3,0,67,-1,28,27.3,-1,-1,-2,-2,-2,-3,-5,-7
"6137",2019-03-20,"Snodgrass","w1819","Non.motorized",65,"Wed","weekday","no_sled","East River","2","2","2",18.3,0,66,-1,30,27.7,-1,-1,-1,-2,-2,-3,-4,-6
"6138",2019-03-20,"Snodgrass","w1819","Mechanized",6,"Wed","weekday","no_sled","East River","2","2","2",18.3,0,66,-1,30,27.7,-1,-1,-1,-2,-2,-3,-4,-6
"6139",2019-03-20,"Snodgrass","w1819","Motorized",0,"Wed","weekday","sled","East River","2","2","2",18.3,0,66,-1,30,27.7,-1,-1,-1,-2,-2,-3,-4,-6
"6140",2019-03-20,"Snodgrass","w1819","Hybrid",0,"Wed","weekday","sled","East River","2","2","2",18.3,0,66,-1,30,27.7,-1,-1,-1,-2,-2,-3,-4,-6
"6141",2019-03-21,"Snodgrass","w1819","Non.motorized",73,"Thu","weekday","no_sled","East River","2","2","2",18.4,0.1,65,-1,33,28.3,-1,-1,-1,-1,-2,-3,-4,-5
"6142",2019-03-21,"Snodgrass","w1819","Mechanized",0,"Thu","weekday","no_sled","East River","2","2","2",18.4,0.1,65,-1,33,28.3,-1,-1,-1,-1,-2,-3,-4,-5
"6143",2019-03-21,"Snodgrass","w1819","Motorized",3,"Thu","weekday","sled","East River","2","2","2",18.4,0.1,65,-1,33,28.3,-1,-1,-1,-1,-2,-3,-4,-5
"6144",2019-03-21,"Snodgrass","w1819","Hybrid",0,"Thu","weekday","sled","East River","2","2","2",18.4,0.1,65,-1,33,28.3,-1,-1,-1,-1,-2,-3,-4,-5
"6145",2019-03-22,"Snodgrass","w1819","Non.motorized",51,"Fri","weekday","no_sled","East River","3","3","2",18.4,0,64,-1,28,28.8,-1,-1,-1,-1,-2,-3,-4,-5
"6146",2019-03-22,"Snodgrass","w1819","Mechanized",1,"Fri","weekday","no_sled","East River","3","3","2",18.4,0,64,-1,28,28.8,-1,-1,-1,-1,-2,-3,-4,-5
"6147",2019-03-22,"Snodgrass","w1819","Motorized",0,"Fri","weekday","sled","East River","3","3","2",18.4,0,64,-1,28,28.8,-1,-1,-1,-1,-2,-3,-4,-5
"6148",2019-03-22,"Snodgrass","w1819","Hybrid",0,"Fri","weekday","sled","East River","3","3","2",18.4,0,64,-1,28,28.8,-1,-1,-1,-1,-2,-3,-4,-5
"6149",2019-03-23,"Snodgrass","w1819","Non.motorized",94,"Sat","weekend","no_sled","East River","2","2","1",18.4,0,65,1,28,28.3,-1,-1,-1,-1,0,-1,-2,-3
"6150",2019-03-23,"Snodgrass","w1819","Mechanized",2,"Sat","weekend","no_sled","East River","2","2","1",18.4,0,65,1,28,28.3,-1,-1,-1,-1,0,-1,-2,-3
"6151",2019-03-23,"Snodgrass","w1819","Motorized",0,"Sat","weekend","sled","East River","2","2","1",18.4,0,65,1,28,28.3,-1,-1,-1,-1,0,-1,-2,-3
"6152",2019-03-23,"Snodgrass","w1819","Hybrid",0,"Sat","weekend","sled","East River","2","2","1",18.4,0,65,1,28,28.3,-1,-1,-1,-1,0,-1,-2,-3
"6153",2019-03-24,"Snodgrass","w1819","Non.motorized",53,"Sun","weekend","no_sled","East River","2","2","1",18.4,0,64,-1,29,28.8,1,-1,-1,-1,0,-1,-2,-3
"6154",2019-03-24,"Snodgrass","w1819","Mechanized",3,"Sun","weekend","no_sled","East River","2","2","1",18.4,0,64,-1,29,28.8,1,-1,-1,-1,0,-1,-2,-3
"6155",2019-03-24,"Snodgrass","w1819","Motorized",0,"Sun","weekend","sled","East River","2","2","1",18.4,0,64,-1,29,28.8,1,-1,-1,-1,0,-1,-2,-3
"6156",2019-03-24,"Snodgrass","w1819","Hybrid",0,"Sun","weekend","sled","East River","2","2","1",18.4,0,64,-1,29,28.8,1,-1,-1,-1,0,-1,-2,-3
"6157",2019-03-25,"Snodgrass","w1819","Non.motorized",33,"Mon","weekday","no_sled","East River","2","2","2",18.6,0.2,64,0,31,29.1,-1,1,-1,-1,-1,0,-1,-2
"6158",2019-03-25,"Snodgrass","w1819","Mechanized",0,"Mon","weekday","no_sled","East River","2","2","2",18.6,0.2,64,0,31,29.1,-1,1,-1,-1,-1,0,-1,-2
"6159",2019-03-25,"Snodgrass","w1819","Motorized",1,"Mon","weekday","sled","East River","2","2","2",18.6,0.2,64,0,31,29.1,-1,1,-1,-1,-1,0,-1,-2
"6160",2019-03-25,"Snodgrass","w1819","Hybrid",0,"Mon","weekday","sled","East River","2","2","2",18.6,0.2,64,0,31,29.1,-1,1,-1,-1,-1,0,-1,-2
"6161",2019-03-26,"Snodgrass","w1819","Non.motorized",70,"Tue","weekday","no_sled","East River","2","2","2",18.9,0.3,63,-1,36,30,0,-1,1,-1,-1,-2,-1,-2
"6162",2019-03-26,"Snodgrass","w1819","Mechanized",0,"Tue","weekday","no_sled","East River","2","2","2",18.9,0.3,63,-1,36,30,0,-1,1,-1,-1,-2,-1,-2
"6163",2019-03-26,"Snodgrass","w1819","Motorized",0,"Tue","weekday","sled","East River","2","2","2",18.9,0.3,63,-1,36,30,0,-1,1,-1,-1,-2,-1,-2
"6164",2019-03-26,"Snodgrass","w1819","Hybrid",0,"Tue","weekday","sled","East River","2","2","2",18.9,0.3,63,-1,36,30,0,-1,1,-1,-1,-2,-1,-2
"6165",2019-03-27,"Snodgrass","w1819","Non.motorized",64,"Wed","weekday","no_sled","East River","1","2","2",18.9,0,62,-1,42,30.5,-1,0,-1,1,-2,-2,-3,-2
"6166",2019-03-27,"Snodgrass","w1819","Mechanized",5,"Wed","weekday","no_sled","East River","1","2","2",18.9,0,62,-1,42,30.5,-1,0,-1,1,-2,-2,-3,-2
"6167",2019-03-27,"Snodgrass","w1819","Motorized",3,"Wed","weekday","sled","East River","1","2","2",18.9,0,62,-1,42,30.5,-1,0,-1,1,-2,-2,-3,-2
"6168",2019-03-27,"Snodgrass","w1819","Hybrid",0,"Wed","weekday","sled","East River","1","2","2",18.9,0,62,-1,42,30.5,-1,0,-1,1,-2,-2,-3,-2
"6169",2019-03-28,"Snodgrass","w1819","Non.motorized",55,"Thu","weekday","no_sled","East River","1","2","2",18.9,0,60,-2,40,31.5,-1,-1,0,-1,-3,-4,-4,-5
"6170",2019-03-28,"Snodgrass","w1819","Mechanized",1,"Thu","weekday","no_sled","East River","1","2","2",18.9,0,60,-2,40,31.5,-1,-1,0,-1,-3,-4,-4,-5
"6171",2019-03-28,"Snodgrass","w1819","Motorized",0,"Thu","weekday","sled","East River","1","2","2",18.9,0,60,-2,40,31.5,-1,-1,0,-1,-3,-4,-4,-5
"6172",2019-03-28,"Snodgrass","w1819","Hybrid",0,"Thu","weekday","sled","East River","1","2","2",18.9,0,60,-2,40,31.5,-1,-1,0,-1,-3,-4,-4,-5
"6173",2019-03-29,"Snodgrass","w1819","Non.motorized",36,"Fri","weekday","no_sled","East River","1","1","1",19,0.1,58,-2,26,32.8,-2,-1,-1,0,-4,-5,-6,-6
"6174",2019-03-29,"Snodgrass","w1819","Mechanized",0,"Fri","weekday","no_sled","East River","1","1","1",19,0.1,58,-2,26,32.8,-2,-1,-1,0,-4,-5,-6,-6
"6175",2019-03-29,"Snodgrass","w1819","Motorized",0,"Fri","weekday","sled","East River","1","1","1",19,0.1,58,-2,26,32.8,-2,-1,-1,0,-4,-5,-6,-6
"6176",2019-03-29,"Snodgrass","w1819","Hybrid",0,"Fri","weekday","sled","East River","1","1","1",19,0.1,58,-2,26,32.8,-2,-1,-1,0,-4,-5,-6,-6
"6177",2019-03-30,"Snodgrass","w1819","Non.motorized",100,"Sat","weekend","no_sled","East River","1","1","1",19.1,0.1,61,3,24,31.3,-2,-2,-1,-1,1,-1,-2,-3
"6178",2019-03-30,"Snodgrass","w1819","Mechanized",2,"Sat","weekend","no_sled","East River","1","1","1",19.1,0.1,61,3,24,31.3,-2,-2,-1,-1,1,-1,-2,-3
"6179",2019-03-30,"Snodgrass","w1819","Motorized",5,"Sat","weekend","sled","East River","1","1","1",19.1,0.1,61,3,24,31.3,-2,-2,-1,-1,1,-1,-2,-3
"6180",2019-03-30,"Snodgrass","w1819","Hybrid",0,"Sat","weekend","sled","East River","1","1","1",19.1,0.1,61,3,24,31.3,-2,-2,-1,-1,1,-1,-2,-3
"6181",2019-03-31,"Snodgrass","w1819","Non.motorized",41,"Sun","weekend","no_sled","East River","1","1","1",19.1,0,59,-2,24,32.4,3,-2,-2,-1,1,-1,-3,-4
"6182",2019-03-31,"Snodgrass","w1819","Mechanized",3,"Sun","weekend","no_sled","East River","1","1","1",19.1,0,59,-2,24,32.4,3,-2,-2,-1,1,-1,-3,-4
"6183",2019-03-31,"Snodgrass","w1819","Motorized",7,"Sun","weekend","sled","East River","1","1","1",19.1,0,59,-2,24,32.4,3,-2,-2,-1,1,-1,-3,-4
"6184",2019-03-31,"Snodgrass","w1819","Hybrid",0,"Sun","weekend","sled","East River","1","1","1",19.1,0,59,-2,24,32.4,3,-2,-2,-1,1,-1,-3,-4
"6185",2019-04-01,"Snodgrass","w1819","Non.motorized",37,"Mon","weekday","no_sled","East River","2","1","1",19.1,0,58,-1,29,32.9,-2,3,-2,-2,-3,0,-2,-4
"6186",2019-04-01,"Snodgrass","w1819","Mechanized",4,"Mon","weekday","no_sled","East River","2","1","1",19.1,0,58,-1,29,32.9,-2,3,-2,-2,-3,0,-2,-4
"6187",2019-04-01,"Snodgrass","w1819","Motorized",7,"Mon","weekday","sled","East River","2","1","1",19.1,0,58,-1,29,32.9,-2,3,-2,-2,-3,0,-2,-4
"6188",2019-04-01,"Snodgrass","w1819","Hybrid",0,"Mon","weekday","sled","East River","2","1","1",19.1,0,58,-1,29,32.9,-2,3,-2,-2,-3,0,-2,-4
"6189",2019-04-02,"Snodgrass","w1819","Non.motorized",24,"Tue","weekday","no_sled","East River","1","1","1",19.1,0,58,0,33,32.9,-1,-2,3,-2,-1,-3,0,-2
"6190",2019-04-02,"Snodgrass","w1819","Mechanized",0,"Tue","weekday","no_sled","East River","1","1","1",19.1,0,58,0,33,32.9,-1,-2,3,-2,-1,-3,0,-2
"6191",2019-04-02,"Snodgrass","w1819","Motorized",0,"Tue","weekday","sled","East River","1","1","1",19.1,0,58,0,33,32.9,-1,-2,3,-2,-1,-3,0,-2
"6192",2019-04-02,"Snodgrass","w1819","Hybrid",0,"Tue","weekday","sled","East River","1","1","1",19.1,0,58,0,33,32.9,-1,-2,3,-2,-1,-3,0,-2
"6193",2019-04-03,"Snodgrass","w1819","Non.motorized",23,"Wed","weekday","no_sled","East River","2","1","1",19.2,0.1,58,0,31,33.1,0,-1,-2,3,0,-1,-3,0
"6194",2019-04-03,"Snodgrass","w1819","Mechanized",0,"Wed","weekday","no_sled","East River","2","1","1",19.2,0.1,58,0,31,33.1,0,-1,-2,3,0,-1,-3,0
"6195",2019-04-03,"Snodgrass","w1819","Motorized",2,"Wed","weekday","sled","East River","2","1","1",19.2,0.1,58,0,31,33.1,0,-1,-2,3,0,-1,-3,0
"6196",2019-04-03,"Snodgrass","w1819","Hybrid",0,"Wed","weekday","sled","East River","2","1","1",19.2,0.1,58,0,31,33.1,0,-1,-2,3,0,-1,-3,0
"6197",2019-04-04,"Snodgrass","w1819","Non.motorized",43,"Thu","weekday","no_sled","East River","2","1","1",19.4,0.2,59,1,35,32.9,0,0,-1,-2,1,1,0,-2
"6198",2019-04-04,"Snodgrass","w1819","Mechanized",0,"Thu","weekday","no_sled","East River","2","1","1",19.4,0.2,59,1,35,32.9,0,0,-1,-2,1,1,0,-2
"6199",2019-04-04,"Snodgrass","w1819","Motorized",0,"Thu","weekday","sled","East River","2","1","1",19.4,0.2,59,1,35,32.9,0,0,-1,-2,1,1,0,-2
"6200",2019-04-04,"Snodgrass","w1819","Hybrid",0,"Thu","weekday","sled","East River","2","1","1",19.4,0.2,59,1,35,32.9,0,0,-1,-2,1,1,0,-2
"6201",2019-04-05,"Snodgrass","w1819","Non.motorized",29,"Fri","weekday","no_sled","East River","1","1","1",19.4,0,57,-2,38,34,1,0,0,-1,-1,-1,-1,-2
"6202",2019-04-05,"Snodgrass","w1819","Mechanized",0,"Fri","weekday","no_sled","East River","1","1","1",19.4,0,57,-2,38,34,1,0,0,-1,-1,-1,-1,-2
"6203",2019-04-05,"Snodgrass","w1819","Motorized",1,"Fri","weekday","sled","East River","1","1","1",19.4,0,57,-2,38,34,1,0,0,-1,-1,-1,-1,-2
"6204",2019-04-05,"Snodgrass","w1819","Hybrid",0,"Fri","weekday","sled","East River","1","1","1",19.4,0,57,-2,38,34,1,0,0,-1,-1,-1,-1,-2
"6205",2019-04-06,"Snodgrass","w1819","Non.motorized",42,"Sat","weekend","no_sled","East River","1","1","1",19.3,-0.1,57,0,35,33.9,-2,1,0,0,-2,-1,-1,-1
"6206",2019-04-06,"Snodgrass","w1819","Mechanized",1,"Sat","weekend","no_sled","East River","1","1","1",19.3,-0.1,57,0,35,33.9,-2,1,0,0,-2,-1,-1,-1
"6207",2019-04-06,"Snodgrass","w1819","Motorized",4,"Sat","weekend","sled","East River","1","1","1",19.3,-0.1,57,0,35,33.9,-2,1,0,0,-2,-1,-1,-1
"6208",2019-04-06,"Snodgrass","w1819","Hybrid",0,"Sat","weekend","sled","East River","1","1","1",19.3,-0.1,57,0,35,33.9,-2,1,0,0,-2,-1,-1,-1
"6209",2019-04-07,"Snodgrass","w1819","Non.motorized",37,"Sun","weekend","no_sled","East River","1","1","1",19.1,-0.2,57,0,37,33.5,0,-2,1,0,0,-2,-1,-1
"6210",2019-04-07,"Snodgrass","w1819","Mechanized",2,"Sun","weekend","no_sled","East River","1","1","1",19.1,-0.2,57,0,37,33.5,0,-2,1,0,0,-2,-1,-1
"6211",2019-04-07,"Snodgrass","w1819","Motorized",3,"Sun","weekend","sled","East River","1","1","1",19.1,-0.2,57,0,37,33.5,0,-2,1,0,0,-2,-1,-1
"6212",2019-04-07,"Snodgrass","w1819","Hybrid",0,"Sun","weekend","sled","East River","1","1","1",19.1,-0.2,57,0,37,33.5,0,-2,1,0,0,-2,-1,-1
"6213",2019-04-08,"Snodgrass","w1819","Non.motorized",30,"Mon","weekday","no_sled","East River","1","2","2",19.3,0.2,54,-3,41,35.7,0,0,-2,1,-3,-3,-5,-4
"6214",2019-04-08,"Snodgrass","w1819","Mechanized",0,"Mon","weekday","no_sled","East River","1","2","2",19.3,0.2,54,-3,41,35.7,0,0,-2,1,-3,-3,-5,-4
"6215",2019-04-08,"Snodgrass","w1819","Motorized",9,"Mon","weekday","sled","East River","1","2","2",19.3,0.2,54,-3,41,35.7,0,0,-2,1,-3,-3,-5,-4
"6216",2019-04-08,"Snodgrass","w1819","Hybrid",4,"Mon","weekday","sled","East River","1","2","2",19.3,0.2,54,-3,41,35.7,0,0,-2,1,-3,-3,-5,-4
"6217",2019-04-09,"Snodgrass","w1819","Non.motorized",6,"Tue","weekday","no_sled","East River","1","2","2",19.3,0,53,-1,43,36.4,-3,0,0,-2,-4,-4,-4,-6
"6218",2019-04-09,"Snodgrass","w1819","Mechanized",0,"Tue","weekday","no_sled","East River","1","2","2",19.3,0,53,-1,43,36.4,-3,0,0,-2,-4,-4,-4,-6
"6219",2019-04-09,"Snodgrass","w1819","Motorized",4,"Tue","weekday","sled","East River","1","2","2",19.3,0,53,-1,43,36.4,-3,0,0,-2,-4,-4,-4,-6
"6220",2019-04-09,"Snodgrass","w1819","Hybrid",4,"Tue","weekday","sled","East River","1","2","2",19.3,0,53,-1,43,36.4,-3,0,0,-2,-4,-4,-4,-6
"6221",2019-04-10,"Snodgrass","w1819","Non.motorized",23,"Wed","weekday","no_sled","East River","2","2","1",19,-0.3,51,-2,30,37.3,-1,-3,0,0,-3,-6,-6,-6
"6222",2019-04-10,"Snodgrass","w1819","Mechanized",0,"Wed","weekday","no_sled","East River","2","2","1",19,-0.3,51,-2,30,37.3,-1,-3,0,0,-3,-6,-6,-6
"6223",2019-04-10,"Snodgrass","w1819","Motorized",4,"Wed","weekday","sled","East River","2","2","1",19,-0.3,51,-2,30,37.3,-1,-3,0,0,-3,-6,-6,-6
"6224",2019-04-10,"Snodgrass","w1819","Hybrid",0,"Wed","weekday","sled","East River","2","2","1",19,-0.3,51,-2,30,37.3,-1,-3,0,0,-3,-6,-6,-6
"6225",2019-04-11,"Snodgrass","w1819","Non.motorized",20,"Thu","weekday","no_sled","East River","3","3","2",18.9,-0.1,53,2,20,35.7,-2,-1,-3,0,0,-1,-4,-4
"6226",2019-04-11,"Snodgrass","w1819","Mechanized",0,"Thu","weekday","no_sled","East River","3","3","2",18.9,-0.1,53,2,20,35.7,-2,-1,-3,0,0,-1,-4,-4
"6227",2019-04-11,"Snodgrass","w1819","Motorized",0,"Thu","weekday","sled","East River","3","3","2",18.9,-0.1,53,2,20,35.7,-2,-1,-3,0,0,-1,-4,-4
"6228",2019-04-11,"Snodgrass","w1819","Hybrid",0,"Thu","weekday","sled","East River","3","3","2",18.9,-0.1,53,2,20,35.7,-2,-1,-3,0,0,-1,-4,-4
"6229",2019-04-12,"Snodgrass","w1819","Non.motorized",51,"Fri","weekday","no_sled","East River","2","2","1",18.7,-0.2,53,0,24,35.3,2,-2,-1,-3,2,0,-1,-4
"6230",2019-04-12,"Snodgrass","w1819","Mechanized",0,"Fri","weekday","no_sled","East River","2","2","1",18.7,-0.2,53,0,24,35.3,2,-2,-1,-3,2,0,-1,-4
"6231",2019-04-12,"Snodgrass","w1819","Motorized",0,"Fri","weekday","sled","East River","2","2","1",18.7,-0.2,53,0,24,35.3,2,-2,-1,-3,2,0,-1,-4
"6232",2019-04-12,"Snodgrass","w1819","Hybrid",0,"Fri","weekday","sled","East River","2","2","1",18.7,-0.2,53,0,24,35.3,2,-2,-1,-3,2,0,-1,-4
"6233",2019-04-13,"Snodgrass","w1819","Non.motorized",42,"Sat","weekend","no_sled","East River","1","1","1",18.8,0.1,52,-1,27,36.2,0,2,-2,-1,-1,1,-1,-2
"6234",2019-04-13,"Snodgrass","w1819","Mechanized",2,"Sat","weekend","no_sled","East River","1","1","1",18.8,0.1,52,-1,27,36.2,0,2,-2,-1,-1,1,-1,-2
"6235",2019-04-13,"Snodgrass","w1819","Motorized",4,"Sat","weekend","sled","East River","1","1","1",18.8,0.1,52,-1,27,36.2,0,2,-2,-1,-1,1,-1,-2
"6236",2019-04-13,"Snodgrass","w1819","Hybrid",0,"Sat","weekend","sled","East River","1","1","1",18.8,0.1,52,-1,27,36.2,0,2,-2,-1,-1,1,-1,-2
"6237",2019-04-14,"Snodgrass","w1819","Non.motorized",29,"Sun","weekend","no_sled","East River","1","1","1",18.7,-0.1,51,-1,35,36.7,-1,0,2,-2,-2,-2,0,-2
"6238",2019-04-14,"Snodgrass","w1819","Mechanized",0,"Sun","weekend","no_sled","East River","1","1","1",18.7,-0.1,51,-1,35,36.7,-1,0,2,-2,-2,-2,0,-2
"6239",2019-04-14,"Snodgrass","w1819","Motorized",0,"Sun","weekend","sled","East River","1","1","1",18.7,-0.1,51,-1,35,36.7,-1,0,2,-2,-2,-2,0,-2
"6240",2019-04-14,"Snodgrass","w1819","Hybrid",0,"Sun","weekend","sled","East River","1","1","1",18.7,-0.1,51,-1,35,36.7,-1,0,2,-2,-2,-2,0,-2
"6241",2019-04-15,"Snodgrass","w1819","Non.motorized",13,"Mon","weekday","no_sled","East River",NA,NA,NA,18.6,-0.1,50,-1,41,37.2,-1,-1,0,2,-2,-3,-3,-1
"6242",2019-04-15,"Snodgrass","w1819","Mechanized",0,"Mon","weekday","no_sled","East River",NA,NA,NA,18.6,-0.1,50,-1,41,37.2,-1,-1,0,2,-2,-3,-3,-1
"6243",2019-04-15,"Snodgrass","w1819","Motorized",0,"Mon","weekday","sled","East River",NA,NA,NA,18.6,-0.1,50,-1,41,37.2,-1,-1,0,2,-2,-3,-3,-1
"6244",2019-04-15,"Snodgrass","w1819","Hybrid",0,"Mon","weekday","sled","East River",NA,NA,NA,18.6,-0.1,50,-1,41,37.2,-1,-1,0,2,-2,-3,-3,-1
"6245",2018-12-01,"Washington Gulch","w1819","Non.motorized",25,"Sat","weekend","no_sled","Washington Gulch","3","3","2",3.3,0.2,19,1,16,17.4,0,0,0,0,1,1,1,1
"6246",2018-12-01,"Washington Gulch","w1819","Mechanized",0,"Sat","weekend","no_sled","Washington Gulch","3","3","2",3.3,0.2,19,1,16,17.4,0,0,0,0,1,1,1,1
"6247",2018-12-01,"Washington Gulch","w1819","Motorized",4,"Sat","weekend","sled","Washington Gulch","3","3","2",3.3,0.2,19,1,16,17.4,0,0,0,0,1,1,1,1
"6248",2018-12-01,"Washington Gulch","w1819","Hybrid",0,"Sat","weekend","sled","Washington Gulch","3","3","2",3.3,0.2,19,1,16,17.4,0,0,0,0,1,1,1,1
"6249",2018-12-02,"Washington Gulch","w1819","Non.motorized",33,"Sun","weekend","no_sled","Washington Gulch","3","3","3",3.3,0,20,1,14,16.5,1,0,0,0,2,2,2,2
"6250",2018-12-02,"Washington Gulch","w1819","Mechanized",0,"Sun","weekend","no_sled","Washington Gulch","3","3","3",3.3,0,20,1,14,16.5,1,0,0,0,2,2,2,2
"6251",2018-12-02,"Washington Gulch","w1819","Motorized",6,"Sun","weekend","sled","Washington Gulch","3","3","3",3.3,0,20,1,14,16.5,1,0,0,0,2,2,2,2
"6252",2018-12-02,"Washington Gulch","w1819","Hybrid",2,"Sun","weekend","sled","Washington Gulch","3","3","3",3.3,0,20,1,14,16.5,1,0,0,0,2,2,2,2
"6253",2018-12-03,"Washington Gulch","w1819","Non.motorized",4,"Mon","weekday","no_sled","Washington Gulch","3","3","2",3.4,0.1,19,-1,13,17.9,1,1,0,0,0,1,1,1
"6254",2018-12-03,"Washington Gulch","w1819","Mechanized",0,"Mon","weekday","no_sled","Washington Gulch","3","3","2",3.4,0.1,19,-1,13,17.9,1,1,0,0,0,1,1,1
"6255",2018-12-03,"Washington Gulch","w1819","Motorized",2,"Mon","weekday","sled","Washington Gulch","3","3","2",3.4,0.1,19,-1,13,17.9,1,1,0,0,0,1,1,1
"6256",2018-12-03,"Washington Gulch","w1819","Hybrid",2,"Mon","weekday","sled","Washington Gulch","3","3","2",3.4,0.1,19,-1,13,17.9,1,1,0,0,0,1,1,1
"6257",2018-12-04,"Washington Gulch","w1819","Non.motorized",15,"Tue","weekday","no_sled","Washington Gulch","3","3","2",3.5,0.1,20,1,8,17.5,-1,1,1,0,0,1,2,2
"6258",2018-12-04,"Washington Gulch","w1819","Mechanized",0,"Tue","weekday","no_sled","Washington Gulch","3","3","2",3.5,0.1,20,1,8,17.5,-1,1,1,0,0,1,2,2
"6259",2018-12-04,"Washington Gulch","w1819","Motorized",6,"Tue","weekday","sled","Washington Gulch","3","3","2",3.5,0.1,20,1,8,17.5,-1,1,1,0,0,1,2,2
"6260",2018-12-04,"Washington Gulch","w1819","Hybrid",1,"Tue","weekday","sled","Washington Gulch","3","3","2",3.5,0.1,20,1,8,17.5,-1,1,1,0,0,1,2,2
"6261",2018-12-05,"Washington Gulch","w1819","Non.motorized",6,"Wed","weekday","no_sled","Washington Gulch","3","3","2",3.5,0,19,-1,21,18.4,1,-1,1,1,0,-1,0,1
"6262",2018-12-05,"Washington Gulch","w1819","Mechanized",1,"Wed","weekday","no_sled","Washington Gulch","3","3","2",3.5,0,19,-1,21,18.4,1,-1,1,1,0,-1,0,1
"6263",2018-12-05,"Washington Gulch","w1819","Motorized",0,"Wed","weekday","sled","Washington Gulch","3","3","2",3.5,0,19,-1,21,18.4,1,-1,1,1,0,-1,0,1
"6264",2018-12-05,"Washington Gulch","w1819","Hybrid",0,"Wed","weekday","sled","Washington Gulch","3","3","2",3.5,0,19,-1,21,18.4,1,-1,1,1,0,-1,0,1
"6265",2018-12-06,"Washington Gulch","w1819","Non.motorized",11,"Thu","weekday","no_sled","Washington Gulch","2","2","2",3.7,0.2,18,-1,25,20.6,-1,1,-1,1,-2,-1,-2,-1
"6266",2018-12-06,"Washington Gulch","w1819","Mechanized",0,"Thu","weekday","no_sled","Washington Gulch","2","2","2",3.7,0.2,18,-1,25,20.6,-1,1,-1,1,-2,-1,-2,-1
"6267",2018-12-06,"Washington Gulch","w1819","Motorized",2,"Thu","weekday","sled","Washington Gulch","2","2","2",3.7,0.2,18,-1,25,20.6,-1,1,-1,1,-2,-1,-2,-1
"6268",2018-12-06,"Washington Gulch","w1819","Hybrid",2,"Thu","weekday","sled","Washington Gulch","2","2","2",3.7,0.2,18,-1,25,20.6,-1,1,-1,1,-2,-1,-2,-1
"6269",2018-12-07,"Washington Gulch","w1819","Non.motorized",13,"Fri","weekday","no_sled","Washington Gulch","2","2","2",3.8,0.1,21,3,23,18.1,-1,-1,1,-1,2,1,2,1
"6270",2018-12-07,"Washington Gulch","w1819","Mechanized",0,"Fri","weekday","no_sled","Washington Gulch","2","2","2",3.8,0.1,21,3,23,18.1,-1,-1,1,-1,2,1,2,1
"6271",2018-12-07,"Washington Gulch","w1819","Motorized",5,"Fri","weekday","sled","Washington Gulch","2","2","2",3.8,0.1,21,3,23,18.1,-1,-1,1,-1,2,1,2,1
"6272",2018-12-07,"Washington Gulch","w1819","Hybrid",3,"Fri","weekday","sled","Washington Gulch","2","2","2",3.8,0.1,21,3,23,18.1,-1,-1,1,-1,2,1,2,1
"6273",2018-12-08,"Washington Gulch","w1819","Non.motorized",49,"Sat","weekend","no_sled","Washington Gulch","2","2","2",3.8,0,20,-1,23,19,3,-1,-1,1,2,1,0,1
"6274",2018-12-08,"Washington Gulch","w1819","Mechanized",0,"Sat","weekend","no_sled","Washington Gulch","2","2","2",3.8,0,20,-1,23,19,3,-1,-1,1,2,1,0,1
"6275",2018-12-08,"Washington Gulch","w1819","Motorized",3,"Sat","weekend","sled","Washington Gulch","2","2","2",3.8,0,20,-1,23,19,3,-1,-1,1,2,1,0,1
"6276",2018-12-08,"Washington Gulch","w1819","Hybrid",0,"Sat","weekend","sled","Washington Gulch","2","2","2",3.8,0,20,-1,23,19,3,-1,-1,1,2,1,0,1
"6277",2018-12-09,"Washington Gulch","w1819","Non.motorized",63,"Sun","weekend","no_sled","Washington Gulch","2","2","2",3.8,0,20,0,19,19,-1,3,-1,-1,-1,2,1,0
"6278",2018-12-09,"Washington Gulch","w1819","Mechanized",0,"Sun","weekend","no_sled","Washington Gulch","2","2","2",3.8,0,20,0,19,19,-1,3,-1,-1,-1,2,1,0
"6279",2018-12-09,"Washington Gulch","w1819","Motorized",9,"Sun","weekend","sled","Washington Gulch","2","2","2",3.8,0,20,0,19,19,-1,3,-1,-1,-1,2,1,0
"6280",2018-12-09,"Washington Gulch","w1819","Hybrid",7,"Sun","weekend","sled","Washington Gulch","2","2","2",3.8,0,20,0,19,19,-1,3,-1,-1,-1,2,1,0
"6281",2018-12-10,"Washington Gulch","w1819","Non.motorized",13,"Mon","weekday","no_sled","Washington Gulch","2","2","2",3.8,0,20,0,21,19,0,-1,3,-1,0,-1,2,1
"6282",2018-12-10,"Washington Gulch","w1819","Mechanized",0,"Mon","weekday","no_sled","Washington Gulch","2","2","2",3.8,0,20,0,21,19,0,-1,3,-1,0,-1,2,1
"6283",2018-12-10,"Washington Gulch","w1819","Motorized",4,"Mon","weekday","sled","Washington Gulch","2","2","2",3.8,0,20,0,21,19,0,-1,3,-1,0,-1,2,1
"6284",2018-12-10,"Washington Gulch","w1819","Hybrid",2,"Mon","weekday","sled","Washington Gulch","2","2","2",3.8,0,20,0,21,19,0,-1,3,-1,0,-1,2,1
"6285",2018-12-11,"Washington Gulch","w1819","Non.motorized",22,"Tue","weekday","no_sled","Washington Gulch","2","2","2",3.9,0.1,19,-1,27,20.5,0,0,-1,3,-1,-1,-2,1
"6286",2018-12-11,"Washington Gulch","w1819","Mechanized",0,"Tue","weekday","no_sled","Washington Gulch","2","2","2",3.9,0.1,19,-1,27,20.5,0,0,-1,3,-1,-1,-2,1
"6287",2018-12-11,"Washington Gulch","w1819","Motorized",6,"Tue","weekday","sled","Washington Gulch","2","2","2",3.9,0.1,19,-1,27,20.5,0,0,-1,3,-1,-1,-2,1
"6288",2018-12-11,"Washington Gulch","w1819","Hybrid",2,"Tue","weekday","sled","Washington Gulch","2","2","2",3.9,0.1,19,-1,27,20.5,0,0,-1,3,-1,-1,-2,1
"6289",2018-12-12,"Washington Gulch","w1819","Non.motorized",9,"Wed","weekday","no_sled","Washington Gulch","2","2","1",3.9,0,19,0,21,20.5,-1,0,0,-1,-1,-1,-1,-2
"6290",2018-12-12,"Washington Gulch","w1819","Mechanized",0,"Wed","weekday","no_sled","Washington Gulch","2","2","1",3.9,0,19,0,21,20.5,-1,0,0,-1,-1,-1,-1,-2
"6291",2018-12-12,"Washington Gulch","w1819","Motorized",0,"Wed","weekday","sled","Washington Gulch","2","2","1",3.9,0,19,0,21,20.5,-1,0,0,-1,-1,-1,-1,-2
"6292",2018-12-12,"Washington Gulch","w1819","Hybrid",0,"Wed","weekday","sled","Washington Gulch","2","2","1",3.9,0,19,0,21,20.5,-1,0,0,-1,-1,-1,-1,-2
"6293",2018-12-13,"Washington Gulch","w1819","Non.motorized",18,"Thu","weekday","no_sled","Washington Gulch","3","3","2",4,0.1,21,2,15,19,0,-1,0,0,2,1,1,1
"6294",2018-12-13,"Washington Gulch","w1819","Mechanized",0,"Thu","weekday","no_sled","Washington Gulch","3","3","2",4,0.1,21,2,15,19,0,-1,0,0,2,1,1,1
"6295",2018-12-13,"Washington Gulch","w1819","Motorized",3,"Thu","weekday","sled","Washington Gulch","3","3","2",4,0.1,21,2,15,19,0,-1,0,0,2,1,1,1
"6296",2018-12-13,"Washington Gulch","w1819","Hybrid",1,"Thu","weekday","sled","Washington Gulch","3","3","2",4,0.1,21,2,15,19,0,-1,0,0,2,1,1,1
"6297",2018-12-14,"Washington Gulch","w1819","Non.motorized",34,"Fri","weekday","no_sled","Washington Gulch","3","3","2",4,0,20,-1,24,20,2,0,-1,0,1,1,0,0
"6298",2018-12-14,"Washington Gulch","w1819","Mechanized",0,"Fri","weekday","no_sled","Washington Gulch","3","3","2",4,0,20,-1,24,20,2,0,-1,0,1,1,0,0
"6299",2018-12-14,"Washington Gulch","w1819","Motorized",3,"Fri","weekday","sled","Washington Gulch","3","3","2",4,0,20,-1,24,20,2,0,-1,0,1,1,0,0
"6300",2018-12-14,"Washington Gulch","w1819","Hybrid",3,"Fri","weekday","sled","Washington Gulch","3","3","2",4,0,20,-1,24,20,2,0,-1,0,1,1,0,0
"6301",2018-12-15,"Washington Gulch","w1819","Non.motorized",42,"Sat","weekend","no_sled","Washington Gulch","2","2","2",4,0,20,0,29,20,-1,2,0,-1,-1,1,1,0
"6302",2018-12-15,"Washington Gulch","w1819","Mechanized",0,"Sat","weekend","no_sled","Washington Gulch","2","2","2",4,0,20,0,29,20,-1,2,0,-1,-1,1,1,0
"6303",2018-12-15,"Washington Gulch","w1819","Motorized",3,"Sat","weekend","sled","Washington Gulch","2","2","2",4,0,20,0,29,20,-1,2,0,-1,-1,1,1,0
"6304",2018-12-15,"Washington Gulch","w1819","Hybrid",0,"Sat","weekend","sled","Washington Gulch","2","2","2",4,0,20,0,29,20,-1,2,0,-1,-1,1,1,0
"6305",2018-12-16,"Washington Gulch","w1819","Non.motorized",74,"Sun","weekend","no_sled","Washington Gulch","2","2","2",4.1,0.1,19,-1,28,21.6,0,-1,2,0,-1,-2,0,0
"6306",2018-12-16,"Washington Gulch","w1819","Mechanized",2,"Sun","weekend","no_sled","Washington Gulch","2","2","2",4.1,0.1,19,-1,28,21.6,0,-1,2,0,-1,-2,0,0
"6307",2018-12-16,"Washington Gulch","w1819","Motorized",9,"Sun","weekend","sled","Washington Gulch","2","2","2",4.1,0.1,19,-1,28,21.6,0,-1,2,0,-1,-2,0,0
"6308",2018-12-16,"Washington Gulch","w1819","Hybrid",5,"Sun","weekend","sled","Washington Gulch","2","2","2",4.1,0.1,19,-1,28,21.6,0,-1,2,0,-1,-2,0,0
"6309",2018-12-17,"Washington Gulch","w1819","Non.motorized",9,"Mon","weekday","no_sled","Washington Gulch","2","2","2",4.1,0,19,0,29,21.6,-1,0,-1,2,-1,-1,-2,0
"6310",2018-12-17,"Washington Gulch","w1819","Mechanized",0,"Mon","weekday","no_sled","Washington Gulch","2","2","2",4.1,0,19,0,29,21.6,-1,0,-1,2,-1,-1,-2,0
"6311",2018-12-17,"Washington Gulch","w1819","Motorized",6,"Mon","weekday","sled","Washington Gulch","2","2","2",4.1,0,19,0,29,21.6,-1,0,-1,2,-1,-1,-2,0
"6312",2018-12-17,"Washington Gulch","w1819","Hybrid",6,"Mon","weekday","sled","Washington Gulch","2","2","2",4.1,0,19,0,29,21.6,-1,0,-1,2,-1,-1,-2,0
"6313",2018-12-18,"Washington Gulch","w1819","Non.motorized",18,"Tue","weekday","no_sled","Washington Gulch","2","2","2",4.1,0,19,0,27,21.6,0,-1,0,-1,0,-1,-1,-2
"6314",2018-12-18,"Washington Gulch","w1819","Mechanized",0,"Tue","weekday","no_sled","Washington Gulch","2","2","2",4.1,0,19,0,27,21.6,0,-1,0,-1,0,-1,-1,-2
"6315",2018-12-18,"Washington Gulch","w1819","Motorized",8,"Tue","weekday","sled","Washington Gulch","2","2","2",4.1,0,19,0,27,21.6,0,-1,0,-1,0,-1,-1,-2
"6316",2018-12-18,"Washington Gulch","w1819","Hybrid",6,"Tue","weekday","sled","Washington Gulch","2","2","2",4.1,0,19,0,27,21.6,0,-1,0,-1,0,-1,-1,-2
"6317",2018-12-19,"Washington Gulch","w1819","Non.motorized",12,"Wed","weekday","no_sled","Washington Gulch","2","2","2",4.1,0,19,0,24,21.6,0,0,-1,0,0,0,-1,-1
"6318",2018-12-19,"Washington Gulch","w1819","Mechanized",0,"Wed","weekday","no_sled","Washington Gulch","2","2","2",4.1,0,19,0,24,21.6,0,0,-1,0,0,0,-1,-1
"6319",2018-12-19,"Washington Gulch","w1819","Motorized",1,"Wed","weekday","sled","Washington Gulch","2","2","2",4.1,0,19,0,24,21.6,0,0,-1,0,0,0,-1,-1
"6320",2018-12-19,"Washington Gulch","w1819","Hybrid",1,"Wed","weekday","sled","Washington Gulch","2","2","2",4.1,0,19,0,24,21.6,0,0,-1,0,0,0,-1,-1
"6321",2018-12-20,"Washington Gulch","w1819","Non.motorized",9,"Thu","weekday","no_sled","Washington Gulch","2","2","1",4.1,0,20,1,25,20.5,0,0,0,-1,1,1,1,0
"6322",2018-12-20,"Washington Gulch","w1819","Mechanized",0,"Thu","weekday","no_sled","Washington Gulch","2","2","1",4.1,0,20,1,25,20.5,0,0,0,-1,1,1,1,0
"6323",2018-12-20,"Washington Gulch","w1819","Motorized",10,"Thu","weekday","sled","Washington Gulch","2","2","1",4.1,0,20,1,25,20.5,0,0,0,-1,1,1,1,0
"6324",2018-12-20,"Washington Gulch","w1819","Hybrid",9,"Thu","weekday","sled","Washington Gulch","2","2","1",4.1,0,20,1,25,20.5,0,0,0,-1,1,1,1,0
"6325",2018-12-21,"Washington Gulch","w1819","Non.motorized",23,"Fri","weekday","no_sled","Washington Gulch","2","2","1",4.1,0,19,-1,28,21.6,1,0,0,0,0,0,0,0
"6326",2018-12-21,"Washington Gulch","w1819","Mechanized",0,"Fri","weekday","no_sled","Washington Gulch","2","2","1",4.1,0,19,-1,28,21.6,1,0,0,0,0,0,0,0
"6327",2018-12-21,"Washington Gulch","w1819","Motorized",0,"Fri","weekday","sled","Washington Gulch","2","2","1",4.1,0,19,-1,28,21.6,1,0,0,0,0,0,0,0
"6328",2018-12-21,"Washington Gulch","w1819","Hybrid",0,"Fri","weekday","sled","Washington Gulch","2","2","1",4.1,0,19,-1,28,21.6,1,0,0,0,0,0,0,0
"6329",2018-12-22,"Washington Gulch","w1819","Non.motorized",39,"Sat","weekend","no_sled","Washington Gulch","2","2","1",4.2,0.1,19,0,20,22.1,-1,1,0,0,-1,0,0,0
"6330",2018-12-22,"Washington Gulch","w1819","Mechanized",0,"Sat","weekend","no_sled","Washington Gulch","2","2","1",4.2,0.1,19,0,20,22.1,-1,1,0,0,-1,0,0,0
"6331",2018-12-22,"Washington Gulch","w1819","Motorized",21,"Sat","weekend","sled","Washington Gulch","2","2","1",4.2,0.1,19,0,20,22.1,-1,1,0,0,-1,0,0,0
"6332",2018-12-22,"Washington Gulch","w1819","Hybrid",2,"Sat","weekend","sled","Washington Gulch","2","2","1",4.2,0.1,19,0,20,22.1,-1,1,0,0,-1,0,0,0
"6333",2018-12-23,"Washington Gulch","w1819","Non.motorized",66,"Sun","weekend","no_sled","Washington Gulch","2","2","1",4.2,0,21,2,19,20,0,-1,1,0,2,1,2,2
"6334",2018-12-23,"Washington Gulch","w1819","Mechanized",0,"Sun","weekend","no_sled","Washington Gulch","2","2","1",4.2,0,21,2,19,20,0,-1,1,0,2,1,2,2
"6335",2018-12-23,"Washington Gulch","w1819","Motorized",13,"Sun","weekend","sled","Washington Gulch","2","2","1",4.2,0,21,2,19,20,0,-1,1,0,2,1,2,2
"6336",2018-12-23,"Washington Gulch","w1819","Hybrid",3,"Sun","weekend","sled","Washington Gulch","2","2","1",4.2,0,21,2,19,20,0,-1,1,0,2,1,2,2
"6337",2018-12-24,"Washington Gulch","w1819","Non.motorized",28,"Mon","weekday","no_sled","Washington Gulch","2","2","2",4.3,0.1,20,-1,21,21.5,2,0,-1,1,1,1,0,1
"6338",2018-12-24,"Washington Gulch","w1819","Mechanized",0,"Mon","weekday","no_sled","Washington Gulch","2","2","2",4.3,0.1,20,-1,21,21.5,2,0,-1,1,1,1,0,1
"6339",2018-12-24,"Washington Gulch","w1819","Motorized",13,"Mon","weekday","sled","Washington Gulch","2","2","2",4.3,0.1,20,-1,21,21.5,2,0,-1,1,1,1,0,1
"6340",2018-12-24,"Washington Gulch","w1819","Hybrid",4,"Mon","weekday","sled","Washington Gulch","2","2","2",4.3,0.1,20,-1,21,21.5,2,0,-1,1,1,1,0,1
"6341",2018-12-25,"Washington Gulch","w1819","Non.motorized",57,"Tue","weekday","no_sled","Washington Gulch","2","2","2",4.7,0.4,25,5,25,18.8,-1,2,0,-1,4,6,6,5
"6342",2018-12-25,"Washington Gulch","w1819","Mechanized",0,"Tue","weekday","no_sled","Washington Gulch","2","2","2",4.7,0.4,25,5,25,18.8,-1,2,0,-1,4,6,6,5
"6343",2018-12-25,"Washington Gulch","w1819","Motorized",9,"Tue","weekday","sled","Washington Gulch","2","2","2",4.7,0.4,25,5,25,18.8,-1,2,0,-1,4,6,6,5
"6344",2018-12-25,"Washington Gulch","w1819","Hybrid",7,"Tue","weekday","sled","Washington Gulch","2","2","2",4.7,0.4,25,5,25,18.8,-1,2,0,-1,4,6,6,5
"6345",2018-12-26,"Washington Gulch","w1819","Non.motorized",54,"Wed","weekday","no_sled","Washington Gulch","3","3","3",4.7,0,23,-2,24,20.4,5,-1,2,0,3,2,4,4
"6346",2018-12-26,"Washington Gulch","w1819","Mechanized",0,"Wed","weekday","no_sled","Washington Gulch","3","3","3",4.7,0,23,-2,24,20.4,5,-1,2,0,3,2,4,4
"6347",2018-12-26,"Washington Gulch","w1819","Motorized",12,"Wed","weekday","sled","Washington Gulch","3","3","3",4.7,0,23,-2,24,20.4,5,-1,2,0,3,2,4,4
"6348",2018-12-26,"Washington Gulch","w1819","Hybrid",8,"Wed","weekday","sled","Washington Gulch","3","3","3",4.7,0,23,-2,24,20.4,5,-1,2,0,3,2,4,4
"6349",2018-12-27,"Washington Gulch","w1819","Non.motorized",68,"Thu","weekday","no_sled","Washington Gulch","3","3","2",4.7,0,24,1,12,19.6,-2,5,-1,2,-1,4,3,5
"6350",2018-12-27,"Washington Gulch","w1819","Mechanized",0,"Thu","weekday","no_sled","Washington Gulch","3","3","2",4.7,0,24,1,12,19.6,-2,5,-1,2,-1,4,3,5
"6351",2018-12-27,"Washington Gulch","w1819","Motorized",6,"Thu","weekday","sled","Washington Gulch","3","3","2",4.7,0,24,1,12,19.6,-2,5,-1,2,-1,4,3,5
"6352",2018-12-27,"Washington Gulch","w1819","Hybrid",6,"Thu","weekday","sled","Washington Gulch","3","3","2",4.7,0,24,1,12,19.6,-2,5,-1,2,-1,4,3,5
"6353",2018-12-28,"Washington Gulch","w1819","Non.motorized",38,"Fri","weekday","no_sled","Washington Gulch","3","3","2",4.7,0,24,0,12,19.6,1,-2,5,-1,1,-1,4,3
"6354",2018-12-28,"Washington Gulch","w1819","Mechanized",0,"Fri","weekday","no_sled","Washington Gulch","3","3","2",4.7,0,24,0,12,19.6,1,-2,5,-1,1,-1,4,3
"6355",2018-12-28,"Washington Gulch","w1819","Motorized",4,"Fri","weekday","sled","Washington Gulch","3","3","2",4.7,0,24,0,12,19.6,1,-2,5,-1,1,-1,4,3
"6356",2018-12-28,"Washington Gulch","w1819","Hybrid",2,"Fri","weekday","sled","Washington Gulch","3","3","2",4.7,0,24,0,12,19.6,1,-2,5,-1,1,-1,4,3
"6357",2018-12-29,"Washington Gulch","w1819","Non.motorized",72,"Sat","weekend","no_sled","Washington Gulch","3","3","2",4.7,0,24,0,8,19.6,0,1,-2,5,0,1,-1,4
"6358",2018-12-29,"Washington Gulch","w1819","Mechanized",0,"Sat","weekend","no_sled","Washington Gulch","3","3","2",4.7,0,24,0,8,19.6,0,1,-2,5,0,1,-1,4
"6359",2018-12-29,"Washington Gulch","w1819","Motorized",17,"Sat","weekend","sled","Washington Gulch","3","3","2",4.7,0,24,0,8,19.6,0,1,-2,5,0,1,-1,4
"6360",2018-12-29,"Washington Gulch","w1819","Hybrid",3,"Sat","weekend","sled","Washington Gulch","3","3","2",4.7,0,24,0,8,19.6,0,1,-2,5,0,1,-1,4
"6361",2018-12-30,"Washington Gulch","w1819","Non.motorized",85,"Sun","weekend","no_sled","Washington Gulch","3","3","2",4.7,0,24,0,16,19.6,0,0,1,-2,0,0,1,-1
"6362",2018-12-30,"Washington Gulch","w1819","Mechanized",0,"Sun","weekend","no_sled","Washington Gulch","3","3","2",4.7,0,24,0,16,19.6,0,0,1,-2,0,0,1,-1
"6363",2018-12-30,"Washington Gulch","w1819","Motorized",36,"Sun","weekend","sled","Washington Gulch","3","3","2",4.7,0,24,0,16,19.6,0,0,1,-2,0,0,1,-1
"6364",2018-12-30,"Washington Gulch","w1819","Hybrid",5,"Sun","weekend","sled","Washington Gulch","3","3","2",4.7,0,24,0,16,19.6,0,0,1,-2,0,0,1,-1
"6365",2018-12-31,"Washington Gulch","w1819","Non.motorized",53,"Mon","weekday","no_sled","Washington Gulch","3","3","3",4.9,0.2,23,-1,14,21.3,0,0,0,1,-1,-1,-1,0
"6366",2018-12-31,"Washington Gulch","w1819","Mechanized",0,"Mon","weekday","no_sled","Washington Gulch","3","3","3",4.9,0.2,23,-1,14,21.3,0,0,0,1,-1,-1,-1,0
"6367",2018-12-31,"Washington Gulch","w1819","Motorized",8,"Mon","weekday","sled","Washington Gulch","3","3","3",4.9,0.2,23,-1,14,21.3,0,0,0,1,-1,-1,-1,0
"6368",2018-12-31,"Washington Gulch","w1819","Hybrid",2,"Mon","weekday","sled","Washington Gulch","3","3","3",4.9,0.2,23,-1,14,21.3,0,0,0,1,-1,-1,-1,0
"6369",2019-01-01,"Washington Gulch","w1819","Non.motorized",19,"Tue","weekday","no_sled","Washington Gulch","3","3","3",5.1,0.2,29,6,11,17.6,-1,0,0,0,5,5,5,5
"6370",2019-01-01,"Washington Gulch","w1819","Mechanized",1,"Tue","weekday","no_sled","Washington Gulch","3","3","3",5.1,0.2,29,6,11,17.6,-1,0,0,0,5,5,5,5
"6371",2019-01-01,"Washington Gulch","w1819","Motorized",0,"Tue","weekday","sled","Washington Gulch","3","3","3",5.1,0.2,29,6,11,17.6,-1,0,0,0,5,5,5,5
"6372",2019-01-01,"Washington Gulch","w1819","Hybrid",0,"Tue","weekday","sled","Washington Gulch","3","3","3",5.1,0.2,29,6,11,17.6,-1,0,0,0,5,5,5,5
"6373",2019-01-02,"Washington Gulch","w1819","Non.motorized",2,"Wed","weekday","no_sled","Washington Gulch","3","3","2",5.1,0,28,-1,10,18.2,6,-1,0,0,5,4,4,4
"6374",2019-01-02,"Washington Gulch","w1819","Mechanized",0,"Wed","weekday","no_sled","Washington Gulch","3","3","2",5.1,0,28,-1,10,18.2,6,-1,0,0,5,4,4,4
"6375",2019-01-02,"Washington Gulch","w1819","Motorized",0,"Wed","weekday","sled","Washington Gulch","3","3","2",5.1,0,28,-1,10,18.2,6,-1,0,0,5,4,4,4
"6376",2019-01-02,"Washington Gulch","w1819","Hybrid",0,"Wed","weekday","sled","Washington Gulch","3","3","2",5.1,0,28,-1,10,18.2,6,-1,0,0,5,4,4,4
"6377",2019-01-03,"Washington Gulch","w1819","Non.motorized",8,"Thu","weekday","no_sled","Washington Gulch","3","3","2",5.1,0,27,-1,22,18.9,-1,6,-1,0,-2,4,3,3
"6378",2019-01-03,"Washington Gulch","w1819","Mechanized",0,"Thu","weekday","no_sled","Washington Gulch","3","3","2",5.1,0,27,-1,22,18.9,-1,6,-1,0,-2,4,3,3
"6379",2019-01-03,"Washington Gulch","w1819","Motorized",1,"Thu","weekday","sled","Washington Gulch","3","3","2",5.1,0,27,-1,22,18.9,-1,6,-1,0,-2,4,3,3
"6380",2019-01-03,"Washington Gulch","w1819","Hybrid",0,"Thu","weekday","sled","Washington Gulch","3","3","2",5.1,0,27,-1,22,18.9,-1,6,-1,0,-2,4,3,3
"6381",2019-01-04,"Washington Gulch","w1819","Non.motorized",3,"Fri","weekday","no_sled","Washington Gulch","3","3","2",5.3,0.2,26,-1,29,20.4,-1,-1,6,-1,-2,-3,3,2
"6382",2019-01-04,"Washington Gulch","w1819","Mechanized",0,"Fri","weekday","no_sled","Washington Gulch","3","3","2",5.3,0.2,26,-1,29,20.4,-1,-1,6,-1,-2,-3,3,2
"6383",2019-01-04,"Washington Gulch","w1819","Motorized",3,"Fri","weekday","sled","Washington Gulch","3","3","2",5.3,0.2,26,-1,29,20.4,-1,-1,6,-1,-2,-3,3,2
"6384",2019-01-04,"Washington Gulch","w1819","Hybrid",3,"Fri","weekday","sled","Washington Gulch","3","3","2",5.3,0.2,26,-1,29,20.4,-1,-1,6,-1,-2,-3,3,2
"6385",2019-01-05,"Washington Gulch","w1819","Non.motorized",12,"Sat","weekend","no_sled","Washington Gulch","2","2","2",5.3,0,25,-1,30,21.2,-1,-1,-1,6,-2,-3,-4,2
"6386",2019-01-05,"Washington Gulch","w1819","Mechanized",0,"Sat","weekend","no_sled","Washington Gulch","2","2","2",5.3,0,25,-1,30,21.2,-1,-1,-1,6,-2,-3,-4,2
"6387",2019-01-05,"Washington Gulch","w1819","Motorized",3,"Sat","weekend","sled","Washington Gulch","2","2","2",5.3,0,25,-1,30,21.2,-1,-1,-1,6,-2,-3,-4,2
"6388",2019-01-05,"Washington Gulch","w1819","Hybrid",3,"Sat","weekend","sled","Washington Gulch","2","2","2",5.3,0,25,-1,30,21.2,-1,-1,-1,6,-2,-3,-4,2
"6389",2019-01-06,"Washington Gulch","w1819","Non.motorized",NA,"Sun","weekend","no_sled","Washington Gulch","3","3","3",5.3,0,25,0,26,21.2,-1,-1,-1,-1,-1,-2,-3,-4
"6390",2019-01-06,"Washington Gulch","w1819","Mechanized",NA,"Sun","weekend","no_sled","Washington Gulch","3","3","3",5.3,0,25,0,26,21.2,-1,-1,-1,-1,-1,-2,-3,-4
"6391",2019-01-06,"Washington Gulch","w1819","Motorized",NA,"Sun","weekend","sled","Washington Gulch","3","3","3",5.3,0,25,0,26,21.2,-1,-1,-1,-1,-1,-2,-3,-4
"6392",2019-01-06,"Washington Gulch","w1819","Hybrid",NA,"Sun","weekend","sled","Washington Gulch","3","3","3",5.3,0,25,0,26,21.2,-1,-1,-1,-1,-1,-2,-3,-4
"6393",2019-01-07,"Washington Gulch","w1819","Non.motorized",NA,"Mon","weekday","no_sled","Washington Gulch","3","3","3",5.8,0.5,32,7,21,18.1,0,-1,-1,-1,7,6,5,4
"6394",2019-01-07,"Washington Gulch","w1819","Mechanized",NA,"Mon","weekday","no_sled","Washington Gulch","3","3","3",5.8,0.5,32,7,21,18.1,0,-1,-1,-1,7,6,5,4
"6395",2019-01-07,"Washington Gulch","w1819","Motorized",NA,"Mon","weekday","sled","Washington Gulch","3","3","3",5.8,0.5,32,7,21,18.1,0,-1,-1,-1,7,6,5,4
"6396",2019-01-07,"Washington Gulch","w1819","Hybrid",NA,"Mon","weekday","sled","Washington Gulch","3","3","3",5.8,0.5,32,7,21,18.1,0,-1,-1,-1,7,6,5,4
"6397",2019-01-08,"Washington Gulch","w1819","Non.motorized",2,"Tue","weekday","no_sled","Washington Gulch","3","3","3",5.9,0.1,32,0,24,18.4,7,0,-1,-1,7,7,6,5
"6398",2019-01-08,"Washington Gulch","w1819","Mechanized",0,"Tue","weekday","no_sled","Washington Gulch","3","3","3",5.9,0.1,32,0,24,18.4,7,0,-1,-1,7,7,6,5
"6399",2019-01-08,"Washington Gulch","w1819","Motorized",5,"Tue","weekday","sled","Washington Gulch","3","3","3",5.9,0.1,32,0,24,18.4,7,0,-1,-1,7,7,6,5
"6400",2019-01-08,"Washington Gulch","w1819","Hybrid",4,"Tue","weekday","sled","Washington Gulch","3","3","3",5.9,0.1,32,0,24,18.4,7,0,-1,-1,7,7,6,5
"6401",2019-01-09,"Washington Gulch","w1819","Non.motorized",1,"Wed","weekday","no_sled","Washington Gulch","3","3","3",6,0.1,30,-2,29,20,0,7,0,-1,-2,5,5,4
"6402",2019-01-09,"Washington Gulch","w1819","Mechanized",0,"Wed","weekday","no_sled","Washington Gulch","3","3","3",6,0.1,30,-2,29,20,0,7,0,-1,-2,5,5,4
"6403",2019-01-09,"Washington Gulch","w1819","Motorized",5,"Wed","weekday","sled","Washington Gulch","3","3","3",6,0.1,30,-2,29,20,0,7,0,-1,-2,5,5,4
"6404",2019-01-09,"Washington Gulch","w1819","Hybrid",2,"Wed","weekday","sled","Washington Gulch","3","3","3",6,0.1,30,-2,29,20,0,7,0,-1,-2,5,5,4
"6405",2019-01-10,"Washington Gulch","w1819","Non.motorized",5,"Thu","weekday","no_sled","Washington Gulch","3","3","3",6,0,29,-1,29,20.7,-2,0,7,0,-3,-3,4,4
"6406",2019-01-10,"Washington Gulch","w1819","Mechanized",0,"Thu","weekday","no_sled","Washington Gulch","3","3","3",6,0,29,-1,29,20.7,-2,0,7,0,-3,-3,4,4
"6407",2019-01-10,"Washington Gulch","w1819","Motorized",0,"Thu","weekday","sled","Washington Gulch","3","3","3",6,0,29,-1,29,20.7,-2,0,7,0,-3,-3,4,4
"6408",2019-01-10,"Washington Gulch","w1819","Hybrid",0,"Thu","weekday","sled","Washington Gulch","3","3","3",6,0,29,-1,29,20.7,-2,0,7,0,-3,-3,4,4
"6409",2019-01-11,"Washington Gulch","w1819","Non.motorized",18,"Fri","weekday","no_sled","Washington Gulch","2","2","2",6.1,0.1,29,0,25,21,-1,-2,0,7,-1,-3,-3,4
"6410",2019-01-11,"Washington Gulch","w1819","Mechanized",0,"Fri","weekday","no_sled","Washington Gulch","2","2","2",6.1,0.1,29,0,25,21,-1,-2,0,7,-1,-3,-3,4
"6411",2019-01-11,"Washington Gulch","w1819","Motorized",3,"Fri","weekday","sled","Washington Gulch","2","2","2",6.1,0.1,29,0,25,21,-1,-2,0,7,-1,-3,-3,4
"6412",2019-01-11,"Washington Gulch","w1819","Hybrid",2,"Fri","weekday","sled","Washington Gulch","2","2","2",6.1,0.1,29,0,25,21,-1,-2,0,7,-1,-3,-3,4
"6413",2019-01-12,"Washington Gulch","w1819","Non.motorized",19,"Sat","weekend","no_sled","Washington Gulch","3","3","2",6.1,0,28,-1,21,21.8,0,-1,-2,0,-1,-2,-4,-4
"6414",2019-01-12,"Washington Gulch","w1819","Mechanized",0,"Sat","weekend","no_sled","Washington Gulch","3","3","2",6.1,0,28,-1,21,21.8,0,-1,-2,0,-1,-2,-4,-4
"6415",2019-01-12,"Washington Gulch","w1819","Motorized",3,"Sat","weekend","sled","Washington Gulch","3","3","2",6.1,0,28,-1,21,21.8,0,-1,-2,0,-1,-2,-4,-4
"6416",2019-01-12,"Washington Gulch","w1819","Hybrid",0,"Sat","weekend","sled","Washington Gulch","3","3","2",6.1,0,28,-1,21,21.8,0,-1,-2,0,-1,-2,-4,-4
"6417",2019-01-13,"Washington Gulch","w1819","Non.motorized",29,"Sun","weekend","no_sled","Washington Gulch","2","2","2",6.2,0.1,30,2,18,20.7,-1,0,-1,-2,1,1,0,-2
"6418",2019-01-13,"Washington Gulch","w1819","Mechanized",0,"Sun","weekend","no_sled","Washington Gulch","2","2","2",6.2,0.1,30,2,18,20.7,-1,0,-1,-2,1,1,0,-2
"6419",2019-01-13,"Washington Gulch","w1819","Motorized",6,"Sun","weekend","sled","Washington Gulch","2","2","2",6.2,0.1,30,2,18,20.7,-1,0,-1,-2,1,1,0,-2
"6420",2019-01-13,"Washington Gulch","w1819","Hybrid",6,"Sun","weekend","sled","Washington Gulch","2","2","2",6.2,0.1,30,2,18,20.7,-1,0,-1,-2,1,1,0,-2
"6421",2019-01-14,"Washington Gulch","w1819","Non.motorized",8,"Mon","weekday","no_sled","Washington Gulch","2","2","2",6.2,0,30,0,18,20.7,2,-1,0,-1,2,1,1,0
"6422",2019-01-14,"Washington Gulch","w1819","Mechanized",0,"Mon","weekday","no_sled","Washington Gulch","2","2","2",6.2,0,30,0,18,20.7,2,-1,0,-1,2,1,1,0
"6423",2019-01-14,"Washington Gulch","w1819","Motorized",9,"Mon","weekday","sled","Washington Gulch","2","2","2",6.2,0,30,0,18,20.7,2,-1,0,-1,2,1,1,0
"6424",2019-01-14,"Washington Gulch","w1819","Hybrid",2,"Mon","weekday","sled","Washington Gulch","2","2","2",6.2,0,30,0,18,20.7,2,-1,0,-1,2,1,1,0
"6425",2019-01-15,"Washington Gulch","w1819","Non.motorized",0,"Tue","weekday","no_sled","Washington Gulch","2","2","2",6.2,0,29,-1,24,21.4,0,2,-1,0,-1,1,0,0
"6426",2019-01-15,"Washington Gulch","w1819","Mechanized",0,"Tue","weekday","no_sled","Washington Gulch","2","2","2",6.2,0,29,-1,24,21.4,0,2,-1,0,-1,1,0,0
"6427",2019-01-15,"Washington Gulch","w1819","Motorized",0,"Tue","weekday","sled","Washington Gulch","2","2","2",6.2,0,29,-1,24,21.4,0,2,-1,0,-1,1,0,0
"6428",2019-01-15,"Washington Gulch","w1819","Hybrid",0,"Tue","weekday","sled","Washington Gulch","2","2","2",6.2,0,29,-1,24,21.4,0,2,-1,0,-1,1,0,0
"6429",2019-01-16,"Washington Gulch","w1819","Non.motorized",0,"Wed","weekday","no_sled","Washington Gulch","4","4","3",6.3,0.1,29,0,26,21.7,-1,0,2,-1,-1,-1,1,0
"6430",2019-01-16,"Washington Gulch","w1819","Mechanized",0,"Wed","weekday","no_sled","Washington Gulch","4","4","3",6.3,0.1,29,0,26,21.7,-1,0,2,-1,-1,-1,1,0
"6431",2019-01-16,"Washington Gulch","w1819","Motorized",0,"Wed","weekday","sled","Washington Gulch","4","4","3",6.3,0.1,29,0,26,21.7,-1,0,2,-1,-1,-1,1,0
"6432",2019-01-16,"Washington Gulch","w1819","Hybrid",0,"Wed","weekday","sled","Washington Gulch","4","4","3",6.3,0.1,29,0,26,21.7,-1,0,2,-1,-1,-1,1,0
"6433",2019-01-17,"Washington Gulch","w1819","Non.motorized",0,"Thu","weekday","no_sled","Washington Gulch","3","3","2",7,0.7,38,9,28,18.4,0,-1,0,2,9,8,8,10
"6434",2019-01-17,"Washington Gulch","w1819","Mechanized",0,"Thu","weekday","no_sled","Washington Gulch","3","3","2",7,0.7,38,9,28,18.4,0,-1,0,2,9,8,8,10
"6435",2019-01-17,"Washington Gulch","w1819","Motorized",0,"Thu","weekday","sled","Washington Gulch","3","3","2",7,0.7,38,9,28,18.4,0,-1,0,2,9,8,8,10
"6436",2019-01-17,"Washington Gulch","w1819","Hybrid",0,"Thu","weekday","sled","Washington Gulch","3","3","2",7,0.7,38,9,28,18.4,0,-1,0,2,9,8,8,10
"6437",2019-01-18,"Washington Gulch","w1819","Non.motorized",0,"Fri","weekday","no_sled","Washington Gulch","4","4","4",7.5,0.5,41,3,22,18.3,9,0,-1,0,12,12,11,11
"6438",2019-01-18,"Washington Gulch","w1819","Mechanized",0,"Fri","weekday","no_sled","Washington Gulch","4","4","4",7.5,0.5,41,3,22,18.3,9,0,-1,0,12,12,11,11
"6439",2019-01-18,"Washington Gulch","w1819","Motorized",0,"Fri","weekday","sled","Washington Gulch","4","4","4",7.5,0.5,41,3,22,18.3,9,0,-1,0,12,12,11,11
"6440",2019-01-18,"Washington Gulch","w1819","Hybrid",0,"Fri","weekday","sled","Washington Gulch","4","4","4",7.5,0.5,41,3,22,18.3,9,0,-1,0,12,12,11,11
"6441",2019-01-19,"Washington Gulch","w1819","Non.motorized",0,"Sat","weekend","no_sled","Washington Gulch","3","3","3",7.8,0.3,43,2,20,18.1,3,9,0,-1,5,14,14,13
"6442",2019-01-19,"Washington Gulch","w1819","Mechanized",0,"Sat","weekend","no_sled","Washington Gulch","3","3","3",7.8,0.3,43,2,20,18.1,3,9,0,-1,5,14,14,13
"6443",2019-01-19,"Washington Gulch","w1819","Motorized",0,"Sat","weekend","sled","Washington Gulch","3","3","3",7.8,0.3,43,2,20,18.1,3,9,0,-1,5,14,14,13
"6444",2019-01-19,"Washington Gulch","w1819","Hybrid",0,"Sat","weekend","sled","Washington Gulch","3","3","3",7.8,0.3,43,2,20,18.1,3,9,0,-1,5,14,14,13
"6445",2019-01-20,"Washington Gulch","w1819","Non.motorized",0,"Sun","weekend","no_sled","Washington Gulch","3","3","3",7.9,0.1,41,-2,27,19.3,2,3,9,0,0,3,12,12
"6446",2019-01-20,"Washington Gulch","w1819","Mechanized",0,"Sun","weekend","no_sled","Washington Gulch","3","3","3",7.9,0.1,41,-2,27,19.3,2,3,9,0,0,3,12,12
"6447",2019-01-20,"Washington Gulch","w1819","Motorized",0,"Sun","weekend","sled","Washington Gulch","3","3","3",7.9,0.1,41,-2,27,19.3,2,3,9,0,0,3,12,12
"6448",2019-01-20,"Washington Gulch","w1819","Hybrid",0,"Sun","weekend","sled","Washington Gulch","3","3","3",7.9,0.1,41,-2,27,19.3,2,3,9,0,0,3,12,12
"6449",2019-01-21,"Washington Gulch","w1819","Non.motorized",NA,"Mon","weekday","no_sled","Washington Gulch","3","3","3",7.9,0,39,-2,23,20.3,-2,2,3,9,-4,-2,1,10
"6450",2019-01-21,"Washington Gulch","w1819","Mechanized",NA,"Mon","weekday","no_sled","Washington Gulch","3","3","3",7.9,0,39,-2,23,20.3,-2,2,3,9,-4,-2,1,10
"6451",2019-01-21,"Washington Gulch","w1819","Motorized",NA,"Mon","weekday","sled","Washington Gulch","3","3","3",7.9,0,39,-2,23,20.3,-2,2,3,9,-4,-2,1,10
"6452",2019-01-21,"Washington Gulch","w1819","Hybrid",NA,"Mon","weekday","sled","Washington Gulch","3","3","3",7.9,0,39,-2,23,20.3,-2,2,3,9,-4,-2,1,10
"6453",2019-01-22,"Washington Gulch","w1819","Non.motorized",NA,"Tue","weekday","no_sled","Washington Gulch","3","3","3",8,0.1,41,2,12,19.5,-2,-2,2,3,0,-2,0,3
"6454",2019-01-22,"Washington Gulch","w1819","Mechanized",NA,"Tue","weekday","no_sled","Washington Gulch","3","3","3",8,0.1,41,2,12,19.5,-2,-2,2,3,0,-2,0,3
"6455",2019-01-22,"Washington Gulch","w1819","Motorized",NA,"Tue","weekday","sled","Washington Gulch","3","3","3",8,0.1,41,2,12,19.5,-2,-2,2,3,0,-2,0,3
"6456",2019-01-22,"Washington Gulch","w1819","Hybrid",NA,"Tue","weekday","sled","Washington Gulch","3","3","3",8,0.1,41,2,12,19.5,-2,-2,2,3,0,-2,0,3
"6457",2019-01-23,"Washington Gulch","w1819","Non.motorized",NA,"Wed","weekday","no_sled","Washington Gulch","3","3","2",8,0,40,-1,14,20,2,-2,-2,2,1,-1,-3,-1
"6458",2019-01-23,"Washington Gulch","w1819","Mechanized",NA,"Wed","weekday","no_sled","Washington Gulch","3","3","2",8,0,40,-1,14,20,2,-2,-2,2,1,-1,-3,-1
"6459",2019-01-23,"Washington Gulch","w1819","Motorized",NA,"Wed","weekday","sled","Washington Gulch","3","3","2",8,0,40,-1,14,20,2,-2,-2,2,1,-1,-3,-1
"6460",2019-01-23,"Washington Gulch","w1819","Hybrid",NA,"Wed","weekday","sled","Washington Gulch","3","3","2",8,0,40,-1,14,20,2,-2,-2,2,1,-1,-3,-1
"6461",2019-01-24,"Washington Gulch","w1819","Non.motorized",1,"Thu","weekday","no_sled","Washington Gulch","3","3","2",8.2,0.2,40,0,17,20.5,-1,2,-2,-2,-1,1,-1,-3
"6462",2019-01-24,"Washington Gulch","w1819","Mechanized",1,"Thu","weekday","no_sled","Washington Gulch","3","3","2",8.2,0.2,40,0,17,20.5,-1,2,-2,-2,-1,1,-1,-3
"6463",2019-01-24,"Washington Gulch","w1819","Motorized",0,"Thu","weekday","sled","Washington Gulch","3","3","2",8.2,0.2,40,0,17,20.5,-1,2,-2,-2,-1,1,-1,-3
"6464",2019-01-24,"Washington Gulch","w1819","Hybrid",0,"Thu","weekday","sled","Washington Gulch","3","3","2",8.2,0.2,40,0,17,20.5,-1,2,-2,-2,-1,1,-1,-3
"6465",2019-01-25,"Washington Gulch","w1819","Non.motorized",0,"Fri","weekday","no_sled","Washington Gulch","3","3","2",8.3,0.1,40,0,15,20.8,0,-1,2,-2,0,-1,1,-1
"6466",2019-01-25,"Washington Gulch","w1819","Mechanized",0,"Fri","weekday","no_sled","Washington Gulch","3","3","2",8.3,0.1,40,0,15,20.8,0,-1,2,-2,0,-1,1,-1
"6467",2019-01-25,"Washington Gulch","w1819","Motorized",1,"Fri","weekday","sled","Washington Gulch","3","3","2",8.3,0.1,40,0,15,20.8,0,-1,2,-2,0,-1,1,-1
"6468",2019-01-25,"Washington Gulch","w1819","Hybrid",0,"Fri","weekday","sled","Washington Gulch","3","3","2",8.3,0.1,40,0,15,20.8,0,-1,2,-2,0,-1,1,-1
"6469",2019-01-26,"Washington Gulch","w1819","Non.motorized",0,"Sat","weekend","no_sled","Washington Gulch","3","3","2",8.3,0,39,-1,19,21.3,0,0,-1,2,-1,-1,-2,0
"6470",2019-01-26,"Washington Gulch","w1819","Mechanized",0,"Sat","weekend","no_sled","Washington Gulch","3","3","2",8.3,0,39,-1,19,21.3,0,0,-1,2,-1,-1,-2,0
"6471",2019-01-26,"Washington Gulch","w1819","Motorized",0,"Sat","weekend","sled","Washington Gulch","3","3","2",8.3,0,39,-1,19,21.3,0,0,-1,2,-1,-1,-2,0
"6472",2019-01-26,"Washington Gulch","w1819","Hybrid",0,"Sat","weekend","sled","Washington Gulch","3","3","2",8.3,0,39,-1,19,21.3,0,0,-1,2,-1,-1,-2,0
"6473",2019-01-27,"Washington Gulch","w1819","Non.motorized",0,"Sun","weekend","no_sled","Washington Gulch","3","3","2",8.3,0,38,-1,24,21.8,-1,0,0,-1,-2,-2,-2,-3
"6474",2019-01-27,"Washington Gulch","w1819","Mechanized",0,"Sun","weekend","no_sled","Washington Gulch","3","3","2",8.3,0,38,-1,24,21.8,-1,0,0,-1,-2,-2,-2,-3
"6475",2019-01-27,"Washington Gulch","w1819","Motorized",0,"Sun","weekend","sled","Washington Gulch","3","3","2",8.3,0,38,-1,24,21.8,-1,0,0,-1,-2,-2,-2,-3
"6476",2019-01-27,"Washington Gulch","w1819","Hybrid",0,"Sun","weekend","sled","Washington Gulch","3","3","2",8.3,0,38,-1,24,21.8,-1,0,0,-1,-2,-2,-2,-3
"6477",2019-01-28,"Washington Gulch","w1819","Non.motorized",0,"Mon","weekday","no_sled","Washington Gulch","2","2","2",8.3,0,38,0,17,21.8,-1,-1,0,0,-1,-2,-2,-2
"6478",2019-01-28,"Washington Gulch","w1819","Mechanized",0,"Mon","weekday","no_sled","Washington Gulch","2","2","2",8.3,0,38,0,17,21.8,-1,-1,0,0,-1,-2,-2,-2
"6479",2019-01-28,"Washington Gulch","w1819","Motorized",0,"Mon","weekday","sled","Washington Gulch","2","2","2",8.3,0,38,0,17,21.8,-1,-1,0,0,-1,-2,-2,-2
"6480",2019-01-28,"Washington Gulch","w1819","Hybrid",0,"Mon","weekday","sled","Washington Gulch","2","2","2",8.3,0,38,0,17,21.8,-1,-1,0,0,-1,-2,-2,-2
"6481",2019-01-29,"Washington Gulch","w1819","Non.motorized",0,"Tue","weekday","no_sled","Washington Gulch","2","2","2",8.3,0,38,0,16,21.8,0,-1,-1,0,0,-1,-2,-2
"6482",2019-01-29,"Washington Gulch","w1819","Mechanized",0,"Tue","weekday","no_sled","Washington Gulch","2","2","2",8.3,0,38,0,16,21.8,0,-1,-1,0,0,-1,-2,-2
"6483",2019-01-29,"Washington Gulch","w1819","Motorized",0,"Tue","weekday","sled","Washington Gulch","2","2","2",8.3,0,38,0,16,21.8,0,-1,-1,0,0,-1,-2,-2
"6484",2019-01-29,"Washington Gulch","w1819","Hybrid",0,"Tue","weekday","sled","Washington Gulch","2","2","2",8.3,0,38,0,16,21.8,0,-1,-1,0,0,-1,-2,-2
"6485",2019-01-30,"Washington Gulch","w1819","Non.motorized",0,"Wed","weekday","no_sled","Washington Gulch","2","2","1",8.3,0,37,-1,20,22.4,0,0,-1,-1,-1,-1,-2,-3
"6486",2019-01-30,"Washington Gulch","w1819","Mechanized",0,"Wed","weekday","no_sled","Washington Gulch","2","2","1",8.3,0,37,-1,20,22.4,0,0,-1,-1,-1,-1,-2,-3
"6487",2019-01-30,"Washington Gulch","w1819","Motorized",0,"Wed","weekday","sled","Washington Gulch","2","2","1",8.3,0,37,-1,20,22.4,0,0,-1,-1,-1,-1,-2,-3
"6488",2019-01-30,"Washington Gulch","w1819","Hybrid",0,"Wed","weekday","sled","Washington Gulch","2","2","1",8.3,0,37,-1,20,22.4,0,0,-1,-1,-1,-1,-2,-3
"6489",2019-01-31,"Washington Gulch","w1819","Non.motorized",0,"Thu","weekday","no_sled","Washington Gulch","2","2","1",8.3,0,36,-1,24,23.1,-1,0,0,-1,-2,-2,-2,-3
"6490",2019-01-31,"Washington Gulch","w1819","Mechanized",0,"Thu","weekday","no_sled","Washington Gulch","2","2","1",8.3,0,36,-1,24,23.1,-1,0,0,-1,-2,-2,-2,-3
"6491",2019-01-31,"Washington Gulch","w1819","Motorized",0,"Thu","weekday","sled","Washington Gulch","2","2","1",8.3,0,36,-1,24,23.1,-1,0,0,-1,-2,-2,-2,-3
"6492",2019-01-31,"Washington Gulch","w1819","Hybrid",0,"Thu","weekday","sled","Washington Gulch","2","2","1",8.3,0,36,-1,24,23.1,-1,0,0,-1,-2,-2,-2,-3
"6493",2019-02-01,"Washington Gulch","w1819","Non.motorized",0,"Fri","weekday","no_sled","Washington Gulch","2","2","1",8.3,0,36,0,25,23.1,-1,-1,0,0,-1,-2,-2,-2
"6494",2019-02-01,"Washington Gulch","w1819","Mechanized",0,"Fri","weekday","no_sled","Washington Gulch","2","2","1",8.3,0,36,0,25,23.1,-1,-1,0,0,-1,-2,-2,-2
"6495",2019-02-01,"Washington Gulch","w1819","Motorized",0,"Fri","weekday","sled","Washington Gulch","2","2","1",8.3,0,36,0,25,23.1,-1,-1,0,0,-1,-2,-2,-2
"6496",2019-02-01,"Washington Gulch","w1819","Hybrid",0,"Fri","weekday","sled","Washington Gulch","2","2","1",8.3,0,36,0,25,23.1,-1,-1,0,0,-1,-2,-2,-2
"6497",2019-02-02,"Washington Gulch","w1819","Non.motorized",0,"Sat","weekend","no_sled","Washington Gulch","2","2","1",8.3,0,36,0,26,23.1,0,-1,-1,0,0,-1,-2,-2
"6498",2019-02-02,"Washington Gulch","w1819","Mechanized",0,"Sat","weekend","no_sled","Washington Gulch","2","2","1",8.3,0,36,0,26,23.1,0,-1,-1,0,0,-1,-2,-2
"6499",2019-02-02,"Washington Gulch","w1819","Motorized",0,"Sat","weekend","sled","Washington Gulch","2","2","1",8.3,0,36,0,26,23.1,0,-1,-1,0,0,-1,-2,-2
"6500",2019-02-02,"Washington Gulch","w1819","Hybrid",0,"Sat","weekend","sled","Washington Gulch","2","2","1",8.3,0,36,0,26,23.1,0,-1,-1,0,0,-1,-2,-2
"6501",2019-02-03,"Washington Gulch","w1819","Non.motorized",0,"Sun","weekend","no_sled","Washington Gulch","3","3","2",8.4,0.1,36,0,28,23.3,0,0,-1,-1,0,0,-1,-2
"6502",2019-02-03,"Washington Gulch","w1819","Mechanized",0,"Sun","weekend","no_sled","Washington Gulch","3","3","2",8.4,0.1,36,0,28,23.3,0,0,-1,-1,0,0,-1,-2
"6503",2019-02-03,"Washington Gulch","w1819","Motorized",0,"Sun","weekend","sled","Washington Gulch","3","3","2",8.4,0.1,36,0,28,23.3,0,0,-1,-1,0,0,-1,-2
"6504",2019-02-03,"Washington Gulch","w1819","Hybrid",0,"Sun","weekend","sled","Washington Gulch","3","3","2",8.4,0.1,36,0,28,23.3,0,0,-1,-1,0,0,-1,-2
"6505",2019-02-04,"Washington Gulch","w1819","Non.motorized",0,"Mon","weekday","no_sled","Washington Gulch","3","3","2",8.8,0.4,39,3,28,22.6,0,0,0,-1,3,3,3,2
"6506",2019-02-04,"Washington Gulch","w1819","Mechanized",0,"Mon","weekday","no_sled","Washington Gulch","3","3","2",8.8,0.4,39,3,28,22.6,0,0,0,-1,3,3,3,2
"6507",2019-02-04,"Washington Gulch","w1819","Motorized",0,"Mon","weekday","sled","Washington Gulch","3","3","2",8.8,0.4,39,3,28,22.6,0,0,0,-1,3,3,3,2
"6508",2019-02-04,"Washington Gulch","w1819","Hybrid",0,"Mon","weekday","sled","Washington Gulch","3","3","2",8.8,0.4,39,3,28,22.6,0,0,0,-1,3,3,3,2
"6509",2019-02-05,"Washington Gulch","w1819","Non.motorized",2,"Tue","weekday","no_sled","Washington Gulch","3","2","2",9,0.2,40,1,26,22.5,3,0,0,0,4,4,4,4
"6510",2019-02-05,"Washington Gulch","w1819","Mechanized",0,"Tue","weekday","no_sled","Washington Gulch","3","2","2",9,0.2,40,1,26,22.5,3,0,0,0,4,4,4,4
"6511",2019-02-05,"Washington Gulch","w1819","Motorized",0,"Tue","weekday","sled","Washington Gulch","3","2","2",9,0.2,40,1,26,22.5,3,0,0,0,4,4,4,4
"6512",2019-02-05,"Washington Gulch","w1819","Hybrid",0,"Tue","weekday","sled","Washington Gulch","3","2","2",9,0.2,40,1,26,22.5,3,0,0,0,4,4,4,4
"6513",2019-02-06,"Washington Gulch","w1819","Non.motorized",3,"Wed","weekday","no_sled","Washington Gulch","4","4","3",9,0,40,0,16,22.5,1,3,0,0,1,4,4,4
"6514",2019-02-06,"Washington Gulch","w1819","Mechanized",0,"Wed","weekday","no_sled","Washington Gulch","4","4","3",9,0,40,0,16,22.5,1,3,0,0,1,4,4,4
"6515",2019-02-06,"Washington Gulch","w1819","Motorized",0,"Wed","weekday","sled","Washington Gulch","4","4","3",9,0,40,0,16,22.5,1,3,0,0,1,4,4,4
"6516",2019-02-06,"Washington Gulch","w1819","Hybrid",0,"Wed","weekday","sled","Washington Gulch","4","4","3",9,0,40,0,16,22.5,1,3,0,0,1,4,4,4
"6517",2019-02-07,"Washington Gulch","w1819","Non.motorized",19,"Thu","weekday","no_sled","Washington Gulch","3","3","2",9.2,0.2,43,3,4,21.4,0,1,3,0,3,4,7,7
"6518",2019-02-07,"Washington Gulch","w1819","Mechanized",0,"Thu","weekday","no_sled","Washington Gulch","3","3","2",9.2,0.2,43,3,4,21.4,0,1,3,0,3,4,7,7
"6519",2019-02-07,"Washington Gulch","w1819","Motorized",2,"Thu","weekday","sled","Washington Gulch","3","3","2",9.2,0.2,43,3,4,21.4,0,1,3,0,3,4,7,7
"6520",2019-02-07,"Washington Gulch","w1819","Hybrid",2,"Thu","weekday","sled","Washington Gulch","3","3","2",9.2,0.2,43,3,4,21.4,0,1,3,0,3,4,7,7
"6521",2019-02-08,"Washington Gulch","w1819","Non.motorized",0,"Fri","weekday","no_sled","Washington Gulch","3","2","2",9.2,0,42,-1,10,21.9,3,0,1,3,2,2,3,6
"6522",2019-02-08,"Washington Gulch","w1819","Mechanized",0,"Fri","weekday","no_sled","Washington Gulch","3","2","2",9.2,0,42,-1,10,21.9,3,0,1,3,2,2,3,6
"6523",2019-02-08,"Washington Gulch","w1819","Motorized",0,"Fri","weekday","sled","Washington Gulch","3","2","2",9.2,0,42,-1,10,21.9,3,0,1,3,2,2,3,6
"6524",2019-02-08,"Washington Gulch","w1819","Hybrid",0,"Fri","weekday","sled","Washington Gulch","3","2","2",9.2,0,42,-1,10,21.9,3,0,1,3,2,2,3,6
"6525",2019-02-09,"Washington Gulch","w1819","Non.motorized",5,"Sat","weekend","no_sled","Washington Gulch","3","2","2",9.2,0,41,-1,20,22.4,-1,3,0,1,-2,1,1,2
"6526",2019-02-09,"Washington Gulch","w1819","Mechanized",0,"Sat","weekend","no_sled","Washington Gulch","3","2","2",9.2,0,41,-1,20,22.4,-1,3,0,1,-2,1,1,2
"6527",2019-02-09,"Washington Gulch","w1819","Motorized",0,"Sat","weekend","sled","Washington Gulch","3","2","2",9.2,0,41,-1,20,22.4,-1,3,0,1,-2,1,1,2
"6528",2019-02-09,"Washington Gulch","w1819","Hybrid",0,"Sat","weekend","sled","Washington Gulch","3","2","2",9.2,0,41,-1,20,22.4,-1,3,0,1,-2,1,1,2
"6529",2019-02-10,"Washington Gulch","w1819","Non.motorized",0,"Sun","weekend","no_sled","Washington Gulch","2","2","2",9.3,0.1,40,-1,20,23.2,-1,-1,3,0,-2,-3,0,0
"6530",2019-02-10,"Washington Gulch","w1819","Mechanized",0,"Sun","weekend","no_sled","Washington Gulch","2","2","2",9.3,0.1,40,-1,20,23.2,-1,-1,3,0,-2,-3,0,0
"6531",2019-02-10,"Washington Gulch","w1819","Motorized",0,"Sun","weekend","sled","Washington Gulch","2","2","2",9.3,0.1,40,-1,20,23.2,-1,-1,3,0,-2,-3,0,0
"6532",2019-02-10,"Washington Gulch","w1819","Hybrid",0,"Sun","weekend","sled","Washington Gulch","2","2","2",9.3,0.1,40,-1,20,23.2,-1,-1,3,0,-2,-3,0,0
"6533",2019-02-11,"Washington Gulch","w1819","Non.motorized",0,"Mon","weekday","no_sled","Washington Gulch","2","2","1",9.3,0,40,0,15,23.2,-1,-1,-1,3,-1,-2,-3,0
"6534",2019-02-11,"Washington Gulch","w1819","Mechanized",0,"Mon","weekday","no_sled","Washington Gulch","2","2","1",9.3,0,40,0,15,23.2,-1,-1,-1,3,-1,-2,-3,0
"6535",2019-02-11,"Washington Gulch","w1819","Motorized",0,"Mon","weekday","sled","Washington Gulch","2","2","1",9.3,0,40,0,15,23.2,-1,-1,-1,3,-1,-2,-3,0
"6536",2019-02-11,"Washington Gulch","w1819","Hybrid",0,"Mon","weekday","sled","Washington Gulch","2","2","1",9.3,0,40,0,15,23.2,-1,-1,-1,3,-1,-2,-3,0
"6537",2019-02-12,"Washington Gulch","w1819","Non.motorized",0,"Tue","weekday","no_sled","Washington Gulch","2","2","1",9.3,0,40,0,18,23.2,0,-1,-1,-1,0,-1,-2,-3
"6538",2019-02-12,"Washington Gulch","w1819","Mechanized",0,"Tue","weekday","no_sled","Washington Gulch","2","2","1",9.3,0,40,0,18,23.2,0,-1,-1,-1,0,-1,-2,-3
"6539",2019-02-12,"Washington Gulch","w1819","Motorized",2,"Tue","weekday","sled","Washington Gulch","2","2","1",9.3,0,40,0,18,23.2,0,-1,-1,-1,0,-1,-2,-3
"6540",2019-02-12,"Washington Gulch","w1819","Hybrid",0,"Tue","weekday","sled","Washington Gulch","2","2","1",9.3,0,40,0,18,23.2,0,-1,-1,-1,0,-1,-2,-3
"6541",2019-02-13,"Washington Gulch","w1819","Non.motorized",NA,"Wed","weekday","no_sled","Washington Gulch","2","2","1",9.4,0.1,40,0,26,23.5,0,0,-1,-1,0,0,-1,-2
"6542",2019-02-13,"Washington Gulch","w1819","Mechanized",NA,"Wed","weekday","no_sled","Washington Gulch","2","2","1",9.4,0.1,40,0,26,23.5,0,0,-1,-1,0,0,-1,-2
"6543",2019-02-13,"Washington Gulch","w1819","Motorized",NA,"Wed","weekday","sled","Washington Gulch","2","2","1",9.4,0.1,40,0,26,23.5,0,0,-1,-1,0,0,-1,-2
"6544",2019-02-13,"Washington Gulch","w1819","Hybrid",NA,"Wed","weekday","sled","Washington Gulch","2","2","1",9.4,0.1,40,0,26,23.5,0,0,-1,-1,0,0,-1,-2
"6545",2019-02-14,"Washington Gulch","w1819","Non.motorized",NA,"Thu","weekday","no_sled","Washington Gulch","3","2","2",9.7,0.3,41,1,29,23.7,0,0,0,-1,1,1,1,0
"6546",2019-02-14,"Washington Gulch","w1819","Mechanized",NA,"Thu","weekday","no_sled","Washington Gulch","3","2","2",9.7,0.3,41,1,29,23.7,0,0,0,-1,1,1,1,0
"6547",2019-02-14,"Washington Gulch","w1819","Motorized",NA,"Thu","weekday","sled","Washington Gulch","3","2","2",9.7,0.3,41,1,29,23.7,0,0,0,-1,1,1,1,0
"6548",2019-02-14,"Washington Gulch","w1819","Hybrid",NA,"Thu","weekday","sled","Washington Gulch","3","2","2",9.7,0.3,41,1,29,23.7,0,0,0,-1,1,1,1,0
"6549",2019-02-15,"Washington Gulch","w1819","Non.motorized",1,"Fri","weekday","no_sled","Washington Gulch","4","4","3",10.8,1.1,51,10,27,21.2,1,0,0,0,11,11,11,11
"6550",2019-02-15,"Washington Gulch","w1819","Mechanized",0,"Fri","weekday","no_sled","Washington Gulch","4","4","3",10.8,1.1,51,10,27,21.2,1,0,0,0,11,11,11,11
"6551",2019-02-15,"Washington Gulch","w1819","Motorized",0,"Fri","weekday","sled","Washington Gulch","4","4","3",10.8,1.1,51,10,27,21.2,1,0,0,0,11,11,11,11
"6552",2019-02-15,"Washington Gulch","w1819","Hybrid",0,"Fri","weekday","sled","Washington Gulch","4","4","3",10.8,1.1,51,10,27,21.2,1,0,0,0,11,11,11,11
"6553",2019-02-16,"Washington Gulch","w1819","Non.motorized",0,"Sat","weekend","no_sled","Washington Gulch","3","3","3",11.1,0.3,52,1,14,21.3,10,1,0,0,11,12,12,12
"6554",2019-02-16,"Washington Gulch","w1819","Mechanized",0,"Sat","weekend","no_sled","Washington Gulch","3","3","3",11.1,0.3,52,1,14,21.3,10,1,0,0,11,12,12,12
"6555",2019-02-16,"Washington Gulch","w1819","Motorized",0,"Sat","weekend","sled","Washington Gulch","3","3","3",11.1,0.3,52,1,14,21.3,10,1,0,0,11,12,12,12
"6556",2019-02-16,"Washington Gulch","w1819","Hybrid",0,"Sat","weekend","sled","Washington Gulch","3","3","3",11.1,0.3,52,1,14,21.3,10,1,0,0,11,12,12,12
"6557",2019-02-17,"Washington Gulch","w1819","Non.motorized",0,"Sun","weekend","no_sled","Washington Gulch","3","3","3",11.3,0.2,55,3,10,20.5,1,10,1,0,4,14,15,15
"6558",2019-02-17,"Washington Gulch","w1819","Mechanized",0,"Sun","weekend","no_sled","Washington Gulch","3","3","3",11.3,0.2,55,3,10,20.5,1,10,1,0,4,14,15,15
"6559",2019-02-17,"Washington Gulch","w1819","Motorized",0,"Sun","weekend","sled","Washington Gulch","3","3","3",11.3,0.2,55,3,10,20.5,1,10,1,0,4,14,15,15
"6560",2019-02-17,"Washington Gulch","w1819","Hybrid",0,"Sun","weekend","sled","Washington Gulch","3","3","3",11.3,0.2,55,3,10,20.5,1,10,1,0,4,14,15,15
"6561",2019-02-18,"Washington Gulch","w1819","Non.motorized",0,"Mon","weekday","no_sled","Washington Gulch","3","3","2",11.4,0.1,53,-2,13,21.5,3,1,10,1,1,2,12,13
"6562",2019-02-18,"Washington Gulch","w1819","Mechanized",0,"Mon","weekday","no_sled","Washington Gulch","3","3","2",11.4,0.1,53,-2,13,21.5,3,1,10,1,1,2,12,13
"6563",2019-02-18,"Washington Gulch","w1819","Motorized",0,"Mon","weekday","sled","Washington Gulch","3","3","2",11.4,0.1,53,-2,13,21.5,3,1,10,1,1,2,12,13
"6564",2019-02-18,"Washington Gulch","w1819","Hybrid",0,"Mon","weekday","sled","Washington Gulch","3","3","2",11.4,0.1,53,-2,13,21.5,3,1,10,1,1,2,12,13
"6565",2019-02-19,"Washington Gulch","w1819","Non.motorized",0,"Tue","weekday","no_sled","Washington Gulch","3","3","2",11.5,0.1,53,0,11,21.7,-2,3,1,10,-2,1,2,12
"6566",2019-02-19,"Washington Gulch","w1819","Mechanized",0,"Tue","weekday","no_sled","Washington Gulch","3","3","2",11.5,0.1,53,0,11,21.7,-2,3,1,10,-2,1,2,12
"6567",2019-02-19,"Washington Gulch","w1819","Motorized",0,"Tue","weekday","sled","Washington Gulch","3","3","2",11.5,0.1,53,0,11,21.7,-2,3,1,10,-2,1,2,12
"6568",2019-02-19,"Washington Gulch","w1819","Hybrid",0,"Tue","weekday","sled","Washington Gulch","3","3","2",11.5,0.1,53,0,11,21.7,-2,3,1,10,-2,1,2,12
"6569",2019-02-20,"Washington Gulch","w1819","Non.motorized",0,"Wed","weekday","no_sled","Washington Gulch","3","3","2",11.6,0.1,53,0,7,21.9,0,-2,3,1,0,-2,1,2
"6570",2019-02-20,"Washington Gulch","w1819","Mechanized",0,"Wed","weekday","no_sled","Washington Gulch","3","3","2",11.6,0.1,53,0,7,21.9,0,-2,3,1,0,-2,1,2
"6571",2019-02-20,"Washington Gulch","w1819","Motorized",0,"Wed","weekday","sled","Washington Gulch","3","3","2",11.6,0.1,53,0,7,21.9,0,-2,3,1,0,-2,1,2
"6572",2019-02-20,"Washington Gulch","w1819","Hybrid",0,"Wed","weekday","sled","Washington Gulch","3","3","2",11.6,0.1,53,0,7,21.9,0,-2,3,1,0,-2,1,2
"6573",2019-02-21,"Washington Gulch","w1819","Non.motorized",0,"Thu","weekday","no_sled","Washington Gulch","3","3","3",11.6,0,52,-1,15,22.3,0,0,-2,3,-1,-1,-3,0
"6574",2019-02-21,"Washington Gulch","w1819","Mechanized",0,"Thu","weekday","no_sled","Washington Gulch","3","3","3",11.6,0,52,-1,15,22.3,0,0,-2,3,-1,-1,-3,0
"6575",2019-02-21,"Washington Gulch","w1819","Motorized",0,"Thu","weekday","sled","Washington Gulch","3","3","3",11.6,0,52,-1,15,22.3,0,0,-2,3,-1,-1,-3,0
"6576",2019-02-21,"Washington Gulch","w1819","Hybrid",0,"Thu","weekday","sled","Washington Gulch","3","3","3",11.6,0,52,-1,15,22.3,0,0,-2,3,-1,-1,-3,0
"6577",2019-02-22,"Washington Gulch","w1819","Non.motorized",0,"Fri","weekday","no_sled","Washington Gulch","3","3","3",11.8,0.2,52,0,20,22.7,-1,0,0,-2,-1,-1,-1,-3
"6578",2019-02-22,"Washington Gulch","w1819","Mechanized",0,"Fri","weekday","no_sled","Washington Gulch","3","3","3",11.8,0.2,52,0,20,22.7,-1,0,0,-2,-1,-1,-1,-3
"6579",2019-02-22,"Washington Gulch","w1819","Motorized",0,"Fri","weekday","sled","Washington Gulch","3","3","3",11.8,0.2,52,0,20,22.7,-1,0,0,-2,-1,-1,-1,-3
"6580",2019-02-22,"Washington Gulch","w1819","Hybrid",0,"Fri","weekday","sled","Washington Gulch","3","3","3",11.8,0.2,52,0,20,22.7,-1,0,0,-2,-1,-1,-1,-3
"6581",2019-02-23,"Washington Gulch","w1819","Non.motorized",11,"Sat","weekend","no_sled","Washington Gulch","3","3","3",12.1,0.3,53,1,13,22.8,0,-1,0,0,1,0,0,0
"6582",2019-02-23,"Washington Gulch","w1819","Mechanized",0,"Sat","weekend","no_sled","Washington Gulch","3","3","3",12.1,0.3,53,1,13,22.8,0,-1,0,0,1,0,0,0
"6583",2019-02-23,"Washington Gulch","w1819","Motorized",13,"Sat","weekend","sled","Washington Gulch","3","3","3",12.1,0.3,53,1,13,22.8,0,-1,0,0,1,0,0,0
"6584",2019-02-23,"Washington Gulch","w1819","Hybrid",6,"Sat","weekend","sled","Washington Gulch","3","3","3",12.1,0.3,53,1,13,22.8,0,-1,0,0,1,0,0,0
"6585",2019-02-24,"Washington Gulch","w1819","Non.motorized",24,"Sun","weekend","no_sled","Washington Gulch","3","3","2",12.1,0,52,-1,14,23.3,1,0,-1,0,0,0,-1,-1
"6586",2019-02-24,"Washington Gulch","w1819","Mechanized",0,"Sun","weekend","no_sled","Washington Gulch","3","3","2",12.1,0,52,-1,14,23.3,1,0,-1,0,0,0,-1,-1
"6587",2019-02-24,"Washington Gulch","w1819","Motorized",4,"Sun","weekend","sled","Washington Gulch","3","3","2",12.1,0,52,-1,14,23.3,1,0,-1,0,0,0,-1,-1
"6588",2019-02-24,"Washington Gulch","w1819","Hybrid",2,"Sun","weekend","sled","Washington Gulch","3","3","2",12.1,0,52,-1,14,23.3,1,0,-1,0,0,0,-1,-1
"6589",2019-02-25,"Washington Gulch","w1819","Non.motorized",11,"Mon","weekday","no_sled","Washington Gulch","3","3","2",12.1,0,51,-1,22,23.7,-1,1,0,-1,-2,-1,-1,-2
"6590",2019-02-25,"Washington Gulch","w1819","Mechanized",0,"Mon","weekday","no_sled","Washington Gulch","3","3","2",12.1,0,51,-1,22,23.7,-1,1,0,-1,-2,-1,-1,-2
"6591",2019-02-25,"Washington Gulch","w1819","Motorized",3,"Mon","weekday","sled","Washington Gulch","3","3","2",12.1,0,51,-1,22,23.7,-1,1,0,-1,-2,-1,-1,-2
"6592",2019-02-25,"Washington Gulch","w1819","Hybrid",0,"Mon","weekday","sled","Washington Gulch","3","3","2",12.1,0,51,-1,22,23.7,-1,1,0,-1,-2,-1,-1,-2
"6593",2019-02-26,"Washington Gulch","w1819","Non.motorized",38,"Tue","weekday","no_sled","Washington Gulch","2","2","2",12.1,0,50,-1,27,24.2,-1,-1,1,0,-2,-3,-2,-2
"6594",2019-02-26,"Washington Gulch","w1819","Mechanized",0,"Tue","weekday","no_sled","Washington Gulch","2","2","2",12.1,0,50,-1,27,24.2,-1,-1,1,0,-2,-3,-2,-2
"6595",2019-02-26,"Washington Gulch","w1819","Motorized",7,"Tue","weekday","sled","Washington Gulch","2","2","2",12.1,0,50,-1,27,24.2,-1,-1,1,0,-2,-3,-2,-2
"6596",2019-02-26,"Washington Gulch","w1819","Hybrid",1,"Tue","weekday","sled","Washington Gulch","2","2","2",12.1,0,50,-1,27,24.2,-1,-1,1,0,-2,-3,-2,-2
"6597",2019-02-27,"Washington Gulch","w1819","Non.motorized",49,"Wed","weekday","no_sled","Washington Gulch","2","2","2",12.1,0,50,0,30,24.2,-1,-1,-1,1,-1,-2,-3,-2
"6598",2019-02-27,"Washington Gulch","w1819","Mechanized",0,"Wed","weekday","no_sled","Washington Gulch","2","2","2",12.1,0,50,0,30,24.2,-1,-1,-1,1,-1,-2,-3,-2
"6599",2019-02-27,"Washington Gulch","w1819","Motorized",0,"Wed","weekday","sled","Washington Gulch","2","2","2",12.1,0,50,0,30,24.2,-1,-1,-1,1,-1,-2,-3,-2
"6600",2019-02-27,"Washington Gulch","w1819","Hybrid",0,"Wed","weekday","sled","Washington Gulch","2","2","2",12.1,0,50,0,30,24.2,-1,-1,-1,1,-1,-2,-3,-2
"6601",2019-02-28,"Washington Gulch","w1819","Non.motorized",8,"Thu","weekday","no_sled","Washington Gulch","2","2","2",12.2,0.1,49,-1,30,24.9,0,-1,-1,-1,-1,-2,-3,-4
"6602",2019-02-28,"Washington Gulch","w1819","Mechanized",0,"Thu","weekday","no_sled","Washington Gulch","2","2","2",12.2,0.1,49,-1,30,24.9,0,-1,-1,-1,-1,-2,-3,-4
"6603",2019-02-28,"Washington Gulch","w1819","Motorized",2,"Thu","weekday","sled","Washington Gulch","2","2","2",12.2,0.1,49,-1,30,24.9,0,-1,-1,-1,-1,-2,-3,-4
"6604",2019-02-28,"Washington Gulch","w1819","Hybrid",2,"Thu","weekday","sled","Washington Gulch","2","2","2",12.2,0.1,49,-1,30,24.9,0,-1,-1,-1,-1,-2,-3,-4
"6605",2019-03-01,"Washington Gulch","w1819","Non.motorized",7,"Fri","weekday","no_sled","Washington Gulch","2","2","1",12.3,0.1,49,0,29,25.1,-1,0,-1,-1,-1,-1,-2,-3
"6606",2019-03-01,"Washington Gulch","w1819","Mechanized",0,"Fri","weekday","no_sled","Washington Gulch","2","2","1",12.3,0.1,49,0,29,25.1,-1,0,-1,-1,-1,-1,-2,-3
"6607",2019-03-01,"Washington Gulch","w1819","Motorized",0,"Fri","weekday","sled","Washington Gulch","2","2","1",12.3,0.1,49,0,29,25.1,-1,0,-1,-1,-1,-1,-2,-3
"6608",2019-03-01,"Washington Gulch","w1819","Hybrid",0,"Fri","weekday","sled","Washington Gulch","2","2","1",12.3,0.1,49,0,29,25.1,-1,0,-1,-1,-1,-1,-2,-3
"6609",2019-03-02,"Washington Gulch","w1819","Non.motorized",0,"Sat","weekend","no_sled","Washington Gulch","3","3","2",13,0.7,58,9,30,22.4,0,-1,0,-1,9,8,8,7
"6610",2019-03-02,"Washington Gulch","w1819","Mechanized",0,"Sat","weekend","no_sled","Washington Gulch","3","3","2",13,0.7,58,9,30,22.4,0,-1,0,-1,9,8,8,7
"6611",2019-03-02,"Washington Gulch","w1819","Motorized",0,"Sat","weekend","sled","Washington Gulch","3","3","2",13,0.7,58,9,30,22.4,0,-1,0,-1,9,8,8,7
"6612",2019-03-02,"Washington Gulch","w1819","Hybrid",0,"Sat","weekend","sled","Washington Gulch","3","3","2",13,0.7,58,9,30,22.4,0,-1,0,-1,9,8,8,7
"6613",2019-03-03,"Washington Gulch","w1819","Non.motorized",0,"Sun","weekend","no_sled","Washington Gulch","3","3","3",13.7,0.7,64,6,27,21.4,9,0,-1,0,15,15,14,14
"6614",2019-03-03,"Washington Gulch","w1819","Mechanized",0,"Sun","weekend","no_sled","Washington Gulch","3","3","3",13.7,0.7,64,6,27,21.4,9,0,-1,0,15,15,14,14
"6615",2019-03-03,"Washington Gulch","w1819","Motorized",0,"Sun","weekend","sled","Washington Gulch","3","3","3",13.7,0.7,64,6,27,21.4,9,0,-1,0,15,15,14,14
"6616",2019-03-03,"Washington Gulch","w1819","Hybrid",0,"Sun","weekend","sled","Washington Gulch","3","3","3",13.7,0.7,64,6,27,21.4,9,0,-1,0,15,15,14,14
"6617",2019-03-04,"Washington Gulch","w1819","Non.motorized",4,"Mon","weekday","no_sled","Washington Gulch","3","3","3",14.4,0.7,66,2,23,21.8,6,9,0,-1,8,17,17,16
"6618",2019-03-04,"Washington Gulch","w1819","Mechanized",0,"Mon","weekday","no_sled","Washington Gulch","3","3","3",14.4,0.7,66,2,23,21.8,6,9,0,-1,8,17,17,16
"6619",2019-03-04,"Washington Gulch","w1819","Motorized",0,"Mon","weekday","sled","Washington Gulch","3","3","3",14.4,0.7,66,2,23,21.8,6,9,0,-1,8,17,17,16
"6620",2019-03-04,"Washington Gulch","w1819","Hybrid",0,"Mon","weekday","sled","Washington Gulch","3","3","3",14.4,0.7,66,2,23,21.8,6,9,0,-1,8,17,17,16
"6621",2019-03-05,"Washington Gulch","w1819","Non.motorized",12,"Tue","weekday","no_sled","Washington Gulch","3","3","3",14.4,0,64,-2,24,22.5,2,6,9,0,0,6,15,15
"6622",2019-03-05,"Washington Gulch","w1819","Mechanized",0,"Tue","weekday","no_sled","Washington Gulch","3","3","3",14.4,0,64,-2,24,22.5,2,6,9,0,0,6,15,15
"6623",2019-03-05,"Washington Gulch","w1819","Motorized",14,"Tue","weekday","sled","Washington Gulch","3","3","3",14.4,0,64,-2,24,22.5,2,6,9,0,0,6,15,15
"6624",2019-03-05,"Washington Gulch","w1819","Hybrid",8,"Tue","weekday","sled","Washington Gulch","3","3","3",14.4,0,64,-2,24,22.5,2,6,9,0,0,6,15,15
"6625",2019-03-06,"Washington Gulch","w1819","Non.motorized",12,"Wed","weekday","no_sled","Washington Gulch","3","3","2",14.5,0.1,62,-2,31,23.4,-2,2,6,9,-4,-2,4,13
"6626",2019-03-06,"Washington Gulch","w1819","Non.motorized",12,"Wed","weekday","no_sled","Washington Gulch","4","4","3",14.5,0.1,62,-2,31,23.4,-2,2,6,9,-4,-2,4,13
"6627",2019-03-06,"Washington Gulch","w1819","Mechanized",0,"Wed","weekday","no_sled","Washington Gulch","3","3","2",14.5,0.1,62,-2,31,23.4,-2,2,6,9,-4,-2,4,13
"6628",2019-03-06,"Washington Gulch","w1819","Mechanized",0,"Wed","weekday","no_sled","Washington Gulch","4","4","3",14.5,0.1,62,-2,31,23.4,-2,2,6,9,-4,-2,4,13
"6629",2019-03-06,"Washington Gulch","w1819","Motorized",0,"Wed","weekday","sled","Washington Gulch","3","3","2",14.5,0.1,62,-2,31,23.4,-2,2,6,9,-4,-2,4,13
"6630",2019-03-06,"Washington Gulch","w1819","Motorized",0,"Wed","weekday","sled","Washington Gulch","4","4","3",14.5,0.1,62,-2,31,23.4,-2,2,6,9,-4,-2,4,13
"6631",2019-03-06,"Washington Gulch","w1819","Hybrid",0,"Wed","weekday","sled","Washington Gulch","3","3","2",14.5,0.1,62,-2,31,23.4,-2,2,6,9,-4,-2,4,13
"6632",2019-03-06,"Washington Gulch","w1819","Hybrid",0,"Wed","weekday","sled","Washington Gulch","4","4","3",14.5,0.1,62,-2,31,23.4,-2,2,6,9,-4,-2,4,13
"6633",2019-03-07,"Washington Gulch","w1819","Non.motorized",0,"Thu","weekday","no_sled","Washington Gulch","4","4","3",16.2,1.7,71,9,30,22.8,-2,-2,2,6,7,5,7,13
"6634",2019-03-07,"Washington Gulch","w1819","Mechanized",0,"Thu","weekday","no_sled","Washington Gulch","4","4","3",16.2,1.7,71,9,30,22.8,-2,-2,2,6,7,5,7,13
"6635",2019-03-07,"Washington Gulch","w1819","Motorized",0,"Thu","weekday","sled","Washington Gulch","4","4","3",16.2,1.7,71,9,30,22.8,-2,-2,2,6,7,5,7,13
"6636",2019-03-07,"Washington Gulch","w1819","Hybrid",0,"Thu","weekday","sled","Washington Gulch","4","4","3",16.2,1.7,71,9,30,22.8,-2,-2,2,6,7,5,7,13
"6637",2019-03-08,"Washington Gulch","w1819","Non.motorized",0,"Fri","weekday","no_sled","Washington Gulch","3","3","3",16.6,0.4,71,0,27,23.4,9,-2,-2,2,9,7,5,7
"6638",2019-03-08,"Washington Gulch","w1819","Mechanized",0,"Fri","weekday","no_sled","Washington Gulch","3","3","3",16.6,0.4,71,0,27,23.4,9,-2,-2,2,9,7,5,7
"6639",2019-03-08,"Washington Gulch","w1819","Motorized",3,"Fri","weekday","sled","Washington Gulch","3","3","3",16.6,0.4,71,0,27,23.4,9,-2,-2,2,9,7,5,7
"6640",2019-03-08,"Washington Gulch","w1819","Hybrid",1,"Fri","weekday","sled","Washington Gulch","3","3","3",16.6,0.4,71,0,27,23.4,9,-2,-2,2,9,7,5,7
"6641",2019-03-09,"Washington Gulch","w1819","Non.motorized",37,"Sat","weekend","no_sled","Washington Gulch","4","4","3",17.2,0.6,76,5,22,22.6,0,9,-2,-2,5,14,12,10
"6642",2019-03-09,"Washington Gulch","w1819","Mechanized",0,"Sat","weekend","no_sled","Washington Gulch","4","4","3",17.2,0.6,76,5,22,22.6,0,9,-2,-2,5,14,12,10
"6643",2019-03-09,"Washington Gulch","w1819","Motorized",5,"Sat","weekend","sled","Washington Gulch","4","4","3",17.2,0.6,76,5,22,22.6,0,9,-2,-2,5,14,12,10
"6644",2019-03-09,"Washington Gulch","w1819","Hybrid",0,"Sat","weekend","sled","Washington Gulch","4","4","3",17.2,0.6,76,5,22,22.6,0,9,-2,-2,5,14,12,10
"6645",2019-03-10,"Washington Gulch","w1819","Non.motorized",44,"Sun","weekend","no_sled","Washington Gulch","3","3","3",17.3,0.1,73,-3,25,23.7,5,0,9,-2,2,2,11,9
"6646",2019-03-10,"Washington Gulch","w1819","Mechanized",0,"Sun","weekend","no_sled","Washington Gulch","3","3","3",17.3,0.1,73,-3,25,23.7,5,0,9,-2,2,2,11,9
"6647",2019-03-10,"Washington Gulch","w1819","Motorized",8,"Sun","weekend","sled","Washington Gulch","3","3","3",17.3,0.1,73,-3,25,23.7,5,0,9,-2,2,2,11,9
"6648",2019-03-10,"Washington Gulch","w1819","Hybrid",2,"Sun","weekend","sled","Washington Gulch","3","3","3",17.3,0.1,73,-3,25,23.7,5,0,9,-2,2,2,11,9
"6649",2019-03-11,"Washington Gulch","w1819","Non.motorized",11,"Mon","weekday","no_sled","Washington Gulch","3","3","2",17.3,0,71,-2,29,24.4,-3,5,0,9,-5,0,0,9
"6650",2019-03-11,"Washington Gulch","w1819","Mechanized",0,"Mon","weekday","no_sled","Washington Gulch","3","3","2",17.3,0,71,-2,29,24.4,-3,5,0,9,-5,0,0,9
"6651",2019-03-11,"Washington Gulch","w1819","Motorized",0,"Mon","weekday","sled","Washington Gulch","3","3","2",17.3,0,71,-2,29,24.4,-3,5,0,9,-5,0,0,9
"6652",2019-03-11,"Washington Gulch","w1819","Hybrid",0,"Mon","weekday","sled","Washington Gulch","3","3","2",17.3,0,71,-2,29,24.4,-3,5,0,9,-5,0,0,9
"6653",2019-03-12,"Washington Gulch","w1819","Non.motorized",0,"Tue","weekday","no_sled","Washington Gulch","3","3","3",17.4,0.1,70,-1,32,24.9,-2,-3,5,0,-3,-6,-1,-1
"6654",2019-03-12,"Washington Gulch","w1819","Non.motorized",0,"Tue","weekday","no_sled","Washington Gulch","4","4","4",17.4,0.1,70,-1,32,24.9,-2,-3,5,0,-3,-6,-1,-1
"6655",2019-03-12,"Washington Gulch","w1819","Mechanized",0,"Tue","weekday","no_sled","Washington Gulch","3","3","3",17.4,0.1,70,-1,32,24.9,-2,-3,5,0,-3,-6,-1,-1
"6656",2019-03-12,"Washington Gulch","w1819","Mechanized",0,"Tue","weekday","no_sled","Washington Gulch","4","4","4",17.4,0.1,70,-1,32,24.9,-2,-3,5,0,-3,-6,-1,-1
"6657",2019-03-12,"Washington Gulch","w1819","Motorized",0,"Tue","weekday","sled","Washington Gulch","3","3","3",17.4,0.1,70,-1,32,24.9,-2,-3,5,0,-3,-6,-1,-1
"6658",2019-03-12,"Washington Gulch","w1819","Motorized",0,"Tue","weekday","sled","Washington Gulch","4","4","4",17.4,0.1,70,-1,32,24.9,-2,-3,5,0,-3,-6,-1,-1
"6659",2019-03-12,"Washington Gulch","w1819","Hybrid",0,"Tue","weekday","sled","Washington Gulch","3","3","3",17.4,0.1,70,-1,32,24.9,-2,-3,5,0,-3,-6,-1,-1
"6660",2019-03-12,"Washington Gulch","w1819","Hybrid",0,"Tue","weekday","sled","Washington Gulch","4","4","4",17.4,0.1,70,-1,32,24.9,-2,-3,5,0,-3,-6,-1,-1
"6661",2019-03-13,"Washington Gulch","w1819","Non.motorized",0,"Wed","weekday","no_sled","Washington Gulch","4","4","3",18.1,0.7,74,4,24,24.5,-1,-2,-3,5,3,1,-2,3
"6662",2019-03-13,"Washington Gulch","w1819","Mechanized",0,"Wed","weekday","no_sled","Washington Gulch","4","4","3",18.1,0.7,74,4,24,24.5,-1,-2,-3,5,3,1,-2,3
"6663",2019-03-13,"Washington Gulch","w1819","Motorized",0,"Wed","weekday","sled","Washington Gulch","4","4","3",18.1,0.7,74,4,24,24.5,-1,-2,-3,5,3,1,-2,3
"6664",2019-03-13,"Washington Gulch","w1819","Hybrid",0,"Wed","weekday","sled","Washington Gulch","4","4","3",18.1,0.7,74,4,24,24.5,-1,-2,-3,5,3,1,-2,3
"6665",2019-03-14,"Washington Gulch","w1819","Non.motorized",0,"Thu","weekday","no_sled","Washington Gulch","4","4","3",18.1,0,74,0,17,24.5,4,-1,-2,-3,4,3,1,-2
"6666",2019-03-14,"Washington Gulch","w1819","Mechanized",0,"Thu","weekday","no_sled","Washington Gulch","4","4","3",18.1,0,74,0,17,24.5,4,-1,-2,-3,4,3,1,-2
"6667",2019-03-14,"Washington Gulch","w1819","Motorized",0,"Thu","weekday","sled","Washington Gulch","4","4","3",18.1,0,74,0,17,24.5,4,-1,-2,-3,4,3,1,-2
"6668",2019-03-14,"Washington Gulch","w1819","Hybrid",0,"Thu","weekday","sled","Washington Gulch","4","4","3",18.1,0,74,0,17,24.5,4,-1,-2,-3,4,3,1,-2
"6669",2019-03-15,"Washington Gulch","w1819","Non.motorized",19,"Fri","weekday","no_sled","Washington Gulch","3","3","2",18.1,0,72,-2,18,25.1,0,4,-1,-2,-2,2,1,-1
"6670",2019-03-15,"Washington Gulch","w1819","Mechanized",0,"Fri","weekday","no_sled","Washington Gulch","3","3","2",18.1,0,72,-2,18,25.1,0,4,-1,-2,-2,2,1,-1
"6671",2019-03-15,"Washington Gulch","w1819","Motorized",13,"Fri","weekday","sled","Washington Gulch","3","3","2",18.1,0,72,-2,18,25.1,0,4,-1,-2,-2,2,1,-1
"6672",2019-03-15,"Washington Gulch","w1819","Hybrid",0,"Fri","weekday","sled","Washington Gulch","3","3","2",18.1,0,72,-2,18,25.1,0,4,-1,-2,-2,2,1,-1
"6673",2019-03-16,"Washington Gulch","w1819","Non.motorized",60,"Sat","weekend","no_sled","Washington Gulch","3","3","2",18.2,0.1,70,-2,26,26,-2,0,4,-1,-4,-4,0,-1
"6674",2019-03-16,"Washington Gulch","w1819","Mechanized",0,"Sat","weekend","no_sled","Washington Gulch","3","3","2",18.2,0.1,70,-2,26,26,-2,0,4,-1,-4,-4,0,-1
"6675",2019-03-16,"Washington Gulch","w1819","Motorized",17,"Sat","weekend","sled","Washington Gulch","3","3","2",18.2,0.1,70,-2,26,26,-2,0,4,-1,-4,-4,0,-1
"6676",2019-03-16,"Washington Gulch","w1819","Hybrid",0,"Sat","weekend","sled","Washington Gulch","3","3","2",18.2,0.1,70,-2,26,26,-2,0,4,-1,-4,-4,0,-1
"6677",2019-03-17,"Washington Gulch","w1819","Non.motorized",43,"Sun","weekend","no_sled","Washington Gulch","3","3","2",18.2,0,69,-1,28,26.4,-2,-2,0,4,-3,-5,-5,-1
"6678",2019-03-17,"Washington Gulch","w1819","Mechanized",0,"Sun","weekend","no_sled","Washington Gulch","3","3","2",18.2,0,69,-1,28,26.4,-2,-2,0,4,-3,-5,-5,-1
"6679",2019-03-17,"Washington Gulch","w1819","Motorized",24,"Sun","weekend","sled","Washington Gulch","3","3","2",18.2,0,69,-1,28,26.4,-2,-2,0,4,-3,-5,-5,-1
"6680",2019-03-17,"Washington Gulch","w1819","Hybrid",0,"Sun","weekend","sled","Washington Gulch","3","3","2",18.2,0,69,-1,28,26.4,-2,-2,0,4,-3,-5,-5,-1
"6681",2019-03-18,"Washington Gulch","w1819","Non.motorized",19,"Mon","weekday","no_sled","Washington Gulch","2","2","2",18.3,0.1,68,-1,29,26.9,-1,-2,-2,0,-2,-4,-6,-6
"6682",2019-03-18,"Washington Gulch","w1819","Mechanized",0,"Mon","weekday","no_sled","Washington Gulch","2","2","2",18.3,0.1,68,-1,29,26.9,-1,-2,-2,0,-2,-4,-6,-6
"6683",2019-03-18,"Washington Gulch","w1819","Motorized",13,"Mon","weekday","sled","Washington Gulch","2","2","2",18.3,0.1,68,-1,29,26.9,-1,-2,-2,0,-2,-4,-6,-6
"6684",2019-03-18,"Washington Gulch","w1819","Hybrid",0,"Mon","weekday","sled","Washington Gulch","2","2","2",18.3,0.1,68,-1,29,26.9,-1,-2,-2,0,-2,-4,-6,-6
"6685",2019-03-19,"Washington Gulch","w1819","Non.motorized",0,"Tue","weekday","no_sled","Washington Gulch","2","2","2",18.3,0,67,-1,28,27.3,-1,-1,-2,-2,-2,-3,-5,-7
"6686",2019-03-19,"Washington Gulch","w1819","Mechanized",0,"Tue","weekday","no_sled","Washington Gulch","2","2","2",18.3,0,67,-1,28,27.3,-1,-1,-2,-2,-2,-3,-5,-7
"6687",2019-03-19,"Washington Gulch","w1819","Motorized",0,"Tue","weekday","sled","Washington Gulch","2","2","2",18.3,0,67,-1,28,27.3,-1,-1,-2,-2,-2,-3,-5,-7
"6688",2019-03-19,"Washington Gulch","w1819","Hybrid",0,"Tue","weekday","sled","Washington Gulch","2","2","2",18.3,0,67,-1,28,27.3,-1,-1,-2,-2,-2,-3,-5,-7
"6689",2019-03-20,"Washington Gulch","w1819","Non.motorized",0,"Wed","weekday","no_sled","Washington Gulch","2","2","2",18.3,0,66,-1,30,27.7,-1,-1,-1,-2,-2,-3,-4,-6
"6690",2019-03-20,"Washington Gulch","w1819","Mechanized",0,"Wed","weekday","no_sled","Washington Gulch","2","2","2",18.3,0,66,-1,30,27.7,-1,-1,-1,-2,-2,-3,-4,-6
"6691",2019-03-20,"Washington Gulch","w1819","Motorized",0,"Wed","weekday","sled","Washington Gulch","2","2","2",18.3,0,66,-1,30,27.7,-1,-1,-1,-2,-2,-3,-4,-6
"6692",2019-03-20,"Washington Gulch","w1819","Hybrid",0,"Wed","weekday","sled","Washington Gulch","2","2","2",18.3,0,66,-1,30,27.7,-1,-1,-1,-2,-2,-3,-4,-6
"6693",2019-03-21,"Washington Gulch","w1819","Non.motorized",0,"Thu","weekday","no_sled","Washington Gulch","2","2","2",18.4,0.1,65,-1,33,28.3,-1,-1,-1,-1,-2,-3,-4,-5
"6694",2019-03-21,"Washington Gulch","w1819","Mechanized",0,"Thu","weekday","no_sled","Washington Gulch","2","2","2",18.4,0.1,65,-1,33,28.3,-1,-1,-1,-1,-2,-3,-4,-5
"6695",2019-03-21,"Washington Gulch","w1819","Motorized",0,"Thu","weekday","sled","Washington Gulch","2","2","2",18.4,0.1,65,-1,33,28.3,-1,-1,-1,-1,-2,-3,-4,-5
"6696",2019-03-21,"Washington Gulch","w1819","Hybrid",0,"Thu","weekday","sled","Washington Gulch","2","2","2",18.4,0.1,65,-1,33,28.3,-1,-1,-1,-1,-2,-3,-4,-5
"6697",2019-03-22,"Washington Gulch","w1819","Non.motorized",0,"Fri","weekday","no_sled","Washington Gulch","3","3","2",18.4,0,64,-1,28,28.8,-1,-1,-1,-1,-2,-3,-4,-5
"6698",2019-03-22,"Washington Gulch","w1819","Mechanized",0,"Fri","weekday","no_sled","Washington Gulch","3","3","2",18.4,0,64,-1,28,28.8,-1,-1,-1,-1,-2,-3,-4,-5
"6699",2019-03-22,"Washington Gulch","w1819","Motorized",0,"Fri","weekday","sled","Washington Gulch","3","3","2",18.4,0,64,-1,28,28.8,-1,-1,-1,-1,-2,-3,-4,-5
"6700",2019-03-22,"Washington Gulch","w1819","Hybrid",0,"Fri","weekday","sled","Washington Gulch","3","3","2",18.4,0,64,-1,28,28.8,-1,-1,-1,-1,-2,-3,-4,-5
"6701",2019-03-23,"Washington Gulch","w1819","Non.motorized",0,"Sat","weekend","no_sled","Washington Gulch","2","2","1",18.4,0,65,1,28,28.3,-1,-1,-1,-1,0,-1,-2,-3
"6702",2019-03-23,"Washington Gulch","w1819","Mechanized",0,"Sat","weekend","no_sled","Washington Gulch","2","2","1",18.4,0,65,1,28,28.3,-1,-1,-1,-1,0,-1,-2,-3
"6703",2019-03-23,"Washington Gulch","w1819","Motorized",0,"Sat","weekend","sled","Washington Gulch","2","2","1",18.4,0,65,1,28,28.3,-1,-1,-1,-1,0,-1,-2,-3
"6704",2019-03-23,"Washington Gulch","w1819","Hybrid",0,"Sat","weekend","sled","Washington Gulch","2","2","1",18.4,0,65,1,28,28.3,-1,-1,-1,-1,0,-1,-2,-3
"6705",2019-03-24,"Washington Gulch","w1819","Non.motorized",0,"Sun","weekend","no_sled","Washington Gulch","2","2","1",18.4,0,64,-1,29,28.8,1,-1,-1,-1,0,-1,-2,-3
"6706",2019-03-24,"Washington Gulch","w1819","Mechanized",0,"Sun","weekend","no_sled","Washington Gulch","2","2","1",18.4,0,64,-1,29,28.8,1,-1,-1,-1,0,-1,-2,-3
"6707",2019-03-24,"Washington Gulch","w1819","Motorized",0,"Sun","weekend","sled","Washington Gulch","2","2","1",18.4,0,64,-1,29,28.8,1,-1,-1,-1,0,-1,-2,-3
"6708",2019-03-24,"Washington Gulch","w1819","Hybrid",0,"Sun","weekend","sled","Washington Gulch","2","2","1",18.4,0,64,-1,29,28.8,1,-1,-1,-1,0,-1,-2,-3
"6709",2019-03-25,"Washington Gulch","w1819","Non.motorized",4,"Mon","weekday","no_sled","Washington Gulch","2","2","2",18.6,0.2,64,0,31,29.1,-1,1,-1,-1,-1,0,-1,-2
"6710",2019-03-25,"Washington Gulch","w1819","Mechanized",0,"Mon","weekday","no_sled","Washington Gulch","2","2","2",18.6,0.2,64,0,31,29.1,-1,1,-1,-1,-1,0,-1,-2
"6711",2019-03-25,"Washington Gulch","w1819","Motorized",1,"Mon","weekday","sled","Washington Gulch","2","2","2",18.6,0.2,64,0,31,29.1,-1,1,-1,-1,-1,0,-1,-2
"6712",2019-03-25,"Washington Gulch","w1819","Hybrid",0,"Mon","weekday","sled","Washington Gulch","2","2","2",18.6,0.2,64,0,31,29.1,-1,1,-1,-1,-1,0,-1,-2
"6713",2019-03-26,"Washington Gulch","w1819","Non.motorized",20,"Tue","weekday","no_sled","Washington Gulch","2","2","2",18.9,0.3,63,-1,36,30,0,-1,1,-1,-1,-2,-1,-2
"6714",2019-03-26,"Washington Gulch","w1819","Mechanized",0,"Tue","weekday","no_sled","Washington Gulch","2","2","2",18.9,0.3,63,-1,36,30,0,-1,1,-1,-1,-2,-1,-2
"6715",2019-03-26,"Washington Gulch","w1819","Motorized",0,"Tue","weekday","sled","Washington Gulch","2","2","2",18.9,0.3,63,-1,36,30,0,-1,1,-1,-1,-2,-1,-2
"6716",2019-03-26,"Washington Gulch","w1819","Hybrid",0,"Tue","weekday","sled","Washington Gulch","2","2","2",18.9,0.3,63,-1,36,30,0,-1,1,-1,-1,-2,-1,-2
"6717",2019-03-27,"Washington Gulch","w1819","Non.motorized",22,"Wed","weekday","no_sled","Washington Gulch","1","2","2",18.9,0,62,-1,42,30.5,-1,0,-1,1,-2,-2,-3,-2
"6718",2019-03-27,"Washington Gulch","w1819","Mechanized",0,"Wed","weekday","no_sled","Washington Gulch","1","2","2",18.9,0,62,-1,42,30.5,-1,0,-1,1,-2,-2,-3,-2
"6719",2019-03-27,"Washington Gulch","w1819","Motorized",2,"Wed","weekday","sled","Washington Gulch","1","2","2",18.9,0,62,-1,42,30.5,-1,0,-1,1,-2,-2,-3,-2
"6720",2019-03-27,"Washington Gulch","w1819","Hybrid",0,"Wed","weekday","sled","Washington Gulch","1","2","2",18.9,0,62,-1,42,30.5,-1,0,-1,1,-2,-2,-3,-2
"6721",2019-03-28,"Washington Gulch","w1819","Non.motorized",13,"Thu","weekday","no_sled","Washington Gulch","1","2","2",18.9,0,60,-2,40,31.5,-1,-1,0,-1,-3,-4,-4,-5
"6722",2019-03-28,"Washington Gulch","w1819","Mechanized",0,"Thu","weekday","no_sled","Washington Gulch","1","2","2",18.9,0,60,-2,40,31.5,-1,-1,0,-1,-3,-4,-4,-5
"6723",2019-03-28,"Washington Gulch","w1819","Motorized",5,"Thu","weekday","sled","Washington Gulch","1","2","2",18.9,0,60,-2,40,31.5,-1,-1,0,-1,-3,-4,-4,-5
"6724",2019-03-28,"Washington Gulch","w1819","Hybrid",0,"Thu","weekday","sled","Washington Gulch","1","2","2",18.9,0,60,-2,40,31.5,-1,-1,0,-1,-3,-4,-4,-5
"6725",2019-03-29,"Washington Gulch","w1819","Non.motorized",15,"Fri","weekday","no_sled","Washington Gulch","1","1","1",19,0.1,58,-2,26,32.8,-2,-1,-1,0,-4,-5,-6,-6
"6726",2019-03-29,"Washington Gulch","w1819","Mechanized",0,"Fri","weekday","no_sled","Washington Gulch","1","1","1",19,0.1,58,-2,26,32.8,-2,-1,-1,0,-4,-5,-6,-6
"6727",2019-03-29,"Washington Gulch","w1819","Motorized",0,"Fri","weekday","sled","Washington Gulch","1","1","1",19,0.1,58,-2,26,32.8,-2,-1,-1,0,-4,-5,-6,-6
"6728",2019-03-29,"Washington Gulch","w1819","Hybrid",0,"Fri","weekday","sled","Washington Gulch","1","1","1",19,0.1,58,-2,26,32.8,-2,-1,-1,0,-4,-5,-6,-6
"6729",2019-03-30,"Washington Gulch","w1819","Non.motorized",48,"Sat","weekend","no_sled","Washington Gulch","1","1","1",19.1,0.1,61,3,24,31.3,-2,-2,-1,-1,1,-1,-2,-3
"6730",2019-03-30,"Washington Gulch","w1819","Mechanized",0,"Sat","weekend","no_sled","Washington Gulch","1","1","1",19.1,0.1,61,3,24,31.3,-2,-2,-1,-1,1,-1,-2,-3
"6731",2019-03-30,"Washington Gulch","w1819","Motorized",2,"Sat","weekend","sled","Washington Gulch","1","1","1",19.1,0.1,61,3,24,31.3,-2,-2,-1,-1,1,-1,-2,-3
"6732",2019-03-30,"Washington Gulch","w1819","Hybrid",1,"Sat","weekend","sled","Washington Gulch","1","1","1",19.1,0.1,61,3,24,31.3,-2,-2,-1,-1,1,-1,-2,-3
"6733",2019-03-31,"Washington Gulch","w1819","Non.motorized",19,"Sun","weekend","no_sled","Washington Gulch","1","1","1",19.1,0,59,-2,24,32.4,3,-2,-2,-1,1,-1,-3,-4
"6734",2019-03-31,"Washington Gulch","w1819","Mechanized",0,"Sun","weekend","no_sled","Washington Gulch","1","1","1",19.1,0,59,-2,24,32.4,3,-2,-2,-1,1,-1,-3,-4
"6735",2019-03-31,"Washington Gulch","w1819","Motorized",0,"Sun","weekend","sled","Washington Gulch","1","1","1",19.1,0,59,-2,24,32.4,3,-2,-2,-1,1,-1,-3,-4
"6736",2019-03-31,"Washington Gulch","w1819","Hybrid",0,"Sun","weekend","sled","Washington Gulch","1","1","1",19.1,0,59,-2,24,32.4,3,-2,-2,-1,1,-1,-3,-4
"6737",2019-04-01,"Washington Gulch","w1819","Non.motorized",10,"Mon","weekday","no_sled","Washington Gulch","2","1","1",19.1,0,58,-1,29,32.9,-2,3,-2,-2,-3,0,-2,-4
"6738",2019-04-01,"Washington Gulch","w1819","Mechanized",0,"Mon","weekday","no_sled","Washington Gulch","2","1","1",19.1,0,58,-1,29,32.9,-2,3,-2,-2,-3,0,-2,-4
"6739",2019-04-01,"Washington Gulch","w1819","Motorized",5,"Mon","weekday","sled","Washington Gulch","2","1","1",19.1,0,58,-1,29,32.9,-2,3,-2,-2,-3,0,-2,-4
"6740",2019-04-01,"Washington Gulch","w1819","Hybrid",1,"Mon","weekday","sled","Washington Gulch","2","1","1",19.1,0,58,-1,29,32.9,-2,3,-2,-2,-3,0,-2,-4
"6741",2019-04-02,"Washington Gulch","w1819","Non.motorized",13,"Tue","weekday","no_sled","Washington Gulch","1","1","1",19.1,0,58,0,33,32.9,-1,-2,3,-2,-1,-3,0,-2
"6742",2019-04-02,"Washington Gulch","w1819","Mechanized",0,"Tue","weekday","no_sled","Washington Gulch","1","1","1",19.1,0,58,0,33,32.9,-1,-2,3,-2,-1,-3,0,-2
"6743",2019-04-02,"Washington Gulch","w1819","Motorized",5,"Tue","weekday","sled","Washington Gulch","1","1","1",19.1,0,58,0,33,32.9,-1,-2,3,-2,-1,-3,0,-2
"6744",2019-04-02,"Washington Gulch","w1819","Hybrid",0,"Tue","weekday","sled","Washington Gulch","1","1","1",19.1,0,58,0,33,32.9,-1,-2,3,-2,-1,-3,0,-2
"6745",2019-04-03,"Washington Gulch","w1819","Non.motorized",5,"Wed","weekday","no_sled","Washington Gulch","2","1","1",19.2,0.1,58,0,31,33.1,0,-1,-2,3,0,-1,-3,0
"6746",2019-04-03,"Washington Gulch","w1819","Mechanized",0,"Wed","weekday","no_sled","Washington Gulch","2","1","1",19.2,0.1,58,0,31,33.1,0,-1,-2,3,0,-1,-3,0
"6747",2019-04-03,"Washington Gulch","w1819","Motorized",1,"Wed","weekday","sled","Washington Gulch","2","1","1",19.2,0.1,58,0,31,33.1,0,-1,-2,3,0,-1,-3,0
"6748",2019-04-03,"Washington Gulch","w1819","Hybrid",1,"Wed","weekday","sled","Washington Gulch","2","1","1",19.2,0.1,58,0,31,33.1,0,-1,-2,3,0,-1,-3,0
"6749",2019-04-04,"Washington Gulch","w1819","Non.motorized",12,"Thu","weekday","no_sled","Washington Gulch","2","1","1",19.4,0.2,59,1,35,32.9,0,0,-1,-2,1,1,0,-2
"6750",2019-04-04,"Washington Gulch","w1819","Mechanized",0,"Thu","weekday","no_sled","Washington Gulch","2","1","1",19.4,0.2,59,1,35,32.9,0,0,-1,-2,1,1,0,-2
"6751",2019-04-04,"Washington Gulch","w1819","Motorized",3,"Thu","weekday","sled","Washington Gulch","2","1","1",19.4,0.2,59,1,35,32.9,0,0,-1,-2,1,1,0,-2
"6752",2019-04-04,"Washington Gulch","w1819","Hybrid",3,"Thu","weekday","sled","Washington Gulch","2","1","1",19.4,0.2,59,1,35,32.9,0,0,-1,-2,1,1,0,-2
"6753",2019-04-05,"Washington Gulch","w1819","Non.motorized",8,"Fri","weekday","no_sled","Washington Gulch","1","1","1",19.4,0,57,-2,38,34,1,0,0,-1,-1,-1,-1,-2
"6754",2019-04-05,"Washington Gulch","w1819","Mechanized",0,"Fri","weekday","no_sled","Washington Gulch","1","1","1",19.4,0,57,-2,38,34,1,0,0,-1,-1,-1,-1,-2
"6755",2019-04-05,"Washington Gulch","w1819","Motorized",2,"Fri","weekday","sled","Washington Gulch","1","1","1",19.4,0,57,-2,38,34,1,0,0,-1,-1,-1,-1,-2
"6756",2019-04-05,"Washington Gulch","w1819","Hybrid",2,"Fri","weekday","sled","Washington Gulch","1","1","1",19.4,0,57,-2,38,34,1,0,0,-1,-1,-1,-1,-2
"6757",2019-04-06,"Washington Gulch","w1819","Non.motorized",0,"Sat","weekend","no_sled","Washington Gulch","1","1","1",19.3,-0.1,57,0,35,33.9,-2,1,0,0,-2,-1,-1,-1
"6758",2019-04-06,"Washington Gulch","w1819","Mechanized",0,"Sat","weekend","no_sled","Washington Gulch","1","1","1",19.3,-0.1,57,0,35,33.9,-2,1,0,0,-2,-1,-1,-1
"6759",2019-04-06,"Washington Gulch","w1819","Motorized",0,"Sat","weekend","sled","Washington Gulch","1","1","1",19.3,-0.1,57,0,35,33.9,-2,1,0,0,-2,-1,-1,-1
"6760",2019-04-06,"Washington Gulch","w1819","Hybrid",0,"Sat","weekend","sled","Washington Gulch","1","1","1",19.3,-0.1,57,0,35,33.9,-2,1,0,0,-2,-1,-1,-1
"6761",2019-04-07,"Washington Gulch","w1819","Non.motorized",0,"Sun","weekend","no_sled","Washington Gulch","1","1","1",19.1,-0.2,57,0,37,33.5,0,-2,1,0,0,-2,-1,-1
"6762",2019-04-07,"Washington Gulch","w1819","Mechanized",0,"Sun","weekend","no_sled","Washington Gulch","1","1","1",19.1,-0.2,57,0,37,33.5,0,-2,1,0,0,-2,-1,-1
"6763",2019-04-07,"Washington Gulch","w1819","Motorized",0,"Sun","weekend","sled","Washington Gulch","1","1","1",19.1,-0.2,57,0,37,33.5,0,-2,1,0,0,-2,-1,-1
"6764",2019-04-07,"Washington Gulch","w1819","Hybrid",0,"Sun","weekend","sled","Washington Gulch","1","1","1",19.1,-0.2,57,0,37,33.5,0,-2,1,0,0,-2,-1,-1
"6765",2019-04-08,"Washington Gulch","w1819","Non.motorized",9,"Mon","weekday","no_sled","Washington Gulch","1","2","2",19.3,0.2,54,-3,41,35.7,0,0,-2,1,-3,-3,-5,-4
"6766",2019-04-08,"Washington Gulch","w1819","Mechanized",0,"Mon","weekday","no_sled","Washington Gulch","1","2","2",19.3,0.2,54,-3,41,35.7,0,0,-2,1,-3,-3,-5,-4
"6767",2019-04-08,"Washington Gulch","w1819","Motorized",3,"Mon","weekday","sled","Washington Gulch","1","2","2",19.3,0.2,54,-3,41,35.7,0,0,-2,1,-3,-3,-5,-4
"6768",2019-04-08,"Washington Gulch","w1819","Hybrid",1,"Mon","weekday","sled","Washington Gulch","1","2","2",19.3,0.2,54,-3,41,35.7,0,0,-2,1,-3,-3,-5,-4
"6769",2019-04-09,"Washington Gulch","w1819","Non.motorized",3,"Tue","weekday","no_sled","Washington Gulch","1","2","2",19.3,0,53,-1,43,36.4,-3,0,0,-2,-4,-4,-4,-6
"6770",2019-04-09,"Washington Gulch","w1819","Mechanized",0,"Tue","weekday","no_sled","Washington Gulch","1","2","2",19.3,0,53,-1,43,36.4,-3,0,0,-2,-4,-4,-4,-6
"6771",2019-04-09,"Washington Gulch","w1819","Motorized",3,"Tue","weekday","sled","Washington Gulch","1","2","2",19.3,0,53,-1,43,36.4,-3,0,0,-2,-4,-4,-4,-6
"6772",2019-04-09,"Washington Gulch","w1819","Hybrid",0,"Tue","weekday","sled","Washington Gulch","1","2","2",19.3,0,53,-1,43,36.4,-3,0,0,-2,-4,-4,-4,-6
"6773",2019-04-10,"Washington Gulch","w1819","Non.motorized",4,"Wed","weekday","no_sled","Washington Gulch","2","2","1",19,-0.3,51,-2,30,37.3,-1,-3,0,0,-3,-6,-6,-6
"6774",2019-04-10,"Washington Gulch","w1819","Mechanized",0,"Wed","weekday","no_sled","Washington Gulch","2","2","1",19,-0.3,51,-2,30,37.3,-1,-3,0,0,-3,-6,-6,-6
"6775",2019-04-10,"Washington Gulch","w1819","Motorized",2,"Wed","weekday","sled","Washington Gulch","2","2","1",19,-0.3,51,-2,30,37.3,-1,-3,0,0,-3,-6,-6,-6
"6776",2019-04-10,"Washington Gulch","w1819","Hybrid",2,"Wed","weekday","sled","Washington Gulch","2","2","1",19,-0.3,51,-2,30,37.3,-1,-3,0,0,-3,-6,-6,-6
"6777",2019-04-11,"Washington Gulch","w1819","Non.motorized",9,"Thu","weekday","no_sled","Washington Gulch","3","3","2",18.9,-0.1,53,2,20,35.7,-2,-1,-3,0,0,-1,-4,-4
"6778",2019-04-11,"Washington Gulch","w1819","Mechanized",0,"Thu","weekday","no_sled","Washington Gulch","3","3","2",18.9,-0.1,53,2,20,35.7,-2,-1,-3,0,0,-1,-4,-4
"6779",2019-04-11,"Washington Gulch","w1819","Motorized",1,"Thu","weekday","sled","Washington Gulch","3","3","2",18.9,-0.1,53,2,20,35.7,-2,-1,-3,0,0,-1,-4,-4
"6780",2019-04-11,"Washington Gulch","w1819","Hybrid",1,"Thu","weekday","sled","Washington Gulch","3","3","2",18.9,-0.1,53,2,20,35.7,-2,-1,-3,0,0,-1,-4,-4
"6781",2019-04-12,"Washington Gulch","w1819","Non.motorized",11,"Fri","weekday","no_sled","Washington Gulch","2","2","1",18.7,-0.2,53,0,24,35.3,2,-2,-1,-3,2,0,-1,-4
"6782",2019-04-12,"Washington Gulch","w1819","Mechanized",0,"Fri","weekday","no_sled","Washington Gulch","2","2","1",18.7,-0.2,53,0,24,35.3,2,-2,-1,-3,2,0,-1,-4
"6783",2019-04-12,"Washington Gulch","w1819","Motorized",7,"Fri","weekday","sled","Washington Gulch","2","2","1",18.7,-0.2,53,0,24,35.3,2,-2,-1,-3,2,0,-1,-4
"6784",2019-04-12,"Washington Gulch","w1819","Hybrid",0,"Fri","weekday","sled","Washington Gulch","2","2","1",18.7,-0.2,53,0,24,35.3,2,-2,-1,-3,2,0,-1,-4
"6785",2019-04-13,"Washington Gulch","w1819","Non.motorized",0,"Sat","weekend","no_sled","Washington Gulch","1","1","1",18.8,0.1,52,-1,27,36.2,0,2,-2,-1,-1,1,-1,-2
"6786",2019-04-13,"Washington Gulch","w1819","Mechanized",0,"Sat","weekend","no_sled","Washington Gulch","1","1","1",18.8,0.1,52,-1,27,36.2,0,2,-2,-1,-1,1,-1,-2
"6787",2019-04-13,"Washington Gulch","w1819","Motorized",0,"Sat","weekend","sled","Washington Gulch","1","1","1",18.8,0.1,52,-1,27,36.2,0,2,-2,-1,-1,1,-1,-2
"6788",2019-04-13,"Washington Gulch","w1819","Hybrid",0,"Sat","weekend","sled","Washington Gulch","1","1","1",18.8,0.1,52,-1,27,36.2,0,2,-2,-1,-1,1,-1,-2
"6789",2019-04-14,"Washington Gulch","w1819","Non.motorized",0,"Sun","weekend","no_sled","Washington Gulch","1","1","1",18.7,-0.1,51,-1,35,36.7,-1,0,2,-2,-2,-2,0,-2
"6790",2019-04-14,"Washington Gulch","w1819","Mechanized",0,"Sun","weekend","no_sled","Washington Gulch","1","1","1",18.7,-0.1,51,-1,35,36.7,-1,0,2,-2,-2,-2,0,-2
"6791",2019-04-14,"Washington Gulch","w1819","Motorized",0,"Sun","weekend","sled","Washington Gulch","1","1","1",18.7,-0.1,51,-1,35,36.7,-1,0,2,-2,-2,-2,0,-2
"6792",2019-04-14,"Washington Gulch","w1819","Hybrid",0,"Sun","weekend","sled","Washington Gulch","1","1","1",18.7,-0.1,51,-1,35,36.7,-1,0,2,-2,-2,-2,0,-2
"6793",2019-04-15,"Washington Gulch","w1819","Non.motorized",0,"Mon","weekday","no_sled","Washington Gulch",NA,NA,NA,18.6,-0.1,50,-1,41,37.2,-1,-1,0,2,-2,-3,-3,-1
"6794",2019-04-15,"Washington Gulch","w1819","Mechanized",0,"Mon","weekday","no_sled","Washington Gulch",NA,NA,NA,18.6,-0.1,50,-1,41,37.2,-1,-1,0,2,-2,-3,-3,-1
"6795",2019-04-15,"Washington Gulch","w1819","Motorized",0,"Mon","weekday","sled","Washington Gulch",NA,NA,NA,18.6,-0.1,50,-1,41,37.2,-1,-1,0,2,-2,-3,-3,-1
"6796",2019-04-15,"Washington Gulch","w1819","Hybrid",0,"Mon","weekday","sled","Washington Gulch",NA,NA,NA,18.6,-0.1,50,-1,41,37.2,-1,-1,0,2,-2,-3,-3,-1
"6797",2019-12-06,"Brush Creek Rd","w1920","Non.motorized",10,"Fri","weekday","no_sled","Brush/Cement","2","2","1",2.9,0.4,19,5,24,15.3,0,0,0,0,5,5,5,5
"6798",2019-12-06,"Brush Creek Rd","w1920","Mechanized",0,"Fri","weekday","no_sled","Brush/Cement","2","2","1",2.9,0.4,19,5,24,15.3,0,0,0,0,5,5,5,5
"6799",2019-12-06,"Brush Creek Rd","w1920","Motorized",0,"Fri","weekday","sled","Brush/Cement","2","2","1",2.9,0.4,19,5,24,15.3,0,0,0,0,5,5,5,5
"6800",2019-12-06,"Brush Creek Rd","w1920","Hybrid",0,"Fri","weekday","sled","Brush/Cement","2","2","1",2.9,0.4,19,5,24,15.3,0,0,0,0,5,5,5,5
"6801",2019-12-07,"Brush Creek Rd","w1920","Non.motorized",16,"Sat","weekend","no_sled","Brush/Cement","2","2","1",3,0.1,18,-1,29,16.7,5,0,0,0,4,4,4,4
"6802",2019-12-07,"Brush Creek Rd","w1920","Mechanized",0,"Sat","weekend","no_sled","Brush/Cement","2","2","1",3,0.1,18,-1,29,16.7,5,0,0,0,4,4,4,4
"6803",2019-12-07,"Brush Creek Rd","w1920","Motorized",0,"Sat","weekend","sled","Brush/Cement","2","2","1",3,0.1,18,-1,29,16.7,5,0,0,0,4,4,4,4
"6804",2019-12-07,"Brush Creek Rd","w1920","Hybrid",0,"Sat","weekend","sled","Brush/Cement","2","2","1",3,0.1,18,-1,29,16.7,5,0,0,0,4,4,4,4
"6805",2019-12-08,"Brush Creek Rd","w1920","Non.motorized",4,"Sun","weekend","no_sled","Brush/Cement","2","2","1",3,0,17,-1,28,17.6,-1,5,0,0,-2,3,3,3
"6806",2019-12-08,"Brush Creek Rd","w1920","Mechanized",0,"Sun","weekend","no_sled","Brush/Cement","2","2","1",3,0,17,-1,28,17.6,-1,5,0,0,-2,3,3,3
"6807",2019-12-08,"Brush Creek Rd","w1920","Motorized",0,"Sun","weekend","sled","Brush/Cement","2","2","1",3,0,17,-1,28,17.6,-1,5,0,0,-2,3,3,3
"6808",2019-12-08,"Brush Creek Rd","w1920","Hybrid",0,"Sun","weekend","sled","Brush/Cement","2","2","1",3,0,17,-1,28,17.6,-1,5,0,0,-2,3,3,3
"6809",2019-12-09,"Brush Creek Rd","w1920","Non.motorized",2,"Mon","weekday","no_sled","Brush/Cement","3","3","2",3.4,0.4,22,5,21,15.5,-1,-1,5,0,4,3,8,8
"6810",2019-12-09,"Brush Creek Rd","w1920","Mechanized",0,"Mon","weekday","no_sled","Brush/Cement","3","3","2",3.4,0.4,22,5,21,15.5,-1,-1,5,0,4,3,8,8
"6811",2019-12-09,"Brush Creek Rd","w1920","Motorized",0,"Mon","weekday","sled","Brush/Cement","3","3","2",3.4,0.4,22,5,21,15.5,-1,-1,5,0,4,3,8,8
"6812",2019-12-09,"Brush Creek Rd","w1920","Hybrid",0,"Mon","weekday","sled","Brush/Cement","3","3","2",3.4,0.4,22,5,21,15.5,-1,-1,5,0,4,3,8,8
"6813",2020-12-10,"Brush Creek Rd","w1920","Non.motorized",5,"Thu","weekday","no_sled","Brush/Cement",NA,NA,NA,2.5,NA,11,0,28,22.7,0,0,0,0,0,0,0,0
"6814",2020-12-10,"Brush Creek Rd","w1920","Mechanized",0,"Thu","weekday","no_sled","Brush/Cement",NA,NA,NA,2.5,NA,11,0,28,22.7,0,0,0,0,0,0,0,0
"6815",2020-12-10,"Brush Creek Rd","w1920","Motorized",0,"Thu","weekday","sled","Brush/Cement",NA,NA,NA,2.5,NA,11,0,28,22.7,0,0,0,0,0,0,0,0
"6816",2020-12-10,"Brush Creek Rd","w1920","Hybrid",0,"Thu","weekday","sled","Brush/Cement",NA,NA,NA,2.5,NA,11,0,28,22.7,0,0,0,0,0,0,0,0
"6817",2019-12-11,"Brush Creek Rd","w1920","Non.motorized",5,"Wed","weekday","no_sled","Brush/Cement","2","2","2",3.4,0,20,-1,22,17,-1,5,-1,-1,-2,3,2,1
"6818",2019-12-11,"Brush Creek Rd","w1920","Mechanized",0,"Wed","weekday","no_sled","Brush/Cement","2","2","2",3.4,0,20,-1,22,17,-1,5,-1,-1,-2,3,2,1
"6819",2019-12-11,"Brush Creek Rd","w1920","Motorized",0,"Wed","weekday","sled","Brush/Cement","2","2","2",3.4,0,20,-1,22,17,-1,5,-1,-1,-2,3,2,1
"6820",2019-12-11,"Brush Creek Rd","w1920","Hybrid",0,"Wed","weekday","sled","Brush/Cement","2","2","2",3.4,0,20,-1,22,17,-1,5,-1,-1,-2,3,2,1
"6821",2019-12-12,"Brush Creek Rd","w1920","Non.motorized",4,"Thu","weekday","no_sled","Brush/Cement","2","2","2",3.4,0,19,-1,25,17.9,-1,-1,5,-1,-2,-3,2,1
"6822",2019-12-12,"Brush Creek Rd","w1920","Mechanized",0,"Thu","weekday","no_sled","Brush/Cement","2","2","2",3.4,0,19,-1,25,17.9,-1,-1,5,-1,-2,-3,2,1
"6823",2019-12-12,"Brush Creek Rd","w1920","Motorized",0,"Thu","weekday","sled","Brush/Cement","2","2","2",3.4,0,19,-1,25,17.9,-1,-1,5,-1,-2,-3,2,1
"6824",2019-12-12,"Brush Creek Rd","w1920","Hybrid",0,"Thu","weekday","sled","Brush/Cement","2","2","2",3.4,0,19,-1,25,17.9,-1,-1,5,-1,-2,-3,2,1
"6825",2019-12-13,"Brush Creek Rd","w1920","Non.motorized",4,"Fri","weekday","no_sled","Brush/Cement","2","2","2",3.8,0.4,21,2,24,18.1,-1,-1,-1,5,1,0,-1,4
"6826",2019-12-13,"Brush Creek Rd","w1920","Mechanized",0,"Fri","weekday","no_sled","Brush/Cement","2","2","2",3.8,0.4,21,2,24,18.1,-1,-1,-1,5,1,0,-1,4
"6827",2019-12-13,"Brush Creek Rd","w1920","Motorized",0,"Fri","weekday","sled","Brush/Cement","2","2","2",3.8,0.4,21,2,24,18.1,-1,-1,-1,5,1,0,-1,4
"6828",2019-12-13,"Brush Creek Rd","w1920","Hybrid",0,"Fri","weekday","sled","Brush/Cement","2","2","2",3.8,0.4,21,2,24,18.1,-1,-1,-1,5,1,0,-1,4
"6829",2019-12-14,"Brush Creek Rd","w1920","Non.motorized",6,"Sat","weekend","no_sled","Brush/Cement","3","3","3",4.2,0.4,27,6,25,15.6,2,-1,-1,-1,8,7,6,5
"6830",2019-12-14,"Brush Creek Rd","w1920","Mechanized",0,"Sat","weekend","no_sled","Brush/Cement","3","3","3",4.2,0.4,27,6,25,15.6,2,-1,-1,-1,8,7,6,5
"6831",2019-12-14,"Brush Creek Rd","w1920","Motorized",0,"Sat","weekend","sled","Brush/Cement","3","3","3",4.2,0.4,27,6,25,15.6,2,-1,-1,-1,8,7,6,5
"6832",2019-12-14,"Brush Creek Rd","w1920","Hybrid",0,"Sat","weekend","sled","Brush/Cement","3","3","3",4.2,0.4,27,6,25,15.6,2,-1,-1,-1,8,7,6,5
"6833",2019-12-15,"Brush Creek Rd","w1920","Non.motorized",4,"Sun","weekend","no_sled","Brush/Cement","3","3","2",4.8,0.6,31,4,17,15.5,6,2,-1,-1,10,12,11,10
"6834",2019-12-15,"Brush Creek Rd","w1920","Mechanized",0,"Sun","weekend","no_sled","Brush/Cement","3","3","2",4.8,0.6,31,4,17,15.5,6,2,-1,-1,10,12,11,10
"6835",2019-12-15,"Brush Creek Rd","w1920","Motorized",0,"Sun","weekend","sled","Brush/Cement","3","3","2",4.8,0.6,31,4,17,15.5,6,2,-1,-1,10,12,11,10
"6836",2019-12-15,"Brush Creek Rd","w1920","Hybrid",0,"Sun","weekend","sled","Brush/Cement","3","3","2",4.8,0.6,31,4,17,15.5,6,2,-1,-1,10,12,11,10
"6837",2019-12-16,"Brush Creek Rd","w1920","Non.motorized",4,"Mon","weekday","no_sled","Brush/Cement","3","3","2",4.8,0,29,-2,6,16.6,4,6,2,-1,2,8,10,9
"6838",2019-12-16,"Brush Creek Rd","w1920","Mechanized",0,"Mon","weekday","no_sled","Brush/Cement","3","3","2",4.8,0,29,-2,6,16.6,4,6,2,-1,2,8,10,9
"6839",2019-12-16,"Brush Creek Rd","w1920","Motorized",0,"Mon","weekday","sled","Brush/Cement","3","3","2",4.8,0,29,-2,6,16.6,4,6,2,-1,2,8,10,9
"6840",2019-12-16,"Brush Creek Rd","w1920","Hybrid",0,"Mon","weekday","sled","Brush/Cement","3","3","2",4.8,0,29,-2,6,16.6,4,6,2,-1,2,8,10,9
"6841",2019-12-17,"Brush Creek Rd","w1920","Non.motorized",NA,"Tue","weekday","no_sled","Brush/Cement","2","2","1",4.8,0,27,-2,8,17.8,-2,4,6,2,-4,0,6,8
"6842",2019-12-17,"Brush Creek Rd","w1920","Mechanized",NA,"Tue","weekday","no_sled","Brush/Cement","2","2","1",4.8,0,27,-2,8,17.8,-2,4,6,2,-4,0,6,8
"6843",2019-12-17,"Brush Creek Rd","w1920","Motorized",NA,"Tue","weekday","sled","Brush/Cement","2","2","1",4.8,0,27,-2,8,17.8,-2,4,6,2,-4,0,6,8
"6844",2019-12-17,"Brush Creek Rd","w1920","Hybrid",NA,"Tue","weekday","sled","Brush/Cement","2","2","1",4.8,0,27,-2,8,17.8,-2,4,6,2,-4,0,6,8
"6845",2019-12-18,"Brush Creek Rd","w1920","Non.motorized",2,"Wed","weekday","no_sled","Brush/Cement","2","2","1",4.8,0,26,-1,20,18.5,-2,-2,4,6,-3,-5,-1,5
"6846",2019-12-18,"Brush Creek Rd","w1920","Mechanized",0,"Wed","weekday","no_sled","Brush/Cement","2","2","1",4.8,0,26,-1,20,18.5,-2,-2,4,6,-3,-5,-1,5
"6847",2019-12-18,"Brush Creek Rd","w1920","Motorized",0,"Wed","weekday","sled","Brush/Cement","2","2","1",4.8,0,26,-1,20,18.5,-2,-2,4,6,-3,-5,-1,5
"6848",2019-12-18,"Brush Creek Rd","w1920","Hybrid",0,"Wed","weekday","sled","Brush/Cement","2","2","1",4.8,0,26,-1,20,18.5,-2,-2,4,6,-3,-5,-1,5
"6849",2019-12-19,"Brush Creek Rd","w1920","Non.motorized",4,"Thu","weekday","no_sled","Brush/Cement","2","2","1",4.9,0.1,25,-1,21,19.6,-1,-2,-2,4,-2,-4,-6,-2
"6850",2019-12-19,"Brush Creek Rd","w1920","Mechanized",0,"Thu","weekday","no_sled","Brush/Cement","2","2","1",4.9,0.1,25,-1,21,19.6,-1,-2,-2,4,-2,-4,-6,-2
"6851",2019-12-19,"Brush Creek Rd","w1920","Motorized",0,"Thu","weekday","sled","Brush/Cement","2","2","1",4.9,0.1,25,-1,21,19.6,-1,-2,-2,4,-2,-4,-6,-2
"6852",2019-12-19,"Brush Creek Rd","w1920","Hybrid",0,"Thu","weekday","sled","Brush/Cement","2","2","1",4.9,0.1,25,-1,21,19.6,-1,-2,-2,4,-2,-4,-6,-2
"6853",2019-12-20,"Brush Creek Rd","w1920","Non.motorized",5,"Fri","weekday","no_sled","Brush/Cement","2","2","1",4.9,0,24,-1,21,20.4,-1,-1,-2,-2,-2,-3,-5,-7
"6854",2019-12-20,"Brush Creek Rd","w1920","Mechanized",0,"Fri","weekday","no_sled","Brush/Cement","2","2","1",4.9,0,24,-1,21,20.4,-1,-1,-2,-2,-2,-3,-5,-7
"6855",2019-12-20,"Brush Creek Rd","w1920","Motorized",0,"Fri","weekday","sled","Brush/Cement","2","2","1",4.9,0,24,-1,21,20.4,-1,-1,-2,-2,-2,-3,-5,-7
"6856",2019-12-20,"Brush Creek Rd","w1920","Hybrid",0,"Fri","weekday","sled","Brush/Cement","2","2","1",4.9,0,24,-1,21,20.4,-1,-1,-2,-2,-2,-3,-5,-7
"6857",2019-12-21,"Brush Creek Rd","w1920","Non.motorized",12,"Sat","weekend","no_sled","Brush/Cement","2","2","1",4.9,0,24,0,27,20.4,-1,-1,-1,-2,-1,-2,-3,-5
"6858",2019-12-21,"Brush Creek Rd","w1920","Mechanized",0,"Sat","weekend","no_sled","Brush/Cement","2","2","1",4.9,0,24,0,27,20.4,-1,-1,-1,-2,-1,-2,-3,-5
"6859",2019-12-21,"Brush Creek Rd","w1920","Motorized",0,"Sat","weekend","sled","Brush/Cement","2","2","1",4.9,0,24,0,27,20.4,-1,-1,-1,-2,-1,-2,-3,-5
"6860",2019-12-21,"Brush Creek Rd","w1920","Hybrid",0,"Sat","weekend","sled","Brush/Cement","2","2","1",4.9,0,24,0,27,20.4,-1,-1,-1,-2,-1,-2,-3,-5
"6861",2019-12-22,"Brush Creek Rd","w1920","Non.motorized",13,"Sun","weekend","no_sled","Brush/Cement","2","2","1",5,0.1,23,-1,31,21.7,0,-1,-1,-1,-1,-2,-3,-4
"6862",2019-12-22,"Brush Creek Rd","w1920","Mechanized",1,"Sun","weekend","no_sled","Brush/Cement","2","2","1",5,0.1,23,-1,31,21.7,0,-1,-1,-1,-1,-2,-3,-4
"6863",2019-12-22,"Brush Creek Rd","w1920","Motorized",0,"Sun","weekend","sled","Brush/Cement","2","2","1",5,0.1,23,-1,31,21.7,0,-1,-1,-1,-1,-2,-3,-4
"6864",2019-12-22,"Brush Creek Rd","w1920","Hybrid",0,"Sun","weekend","sled","Brush/Cement","2","2","1",5,0.1,23,-1,31,21.7,0,-1,-1,-1,-1,-2,-3,-4
"6865",2019-12-23,"Brush Creek Rd","w1920","Non.motorized",23,"Mon","weekday","no_sled","Brush/Cement","2","1","1",5,0,23,0,34,21.7,-1,0,-1,-1,-1,-1,-2,-3
"6866",2019-12-23,"Brush Creek Rd","w1920","Mechanized",0,"Mon","weekday","no_sled","Brush/Cement","2","1","1",5,0,23,0,34,21.7,-1,0,-1,-1,-1,-1,-2,-3
"6867",2019-12-23,"Brush Creek Rd","w1920","Motorized",0,"Mon","weekday","sled","Brush/Cement","2","1","1",5,0,23,0,34,21.7,-1,0,-1,-1,-1,-1,-2,-3
"6868",2019-12-23,"Brush Creek Rd","w1920","Hybrid",0,"Mon","weekday","sled","Brush/Cement","2","1","1",5,0,23,0,34,21.7,-1,0,-1,-1,-1,-1,-2,-3
"6869",2019-12-24,"Brush Creek Rd","w1920","Non.motorized",13,"Tue","weekday","no_sled","Brush/Cement","2","1","1",5,0,22,-1,30,22.7,0,-1,0,-1,-1,-2,-2,-3
"6870",2019-12-24,"Brush Creek Rd","w1920","Mechanized",0,"Tue","weekday","no_sled","Brush/Cement","2","1","1",5,0,22,-1,30,22.7,0,-1,0,-1,-1,-2,-2,-3
"6871",2019-12-24,"Brush Creek Rd","w1920","Motorized",0,"Tue","weekday","sled","Brush/Cement","2","1","1",5,0,22,-1,30,22.7,0,-1,0,-1,-1,-2,-2,-3
"6872",2019-12-24,"Brush Creek Rd","w1920","Hybrid",0,"Tue","weekday","sled","Brush/Cement","2","1","1",5,0,22,-1,30,22.7,0,-1,0,-1,-1,-2,-2,-3
"6873",2019-12-25,"Brush Creek Rd","w1920","Non.motorized",14,"Wed","weekday","no_sled","Brush/Cement","2","2","2",5,0,23,1,22,21.7,-1,0,-1,0,0,0,-1,-1
"6874",2019-12-25,"Brush Creek Rd","w1920","Mechanized",0,"Wed","weekday","no_sled","Brush/Cement","2","2","2",5,0,23,1,22,21.7,-1,0,-1,0,0,0,-1,-1
"6875",2019-12-25,"Brush Creek Rd","w1920","Motorized",0,"Wed","weekday","sled","Brush/Cement","2","2","2",5,0,23,1,22,21.7,-1,0,-1,0,0,0,-1,-1
"6876",2019-12-25,"Brush Creek Rd","w1920","Hybrid",0,"Wed","weekday","sled","Brush/Cement","2","2","2",5,0,23,1,22,21.7,-1,0,-1,0,0,0,-1,-1
"6877",2019-12-26,"Brush Creek Rd","w1920","Non.motorized",15,"Thu","weekday","no_sled","Brush/Cement","2","2","1",5,0,23,0,17,21.7,1,-1,0,-1,1,0,0,-1
"6878",2019-12-26,"Brush Creek Rd","w1920","Mechanized",0,"Thu","weekday","no_sled","Brush/Cement","2","2","1",5,0,23,0,17,21.7,1,-1,0,-1,1,0,0,-1
"6879",2019-12-26,"Brush Creek Rd","w1920","Motorized",0,"Thu","weekday","sled","Brush/Cement","2","2","1",5,0,23,0,17,21.7,1,-1,0,-1,1,0,0,-1
"6880",2019-12-26,"Brush Creek Rd","w1920","Hybrid",0,"Thu","weekday","sled","Brush/Cement","2","2","1",5,0,23,0,17,21.7,1,-1,0,-1,1,0,0,-1
"6881",2019-12-27,"Brush Creek Rd","w1920","Non.motorized",5,"Fri","weekday","no_sled","Brush/Cement","3","3","2",5.1,0.1,24,1,22,21.2,0,1,-1,0,1,2,1,1
"6882",2019-12-27,"Brush Creek Rd","w1920","Mechanized",0,"Fri","weekday","no_sled","Brush/Cement","3","3","2",5.1,0.1,24,1,22,21.2,0,1,-1,0,1,2,1,1
"6883",2019-12-27,"Brush Creek Rd","w1920","Motorized",0,"Fri","weekday","sled","Brush/Cement","3","3","2",5.1,0.1,24,1,22,21.2,0,1,-1,0,1,2,1,1
"6884",2019-12-27,"Brush Creek Rd","w1920","Hybrid",0,"Fri","weekday","sled","Brush/Cement","3","3","2",5.1,0.1,24,1,22,21.2,0,1,-1,0,1,2,1,1
"6885",2019-12-28,"Brush Creek Rd","w1920","Non.motorized",13,"Sat","weekend","no_sled","Brush/Cement","3","3","2",5.6,0.5,30,6,16,18.7,1,0,1,-1,7,7,8,7
"6886",2019-12-28,"Brush Creek Rd","w1920","Mechanized",0,"Sat","weekend","no_sled","Brush/Cement","3","3","2",5.6,0.5,30,6,16,18.7,1,0,1,-1,7,7,8,7
"6887",2019-12-28,"Brush Creek Rd","w1920","Motorized",0,"Sat","weekend","sled","Brush/Cement","3","3","2",5.6,0.5,30,6,16,18.7,1,0,1,-1,7,7,8,7
"6888",2019-12-28,"Brush Creek Rd","w1920","Hybrid",0,"Sat","weekend","sled","Brush/Cement","3","3","2",5.6,0.5,30,6,16,18.7,1,0,1,-1,7,7,8,7
"6889",2019-12-29,"Brush Creek Rd","w1920","Non.motorized",14,"Sun","weekend","no_sled","Brush/Cement","3","3","2",5.6,0,29,-1,3,19.3,6,1,0,1,5,6,6,7
"6890",2019-12-29,"Brush Creek Rd","w1920","Mechanized",0,"Sun","weekend","no_sled","Brush/Cement","3","3","2",5.6,0,29,-1,3,19.3,6,1,0,1,5,6,6,7
"6891",2019-12-29,"Brush Creek Rd","w1920","Motorized",0,"Sun","weekend","sled","Brush/Cement","3","3","2",5.6,0,29,-1,3,19.3,6,1,0,1,5,6,6,7
"6892",2019-12-29,"Brush Creek Rd","w1920","Hybrid",0,"Sun","weekend","sled","Brush/Cement","3","3","2",5.6,0,29,-1,3,19.3,6,1,0,1,5,6,6,7
"6893",2019-12-30,"Brush Creek Rd","w1920","Non.motorized",11,"Mon","weekday","no_sled","Brush/Cement","3","3","2",5.6,0,28,-1,3,20,-1,6,1,0,-2,4,5,5
"6894",2019-12-30,"Brush Creek Rd","w1920","Mechanized",1,"Mon","weekday","no_sled","Brush/Cement","3","3","2",5.6,0,28,-1,3,20,-1,6,1,0,-2,4,5,5
"6895",2019-12-30,"Brush Creek Rd","w1920","Motorized",0,"Mon","weekday","sled","Brush/Cement","3","3","2",5.6,0,28,-1,3,20,-1,6,1,0,-2,4,5,5
"6896",2019-12-30,"Brush Creek Rd","w1920","Hybrid",0,"Mon","weekday","sled","Brush/Cement","3","3","2",5.6,0,28,-1,3,20,-1,6,1,0,-2,4,5,5
"6897",2019-12-31,"Brush Creek Rd","w1920","Non.motorized",9,"Tue","weekday","no_sled","Brush/Cement","2","2","1",5.6,0,28,0,13,20,-1,-1,6,1,-1,-2,4,5
"6898",2019-12-31,"Brush Creek Rd","w1920","Mechanized",1,"Tue","weekday","no_sled","Brush/Cement","2","2","1",5.6,0,28,0,13,20,-1,-1,6,1,-1,-2,4,5
"6899",2019-12-31,"Brush Creek Rd","w1920","Motorized",0,"Tue","weekday","sled","Brush/Cement","2","2","1",5.6,0,28,0,13,20,-1,-1,6,1,-1,-2,4,5
"6900",2019-12-31,"Brush Creek Rd","w1920","Hybrid",0,"Tue","weekday","sled","Brush/Cement","2","2","1",5.6,0,28,0,13,20,-1,-1,6,1,-1,-2,4,5
"6901",2020-01-01,"Brush Creek Rd","w1920","Non.motorized",16,"Wed","weekday","no_sled","Brush/Cement","2","1","1",5.6,0,27,-1,21,20.7,0,-1,-1,6,-1,-2,-3,3
"6902",2020-01-01,"Brush Creek Rd","w1920","Mechanized",1,"Wed","weekday","no_sled","Brush/Cement","2","1","1",5.6,0,27,-1,21,20.7,0,-1,-1,6,-1,-2,-3,3
"6903",2020-01-01,"Brush Creek Rd","w1920","Motorized",0,"Wed","weekday","sled","Brush/Cement","2","1","1",5.6,0,27,-1,21,20.7,0,-1,-1,6,-1,-2,-3,3
"6904",2020-01-01,"Brush Creek Rd","w1920","Hybrid",0,"Wed","weekday","sled","Brush/Cement","2","1","1",5.6,0,27,-1,21,20.7,0,-1,-1,6,-1,-2,-3,3
"6905",2020-01-02,"Brush Creek Rd","w1920","Non.motorized",10,"Thu","weekday","no_sled","Brush/Cement","3","3","2",5.9,0.3,29,2,16,20.3,-1,0,-1,-1,1,1,0,-1
"6906",2020-01-02,"Brush Creek Rd","w1920","Mechanized",1,"Thu","weekday","no_sled","Brush/Cement","3","3","2",5.9,0.3,29,2,16,20.3,-1,0,-1,-1,1,1,0,-1
"6907",2020-01-02,"Brush Creek Rd","w1920","Motorized",0,"Thu","weekday","sled","Brush/Cement","3","3","2",5.9,0.3,29,2,16,20.3,-1,0,-1,-1,1,1,0,-1
"6908",2020-01-02,"Brush Creek Rd","w1920","Hybrid",0,"Thu","weekday","sled","Brush/Cement","3","3","2",5.9,0.3,29,2,16,20.3,-1,0,-1,-1,1,1,0,-1
"6909",2020-01-03,"Brush Creek Rd","w1920","Non.motorized",19,"Fri","weekday","no_sled","Brush/Cement","3","2","1",5.9,0,31,2,19,19,2,-1,0,-1,4,3,3,2
"6910",2020-01-03,"Brush Creek Rd","w1920","Mechanized",1,"Fri","weekday","no_sled","Brush/Cement","3","2","1",5.9,0,31,2,19,19,2,-1,0,-1,4,3,3,2
"6911",2020-01-03,"Brush Creek Rd","w1920","Motorized",0,"Fri","weekday","sled","Brush/Cement","3","2","1",5.9,0,31,2,19,19,2,-1,0,-1,4,3,3,2
"6912",2020-01-03,"Brush Creek Rd","w1920","Hybrid",0,"Fri","weekday","sled","Brush/Cement","3","2","1",5.9,0,31,2,19,19,2,-1,0,-1,4,3,3,2
"6913",2020-01-04,"Brush Creek Rd","w1920","Non.motorized",14,"Sat","weekend","no_sled","Brush/Cement","2","2","1",5.9,0,30,-1,26,19.7,2,2,-1,0,1,3,2,2
"6914",2020-01-04,"Brush Creek Rd","w1920","Mechanized",1,"Sat","weekend","no_sled","Brush/Cement","2","2","1",5.9,0,30,-1,26,19.7,2,2,-1,0,1,3,2,2
"6915",2020-01-04,"Brush Creek Rd","w1920","Motorized",0,"Sat","weekend","sled","Brush/Cement","2","2","1",5.9,0,30,-1,26,19.7,2,2,-1,0,1,3,2,2
"6916",2020-01-04,"Brush Creek Rd","w1920","Hybrid",0,"Sat","weekend","sled","Brush/Cement","2","2","1",5.9,0,30,-1,26,19.7,2,2,-1,0,1,3,2,2
"6917",2020-01-05,"Brush Creek Rd","w1920","Non.motorized",20,"Sun","weekend","no_sled","Brush/Cement","2","2","1",5.9,0,28,-2,23,21.1,-1,2,2,-1,-3,-1,1,0
"6918",2020-01-05,"Brush Creek Rd","w1920","Mechanized",1,"Sun","weekend","no_sled","Brush/Cement","2","2","1",5.9,0,28,-2,23,21.1,-1,2,2,-1,-3,-1,1,0
"6919",2020-01-05,"Brush Creek Rd","w1920","Motorized",0,"Sun","weekend","sled","Brush/Cement","2","2","1",5.9,0,28,-2,23,21.1,-1,2,2,-1,-3,-1,1,0
"6920",2020-01-05,"Brush Creek Rd","w1920","Hybrid",0,"Sun","weekend","sled","Brush/Cement","2","2","1",5.9,0,28,-2,23,21.1,-1,2,2,-1,-3,-1,1,0
"6921",2020-01-06,"Brush Creek Rd","w1920","Non.motorized",13,"Mon","weekday","no_sled","Brush/Cement","2","2","1",5.9,0,28,0,15,21.1,-2,-1,2,2,-2,-3,-1,1
"6922",2020-01-06,"Brush Creek Rd","w1920","Mechanized",2,"Mon","weekday","no_sled","Brush/Cement","2","2","1",5.9,0,28,0,15,21.1,-2,-1,2,2,-2,-3,-1,1
"6923",2020-01-06,"Brush Creek Rd","w1920","Motorized",0,"Mon","weekday","sled","Brush/Cement","2","2","1",5.9,0,28,0,15,21.1,-2,-1,2,2,-2,-3,-1,1
"6924",2020-01-06,"Brush Creek Rd","w1920","Hybrid",0,"Mon","weekday","sled","Brush/Cement","2","2","1",5.9,0,28,0,15,21.1,-2,-1,2,2,-2,-3,-1,1
"6925",2020-01-07,"Brush Creek Rd","w1920","Non.motorized",10,"Tue","weekday","no_sled","Brush/Cement","2","1","1",5.9,0,28,0,22,21.1,0,-2,-1,2,0,-2,-3,-1
"6926",2020-01-07,"Brush Creek Rd","w1920","Mechanized",2,"Tue","weekday","no_sled","Brush/Cement","2","1","1",5.9,0,28,0,22,21.1,0,-2,-1,2,0,-2,-3,-1
"6927",2020-01-07,"Brush Creek Rd","w1920","Motorized",0,"Tue","weekday","sled","Brush/Cement","2","1","1",5.9,0,28,0,22,21.1,0,-2,-1,2,0,-2,-3,-1
"6928",2020-01-07,"Brush Creek Rd","w1920","Hybrid",0,"Tue","weekday","sled","Brush/Cement","2","1","1",5.9,0,28,0,22,21.1,0,-2,-1,2,0,-2,-3,-1
"6929",2020-01-08,"Brush Creek Rd","w1920","Non.motorized",10,"Wed","weekday","no_sled","Brush/Cement","2","1","1",6,0.1,28,0,23,21.4,0,0,-2,-1,0,0,-2,-3
"6930",2020-01-08,"Brush Creek Rd","w1920","Mechanized",0,"Wed","weekday","no_sled","Brush/Cement","2","1","1",6,0.1,28,0,23,21.4,0,0,-2,-1,0,0,-2,-3
"6931",2020-01-08,"Brush Creek Rd","w1920","Motorized",0,"Wed","weekday","sled","Brush/Cement","2","1","1",6,0.1,28,0,23,21.4,0,0,-2,-1,0,0,-2,-3
"6932",2020-01-08,"Brush Creek Rd","w1920","Hybrid",0,"Wed","weekday","sled","Brush/Cement","2","1","1",6,0.1,28,0,23,21.4,0,0,-2,-1,0,0,-2,-3
"6933",2020-01-09,"Brush Creek Rd","w1920","Non.motorized",5,"Thu","weekday","no_sled","Brush/Cement","2","1","1",6,0,27,-1,17,22.2,0,0,0,-2,-1,-1,-1,-3
"6934",2020-01-09,"Brush Creek Rd","w1920","Mechanized",0,"Thu","weekday","no_sled","Brush/Cement","2","1","1",6,0,27,-1,17,22.2,0,0,0,-2,-1,-1,-1,-3
"6935",2020-01-09,"Brush Creek Rd","w1920","Motorized",0,"Thu","weekday","sled","Brush/Cement","2","1","1",6,0,27,-1,17,22.2,0,0,0,-2,-1,-1,-1,-3
"6936",2020-01-09,"Brush Creek Rd","w1920","Hybrid",0,"Thu","weekday","sled","Brush/Cement","2","1","1",6,0,27,-1,17,22.2,0,0,0,-2,-1,-1,-1,-3
"6937",2020-01-10,"Brush Creek Rd","w1920","Non.motorized",4,"Fri","weekday","no_sled","Brush/Cement","2","1","1",6,0,29,2,11,20.7,-1,0,0,0,1,1,1,1
"6938",2020-01-10,"Brush Creek Rd","w1920","Mechanized",0,"Fri","weekday","no_sled","Brush/Cement","2","1","1",6,0,29,2,11,20.7,-1,0,0,0,1,1,1,1
"6939",2020-01-10,"Brush Creek Rd","w1920","Motorized",0,"Fri","weekday","sled","Brush/Cement","2","1","1",6,0,29,2,11,20.7,-1,0,0,0,1,1,1,1
"6940",2020-01-10,"Brush Creek Rd","w1920","Hybrid",0,"Fri","weekday","sled","Brush/Cement","2","1","1",6,0,29,2,11,20.7,-1,0,0,0,1,1,1,1
"6941",2020-01-11,"Brush Creek Rd","w1920","Non.motorized",7,"Sat","weekend","no_sled","Brush/Cement","2","1","1",6,0,29,0,12,20.7,2,-1,0,0,2,1,1,1
"6942",2020-01-11,"Brush Creek Rd","w1920","Mechanized",0,"Sat","weekend","no_sled","Brush/Cement","2","1","1",6,0,29,0,12,20.7,2,-1,0,0,2,1,1,1
"6943",2020-01-11,"Brush Creek Rd","w1920","Motorized",0,"Sat","weekend","sled","Brush/Cement","2","1","1",6,0,29,0,12,20.7,2,-1,0,0,2,1,1,1
"6944",2020-01-11,"Brush Creek Rd","w1920","Hybrid",0,"Sat","weekend","sled","Brush/Cement","2","1","1",6,0,29,0,12,20.7,2,-1,0,0,2,1,1,1
"6945",2020-01-12,"Brush Creek Rd","w1920","Non.motorized",9,"Sun","weekend","no_sled","Brush/Cement","2","1","1",6.1,0.1,29,0,13,21,0,2,-1,0,0,2,1,1
"6946",2020-01-12,"Brush Creek Rd","w1920","Mechanized",0,"Sun","weekend","no_sled","Brush/Cement","2","1","1",6.1,0.1,29,0,13,21,0,2,-1,0,0,2,1,1
"6947",2020-01-12,"Brush Creek Rd","w1920","Motorized",0,"Sun","weekend","sled","Brush/Cement","2","1","1",6.1,0.1,29,0,13,21,0,2,-1,0,0,2,1,1
"6948",2020-01-12,"Brush Creek Rd","w1920","Hybrid",0,"Sun","weekend","sled","Brush/Cement","2","1","1",6.1,0.1,29,0,13,21,0,2,-1,0,0,2,1,1
"6949",2020-01-13,"Brush Creek Rd","w1920","Non.motorized",NA,"Mon","weekday","no_sled","Brush/Cement","2","2","1",6.2,0.1,29,0,16,21.4,0,0,2,-1,0,0,2,1
"6950",2020-01-13,"Brush Creek Rd","w1920","Mechanized",NA,"Mon","weekday","no_sled","Brush/Cement","2","2","1",6.2,0.1,29,0,16,21.4,0,0,2,-1,0,0,2,1
"6951",2020-01-13,"Brush Creek Rd","w1920","Motorized",NA,"Mon","weekday","sled","Brush/Cement","2","2","1",6.2,0.1,29,0,16,21.4,0,0,2,-1,0,0,2,1
"6952",2020-01-13,"Brush Creek Rd","w1920","Hybrid",NA,"Mon","weekday","sled","Brush/Cement","2","2","1",6.2,0.1,29,0,16,21.4,0,0,2,-1,0,0,2,1
"6953",2020-01-14,"Brush Creek Rd","w1920","Non.motorized",5,"Tue","weekday","no_sled","Brush/Cement","3","2","1",6.6,0.4,34,5,23,19.4,0,0,0,2,5,5,5,7
"6954",2020-01-14,"Brush Creek Rd","w1920","Mechanized",0,"Tue","weekday","no_sled","Brush/Cement","3","2","1",6.6,0.4,34,5,23,19.4,0,0,0,2,5,5,5,7
"6955",2020-01-14,"Brush Creek Rd","w1920","Motorized",0,"Tue","weekday","sled","Brush/Cement","3","2","1",6.6,0.4,34,5,23,19.4,0,0,0,2,5,5,5,7
"6956",2020-01-14,"Brush Creek Rd","w1920","Hybrid",0,"Tue","weekday","sled","Brush/Cement","3","2","1",6.6,0.4,34,5,23,19.4,0,0,0,2,5,5,5,7
"6957",2020-01-15,"Brush Creek Rd","w1920","Non.motorized",6,"Wed","weekday","no_sled","Brush/Cement","3","2","1",6.7,0.1,32,-2,23,20.9,5,0,0,0,3,3,3,3
"6958",2020-01-15,"Brush Creek Rd","w1920","Mechanized",0,"Wed","weekday","no_sled","Brush/Cement","3","2","1",6.7,0.1,32,-2,23,20.9,5,0,0,0,3,3,3,3
"6959",2020-01-15,"Brush Creek Rd","w1920","Motorized",0,"Wed","weekday","sled","Brush/Cement","3","2","1",6.7,0.1,32,-2,23,20.9,5,0,0,0,3,3,3,3
"6960",2020-01-15,"Brush Creek Rd","w1920","Hybrid",0,"Wed","weekday","sled","Brush/Cement","3","2","1",6.7,0.1,32,-2,23,20.9,5,0,0,0,3,3,3,3
"6961",2020-01-16,"Brush Creek Rd","w1920","Non.motorized",1,"Thu","weekday","no_sled","Brush/Cement","2","2","1",6.7,0,31,-1,28,21.6,-2,5,0,0,-3,2,2,2
"6962",2020-01-16,"Brush Creek Rd","w1920","Mechanized",0,"Thu","weekday","no_sled","Brush/Cement","2","2","1",6.7,0,31,-1,28,21.6,-2,5,0,0,-3,2,2,2
"6963",2020-01-16,"Brush Creek Rd","w1920","Motorized",0,"Thu","weekday","sled","Brush/Cement","2","2","1",6.7,0,31,-1,28,21.6,-2,5,0,0,-3,2,2,2
"6964",2020-01-16,"Brush Creek Rd","w1920","Hybrid",0,"Thu","weekday","sled","Brush/Cement","2","2","1",6.7,0,31,-1,28,21.6,-2,5,0,0,-3,2,2,2
"6965",2020-01-17,"Brush Creek Rd","w1920","Non.motorized",4,"Fri","weekday","no_sled","Brush/Cement","2","2","1",6.8,0.1,29,-2,19,23.4,-1,-2,5,0,-3,-5,0,0
"6966",2020-01-17,"Brush Creek Rd","w1920","Mechanized",0,"Fri","weekday","no_sled","Brush/Cement","2","2","1",6.8,0.1,29,-2,19,23.4,-1,-2,5,0,-3,-5,0,0
"6967",2020-01-17,"Brush Creek Rd","w1920","Motorized",0,"Fri","weekday","sled","Brush/Cement","2","2","1",6.8,0.1,29,-2,19,23.4,-1,-2,5,0,-3,-5,0,0
"6968",2020-01-17,"Brush Creek Rd","w1920","Hybrid",0,"Fri","weekday","sled","Brush/Cement","2","2","1",6.8,0.1,29,-2,19,23.4,-1,-2,5,0,-3,-5,0,0
"6969",2020-01-18,"Brush Creek Rd","w1920","Non.motorized",11,"Sat","weekend","no_sled","Brush/Cement","2","2","2",7,0.2,34,5,16,20.6,-2,-1,-2,5,3,2,0,5
"6970",2020-01-18,"Brush Creek Rd","w1920","Mechanized",0,"Sat","weekend","no_sled","Brush/Cement","2","2","2",7,0.2,34,5,16,20.6,-2,-1,-2,5,3,2,0,5
"6971",2020-01-18,"Brush Creek Rd","w1920","Motorized",0,"Sat","weekend","sled","Brush/Cement","2","2","2",7,0.2,34,5,16,20.6,-2,-1,-2,5,3,2,0,5
"6972",2020-01-18,"Brush Creek Rd","w1920","Hybrid",0,"Sat","weekend","sled","Brush/Cement","2","2","2",7,0.2,34,5,16,20.6,-2,-1,-2,5,3,2,0,5
"6973",2020-01-19,"Brush Creek Rd","w1920","Non.motorized",21,"Sun","weekend","no_sled","Brush/Cement","2","2","1",7,0,33,-1,21,21.2,5,-2,-1,-2,4,2,1,-1
"6974",2020-01-19,"Brush Creek Rd","w1920","Mechanized",0,"Sun","weekend","no_sled","Brush/Cement","2","2","1",7,0,33,-1,21,21.2,5,-2,-1,-2,4,2,1,-1
"6975",2020-01-19,"Brush Creek Rd","w1920","Motorized",0,"Sun","weekend","sled","Brush/Cement","2","2","1",7,0,33,-1,21,21.2,5,-2,-1,-2,4,2,1,-1
"6976",2020-01-19,"Brush Creek Rd","w1920","Hybrid",0,"Sun","weekend","sled","Brush/Cement","2","2","1",7,0,33,-1,21,21.2,5,-2,-1,-2,4,2,1,-1
"6977",2020-01-20,"Brush Creek Rd","w1920","Non.motorized",9,"Mon","weekday","no_sled","Brush/Cement","2","2","1",7.1,0.1,32,-1,25,22.2,-1,5,-2,-1,-2,3,1,0
"6978",2020-01-20,"Brush Creek Rd","w1920","Mechanized",0,"Mon","weekday","no_sled","Brush/Cement","2","2","1",7.1,0.1,32,-1,25,22.2,-1,5,-2,-1,-2,3,1,0
"6979",2020-01-20,"Brush Creek Rd","w1920","Motorized",0,"Mon","weekday","sled","Brush/Cement","2","2","1",7.1,0.1,32,-1,25,22.2,-1,5,-2,-1,-2,3,1,0
"6980",2020-01-20,"Brush Creek Rd","w1920","Hybrid",0,"Mon","weekday","sled","Brush/Cement","2","2","1",7.1,0.1,32,-1,25,22.2,-1,5,-2,-1,-2,3,1,0
"6981",2020-01-21,"Brush Creek Rd","w1920","Non.motorized",2,"Tue","weekday","no_sled","Brush/Cement","2","2","1",7.1,0,31,-1,28,22.9,-1,-1,5,-2,-2,-3,2,0
"6982",2020-01-21,"Brush Creek Rd","w1920","Mechanized",0,"Tue","weekday","no_sled","Brush/Cement","2","2","1",7.1,0,31,-1,28,22.9,-1,-1,5,-2,-2,-3,2,0
"6983",2020-01-21,"Brush Creek Rd","w1920","Motorized",0,"Tue","weekday","sled","Brush/Cement","2","2","1",7.1,0,31,-1,28,22.9,-1,-1,5,-2,-2,-3,2,0
"6984",2020-01-21,"Brush Creek Rd","w1920","Hybrid",0,"Tue","weekday","sled","Brush/Cement","2","2","1",7.1,0,31,-1,28,22.9,-1,-1,5,-2,-2,-3,2,0
"6985",2020-01-22,"Brush Creek Rd","w1920","Non.motorized",8,"Wed","weekday","no_sled","Brush/Cement","2","2","2",7.3,0.2,32,1,25,22.8,-1,-1,-1,5,0,-1,-2,3
"6986",2020-01-22,"Brush Creek Rd","w1920","Mechanized",0,"Wed","weekday","no_sled","Brush/Cement","2","2","2",7.3,0.2,32,1,25,22.8,-1,-1,-1,5,0,-1,-2,3
"6987",2020-01-22,"Brush Creek Rd","w1920","Motorized",0,"Wed","weekday","sled","Brush/Cement","2","2","2",7.3,0.2,32,1,25,22.8,-1,-1,-1,5,0,-1,-2,3
"6988",2020-01-22,"Brush Creek Rd","w1920","Hybrid",0,"Wed","weekday","sled","Brush/Cement","2","2","2",7.3,0.2,32,1,25,22.8,-1,-1,-1,5,0,-1,-2,3
"6989",2020-01-23,"Brush Creek Rd","w1920","Non.motorized",5,"Thu","weekday","no_sled","Brush/Cement","3","2","2",7.3,0,34,2,23,21.5,1,-1,-1,-1,3,2,1,0
"6990",2020-01-23,"Brush Creek Rd","w1920","Mechanized",1,"Thu","weekday","no_sled","Brush/Cement","3","2","2",7.3,0,34,2,23,21.5,1,-1,-1,-1,3,2,1,0
"6991",2020-01-23,"Brush Creek Rd","w1920","Motorized",0,"Thu","weekday","sled","Brush/Cement","3","2","2",7.3,0,34,2,23,21.5,1,-1,-1,-1,3,2,1,0
"6992",2020-01-23,"Brush Creek Rd","w1920","Hybrid",0,"Thu","weekday","sled","Brush/Cement","3","2","2",7.3,0,34,2,23,21.5,1,-1,-1,-1,3,2,1,0
"6993",2020-01-24,"Brush Creek Rd","w1920","Non.motorized",9,"Fri","weekday","no_sled","Brush/Cement","2","2","1",7.3,0,33,-1,23,22.1,2,1,-1,-1,1,2,1,0
"6994",2020-01-24,"Brush Creek Rd","w1920","Mechanized",1,"Fri","weekday","no_sled","Brush/Cement","2","2","1",7.3,0,33,-1,23,22.1,2,1,-1,-1,1,2,1,0
"6995",2020-01-24,"Brush Creek Rd","w1920","Motorized",0,"Fri","weekday","sled","Brush/Cement","2","2","1",7.3,0,33,-1,23,22.1,2,1,-1,-1,1,2,1,0
"6996",2020-01-24,"Brush Creek Rd","w1920","Hybrid",0,"Fri","weekday","sled","Brush/Cement","2","2","1",7.3,0,33,-1,23,22.1,2,1,-1,-1,1,2,1,0
"6997",2020-01-25,"Brush Creek Rd","w1920","Non.motorized",17,"Sat","weekend","no_sled","Brush/Cement","2","2","1",7.4,0.1,32,-1,25,23.1,-1,2,1,-1,-2,0,1,0
"6998",2020-01-25,"Brush Creek Rd","w1920","Mechanized",1,"Sat","weekend","no_sled","Brush/Cement","2","2","1",7.4,0.1,32,-1,25,23.1,-1,2,1,-1,-2,0,1,0
"6999",2020-01-25,"Brush Creek Rd","w1920","Motorized",0,"Sat","weekend","sled","Brush/Cement","2","2","1",7.4,0.1,32,-1,25,23.1,-1,2,1,-1,-2,0,1,0
"7000",2020-01-25,"Brush Creek Rd","w1920","Hybrid",0,"Sat","weekend","sled","Brush/Cement","2","2","1",7.4,0.1,32,-1,25,23.1,-1,2,1,-1,-2,0,1,0
"7001",2020-01-26,"Brush Creek Rd","w1920","Non.motorized",23,"Sun","weekend","no_sled","Brush/Cement","2","1","1",7.4,0,32,0,28,23.1,-1,-1,2,1,-1,-2,0,1
"7002",2020-01-26,"Brush Creek Rd","w1920","Mechanized",1,"Sun","weekend","no_sled","Brush/Cement","2","1","1",7.4,0,32,0,28,23.1,-1,-1,2,1,-1,-2,0,1
"7003",2020-01-26,"Brush Creek Rd","w1920","Motorized",0,"Sun","weekend","sled","Brush/Cement","2","1","1",7.4,0,32,0,28,23.1,-1,-1,2,1,-1,-2,0,1
"7004",2020-01-26,"Brush Creek Rd","w1920","Hybrid",0,"Sun","weekend","sled","Brush/Cement","2","1","1",7.4,0,32,0,28,23.1,-1,-1,2,1,-1,-2,0,1
"7005",2020-01-27,"Brush Creek Rd","w1920","Non.motorized",4,"Mon","weekday","no_sled","Brush/Cement","2","1","1",7.4,0,32,0,24,23.1,0,-1,-1,2,0,-1,-2,0
"7006",2020-01-27,"Brush Creek Rd","w1920","Mechanized",1,"Mon","weekday","no_sled","Brush/Cement","2","1","1",7.4,0,32,0,24,23.1,0,-1,-1,2,0,-1,-2,0
"7007",2020-01-27,"Brush Creek Rd","w1920","Motorized",0,"Mon","weekday","sled","Brush/Cement","2","1","1",7.4,0,32,0,24,23.1,0,-1,-1,2,0,-1,-2,0
"7008",2020-01-27,"Brush Creek Rd","w1920","Hybrid",0,"Mon","weekday","sled","Brush/Cement","2","1","1",7.4,0,32,0,24,23.1,0,-1,-1,2,0,-1,-2,0
"7009",2020-01-28,"Brush Creek Rd","w1920","Non.motorized",3,"Tue","weekday","no_sled","Brush/Cement","3","2","2",7.4,0,32,0,19,23.1,0,0,-1,-1,0,0,-1,-2
"7010",2020-01-28,"Brush Creek Rd","w1920","Mechanized",1,"Tue","weekday","no_sled","Brush/Cement","3","2","2",7.4,0,32,0,19,23.1,0,0,-1,-1,0,0,-1,-2
"7011",2020-01-28,"Brush Creek Rd","w1920","Motorized",0,"Tue","weekday","sled","Brush/Cement","3","2","2",7.4,0,32,0,19,23.1,0,0,-1,-1,0,0,-1,-2
"7012",2020-01-28,"Brush Creek Rd","w1920","Hybrid",0,"Tue","weekday","sled","Brush/Cement","3","2","2",7.4,0,32,0,19,23.1,0,0,-1,-1,0,0,-1,-2
"7013",2020-01-29,"Brush Creek Rd","w1920","Non.motorized",5,"Wed","weekday","no_sled","Brush/Cement","2","2","1",7.4,0,31,-1,20,23.9,0,0,0,-1,-1,-1,-1,-2
"7014",2020-01-29,"Brush Creek Rd","w1920","Mechanized",1,"Wed","weekday","no_sled","Brush/Cement","2","2","1",7.4,0,31,-1,20,23.9,0,0,0,-1,-1,-1,-1,-2
"7015",2020-01-29,"Brush Creek Rd","w1920","Motorized",0,"Wed","weekday","sled","Brush/Cement","2","2","1",7.4,0,31,-1,20,23.9,0,0,0,-1,-1,-1,-1,-2
"7016",2020-01-29,"Brush Creek Rd","w1920","Hybrid",0,"Wed","weekday","sled","Brush/Cement","2","2","1",7.4,0,31,-1,20,23.9,0,0,0,-1,-1,-1,-1,-2
"7017",2020-01-30,"Brush Creek Rd","w1920","Non.motorized",3,"Thu","weekday","no_sled","Brush/Cement","2","2","1",7.4,0,31,0,17,23.9,-1,0,0,0,-1,-1,-1,-1
"7018",2020-01-30,"Brush Creek Rd","w1920","Mechanized",1,"Thu","weekday","no_sled","Brush/Cement","2","2","1",7.4,0,31,0,17,23.9,-1,0,0,0,-1,-1,-1,-1
"7019",2020-01-30,"Brush Creek Rd","w1920","Motorized",0,"Thu","weekday","sled","Brush/Cement","2","2","1",7.4,0,31,0,17,23.9,-1,0,0,0,-1,-1,-1,-1
"7020",2020-01-30,"Brush Creek Rd","w1920","Hybrid",0,"Thu","weekday","sled","Brush/Cement","2","2","1",7.4,0,31,0,17,23.9,-1,0,0,0,-1,-1,-1,-1
"7021",2020-01-31,"Brush Creek Rd","w1920","Non.motorized",2,"Fri","weekday","no_sled","Brush/Cement","2","1","1",7.4,0,31,0,20,23.9,0,-1,0,0,0,-1,-1,-1
"7022",2020-01-31,"Brush Creek Rd","w1920","Mechanized",1,"Fri","weekday","no_sled","Brush/Cement","2","1","1",7.4,0,31,0,20,23.9,0,-1,0,0,0,-1,-1,-1
"7023",2020-01-31,"Brush Creek Rd","w1920","Motorized",0,"Fri","weekday","sled","Brush/Cement","2","1","1",7.4,0,31,0,20,23.9,0,-1,0,0,0,-1,-1,-1
"7024",2020-01-31,"Brush Creek Rd","w1920","Hybrid",0,"Fri","weekday","sled","Brush/Cement","2","1","1",7.4,0,31,0,20,23.9,0,-1,0,0,0,-1,-1,-1
"7025",2020-02-01,"Brush Creek Rd","w1920","Non.motorized",20,"Sat","weekend","no_sled","Brush/Cement","2","1","1",7.4,0,31,0,28,23.9,0,0,-1,0,0,0,-1,-1
"7026",2020-02-01,"Brush Creek Rd","w1920","Mechanized",1,"Sat","weekend","no_sled","Brush/Cement","2","1","1",7.4,0,31,0,28,23.9,0,0,-1,0,0,0,-1,-1
"7027",2020-02-01,"Brush Creek Rd","w1920","Motorized",0,"Sat","weekend","sled","Brush/Cement","2","1","1",7.4,0,31,0,28,23.9,0,0,-1,0,0,0,-1,-1
"7028",2020-02-01,"Brush Creek Rd","w1920","Hybrid",0,"Sat","weekend","sled","Brush/Cement","2","1","1",7.4,0,31,0,28,23.9,0,0,-1,0,0,0,-1,-1
"7029",2020-02-02,"Brush Creek Rd","w1920","Non.motorized",15,"Sun","weekend","no_sled","Brush/Cement","1","1","1",7.4,0,31,0,33,23.9,0,0,0,-1,0,0,0,-1
"7030",2020-02-02,"Brush Creek Rd","w1920","Mechanized",1,"Sun","weekend","no_sled","Brush/Cement","1","1","1",7.4,0,31,0,33,23.9,0,0,0,-1,0,0,0,-1
"7031",2020-02-02,"Brush Creek Rd","w1920","Motorized",0,"Sun","weekend","sled","Brush/Cement","1","1","1",7.4,0,31,0,33,23.9,0,0,0,-1,0,0,0,-1
"7032",2020-02-02,"Brush Creek Rd","w1920","Hybrid",0,"Sun","weekend","sled","Brush/Cement","1","1","1",7.4,0,31,0,33,23.9,0,0,0,-1,0,0,0,-1
"7033",2020-02-03,"Brush Creek Rd","w1920","Non.motorized",1,"Mon","weekday","no_sled","Brush/Cement","2","2","1",7.4,0,31,0,24,23.9,0,0,0,0,0,0,0,0
"7034",2020-02-03,"Brush Creek Rd","w1920","Mechanized",0,"Mon","weekday","no_sled","Brush/Cement","2","2","1",7.4,0,31,0,24,23.9,0,0,0,0,0,0,0,0
"7035",2020-02-03,"Brush Creek Rd","w1920","Motorized",0,"Mon","weekday","sled","Brush/Cement","2","2","1",7.4,0,31,0,24,23.9,0,0,0,0,0,0,0,0
"7036",2020-02-03,"Brush Creek Rd","w1920","Hybrid",0,"Mon","weekday","sled","Brush/Cement","2","2","1",7.4,0,31,0,24,23.9,0,0,0,0,0,0,0,0
"7037",2020-02-04,"Brush Creek Rd","w1920","Non.motorized",5,"Tue","weekday","no_sled","Brush/Cement","2","2","2",7.4,0,33,2,5,22.4,0,0,0,0,2,2,2,2
"7038",2020-02-04,"Brush Creek Rd","w1920","Mechanized",0,"Tue","weekday","no_sled","Brush/Cement","2","2","2",7.4,0,33,2,5,22.4,0,0,0,0,2,2,2,2
"7039",2020-02-04,"Brush Creek Rd","w1920","Motorized",0,"Tue","weekday","sled","Brush/Cement","2","2","2",7.4,0,33,2,5,22.4,0,0,0,0,2,2,2,2
"7040",2020-02-04,"Brush Creek Rd","w1920","Hybrid",0,"Tue","weekday","sled","Brush/Cement","2","2","2",7.4,0,33,2,5,22.4,0,0,0,0,2,2,2,2
"7041",2020-02-05,"Brush Creek Rd","w1920","Non.motorized",0,"Wed","weekday","no_sled","Brush/Cement","2","2","1",7.4,0,33,0,2,22.4,2,0,0,0,2,2,2,2
"7042",2020-02-05,"Brush Creek Rd","w1920","Mechanized",0,"Wed","weekday","no_sled","Brush/Cement","2","2","1",7.4,0,33,0,2,22.4,2,0,0,0,2,2,2,2
"7043",2020-02-05,"Brush Creek Rd","w1920","Motorized",0,"Wed","weekday","sled","Brush/Cement","2","2","1",7.4,0,33,0,2,22.4,2,0,0,0,2,2,2,2
"7044",2020-02-05,"Brush Creek Rd","w1920","Hybrid",0,"Wed","weekday","sled","Brush/Cement","2","2","1",7.4,0,33,0,2,22.4,2,0,0,0,2,2,2,2
"7045",2020-02-06,"Brush Creek Rd","w1920","Non.motorized",2,"Thu","weekday","no_sled","Brush/Cement","2","2","1",7.5,0.1,32,-1,16,23.4,0,2,0,0,-1,1,1,1
"7046",2020-02-06,"Brush Creek Rd","w1920","Mechanized",0,"Thu","weekday","no_sled","Brush/Cement","2","2","1",7.5,0.1,32,-1,16,23.4,0,2,0,0,-1,1,1,1
"7047",2020-02-06,"Brush Creek Rd","w1920","Motorized",0,"Thu","weekday","sled","Brush/Cement","2","2","1",7.5,0.1,32,-1,16,23.4,0,2,0,0,-1,1,1,1
"7048",2020-02-06,"Brush Creek Rd","w1920","Hybrid",0,"Thu","weekday","sled","Brush/Cement","2","2","1",7.5,0.1,32,-1,16,23.4,0,2,0,0,-1,1,1,1
"7049",2020-02-07,"Brush Creek Rd","w1920","Non.motorized",NA,"Fri","weekday","no_sled","Brush/Cement","3","3","3",7.9,0.4,37,5,26,21.4,-1,0,2,0,4,4,6,6
"7050",2020-02-07,"Brush Creek Rd","w1920","Mechanized",NA,"Fri","weekday","no_sled","Brush/Cement","3","3","3",7.9,0.4,37,5,26,21.4,-1,0,2,0,4,4,6,6
"7051",2020-02-07,"Brush Creek Rd","w1920","Motorized",NA,"Fri","weekday","sled","Brush/Cement","3","3","3",7.9,0.4,37,5,26,21.4,-1,0,2,0,4,4,6,6
"7052",2020-02-07,"Brush Creek Rd","w1920","Hybrid",NA,"Fri","weekday","sled","Brush/Cement","3","3","3",7.9,0.4,37,5,26,21.4,-1,0,2,0,4,4,6,6
"7053",2020-02-08,"Brush Creek Rd","w1920","Non.motorized",7,"Sat","weekend","no_sled","Brush/Cement","3","3","2",8.3,0.4,39,2,30,21.3,5,-1,0,2,7,6,6,8
"7054",2020-02-08,"Brush Creek Rd","w1920","Mechanized",0,"Sat","weekend","no_sled","Brush/Cement","3","3","2",8.3,0.4,39,2,30,21.3,5,-1,0,2,7,6,6,8
"7055",2020-02-08,"Brush Creek Rd","w1920","Motorized",0,"Sat","weekend","sled","Brush/Cement","3","3","2",8.3,0.4,39,2,30,21.3,5,-1,0,2,7,6,6,8
"7056",2020-02-08,"Brush Creek Rd","w1920","Hybrid",0,"Sat","weekend","sled","Brush/Cement","3","3","2",8.3,0.4,39,2,30,21.3,5,-1,0,2,7,6,6,8
"7057",2020-02-09,"Brush Creek Rd","w1920","Non.motorized",11,"Sun","weekend","no_sled","Brush/Cement","3","2","2",8.4,0.1,38,-1,26,22.1,2,5,-1,0,1,6,5,5
"7058",2020-02-09,"Brush Creek Rd","w1920","Mechanized",0,"Sun","weekend","no_sled","Brush/Cement","3","2","2",8.4,0.1,38,-1,26,22.1,2,5,-1,0,1,6,5,5
"7059",2020-02-09,"Brush Creek Rd","w1920","Motorized",0,"Sun","weekend","sled","Brush/Cement","3","2","2",8.4,0.1,38,-1,26,22.1,2,5,-1,0,1,6,5,5
"7060",2020-02-09,"Brush Creek Rd","w1920","Hybrid",0,"Sun","weekend","sled","Brush/Cement","3","2","2",8.4,0.1,38,-1,26,22.1,2,5,-1,0,1,6,5,5
"7061",2020-02-10,"Brush Creek Rd","w1920","Non.motorized",NA,"Mon","weekday","no_sled","Brush/Cement","2","2","1",8.4,0,38,0,22,22.1,-1,2,5,-1,-1,1,6,5
"7062",2020-02-10,"Brush Creek Rd","w1920","Mechanized",NA,"Mon","weekday","no_sled","Brush/Cement","2","2","1",8.4,0,38,0,22,22.1,-1,2,5,-1,-1,1,6,5
"7063",2020-02-10,"Brush Creek Rd","w1920","Motorized",NA,"Mon","weekday","sled","Brush/Cement","2","2","1",8.4,0,38,0,22,22.1,-1,2,5,-1,-1,1,6,5
"7064",2020-02-10,"Brush Creek Rd","w1920","Hybrid",NA,"Mon","weekday","sled","Brush/Cement","2","2","1",8.4,0,38,0,22,22.1,-1,2,5,-1,-1,1,6,5
"7065",2020-02-11,"Brush Creek Rd","w1920","Non.motorized",7,"Tue","weekday","no_sled","Brush/Cement","2","2","2",8.5,0.1,40,2,16,21.2,0,-1,2,5,2,1,3,8
"7066",2020-02-11,"Brush Creek Rd","w1920","Mechanized",0,"Tue","weekday","no_sled","Brush/Cement","2","2","2",8.5,0.1,40,2,16,21.2,0,-1,2,5,2,1,3,8
"7067",2020-02-11,"Brush Creek Rd","w1920","Motorized",0,"Tue","weekday","sled","Brush/Cement","2","2","2",8.5,0.1,40,2,16,21.2,0,-1,2,5,2,1,3,8
"7068",2020-02-11,"Brush Creek Rd","w1920","Hybrid",0,"Tue","weekday","sled","Brush/Cement","2","2","2",8.5,0.1,40,2,16,21.2,0,-1,2,5,2,1,3,8
"7069",2020-02-12,"Brush Creek Rd","w1920","Non.motorized",9,"Wed","weekday","no_sled","Brush/Cement","2","2","2",8.5,0,39,-1,15,21.8,2,0,-1,2,1,1,0,2
"7070",2020-02-12,"Brush Creek Rd","w1920","Mechanized",0,"Wed","weekday","no_sled","Brush/Cement","2","2","2",8.5,0,39,-1,15,21.8,2,0,-1,2,1,1,0,2
"7071",2020-02-12,"Brush Creek Rd","w1920","Motorized",0,"Wed","weekday","sled","Brush/Cement","2","2","2",8.5,0,39,-1,15,21.8,2,0,-1,2,1,1,0,2
"7072",2020-02-12,"Brush Creek Rd","w1920","Hybrid",0,"Wed","weekday","sled","Brush/Cement","2","2","2",8.5,0,39,-1,15,21.8,2,0,-1,2,1,1,0,2
"7073",2020-02-13,"Brush Creek Rd","w1920","Non.motorized",NA,"Thu","weekday","no_sled","Brush/Cement","2","2","1",8.5,0,39,0,18,21.8,-1,2,0,-1,-1,1,1,0
"7074",2020-02-13,"Brush Creek Rd","w1920","Mechanized",NA,"Thu","weekday","no_sled","Brush/Cement","2","2","1",8.5,0,39,0,18,21.8,-1,2,0,-1,-1,1,1,0
"7075",2020-02-13,"Brush Creek Rd","w1920","Motorized",NA,"Thu","weekday","sled","Brush/Cement","2","2","1",8.5,0,39,0,18,21.8,-1,2,0,-1,-1,1,1,0
"7076",2020-02-13,"Brush Creek Rd","w1920","Hybrid",NA,"Thu","weekday","sled","Brush/Cement","2","2","1",8.5,0,39,0,18,21.8,-1,2,0,-1,-1,1,1,0
"7077",2020-02-14,"Brush Creek Rd","w1920","Non.motorized",10,"Fri","weekday","no_sled","Brush/Cement","2","1","1",8.6,0.1,38,-1,24,22.6,0,-1,2,0,-1,-2,0,0
"7078",2020-02-14,"Brush Creek Rd","w1920","Mechanized",0,"Fri","weekday","no_sled","Brush/Cement","2","1","1",8.6,0.1,38,-1,24,22.6,0,-1,2,0,-1,-2,0,0
"7079",2020-02-14,"Brush Creek Rd","w1920","Motorized",0,"Fri","weekday","sled","Brush/Cement","2","1","1",8.6,0.1,38,-1,24,22.6,0,-1,2,0,-1,-2,0,0
"7080",2020-02-14,"Brush Creek Rd","w1920","Hybrid",0,"Fri","weekday","sled","Brush/Cement","2","1","1",8.6,0.1,38,-1,24,22.6,0,-1,2,0,-1,-2,0,0
"7081",2020-02-15,"Brush Creek Rd","w1920","Non.motorized",11,"Sat","weekend","no_sled","Brush/Cement","1","1","1",8.6,0,38,0,26,22.6,-1,0,-1,2,-1,-1,-2,0
"7082",2020-02-15,"Brush Creek Rd","w1920","Mechanized",0,"Sat","weekend","no_sled","Brush/Cement","1","1","1",8.6,0,38,0,26,22.6,-1,0,-1,2,-1,-1,-2,0
"7083",2020-02-15,"Brush Creek Rd","w1920","Motorized",0,"Sat","weekend","sled","Brush/Cement","1","1","1",8.6,0,38,0,26,22.6,-1,0,-1,2,-1,-1,-2,0
"7084",2020-02-15,"Brush Creek Rd","w1920","Hybrid",0,"Sat","weekend","sled","Brush/Cement","1","1","1",8.6,0,38,0,26,22.6,-1,0,-1,2,-1,-1,-2,0
"7085",2020-02-16,"Brush Creek Rd","w1920","Non.motorized",9,"Sun","weekend","no_sled","Brush/Cement","1","1","1",8.8,0.2,37,-1,26,23.8,0,-1,0,-1,-1,-2,-2,-3
"7086",2020-02-16,"Brush Creek Rd","w1920","Mechanized",0,"Sun","weekend","no_sled","Brush/Cement","1","1","1",8.8,0.2,37,-1,26,23.8,0,-1,0,-1,-1,-2,-2,-3
"7087",2020-02-16,"Brush Creek Rd","w1920","Motorized",0,"Sun","weekend","sled","Brush/Cement","1","1","1",8.8,0.2,37,-1,26,23.8,0,-1,0,-1,-1,-2,-2,-3
"7088",2020-02-16,"Brush Creek Rd","w1920","Hybrid",0,"Sun","weekend","sled","Brush/Cement","1","1","1",8.8,0.2,37,-1,26,23.8,0,-1,0,-1,-1,-2,-2,-3
"7089",2020-02-17,"Brush Creek Rd","w1920","Non.motorized",10,"Mon","weekday","no_sled","Brush/Cement","2","1","1",9.2,0.4,43,6,25,21.4,-1,0,-1,0,5,5,4,4
"7090",2020-02-17,"Brush Creek Rd","w1920","Mechanized",0,"Mon","weekday","no_sled","Brush/Cement","2","1","1",9.2,0.4,43,6,25,21.4,-1,0,-1,0,5,5,4,4
"7091",2020-02-17,"Brush Creek Rd","w1920","Motorized",0,"Mon","weekday","sled","Brush/Cement","2","1","1",9.2,0.4,43,6,25,21.4,-1,0,-1,0,5,5,4,4
"7092",2020-02-17,"Brush Creek Rd","w1920","Hybrid",0,"Mon","weekday","sled","Brush/Cement","2","1","1",9.2,0.4,43,6,25,21.4,-1,0,-1,0,5,5,4,4
"7093",2020-02-18,"Brush Creek Rd","w1920","Non.motorized",9,"Tue","weekday","no_sled","Brush/Cement","1","1","1",9.3,0.1,42,-1,18,22.1,6,-1,0,-1,5,4,4,3
"7094",2020-02-18,"Brush Creek Rd","w1920","Mechanized",0,"Tue","weekday","no_sled","Brush/Cement","1","1","1",9.3,0.1,42,-1,18,22.1,6,-1,0,-1,5,4,4,3
"7095",2020-02-18,"Brush Creek Rd","w1920","Motorized",0,"Tue","weekday","sled","Brush/Cement","1","1","1",9.3,0.1,42,-1,18,22.1,6,-1,0,-1,5,4,4,3
"7096",2020-02-18,"Brush Creek Rd","w1920","Hybrid",0,"Tue","weekday","sled","Brush/Cement","1","1","1",9.3,0.1,42,-1,18,22.1,6,-1,0,-1,5,4,4,3
"7097",2020-02-19,"Brush Creek Rd","w1920","Non.motorized",3,"Wed","weekday","no_sled","Brush/Cement","1","1","1",9.3,0,41,-1,22,22.7,-1,6,-1,0,-2,4,3,3
"7098",2020-02-19,"Brush Creek Rd","w1920","Mechanized",0,"Wed","weekday","no_sled","Brush/Cement","1","1","1",9.3,0,41,-1,22,22.7,-1,6,-1,0,-2,4,3,3
"7099",2020-02-19,"Brush Creek Rd","w1920","Motorized",0,"Wed","weekday","sled","Brush/Cement","1","1","1",9.3,0,41,-1,22,22.7,-1,6,-1,0,-2,4,3,3
"7100",2020-02-19,"Brush Creek Rd","w1920","Hybrid",0,"Wed","weekday","sled","Brush/Cement","1","1","1",9.3,0,41,-1,22,22.7,-1,6,-1,0,-2,4,3,3
"7101",2020-02-20,"Brush Creek Rd","w1920","Non.motorized",6,"Thu","weekday","no_sled","Brush/Cement","1","1","1",9.3,0,41,0,18,22.7,-1,-1,6,-1,-1,-2,4,3
"7102",2020-02-20,"Brush Creek Rd","w1920","Mechanized",0,"Thu","weekday","no_sled","Brush/Cement","1","1","1",9.3,0,41,0,18,22.7,-1,-1,6,-1,-1,-2,4,3
"7103",2020-02-20,"Brush Creek Rd","w1920","Motorized",0,"Thu","weekday","sled","Brush/Cement","1","1","1",9.3,0,41,0,18,22.7,-1,-1,6,-1,-1,-2,4,3
"7104",2020-02-20,"Brush Creek Rd","w1920","Hybrid",0,"Thu","weekday","sled","Brush/Cement","1","1","1",9.3,0,41,0,18,22.7,-1,-1,6,-1,-1,-2,4,3
"7105",2020-02-21,"Brush Creek Rd","w1920","Non.motorized",7,"Fri","weekday","no_sled","Brush/Cement","1","1","1",9.3,0,40,-1,26,23.2,0,-1,-1,6,-1,-2,-3,3
"7106",2020-02-21,"Brush Creek Rd","w1920","Mechanized",0,"Fri","weekday","no_sled","Brush/Cement","1","1","1",9.3,0,40,-1,26,23.2,0,-1,-1,6,-1,-2,-3,3
"7107",2020-02-21,"Brush Creek Rd","w1920","Motorized",0,"Fri","weekday","sled","Brush/Cement","1","1","1",9.3,0,40,-1,26,23.2,0,-1,-1,6,-1,-2,-3,3
"7108",2020-02-21,"Brush Creek Rd","w1920","Hybrid",0,"Fri","weekday","sled","Brush/Cement","1","1","1",9.3,0,40,-1,26,23.2,0,-1,-1,6,-1,-2,-3,3
"7109",2020-02-22,"Brush Creek Rd","w1920","Non.motorized",15,"Sat","weekend","no_sled","Brush/Cement","1","1","1",9.4,0.1,39,-1,32,24.1,-1,0,-1,-1,-2,-2,-3,-4
"7110",2020-02-22,"Brush Creek Rd","w1920","Mechanized",0,"Sat","weekend","no_sled","Brush/Cement","1","1","1",9.4,0.1,39,-1,32,24.1,-1,0,-1,-1,-2,-2,-3,-4
"7111",2020-02-22,"Brush Creek Rd","w1920","Motorized",0,"Sat","weekend","sled","Brush/Cement","1","1","1",9.4,0.1,39,-1,32,24.1,-1,0,-1,-1,-2,-2,-3,-4
"7112",2020-02-22,"Brush Creek Rd","w1920","Hybrid",0,"Sat","weekend","sled","Brush/Cement","1","1","1",9.4,0.1,39,-1,32,24.1,-1,0,-1,-1,-2,-2,-3,-4
"7113",2020-02-23,"Brush Creek Rd","w1920","Non.motorized",7,"Sun","weekend","no_sled","Brush/Cement","2","2","2",9.5,0.1,40,1,27,23.8,-1,-1,0,-1,0,-1,-1,-2
"7114",2020-02-23,"Brush Creek Rd","w1920","Mechanized",0,"Sun","weekend","no_sled","Brush/Cement","2","2","2",9.5,0.1,40,1,27,23.8,-1,-1,0,-1,0,-1,-1,-2
"7115",2020-02-23,"Brush Creek Rd","w1920","Motorized",0,"Sun","weekend","sled","Brush/Cement","2","2","2",9.5,0.1,40,1,27,23.8,-1,-1,0,-1,0,-1,-1,-2
"7116",2020-02-23,"Brush Creek Rd","w1920","Hybrid",0,"Sun","weekend","sled","Brush/Cement","2","2","2",9.5,0.1,40,1,27,23.8,-1,-1,0,-1,0,-1,-1,-2
"7117",2020-02-24,"Brush Creek Rd","w1920","Non.motorized",1,"Mon","weekday","no_sled","Brush/Cement","3","3","2",9.8,0.3,43,3,17,22.8,1,-1,-1,0,4,3,2,2
"7118",2020-02-24,"Brush Creek Rd","w1920","Mechanized",0,"Mon","weekday","no_sled","Brush/Cement","3","3","2",9.8,0.3,43,3,17,22.8,1,-1,-1,0,4,3,2,2
"7119",2020-02-24,"Brush Creek Rd","w1920","Motorized",0,"Mon","weekday","sled","Brush/Cement","3","3","2",9.8,0.3,43,3,17,22.8,1,-1,-1,0,4,3,2,2
"7120",2020-02-24,"Brush Creek Rd","w1920","Hybrid",0,"Mon","weekday","sled","Brush/Cement","3","3","2",9.8,0.3,43,3,17,22.8,1,-1,-1,0,4,3,2,2
"7121",2020-02-25,"Brush Creek Rd","w1920","Non.motorized",0,"Tue","weekday","no_sled","Brush/Cement","2","2","1",9.8,0,43,0,8,22.8,3,1,-1,-1,3,4,3,2
"7122",2020-02-25,"Brush Creek Rd","w1920","Mechanized",0,"Tue","weekday","no_sled","Brush/Cement","2","2","1",9.8,0,43,0,8,22.8,3,1,-1,-1,3,4,3,2
"7123",2020-02-25,"Brush Creek Rd","w1920","Motorized",0,"Tue","weekday","sled","Brush/Cement","2","2","1",9.8,0,43,0,8,22.8,3,1,-1,-1,3,4,3,2
"7124",2020-02-25,"Brush Creek Rd","w1920","Hybrid",0,"Tue","weekday","sled","Brush/Cement","2","2","1",9.8,0,43,0,8,22.8,3,1,-1,-1,3,4,3,2
"7125",2020-02-26,"Brush Creek Rd","w1920","Non.motorized",1,"Wed","weekday","no_sled","Brush/Cement","2","2","1",9.8,0,42,-1,15,23.3,0,3,1,-1,-1,2,3,2
"7126",2020-02-26,"Brush Creek Rd","w1920","Mechanized",0,"Wed","weekday","no_sled","Brush/Cement","2","2","1",9.8,0,42,-1,15,23.3,0,3,1,-1,-1,2,3,2
"7127",2020-02-26,"Brush Creek Rd","w1920","Motorized",0,"Wed","weekday","sled","Brush/Cement","2","2","1",9.8,0,42,-1,15,23.3,0,3,1,-1,-1,2,3,2
"7128",2020-02-26,"Brush Creek Rd","w1920","Hybrid",0,"Wed","weekday","sled","Brush/Cement","2","2","1",9.8,0,42,-1,15,23.3,0,3,1,-1,-1,2,3,2
"7129",2020-02-27,"Brush Creek Rd","w1920","Non.motorized",22,"Thu","weekday","no_sled","Brush/Cement","2","2","1",9.9,0.1,41,-1,25,24.1,-1,0,3,1,-2,-2,1,2
"7130",2020-02-27,"Brush Creek Rd","w1920","Mechanized",0,"Thu","weekday","no_sled","Brush/Cement","2","2","1",9.9,0.1,41,-1,25,24.1,-1,0,3,1,-2,-2,1,2
"7131",2020-02-27,"Brush Creek Rd","w1920","Motorized",0,"Thu","weekday","sled","Brush/Cement","2","2","1",9.9,0.1,41,-1,25,24.1,-1,0,3,1,-2,-2,1,2
"7132",2020-02-27,"Brush Creek Rd","w1920","Hybrid",0,"Thu","weekday","sled","Brush/Cement","2","2","1",9.9,0.1,41,-1,25,24.1,-1,0,3,1,-2,-2,1,2
"7133",2020-02-28,"Brush Creek Rd","w1920","Non.motorized",6,"Fri","weekday","no_sled","Brush/Cement","2","1","1",9.9,0,41,0,28,24.1,-1,-1,0,3,-1,-2,-2,1
"7134",2020-02-28,"Brush Creek Rd","w1920","Mechanized",0,"Fri","weekday","no_sled","Brush/Cement","2","1","1",9.9,0,41,0,28,24.1,-1,-1,0,3,-1,-2,-2,1
"7135",2020-02-28,"Brush Creek Rd","w1920","Motorized",0,"Fri","weekday","sled","Brush/Cement","2","1","1",9.9,0,41,0,28,24.1,-1,-1,0,3,-1,-2,-2,1
"7136",2020-02-28,"Brush Creek Rd","w1920","Hybrid",0,"Fri","weekday","sled","Brush/Cement","2","1","1",9.9,0,41,0,28,24.1,-1,-1,0,3,-1,-2,-2,1
"7137",2020-02-29,"Brush Creek Rd","w1920","Non.motorized",17,"Sat","weekend","no_sled","Brush/Cement","1","1","1",9.9,0,40,-1,29,24.8,0,-1,-1,0,-1,-2,-3,-3
"7138",2020-02-29,"Brush Creek Rd","w1920","Mechanized",0,"Sat","weekend","no_sled","Brush/Cement","1","1","1",9.9,0,40,-1,29,24.8,0,-1,-1,0,-1,-2,-3,-3
"7139",2020-02-29,"Brush Creek Rd","w1920","Motorized",0,"Sat","weekend","sled","Brush/Cement","1","1","1",9.9,0,40,-1,29,24.8,0,-1,-1,0,-1,-2,-3,-3
"7140",2020-02-29,"Brush Creek Rd","w1920","Hybrid",0,"Sat","weekend","sled","Brush/Cement","1","1","1",9.9,0,40,-1,29,24.8,0,-1,-1,0,-1,-2,-3,-3
"7141",2020-03-01,"Brush Creek Rd","w1920","Non.motorized",13,"Sun","weekend","no_sled","Brush/Cement","1","1","1",10,0.1,40,0,28,25,-1,0,-1,-1,-1,-1,-2,-3
"7142",2020-03-01,"Brush Creek Rd","w1920","Mechanized",0,"Sun","weekend","no_sled","Brush/Cement","1","1","1",10,0.1,40,0,28,25,-1,0,-1,-1,-1,-1,-2,-3
"7143",2020-03-01,"Brush Creek Rd","w1920","Motorized",0,"Sun","weekend","sled","Brush/Cement","1","1","1",10,0.1,40,0,28,25,-1,0,-1,-1,-1,-1,-2,-3
"7144",2020-03-01,"Brush Creek Rd","w1920","Hybrid",0,"Sun","weekend","sled","Brush/Cement","1","1","1",10,0.1,40,0,28,25,-1,0,-1,-1,-1,-1,-2,-3
"7145",2020-03-02,"Brush Creek Rd","w1920","Non.motorized",0,"Mon","weekday","no_sled","Brush/Cement","2","2","1",10.4,0.4,45,5,25,23.1,0,-1,0,-1,5,4,4,3
"7146",2020-03-02,"Brush Creek Rd","w1920","Mechanized",0,"Mon","weekday","no_sled","Brush/Cement","2","2","1",10.4,0.4,45,5,25,23.1,0,-1,0,-1,5,4,4,3
"7147",2020-03-02,"Brush Creek Rd","w1920","Motorized",0,"Mon","weekday","sled","Brush/Cement","2","2","1",10.4,0.4,45,5,25,23.1,0,-1,0,-1,5,4,4,3
"7148",2020-03-02,"Brush Creek Rd","w1920","Hybrid",0,"Mon","weekday","sled","Brush/Cement","2","2","1",10.4,0.4,45,5,25,23.1,0,-1,0,-1,5,4,4,3
"7149",2020-03-03,"Brush Creek Rd","w1920","Non.motorized",0,"Tue","weekday","no_sled","Brush/Cement","2","1","1",10.9,0.5,50,5,25,21.8,5,0,-1,0,10,10,9,9
"7150",2020-03-03,"Brush Creek Rd","w1920","Mechanized",0,"Tue","weekday","no_sled","Brush/Cement","2","1","1",10.9,0.5,50,5,25,21.8,5,0,-1,0,10,10,9,9
"7151",2020-03-03,"Brush Creek Rd","w1920","Motorized",0,"Tue","weekday","sled","Brush/Cement","2","1","1",10.9,0.5,50,5,25,21.8,5,0,-1,0,10,10,9,9
"7152",2020-03-03,"Brush Creek Rd","w1920","Hybrid",0,"Tue","weekday","sled","Brush/Cement","2","1","1",10.9,0.5,50,5,25,21.8,5,0,-1,0,10,10,9,9
"7153",2020-03-04,"Brush Creek Rd","w1920","Non.motorized",1,"Wed","weekday","no_sled","Brush/Cement","2","1","1",10.9,0,48,-2,29,22.7,5,5,0,-1,3,8,8,7
"7154",2020-03-04,"Brush Creek Rd","w1920","Mechanized",0,"Wed","weekday","no_sled","Brush/Cement","2","1","1",10.9,0,48,-2,29,22.7,5,5,0,-1,3,8,8,7
"7155",2020-03-04,"Brush Creek Rd","w1920","Motorized",0,"Wed","weekday","sled","Brush/Cement","2","1","1",10.9,0,48,-2,29,22.7,5,5,0,-1,3,8,8,7
"7156",2020-03-04,"Brush Creek Rd","w1920","Hybrid",0,"Wed","weekday","sled","Brush/Cement","2","1","1",10.9,0,48,-2,29,22.7,5,5,0,-1,3,8,8,7
"7157",2020-03-05,"Brush Creek Rd","w1920","Non.motorized",0,"Thu","weekday","no_sled","Brush/Cement","2","1","1",10.9,0,46,-2,32,23.7,-2,5,5,0,-4,1,6,6
"7158",2020-03-05,"Brush Creek Rd","w1920","Mechanized",0,"Thu","weekday","no_sled","Brush/Cement","2","1","1",10.9,0,46,-2,32,23.7,-2,5,5,0,-4,1,6,6
"7159",2020-03-05,"Brush Creek Rd","w1920","Motorized",0,"Thu","weekday","sled","Brush/Cement","2","1","1",10.9,0,46,-2,32,23.7,-2,5,5,0,-4,1,6,6
"7160",2020-03-05,"Brush Creek Rd","w1920","Hybrid",0,"Thu","weekday","sled","Brush/Cement","2","1","1",10.9,0,46,-2,32,23.7,-2,5,5,0,-4,1,6,6
"7161",2020-03-06,"Brush Creek Rd","w1920","Non.motorized",7,"Fri","weekday","no_sled","Brush/Cement","1","1","1",10.9,0,45,-1,34,24.2,-2,-2,5,5,-3,-5,0,5
"7162",2020-03-06,"Brush Creek Rd","w1920","Mechanized",0,"Fri","weekday","no_sled","Brush/Cement","1","1","1",10.9,0,45,-1,34,24.2,-2,-2,5,5,-3,-5,0,5
"7163",2020-03-06,"Brush Creek Rd","w1920","Motorized",0,"Fri","weekday","sled","Brush/Cement","1","1","1",10.9,0,45,-1,34,24.2,-2,-2,5,5,-3,-5,0,5
"7164",2020-03-06,"Brush Creek Rd","w1920","Hybrid",0,"Fri","weekday","sled","Brush/Cement","1","1","1",10.9,0,45,-1,34,24.2,-2,-2,5,5,-3,-5,0,5
"7165",2020-03-07,"Brush Creek Rd","w1920","Non.motorized",11,"Sat","weekend","no_sled","Brush/Cement","1","1","2",10.9,0,44,-1,35,24.8,-1,-2,-2,5,-2,-4,-6,-1
"7166",2020-03-07,"Brush Creek Rd","w1920","Mechanized",0,"Sat","weekend","no_sled","Brush/Cement","1","1","2",10.9,0,44,-1,35,24.8,-1,-2,-2,5,-2,-4,-6,-1
"7167",2020-03-07,"Brush Creek Rd","w1920","Motorized",0,"Sat","weekend","sled","Brush/Cement","1","1","2",10.9,0,44,-1,35,24.8,-1,-2,-2,5,-2,-4,-6,-1
"7168",2020-03-07,"Brush Creek Rd","w1920","Hybrid",0,"Sat","weekend","sled","Brush/Cement","1","1","2",10.9,0,44,-1,35,24.8,-1,-2,-2,5,-2,-4,-6,-1
"7169",2020-03-08,"Brush Creek Rd","w1920","Non.motorized",13,"Sun","weekend","no_sled","Brush/Cement","1","1","1",11,0.1,43,-1,33,25.6,-1,-1,-2,-2,-2,-3,-5,-7
"7170",2020-03-08,"Brush Creek Rd","w1920","Mechanized",0,"Sun","weekend","no_sled","Brush/Cement","1","1","1",11,0.1,43,-1,33,25.6,-1,-1,-2,-2,-2,-3,-5,-7
"7171",2020-03-08,"Brush Creek Rd","w1920","Motorized",0,"Sun","weekend","sled","Brush/Cement","1","1","1",11,0.1,43,-1,33,25.6,-1,-1,-2,-2,-2,-3,-5,-7
"7172",2020-03-08,"Brush Creek Rd","w1920","Hybrid",0,"Sun","weekend","sled","Brush/Cement","1","1","1",11,0.1,43,-1,33,25.6,-1,-1,-2,-2,-2,-3,-5,-7
"7173",2020-03-09,"Brush Creek Rd","w1920","Non.motorized",3,"Mon","weekday","no_sled","Brush/Cement","1","1","1",11.1,0.1,42,-1,31,26.4,-1,-1,-1,-2,-2,-3,-4,-6
"7174",2020-03-09,"Brush Creek Rd","w1920","Mechanized",0,"Mon","weekday","no_sled","Brush/Cement","1","1","1",11.1,0.1,42,-1,31,26.4,-1,-1,-1,-2,-2,-3,-4,-6
"7175",2020-03-09,"Brush Creek Rd","w1920","Motorized",0,"Mon","weekday","sled","Brush/Cement","1","1","1",11.1,0.1,42,-1,31,26.4,-1,-1,-1,-2,-2,-3,-4,-6
"7176",2020-03-09,"Brush Creek Rd","w1920","Hybrid",0,"Mon","weekday","sled","Brush/Cement","1","1","1",11.1,0.1,42,-1,31,26.4,-1,-1,-1,-2,-2,-3,-4,-6
"7177",2020-03-10,"Brush Creek Rd","w1920","Non.motorized",0,"Tue","weekday","no_sled","Brush/Cement","1","1","2",11.2,0.1,44,2,31,25.5,-1,-1,-1,-1,1,0,-1,-2
"7178",2020-03-10,"Brush Creek Rd","w1920","Mechanized",0,"Tue","weekday","no_sled","Brush/Cement","1","1","2",11.2,0.1,44,2,31,25.5,-1,-1,-1,-1,1,0,-1,-2
"7179",2020-03-10,"Brush Creek Rd","w1920","Motorized",0,"Tue","weekday","sled","Brush/Cement","1","1","2",11.2,0.1,44,2,31,25.5,-1,-1,-1,-1,1,0,-1,-2
"7180",2020-03-10,"Brush Creek Rd","w1920","Hybrid",0,"Tue","weekday","sled","Brush/Cement","1","1","2",11.2,0.1,44,2,31,25.5,-1,-1,-1,-1,1,0,-1,-2
"7181",2020-03-11,"Brush Creek Rd","w1920","Non.motorized",9,"Wed","weekday","no_sled","Brush/Cement","2","2","1",11.2,0,44,0,32,25.5,2,-1,-1,-1,2,1,0,-1
"7182",2020-03-11,"Brush Creek Rd","w1920","Mechanized",0,"Wed","weekday","no_sled","Brush/Cement","2","2","1",11.2,0,44,0,32,25.5,2,-1,-1,-1,2,1,0,-1
"7183",2020-03-11,"Brush Creek Rd","w1920","Motorized",0,"Wed","weekday","sled","Brush/Cement","2","2","1",11.2,0,44,0,32,25.5,2,-1,-1,-1,2,1,0,-1
"7184",2020-03-11,"Brush Creek Rd","w1920","Hybrid",0,"Wed","weekday","sled","Brush/Cement","2","2","1",11.2,0,44,0,32,25.5,2,-1,-1,-1,2,1,0,-1
"7185",2020-03-12,"Brush Creek Rd","w1920","Non.motorized",4,"Thu","weekday","no_sled","Brush/Cement","2","2","2",11.4,0.2,42,-2,35,27.1,0,2,-1,-1,-2,0,-1,-2
"7186",2020-03-12,"Brush Creek Rd","w1920","Mechanized",0,"Thu","weekday","no_sled","Brush/Cement","2","2","2",11.4,0.2,42,-2,35,27.1,0,2,-1,-1,-2,0,-1,-2
"7187",2020-03-12,"Brush Creek Rd","w1920","Motorized",0,"Thu","weekday","sled","Brush/Cement","2","2","2",11.4,0.2,42,-2,35,27.1,0,2,-1,-1,-2,0,-1,-2
"7188",2020-03-12,"Brush Creek Rd","w1920","Hybrid",0,"Thu","weekday","sled","Brush/Cement","2","2","2",11.4,0.2,42,-2,35,27.1,0,2,-1,-1,-2,0,-1,-2
"7189",2020-03-13,"Brush Creek Rd","w1920","Non.motorized",10,"Fri","weekday","no_sled","Brush/Cement","3","3","2",11.5,0.1,44,2,31,26.1,-2,0,2,-1,0,0,2,1
"7190",2020-03-13,"Brush Creek Rd","w1920","Mechanized",0,"Fri","weekday","no_sled","Brush/Cement","3","3","2",11.5,0.1,44,2,31,26.1,-2,0,2,-1,0,0,2,1
"7191",2020-03-13,"Brush Creek Rd","w1920","Motorized",0,"Fri","weekday","sled","Brush/Cement","3","3","2",11.5,0.1,44,2,31,26.1,-2,0,2,-1,0,0,2,1
"7192",2020-03-13,"Brush Creek Rd","w1920","Hybrid",0,"Fri","weekday","sled","Brush/Cement","3","3","2",11.5,0.1,44,2,31,26.1,-2,0,2,-1,0,0,2,1
"7193",2020-03-14,"Brush Creek Rd","w1920","Non.motorized",16,"Sat","weekend","no_sled","Brush/Cement","3","3","3",11.7,0.2,44,0,31,26.6,2,-2,0,2,2,0,0,2
"7194",2020-03-14,"Brush Creek Rd","w1920","Mechanized",0,"Sat","weekend","no_sled","Brush/Cement","3","3","3",11.7,0.2,44,0,31,26.6,2,-2,0,2,2,0,0,2
"7195",2020-03-14,"Brush Creek Rd","w1920","Motorized",0,"Sat","weekend","sled","Brush/Cement","3","3","3",11.7,0.2,44,0,31,26.6,2,-2,0,2,2,0,0,2
"7196",2020-03-14,"Brush Creek Rd","w1920","Hybrid",0,"Sat","weekend","sled","Brush/Cement","3","3","3",11.7,0.2,44,0,31,26.6,2,-2,0,2,2,0,0,2
"7197",2020-03-15,"Brush Creek Rd","w1920","Non.motorized",27,"Sun","weekend","no_sled","Brush/Cement","2","2","2",11.7,0,45,1,33,26,0,2,-2,0,1,3,1,1
"7198",2020-03-15,"Brush Creek Rd","w1920","Mechanized",0,"Sun","weekend","no_sled","Brush/Cement","2","2","2",11.7,0,45,1,33,26,0,2,-2,0,1,3,1,1
"7199",2020-03-15,"Brush Creek Rd","w1920","Motorized",0,"Sun","weekend","sled","Brush/Cement","2","2","2",11.7,0,45,1,33,26,0,2,-2,0,1,3,1,1
"7200",2020-03-15,"Brush Creek Rd","w1920","Hybrid",0,"Sun","weekend","sled","Brush/Cement","2","2","2",11.7,0,45,1,33,26,0,2,-2,0,1,3,1,1
"7201",2020-03-16,"Brush Creek Rd","w1920","Non.motorized",5,"Mon","weekday","no_sled","Brush/Cement","2","2","2",11.7,0,45,0,35,26,1,0,2,-2,1,1,3,1
"7202",2020-03-16,"Brush Creek Rd","w1920","Mechanized",0,"Mon","weekday","no_sled","Brush/Cement","2","2","2",11.7,0,45,0,35,26,1,0,2,-2,1,1,3,1
"7203",2020-03-16,"Brush Creek Rd","w1920","Motorized",0,"Mon","weekday","sled","Brush/Cement","2","2","2",11.7,0,45,0,35,26,1,0,2,-2,1,1,3,1
"7204",2020-03-16,"Brush Creek Rd","w1920","Hybrid",0,"Mon","weekday","sled","Brush/Cement","2","2","2",11.7,0,45,0,35,26,1,0,2,-2,1,1,3,1
"7205",2020-03-17,"Brush Creek Rd","w1920","Non.motorized",11,"Tue","weekday","no_sled","Brush/Cement","2","2","2",11.7,0,44,-1,36,26.6,0,1,0,2,-1,0,0,2
"7206",2020-03-17,"Brush Creek Rd","w1920","Mechanized",0,"Tue","weekday","no_sled","Brush/Cement","2","2","2",11.7,0,44,-1,36,26.6,0,1,0,2,-1,0,0,2
"7207",2020-03-17,"Brush Creek Rd","w1920","Motorized",0,"Tue","weekday","sled","Brush/Cement","2","2","2",11.7,0,44,-1,36,26.6,0,1,0,2,-1,0,0,2
"7208",2020-03-17,"Brush Creek Rd","w1920","Hybrid",0,"Tue","weekday","sled","Brush/Cement","2","2","2",11.7,0,44,-1,36,26.6,0,1,0,2,-1,0,0,2
"7209",2020-03-18,"Brush Creek Rd","w1920","Non.motorized",12,"Wed","weekday","no_sled","Brush/Cement","2","2","2",11.7,0,43,-1,33,27.2,-1,0,1,0,-2,-2,-1,-1
"7210",2020-03-18,"Brush Creek Rd","w1920","Mechanized",0,"Wed","weekday","no_sled","Brush/Cement","2","2","2",11.7,0,43,-1,33,27.2,-1,0,1,0,-2,-2,-1,-1
"7211",2020-03-18,"Brush Creek Rd","w1920","Motorized",0,"Wed","weekday","sled","Brush/Cement","2","2","2",11.7,0,43,-1,33,27.2,-1,0,1,0,-2,-2,-1,-1
"7212",2020-03-18,"Brush Creek Rd","w1920","Hybrid",0,"Wed","weekday","sled","Brush/Cement","2","2","2",11.7,0,43,-1,33,27.2,-1,0,1,0,-2,-2,-1,-1
"7213",2020-03-19,"Brush Creek Rd","w1920","Non.motorized",5,"Thu","weekday","no_sled","Brush/Cement","3","3","3",11.8,0.1,43,0,27,27.4,-1,-1,0,1,-1,-2,-2,-1
"7214",2020-03-19,"Brush Creek Rd","w1920","Mechanized",0,"Thu","weekday","no_sled","Brush/Cement","3","3","3",11.8,0.1,43,0,27,27.4,-1,-1,0,1,-1,-2,-2,-1
"7215",2020-03-19,"Brush Creek Rd","w1920","Motorized",0,"Thu","weekday","sled","Brush/Cement","3","3","3",11.8,0.1,43,0,27,27.4,-1,-1,0,1,-1,-2,-2,-1
"7216",2020-03-19,"Brush Creek Rd","w1920","Hybrid",0,"Thu","weekday","sled","Brush/Cement","3","3","3",11.8,0.1,43,0,27,27.4,-1,-1,0,1,-1,-2,-2,-1
"7217",2020-03-20,"Brush Creek Rd","w1920","Non.motorized",12,"Fri","weekday","no_sled","Brush/Cement","3","3","2",12.7,0.9,52,9,26,24.4,0,-1,-1,0,9,8,7,7
"7218",2020-03-20,"Brush Creek Rd","w1920","Mechanized",0,"Fri","weekday","no_sled","Brush/Cement","3","3","2",12.7,0.9,52,9,26,24.4,0,-1,-1,0,9,8,7,7
"7219",2020-03-20,"Brush Creek Rd","w1920","Motorized",0,"Fri","weekday","sled","Brush/Cement","3","3","2",12.7,0.9,52,9,26,24.4,0,-1,-1,0,9,8,7,7
"7220",2020-03-20,"Brush Creek Rd","w1920","Hybrid",0,"Fri","weekday","sled","Brush/Cement","3","3","2",12.7,0.9,52,9,26,24.4,0,-1,-1,0,9,8,7,7
"7221",2020-03-21,"Brush Creek Rd","w1920","Non.motorized",12,"Sat","weekend","no_sled","Brush/Cement","3","3","2",12.8,0.1,54,2,26,23.7,9,0,-1,-1,11,11,10,9
"7222",2020-03-21,"Brush Creek Rd","w1920","Mechanized",0,"Sat","weekend","no_sled","Brush/Cement","3","3","2",12.8,0.1,54,2,26,23.7,9,0,-1,-1,11,11,10,9
"7223",2020-03-21,"Brush Creek Rd","w1920","Motorized",0,"Sat","weekend","sled","Brush/Cement","3","3","2",12.8,0.1,54,2,26,23.7,9,0,-1,-1,11,11,10,9
"7224",2020-03-21,"Brush Creek Rd","w1920","Hybrid",0,"Sat","weekend","sled","Brush/Cement","3","3","2",12.8,0.1,54,2,26,23.7,9,0,-1,-1,11,11,10,9
"7225",2020-03-22,"Brush Creek Rd","w1920","Non.motorized",22,"Sun","weekend","no_sled","Brush/Cement","2","2","2",13,0.2,53,-1,28,24.5,2,9,0,-1,1,10,10,9
"7226",2020-03-22,"Brush Creek Rd","w1920","Mechanized",0,"Sun","weekend","no_sled","Brush/Cement","2","2","2",13,0.2,53,-1,28,24.5,2,9,0,-1,1,10,10,9
"7227",2020-03-22,"Brush Creek Rd","w1920","Motorized",0,"Sun","weekend","sled","Brush/Cement","2","2","2",13,0.2,53,-1,28,24.5,2,9,0,-1,1,10,10,9
"7228",2020-03-22,"Brush Creek Rd","w1920","Hybrid",0,"Sun","weekend","sled","Brush/Cement","2","2","2",13,0.2,53,-1,28,24.5,2,9,0,-1,1,10,10,9
"7229",2020-03-23,"Brush Creek Rd","w1920","Non.motorized",10,"Mon","weekday","no_sled","Brush/Cement","2","2","2",13,0,53,0,28,24.5,-1,2,9,0,-1,1,10,10
"7230",2020-03-23,"Brush Creek Rd","w1920","Mechanized",0,"Mon","weekday","no_sled","Brush/Cement","2","2","2",13,0,53,0,28,24.5,-1,2,9,0,-1,1,10,10
"7231",2020-03-23,"Brush Creek Rd","w1920","Motorized",1,"Mon","weekday","sled","Brush/Cement","2","2","2",13,0,53,0,28,24.5,-1,2,9,0,-1,1,10,10
"7232",2020-03-23,"Brush Creek Rd","w1920","Hybrid",1,"Mon","weekday","sled","Brush/Cement","2","2","2",13,0,53,0,28,24.5,-1,2,9,0,-1,1,10,10
"7233",2020-03-24,"Brush Creek Rd","w1920","Non.motorized",NA,"Tue","weekday","no_sled","Brush/Cement","2","2","2",13.2,0.2,53,0,32,24.9,0,-1,2,9,0,-1,1,10
"7234",2020-03-24,"Brush Creek Rd","w1920","Mechanized",NA,"Tue","weekday","no_sled","Brush/Cement","2","2","2",13.2,0.2,53,0,32,24.9,0,-1,2,9,0,-1,1,10
"7235",2020-03-24,"Brush Creek Rd","w1920","Motorized",NA,"Tue","weekday","sled","Brush/Cement","2","2","2",13.2,0.2,53,0,32,24.9,0,-1,2,9,0,-1,1,10
"7236",2020-03-24,"Brush Creek Rd","w1920","Hybrid",NA,"Tue","weekday","sled","Brush/Cement","2","2","2",13.2,0.2,53,0,32,24.9,0,-1,2,9,0,-1,1,10
"7237",2020-03-25,"Brush Creek Rd","w1920","Non.motorized",NA,"Wed","weekday","no_sled","Brush/Cement","2","2","2",13.3,0.1,51,-2,34,26.1,0,0,-1,2,-2,-2,-3,-1
"7238",2020-03-25,"Brush Creek Rd","w1920","Mechanized",NA,"Wed","weekday","no_sled","Brush/Cement","2","2","2",13.3,0.1,51,-2,34,26.1,0,0,-1,2,-2,-2,-3,-1
"7239",2020-03-25,"Brush Creek Rd","w1920","Motorized",NA,"Wed","weekday","sled","Brush/Cement","2","2","2",13.3,0.1,51,-2,34,26.1,0,0,-1,2,-2,-2,-3,-1
"7240",2020-03-25,"Brush Creek Rd","w1920","Hybrid",NA,"Wed","weekday","sled","Brush/Cement","2","2","2",13.3,0.1,51,-2,34,26.1,0,0,-1,2,-2,-2,-3,-1
"7241",2020-03-26,"Brush Creek Rd","w1920","Non.motorized",NA,"Thu","weekday","no_sled","Brush/Cement","2","2","2",13.3,0,50,-1,36,26.6,-2,0,0,-1,-3,-3,-3,-4
"7242",2020-03-26,"Brush Creek Rd","w1920","Non.motorized",NA,"Thu","weekday","no_sled","Brush/Cement","3","3","2",13.3,0,50,-1,36,26.6,-2,0,0,-1,-3,-3,-3,-4
"7243",2020-03-26,"Brush Creek Rd","w1920","Mechanized",NA,"Thu","weekday","no_sled","Brush/Cement","2","2","2",13.3,0,50,-1,36,26.6,-2,0,0,-1,-3,-3,-3,-4
"7244",2020-03-26,"Brush Creek Rd","w1920","Mechanized",NA,"Thu","weekday","no_sled","Brush/Cement","3","3","2",13.3,0,50,-1,36,26.6,-2,0,0,-1,-3,-3,-3,-4
"7245",2020-03-26,"Brush Creek Rd","w1920","Motorized",NA,"Thu","weekday","sled","Brush/Cement","2","2","2",13.3,0,50,-1,36,26.6,-2,0,0,-1,-3,-3,-3,-4
"7246",2020-03-26,"Brush Creek Rd","w1920","Motorized",NA,"Thu","weekday","sled","Brush/Cement","3","3","2",13.3,0,50,-1,36,26.6,-2,0,0,-1,-3,-3,-3,-4
"7247",2020-03-26,"Brush Creek Rd","w1920","Hybrid",NA,"Thu","weekday","sled","Brush/Cement","2","2","2",13.3,0,50,-1,36,26.6,-2,0,0,-1,-3,-3,-3,-4
"7248",2020-03-26,"Brush Creek Rd","w1920","Hybrid",NA,"Thu","weekday","sled","Brush/Cement","3","3","2",13.3,0,50,-1,36,26.6,-2,0,0,-1,-3,-3,-3,-4
"7249",2020-03-27,"Brush Creek Rd","w1920","Non.motorized",NA,"Fri","weekday","no_sled","Brush/Cement","3","3","2",13.3,0,50,0,23,26.6,-1,-2,0,0,-1,-3,-3,-3
"7250",2020-03-27,"Brush Creek Rd","w1920","Mechanized",NA,"Fri","weekday","no_sled","Brush/Cement","3","3","2",13.3,0,50,0,23,26.6,-1,-2,0,0,-1,-3,-3,-3
"7251",2020-03-27,"Brush Creek Rd","w1920","Motorized",NA,"Fri","weekday","sled","Brush/Cement","3","3","2",13.3,0,50,0,23,26.6,-1,-2,0,0,-1,-3,-3,-3
"7252",2020-03-27,"Brush Creek Rd","w1920","Hybrid",NA,"Fri","weekday","sled","Brush/Cement","3","3","2",13.3,0,50,0,23,26.6,-1,-2,0,0,-1,-3,-3,-3
"7253",2020-03-28,"Brush Creek Rd","w1920","Non.motorized",NA,"Sat","weekend","no_sled","Brush/Cement","3","3","3",13.3,0,50,0,18,26.6,0,-1,-2,0,0,-1,-3,-3
"7254",2020-03-28,"Brush Creek Rd","w1920","Mechanized",NA,"Sat","weekend","no_sled","Brush/Cement","3","3","3",13.3,0,50,0,18,26.6,0,-1,-2,0,0,-1,-3,-3
"7255",2020-03-28,"Brush Creek Rd","w1920","Motorized",NA,"Sat","weekend","sled","Brush/Cement","3","3","3",13.3,0,50,0,18,26.6,0,-1,-2,0,0,-1,-3,-3
"7256",2020-03-28,"Brush Creek Rd","w1920","Hybrid",NA,"Sat","weekend","sled","Brush/Cement","3","3","3",13.3,0,50,0,18,26.6,0,-1,-2,0,0,-1,-3,-3
"7257",2020-03-29,"Brush Creek Rd","w1920","Non.motorized",NA,"Sun","weekend","no_sled","Brush/Cement","2","2","2",13.3,0,49,-1,24,27.1,0,0,-1,-2,-1,-1,-2,-4
"7258",2020-03-29,"Brush Creek Rd","w1920","Mechanized",NA,"Sun","weekend","no_sled","Brush/Cement","2","2","2",13.3,0,49,-1,24,27.1,0,0,-1,-2,-1,-1,-2,-4
"7259",2020-03-29,"Brush Creek Rd","w1920","Motorized",NA,"Sun","weekend","sled","Brush/Cement","2","2","2",13.3,0,49,-1,24,27.1,0,0,-1,-2,-1,-1,-2,-4
"7260",2020-03-29,"Brush Creek Rd","w1920","Hybrid",NA,"Sun","weekend","sled","Brush/Cement","2","2","2",13.3,0,49,-1,24,27.1,0,0,-1,-2,-1,-1,-2,-4
"7261",2020-03-30,"Brush Creek Rd","w1920","Non.motorized",NA,"Mon","weekday","no_sled","Brush/Cement","2","2","2",13.4,0.1,49,0,29,27.3,-1,0,0,-1,-1,-1,-1,-2
"7262",2020-03-30,"Brush Creek Rd","w1920","Mechanized",NA,"Mon","weekday","no_sled","Brush/Cement","2","2","2",13.4,0.1,49,0,29,27.3,-1,0,0,-1,-1,-1,-1,-2
"7263",2020-03-30,"Brush Creek Rd","w1920","Motorized",NA,"Mon","weekday","sled","Brush/Cement","2","2","2",13.4,0.1,49,0,29,27.3,-1,0,0,-1,-1,-1,-1,-2
"7264",2020-03-30,"Brush Creek Rd","w1920","Hybrid",NA,"Mon","weekday","sled","Brush/Cement","2","2","2",13.4,0.1,49,0,29,27.3,-1,0,0,-1,-1,-1,-1,-2
"7265",2020-03-31,"Brush Creek Rd","w1920","Non.motorized",NA,"Tue","weekday","no_sled","Brush/Cement","2","2","2",13.6,0.2,51,2,35,26.7,0,-1,0,0,2,1,1,1
"7266",2020-03-31,"Brush Creek Rd","w1920","Mechanized",NA,"Tue","weekday","no_sled","Brush/Cement","2","2","2",13.6,0.2,51,2,35,26.7,0,-1,0,0,2,1,1,1
"7267",2020-03-31,"Brush Creek Rd","w1920","Motorized",NA,"Tue","weekday","sled","Brush/Cement","2","2","2",13.6,0.2,51,2,35,26.7,0,-1,0,0,2,1,1,1
"7268",2020-03-31,"Brush Creek Rd","w1920","Hybrid",NA,"Tue","weekday","sled","Brush/Cement","2","2","2",13.6,0.2,51,2,35,26.7,0,-1,0,0,2,1,1,1
"7269",2020-04-01,"Brush Creek Rd","w1920","Non.motorized",NA,"Wed","weekday","no_sled","Brush/Cement","2","2","2",13.6,0,47,-4,39,28.9,2,0,-1,0,-2,-2,-3,-3
"7270",2020-04-01,"Brush Creek Rd","w1920","Mechanized",NA,"Wed","weekday","no_sled","Brush/Cement","2","2","2",13.6,0,47,-4,39,28.9,2,0,-1,0,-2,-2,-3,-3
"7271",2020-04-01,"Brush Creek Rd","w1920","Motorized",NA,"Wed","weekday","sled","Brush/Cement","2","2","2",13.6,0,47,-4,39,28.9,2,0,-1,0,-2,-2,-3,-3
"7272",2020-04-01,"Brush Creek Rd","w1920","Hybrid",NA,"Wed","weekday","sled","Brush/Cement","2","2","2",13.6,0,47,-4,39,28.9,2,0,-1,0,-2,-2,-3,-3
"7273",2020-04-02,"Brush Creek Rd","w1920","Non.motorized",NA,"Thu","weekday","no_sled","Brush/Cement","2","2","2",13.6,0,46,-1,31,29.6,-4,2,0,-1,-5,-3,-3,-4
"7274",2020-04-02,"Brush Creek Rd","w1920","Mechanized",NA,"Thu","weekday","no_sled","Brush/Cement","2","2","2",13.6,0,46,-1,31,29.6,-4,2,0,-1,-5,-3,-3,-4
"7275",2020-04-02,"Brush Creek Rd","w1920","Motorized",NA,"Thu","weekday","sled","Brush/Cement","2","2","2",13.6,0,46,-1,31,29.6,-4,2,0,-1,-5,-3,-3,-4
"7276",2020-04-02,"Brush Creek Rd","w1920","Hybrid",NA,"Thu","weekday","sled","Brush/Cement","2","2","2",13.6,0,46,-1,31,29.6,-4,2,0,-1,-5,-3,-3,-4
"7277",2020-04-03,"Brush Creek Rd","w1920","Non.motorized",NA,"Fri","weekday","no_sled","Brush/Cement","2","2","2",13.6,0,46,0,28,29.6,-1,-4,2,0,-1,-5,-3,-3
"7278",2020-04-03,"Brush Creek Rd","w1920","Mechanized",NA,"Fri","weekday","no_sled","Brush/Cement","2","2","2",13.6,0,46,0,28,29.6,-1,-4,2,0,-1,-5,-3,-3
"7279",2020-04-03,"Brush Creek Rd","w1920","Motorized",NA,"Fri","weekday","sled","Brush/Cement","2","2","2",13.6,0,46,0,28,29.6,-1,-4,2,0,-1,-5,-3,-3
"7280",2020-04-03,"Brush Creek Rd","w1920","Hybrid",NA,"Fri","weekday","sled","Brush/Cement","2","2","2",13.6,0,46,0,28,29.6,-1,-4,2,0,-1,-5,-3,-3
"7281",2020-04-04,"Brush Creek Rd","w1920","Non.motorized",NA,"Sat","weekend","no_sled","Brush/Cement","2","2","2",13.6,0,45,-1,33,30.2,0,-1,-4,2,-1,-2,-6,-4
"7282",2020-04-04,"Brush Creek Rd","w1920","Mechanized",NA,"Sat","weekend","no_sled","Brush/Cement","2","2","2",13.6,0,45,-1,33,30.2,0,-1,-4,2,-1,-2,-6,-4
"7283",2020-04-04,"Brush Creek Rd","w1920","Motorized",NA,"Sat","weekend","sled","Brush/Cement","2","2","2",13.6,0,45,-1,33,30.2,0,-1,-4,2,-1,-2,-6,-4
"7284",2020-04-04,"Brush Creek Rd","w1920","Hybrid",NA,"Sat","weekend","sled","Brush/Cement","2","2","2",13.6,0,45,-1,33,30.2,0,-1,-4,2,-1,-2,-6,-4
"7285",2020-04-05,"Brush Creek Rd","w1920","Non.motorized",NA,"Sun","weekend","no_sled","Brush/Cement","2","2","3",13.6,0,45,0,38,30.2,-1,0,-1,-4,-1,-1,-2,-6
"7286",2020-04-05,"Brush Creek Rd","w1920","Mechanized",NA,"Sun","weekend","no_sled","Brush/Cement","2","2","3",13.6,0,45,0,38,30.2,-1,0,-1,-4,-1,-1,-2,-6
"7287",2020-04-05,"Brush Creek Rd","w1920","Motorized",NA,"Sun","weekend","sled","Brush/Cement","2","2","3",13.6,0,45,0,38,30.2,-1,0,-1,-4,-1,-1,-2,-6
"7288",2020-04-05,"Brush Creek Rd","w1920","Hybrid",NA,"Sun","weekend","sled","Brush/Cement","2","2","3",13.6,0,45,0,38,30.2,-1,0,-1,-4,-1,-1,-2,-6
"7289",2020-04-06,"Brush Creek Rd","w1920","Non.motorized",3,"Mon","weekday","no_sled","Brush/Cement","2","2","3",13.6,0,44,-1,40,30.9,0,-1,0,-1,-1,-2,-2,-3
"7290",2020-04-06,"Brush Creek Rd","w1920","Mechanized",0,"Mon","weekday","no_sled","Brush/Cement","2","2","3",13.6,0,44,-1,40,30.9,0,-1,0,-1,-1,-2,-2,-3
"7291",2020-04-06,"Brush Creek Rd","w1920","Motorized",0,"Mon","weekday","sled","Brush/Cement","2","2","3",13.6,0,44,-1,40,30.9,0,-1,0,-1,-1,-2,-2,-3
"7292",2020-04-06,"Brush Creek Rd","w1920","Hybrid",0,"Mon","weekday","sled","Brush/Cement","2","2","3",13.6,0,44,-1,40,30.9,0,-1,0,-1,-1,-2,-2,-3
"7293",2020-04-07,"Brush Creek Rd","w1920","Non.motorized",3,"Tue","weekday","no_sled","Brush/Cement","2","2","3",13.4,-0.2,43,-1,39,31.2,-1,0,-1,0,-2,-2,-3,-3
"7294",2020-04-07,"Brush Creek Rd","w1920","Mechanized",0,"Tue","weekday","no_sled","Brush/Cement","2","2","3",13.4,-0.2,43,-1,39,31.2,-1,0,-1,0,-2,-2,-3,-3
"7295",2020-04-07,"Brush Creek Rd","w1920","Motorized",0,"Tue","weekday","sled","Brush/Cement","2","2","3",13.4,-0.2,43,-1,39,31.2,-1,0,-1,0,-2,-2,-3,-3
"7296",2020-04-07,"Brush Creek Rd","w1920","Hybrid",0,"Tue","weekday","sled","Brush/Cement","2","2","3",13.4,-0.2,43,-1,39,31.2,-1,0,-1,0,-2,-2,-3,-3
"7297",2020-04-08,"Brush Creek Rd","w1920","Non.motorized",7,"Wed","weekday","no_sled","Brush/Cement","2","3","3",13.3,-0.1,42,-1,40,31.7,-1,-1,0,-1,-2,-3,-3,-4
"7298",2020-04-08,"Brush Creek Rd","w1920","Mechanized",0,"Wed","weekday","no_sled","Brush/Cement","2","3","3",13.3,-0.1,42,-1,40,31.7,-1,-1,0,-1,-2,-3,-3,-4
"7299",2020-04-08,"Brush Creek Rd","w1920","Motorized",0,"Wed","weekday","sled","Brush/Cement","2","3","3",13.3,-0.1,42,-1,40,31.7,-1,-1,0,-1,-2,-3,-3,-4
"7300",2020-04-08,"Brush Creek Rd","w1920","Hybrid",0,"Wed","weekday","sled","Brush/Cement","2","3","3",13.3,-0.1,42,-1,40,31.7,-1,-1,0,-1,-2,-3,-3,-4
"7301",2020-04-09,"Brush Creek Rd","w1920","Non.motorized",5,"Thu","weekday","no_sled","Brush/Cement","2","3","3",13.1,-0.2,40,-2,42,32.8,-1,-1,-1,0,-3,-4,-5,-5
"7302",2020-04-09,"Brush Creek Rd","w1920","Mechanized",0,"Thu","weekday","no_sled","Brush/Cement","2","3","3",13.1,-0.2,40,-2,42,32.8,-1,-1,-1,0,-3,-4,-5,-5
"7303",2020-04-09,"Brush Creek Rd","w1920","Motorized",0,"Thu","weekday","sled","Brush/Cement","2","3","3",13.1,-0.2,40,-2,42,32.8,-1,-1,-1,0,-3,-4,-5,-5
"7304",2020-04-09,"Brush Creek Rd","w1920","Hybrid",0,"Thu","weekday","sled","Brush/Cement","2","3","3",13.1,-0.2,40,-2,42,32.8,-1,-1,-1,0,-3,-4,-5,-5
"7305",2020-04-10,"Brush Creek Rd","w1920","Non.motorized",2,"Fri","weekday","no_sled","Brush/Cement","3","3","3",12.9,-0.2,39,-1,38,33.1,-2,-1,-1,-1,-3,-4,-5,-6
"7306",2020-04-10,"Brush Creek Rd","w1920","Mechanized",0,"Fri","weekday","no_sled","Brush/Cement","3","3","3",12.9,-0.2,39,-1,38,33.1,-2,-1,-1,-1,-3,-4,-5,-6
"7307",2020-04-10,"Brush Creek Rd","w1920","Motorized",0,"Fri","weekday","sled","Brush/Cement","3","3","3",12.9,-0.2,39,-1,38,33.1,-2,-1,-1,-1,-3,-4,-5,-6
"7308",2020-04-10,"Brush Creek Rd","w1920","Hybrid",0,"Fri","weekday","sled","Brush/Cement","3","3","3",12.9,-0.2,39,-1,38,33.1,-2,-1,-1,-1,-3,-4,-5,-6
"7309",2020-04-11,"Brush Creek Rd","w1920","Non.motorized",6,"Sat","weekend","no_sled","Brush/Cement","2","3","3",12.9,0,39,0,36,33.1,-1,-2,-1,-1,-1,-3,-4,-5
"7310",2020-04-11,"Brush Creek Rd","w1920","Mechanized",0,"Sat","weekend","no_sled","Brush/Cement","2","3","3",12.9,0,39,0,36,33.1,-1,-2,-1,-1,-1,-3,-4,-5
"7311",2020-04-11,"Brush Creek Rd","w1920","Motorized",0,"Sat","weekend","sled","Brush/Cement","2","3","3",12.9,0,39,0,36,33.1,-1,-2,-1,-1,-1,-3,-4,-5
"7312",2020-04-11,"Brush Creek Rd","w1920","Hybrid",0,"Sat","weekend","sled","Brush/Cement","2","3","3",12.9,0,39,0,36,33.1,-1,-2,-1,-1,-1,-3,-4,-5
"7313",2020-04-12,"Brush Creek Rd","w1920","Non.motorized",10,"Sun","weekend","no_sled","Brush/Cement","2","2","2",12.8,-0.1,38,-1,29,33.7,0,-1,-2,-1,-1,-2,-4,-5
"7314",2020-04-12,"Brush Creek Rd","w1920","Mechanized",0,"Sun","weekend","no_sled","Brush/Cement","2","2","2",12.8,-0.1,38,-1,29,33.7,0,-1,-2,-1,-1,-2,-4,-5
"7315",2020-04-12,"Brush Creek Rd","w1920","Motorized",0,"Sun","weekend","sled","Brush/Cement","2","2","2",12.8,-0.1,38,-1,29,33.7,0,-1,-2,-1,-1,-2,-4,-5
"7316",2020-04-12,"Brush Creek Rd","w1920","Hybrid",0,"Sun","weekend","sled","Brush/Cement","2","2","2",12.8,-0.1,38,-1,29,33.7,0,-1,-2,-1,-1,-2,-4,-5
"7317",2020-04-13,"Brush Creek Rd","w1920","Non.motorized",6,"Mon","weekday","no_sled","Brush/Cement",NA,NA,NA,12.9,0.1,39,1,20,33.1,-1,0,-1,-2,0,0,-1,-3
"7318",2020-04-13,"Brush Creek Rd","w1920","Mechanized",0,"Mon","weekday","no_sled","Brush/Cement",NA,NA,NA,12.9,0.1,39,1,20,33.1,-1,0,-1,-2,0,0,-1,-3
"7319",2020-04-13,"Brush Creek Rd","w1920","Motorized",0,"Mon","weekday","sled","Brush/Cement",NA,NA,NA,12.9,0.1,39,1,20,33.1,-1,0,-1,-2,0,0,-1,-3
"7320",2020-04-13,"Brush Creek Rd","w1920","Hybrid",0,"Mon","weekday","sled","Brush/Cement",NA,NA,NA,12.9,0.1,39,1,20,33.1,-1,0,-1,-2,0,0,-1,-3
"7321",2020-04-14,"Brush Creek Rd","w1920","Non.motorized",4,"Tue","weekday","no_sled","Brush/Cement","2","2","2",13,0.1,39,0,18,33.3,1,-1,0,-1,1,0,0,-1
"7322",2020-04-14,"Brush Creek Rd","w1920","Mechanized",0,"Tue","weekday","no_sled","Brush/Cement","2","2","2",13,0.1,39,0,18,33.3,1,-1,0,-1,1,0,0,-1
"7323",2020-04-14,"Brush Creek Rd","w1920","Motorized",0,"Tue","weekday","sled","Brush/Cement","2","2","2",13,0.1,39,0,18,33.3,1,-1,0,-1,1,0,0,-1
"7324",2020-04-14,"Brush Creek Rd","w1920","Hybrid",0,"Tue","weekday","sled","Brush/Cement","2","2","2",13,0.1,39,0,18,33.3,1,-1,0,-1,1,0,0,-1
"7325",2020-04-15,"Brush Creek Rd","w1920","Non.motorized",2,"Wed","weekday","no_sled","Brush/Cement",NA,NA,NA,13.2,0.2,39,0,28,33.8,0,1,-1,0,0,1,0,0
"7326",2020-04-15,"Brush Creek Rd","w1920","Mechanized",0,"Wed","weekday","no_sled","Brush/Cement",NA,NA,NA,13.2,0.2,39,0,28,33.8,0,1,-1,0,0,1,0,0
"7327",2020-04-15,"Brush Creek Rd","w1920","Motorized",0,"Wed","weekday","sled","Brush/Cement",NA,NA,NA,13.2,0.2,39,0,28,33.8,0,1,-1,0,0,1,0,0
"7328",2020-04-15,"Brush Creek Rd","w1920","Hybrid",0,"Wed","weekday","sled","Brush/Cement",NA,NA,NA,13.2,0.2,39,0,28,33.8,0,1,-1,0,0,1,0,0
"7329",2019-12-06,"Cement Creek","w1920","Non.motorized",7,"Fri","weekday","no_sled","Brush/Cement","2","2","1",2.9,0.4,19,5,24,15.3,0,0,0,0,5,5,5,5
"7330",2019-12-06,"Cement Creek","w1920","Mechanized",2,"Fri","weekday","no_sled","Brush/Cement","2","2","1",2.9,0.4,19,5,24,15.3,0,0,0,0,5,5,5,5
"7331",2019-12-06,"Cement Creek","w1920","Motorized",3,"Fri","weekday","sled","Brush/Cement","2","2","1",2.9,0.4,19,5,24,15.3,0,0,0,0,5,5,5,5
"7332",2019-12-06,"Cement Creek","w1920","Hybrid",0,"Fri","weekday","sled","Brush/Cement","2","2","1",2.9,0.4,19,5,24,15.3,0,0,0,0,5,5,5,5
"7333",2019-12-07,"Cement Creek","w1920","Non.motorized",34,"Sat","weekend","no_sled","Brush/Cement","2","2","1",3,0.1,18,-1,29,16.7,5,0,0,0,4,4,4,4
"7334",2019-12-07,"Cement Creek","w1920","Mechanized",2,"Sat","weekend","no_sled","Brush/Cement","2","2","1",3,0.1,18,-1,29,16.7,5,0,0,0,4,4,4,4
"7335",2019-12-07,"Cement Creek","w1920","Motorized",9,"Sat","weekend","sled","Brush/Cement","2","2","1",3,0.1,18,-1,29,16.7,5,0,0,0,4,4,4,4
"7336",2019-12-07,"Cement Creek","w1920","Hybrid",0,"Sat","weekend","sled","Brush/Cement","2","2","1",3,0.1,18,-1,29,16.7,5,0,0,0,4,4,4,4
"7337",2019-12-08,"Cement Creek","w1920","Non.motorized",33,"Sun","weekend","no_sled","Brush/Cement","2","2","1",3,0,17,-1,28,17.6,-1,5,0,0,-2,3,3,3
"7338",2019-12-08,"Cement Creek","w1920","Mechanized",3,"Sun","weekend","no_sled","Brush/Cement","2","2","1",3,0,17,-1,28,17.6,-1,5,0,0,-2,3,3,3
"7339",2019-12-08,"Cement Creek","w1920","Motorized",2,"Sun","weekend","sled","Brush/Cement","2","2","1",3,0,17,-1,28,17.6,-1,5,0,0,-2,3,3,3
"7340",2019-12-08,"Cement Creek","w1920","Hybrid",0,"Sun","weekend","sled","Brush/Cement","2","2","1",3,0,17,-1,28,17.6,-1,5,0,0,-2,3,3,3
"7341",2019-12-09,"Cement Creek","w1920","Non.motorized",3,"Mon","weekday","no_sled","Brush/Cement","3","3","2",3.4,0.4,22,5,21,15.5,-1,-1,5,0,4,3,8,8
"7342",2019-12-09,"Cement Creek","w1920","Mechanized",0,"Mon","weekday","no_sled","Brush/Cement","3","3","2",3.4,0.4,22,5,21,15.5,-1,-1,5,0,4,3,8,8
"7343",2019-12-09,"Cement Creek","w1920","Motorized",5,"Mon","weekday","sled","Brush/Cement","3","3","2",3.4,0.4,22,5,21,15.5,-1,-1,5,0,4,3,8,8
"7344",2019-12-09,"Cement Creek","w1920","Hybrid",0,"Mon","weekday","sled","Brush/Cement","3","3","2",3.4,0.4,22,5,21,15.5,-1,-1,5,0,4,3,8,8
"7345",2019-12-10,"Cement Creek","w1920","Non.motorized",11,"Tue","weekday","no_sled","Brush/Cement","2","2","2",3.4,0,21,-1,19,16.2,5,-1,-1,5,4,3,2,7
"7346",2019-12-10,"Cement Creek","w1920","Mechanized",1,"Tue","weekday","no_sled","Brush/Cement","2","2","2",3.4,0,21,-1,19,16.2,5,-1,-1,5,4,3,2,7
"7347",2019-12-10,"Cement Creek","w1920","Motorized",5,"Tue","weekday","sled","Brush/Cement","2","2","2",3.4,0,21,-1,19,16.2,5,-1,-1,5,4,3,2,7
"7348",2019-12-10,"Cement Creek","w1920","Hybrid",0,"Tue","weekday","sled","Brush/Cement","2","2","2",3.4,0,21,-1,19,16.2,5,-1,-1,5,4,3,2,7
"7349",2019-12-11,"Cement Creek","w1920","Non.motorized",12,"Wed","weekday","no_sled","Brush/Cement","2","2","2",3.4,0,20,-1,22,17,-1,5,-1,-1,-2,3,2,1
"7350",2019-12-11,"Cement Creek","w1920","Mechanized",0,"Wed","weekday","no_sled","Brush/Cement","2","2","2",3.4,0,20,-1,22,17,-1,5,-1,-1,-2,3,2,1
"7351",2019-12-11,"Cement Creek","w1920","Motorized",2,"Wed","weekday","sled","Brush/Cement","2","2","2",3.4,0,20,-1,22,17,-1,5,-1,-1,-2,3,2,1
"7352",2019-12-11,"Cement Creek","w1920","Hybrid",0,"Wed","weekday","sled","Brush/Cement","2","2","2",3.4,0,20,-1,22,17,-1,5,-1,-1,-2,3,2,1
"7353",2019-12-12,"Cement Creek","w1920","Non.motorized",9,"Thu","weekday","no_sled","Brush/Cement","2","2","2",3.4,0,19,-1,25,17.9,-1,-1,5,-1,-2,-3,2,1
"7354",2019-12-12,"Cement Creek","w1920","Mechanized",0,"Thu","weekday","no_sled","Brush/Cement","2","2","2",3.4,0,19,-1,25,17.9,-1,-1,5,-1,-2,-3,2,1
"7355",2019-12-12,"Cement Creek","w1920","Motorized",3,"Thu","weekday","sled","Brush/Cement","2","2","2",3.4,0,19,-1,25,17.9,-1,-1,5,-1,-2,-3,2,1
"7356",2019-12-12,"Cement Creek","w1920","Hybrid",0,"Thu","weekday","sled","Brush/Cement","2","2","2",3.4,0,19,-1,25,17.9,-1,-1,5,-1,-2,-3,2,1
"7357",2019-12-13,"Cement Creek","w1920","Non.motorized",5,"Fri","weekday","no_sled","Brush/Cement","2","2","2",3.8,0.4,21,2,24,18.1,-1,-1,-1,5,1,0,-1,4
"7358",2019-12-13,"Cement Creek","w1920","Mechanized",0,"Fri","weekday","no_sled","Brush/Cement","2","2","2",3.8,0.4,21,2,24,18.1,-1,-1,-1,5,1,0,-1,4
"7359",2019-12-13,"Cement Creek","w1920","Motorized",5,"Fri","weekday","sled","Brush/Cement","2","2","2",3.8,0.4,21,2,24,18.1,-1,-1,-1,5,1,0,-1,4
"7360",2019-12-13,"Cement Creek","w1920","Hybrid",1,"Fri","weekday","sled","Brush/Cement","2","2","2",3.8,0.4,21,2,24,18.1,-1,-1,-1,5,1,0,-1,4
"7361",2019-12-14,"Cement Creek","w1920","Non.motorized",12,"Sat","weekend","no_sled","Brush/Cement","3","3","3",4.2,0.4,27,6,25,15.6,2,-1,-1,-1,8,7,6,5
"7362",2019-12-14,"Cement Creek","w1920","Mechanized",0,"Sat","weekend","no_sled","Brush/Cement","3","3","3",4.2,0.4,27,6,25,15.6,2,-1,-1,-1,8,7,6,5
"7363",2019-12-14,"Cement Creek","w1920","Motorized",2,"Sat","weekend","sled","Brush/Cement","3","3","3",4.2,0.4,27,6,25,15.6,2,-1,-1,-1,8,7,6,5
"7364",2019-12-14,"Cement Creek","w1920","Hybrid",0,"Sat","weekend","sled","Brush/Cement","3","3","3",4.2,0.4,27,6,25,15.6,2,-1,-1,-1,8,7,6,5
"7365",2019-12-15,"Cement Creek","w1920","Non.motorized",40,"Sun","weekend","no_sled","Brush/Cement","3","3","2",4.8,0.6,31,4,17,15.5,6,2,-1,-1,10,12,11,10
"7366",2019-12-15,"Cement Creek","w1920","Mechanized",0,"Sun","weekend","no_sled","Brush/Cement","3","3","2",4.8,0.6,31,4,17,15.5,6,2,-1,-1,10,12,11,10
"7367",2019-12-15,"Cement Creek","w1920","Motorized",4,"Sun","weekend","sled","Brush/Cement","3","3","2",4.8,0.6,31,4,17,15.5,6,2,-1,-1,10,12,11,10
"7368",2019-12-15,"Cement Creek","w1920","Hybrid",1,"Sun","weekend","sled","Brush/Cement","3","3","2",4.8,0.6,31,4,17,15.5,6,2,-1,-1,10,12,11,10
"7369",2019-12-16,"Cement Creek","w1920","Non.motorized",9,"Mon","weekday","no_sled","Brush/Cement","3","3","2",4.8,0,29,-2,6,16.6,4,6,2,-1,2,8,10,9
"7370",2019-12-16,"Cement Creek","w1920","Mechanized",2,"Mon","weekday","no_sled","Brush/Cement","3","3","2",4.8,0,29,-2,6,16.6,4,6,2,-1,2,8,10,9
"7371",2019-12-16,"Cement Creek","w1920","Motorized",6,"Mon","weekday","sled","Brush/Cement","3","3","2",4.8,0,29,-2,6,16.6,4,6,2,-1,2,8,10,9
"7372",2019-12-16,"Cement Creek","w1920","Hybrid",0,"Mon","weekday","sled","Brush/Cement","3","3","2",4.8,0,29,-2,6,16.6,4,6,2,-1,2,8,10,9
"7373",2019-12-17,"Cement Creek","w1920","Non.motorized",4,"Tue","weekday","no_sled","Brush/Cement","2","2","1",4.8,0,27,-2,8,17.8,-2,4,6,2,-4,0,6,8
"7374",2019-12-17,"Cement Creek","w1920","Mechanized",1,"Tue","weekday","no_sled","Brush/Cement","2","2","1",4.8,0,27,-2,8,17.8,-2,4,6,2,-4,0,6,8
"7375",2019-12-17,"Cement Creek","w1920","Motorized",2,"Tue","weekday","sled","Brush/Cement","2","2","1",4.8,0,27,-2,8,17.8,-2,4,6,2,-4,0,6,8
"7376",2019-12-17,"Cement Creek","w1920","Hybrid",0,"Tue","weekday","sled","Brush/Cement","2","2","1",4.8,0,27,-2,8,17.8,-2,4,6,2,-4,0,6,8
"7377",2019-12-18,"Cement Creek","w1920","Non.motorized",4,"Wed","weekday","no_sled","Brush/Cement","2","2","1",4.8,0,26,-1,20,18.5,-2,-2,4,6,-3,-5,-1,5
"7378",2019-12-18,"Cement Creek","w1920","Mechanized",5,"Wed","weekday","no_sled","Brush/Cement","2","2","1",4.8,0,26,-1,20,18.5,-2,-2,4,6,-3,-5,-1,5
"7379",2019-12-18,"Cement Creek","w1920","Motorized",2,"Wed","weekday","sled","Brush/Cement","2","2","1",4.8,0,26,-1,20,18.5,-2,-2,4,6,-3,-5,-1,5
"7380",2019-12-18,"Cement Creek","w1920","Hybrid",0,"Wed","weekday","sled","Brush/Cement","2","2","1",4.8,0,26,-1,20,18.5,-2,-2,4,6,-3,-5,-1,5
"7381",2019-12-19,"Cement Creek","w1920","Non.motorized",5,"Thu","weekday","no_sled","Brush/Cement","2","2","1",4.9,0.1,25,-1,21,19.6,-1,-2,-2,4,-2,-4,-6,-2
"7382",2019-12-19,"Cement Creek","w1920","Mechanized",0,"Thu","weekday","no_sled","Brush/Cement","2","2","1",4.9,0.1,25,-1,21,19.6,-1,-2,-2,4,-2,-4,-6,-2
"7383",2019-12-19,"Cement Creek","w1920","Motorized",4,"Thu","weekday","sled","Brush/Cement","2","2","1",4.9,0.1,25,-1,21,19.6,-1,-2,-2,4,-2,-4,-6,-2
"7384",2019-12-19,"Cement Creek","w1920","Hybrid",0,"Thu","weekday","sled","Brush/Cement","2","2","1",4.9,0.1,25,-1,21,19.6,-1,-2,-2,4,-2,-4,-6,-2
"7385",2019-12-20,"Cement Creek","w1920","Non.motorized",4,"Fri","weekday","no_sled","Brush/Cement","2","2","1",4.9,0,24,-1,21,20.4,-1,-1,-2,-2,-2,-3,-5,-7
"7386",2019-12-20,"Cement Creek","w1920","Mechanized",0,"Fri","weekday","no_sled","Brush/Cement","2","2","1",4.9,0,24,-1,21,20.4,-1,-1,-2,-2,-2,-3,-5,-7
"7387",2019-12-20,"Cement Creek","w1920","Motorized",7,"Fri","weekday","sled","Brush/Cement","2","2","1",4.9,0,24,-1,21,20.4,-1,-1,-2,-2,-2,-3,-5,-7
"7388",2019-12-20,"Cement Creek","w1920","Hybrid",3,"Fri","weekday","sled","Brush/Cement","2","2","1",4.9,0,24,-1,21,20.4,-1,-1,-2,-2,-2,-3,-5,-7
"7389",2019-12-21,"Cement Creek","w1920","Non.motorized",26,"Sat","weekend","no_sled","Brush/Cement","2","2","1",4.9,0,24,0,27,20.4,-1,-1,-1,-2,-1,-2,-3,-5
"7390",2019-12-21,"Cement Creek","w1920","Mechanized",3,"Sat","weekend","no_sled","Brush/Cement","2","2","1",4.9,0,24,0,27,20.4,-1,-1,-1,-2,-1,-2,-3,-5
"7391",2019-12-21,"Cement Creek","w1920","Motorized",3,"Sat","weekend","sled","Brush/Cement","2","2","1",4.9,0,24,0,27,20.4,-1,-1,-1,-2,-1,-2,-3,-5
"7392",2019-12-21,"Cement Creek","w1920","Hybrid",0,"Sat","weekend","sled","Brush/Cement","2","2","1",4.9,0,24,0,27,20.4,-1,-1,-1,-2,-1,-2,-3,-5
"7393",2019-12-22,"Cement Creek","w1920","Non.motorized",31,"Sun","weekend","no_sled","Brush/Cement","2","2","1",5,0.1,23,-1,31,21.7,0,-1,-1,-1,-1,-2,-3,-4
"7394",2019-12-22,"Cement Creek","w1920","Mechanized",3,"Sun","weekend","no_sled","Brush/Cement","2","2","1",5,0.1,23,-1,31,21.7,0,-1,-1,-1,-1,-2,-3,-4
"7395",2019-12-22,"Cement Creek","w1920","Motorized",7,"Sun","weekend","sled","Brush/Cement","2","2","1",5,0.1,23,-1,31,21.7,0,-1,-1,-1,-1,-2,-3,-4
"7396",2019-12-22,"Cement Creek","w1920","Hybrid",0,"Sun","weekend","sled","Brush/Cement","2","2","1",5,0.1,23,-1,31,21.7,0,-1,-1,-1,-1,-2,-3,-4
"7397",2019-12-23,"Cement Creek","w1920","Non.motorized",21,"Mon","weekday","no_sled","Brush/Cement","2","1","1",5,0,23,0,34,21.7,-1,0,-1,-1,-1,-1,-2,-3
"7398",2019-12-23,"Cement Creek","w1920","Mechanized",1,"Mon","weekday","no_sled","Brush/Cement","2","1","1",5,0,23,0,34,21.7,-1,0,-1,-1,-1,-1,-2,-3
"7399",2019-12-23,"Cement Creek","w1920","Motorized",1,"Mon","weekday","sled","Brush/Cement","2","1","1",5,0,23,0,34,21.7,-1,0,-1,-1,-1,-1,-2,-3
"7400",2019-12-23,"Cement Creek","w1920","Hybrid",0,"Mon","weekday","sled","Brush/Cement","2","1","1",5,0,23,0,34,21.7,-1,0,-1,-1,-1,-1,-2,-3
"7401",2019-12-24,"Cement Creek","w1920","Non.motorized",22,"Tue","weekday","no_sled","Brush/Cement","2","1","1",5,0,22,-1,30,22.7,0,-1,0,-1,-1,-2,-2,-3
"7402",2019-12-24,"Cement Creek","w1920","Mechanized",6,"Tue","weekday","no_sled","Brush/Cement","2","1","1",5,0,22,-1,30,22.7,0,-1,0,-1,-1,-2,-2,-3
"7403",2019-12-24,"Cement Creek","w1920","Motorized",8,"Tue","weekday","sled","Brush/Cement","2","1","1",5,0,22,-1,30,22.7,0,-1,0,-1,-1,-2,-2,-3
"7404",2019-12-24,"Cement Creek","w1920","Hybrid",0,"Tue","weekday","sled","Brush/Cement","2","1","1",5,0,22,-1,30,22.7,0,-1,0,-1,-1,-2,-2,-3
"7405",2019-12-25,"Cement Creek","w1920","Non.motorized",30,"Wed","weekday","no_sled","Brush/Cement","2","2","2",5,0,23,1,22,21.7,-1,0,-1,0,0,0,-1,-1
"7406",2019-12-25,"Cement Creek","w1920","Mechanized",2,"Wed","weekday","no_sled","Brush/Cement","2","2","2",5,0,23,1,22,21.7,-1,0,-1,0,0,0,-1,-1
"7407",2019-12-25,"Cement Creek","w1920","Motorized",3,"Wed","weekday","sled","Brush/Cement","2","2","2",5,0,23,1,22,21.7,-1,0,-1,0,0,0,-1,-1
"7408",2019-12-25,"Cement Creek","w1920","Hybrid",0,"Wed","weekday","sled","Brush/Cement","2","2","2",5,0,23,1,22,21.7,-1,0,-1,0,0,0,-1,-1
"7409",2019-12-26,"Cement Creek","w1920","Non.motorized",25,"Thu","weekday","no_sled","Brush/Cement","2","2","1",5,0,23,0,17,21.7,1,-1,0,-1,1,0,0,-1
"7410",2019-12-26,"Cement Creek","w1920","Mechanized",1,"Thu","weekday","no_sled","Brush/Cement","2","2","1",5,0,23,0,17,21.7,1,-1,0,-1,1,0,0,-1
"7411",2019-12-26,"Cement Creek","w1920","Motorized",7,"Thu","weekday","sled","Brush/Cement","2","2","1",5,0,23,0,17,21.7,1,-1,0,-1,1,0,0,-1
"7412",2019-12-26,"Cement Creek","w1920","Hybrid",0,"Thu","weekday","sled","Brush/Cement","2","2","1",5,0,23,0,17,21.7,1,-1,0,-1,1,0,0,-1
"7413",2019-12-27,"Cement Creek","w1920","Non.motorized",22,"Fri","weekday","no_sled","Brush/Cement","3","3","2",5.1,0.1,24,1,22,21.2,0,1,-1,0,1,2,1,1
"7414",2019-12-27,"Cement Creek","w1920","Mechanized",1,"Fri","weekday","no_sled","Brush/Cement","3","3","2",5.1,0.1,24,1,22,21.2,0,1,-1,0,1,2,1,1
"7415",2019-12-27,"Cement Creek","w1920","Motorized",5,"Fri","weekday","sled","Brush/Cement","3","3","2",5.1,0.1,24,1,22,21.2,0,1,-1,0,1,2,1,1
"7416",2019-12-27,"Cement Creek","w1920","Hybrid",1,"Fri","weekday","sled","Brush/Cement","3","3","2",5.1,0.1,24,1,22,21.2,0,1,-1,0,1,2,1,1
"7417",2019-12-28,"Cement Creek","w1920","Non.motorized",34,"Sat","weekend","no_sled","Brush/Cement","3","3","2",5.6,0.5,30,6,16,18.7,1,0,1,-1,7,7,8,7
"7418",2019-12-28,"Cement Creek","w1920","Mechanized",0,"Sat","weekend","no_sled","Brush/Cement","3","3","2",5.6,0.5,30,6,16,18.7,1,0,1,-1,7,7,8,7
"7419",2019-12-28,"Cement Creek","w1920","Motorized",3,"Sat","weekend","sled","Brush/Cement","3","3","2",5.6,0.5,30,6,16,18.7,1,0,1,-1,7,7,8,7
"7420",2019-12-28,"Cement Creek","w1920","Hybrid",0,"Sat","weekend","sled","Brush/Cement","3","3","2",5.6,0.5,30,6,16,18.7,1,0,1,-1,7,7,8,7
"7421",2019-12-29,"Cement Creek","w1920","Non.motorized",30,"Sun","weekend","no_sled","Brush/Cement","3","3","2",5.6,0,29,-1,3,19.3,6,1,0,1,5,6,6,7
"7422",2019-12-29,"Cement Creek","w1920","Mechanized",0,"Sun","weekend","no_sled","Brush/Cement","3","3","2",5.6,0,29,-1,3,19.3,6,1,0,1,5,6,6,7
"7423",2019-12-29,"Cement Creek","w1920","Motorized",6,"Sun","weekend","sled","Brush/Cement","3","3","2",5.6,0,29,-1,3,19.3,6,1,0,1,5,6,6,7
"7424",2019-12-29,"Cement Creek","w1920","Hybrid",0,"Sun","weekend","sled","Brush/Cement","3","3","2",5.6,0,29,-1,3,19.3,6,1,0,1,5,6,6,7
"7425",2019-12-30,"Cement Creek","w1920","Non.motorized",18,"Mon","weekday","no_sled","Brush/Cement","3","3","2",5.6,0,28,-1,3,20,-1,6,1,0,-2,4,5,5
"7426",2019-12-30,"Cement Creek","w1920","Mechanized",2,"Mon","weekday","no_sled","Brush/Cement","3","3","2",5.6,0,28,-1,3,20,-1,6,1,0,-2,4,5,5
"7427",2019-12-30,"Cement Creek","w1920","Motorized",0,"Mon","weekday","sled","Brush/Cement","3","3","2",5.6,0,28,-1,3,20,-1,6,1,0,-2,4,5,5
"7428",2019-12-30,"Cement Creek","w1920","Hybrid",0,"Mon","weekday","sled","Brush/Cement","3","3","2",5.6,0,28,-1,3,20,-1,6,1,0,-2,4,5,5
"7429",2019-12-31,"Cement Creek","w1920","Non.motorized",5,"Tue","weekday","no_sled","Brush/Cement","2","2","1",5.6,0,28,0,13,20,-1,-1,6,1,-1,-2,4,5
"7430",2019-12-31,"Cement Creek","w1920","Mechanized",1,"Tue","weekday","no_sled","Brush/Cement","2","2","1",5.6,0,28,0,13,20,-1,-1,6,1,-1,-2,4,5
"7431",2019-12-31,"Cement Creek","w1920","Motorized",1,"Tue","weekday","sled","Brush/Cement","2","2","1",5.6,0,28,0,13,20,-1,-1,6,1,-1,-2,4,5
"7432",2019-12-31,"Cement Creek","w1920","Hybrid",0,"Tue","weekday","sled","Brush/Cement","2","2","1",5.6,0,28,0,13,20,-1,-1,6,1,-1,-2,4,5
"7433",2020-01-01,"Cement Creek","w1920","Non.motorized",42,"Wed","weekday","no_sled","Brush/Cement","2","1","1",5.6,0,27,-1,21,20.7,0,-1,-1,6,-1,-2,-3,3
"7434",2020-01-01,"Cement Creek","w1920","Mechanized",1,"Wed","weekday","no_sled","Brush/Cement","2","1","1",5.6,0,27,-1,21,20.7,0,-1,-1,6,-1,-2,-3,3
"7435",2020-01-01,"Cement Creek","w1920","Motorized",3,"Wed","weekday","sled","Brush/Cement","2","1","1",5.6,0,27,-1,21,20.7,0,-1,-1,6,-1,-2,-3,3
"7436",2020-01-01,"Cement Creek","w1920","Hybrid",1,"Wed","weekday","sled","Brush/Cement","2","1","1",5.6,0,27,-1,21,20.7,0,-1,-1,6,-1,-2,-3,3
"7437",2020-01-02,"Cement Creek","w1920","Non.motorized",19,"Thu","weekday","no_sled","Brush/Cement","3","3","2",5.9,0.3,29,2,16,20.3,-1,0,-1,-1,1,1,0,-1
"7438",2020-01-02,"Cement Creek","w1920","Mechanized",0,"Thu","weekday","no_sled","Brush/Cement","3","3","2",5.9,0.3,29,2,16,20.3,-1,0,-1,-1,1,1,0,-1
"7439",2020-01-02,"Cement Creek","w1920","Motorized",2,"Thu","weekday","sled","Brush/Cement","3","3","2",5.9,0.3,29,2,16,20.3,-1,0,-1,-1,1,1,0,-1
"7440",2020-01-02,"Cement Creek","w1920","Hybrid",0,"Thu","weekday","sled","Brush/Cement","3","3","2",5.9,0.3,29,2,16,20.3,-1,0,-1,-1,1,1,0,-1
"7441",2020-01-03,"Cement Creek","w1920","Non.motorized",37,"Fri","weekday","no_sled","Brush/Cement","3","2","1",5.9,0,31,2,19,19,2,-1,0,-1,4,3,3,2
"7442",2020-01-03,"Cement Creek","w1920","Mechanized",0,"Fri","weekday","no_sled","Brush/Cement","3","2","1",5.9,0,31,2,19,19,2,-1,0,-1,4,3,3,2
"7443",2020-01-03,"Cement Creek","w1920","Motorized",3,"Fri","weekday","sled","Brush/Cement","3","2","1",5.9,0,31,2,19,19,2,-1,0,-1,4,3,3,2
"7444",2020-01-03,"Cement Creek","w1920","Hybrid",2,"Fri","weekday","sled","Brush/Cement","3","2","1",5.9,0,31,2,19,19,2,-1,0,-1,4,3,3,2
"7445",2020-01-04,"Cement Creek","w1920","Non.motorized",36,"Sat","weekend","no_sled","Brush/Cement","2","2","1",5.9,0,30,-1,26,19.7,2,2,-1,0,1,3,2,2
"7446",2020-01-04,"Cement Creek","w1920","Mechanized",2,"Sat","weekend","no_sled","Brush/Cement","2","2","1",5.9,0,30,-1,26,19.7,2,2,-1,0,1,3,2,2
"7447",2020-01-04,"Cement Creek","w1920","Motorized",1,"Sat","weekend","sled","Brush/Cement","2","2","1",5.9,0,30,-1,26,19.7,2,2,-1,0,1,3,2,2
"7448",2020-01-04,"Cement Creek","w1920","Hybrid",0,"Sat","weekend","sled","Brush/Cement","2","2","1",5.9,0,30,-1,26,19.7,2,2,-1,0,1,3,2,2
"7449",2020-01-05,"Cement Creek","w1920","Non.motorized",24,"Sun","weekend","no_sled","Brush/Cement","2","2","1",5.9,0,28,-2,23,21.1,-1,2,2,-1,-3,-1,1,0
"7450",2020-01-05,"Cement Creek","w1920","Mechanized",2,"Sun","weekend","no_sled","Brush/Cement","2","2","1",5.9,0,28,-2,23,21.1,-1,2,2,-1,-3,-1,1,0
"7451",2020-01-05,"Cement Creek","w1920","Motorized",1,"Sun","weekend","sled","Brush/Cement","2","2","1",5.9,0,28,-2,23,21.1,-1,2,2,-1,-3,-1,1,0
"7452",2020-01-05,"Cement Creek","w1920","Hybrid",0,"Sun","weekend","sled","Brush/Cement","2","2","1",5.9,0,28,-2,23,21.1,-1,2,2,-1,-3,-1,1,0
"7453",2020-01-06,"Cement Creek","w1920","Non.motorized",15,"Mon","weekday","no_sled","Brush/Cement","2","2","1",5.9,0,28,0,15,21.1,-2,-1,2,2,-2,-3,-1,1
"7454",2020-01-06,"Cement Creek","w1920","Mechanized",1,"Mon","weekday","no_sled","Brush/Cement","2","2","1",5.9,0,28,0,15,21.1,-2,-1,2,2,-2,-3,-1,1
"7455",2020-01-06,"Cement Creek","w1920","Motorized",4,"Mon","weekday","sled","Brush/Cement","2","2","1",5.9,0,28,0,15,21.1,-2,-1,2,2,-2,-3,-1,1
"7456",2020-01-06,"Cement Creek","w1920","Hybrid",0,"Mon","weekday","sled","Brush/Cement","2","2","1",5.9,0,28,0,15,21.1,-2,-1,2,2,-2,-3,-1,1
"7457",2020-01-07,"Cement Creek","w1920","Non.motorized",8,"Tue","weekday","no_sled","Brush/Cement","2","1","1",5.9,0,28,0,22,21.1,0,-2,-1,2,0,-2,-3,-1
"7458",2020-01-07,"Cement Creek","w1920","Mechanized",2,"Tue","weekday","no_sled","Brush/Cement","2","1","1",5.9,0,28,0,22,21.1,0,-2,-1,2,0,-2,-3,-1
"7459",2020-01-07,"Cement Creek","w1920","Motorized",3,"Tue","weekday","sled","Brush/Cement","2","1","1",5.9,0,28,0,22,21.1,0,-2,-1,2,0,-2,-3,-1
"7460",2020-01-07,"Cement Creek","w1920","Hybrid",0,"Tue","weekday","sled","Brush/Cement","2","1","1",5.9,0,28,0,22,21.1,0,-2,-1,2,0,-2,-3,-1
"7461",2020-01-08,"Cement Creek","w1920","Non.motorized",14,"Wed","weekday","no_sled","Brush/Cement","2","1","1",6,0.1,28,0,23,21.4,0,0,-2,-1,0,0,-2,-3
"7462",2020-01-08,"Cement Creek","w1920","Mechanized",1,"Wed","weekday","no_sled","Brush/Cement","2","1","1",6,0.1,28,0,23,21.4,0,0,-2,-1,0,0,-2,-3
"7463",2020-01-08,"Cement Creek","w1920","Motorized",0,"Wed","weekday","sled","Brush/Cement","2","1","1",6,0.1,28,0,23,21.4,0,0,-2,-1,0,0,-2,-3
"7464",2020-01-08,"Cement Creek","w1920","Hybrid",0,"Wed","weekday","sled","Brush/Cement","2","1","1",6,0.1,28,0,23,21.4,0,0,-2,-1,0,0,-2,-3
"7465",2020-01-09,"Cement Creek","w1920","Non.motorized",15,"Thu","weekday","no_sled","Brush/Cement","2","1","1",6,0,27,-1,17,22.2,0,0,0,-2,-1,-1,-1,-3
"7466",2020-01-09,"Cement Creek","w1920","Mechanized",1,"Thu","weekday","no_sled","Brush/Cement","2","1","1",6,0,27,-1,17,22.2,0,0,0,-2,-1,-1,-1,-3
"7467",2020-01-09,"Cement Creek","w1920","Motorized",0,"Thu","weekday","sled","Brush/Cement","2","1","1",6,0,27,-1,17,22.2,0,0,0,-2,-1,-1,-1,-3
"7468",2020-01-09,"Cement Creek","w1920","Hybrid",0,"Thu","weekday","sled","Brush/Cement","2","1","1",6,0,27,-1,17,22.2,0,0,0,-2,-1,-1,-1,-3
"7469",2020-01-10,"Cement Creek","w1920","Non.motorized",13,"Fri","weekday","no_sled","Brush/Cement","2","1","1",6,0,29,2,11,20.7,-1,0,0,0,1,1,1,1
"7470",2020-01-10,"Cement Creek","w1920","Mechanized",2,"Fri","weekday","no_sled","Brush/Cement","2","1","1",6,0,29,2,11,20.7,-1,0,0,0,1,1,1,1
"7471",2020-01-10,"Cement Creek","w1920","Motorized",2,"Fri","weekday","sled","Brush/Cement","2","1","1",6,0,29,2,11,20.7,-1,0,0,0,1,1,1,1
"7472",2020-01-10,"Cement Creek","w1920","Hybrid",0,"Fri","weekday","sled","Brush/Cement","2","1","1",6,0,29,2,11,20.7,-1,0,0,0,1,1,1,1
"7473",2020-01-11,"Cement Creek","w1920","Non.motorized",13,"Sat","weekend","no_sled","Brush/Cement","2","1","1",6,0,29,0,12,20.7,2,-1,0,0,2,1,1,1
"7474",2020-01-11,"Cement Creek","w1920","Mechanized",2,"Sat","weekend","no_sled","Brush/Cement","2","1","1",6,0,29,0,12,20.7,2,-1,0,0,2,1,1,1
"7475",2020-01-11,"Cement Creek","w1920","Motorized",0,"Sat","weekend","sled","Brush/Cement","2","1","1",6,0,29,0,12,20.7,2,-1,0,0,2,1,1,1
"7476",2020-01-11,"Cement Creek","w1920","Hybrid",0,"Sat","weekend","sled","Brush/Cement","2","1","1",6,0,29,0,12,20.7,2,-1,0,0,2,1,1,1
"7477",2020-01-12,"Cement Creek","w1920","Non.motorized",NA,"Sun","weekend","no_sled","Brush/Cement","2","1","1",6.1,0.1,29,0,13,21,0,2,-1,0,0,2,1,1
"7478",2020-01-12,"Cement Creek","w1920","Mechanized",NA,"Sun","weekend","no_sled","Brush/Cement","2","1","1",6.1,0.1,29,0,13,21,0,2,-1,0,0,2,1,1
"7479",2020-01-12,"Cement Creek","w1920","Motorized",NA,"Sun","weekend","sled","Brush/Cement","2","1","1",6.1,0.1,29,0,13,21,0,2,-1,0,0,2,1,1
"7480",2020-01-12,"Cement Creek","w1920","Hybrid",NA,"Sun","weekend","sled","Brush/Cement","2","1","1",6.1,0.1,29,0,13,21,0,2,-1,0,0,2,1,1
"7481",2020-01-13,"Cement Creek","w1920","Non.motorized",NA,"Mon","weekday","no_sled","Brush/Cement","2","2","1",6.2,0.1,29,0,16,21.4,0,0,2,-1,0,0,2,1
"7482",2020-01-13,"Cement Creek","w1920","Mechanized",NA,"Mon","weekday","no_sled","Brush/Cement","2","2","1",6.2,0.1,29,0,16,21.4,0,0,2,-1,0,0,2,1
"7483",2020-01-13,"Cement Creek","w1920","Motorized",NA,"Mon","weekday","sled","Brush/Cement","2","2","1",6.2,0.1,29,0,16,21.4,0,0,2,-1,0,0,2,1
"7484",2020-01-13,"Cement Creek","w1920","Hybrid",NA,"Mon","weekday","sled","Brush/Cement","2","2","1",6.2,0.1,29,0,16,21.4,0,0,2,-1,0,0,2,1
"7485",2020-01-14,"Cement Creek","w1920","Non.motorized",NA,"Tue","weekday","no_sled","Brush/Cement","3","2","1",6.6,0.4,34,5,23,19.4,0,0,0,2,5,5,5,7
"7486",2020-01-14,"Cement Creek","w1920","Mechanized",NA,"Tue","weekday","no_sled","Brush/Cement","3","2","1",6.6,0.4,34,5,23,19.4,0,0,0,2,5,5,5,7
"7487",2020-01-14,"Cement Creek","w1920","Motorized",NA,"Tue","weekday","sled","Brush/Cement","3","2","1",6.6,0.4,34,5,23,19.4,0,0,0,2,5,5,5,7
"7488",2020-01-14,"Cement Creek","w1920","Hybrid",NA,"Tue","weekday","sled","Brush/Cement","3","2","1",6.6,0.4,34,5,23,19.4,0,0,0,2,5,5,5,7
"7489",2020-01-15,"Cement Creek","w1920","Non.motorized",NA,"Wed","weekday","no_sled","Brush/Cement","3","2","1",6.7,0.1,32,-2,23,20.9,5,0,0,0,3,3,3,3
"7490",2020-01-15,"Cement Creek","w1920","Mechanized",NA,"Wed","weekday","no_sled","Brush/Cement","3","2","1",6.7,0.1,32,-2,23,20.9,5,0,0,0,3,3,3,3
"7491",2020-01-15,"Cement Creek","w1920","Motorized",NA,"Wed","weekday","sled","Brush/Cement","3","2","1",6.7,0.1,32,-2,23,20.9,5,0,0,0,3,3,3,3
"7492",2020-01-15,"Cement Creek","w1920","Hybrid",NA,"Wed","weekday","sled","Brush/Cement","3","2","1",6.7,0.1,32,-2,23,20.9,5,0,0,0,3,3,3,3
"7493",2020-01-16,"Cement Creek","w1920","Non.motorized",NA,"Thu","weekday","no_sled","Brush/Cement","2","2","1",6.7,0,31,-1,28,21.6,-2,5,0,0,-3,2,2,2
"7494",2020-01-16,"Cement Creek","w1920","Mechanized",NA,"Thu","weekday","no_sled","Brush/Cement","2","2","1",6.7,0,31,-1,28,21.6,-2,5,0,0,-3,2,2,2
"7495",2020-01-16,"Cement Creek","w1920","Motorized",NA,"Thu","weekday","sled","Brush/Cement","2","2","1",6.7,0,31,-1,28,21.6,-2,5,0,0,-3,2,2,2
"7496",2020-01-16,"Cement Creek","w1920","Hybrid",NA,"Thu","weekday","sled","Brush/Cement","2","2","1",6.7,0,31,-1,28,21.6,-2,5,0,0,-3,2,2,2
"7497",2020-01-17,"Cement Creek","w1920","Non.motorized",NA,"Fri","weekday","no_sled","Brush/Cement","2","2","1",6.8,0.1,29,-2,19,23.4,-1,-2,5,0,-3,-5,0,0
"7498",2020-01-17,"Cement Creek","w1920","Mechanized",NA,"Fri","weekday","no_sled","Brush/Cement","2","2","1",6.8,0.1,29,-2,19,23.4,-1,-2,5,0,-3,-5,0,0
"7499",2020-01-17,"Cement Creek","w1920","Motorized",NA,"Fri","weekday","sled","Brush/Cement","2","2","1",6.8,0.1,29,-2,19,23.4,-1,-2,5,0,-3,-5,0,0
"7500",2020-01-17,"Cement Creek","w1920","Hybrid",NA,"Fri","weekday","sled","Brush/Cement","2","2","1",6.8,0.1,29,-2,19,23.4,-1,-2,5,0,-3,-5,0,0
"7501",2020-01-18,"Cement Creek","w1920","Non.motorized",NA,"Sat","weekend","no_sled","Brush/Cement","2","2","2",7,0.2,34,5,16,20.6,-2,-1,-2,5,3,2,0,5
"7502",2020-01-18,"Cement Creek","w1920","Mechanized",NA,"Sat","weekend","no_sled","Brush/Cement","2","2","2",7,0.2,34,5,16,20.6,-2,-1,-2,5,3,2,0,5
"7503",2020-01-18,"Cement Creek","w1920","Motorized",NA,"Sat","weekend","sled","Brush/Cement","2","2","2",7,0.2,34,5,16,20.6,-2,-1,-2,5,3,2,0,5
"7504",2020-01-18,"Cement Creek","w1920","Hybrid",NA,"Sat","weekend","sled","Brush/Cement","2","2","2",7,0.2,34,5,16,20.6,-2,-1,-2,5,3,2,0,5
"7505",2020-01-19,"Cement Creek","w1920","Non.motorized",NA,"Sun","weekend","no_sled","Brush/Cement","2","2","1",7,0,33,-1,21,21.2,5,-2,-1,-2,4,2,1,-1
"7506",2020-01-19,"Cement Creek","w1920","Mechanized",NA,"Sun","weekend","no_sled","Brush/Cement","2","2","1",7,0,33,-1,21,21.2,5,-2,-1,-2,4,2,1,-1
"7507",2020-01-19,"Cement Creek","w1920","Motorized",NA,"Sun","weekend","sled","Brush/Cement","2","2","1",7,0,33,-1,21,21.2,5,-2,-1,-2,4,2,1,-1
"7508",2020-01-19,"Cement Creek","w1920","Hybrid",NA,"Sun","weekend","sled","Brush/Cement","2","2","1",7,0,33,-1,21,21.2,5,-2,-1,-2,4,2,1,-1
"7509",2020-01-20,"Cement Creek","w1920","Non.motorized",NA,"Mon","weekday","no_sled","Brush/Cement","2","2","1",7.1,0.1,32,-1,25,22.2,-1,5,-2,-1,-2,3,1,0
"7510",2020-01-20,"Cement Creek","w1920","Mechanized",NA,"Mon","weekday","no_sled","Brush/Cement","2","2","1",7.1,0.1,32,-1,25,22.2,-1,5,-2,-1,-2,3,1,0
"7511",2020-01-20,"Cement Creek","w1920","Motorized",NA,"Mon","weekday","sled","Brush/Cement","2","2","1",7.1,0.1,32,-1,25,22.2,-1,5,-2,-1,-2,3,1,0
"7512",2020-01-20,"Cement Creek","w1920","Hybrid",NA,"Mon","weekday","sled","Brush/Cement","2","2","1",7.1,0.1,32,-1,25,22.2,-1,5,-2,-1,-2,3,1,0
"7513",2020-01-21,"Cement Creek","w1920","Non.motorized",NA,"Tue","weekday","no_sled","Brush/Cement","2","2","1",7.1,0,31,-1,28,22.9,-1,-1,5,-2,-2,-3,2,0
"7514",2020-01-21,"Cement Creek","w1920","Mechanized",NA,"Tue","weekday","no_sled","Brush/Cement","2","2","1",7.1,0,31,-1,28,22.9,-1,-1,5,-2,-2,-3,2,0
"7515",2020-01-21,"Cement Creek","w1920","Motorized",NA,"Tue","weekday","sled","Brush/Cement","2","2","1",7.1,0,31,-1,28,22.9,-1,-1,5,-2,-2,-3,2,0
"7516",2020-01-21,"Cement Creek","w1920","Hybrid",NA,"Tue","weekday","sled","Brush/Cement","2","2","1",7.1,0,31,-1,28,22.9,-1,-1,5,-2,-2,-3,2,0
"7517",2020-01-22,"Cement Creek","w1920","Non.motorized",NA,"Wed","weekday","no_sled","Brush/Cement","2","2","2",7.3,0.2,32,1,25,22.8,-1,-1,-1,5,0,-1,-2,3
"7518",2020-01-22,"Cement Creek","w1920","Mechanized",NA,"Wed","weekday","no_sled","Brush/Cement","2","2","2",7.3,0.2,32,1,25,22.8,-1,-1,-1,5,0,-1,-2,3
"7519",2020-01-22,"Cement Creek","w1920","Motorized",NA,"Wed","weekday","sled","Brush/Cement","2","2","2",7.3,0.2,32,1,25,22.8,-1,-1,-1,5,0,-1,-2,3
"7520",2020-01-22,"Cement Creek","w1920","Hybrid",NA,"Wed","weekday","sled","Brush/Cement","2","2","2",7.3,0.2,32,1,25,22.8,-1,-1,-1,5,0,-1,-2,3
"7521",2020-01-23,"Cement Creek","w1920","Non.motorized",NA,"Thu","weekday","no_sled","Brush/Cement","3","2","2",7.3,0,34,2,23,21.5,1,-1,-1,-1,3,2,1,0
"7522",2020-01-23,"Cement Creek","w1920","Mechanized",NA,"Thu","weekday","no_sled","Brush/Cement","3","2","2",7.3,0,34,2,23,21.5,1,-1,-1,-1,3,2,1,0
"7523",2020-01-23,"Cement Creek","w1920","Motorized",NA,"Thu","weekday","sled","Brush/Cement","3","2","2",7.3,0,34,2,23,21.5,1,-1,-1,-1,3,2,1,0
"7524",2020-01-23,"Cement Creek","w1920","Hybrid",NA,"Thu","weekday","sled","Brush/Cement","3","2","2",7.3,0,34,2,23,21.5,1,-1,-1,-1,3,2,1,0
"7525",2020-01-24,"Cement Creek","w1920","Non.motorized",NA,"Fri","weekday","no_sled","Brush/Cement","2","2","1",7.3,0,33,-1,23,22.1,2,1,-1,-1,1,2,1,0
"7526",2020-01-24,"Cement Creek","w1920","Mechanized",NA,"Fri","weekday","no_sled","Brush/Cement","2","2","1",7.3,0,33,-1,23,22.1,2,1,-1,-1,1,2,1,0
"7527",2020-01-24,"Cement Creek","w1920","Motorized",NA,"Fri","weekday","sled","Brush/Cement","2","2","1",7.3,0,33,-1,23,22.1,2,1,-1,-1,1,2,1,0
"7528",2020-01-24,"Cement Creek","w1920","Hybrid",NA,"Fri","weekday","sled","Brush/Cement","2","2","1",7.3,0,33,-1,23,22.1,2,1,-1,-1,1,2,1,0
"7529",2020-01-25,"Cement Creek","w1920","Non.motorized",NA,"Sat","weekend","no_sled","Brush/Cement","2","2","1",7.4,0.1,32,-1,25,23.1,-1,2,1,-1,-2,0,1,0
"7530",2020-01-25,"Cement Creek","w1920","Mechanized",NA,"Sat","weekend","no_sled","Brush/Cement","2","2","1",7.4,0.1,32,-1,25,23.1,-1,2,1,-1,-2,0,1,0
"7531",2020-01-25,"Cement Creek","w1920","Motorized",NA,"Sat","weekend","sled","Brush/Cement","2","2","1",7.4,0.1,32,-1,25,23.1,-1,2,1,-1,-2,0,1,0
"7532",2020-01-25,"Cement Creek","w1920","Hybrid",NA,"Sat","weekend","sled","Brush/Cement","2","2","1",7.4,0.1,32,-1,25,23.1,-1,2,1,-1,-2,0,1,0
"7533",2020-01-26,"Cement Creek","w1920","Non.motorized",NA,"Sun","weekend","no_sled","Brush/Cement","2","1","1",7.4,0,32,0,28,23.1,-1,-1,2,1,-1,-2,0,1
"7534",2020-01-26,"Cement Creek","w1920","Mechanized",NA,"Sun","weekend","no_sled","Brush/Cement","2","1","1",7.4,0,32,0,28,23.1,-1,-1,2,1,-1,-2,0,1
"7535",2020-01-26,"Cement Creek","w1920","Motorized",NA,"Sun","weekend","sled","Brush/Cement","2","1","1",7.4,0,32,0,28,23.1,-1,-1,2,1,-1,-2,0,1
"7536",2020-01-26,"Cement Creek","w1920","Hybrid",NA,"Sun","weekend","sled","Brush/Cement","2","1","1",7.4,0,32,0,28,23.1,-1,-1,2,1,-1,-2,0,1
"7537",2020-01-27,"Cement Creek","w1920","Non.motorized",NA,"Mon","weekday","no_sled","Brush/Cement","2","1","1",7.4,0,32,0,24,23.1,0,-1,-1,2,0,-1,-2,0
"7538",2020-01-27,"Cement Creek","w1920","Mechanized",NA,"Mon","weekday","no_sled","Brush/Cement","2","1","1",7.4,0,32,0,24,23.1,0,-1,-1,2,0,-1,-2,0
"7539",2020-01-27,"Cement Creek","w1920","Motorized",NA,"Mon","weekday","sled","Brush/Cement","2","1","1",7.4,0,32,0,24,23.1,0,-1,-1,2,0,-1,-2,0
"7540",2020-01-27,"Cement Creek","w1920","Hybrid",NA,"Mon","weekday","sled","Brush/Cement","2","1","1",7.4,0,32,0,24,23.1,0,-1,-1,2,0,-1,-2,0
"7541",2020-01-28,"Cement Creek","w1920","Non.motorized",NA,"Tue","weekday","no_sled","Brush/Cement","3","2","2",7.4,0,32,0,19,23.1,0,0,-1,-1,0,0,-1,-2
"7542",2020-01-28,"Cement Creek","w1920","Mechanized",NA,"Tue","weekday","no_sled","Brush/Cement","3","2","2",7.4,0,32,0,19,23.1,0,0,-1,-1,0,0,-1,-2
"7543",2020-01-28,"Cement Creek","w1920","Motorized",NA,"Tue","weekday","sled","Brush/Cement","3","2","2",7.4,0,32,0,19,23.1,0,0,-1,-1,0,0,-1,-2
"7544",2020-01-28,"Cement Creek","w1920","Hybrid",NA,"Tue","weekday","sled","Brush/Cement","3","2","2",7.4,0,32,0,19,23.1,0,0,-1,-1,0,0,-1,-2
"7545",2020-01-29,"Cement Creek","w1920","Non.motorized",NA,"Wed","weekday","no_sled","Brush/Cement","2","2","1",7.4,0,31,-1,20,23.9,0,0,0,-1,-1,-1,-1,-2
"7546",2020-01-29,"Cement Creek","w1920","Mechanized",NA,"Wed","weekday","no_sled","Brush/Cement","2","2","1",7.4,0,31,-1,20,23.9,0,0,0,-1,-1,-1,-1,-2
"7547",2020-01-29,"Cement Creek","w1920","Motorized",NA,"Wed","weekday","sled","Brush/Cement","2","2","1",7.4,0,31,-1,20,23.9,0,0,0,-1,-1,-1,-1,-2
"7548",2020-01-29,"Cement Creek","w1920","Hybrid",NA,"Wed","weekday","sled","Brush/Cement","2","2","1",7.4,0,31,-1,20,23.9,0,0,0,-1,-1,-1,-1,-2
"7549",2020-01-30,"Cement Creek","w1920","Non.motorized",9,"Thu","weekday","no_sled","Brush/Cement","2","2","1",7.4,0,31,0,17,23.9,-1,0,0,0,-1,-1,-1,-1
"7550",2020-01-30,"Cement Creek","w1920","Mechanized",1,"Thu","weekday","no_sled","Brush/Cement","2","2","1",7.4,0,31,0,17,23.9,-1,0,0,0,-1,-1,-1,-1
"7551",2020-01-30,"Cement Creek","w1920","Motorized",1,"Thu","weekday","sled","Brush/Cement","2","2","1",7.4,0,31,0,17,23.9,-1,0,0,0,-1,-1,-1,-1
"7552",2020-01-30,"Cement Creek","w1920","Hybrid",0,"Thu","weekday","sled","Brush/Cement","2","2","1",7.4,0,31,0,17,23.9,-1,0,0,0,-1,-1,-1,-1
"7553",2020-01-31,"Cement Creek","w1920","Non.motorized",16,"Fri","weekday","no_sled","Brush/Cement","2","1","1",7.4,0,31,0,20,23.9,0,-1,0,0,0,-1,-1,-1
"7554",2020-01-31,"Cement Creek","w1920","Mechanized",1,"Fri","weekday","no_sled","Brush/Cement","2","1","1",7.4,0,31,0,20,23.9,0,-1,0,0,0,-1,-1,-1
"7555",2020-01-31,"Cement Creek","w1920","Motorized",2,"Fri","weekday","sled","Brush/Cement","2","1","1",7.4,0,31,0,20,23.9,0,-1,0,0,0,-1,-1,-1
"7556",2020-01-31,"Cement Creek","w1920","Hybrid",0,"Fri","weekday","sled","Brush/Cement","2","1","1",7.4,0,31,0,20,23.9,0,-1,0,0,0,-1,-1,-1
"7557",2020-02-01,"Cement Creek","w1920","Non.motorized",29,"Sat","weekend","no_sled","Brush/Cement","2","1","1",7.4,0,31,0,28,23.9,0,0,-1,0,0,0,-1,-1
"7558",2020-02-01,"Cement Creek","w1920","Mechanized",2,"Sat","weekend","no_sled","Brush/Cement","2","1","1",7.4,0,31,0,28,23.9,0,0,-1,0,0,0,-1,-1
"7559",2020-02-01,"Cement Creek","w1920","Motorized",4,"Sat","weekend","sled","Brush/Cement","2","1","1",7.4,0,31,0,28,23.9,0,0,-1,0,0,0,-1,-1
"7560",2020-02-01,"Cement Creek","w1920","Hybrid",2,"Sat","weekend","sled","Brush/Cement","2","1","1",7.4,0,31,0,28,23.9,0,0,-1,0,0,0,-1,-1
"7561",2020-02-02,"Cement Creek","w1920","Non.motorized",30,"Sun","weekend","no_sled","Brush/Cement","1","1","1",7.4,0,31,0,33,23.9,0,0,0,-1,0,0,0,-1
"7562",2020-02-02,"Cement Creek","w1920","Mechanized",3,"Sun","weekend","no_sled","Brush/Cement","1","1","1",7.4,0,31,0,33,23.9,0,0,0,-1,0,0,0,-1
"7563",2020-02-02,"Cement Creek","w1920","Motorized",3,"Sun","weekend","sled","Brush/Cement","1","1","1",7.4,0,31,0,33,23.9,0,0,0,-1,0,0,0,-1
"7564",2020-02-02,"Cement Creek","w1920","Hybrid",1,"Sun","weekend","sled","Brush/Cement","1","1","1",7.4,0,31,0,33,23.9,0,0,0,-1,0,0,0,-1
"7565",2020-02-03,"Cement Creek","w1920","Non.motorized",5,"Mon","weekday","no_sled","Brush/Cement","2","2","1",7.4,0,31,0,24,23.9,0,0,0,0,0,0,0,0
"7566",2020-02-03,"Cement Creek","w1920","Mechanized",0,"Mon","weekday","no_sled","Brush/Cement","2","2","1",7.4,0,31,0,24,23.9,0,0,0,0,0,0,0,0
"7567",2020-02-03,"Cement Creek","w1920","Motorized",1,"Mon","weekday","sled","Brush/Cement","2","2","1",7.4,0,31,0,24,23.9,0,0,0,0,0,0,0,0
"7568",2020-02-03,"Cement Creek","w1920","Hybrid",0,"Mon","weekday","sled","Brush/Cement","2","2","1",7.4,0,31,0,24,23.9,0,0,0,0,0,0,0,0
"7569",2020-02-04,"Cement Creek","w1920","Non.motorized",3,"Tue","weekday","no_sled","Brush/Cement","2","2","2",7.4,0,33,2,5,22.4,0,0,0,0,2,2,2,2
"7570",2020-02-04,"Cement Creek","w1920","Mechanized",0,"Tue","weekday","no_sled","Brush/Cement","2","2","2",7.4,0,33,2,5,22.4,0,0,0,0,2,2,2,2
"7571",2020-02-04,"Cement Creek","w1920","Motorized",0,"Tue","weekday","sled","Brush/Cement","2","2","2",7.4,0,33,2,5,22.4,0,0,0,0,2,2,2,2
"7572",2020-02-04,"Cement Creek","w1920","Hybrid",0,"Tue","weekday","sled","Brush/Cement","2","2","2",7.4,0,33,2,5,22.4,0,0,0,0,2,2,2,2
"7573",2020-02-05,"Cement Creek","w1920","Non.motorized",10,"Wed","weekday","no_sled","Brush/Cement","2","2","1",7.4,0,33,0,2,22.4,2,0,0,0,2,2,2,2
"7574",2020-02-05,"Cement Creek","w1920","Mechanized",1,"Wed","weekday","no_sled","Brush/Cement","2","2","1",7.4,0,33,0,2,22.4,2,0,0,0,2,2,2,2
"7575",2020-02-05,"Cement Creek","w1920","Motorized",3,"Wed","weekday","sled","Brush/Cement","2","2","1",7.4,0,33,0,2,22.4,2,0,0,0,2,2,2,2
"7576",2020-02-05,"Cement Creek","w1920","Hybrid",0,"Wed","weekday","sled","Brush/Cement","2","2","1",7.4,0,33,0,2,22.4,2,0,0,0,2,2,2,2
"7577",2020-02-06,"Cement Creek","w1920","Non.motorized",2,"Thu","weekday","no_sled","Brush/Cement","2","2","1",7.5,0.1,32,-1,16,23.4,0,2,0,0,-1,1,1,1
"7578",2020-02-06,"Cement Creek","w1920","Mechanized",0,"Thu","weekday","no_sled","Brush/Cement","2","2","1",7.5,0.1,32,-1,16,23.4,0,2,0,0,-1,1,1,1
"7579",2020-02-06,"Cement Creek","w1920","Motorized",1,"Thu","weekday","sled","Brush/Cement","2","2","1",7.5,0.1,32,-1,16,23.4,0,2,0,0,-1,1,1,1
"7580",2020-02-06,"Cement Creek","w1920","Hybrid",0,"Thu","weekday","sled","Brush/Cement","2","2","1",7.5,0.1,32,-1,16,23.4,0,2,0,0,-1,1,1,1
"7581",2020-02-07,"Cement Creek","w1920","Non.motorized",NA,"Fri","weekday","no_sled","Brush/Cement","3","3","3",7.9,0.4,37,5,26,21.4,-1,0,2,0,4,4,6,6
"7582",2020-02-07,"Cement Creek","w1920","Mechanized",NA,"Fri","weekday","no_sled","Brush/Cement","3","3","3",7.9,0.4,37,5,26,21.4,-1,0,2,0,4,4,6,6
"7583",2020-02-07,"Cement Creek","w1920","Motorized",NA,"Fri","weekday","sled","Brush/Cement","3","3","3",7.9,0.4,37,5,26,21.4,-1,0,2,0,4,4,6,6
"7584",2020-02-07,"Cement Creek","w1920","Hybrid",NA,"Fri","weekday","sled","Brush/Cement","3","3","3",7.9,0.4,37,5,26,21.4,-1,0,2,0,4,4,6,6
"7585",2020-02-08,"Cement Creek","w1920","Non.motorized",5,"Sat","weekend","no_sled","Brush/Cement","3","3","2",8.3,0.4,39,2,30,21.3,5,-1,0,2,7,6,6,8
"7586",2020-02-08,"Cement Creek","w1920","Mechanized",0,"Sat","weekend","no_sled","Brush/Cement","3","3","2",8.3,0.4,39,2,30,21.3,5,-1,0,2,7,6,6,8
"7587",2020-02-08,"Cement Creek","w1920","Motorized",1,"Sat","weekend","sled","Brush/Cement","3","3","2",8.3,0.4,39,2,30,21.3,5,-1,0,2,7,6,6,8
"7588",2020-02-08,"Cement Creek","w1920","Hybrid",0,"Sat","weekend","sled","Brush/Cement","3","3","2",8.3,0.4,39,2,30,21.3,5,-1,0,2,7,6,6,8
"7589",2020-02-09,"Cement Creek","w1920","Non.motorized",38,"Sun","weekend","no_sled","Brush/Cement","3","2","2",8.4,0.1,38,-1,26,22.1,2,5,-1,0,1,6,5,5
"7590",2020-02-09,"Cement Creek","w1920","Mechanized",4,"Sun","weekend","no_sled","Brush/Cement","3","2","2",8.4,0.1,38,-1,26,22.1,2,5,-1,0,1,6,5,5
"7591",2020-02-09,"Cement Creek","w1920","Motorized",1,"Sun","weekend","sled","Brush/Cement","3","2","2",8.4,0.1,38,-1,26,22.1,2,5,-1,0,1,6,5,5
"7592",2020-02-09,"Cement Creek","w1920","Hybrid",0,"Sun","weekend","sled","Brush/Cement","3","2","2",8.4,0.1,38,-1,26,22.1,2,5,-1,0,1,6,5,5
"7593",2020-02-10,"Cement Creek","w1920","Non.motorized",20,"Mon","weekday","no_sled","Brush/Cement","2","2","1",8.4,0,38,0,22,22.1,-1,2,5,-1,-1,1,6,5
"7594",2020-02-10,"Cement Creek","w1920","Mechanized",1,"Mon","weekday","no_sled","Brush/Cement","2","2","1",8.4,0,38,0,22,22.1,-1,2,5,-1,-1,1,6,5
"7595",2020-02-10,"Cement Creek","w1920","Motorized",2,"Mon","weekday","sled","Brush/Cement","2","2","1",8.4,0,38,0,22,22.1,-1,2,5,-1,-1,1,6,5
"7596",2020-02-10,"Cement Creek","w1920","Hybrid",1,"Mon","weekday","sled","Brush/Cement","2","2","1",8.4,0,38,0,22,22.1,-1,2,5,-1,-1,1,6,5
"7597",2020-02-11,"Cement Creek","w1920","Non.motorized",10,"Tue","weekday","no_sled","Brush/Cement","2","2","2",8.5,0.1,40,2,16,21.2,0,-1,2,5,2,1,3,8
"7598",2020-02-11,"Cement Creek","w1920","Mechanized",2,"Tue","weekday","no_sled","Brush/Cement","2","2","2",8.5,0.1,40,2,16,21.2,0,-1,2,5,2,1,3,8
"7599",2020-02-11,"Cement Creek","w1920","Motorized",6,"Tue","weekday","sled","Brush/Cement","2","2","2",8.5,0.1,40,2,16,21.2,0,-1,2,5,2,1,3,8
"7600",2020-02-11,"Cement Creek","w1920","Hybrid",2,"Tue","weekday","sled","Brush/Cement","2","2","2",8.5,0.1,40,2,16,21.2,0,-1,2,5,2,1,3,8
"7601",2020-02-12,"Cement Creek","w1920","Non.motorized",4,"Wed","weekday","no_sled","Brush/Cement","2","2","2",8.5,0,39,-1,15,21.8,2,0,-1,2,1,1,0,2
"7602",2020-02-12,"Cement Creek","w1920","Mechanized",1,"Wed","weekday","no_sled","Brush/Cement","2","2","2",8.5,0,39,-1,15,21.8,2,0,-1,2,1,1,0,2
"7603",2020-02-12,"Cement Creek","w1920","Motorized",3,"Wed","weekday","sled","Brush/Cement","2","2","2",8.5,0,39,-1,15,21.8,2,0,-1,2,1,1,0,2
"7604",2020-02-12,"Cement Creek","w1920","Hybrid",0,"Wed","weekday","sled","Brush/Cement","2","2","2",8.5,0,39,-1,15,21.8,2,0,-1,2,1,1,0,2
"7605",2020-02-13,"Cement Creek","w1920","Non.motorized",11,"Thu","weekday","no_sled","Brush/Cement","2","2","1",8.5,0,39,0,18,21.8,-1,2,0,-1,-1,1,1,0
"7606",2020-02-13,"Cement Creek","w1920","Mechanized",0,"Thu","weekday","no_sled","Brush/Cement","2","2","1",8.5,0,39,0,18,21.8,-1,2,0,-1,-1,1,1,0
"7607",2020-02-13,"Cement Creek","w1920","Motorized",3,"Thu","weekday","sled","Brush/Cement","2","2","1",8.5,0,39,0,18,21.8,-1,2,0,-1,-1,1,1,0
"7608",2020-02-13,"Cement Creek","w1920","Hybrid",1,"Thu","weekday","sled","Brush/Cement","2","2","1",8.5,0,39,0,18,21.8,-1,2,0,-1,-1,1,1,0
"7609",2020-02-14,"Cement Creek","w1920","Non.motorized",17,"Fri","weekday","no_sled","Brush/Cement","2","1","1",8.6,0.1,38,-1,24,22.6,0,-1,2,0,-1,-2,0,0
"7610",2020-02-14,"Cement Creek","w1920","Mechanized",1,"Fri","weekday","no_sled","Brush/Cement","2","1","1",8.6,0.1,38,-1,24,22.6,0,-1,2,0,-1,-2,0,0
"7611",2020-02-14,"Cement Creek","w1920","Motorized",0,"Fri","weekday","sled","Brush/Cement","2","1","1",8.6,0.1,38,-1,24,22.6,0,-1,2,0,-1,-2,0,0
"7612",2020-02-14,"Cement Creek","w1920","Hybrid",0,"Fri","weekday","sled","Brush/Cement","2","1","1",8.6,0.1,38,-1,24,22.6,0,-1,2,0,-1,-2,0,0
"7613",2020-02-15,"Cement Creek","w1920","Non.motorized",64,"Sat","weekend","no_sled","Brush/Cement","1","1","1",8.6,0,38,0,26,22.6,-1,0,-1,2,-1,-1,-2,0
"7614",2020-02-15,"Cement Creek","w1920","Mechanized",3,"Sat","weekend","no_sled","Brush/Cement","1","1","1",8.6,0,38,0,26,22.6,-1,0,-1,2,-1,-1,-2,0
"7615",2020-02-15,"Cement Creek","w1920","Motorized",9,"Sat","weekend","sled","Brush/Cement","1","1","1",8.6,0,38,0,26,22.6,-1,0,-1,2,-1,-1,-2,0
"7616",2020-02-15,"Cement Creek","w1920","Hybrid",0,"Sat","weekend","sled","Brush/Cement","1","1","1",8.6,0,38,0,26,22.6,-1,0,-1,2,-1,-1,-2,0
"7617",2020-02-16,"Cement Creek","w1920","Non.motorized",33,"Sun","weekend","no_sled","Brush/Cement","1","1","1",8.8,0.2,37,-1,26,23.8,0,-1,0,-1,-1,-2,-2,-3
"7618",2020-02-16,"Cement Creek","w1920","Mechanized",0,"Sun","weekend","no_sled","Brush/Cement","1","1","1",8.8,0.2,37,-1,26,23.8,0,-1,0,-1,-1,-2,-2,-3
"7619",2020-02-16,"Cement Creek","w1920","Motorized",3,"Sun","weekend","sled","Brush/Cement","1","1","1",8.8,0.2,37,-1,26,23.8,0,-1,0,-1,-1,-2,-2,-3
"7620",2020-02-16,"Cement Creek","w1920","Hybrid",0,"Sun","weekend","sled","Brush/Cement","1","1","1",8.8,0.2,37,-1,26,23.8,0,-1,0,-1,-1,-2,-2,-3
"7621",2020-02-17,"Cement Creek","w1920","Non.motorized",13,"Mon","weekday","no_sled","Brush/Cement","2","1","1",9.2,0.4,43,6,25,21.4,-1,0,-1,0,5,5,4,4
"7622",2020-02-17,"Cement Creek","w1920","Mechanized",0,"Mon","weekday","no_sled","Brush/Cement","2","1","1",9.2,0.4,43,6,25,21.4,-1,0,-1,0,5,5,4,4
"7623",2020-02-17,"Cement Creek","w1920","Motorized",3,"Mon","weekday","sled","Brush/Cement","2","1","1",9.2,0.4,43,6,25,21.4,-1,0,-1,0,5,5,4,4
"7624",2020-02-17,"Cement Creek","w1920","Hybrid",0,"Mon","weekday","sled","Brush/Cement","2","1","1",9.2,0.4,43,6,25,21.4,-1,0,-1,0,5,5,4,4
"7625",2020-02-18,"Cement Creek","w1920","Non.motorized",15,"Tue","weekday","no_sled","Brush/Cement","1","1","1",9.3,0.1,42,-1,18,22.1,6,-1,0,-1,5,4,4,3
"7626",2020-02-18,"Cement Creek","w1920","Mechanized",0,"Tue","weekday","no_sled","Brush/Cement","1","1","1",9.3,0.1,42,-1,18,22.1,6,-1,0,-1,5,4,4,3
"7627",2020-02-18,"Cement Creek","w1920","Motorized",0,"Tue","weekday","sled","Brush/Cement","1","1","1",9.3,0.1,42,-1,18,22.1,6,-1,0,-1,5,4,4,3
"7628",2020-02-18,"Cement Creek","w1920","Hybrid",0,"Tue","weekday","sled","Brush/Cement","1","1","1",9.3,0.1,42,-1,18,22.1,6,-1,0,-1,5,4,4,3
"7629",2020-02-19,"Cement Creek","w1920","Non.motorized",12,"Wed","weekday","no_sled","Brush/Cement","1","1","1",9.3,0,41,-1,22,22.7,-1,6,-1,0,-2,4,3,3
"7630",2020-02-19,"Cement Creek","w1920","Mechanized",0,"Wed","weekday","no_sled","Brush/Cement","1","1","1",9.3,0,41,-1,22,22.7,-1,6,-1,0,-2,4,3,3
"7631",2020-02-19,"Cement Creek","w1920","Motorized",2,"Wed","weekday","sled","Brush/Cement","1","1","1",9.3,0,41,-1,22,22.7,-1,6,-1,0,-2,4,3,3
"7632",2020-02-19,"Cement Creek","w1920","Hybrid",0,"Wed","weekday","sled","Brush/Cement","1","1","1",9.3,0,41,-1,22,22.7,-1,6,-1,0,-2,4,3,3
"7633",2020-02-20,"Cement Creek","w1920","Non.motorized",21,"Thu","weekday","no_sled","Brush/Cement","1","1","1",9.3,0,41,0,18,22.7,-1,-1,6,-1,-1,-2,4,3
"7634",2020-02-20,"Cement Creek","w1920","Mechanized",0,"Thu","weekday","no_sled","Brush/Cement","1","1","1",9.3,0,41,0,18,22.7,-1,-1,6,-1,-1,-2,4,3
"7635",2020-02-20,"Cement Creek","w1920","Motorized",3,"Thu","weekday","sled","Brush/Cement","1","1","1",9.3,0,41,0,18,22.7,-1,-1,6,-1,-1,-2,4,3
"7636",2020-02-20,"Cement Creek","w1920","Hybrid",0,"Thu","weekday","sled","Brush/Cement","1","1","1",9.3,0,41,0,18,22.7,-1,-1,6,-1,-1,-2,4,3
"7637",2020-02-21,"Cement Creek","w1920","Non.motorized",19,"Fri","weekday","no_sled","Brush/Cement","1","1","1",9.3,0,40,-1,26,23.2,0,-1,-1,6,-1,-2,-3,3
"7638",2020-02-21,"Cement Creek","w1920","Mechanized",2,"Fri","weekday","no_sled","Brush/Cement","1","1","1",9.3,0,40,-1,26,23.2,0,-1,-1,6,-1,-2,-3,3
"7639",2020-02-21,"Cement Creek","w1920","Motorized",3,"Fri","weekday","sled","Brush/Cement","1","1","1",9.3,0,40,-1,26,23.2,0,-1,-1,6,-1,-2,-3,3
"7640",2020-02-21,"Cement Creek","w1920","Hybrid",0,"Fri","weekday","sled","Brush/Cement","1","1","1",9.3,0,40,-1,26,23.2,0,-1,-1,6,-1,-2,-3,3
"7641",2020-02-22,"Cement Creek","w1920","Non.motorized",36,"Sat","weekend","no_sled","Brush/Cement","1","1","1",9.4,0.1,39,-1,32,24.1,-1,0,-1,-1,-2,-2,-3,-4
"7642",2020-02-22,"Cement Creek","w1920","Mechanized",0,"Sat","weekend","no_sled","Brush/Cement","1","1","1",9.4,0.1,39,-1,32,24.1,-1,0,-1,-1,-2,-2,-3,-4
"7643",2020-02-22,"Cement Creek","w1920","Motorized",1,"Sat","weekend","sled","Brush/Cement","1","1","1",9.4,0.1,39,-1,32,24.1,-1,0,-1,-1,-2,-2,-3,-4
"7644",2020-02-22,"Cement Creek","w1920","Hybrid",0,"Sat","weekend","sled","Brush/Cement","1","1","1",9.4,0.1,39,-1,32,24.1,-1,0,-1,-1,-2,-2,-3,-4
"7645",2020-02-23,"Cement Creek","w1920","Non.motorized",26,"Sun","weekend","no_sled","Brush/Cement","2","2","2",9.5,0.1,40,1,27,23.8,-1,-1,0,-1,0,-1,-1,-2
"7646",2020-02-23,"Cement Creek","w1920","Mechanized",0,"Sun","weekend","no_sled","Brush/Cement","2","2","2",9.5,0.1,40,1,27,23.8,-1,-1,0,-1,0,-1,-1,-2
"7647",2020-02-23,"Cement Creek","w1920","Motorized",3,"Sun","weekend","sled","Brush/Cement","2","2","2",9.5,0.1,40,1,27,23.8,-1,-1,0,-1,0,-1,-1,-2
"7648",2020-02-23,"Cement Creek","w1920","Hybrid",0,"Sun","weekend","sled","Brush/Cement","2","2","2",9.5,0.1,40,1,27,23.8,-1,-1,0,-1,0,-1,-1,-2
"7649",2020-02-24,"Cement Creek","w1920","Non.motorized",3,"Mon","weekday","no_sled","Brush/Cement","3","3","2",9.8,0.3,43,3,17,22.8,1,-1,-1,0,4,3,2,2
"7650",2020-02-24,"Cement Creek","w1920","Mechanized",0,"Mon","weekday","no_sled","Brush/Cement","3","3","2",9.8,0.3,43,3,17,22.8,1,-1,-1,0,4,3,2,2
"7651",2020-02-24,"Cement Creek","w1920","Motorized",4,"Mon","weekday","sled","Brush/Cement","3","3","2",9.8,0.3,43,3,17,22.8,1,-1,-1,0,4,3,2,2
"7652",2020-02-24,"Cement Creek","w1920","Hybrid",0,"Mon","weekday","sled","Brush/Cement","3","3","2",9.8,0.3,43,3,17,22.8,1,-1,-1,0,4,3,2,2
"7653",2020-02-25,"Cement Creek","w1920","Non.motorized",12,"Tue","weekday","no_sled","Brush/Cement","2","2","1",9.8,0,43,0,8,22.8,3,1,-1,-1,3,4,3,2
"7654",2020-02-25,"Cement Creek","w1920","Mechanized",1,"Tue","weekday","no_sled","Brush/Cement","2","2","1",9.8,0,43,0,8,22.8,3,1,-1,-1,3,4,3,2
"7655",2020-02-25,"Cement Creek","w1920","Motorized",4,"Tue","weekday","sled","Brush/Cement","2","2","1",9.8,0,43,0,8,22.8,3,1,-1,-1,3,4,3,2
"7656",2020-02-25,"Cement Creek","w1920","Hybrid",0,"Tue","weekday","sled","Brush/Cement","2","2","1",9.8,0,43,0,8,22.8,3,1,-1,-1,3,4,3,2
"7657",2020-02-26,"Cement Creek","w1920","Non.motorized",6,"Wed","weekday","no_sled","Brush/Cement","2","2","1",9.8,0,42,-1,15,23.3,0,3,1,-1,-1,2,3,2
"7658",2020-02-26,"Cement Creek","w1920","Mechanized",0,"Wed","weekday","no_sled","Brush/Cement","2","2","1",9.8,0,42,-1,15,23.3,0,3,1,-1,-1,2,3,2
"7659",2020-02-26,"Cement Creek","w1920","Motorized",2,"Wed","weekday","sled","Brush/Cement","2","2","1",9.8,0,42,-1,15,23.3,0,3,1,-1,-1,2,3,2
"7660",2020-02-26,"Cement Creek","w1920","Hybrid",0,"Wed","weekday","sled","Brush/Cement","2","2","1",9.8,0,42,-1,15,23.3,0,3,1,-1,-1,2,3,2
"7661",2020-02-27,"Cement Creek","w1920","Non.motorized",20,"Thu","weekday","no_sled","Brush/Cement","2","2","1",9.9,0.1,41,-1,25,24.1,-1,0,3,1,-2,-2,1,2
"7662",2020-02-27,"Cement Creek","w1920","Mechanized",6,"Thu","weekday","no_sled","Brush/Cement","2","2","1",9.9,0.1,41,-1,25,24.1,-1,0,3,1,-2,-2,1,2
"7663",2020-02-27,"Cement Creek","w1920","Motorized",3,"Thu","weekday","sled","Brush/Cement","2","2","1",9.9,0.1,41,-1,25,24.1,-1,0,3,1,-2,-2,1,2
"7664",2020-02-27,"Cement Creek","w1920","Hybrid",1,"Thu","weekday","sled","Brush/Cement","2","2","1",9.9,0.1,41,-1,25,24.1,-1,0,3,1,-2,-2,1,2
"7665",2020-02-28,"Cement Creek","w1920","Non.motorized",9,"Fri","weekday","no_sled","Brush/Cement","2","1","1",9.9,0,41,0,28,24.1,-1,-1,0,3,-1,-2,-2,1
"7666",2020-02-28,"Cement Creek","w1920","Mechanized",0,"Fri","weekday","no_sled","Brush/Cement","2","1","1",9.9,0,41,0,28,24.1,-1,-1,0,3,-1,-2,-2,1
"7667",2020-02-28,"Cement Creek","w1920","Motorized",7,"Fri","weekday","sled","Brush/Cement","2","1","1",9.9,0,41,0,28,24.1,-1,-1,0,3,-1,-2,-2,1
"7668",2020-02-28,"Cement Creek","w1920","Hybrid",0,"Fri","weekday","sled","Brush/Cement","2","1","1",9.9,0,41,0,28,24.1,-1,-1,0,3,-1,-2,-2,1
"7669",2020-02-29,"Cement Creek","w1920","Non.motorized",46,"Sat","weekend","no_sled","Brush/Cement","1","1","1",9.9,0,40,-1,29,24.8,0,-1,-1,0,-1,-2,-3,-3
"7670",2020-02-29,"Cement Creek","w1920","Mechanized",2,"Sat","weekend","no_sled","Brush/Cement","1","1","1",9.9,0,40,-1,29,24.8,0,-1,-1,0,-1,-2,-3,-3
"7671",2020-02-29,"Cement Creek","w1920","Motorized",2,"Sat","weekend","sled","Brush/Cement","1","1","1",9.9,0,40,-1,29,24.8,0,-1,-1,0,-1,-2,-3,-3
"7672",2020-02-29,"Cement Creek","w1920","Hybrid",0,"Sat","weekend","sled","Brush/Cement","1","1","1",9.9,0,40,-1,29,24.8,0,-1,-1,0,-1,-2,-3,-3
"7673",2020-03-01,"Cement Creek","w1920","Non.motorized",28,"Sun","weekend","no_sled","Brush/Cement","1","1","1",10,0.1,40,0,28,25,-1,0,-1,-1,-1,-1,-2,-3
"7674",2020-03-01,"Cement Creek","w1920","Mechanized",3,"Sun","weekend","no_sled","Brush/Cement","1","1","1",10,0.1,40,0,28,25,-1,0,-1,-1,-1,-1,-2,-3
"7675",2020-03-01,"Cement Creek","w1920","Motorized",8,"Sun","weekend","sled","Brush/Cement","1","1","1",10,0.1,40,0,28,25,-1,0,-1,-1,-1,-1,-2,-3
"7676",2020-03-01,"Cement Creek","w1920","Hybrid",2,"Sun","weekend","sled","Brush/Cement","1","1","1",10,0.1,40,0,28,25,-1,0,-1,-1,-1,-1,-2,-3
"7677",2020-03-02,"Cement Creek","w1920","Non.motorized",0,"Mon","weekday","no_sled","Brush/Cement","2","2","1",10.4,0.4,45,5,25,23.1,0,-1,0,-1,5,4,4,3
"7678",2020-03-02,"Cement Creek","w1920","Mechanized",0,"Mon","weekday","no_sled","Brush/Cement","2","2","1",10.4,0.4,45,5,25,23.1,0,-1,0,-1,5,4,4,3
"7679",2020-03-02,"Cement Creek","w1920","Motorized",0,"Mon","weekday","sled","Brush/Cement","2","2","1",10.4,0.4,45,5,25,23.1,0,-1,0,-1,5,4,4,3
"7680",2020-03-02,"Cement Creek","w1920","Hybrid",0,"Mon","weekday","sled","Brush/Cement","2","2","1",10.4,0.4,45,5,25,23.1,0,-1,0,-1,5,4,4,3
"7681",2020-03-03,"Cement Creek","w1920","Non.motorized",19,"Tue","weekday","no_sled","Brush/Cement","2","1","1",10.9,0.5,50,5,25,21.8,5,0,-1,0,10,10,9,9
"7682",2020-03-03,"Cement Creek","w1920","Mechanized",1,"Tue","weekday","no_sled","Brush/Cement","2","1","1",10.9,0.5,50,5,25,21.8,5,0,-1,0,10,10,9,9
"7683",2020-03-03,"Cement Creek","w1920","Motorized",5,"Tue","weekday","sled","Brush/Cement","2","1","1",10.9,0.5,50,5,25,21.8,5,0,-1,0,10,10,9,9
"7684",2020-03-03,"Cement Creek","w1920","Hybrid",0,"Tue","weekday","sled","Brush/Cement","2","1","1",10.9,0.5,50,5,25,21.8,5,0,-1,0,10,10,9,9
"7685",2020-03-04,"Cement Creek","w1920","Non.motorized",18,"Wed","weekday","no_sled","Brush/Cement","2","1","1",10.9,0,48,-2,29,22.7,5,5,0,-1,3,8,8,7
"7686",2020-03-04,"Cement Creek","w1920","Mechanized",0,"Wed","weekday","no_sled","Brush/Cement","2","1","1",10.9,0,48,-2,29,22.7,5,5,0,-1,3,8,8,7
"7687",2020-03-04,"Cement Creek","w1920","Motorized",4,"Wed","weekday","sled","Brush/Cement","2","1","1",10.9,0,48,-2,29,22.7,5,5,0,-1,3,8,8,7
"7688",2020-03-04,"Cement Creek","w1920","Hybrid",1,"Wed","weekday","sled","Brush/Cement","2","1","1",10.9,0,48,-2,29,22.7,5,5,0,-1,3,8,8,7
"7689",2020-03-05,"Cement Creek","w1920","Non.motorized",10,"Thu","weekday","no_sled","Brush/Cement","2","1","1",10.9,0,46,-2,32,23.7,-2,5,5,0,-4,1,6,6
"7690",2020-03-05,"Cement Creek","w1920","Mechanized",0,"Thu","weekday","no_sled","Brush/Cement","2","1","1",10.9,0,46,-2,32,23.7,-2,5,5,0,-4,1,6,6
"7691",2020-03-05,"Cement Creek","w1920","Motorized",5,"Thu","weekday","sled","Brush/Cement","2","1","1",10.9,0,46,-2,32,23.7,-2,5,5,0,-4,1,6,6
"7692",2020-03-05,"Cement Creek","w1920","Hybrid",2,"Thu","weekday","sled","Brush/Cement","2","1","1",10.9,0,46,-2,32,23.7,-2,5,5,0,-4,1,6,6
"7693",2020-03-06,"Cement Creek","w1920","Non.motorized",7,"Fri","weekday","no_sled","Brush/Cement","1","1","1",10.9,0,45,-1,34,24.2,-2,-2,5,5,-3,-5,0,5
"7694",2020-03-06,"Cement Creek","w1920","Mechanized",0,"Fri","weekday","no_sled","Brush/Cement","1","1","1",10.9,0,45,-1,34,24.2,-2,-2,5,5,-3,-5,0,5
"7695",2020-03-06,"Cement Creek","w1920","Motorized",5,"Fri","weekday","sled","Brush/Cement","1","1","1",10.9,0,45,-1,34,24.2,-2,-2,5,5,-3,-5,0,5
"7696",2020-03-06,"Cement Creek","w1920","Hybrid",0,"Fri","weekday","sled","Brush/Cement","1","1","1",10.9,0,45,-1,34,24.2,-2,-2,5,5,-3,-5,0,5
"7697",2020-03-07,"Cement Creek","w1920","Non.motorized",26,"Sat","weekend","no_sled","Brush/Cement","1","1","2",10.9,0,44,-1,35,24.8,-1,-2,-2,5,-2,-4,-6,-1
"7698",2020-03-07,"Cement Creek","w1920","Mechanized",0,"Sat","weekend","no_sled","Brush/Cement","1","1","2",10.9,0,44,-1,35,24.8,-1,-2,-2,5,-2,-4,-6,-1
"7699",2020-03-07,"Cement Creek","w1920","Motorized",3,"Sat","weekend","sled","Brush/Cement","1","1","2",10.9,0,44,-1,35,24.8,-1,-2,-2,5,-2,-4,-6,-1
"7700",2020-03-07,"Cement Creek","w1920","Hybrid",0,"Sat","weekend","sled","Brush/Cement","1","1","2",10.9,0,44,-1,35,24.8,-1,-2,-2,5,-2,-4,-6,-1
"7701",2020-03-08,"Cement Creek","w1920","Non.motorized",22,"Sun","weekend","no_sled","Brush/Cement","1","1","1",11,0.1,43,-1,33,25.6,-1,-1,-2,-2,-2,-3,-5,-7
"7702",2020-03-08,"Cement Creek","w1920","Mechanized",0,"Sun","weekend","no_sled","Brush/Cement","1","1","1",11,0.1,43,-1,33,25.6,-1,-1,-2,-2,-2,-3,-5,-7
"7703",2020-03-08,"Cement Creek","w1920","Motorized",5,"Sun","weekend","sled","Brush/Cement","1","1","1",11,0.1,43,-1,33,25.6,-1,-1,-2,-2,-2,-3,-5,-7
"7704",2020-03-08,"Cement Creek","w1920","Hybrid",0,"Sun","weekend","sled","Brush/Cement","1","1","1",11,0.1,43,-1,33,25.6,-1,-1,-2,-2,-2,-3,-5,-7
"7705",2020-03-09,"Cement Creek","w1920","Non.motorized",4,"Mon","weekday","no_sled","Brush/Cement","1","1","1",11.1,0.1,42,-1,31,26.4,-1,-1,-1,-2,-2,-3,-4,-6
"7706",2020-03-09,"Cement Creek","w1920","Mechanized",1,"Mon","weekday","no_sled","Brush/Cement","1","1","1",11.1,0.1,42,-1,31,26.4,-1,-1,-1,-2,-2,-3,-4,-6
"7707",2020-03-09,"Cement Creek","w1920","Motorized",1,"Mon","weekday","sled","Brush/Cement","1","1","1",11.1,0.1,42,-1,31,26.4,-1,-1,-1,-2,-2,-3,-4,-6
"7708",2020-03-09,"Cement Creek","w1920","Hybrid",0,"Mon","weekday","sled","Brush/Cement","1","1","1",11.1,0.1,42,-1,31,26.4,-1,-1,-1,-2,-2,-3,-4,-6
"7709",2020-03-10,"Cement Creek","w1920","Non.motorized",8,"Tue","weekday","no_sled","Brush/Cement","1","1","2",11.2,0.1,44,2,31,25.5,-1,-1,-1,-1,1,0,-1,-2
"7710",2020-03-10,"Cement Creek","w1920","Mechanized",2,"Tue","weekday","no_sled","Brush/Cement","1","1","2",11.2,0.1,44,2,31,25.5,-1,-1,-1,-1,1,0,-1,-2
"7711",2020-03-10,"Cement Creek","w1920","Motorized",2,"Tue","weekday","sled","Brush/Cement","1","1","2",11.2,0.1,44,2,31,25.5,-1,-1,-1,-1,1,0,-1,-2
"7712",2020-03-10,"Cement Creek","w1920","Hybrid",1,"Tue","weekday","sled","Brush/Cement","1","1","2",11.2,0.1,44,2,31,25.5,-1,-1,-1,-1,1,0,-1,-2
"7713",2020-03-11,"Cement Creek","w1920","Non.motorized",2,"Wed","weekday","no_sled","Brush/Cement","2","2","1",11.2,0,44,0,32,25.5,2,-1,-1,-1,2,1,0,-1
"7714",2020-03-11,"Cement Creek","w1920","Mechanized",1,"Wed","weekday","no_sled","Brush/Cement","2","2","1",11.2,0,44,0,32,25.5,2,-1,-1,-1,2,1,0,-1
"7715",2020-03-11,"Cement Creek","w1920","Motorized",1,"Wed","weekday","sled","Brush/Cement","2","2","1",11.2,0,44,0,32,25.5,2,-1,-1,-1,2,1,0,-1
"7716",2020-03-11,"Cement Creek","w1920","Hybrid",0,"Wed","weekday","sled","Brush/Cement","2","2","1",11.2,0,44,0,32,25.5,2,-1,-1,-1,2,1,0,-1
"7717",2020-03-12,"Cement Creek","w1920","Non.motorized",6,"Thu","weekday","no_sled","Brush/Cement","2","2","2",11.4,0.2,42,-2,35,27.1,0,2,-1,-1,-2,0,-1,-2
"7718",2020-03-12,"Cement Creek","w1920","Mechanized",0,"Thu","weekday","no_sled","Brush/Cement","2","2","2",11.4,0.2,42,-2,35,27.1,0,2,-1,-1,-2,0,-1,-2
"7719",2020-03-12,"Cement Creek","w1920","Motorized",5,"Thu","weekday","sled","Brush/Cement","2","2","2",11.4,0.2,42,-2,35,27.1,0,2,-1,-1,-2,0,-1,-2
"7720",2020-03-12,"Cement Creek","w1920","Hybrid",0,"Thu","weekday","sled","Brush/Cement","2","2","2",11.4,0.2,42,-2,35,27.1,0,2,-1,-1,-2,0,-1,-2
"7721",2020-03-13,"Cement Creek","w1920","Non.motorized",8,"Fri","weekday","no_sled","Brush/Cement","3","3","2",11.5,0.1,44,2,31,26.1,-2,0,2,-1,0,0,2,1
"7722",2020-03-13,"Cement Creek","w1920","Mechanized",1,"Fri","weekday","no_sled","Brush/Cement","3","3","2",11.5,0.1,44,2,31,26.1,-2,0,2,-1,0,0,2,1
"7723",2020-03-13,"Cement Creek","w1920","Motorized",4,"Fri","weekday","sled","Brush/Cement","3","3","2",11.5,0.1,44,2,31,26.1,-2,0,2,-1,0,0,2,1
"7724",2020-03-13,"Cement Creek","w1920","Hybrid",0,"Fri","weekday","sled","Brush/Cement","3","3","2",11.5,0.1,44,2,31,26.1,-2,0,2,-1,0,0,2,1
"7725",2020-03-14,"Cement Creek","w1920","Non.motorized",23,"Sat","weekend","no_sled","Brush/Cement","3","3","3",11.7,0.2,44,0,31,26.6,2,-2,0,2,2,0,0,2
"7726",2020-03-14,"Cement Creek","w1920","Mechanized",5,"Sat","weekend","no_sled","Brush/Cement","3","3","3",11.7,0.2,44,0,31,26.6,2,-2,0,2,2,0,0,2
"7727",2020-03-14,"Cement Creek","w1920","Motorized",6,"Sat","weekend","sled","Brush/Cement","3","3","3",11.7,0.2,44,0,31,26.6,2,-2,0,2,2,0,0,2
"7728",2020-03-14,"Cement Creek","w1920","Hybrid",1,"Sat","weekend","sled","Brush/Cement","3","3","3",11.7,0.2,44,0,31,26.6,2,-2,0,2,2,0,0,2
"7729",2020-03-15,"Cement Creek","w1920","Non.motorized",41,"Sun","weekend","no_sled","Brush/Cement","2","2","2",11.7,0,45,1,33,26,0,2,-2,0,1,3,1,1
"7730",2020-03-15,"Cement Creek","w1920","Mechanized",2,"Sun","weekend","no_sled","Brush/Cement","2","2","2",11.7,0,45,1,33,26,0,2,-2,0,1,3,1,1
"7731",2020-03-15,"Cement Creek","w1920","Motorized",14,"Sun","weekend","sled","Brush/Cement","2","2","2",11.7,0,45,1,33,26,0,2,-2,0,1,3,1,1
"7732",2020-03-15,"Cement Creek","w1920","Hybrid",0,"Sun","weekend","sled","Brush/Cement","2","2","2",11.7,0,45,1,33,26,0,2,-2,0,1,3,1,1
"7733",2020-03-16,"Cement Creek","w1920","Non.motorized",35,"Mon","weekday","no_sled","Brush/Cement","2","2","2",11.7,0,45,0,35,26,1,0,2,-2,1,1,3,1
"7734",2020-03-16,"Cement Creek","w1920","Mechanized",0,"Mon","weekday","no_sled","Brush/Cement","2","2","2",11.7,0,45,0,35,26,1,0,2,-2,1,1,3,1
"7735",2020-03-16,"Cement Creek","w1920","Motorized",4,"Mon","weekday","sled","Brush/Cement","2","2","2",11.7,0,45,0,35,26,1,0,2,-2,1,1,3,1
"7736",2020-03-16,"Cement Creek","w1920","Hybrid",1,"Mon","weekday","sled","Brush/Cement","2","2","2",11.7,0,45,0,35,26,1,0,2,-2,1,1,3,1
"7737",2020-03-17,"Cement Creek","w1920","Non.motorized",27,"Tue","weekday","no_sled","Brush/Cement","2","2","2",11.7,0,44,-1,36,26.6,0,1,0,2,-1,0,0,2
"7738",2020-03-17,"Cement Creek","w1920","Mechanized",1,"Tue","weekday","no_sled","Brush/Cement","2","2","2",11.7,0,44,-1,36,26.6,0,1,0,2,-1,0,0,2
"7739",2020-03-17,"Cement Creek","w1920","Motorized",6,"Tue","weekday","sled","Brush/Cement","2","2","2",11.7,0,44,-1,36,26.6,0,1,0,2,-1,0,0,2
"7740",2020-03-17,"Cement Creek","w1920","Hybrid",1,"Tue","weekday","sled","Brush/Cement","2","2","2",11.7,0,44,-1,36,26.6,0,1,0,2,-1,0,0,2
"7741",2020-03-18,"Cement Creek","w1920","Non.motorized",6,"Wed","weekday","no_sled","Brush/Cement","2","2","2",11.7,0,43,-1,33,27.2,-1,0,1,0,-2,-2,-1,-1
"7742",2020-03-18,"Cement Creek","w1920","Mechanized",1,"Wed","weekday","no_sled","Brush/Cement","2","2","2",11.7,0,43,-1,33,27.2,-1,0,1,0,-2,-2,-1,-1
"7743",2020-03-18,"Cement Creek","w1920","Motorized",0,"Wed","weekday","sled","Brush/Cement","2","2","2",11.7,0,43,-1,33,27.2,-1,0,1,0,-2,-2,-1,-1
"7744",2020-03-18,"Cement Creek","w1920","Hybrid",0,"Wed","weekday","sled","Brush/Cement","2","2","2",11.7,0,43,-1,33,27.2,-1,0,1,0,-2,-2,-1,-1
"7745",2020-03-19,"Cement Creek","w1920","Non.motorized",2,"Thu","weekday","no_sled","Brush/Cement","3","3","3",11.8,0.1,43,0,27,27.4,-1,-1,0,1,-1,-2,-2,-1
"7746",2020-03-19,"Cement Creek","w1920","Mechanized",0,"Thu","weekday","no_sled","Brush/Cement","3","3","3",11.8,0.1,43,0,27,27.4,-1,-1,0,1,-1,-2,-2,-1
"7747",2020-03-19,"Cement Creek","w1920","Motorized",0,"Thu","weekday","sled","Brush/Cement","3","3","3",11.8,0.1,43,0,27,27.4,-1,-1,0,1,-1,-2,-2,-1
"7748",2020-03-19,"Cement Creek","w1920","Hybrid",0,"Thu","weekday","sled","Brush/Cement","3","3","3",11.8,0.1,43,0,27,27.4,-1,-1,0,1,-1,-2,-2,-1
"7749",2020-03-20,"Cement Creek","w1920","Non.motorized",17,"Fri","weekday","no_sled","Brush/Cement","3","3","2",12.7,0.9,52,9,26,24.4,0,-1,-1,0,9,8,7,7
"7750",2020-03-20,"Cement Creek","w1920","Mechanized",0,"Fri","weekday","no_sled","Brush/Cement","3","3","2",12.7,0.9,52,9,26,24.4,0,-1,-1,0,9,8,7,7
"7751",2020-03-20,"Cement Creek","w1920","Motorized",4,"Fri","weekday","sled","Brush/Cement","3","3","2",12.7,0.9,52,9,26,24.4,0,-1,-1,0,9,8,7,7
"7752",2020-03-20,"Cement Creek","w1920","Hybrid",0,"Fri","weekday","sled","Brush/Cement","3","3","2",12.7,0.9,52,9,26,24.4,0,-1,-1,0,9,8,7,7
"7753",2020-03-21,"Cement Creek","w1920","Non.motorized",32,"Sat","weekend","no_sled","Brush/Cement","3","3","2",12.8,0.1,54,2,26,23.7,9,0,-1,-1,11,11,10,9
"7754",2020-03-21,"Cement Creek","w1920","Mechanized",3,"Sat","weekend","no_sled","Brush/Cement","3","3","2",12.8,0.1,54,2,26,23.7,9,0,-1,-1,11,11,10,9
"7755",2020-03-21,"Cement Creek","w1920","Motorized",3,"Sat","weekend","sled","Brush/Cement","3","3","2",12.8,0.1,54,2,26,23.7,9,0,-1,-1,11,11,10,9
"7756",2020-03-21,"Cement Creek","w1920","Hybrid",0,"Sat","weekend","sled","Brush/Cement","3","3","2",12.8,0.1,54,2,26,23.7,9,0,-1,-1,11,11,10,9
"7757",2020-03-22,"Cement Creek","w1920","Non.motorized",8,"Sun","weekend","no_sled","Brush/Cement","2","2","2",13,0.2,53,-1,28,24.5,2,9,0,-1,1,10,10,9
"7758",2020-03-22,"Cement Creek","w1920","Mechanized",0,"Sun","weekend","no_sled","Brush/Cement","2","2","2",13,0.2,53,-1,28,24.5,2,9,0,-1,1,10,10,9
"7759",2020-03-22,"Cement Creek","w1920","Motorized",2,"Sun","weekend","sled","Brush/Cement","2","2","2",13,0.2,53,-1,28,24.5,2,9,0,-1,1,10,10,9
"7760",2020-03-22,"Cement Creek","w1920","Hybrid",0,"Sun","weekend","sled","Brush/Cement","2","2","2",13,0.2,53,-1,28,24.5,2,9,0,-1,1,10,10,9
"7761",2020-03-23,"Cement Creek","w1920","Non.motorized",12,"Mon","weekday","no_sled","Brush/Cement","2","2","2",13,0,53,0,28,24.5,-1,2,9,0,-1,1,10,10
"7762",2020-03-23,"Cement Creek","w1920","Mechanized",2,"Mon","weekday","no_sled","Brush/Cement","2","2","2",13,0,53,0,28,24.5,-1,2,9,0,-1,1,10,10
"7763",2020-03-23,"Cement Creek","w1920","Motorized",3,"Mon","weekday","sled","Brush/Cement","2","2","2",13,0,53,0,28,24.5,-1,2,9,0,-1,1,10,10
"7764",2020-03-23,"Cement Creek","w1920","Hybrid",0,"Mon","weekday","sled","Brush/Cement","2","2","2",13,0,53,0,28,24.5,-1,2,9,0,-1,1,10,10
"7765",2020-03-24,"Cement Creek","w1920","Non.motorized",20,"Tue","weekday","no_sled","Brush/Cement","2","2","2",13.2,0.2,53,0,32,24.9,0,-1,2,9,0,-1,1,10
"7766",2020-03-24,"Cement Creek","w1920","Mechanized",1,"Tue","weekday","no_sled","Brush/Cement","2","2","2",13.2,0.2,53,0,32,24.9,0,-1,2,9,0,-1,1,10
"7767",2020-03-24,"Cement Creek","w1920","Motorized",5,"Tue","weekday","sled","Brush/Cement","2","2","2",13.2,0.2,53,0,32,24.9,0,-1,2,9,0,-1,1,10
"7768",2020-03-24,"Cement Creek","w1920","Hybrid",0,"Tue","weekday","sled","Brush/Cement","2","2","2",13.2,0.2,53,0,32,24.9,0,-1,2,9,0,-1,1,10
"7769",2020-03-25,"Cement Creek","w1920","Non.motorized",20,"Wed","weekday","no_sled","Brush/Cement","2","2","2",13.3,0.1,51,-2,34,26.1,0,0,-1,2,-2,-2,-3,-1
"7770",2020-03-25,"Cement Creek","w1920","Mechanized",2,"Wed","weekday","no_sled","Brush/Cement","2","2","2",13.3,0.1,51,-2,34,26.1,0,0,-1,2,-2,-2,-3,-1
"7771",2020-03-25,"Cement Creek","w1920","Motorized",2,"Wed","weekday","sled","Brush/Cement","2","2","2",13.3,0.1,51,-2,34,26.1,0,0,-1,2,-2,-2,-3,-1
"7772",2020-03-25,"Cement Creek","w1920","Hybrid",0,"Wed","weekday","sled","Brush/Cement","2","2","2",13.3,0.1,51,-2,34,26.1,0,0,-1,2,-2,-2,-3,-1
"7773",2020-03-26,"Cement Creek","w1920","Non.motorized",23,"Thu","weekday","no_sled","Brush/Cement","2","2","2",13.3,0,50,-1,36,26.6,-2,0,0,-1,-3,-3,-3,-4
"7774",2020-03-26,"Cement Creek","w1920","Non.motorized",23,"Thu","weekday","no_sled","Brush/Cement","3","3","2",13.3,0,50,-1,36,26.6,-2,0,0,-1,-3,-3,-3,-4
"7775",2020-03-26,"Cement Creek","w1920","Mechanized",0,"Thu","weekday","no_sled","Brush/Cement","2","2","2",13.3,0,50,-1,36,26.6,-2,0,0,-1,-3,-3,-3,-4
"7776",2020-03-26,"Cement Creek","w1920","Mechanized",0,"Thu","weekday","no_sled","Brush/Cement","3","3","2",13.3,0,50,-1,36,26.6,-2,0,0,-1,-3,-3,-3,-4
"7777",2020-03-26,"Cement Creek","w1920","Motorized",2,"Thu","weekday","sled","Brush/Cement","2","2","2",13.3,0,50,-1,36,26.6,-2,0,0,-1,-3,-3,-3,-4
"7778",2020-03-26,"Cement Creek","w1920","Motorized",2,"Thu","weekday","sled","Brush/Cement","3","3","2",13.3,0,50,-1,36,26.6,-2,0,0,-1,-3,-3,-3,-4
"7779",2020-03-26,"Cement Creek","w1920","Hybrid",0,"Thu","weekday","sled","Brush/Cement","2","2","2",13.3,0,50,-1,36,26.6,-2,0,0,-1,-3,-3,-3,-4
"7780",2020-03-26,"Cement Creek","w1920","Hybrid",0,"Thu","weekday","sled","Brush/Cement","3","3","2",13.3,0,50,-1,36,26.6,-2,0,0,-1,-3,-3,-3,-4
"7781",2020-03-27,"Cement Creek","w1920","Non.motorized",8,"Fri","weekday","no_sled","Brush/Cement","3","3","2",13.3,0,50,0,23,26.6,-1,-2,0,0,-1,-3,-3,-3
"7782",2020-03-27,"Cement Creek","w1920","Mechanized",0,"Fri","weekday","no_sled","Brush/Cement","3","3","2",13.3,0,50,0,23,26.6,-1,-2,0,0,-1,-3,-3,-3
"7783",2020-03-27,"Cement Creek","w1920","Motorized",2,"Fri","weekday","sled","Brush/Cement","3","3","2",13.3,0,50,0,23,26.6,-1,-2,0,0,-1,-3,-3,-3
"7784",2020-03-27,"Cement Creek","w1920","Hybrid",0,"Fri","weekday","sled","Brush/Cement","3","3","2",13.3,0,50,0,23,26.6,-1,-2,0,0,-1,-3,-3,-3
"7785",2020-03-28,"Cement Creek","w1920","Non.motorized",28,"Sat","weekend","no_sled","Brush/Cement","3","3","3",13.3,0,50,0,18,26.6,0,-1,-2,0,0,-1,-3,-3
"7786",2020-03-28,"Cement Creek","w1920","Mechanized",3,"Sat","weekend","no_sled","Brush/Cement","3","3","3",13.3,0,50,0,18,26.6,0,-1,-2,0,0,-1,-3,-3
"7787",2020-03-28,"Cement Creek","w1920","Motorized",2,"Sat","weekend","sled","Brush/Cement","3","3","3",13.3,0,50,0,18,26.6,0,-1,-2,0,0,-1,-3,-3
"7788",2020-03-28,"Cement Creek","w1920","Hybrid",0,"Sat","weekend","sled","Brush/Cement","3","3","3",13.3,0,50,0,18,26.6,0,-1,-2,0,0,-1,-3,-3
"7789",2020-03-29,"Cement Creek","w1920","Non.motorized",25,"Sun","weekend","no_sled","Brush/Cement","2","2","2",13.3,0,49,-1,24,27.1,0,0,-1,-2,-1,-1,-2,-4
"7790",2020-03-29,"Cement Creek","w1920","Mechanized",0,"Sun","weekend","no_sled","Brush/Cement","2","2","2",13.3,0,49,-1,24,27.1,0,0,-1,-2,-1,-1,-2,-4
"7791",2020-03-29,"Cement Creek","w1920","Motorized",3,"Sun","weekend","sled","Brush/Cement","2","2","2",13.3,0,49,-1,24,27.1,0,0,-1,-2,-1,-1,-2,-4
"7792",2020-03-29,"Cement Creek","w1920","Hybrid",1,"Sun","weekend","sled","Brush/Cement","2","2","2",13.3,0,49,-1,24,27.1,0,0,-1,-2,-1,-1,-2,-4
"7793",2020-03-30,"Cement Creek","w1920","Non.motorized",13,"Mon","weekday","no_sled","Brush/Cement","2","2","2",13.4,0.1,49,0,29,27.3,-1,0,0,-1,-1,-1,-1,-2
"7794",2020-03-30,"Cement Creek","w1920","Mechanized",1,"Mon","weekday","no_sled","Brush/Cement","2","2","2",13.4,0.1,49,0,29,27.3,-1,0,0,-1,-1,-1,-1,-2
"7795",2020-03-30,"Cement Creek","w1920","Motorized",6,"Mon","weekday","sled","Brush/Cement","2","2","2",13.4,0.1,49,0,29,27.3,-1,0,0,-1,-1,-1,-1,-2
"7796",2020-03-30,"Cement Creek","w1920","Hybrid",0,"Mon","weekday","sled","Brush/Cement","2","2","2",13.4,0.1,49,0,29,27.3,-1,0,0,-1,-1,-1,-1,-2
"7797",2020-03-31,"Cement Creek","w1920","Non.motorized",12,"Tue","weekday","no_sled","Brush/Cement","2","2","2",13.6,0.2,51,2,35,26.7,0,-1,0,0,2,1,1,1
"7798",2020-03-31,"Cement Creek","w1920","Mechanized",0,"Tue","weekday","no_sled","Brush/Cement","2","2","2",13.6,0.2,51,2,35,26.7,0,-1,0,0,2,1,1,1
"7799",2020-03-31,"Cement Creek","w1920","Motorized",2,"Tue","weekday","sled","Brush/Cement","2","2","2",13.6,0.2,51,2,35,26.7,0,-1,0,0,2,1,1,1
"7800",2020-03-31,"Cement Creek","w1920","Hybrid",0,"Tue","weekday","sled","Brush/Cement","2","2","2",13.6,0.2,51,2,35,26.7,0,-1,0,0,2,1,1,1
"7801",2020-04-01,"Cement Creek","w1920","Non.motorized",6,"Wed","weekday","no_sled","Brush/Cement","2","2","2",13.6,0,47,-4,39,28.9,2,0,-1,0,-2,-2,-3,-3
"7802",2020-04-01,"Cement Creek","w1920","Mechanized",0,"Wed","weekday","no_sled","Brush/Cement","2","2","2",13.6,0,47,-4,39,28.9,2,0,-1,0,-2,-2,-3,-3
"7803",2020-04-01,"Cement Creek","w1920","Motorized",6,"Wed","weekday","sled","Brush/Cement","2","2","2",13.6,0,47,-4,39,28.9,2,0,-1,0,-2,-2,-3,-3
"7804",2020-04-01,"Cement Creek","w1920","Hybrid",1,"Wed","weekday","sled","Brush/Cement","2","2","2",13.6,0,47,-4,39,28.9,2,0,-1,0,-2,-2,-3,-3
"7805",2020-04-02,"Cement Creek","w1920","Non.motorized",5,"Thu","weekday","no_sled","Brush/Cement","2","2","2",13.6,0,46,-1,31,29.6,-4,2,0,-1,-5,-3,-3,-4
"7806",2020-04-02,"Cement Creek","w1920","Mechanized",1,"Thu","weekday","no_sled","Brush/Cement","2","2","2",13.6,0,46,-1,31,29.6,-4,2,0,-1,-5,-3,-3,-4
"7807",2020-04-02,"Cement Creek","w1920","Motorized",1,"Thu","weekday","sled","Brush/Cement","2","2","2",13.6,0,46,-1,31,29.6,-4,2,0,-1,-5,-3,-3,-4
"7808",2020-04-02,"Cement Creek","w1920","Hybrid",0,"Thu","weekday","sled","Brush/Cement","2","2","2",13.6,0,46,-1,31,29.6,-4,2,0,-1,-5,-3,-3,-4
"7809",2020-04-03,"Cement Creek","w1920","Non.motorized",27,"Fri","weekday","no_sled","Brush/Cement","2","2","2",13.6,0,46,0,28,29.6,-1,-4,2,0,-1,-5,-3,-3
"7810",2020-04-03,"Cement Creek","w1920","Mechanized",0,"Fri","weekday","no_sled","Brush/Cement","2","2","2",13.6,0,46,0,28,29.6,-1,-4,2,0,-1,-5,-3,-3
"7811",2020-04-03,"Cement Creek","w1920","Motorized",1,"Fri","weekday","sled","Brush/Cement","2","2","2",13.6,0,46,0,28,29.6,-1,-4,2,0,-1,-5,-3,-3
"7812",2020-04-03,"Cement Creek","w1920","Hybrid",0,"Fri","weekday","sled","Brush/Cement","2","2","2",13.6,0,46,0,28,29.6,-1,-4,2,0,-1,-5,-3,-3
"7813",2020-04-04,"Cement Creek","w1920","Non.motorized",21,"Sat","weekend","no_sled","Brush/Cement","2","2","2",13.6,0,45,-1,33,30.2,0,-1,-4,2,-1,-2,-6,-4
"7814",2020-04-04,"Cement Creek","w1920","Mechanized",0,"Sat","weekend","no_sled","Brush/Cement","2","2","2",13.6,0,45,-1,33,30.2,0,-1,-4,2,-1,-2,-6,-4
"7815",2020-04-04,"Cement Creek","w1920","Motorized",6,"Sat","weekend","sled","Brush/Cement","2","2","2",13.6,0,45,-1,33,30.2,0,-1,-4,2,-1,-2,-6,-4
"7816",2020-04-04,"Cement Creek","w1920","Hybrid",1,"Sat","weekend","sled","Brush/Cement","2","2","2",13.6,0,45,-1,33,30.2,0,-1,-4,2,-1,-2,-6,-4
"7817",2020-04-05,"Cement Creek","w1920","Non.motorized",21,"Sun","weekend","no_sled","Brush/Cement","2","2","3",13.6,0,45,0,38,30.2,-1,0,-1,-4,-1,-1,-2,-6
"7818",2020-04-05,"Cement Creek","w1920","Mechanized",1,"Sun","weekend","no_sled","Brush/Cement","2","2","3",13.6,0,45,0,38,30.2,-1,0,-1,-4,-1,-1,-2,-6
"7819",2020-04-05,"Cement Creek","w1920","Motorized",4,"Sun","weekend","sled","Brush/Cement","2","2","3",13.6,0,45,0,38,30.2,-1,0,-1,-4,-1,-1,-2,-6
"7820",2020-04-05,"Cement Creek","w1920","Hybrid",0,"Sun","weekend","sled","Brush/Cement","2","2","3",13.6,0,45,0,38,30.2,-1,0,-1,-4,-1,-1,-2,-6
"7821",2020-04-06,"Cement Creek","w1920","Non.motorized",11,"Mon","weekday","no_sled","Brush/Cement","2","2","3",13.6,0,44,-1,40,30.9,0,-1,0,-1,-1,-2,-2,-3
"7822",2020-04-06,"Cement Creek","w1920","Mechanized",1,"Mon","weekday","no_sled","Brush/Cement","2","2","3",13.6,0,44,-1,40,30.9,0,-1,0,-1,-1,-2,-2,-3
"7823",2020-04-06,"Cement Creek","w1920","Motorized",0,"Mon","weekday","sled","Brush/Cement","2","2","3",13.6,0,44,-1,40,30.9,0,-1,0,-1,-1,-2,-2,-3
"7824",2020-04-06,"Cement Creek","w1920","Hybrid",0,"Mon","weekday","sled","Brush/Cement","2","2","3",13.6,0,44,-1,40,30.9,0,-1,0,-1,-1,-2,-2,-3
"7825",2020-04-07,"Cement Creek","w1920","Non.motorized",12,"Tue","weekday","no_sled","Brush/Cement","2","2","3",13.4,-0.2,43,-1,39,31.2,-1,0,-1,0,-2,-2,-3,-3
"7826",2020-04-07,"Cement Creek","w1920","Mechanized",1,"Tue","weekday","no_sled","Brush/Cement","2","2","3",13.4,-0.2,43,-1,39,31.2,-1,0,-1,0,-2,-2,-3,-3
"7827",2020-04-07,"Cement Creek","w1920","Motorized",4,"Tue","weekday","sled","Brush/Cement","2","2","3",13.4,-0.2,43,-1,39,31.2,-1,0,-1,0,-2,-2,-3,-3
"7828",2020-04-07,"Cement Creek","w1920","Hybrid",2,"Tue","weekday","sled","Brush/Cement","2","2","3",13.4,-0.2,43,-1,39,31.2,-1,0,-1,0,-2,-2,-3,-3
"7829",2020-04-08,"Cement Creek","w1920","Non.motorized",17,"Wed","weekday","no_sled","Brush/Cement","2","3","3",13.3,-0.1,42,-1,40,31.7,-1,-1,0,-1,-2,-3,-3,-4
"7830",2020-04-08,"Cement Creek","w1920","Mechanized",0,"Wed","weekday","no_sled","Brush/Cement","2","3","3",13.3,-0.1,42,-1,40,31.7,-1,-1,0,-1,-2,-3,-3,-4
"7831",2020-04-08,"Cement Creek","w1920","Motorized",0,"Wed","weekday","sled","Brush/Cement","2","3","3",13.3,-0.1,42,-1,40,31.7,-1,-1,0,-1,-2,-3,-3,-4
"7832",2020-04-08,"Cement Creek","w1920","Hybrid",0,"Wed","weekday","sled","Brush/Cement","2","3","3",13.3,-0.1,42,-1,40,31.7,-1,-1,0,-1,-2,-3,-3,-4
"7833",2020-04-09,"Cement Creek","w1920","Non.motorized",9,"Thu","weekday","no_sled","Brush/Cement","2","3","3",13.1,-0.2,40,-2,42,32.8,-1,-1,-1,0,-3,-4,-5,-5
"7834",2020-04-09,"Cement Creek","w1920","Mechanized",0,"Thu","weekday","no_sled","Brush/Cement","2","3","3",13.1,-0.2,40,-2,42,32.8,-1,-1,-1,0,-3,-4,-5,-5
"7835",2020-04-09,"Cement Creek","w1920","Motorized",1,"Thu","weekday","sled","Brush/Cement","2","3","3",13.1,-0.2,40,-2,42,32.8,-1,-1,-1,0,-3,-4,-5,-5
"7836",2020-04-09,"Cement Creek","w1920","Hybrid",0,"Thu","weekday","sled","Brush/Cement","2","3","3",13.1,-0.2,40,-2,42,32.8,-1,-1,-1,0,-3,-4,-5,-5
"7837",2020-04-10,"Cement Creek","w1920","Non.motorized",6,"Fri","weekday","no_sled","Brush/Cement","3","3","3",12.9,-0.2,39,-1,38,33.1,-2,-1,-1,-1,-3,-4,-5,-6
"7838",2020-04-10,"Cement Creek","w1920","Mechanized",1,"Fri","weekday","no_sled","Brush/Cement","3","3","3",12.9,-0.2,39,-1,38,33.1,-2,-1,-1,-1,-3,-4,-5,-6
"7839",2020-04-10,"Cement Creek","w1920","Motorized",0,"Fri","weekday","sled","Brush/Cement","3","3","3",12.9,-0.2,39,-1,38,33.1,-2,-1,-1,-1,-3,-4,-5,-6
"7840",2020-04-10,"Cement Creek","w1920","Hybrid",0,"Fri","weekday","sled","Brush/Cement","3","3","3",12.9,-0.2,39,-1,38,33.1,-2,-1,-1,-1,-3,-4,-5,-6
"7841",2020-04-11,"Cement Creek","w1920","Non.motorized",17,"Sat","weekend","no_sled","Brush/Cement","2","3","3",12.9,0,39,0,36,33.1,-1,-2,-1,-1,-1,-3,-4,-5
"7842",2020-04-11,"Cement Creek","w1920","Mechanized",1,"Sat","weekend","no_sled","Brush/Cement","2","3","3",12.9,0,39,0,36,33.1,-1,-2,-1,-1,-1,-3,-4,-5
"7843",2020-04-11,"Cement Creek","w1920","Motorized",2,"Sat","weekend","sled","Brush/Cement","2","3","3",12.9,0,39,0,36,33.1,-1,-2,-1,-1,-1,-3,-4,-5
"7844",2020-04-11,"Cement Creek","w1920","Hybrid",2,"Sat","weekend","sled","Brush/Cement","2","3","3",12.9,0,39,0,36,33.1,-1,-2,-1,-1,-1,-3,-4,-5
"7845",2020-04-12,"Cement Creek","w1920","Non.motorized",16,"Sun","weekend","no_sled","Brush/Cement","2","2","2",12.8,-0.1,38,-1,29,33.7,0,-1,-2,-1,-1,-2,-4,-5
"7846",2020-04-12,"Cement Creek","w1920","Mechanized",0,"Sun","weekend","no_sled","Brush/Cement","2","2","2",12.8,-0.1,38,-1,29,33.7,0,-1,-2,-1,-1,-2,-4,-5
"7847",2020-04-12,"Cement Creek","w1920","Motorized",3,"Sun","weekend","sled","Brush/Cement","2","2","2",12.8,-0.1,38,-1,29,33.7,0,-1,-2,-1,-1,-2,-4,-5
"7848",2020-04-12,"Cement Creek","w1920","Hybrid",0,"Sun","weekend","sled","Brush/Cement","2","2","2",12.8,-0.1,38,-1,29,33.7,0,-1,-2,-1,-1,-2,-4,-5
"7849",2020-04-13,"Cement Creek","w1920","Non.motorized",2,"Mon","weekday","no_sled","Brush/Cement",NA,NA,NA,12.9,0.1,39,1,20,33.1,-1,0,-1,-2,0,0,-1,-3
"7850",2020-04-13,"Cement Creek","w1920","Mechanized",0,"Mon","weekday","no_sled","Brush/Cement",NA,NA,NA,12.9,0.1,39,1,20,33.1,-1,0,-1,-2,0,0,-1,-3
"7851",2020-04-13,"Cement Creek","w1920","Motorized",0,"Mon","weekday","sled","Brush/Cement",NA,NA,NA,12.9,0.1,39,1,20,33.1,-1,0,-1,-2,0,0,-1,-3
"7852",2020-04-13,"Cement Creek","w1920","Hybrid",0,"Mon","weekday","sled","Brush/Cement",NA,NA,NA,12.9,0.1,39,1,20,33.1,-1,0,-1,-2,0,0,-1,-3
"7853",2020-04-14,"Cement Creek","w1920","Non.motorized",4,"Tue","weekday","no_sled","Brush/Cement","2","2","2",13,0.1,39,0,18,33.3,1,-1,0,-1,1,0,0,-1
"7854",2020-04-14,"Cement Creek","w1920","Mechanized",0,"Tue","weekday","no_sled","Brush/Cement","2","2","2",13,0.1,39,0,18,33.3,1,-1,0,-1,1,0,0,-1
"7855",2020-04-14,"Cement Creek","w1920","Motorized",0,"Tue","weekday","sled","Brush/Cement","2","2","2",13,0.1,39,0,18,33.3,1,-1,0,-1,1,0,0,-1
"7856",2020-04-14,"Cement Creek","w1920","Hybrid",0,"Tue","weekday","sled","Brush/Cement","2","2","2",13,0.1,39,0,18,33.3,1,-1,0,-1,1,0,0,-1
"7857",2020-04-15,"Cement Creek","w1920","Non.motorized",6,"Wed","weekday","no_sled","Brush/Cement",NA,NA,NA,13.2,0.2,39,0,28,33.8,0,1,-1,0,0,1,0,0
"7858",2020-04-15,"Cement Creek","w1920","Mechanized",0,"Wed","weekday","no_sled","Brush/Cement",NA,NA,NA,13.2,0.2,39,0,28,33.8,0,1,-1,0,0,1,0,0
"7859",2020-04-15,"Cement Creek","w1920","Motorized",1,"Wed","weekday","sled","Brush/Cement",NA,NA,NA,13.2,0.2,39,0,28,33.8,0,1,-1,0,0,1,0,0
"7860",2020-04-15,"Cement Creek","w1920","Hybrid",1,"Wed","weekday","sled","Brush/Cement",NA,NA,NA,13.2,0.2,39,0,28,33.8,0,1,-1,0,0,1,0,0
"7861",2019-12-06,"Gothic Rd","w1920","Non.motorized",14,"Fri","weekday","no_sled","East River","2","2","1",2.9,0.4,19,5,24,15.3,0,0,0,0,5,5,5,5
"7862",2019-12-06,"Gothic Rd","w1920","Mechanized",2,"Fri","weekday","no_sled","East River","2","2","1",2.9,0.4,19,5,24,15.3,0,0,0,0,5,5,5,5
"7863",2019-12-06,"Gothic Rd","w1920","Motorized",2,"Fri","weekday","sled","East River","2","2","1",2.9,0.4,19,5,24,15.3,0,0,0,0,5,5,5,5
"7864",2019-12-06,"Gothic Rd","w1920","Hybrid",0,"Fri","weekday","sled","East River","2","2","1",2.9,0.4,19,5,24,15.3,0,0,0,0,5,5,5,5
"7865",2019-12-07,"Gothic Rd","w1920","Non.motorized",NA,"Sat","weekend","no_sled","East River","2","2","1",3,0.1,18,-1,29,16.7,5,0,0,0,4,4,4,4
"7866",2019-12-07,"Gothic Rd","w1920","Mechanized",NA,"Sat","weekend","no_sled","East River","2","2","1",3,0.1,18,-1,29,16.7,5,0,0,0,4,4,4,4
"7867",2019-12-07,"Gothic Rd","w1920","Motorized",NA,"Sat","weekend","sled","East River","2","2","1",3,0.1,18,-1,29,16.7,5,0,0,0,4,4,4,4
"7868",2019-12-07,"Gothic Rd","w1920","Hybrid",NA,"Sat","weekend","sled","East River","2","2","1",3,0.1,18,-1,29,16.7,5,0,0,0,4,4,4,4
"7869",2019-12-08,"Gothic Rd","w1920","Non.motorized",12,"Sun","weekend","no_sled","East River","2","2","1",3,0,17,-1,28,17.6,-1,5,0,0,-2,3,3,3
"7870",2019-12-08,"Gothic Rd","w1920","Mechanized",0,"Sun","weekend","no_sled","East River","2","2","1",3,0,17,-1,28,17.6,-1,5,0,0,-2,3,3,3
"7871",2019-12-08,"Gothic Rd","w1920","Motorized",2,"Sun","weekend","sled","East River","2","2","1",3,0,17,-1,28,17.6,-1,5,0,0,-2,3,3,3
"7872",2019-12-08,"Gothic Rd","w1920","Hybrid",0,"Sun","weekend","sled","East River","2","2","1",3,0,17,-1,28,17.6,-1,5,0,0,-2,3,3,3
"7873",2019-12-09,"Gothic Rd","w1920","Non.motorized",3,"Mon","weekday","no_sled","East River","3","3","2",3.4,0.4,22,5,21,15.5,-1,-1,5,0,4,3,8,8
"7874",2019-12-09,"Gothic Rd","w1920","Mechanized",0,"Mon","weekday","no_sled","East River","3","3","2",3.4,0.4,22,5,21,15.5,-1,-1,5,0,4,3,8,8
"7875",2019-12-09,"Gothic Rd","w1920","Motorized",3,"Mon","weekday","sled","East River","3","3","2",3.4,0.4,22,5,21,15.5,-1,-1,5,0,4,3,8,8
"7876",2019-12-09,"Gothic Rd","w1920","Hybrid",0,"Mon","weekday","sled","East River","3","3","2",3.4,0.4,22,5,21,15.5,-1,-1,5,0,4,3,8,8
"7877",2020-12-10,"Gothic Rd","w1920","Non.motorized",7,"Thu","weekday","no_sled","East River",NA,NA,NA,2.5,NA,11,0,28,22.7,0,0,0,0,0,0,0,0
"7878",2020-12-10,"Gothic Rd","w1920","Mechanized",0,"Thu","weekday","no_sled","East River",NA,NA,NA,2.5,NA,11,0,28,22.7,0,0,0,0,0,0,0,0
"7879",2020-12-10,"Gothic Rd","w1920","Motorized",2,"Thu","weekday","sled","East River",NA,NA,NA,2.5,NA,11,0,28,22.7,0,0,0,0,0,0,0,0
"7880",2020-12-10,"Gothic Rd","w1920","Hybrid",0,"Thu","weekday","sled","East River",NA,NA,NA,2.5,NA,11,0,28,22.7,0,0,0,0,0,0,0,0
"7881",2019-12-11,"Gothic Rd","w1920","Non.motorized",11,"Wed","weekday","no_sled","East River","2","2","2",3.4,0,20,-1,22,17,-1,5,-1,-1,-2,3,2,1
"7882",2019-12-11,"Gothic Rd","w1920","Mechanized",0,"Wed","weekday","no_sled","East River","2","2","2",3.4,0,20,-1,22,17,-1,5,-1,-1,-2,3,2,1
"7883",2019-12-11,"Gothic Rd","w1920","Motorized",1,"Wed","weekday","sled","East River","2","2","2",3.4,0,20,-1,22,17,-1,5,-1,-1,-2,3,2,1
"7884",2019-12-11,"Gothic Rd","w1920","Hybrid",0,"Wed","weekday","sled","East River","2","2","2",3.4,0,20,-1,22,17,-1,5,-1,-1,-2,3,2,1
"7885",2019-12-12,"Gothic Rd","w1920","Non.motorized",15,"Thu","weekday","no_sled","East River","2","2","2",3.4,0,19,-1,25,17.9,-1,-1,5,-1,-2,-3,2,1
"7886",2019-12-12,"Gothic Rd","w1920","Mechanized",0,"Thu","weekday","no_sled","East River","2","2","2",3.4,0,19,-1,25,17.9,-1,-1,5,-1,-2,-3,2,1
"7887",2019-12-12,"Gothic Rd","w1920","Motorized",0,"Thu","weekday","sled","East River","2","2","2",3.4,0,19,-1,25,17.9,-1,-1,5,-1,-2,-3,2,1
"7888",2019-12-12,"Gothic Rd","w1920","Hybrid",0,"Thu","weekday","sled","East River","2","2","2",3.4,0,19,-1,25,17.9,-1,-1,5,-1,-2,-3,2,1
"7889",2019-12-13,"Gothic Rd","w1920","Non.motorized",11,"Fri","weekday","no_sled","East River","2","2","2",3.8,0.4,21,2,24,18.1,-1,-1,-1,5,1,0,-1,4
"7890",2019-12-13,"Gothic Rd","w1920","Mechanized",0,"Fri","weekday","no_sled","East River","2","2","2",3.8,0.4,21,2,24,18.1,-1,-1,-1,5,1,0,-1,4
"7891",2019-12-13,"Gothic Rd","w1920","Motorized",0,"Fri","weekday","sled","East River","2","2","2",3.8,0.4,21,2,24,18.1,-1,-1,-1,5,1,0,-1,4
"7892",2019-12-13,"Gothic Rd","w1920","Hybrid",0,"Fri","weekday","sled","East River","2","2","2",3.8,0.4,21,2,24,18.1,-1,-1,-1,5,1,0,-1,4
"7893",2019-12-14,"Gothic Rd","w1920","Non.motorized",7,"Sat","weekend","no_sled","East River","3","3","3",4.2,0.4,27,6,25,15.6,2,-1,-1,-1,8,7,6,5
"7894",2019-12-14,"Gothic Rd","w1920","Mechanized",2,"Sat","weekend","no_sled","East River","3","3","3",4.2,0.4,27,6,25,15.6,2,-1,-1,-1,8,7,6,5
"7895",2019-12-14,"Gothic Rd","w1920","Motorized",0,"Sat","weekend","sled","East River","3","3","3",4.2,0.4,27,6,25,15.6,2,-1,-1,-1,8,7,6,5
"7896",2019-12-14,"Gothic Rd","w1920","Hybrid",0,"Sat","weekend","sled","East River","3","3","3",4.2,0.4,27,6,25,15.6,2,-1,-1,-1,8,7,6,5
"7897",2019-12-15,"Gothic Rd","w1920","Non.motorized",13,"Sun","weekend","no_sled","East River","3","3","2",4.8,0.6,31,4,17,15.5,6,2,-1,-1,10,12,11,10
"7898",2019-12-15,"Gothic Rd","w1920","Mechanized",0,"Sun","weekend","no_sled","East River","3","3","2",4.8,0.6,31,4,17,15.5,6,2,-1,-1,10,12,11,10
"7899",2019-12-15,"Gothic Rd","w1920","Motorized",0,"Sun","weekend","sled","East River","3","3","2",4.8,0.6,31,4,17,15.5,6,2,-1,-1,10,12,11,10
"7900",2019-12-15,"Gothic Rd","w1920","Hybrid",0,"Sun","weekend","sled","East River","3","3","2",4.8,0.6,31,4,17,15.5,6,2,-1,-1,10,12,11,10
"7901",2019-12-16,"Gothic Rd","w1920","Non.motorized",7,"Mon","weekday","no_sled","East River","3","3","2",4.8,0,29,-2,6,16.6,4,6,2,-1,2,8,10,9
"7902",2019-12-16,"Gothic Rd","w1920","Mechanized",0,"Mon","weekday","no_sled","East River","3","3","2",4.8,0,29,-2,6,16.6,4,6,2,-1,2,8,10,9
"7903",2019-12-16,"Gothic Rd","w1920","Motorized",1,"Mon","weekday","sled","East River","3","3","2",4.8,0,29,-2,6,16.6,4,6,2,-1,2,8,10,9
"7904",2019-12-16,"Gothic Rd","w1920","Hybrid",0,"Mon","weekday","sled","East River","3","3","2",4.8,0,29,-2,6,16.6,4,6,2,-1,2,8,10,9
"7905",2019-12-17,"Gothic Rd","w1920","Non.motorized",3,"Tue","weekday","no_sled","East River","2","2","1",4.8,0,27,-2,8,17.8,-2,4,6,2,-4,0,6,8
"7906",2019-12-17,"Gothic Rd","w1920","Mechanized",0,"Tue","weekday","no_sled","East River","2","2","1",4.8,0,27,-2,8,17.8,-2,4,6,2,-4,0,6,8
"7907",2019-12-17,"Gothic Rd","w1920","Motorized",0,"Tue","weekday","sled","East River","2","2","1",4.8,0,27,-2,8,17.8,-2,4,6,2,-4,0,6,8
"7908",2019-12-17,"Gothic Rd","w1920","Hybrid",0,"Tue","weekday","sled","East River","2","2","1",4.8,0,27,-2,8,17.8,-2,4,6,2,-4,0,6,8
"7909",2019-12-18,"Gothic Rd","w1920","Non.motorized",10,"Wed","weekday","no_sled","East River","2","2","1",4.8,0,26,-1,20,18.5,-2,-2,4,6,-3,-5,-1,5
"7910",2019-12-18,"Gothic Rd","w1920","Mechanized",1,"Wed","weekday","no_sled","East River","2","2","1",4.8,0,26,-1,20,18.5,-2,-2,4,6,-3,-5,-1,5
"7911",2019-12-18,"Gothic Rd","w1920","Motorized",2,"Wed","weekday","sled","East River","2","2","1",4.8,0,26,-1,20,18.5,-2,-2,4,6,-3,-5,-1,5
"7912",2019-12-18,"Gothic Rd","w1920","Hybrid",0,"Wed","weekday","sled","East River","2","2","1",4.8,0,26,-1,20,18.5,-2,-2,4,6,-3,-5,-1,5
"7913",2019-12-19,"Gothic Rd","w1920","Non.motorized",13,"Thu","weekday","no_sled","East River","2","2","1",4.9,0.1,25,-1,21,19.6,-1,-2,-2,4,-2,-4,-6,-2
"7914",2019-12-19,"Gothic Rd","w1920","Mechanized",0,"Thu","weekday","no_sled","East River","2","2","1",4.9,0.1,25,-1,21,19.6,-1,-2,-2,4,-2,-4,-6,-2
"7915",2019-12-19,"Gothic Rd","w1920","Motorized",0,"Thu","weekday","sled","East River","2","2","1",4.9,0.1,25,-1,21,19.6,-1,-2,-2,4,-2,-4,-6,-2
"7916",2019-12-19,"Gothic Rd","w1920","Hybrid",0,"Thu","weekday","sled","East River","2","2","1",4.9,0.1,25,-1,21,19.6,-1,-2,-2,4,-2,-4,-6,-2
"7917",2019-12-20,"Gothic Rd","w1920","Non.motorized",20,"Fri","weekday","no_sled","East River","2","2","1",4.9,0,24,-1,21,20.4,-1,-1,-2,-2,-2,-3,-5,-7
"7918",2019-12-20,"Gothic Rd","w1920","Mechanized",0,"Fri","weekday","no_sled","East River","2","2","1",4.9,0,24,-1,21,20.4,-1,-1,-2,-2,-2,-3,-5,-7
"7919",2019-12-20,"Gothic Rd","w1920","Motorized",1,"Fri","weekday","sled","East River","2","2","1",4.9,0,24,-1,21,20.4,-1,-1,-2,-2,-2,-3,-5,-7
"7920",2019-12-20,"Gothic Rd","w1920","Hybrid",0,"Fri","weekday","sled","East River","2","2","1",4.9,0,24,-1,21,20.4,-1,-1,-2,-2,-2,-3,-5,-7
"7921",2019-12-21,"Gothic Rd","w1920","Non.motorized",33,"Sat","weekend","no_sled","East River","2","2","1",4.9,0,24,0,27,20.4,-1,-1,-1,-2,-1,-2,-3,-5
"7922",2019-12-21,"Gothic Rd","w1920","Mechanized",3,"Sat","weekend","no_sled","East River","2","2","1",4.9,0,24,0,27,20.4,-1,-1,-1,-2,-1,-2,-3,-5
"7923",2019-12-21,"Gothic Rd","w1920","Motorized",1,"Sat","weekend","sled","East River","2","2","1",4.9,0,24,0,27,20.4,-1,-1,-1,-2,-1,-2,-3,-5
"7924",2019-12-21,"Gothic Rd","w1920","Hybrid",0,"Sat","weekend","sled","East River","2","2","1",4.9,0,24,0,27,20.4,-1,-1,-1,-2,-1,-2,-3,-5
"7925",2019-12-22,"Gothic Rd","w1920","Non.motorized",25,"Sun","weekend","no_sled","East River","2","2","1",5,0.1,23,-1,31,21.7,0,-1,-1,-1,-1,-2,-3,-4
"7926",2019-12-22,"Gothic Rd","w1920","Mechanized",2,"Sun","weekend","no_sled","East River","2","2","1",5,0.1,23,-1,31,21.7,0,-1,-1,-1,-1,-2,-3,-4
"7927",2019-12-22,"Gothic Rd","w1920","Motorized",0,"Sun","weekend","sled","East River","2","2","1",5,0.1,23,-1,31,21.7,0,-1,-1,-1,-1,-2,-3,-4
"7928",2019-12-22,"Gothic Rd","w1920","Hybrid",0,"Sun","weekend","sled","East River","2","2","1",5,0.1,23,-1,31,21.7,0,-1,-1,-1,-1,-2,-3,-4
"7929",2019-12-23,"Gothic Rd","w1920","Non.motorized",12,"Mon","weekday","no_sled","East River","2","1","1",5,0,23,0,34,21.7,-1,0,-1,-1,-1,-1,-2,-3
"7930",2019-12-23,"Gothic Rd","w1920","Mechanized",1,"Mon","weekday","no_sled","East River","2","1","1",5,0,23,0,34,21.7,-1,0,-1,-1,-1,-1,-2,-3
"7931",2019-12-23,"Gothic Rd","w1920","Motorized",0,"Mon","weekday","sled","East River","2","1","1",5,0,23,0,34,21.7,-1,0,-1,-1,-1,-1,-2,-3
"7932",2019-12-23,"Gothic Rd","w1920","Hybrid",0,"Mon","weekday","sled","East River","2","1","1",5,0,23,0,34,21.7,-1,0,-1,-1,-1,-1,-2,-3
"7933",2019-12-24,"Gothic Rd","w1920","Non.motorized",27,"Tue","weekday","no_sled","East River","2","1","1",5,0,22,-1,30,22.7,0,-1,0,-1,-1,-2,-2,-3
"7934",2019-12-24,"Gothic Rd","w1920","Mechanized",3,"Tue","weekday","no_sled","East River","2","1","1",5,0,22,-1,30,22.7,0,-1,0,-1,-1,-2,-2,-3
"7935",2019-12-24,"Gothic Rd","w1920","Motorized",0,"Tue","weekday","sled","East River","2","1","1",5,0,22,-1,30,22.7,0,-1,0,-1,-1,-2,-2,-3
"7936",2019-12-24,"Gothic Rd","w1920","Hybrid",0,"Tue","weekday","sled","East River","2","1","1",5,0,22,-1,30,22.7,0,-1,0,-1,-1,-2,-2,-3
"7937",2019-12-25,"Gothic Rd","w1920","Non.motorized",39,"Wed","weekday","no_sled","East River","2","2","2",5,0,23,1,22,21.7,-1,0,-1,0,0,0,-1,-1
"7938",2019-12-25,"Gothic Rd","w1920","Mechanized",4,"Wed","weekday","no_sled","East River","2","2","2",5,0,23,1,22,21.7,-1,0,-1,0,0,0,-1,-1
"7939",2019-12-25,"Gothic Rd","w1920","Motorized",0,"Wed","weekday","sled","East River","2","2","2",5,0,23,1,22,21.7,-1,0,-1,0,0,0,-1,-1
"7940",2019-12-25,"Gothic Rd","w1920","Hybrid",0,"Wed","weekday","sled","East River","2","2","2",5,0,23,1,22,21.7,-1,0,-1,0,0,0,-1,-1
"7941",2019-12-26,"Gothic Rd","w1920","Non.motorized",36,"Thu","weekday","no_sled","East River","2","2","1",5,0,23,0,17,21.7,1,-1,0,-1,1,0,0,-1
"7942",2019-12-26,"Gothic Rd","w1920","Mechanized",4,"Thu","weekday","no_sled","East River","2","2","1",5,0,23,0,17,21.7,1,-1,0,-1,1,0,0,-1
"7943",2019-12-26,"Gothic Rd","w1920","Motorized",0,"Thu","weekday","sled","East River","2","2","1",5,0,23,0,17,21.7,1,-1,0,-1,1,0,0,-1
"7944",2019-12-26,"Gothic Rd","w1920","Hybrid",0,"Thu","weekday","sled","East River","2","2","1",5,0,23,0,17,21.7,1,-1,0,-1,1,0,0,-1
"7945",2019-12-27,"Gothic Rd","w1920","Non.motorized",42,"Fri","weekday","no_sled","East River","3","3","2",5.1,0.1,24,1,22,21.2,0,1,-1,0,1,2,1,1
"7946",2019-12-27,"Gothic Rd","w1920","Mechanized",2,"Fri","weekday","no_sled","East River","3","3","2",5.1,0.1,24,1,22,21.2,0,1,-1,0,1,2,1,1
"7947",2019-12-27,"Gothic Rd","w1920","Motorized",0,"Fri","weekday","sled","East River","3","3","2",5.1,0.1,24,1,22,21.2,0,1,-1,0,1,2,1,1
"7948",2019-12-27,"Gothic Rd","w1920","Hybrid",0,"Fri","weekday","sled","East River","3","3","2",5.1,0.1,24,1,22,21.2,0,1,-1,0,1,2,1,1
"7949",2019-12-28,"Gothic Rd","w1920","Non.motorized",55,"Sat","weekend","no_sled","East River","3","3","2",5.6,0.5,30,6,16,18.7,1,0,1,-1,7,7,8,7
"7950",2019-12-28,"Gothic Rd","w1920","Mechanized",1,"Sat","weekend","no_sled","East River","3","3","2",5.6,0.5,30,6,16,18.7,1,0,1,-1,7,7,8,7
"7951",2019-12-28,"Gothic Rd","w1920","Motorized",0,"Sat","weekend","sled","East River","3","3","2",5.6,0.5,30,6,16,18.7,1,0,1,-1,7,7,8,7
"7952",2019-12-28,"Gothic Rd","w1920","Hybrid",0,"Sat","weekend","sled","East River","3","3","2",5.6,0.5,30,6,16,18.7,1,0,1,-1,7,7,8,7
"7953",2019-12-29,"Gothic Rd","w1920","Non.motorized",50,"Sun","weekend","no_sled","East River","3","3","2",5.6,0,29,-1,3,19.3,6,1,0,1,5,6,6,7
"7954",2019-12-29,"Gothic Rd","w1920","Mechanized",1,"Sun","weekend","no_sled","East River","3","3","2",5.6,0,29,-1,3,19.3,6,1,0,1,5,6,6,7
"7955",2019-12-29,"Gothic Rd","w1920","Motorized",0,"Sun","weekend","sled","East River","3","3","2",5.6,0,29,-1,3,19.3,6,1,0,1,5,6,6,7
"7956",2019-12-29,"Gothic Rd","w1920","Hybrid",0,"Sun","weekend","sled","East River","3","3","2",5.6,0,29,-1,3,19.3,6,1,0,1,5,6,6,7
"7957",2019-12-30,"Gothic Rd","w1920","Non.motorized",55,"Mon","weekday","no_sled","East River","3","3","2",5.6,0,28,-1,3,20,-1,6,1,0,-2,4,5,5
"7958",2019-12-30,"Gothic Rd","w1920","Mechanized",2,"Mon","weekday","no_sled","East River","3","3","2",5.6,0,28,-1,3,20,-1,6,1,0,-2,4,5,5
"7959",2019-12-30,"Gothic Rd","w1920","Motorized",0,"Mon","weekday","sled","East River","3","3","2",5.6,0,28,-1,3,20,-1,6,1,0,-2,4,5,5
"7960",2019-12-30,"Gothic Rd","w1920","Hybrid",0,"Mon","weekday","sled","East River","3","3","2",5.6,0,28,-1,3,20,-1,6,1,0,-2,4,5,5
"7961",2019-12-31,"Gothic Rd","w1920","Non.motorized",39,"Tue","weekday","no_sled","East River","2","2","1",5.6,0,28,0,13,20,-1,-1,6,1,-1,-2,4,5
"7962",2019-12-31,"Gothic Rd","w1920","Mechanized",5,"Tue","weekday","no_sled","East River","2","2","1",5.6,0,28,0,13,20,-1,-1,6,1,-1,-2,4,5
"7963",2019-12-31,"Gothic Rd","w1920","Motorized",1,"Tue","weekday","sled","East River","2","2","1",5.6,0,28,0,13,20,-1,-1,6,1,-1,-2,4,5
"7964",2019-12-31,"Gothic Rd","w1920","Hybrid",0,"Tue","weekday","sled","East River","2","2","1",5.6,0,28,0,13,20,-1,-1,6,1,-1,-2,4,5
"7965",2020-01-01,"Gothic Rd","w1920","Non.motorized",49,"Wed","weekday","no_sled","East River","2","1","1",5.6,0,27,-1,21,20.7,0,-1,-1,6,-1,-2,-3,3
"7966",2020-01-01,"Gothic Rd","w1920","Mechanized",1,"Wed","weekday","no_sled","East River","2","1","1",5.6,0,27,-1,21,20.7,0,-1,-1,6,-1,-2,-3,3
"7967",2020-01-01,"Gothic Rd","w1920","Motorized",1,"Wed","weekday","sled","East River","2","1","1",5.6,0,27,-1,21,20.7,0,-1,-1,6,-1,-2,-3,3
"7968",2020-01-01,"Gothic Rd","w1920","Hybrid",0,"Wed","weekday","sled","East River","2","1","1",5.6,0,27,-1,21,20.7,0,-1,-1,6,-1,-2,-3,3
"7969",2020-01-02,"Gothic Rd","w1920","Non.motorized",33,"Thu","weekday","no_sled","East River","3","3","2",5.9,0.3,29,2,16,20.3,-1,0,-1,-1,1,1,0,-1
"7970",2020-01-02,"Gothic Rd","w1920","Mechanized",1,"Thu","weekday","no_sled","East River","3","3","2",5.9,0.3,29,2,16,20.3,-1,0,-1,-1,1,1,0,-1
"7971",2020-01-02,"Gothic Rd","w1920","Motorized",3,"Thu","weekday","sled","East River","3","3","2",5.9,0.3,29,2,16,20.3,-1,0,-1,-1,1,1,0,-1
"7972",2020-01-02,"Gothic Rd","w1920","Hybrid",0,"Thu","weekday","sled","East River","3","3","2",5.9,0.3,29,2,16,20.3,-1,0,-1,-1,1,1,0,-1
"7973",2020-01-03,"Gothic Rd","w1920","Non.motorized",36,"Fri","weekday","no_sled","East River","3","2","1",5.9,0,31,2,19,19,2,-1,0,-1,4,3,3,2
"7974",2020-01-03,"Gothic Rd","w1920","Mechanized",5,"Fri","weekday","no_sled","East River","3","2","1",5.9,0,31,2,19,19,2,-1,0,-1,4,3,3,2
"7975",2020-01-03,"Gothic Rd","w1920","Motorized",0,"Fri","weekday","sled","East River","3","2","1",5.9,0,31,2,19,19,2,-1,0,-1,4,3,3,2
"7976",2020-01-03,"Gothic Rd","w1920","Hybrid",0,"Fri","weekday","sled","East River","3","2","1",5.9,0,31,2,19,19,2,-1,0,-1,4,3,3,2
"7977",2020-01-04,"Gothic Rd","w1920","Non.motorized",34,"Sat","weekend","no_sled","East River","2","2","1",5.9,0,30,-1,26,19.7,2,2,-1,0,1,3,2,2
"7978",2020-01-04,"Gothic Rd","w1920","Mechanized",7,"Sat","weekend","no_sled","East River","2","2","1",5.9,0,30,-1,26,19.7,2,2,-1,0,1,3,2,2
"7979",2020-01-04,"Gothic Rd","w1920","Motorized",1,"Sat","weekend","sled","East River","2","2","1",5.9,0,30,-1,26,19.7,2,2,-1,0,1,3,2,2
"7980",2020-01-04,"Gothic Rd","w1920","Hybrid",0,"Sat","weekend","sled","East River","2","2","1",5.9,0,30,-1,26,19.7,2,2,-1,0,1,3,2,2
"7981",2020-01-05,"Gothic Rd","w1920","Non.motorized",18,"Sun","weekend","no_sled","East River","2","2","1",5.9,0,28,-2,23,21.1,-1,2,2,-1,-3,-1,1,0
"7982",2020-01-05,"Gothic Rd","w1920","Mechanized",3,"Sun","weekend","no_sled","East River","2","2","1",5.9,0,28,-2,23,21.1,-1,2,2,-1,-3,-1,1,0
"7983",2020-01-05,"Gothic Rd","w1920","Motorized",0,"Sun","weekend","sled","East River","2","2","1",5.9,0,28,-2,23,21.1,-1,2,2,-1,-3,-1,1,0
"7984",2020-01-05,"Gothic Rd","w1920","Hybrid",0,"Sun","weekend","sled","East River","2","2","1",5.9,0,28,-2,23,21.1,-1,2,2,-1,-3,-1,1,0
"7985",2020-01-06,"Gothic Rd","w1920","Non.motorized",22,"Mon","weekday","no_sled","East River","2","2","1",5.9,0,28,0,15,21.1,-2,-1,2,2,-2,-3,-1,1
"7986",2020-01-06,"Gothic Rd","w1920","Mechanized",1,"Mon","weekday","no_sled","East River","2","2","1",5.9,0,28,0,15,21.1,-2,-1,2,2,-2,-3,-1,1
"7987",2020-01-06,"Gothic Rd","w1920","Motorized",2,"Mon","weekday","sled","East River","2","2","1",5.9,0,28,0,15,21.1,-2,-1,2,2,-2,-3,-1,1
"7988",2020-01-06,"Gothic Rd","w1920","Hybrid",0,"Mon","weekday","sled","East River","2","2","1",5.9,0,28,0,15,21.1,-2,-1,2,2,-2,-3,-1,1
"7989",2020-01-07,"Gothic Rd","w1920","Non.motorized",16,"Tue","weekday","no_sled","East River","2","1","1",5.9,0,28,0,22,21.1,0,-2,-1,2,0,-2,-3,-1
"7990",2020-01-07,"Gothic Rd","w1920","Mechanized",4,"Tue","weekday","no_sled","East River","2","1","1",5.9,0,28,0,22,21.1,0,-2,-1,2,0,-2,-3,-1
"7991",2020-01-07,"Gothic Rd","w1920","Motorized",0,"Tue","weekday","sled","East River","2","1","1",5.9,0,28,0,22,21.1,0,-2,-1,2,0,-2,-3,-1
"7992",2020-01-07,"Gothic Rd","w1920","Hybrid",0,"Tue","weekday","sled","East River","2","1","1",5.9,0,28,0,22,21.1,0,-2,-1,2,0,-2,-3,-1
"7993",2020-01-08,"Gothic Rd","w1920","Non.motorized",21,"Wed","weekday","no_sled","East River","2","1","1",6,0.1,28,0,23,21.4,0,0,-2,-1,0,0,-2,-3
"7994",2020-01-08,"Gothic Rd","w1920","Mechanized",0,"Wed","weekday","no_sled","East River","2","1","1",6,0.1,28,0,23,21.4,0,0,-2,-1,0,0,-2,-3
"7995",2020-01-08,"Gothic Rd","w1920","Motorized",0,"Wed","weekday","sled","East River","2","1","1",6,0.1,28,0,23,21.4,0,0,-2,-1,0,0,-2,-3
"7996",2020-01-08,"Gothic Rd","w1920","Hybrid",0,"Wed","weekday","sled","East River","2","1","1",6,0.1,28,0,23,21.4,0,0,-2,-1,0,0,-2,-3
"7997",2020-01-09,"Gothic Rd","w1920","Non.motorized",19,"Thu","weekday","no_sled","East River","2","1","1",6,0,27,-1,17,22.2,0,0,0,-2,-1,-1,-1,-3
"7998",2020-01-09,"Gothic Rd","w1920","Mechanized",0,"Thu","weekday","no_sled","East River","2","1","1",6,0,27,-1,17,22.2,0,0,0,-2,-1,-1,-1,-3
"7999",2020-01-09,"Gothic Rd","w1920","Motorized",1,"Thu","weekday","sled","East River","2","1","1",6,0,27,-1,17,22.2,0,0,0,-2,-1,-1,-1,-3
"8000",2020-01-09,"Gothic Rd","w1920","Hybrid",0,"Thu","weekday","sled","East River","2","1","1",6,0,27,-1,17,22.2,0,0,0,-2,-1,-1,-1,-3
"8001",2020-01-10,"Gothic Rd","w1920","Non.motorized",36,"Fri","weekday","no_sled","East River","2","1","1",6,0,29,2,11,20.7,-1,0,0,0,1,1,1,1
"8002",2020-01-10,"Gothic Rd","w1920","Mechanized",2,"Fri","weekday","no_sled","East River","2","1","1",6,0,29,2,11,20.7,-1,0,0,0,1,1,1,1
"8003",2020-01-10,"Gothic Rd","w1920","Motorized",3,"Fri","weekday","sled","East River","2","1","1",6,0,29,2,11,20.7,-1,0,0,0,1,1,1,1
"8004",2020-01-10,"Gothic Rd","w1920","Hybrid",0,"Fri","weekday","sled","East River","2","1","1",6,0,29,2,11,20.7,-1,0,0,0,1,1,1,1
"8005",2020-01-11,"Gothic Rd","w1920","Non.motorized",22,"Sat","weekend","no_sled","East River","2","1","1",6,0,29,0,12,20.7,2,-1,0,0,2,1,1,1
"8006",2020-01-11,"Gothic Rd","w1920","Mechanized",1,"Sat","weekend","no_sled","East River","2","1","1",6,0,29,0,12,20.7,2,-1,0,0,2,1,1,1
"8007",2020-01-11,"Gothic Rd","w1920","Motorized",1,"Sat","weekend","sled","East River","2","1","1",6,0,29,0,12,20.7,2,-1,0,0,2,1,1,1
"8008",2020-01-11,"Gothic Rd","w1920","Hybrid",0,"Sat","weekend","sled","East River","2","1","1",6,0,29,0,12,20.7,2,-1,0,0,2,1,1,1
"8009",2020-01-12,"Gothic Rd","w1920","Non.motorized",26,"Sun","weekend","no_sled","East River","2","1","1",6.1,0.1,29,0,13,21,0,2,-1,0,0,2,1,1
"8010",2020-01-12,"Gothic Rd","w1920","Mechanized",0,"Sun","weekend","no_sled","East River","2","1","1",6.1,0.1,29,0,13,21,0,2,-1,0,0,2,1,1
"8011",2020-01-12,"Gothic Rd","w1920","Motorized",0,"Sun","weekend","sled","East River","2","1","1",6.1,0.1,29,0,13,21,0,2,-1,0,0,2,1,1
"8012",2020-01-12,"Gothic Rd","w1920","Hybrid",0,"Sun","weekend","sled","East River","2","1","1",6.1,0.1,29,0,13,21,0,2,-1,0,0,2,1,1
"8013",2020-01-13,"Gothic Rd","w1920","Non.motorized",4,"Mon","weekday","no_sled","East River","2","2","1",6.2,0.1,29,0,16,21.4,0,0,2,-1,0,0,2,1
"8014",2020-01-13,"Gothic Rd","w1920","Mechanized",0,"Mon","weekday","no_sled","East River","2","2","1",6.2,0.1,29,0,16,21.4,0,0,2,-1,0,0,2,1
"8015",2020-01-13,"Gothic Rd","w1920","Motorized",0,"Mon","weekday","sled","East River","2","2","1",6.2,0.1,29,0,16,21.4,0,0,2,-1,0,0,2,1
"8016",2020-01-13,"Gothic Rd","w1920","Hybrid",0,"Mon","weekday","sled","East River","2","2","1",6.2,0.1,29,0,16,21.4,0,0,2,-1,0,0,2,1
"8017",2020-01-14,"Gothic Rd","w1920","Non.motorized",9,"Tue","weekday","no_sled","East River","3","2","1",6.6,0.4,34,5,23,19.4,0,0,0,2,5,5,5,7
"8018",2020-01-14,"Gothic Rd","w1920","Mechanized",0,"Tue","weekday","no_sled","East River","3","2","1",6.6,0.4,34,5,23,19.4,0,0,0,2,5,5,5,7
"8019",2020-01-14,"Gothic Rd","w1920","Motorized",0,"Tue","weekday","sled","East River","3","2","1",6.6,0.4,34,5,23,19.4,0,0,0,2,5,5,5,7
"8020",2020-01-14,"Gothic Rd","w1920","Hybrid",0,"Tue","weekday","sled","East River","3","2","1",6.6,0.4,34,5,23,19.4,0,0,0,2,5,5,5,7
"8021",2020-01-15,"Gothic Rd","w1920","Non.motorized",21,"Wed","weekday","no_sled","East River","3","2","1",6.7,0.1,32,-2,23,20.9,5,0,0,0,3,3,3,3
"8022",2020-01-15,"Gothic Rd","w1920","Mechanized",1,"Wed","weekday","no_sled","East River","3","2","1",6.7,0.1,32,-2,23,20.9,5,0,0,0,3,3,3,3
"8023",2020-01-15,"Gothic Rd","w1920","Motorized",2,"Wed","weekday","sled","East River","3","2","1",6.7,0.1,32,-2,23,20.9,5,0,0,0,3,3,3,3
"8024",2020-01-15,"Gothic Rd","w1920","Hybrid",0,"Wed","weekday","sled","East River","3","2","1",6.7,0.1,32,-2,23,20.9,5,0,0,0,3,3,3,3
"8025",2020-01-16,"Gothic Rd","w1920","Non.motorized",17,"Thu","weekday","no_sled","East River","2","2","1",6.7,0,31,-1,28,21.6,-2,5,0,0,-3,2,2,2
"8026",2020-01-16,"Gothic Rd","w1920","Mechanized",0,"Thu","weekday","no_sled","East River","2","2","1",6.7,0,31,-1,28,21.6,-2,5,0,0,-3,2,2,2
"8027",2020-01-16,"Gothic Rd","w1920","Motorized",0,"Thu","weekday","sled","East River","2","2","1",6.7,0,31,-1,28,21.6,-2,5,0,0,-3,2,2,2
"8028",2020-01-16,"Gothic Rd","w1920","Hybrid",0,"Thu","weekday","sled","East River","2","2","1",6.7,0,31,-1,28,21.6,-2,5,0,0,-3,2,2,2
"8029",2020-01-17,"Gothic Rd","w1920","Non.motorized",5,"Fri","weekday","no_sled","East River","2","2","1",6.8,0.1,29,-2,19,23.4,-1,-2,5,0,-3,-5,0,0
"8030",2020-01-17,"Gothic Rd","w1920","Mechanized",0,"Fri","weekday","no_sled","East River","2","2","1",6.8,0.1,29,-2,19,23.4,-1,-2,5,0,-3,-5,0,0
"8031",2020-01-17,"Gothic Rd","w1920","Motorized",0,"Fri","weekday","sled","East River","2","2","1",6.8,0.1,29,-2,19,23.4,-1,-2,5,0,-3,-5,0,0
"8032",2020-01-17,"Gothic Rd","w1920","Hybrid",0,"Fri","weekday","sled","East River","2","2","1",6.8,0.1,29,-2,19,23.4,-1,-2,5,0,-3,-5,0,0
"8033",2020-01-18,"Gothic Rd","w1920","Non.motorized",20,"Sat","weekend","no_sled","East River","2","2","2",7,0.2,34,5,16,20.6,-2,-1,-2,5,3,2,0,5
"8034",2020-01-18,"Gothic Rd","w1920","Mechanized",0,"Sat","weekend","no_sled","East River","2","2","2",7,0.2,34,5,16,20.6,-2,-1,-2,5,3,2,0,5
"8035",2020-01-18,"Gothic Rd","w1920","Motorized",0,"Sat","weekend","sled","East River","2","2","2",7,0.2,34,5,16,20.6,-2,-1,-2,5,3,2,0,5
"8036",2020-01-18,"Gothic Rd","w1920","Hybrid",0,"Sat","weekend","sled","East River","2","2","2",7,0.2,34,5,16,20.6,-2,-1,-2,5,3,2,0,5
"8037",2020-01-19,"Gothic Rd","w1920","Non.motorized",21,"Sun","weekend","no_sled","East River","2","2","1",7,0,33,-1,21,21.2,5,-2,-1,-2,4,2,1,-1
"8038",2020-01-19,"Gothic Rd","w1920","Mechanized",1,"Sun","weekend","no_sled","East River","2","2","1",7,0,33,-1,21,21.2,5,-2,-1,-2,4,2,1,-1
"8039",2020-01-19,"Gothic Rd","w1920","Motorized",1,"Sun","weekend","sled","East River","2","2","1",7,0,33,-1,21,21.2,5,-2,-1,-2,4,2,1,-1
"8040",2020-01-19,"Gothic Rd","w1920","Hybrid",0,"Sun","weekend","sled","East River","2","2","1",7,0,33,-1,21,21.2,5,-2,-1,-2,4,2,1,-1
"8041",2020-01-20,"Gothic Rd","w1920","Non.motorized",9,"Mon","weekday","no_sled","East River","2","2","1",7.1,0.1,32,-1,25,22.2,-1,5,-2,-1,-2,3,1,0
"8042",2020-01-20,"Gothic Rd","w1920","Mechanized",1,"Mon","weekday","no_sled","East River","2","2","1",7.1,0.1,32,-1,25,22.2,-1,5,-2,-1,-2,3,1,0
"8043",2020-01-20,"Gothic Rd","w1920","Motorized",0,"Mon","weekday","sled","East River","2","2","1",7.1,0.1,32,-1,25,22.2,-1,5,-2,-1,-2,3,1,0
"8044",2020-01-20,"Gothic Rd","w1920","Hybrid",0,"Mon","weekday","sled","East River","2","2","1",7.1,0.1,32,-1,25,22.2,-1,5,-2,-1,-2,3,1,0
"8045",2020-01-21,"Gothic Rd","w1920","Non.motorized",4,"Tue","weekday","no_sled","East River","2","2","1",7.1,0,31,-1,28,22.9,-1,-1,5,-2,-2,-3,2,0
"8046",2020-01-21,"Gothic Rd","w1920","Mechanized",0,"Tue","weekday","no_sled","East River","2","2","1",7.1,0,31,-1,28,22.9,-1,-1,5,-2,-2,-3,2,0
"8047",2020-01-21,"Gothic Rd","w1920","Motorized",0,"Tue","weekday","sled","East River","2","2","1",7.1,0,31,-1,28,22.9,-1,-1,5,-2,-2,-3,2,0
"8048",2020-01-21,"Gothic Rd","w1920","Hybrid",0,"Tue","weekday","sled","East River","2","2","1",7.1,0,31,-1,28,22.9,-1,-1,5,-2,-2,-3,2,0
"8049",2020-01-22,"Gothic Rd","w1920","Non.motorized",10,"Wed","weekday","no_sled","East River","2","2","2",7.3,0.2,32,1,25,22.8,-1,-1,-1,5,0,-1,-2,3
"8050",2020-01-22,"Gothic Rd","w1920","Mechanized",0,"Wed","weekday","no_sled","East River","2","2","2",7.3,0.2,32,1,25,22.8,-1,-1,-1,5,0,-1,-2,3
"8051",2020-01-22,"Gothic Rd","w1920","Motorized",1,"Wed","weekday","sled","East River","2","2","2",7.3,0.2,32,1,25,22.8,-1,-1,-1,5,0,-1,-2,3
"8052",2020-01-22,"Gothic Rd","w1920","Hybrid",0,"Wed","weekday","sled","East River","2","2","2",7.3,0.2,32,1,25,22.8,-1,-1,-1,5,0,-1,-2,3
"8053",2020-01-23,"Gothic Rd","w1920","Non.motorized",5,"Thu","weekday","no_sled","East River","3","2","2",7.3,0,34,2,23,21.5,1,-1,-1,-1,3,2,1,0
"8054",2020-01-23,"Gothic Rd","w1920","Mechanized",1,"Thu","weekday","no_sled","East River","3","2","2",7.3,0,34,2,23,21.5,1,-1,-1,-1,3,2,1,0
"8055",2020-01-23,"Gothic Rd","w1920","Motorized",2,"Thu","weekday","sled","East River","3","2","2",7.3,0,34,2,23,21.5,1,-1,-1,-1,3,2,1,0
"8056",2020-01-23,"Gothic Rd","w1920","Hybrid",0,"Thu","weekday","sled","East River","3","2","2",7.3,0,34,2,23,21.5,1,-1,-1,-1,3,2,1,0
"8057",2020-01-24,"Gothic Rd","w1920","Non.motorized",26,"Fri","weekday","no_sled","East River","2","2","1",7.3,0,33,-1,23,22.1,2,1,-1,-1,1,2,1,0
"8058",2020-01-24,"Gothic Rd","w1920","Mechanized",2,"Fri","weekday","no_sled","East River","2","2","1",7.3,0,33,-1,23,22.1,2,1,-1,-1,1,2,1,0
"8059",2020-01-24,"Gothic Rd","w1920","Motorized",0,"Fri","weekday","sled","East River","2","2","1",7.3,0,33,-1,23,22.1,2,1,-1,-1,1,2,1,0
"8060",2020-01-24,"Gothic Rd","w1920","Hybrid",0,"Fri","weekday","sled","East River","2","2","1",7.3,0,33,-1,23,22.1,2,1,-1,-1,1,2,1,0
"8061",2020-01-25,"Gothic Rd","w1920","Non.motorized",23,"Sat","weekend","no_sled","East River","2","2","1",7.4,0.1,32,-1,25,23.1,-1,2,1,-1,-2,0,1,0
"8062",2020-01-25,"Gothic Rd","w1920","Mechanized",1,"Sat","weekend","no_sled","East River","2","2","1",7.4,0.1,32,-1,25,23.1,-1,2,1,-1,-2,0,1,0
"8063",2020-01-25,"Gothic Rd","w1920","Motorized",0,"Sat","weekend","sled","East River","2","2","1",7.4,0.1,32,-1,25,23.1,-1,2,1,-1,-2,0,1,0
"8064",2020-01-25,"Gothic Rd","w1920","Hybrid",0,"Sat","weekend","sled","East River","2","2","1",7.4,0.1,32,-1,25,23.1,-1,2,1,-1,-2,0,1,0
"8065",2020-01-26,"Gothic Rd","w1920","Non.motorized",20,"Sun","weekend","no_sled","East River","2","1","1",7.4,0,32,0,28,23.1,-1,-1,2,1,-1,-2,0,1
"8066",2020-01-26,"Gothic Rd","w1920","Mechanized",1,"Sun","weekend","no_sled","East River","2","1","1",7.4,0,32,0,28,23.1,-1,-1,2,1,-1,-2,0,1
"8067",2020-01-26,"Gothic Rd","w1920","Motorized",0,"Sun","weekend","sled","East River","2","1","1",7.4,0,32,0,28,23.1,-1,-1,2,1,-1,-2,0,1
"8068",2020-01-26,"Gothic Rd","w1920","Hybrid",0,"Sun","weekend","sled","East River","2","1","1",7.4,0,32,0,28,23.1,-1,-1,2,1,-1,-2,0,1
"8069",2020-01-27,"Gothic Rd","w1920","Non.motorized",14,"Mon","weekday","no_sled","East River","2","1","1",7.4,0,32,0,24,23.1,0,-1,-1,2,0,-1,-2,0
"8070",2020-01-27,"Gothic Rd","w1920","Mechanized",0,"Mon","weekday","no_sled","East River","2","1","1",7.4,0,32,0,24,23.1,0,-1,-1,2,0,-1,-2,0
"8071",2020-01-27,"Gothic Rd","w1920","Motorized",2,"Mon","weekday","sled","East River","2","1","1",7.4,0,32,0,24,23.1,0,-1,-1,2,0,-1,-2,0
"8072",2020-01-27,"Gothic Rd","w1920","Hybrid",0,"Mon","weekday","sled","East River","2","1","1",7.4,0,32,0,24,23.1,0,-1,-1,2,0,-1,-2,0
"8073",2020-01-28,"Gothic Rd","w1920","Non.motorized",16,"Tue","weekday","no_sled","East River","3","2","2",7.4,0,32,0,19,23.1,0,0,-1,-1,0,0,-1,-2
"8074",2020-01-28,"Gothic Rd","w1920","Mechanized",1,"Tue","weekday","no_sled","East River","3","2","2",7.4,0,32,0,19,23.1,0,0,-1,-1,0,0,-1,-2
"8075",2020-01-28,"Gothic Rd","w1920","Motorized",0,"Tue","weekday","sled","East River","3","2","2",7.4,0,32,0,19,23.1,0,0,-1,-1,0,0,-1,-2
"8076",2020-01-28,"Gothic Rd","w1920","Hybrid",0,"Tue","weekday","sled","East River","3","2","2",7.4,0,32,0,19,23.1,0,0,-1,-1,0,0,-1,-2
"8077",2020-01-29,"Gothic Rd","w1920","Non.motorized",4,"Wed","weekday","no_sled","East River","2","2","1",7.4,0,31,-1,20,23.9,0,0,0,-1,-1,-1,-1,-2
"8078",2020-01-29,"Gothic Rd","w1920","Mechanized",0,"Wed","weekday","no_sled","East River","2","2","1",7.4,0,31,-1,20,23.9,0,0,0,-1,-1,-1,-1,-2
"8079",2020-01-29,"Gothic Rd","w1920","Motorized",0,"Wed","weekday","sled","East River","2","2","1",7.4,0,31,-1,20,23.9,0,0,0,-1,-1,-1,-1,-2
"8080",2020-01-29,"Gothic Rd","w1920","Hybrid",0,"Wed","weekday","sled","East River","2","2","1",7.4,0,31,-1,20,23.9,0,0,0,-1,-1,-1,-1,-2
"8081",2020-01-30,"Gothic Rd","w1920","Non.motorized",11,"Thu","weekday","no_sled","East River","2","2","1",7.4,0,31,0,17,23.9,-1,0,0,0,-1,-1,-1,-1
"8082",2020-01-30,"Gothic Rd","w1920","Mechanized",1,"Thu","weekday","no_sled","East River","2","2","1",7.4,0,31,0,17,23.9,-1,0,0,0,-1,-1,-1,-1
"8083",2020-01-30,"Gothic Rd","w1920","Motorized",0,"Thu","weekday","sled","East River","2","2","1",7.4,0,31,0,17,23.9,-1,0,0,0,-1,-1,-1,-1
"8084",2020-01-30,"Gothic Rd","w1920","Hybrid",0,"Thu","weekday","sled","East River","2","2","1",7.4,0,31,0,17,23.9,-1,0,0,0,-1,-1,-1,-1
"8085",2020-01-31,"Gothic Rd","w1920","Non.motorized",27,"Fri","weekday","no_sled","East River","2","1","1",7.4,0,31,0,20,23.9,0,-1,0,0,0,-1,-1,-1
"8086",2020-01-31,"Gothic Rd","w1920","Mechanized",2,"Fri","weekday","no_sled","East River","2","1","1",7.4,0,31,0,20,23.9,0,-1,0,0,0,-1,-1,-1
"8087",2020-01-31,"Gothic Rd","w1920","Motorized",0,"Fri","weekday","sled","East River","2","1","1",7.4,0,31,0,20,23.9,0,-1,0,0,0,-1,-1,-1
"8088",2020-01-31,"Gothic Rd","w1920","Hybrid",0,"Fri","weekday","sled","East River","2","1","1",7.4,0,31,0,20,23.9,0,-1,0,0,0,-1,-1,-1
"8089",2020-02-01,"Gothic Rd","w1920","Non.motorized",15,"Sat","weekend","no_sled","East River","2","1","1",7.4,0,31,0,28,23.9,0,0,-1,0,0,0,-1,-1
"8090",2020-02-01,"Gothic Rd","w1920","Mechanized",5,"Sat","weekend","no_sled","East River","2","1","1",7.4,0,31,0,28,23.9,0,0,-1,0,0,0,-1,-1
"8091",2020-02-01,"Gothic Rd","w1920","Motorized",0,"Sat","weekend","sled","East River","2","1","1",7.4,0,31,0,28,23.9,0,0,-1,0,0,0,-1,-1
"8092",2020-02-01,"Gothic Rd","w1920","Hybrid",0,"Sat","weekend","sled","East River","2","1","1",7.4,0,31,0,28,23.9,0,0,-1,0,0,0,-1,-1
"8093",2020-02-02,"Gothic Rd","w1920","Non.motorized",27,"Sun","weekend","no_sled","East River","1","1","1",7.4,0,31,0,33,23.9,0,0,0,-1,0,0,0,-1
"8094",2020-02-02,"Gothic Rd","w1920","Mechanized",4,"Sun","weekend","no_sled","East River","1","1","1",7.4,0,31,0,33,23.9,0,0,0,-1,0,0,0,-1
"8095",2020-02-02,"Gothic Rd","w1920","Motorized",0,"Sun","weekend","sled","East River","1","1","1",7.4,0,31,0,33,23.9,0,0,0,-1,0,0,0,-1
"8096",2020-02-02,"Gothic Rd","w1920","Hybrid",0,"Sun","weekend","sled","East River","1","1","1",7.4,0,31,0,33,23.9,0,0,0,-1,0,0,0,-1
"8097",2020-02-03,"Gothic Rd","w1920","Non.motorized",8,"Mon","weekday","no_sled","East River","2","2","1",7.4,0,31,0,24,23.9,0,0,0,0,0,0,0,0
"8098",2020-02-03,"Gothic Rd","w1920","Mechanized",0,"Mon","weekday","no_sled","East River","2","2","1",7.4,0,31,0,24,23.9,0,0,0,0,0,0,0,0
"8099",2020-02-03,"Gothic Rd","w1920","Motorized",0,"Mon","weekday","sled","East River","2","2","1",7.4,0,31,0,24,23.9,0,0,0,0,0,0,0,0
"8100",2020-02-03,"Gothic Rd","w1920","Hybrid",0,"Mon","weekday","sled","East River","2","2","1",7.4,0,31,0,24,23.9,0,0,0,0,0,0,0,0
"8101",2020-02-04,"Gothic Rd","w1920","Non.motorized",21,"Tue","weekday","no_sled","East River","2","2","2",7.4,0,33,2,5,22.4,0,0,0,0,2,2,2,2
"8102",2020-02-04,"Gothic Rd","w1920","Mechanized",3,"Tue","weekday","no_sled","East River","2","2","2",7.4,0,33,2,5,22.4,0,0,0,0,2,2,2,2
"8103",2020-02-04,"Gothic Rd","w1920","Motorized",1,"Tue","weekday","sled","East River","2","2","2",7.4,0,33,2,5,22.4,0,0,0,0,2,2,2,2
"8104",2020-02-04,"Gothic Rd","w1920","Hybrid",0,"Tue","weekday","sled","East River","2","2","2",7.4,0,33,2,5,22.4,0,0,0,0,2,2,2,2
"8105",2020-02-05,"Gothic Rd","w1920","Non.motorized",10,"Wed","weekday","no_sled","East River","2","2","1",7.4,0,33,0,2,22.4,2,0,0,0,2,2,2,2
"8106",2020-02-05,"Gothic Rd","w1920","Mechanized",0,"Wed","weekday","no_sled","East River","2","2","1",7.4,0,33,0,2,22.4,2,0,0,0,2,2,2,2
"8107",2020-02-05,"Gothic Rd","w1920","Motorized",0,"Wed","weekday","sled","East River","2","2","1",7.4,0,33,0,2,22.4,2,0,0,0,2,2,2,2
"8108",2020-02-05,"Gothic Rd","w1920","Hybrid",0,"Wed","weekday","sled","East River","2","2","1",7.4,0,33,0,2,22.4,2,0,0,0,2,2,2,2
"8109",2020-02-06,"Gothic Rd","w1920","Non.motorized",9,"Thu","weekday","no_sled","East River","2","2","1",7.5,0.1,32,-1,16,23.4,0,2,0,0,-1,1,1,1
"8110",2020-02-06,"Gothic Rd","w1920","Mechanized",0,"Thu","weekday","no_sled","East River","2","2","1",7.5,0.1,32,-1,16,23.4,0,2,0,0,-1,1,1,1
"8111",2020-02-06,"Gothic Rd","w1920","Motorized",1,"Thu","weekday","sled","East River","2","2","1",7.5,0.1,32,-1,16,23.4,0,2,0,0,-1,1,1,1
"8112",2020-02-06,"Gothic Rd","w1920","Hybrid",0,"Thu","weekday","sled","East River","2","2","1",7.5,0.1,32,-1,16,23.4,0,2,0,0,-1,1,1,1
"8113",2020-02-07,"Gothic Rd","w1920","Non.motorized",6,"Fri","weekday","no_sled","East River","3","3","3",7.9,0.4,37,5,26,21.4,-1,0,2,0,4,4,6,6
"8114",2020-02-07,"Gothic Rd","w1920","Mechanized",0,"Fri","weekday","no_sled","East River","3","3","3",7.9,0.4,37,5,26,21.4,-1,0,2,0,4,4,6,6
"8115",2020-02-07,"Gothic Rd","w1920","Motorized",3,"Fri","weekday","sled","East River","3","3","3",7.9,0.4,37,5,26,21.4,-1,0,2,0,4,4,6,6
"8116",2020-02-07,"Gothic Rd","w1920","Hybrid",0,"Fri","weekday","sled","East River","3","3","3",7.9,0.4,37,5,26,21.4,-1,0,2,0,4,4,6,6
"8117",2020-02-08,"Gothic Rd","w1920","Non.motorized",20,"Sat","weekend","no_sled","East River","3","3","2",8.3,0.4,39,2,30,21.3,5,-1,0,2,7,6,6,8
"8118",2020-02-08,"Gothic Rd","w1920","Mechanized",2,"Sat","weekend","no_sled","East River","3","3","2",8.3,0.4,39,2,30,21.3,5,-1,0,2,7,6,6,8
"8119",2020-02-08,"Gothic Rd","w1920","Motorized",3,"Sat","weekend","sled","East River","3","3","2",8.3,0.4,39,2,30,21.3,5,-1,0,2,7,6,6,8
"8120",2020-02-08,"Gothic Rd","w1920","Hybrid",0,"Sat","weekend","sled","East River","3","3","2",8.3,0.4,39,2,30,21.3,5,-1,0,2,7,6,6,8
"8121",2020-02-09,"Gothic Rd","w1920","Non.motorized",7,"Sun","weekend","no_sled","East River","3","2","2",8.4,0.1,38,-1,26,22.1,2,5,-1,0,1,6,5,5
"8122",2020-02-09,"Gothic Rd","w1920","Mechanized",1,"Sun","weekend","no_sled","East River","3","2","2",8.4,0.1,38,-1,26,22.1,2,5,-1,0,1,6,5,5
"8123",2020-02-09,"Gothic Rd","w1920","Motorized",3,"Sun","weekend","sled","East River","3","2","2",8.4,0.1,38,-1,26,22.1,2,5,-1,0,1,6,5,5
"8124",2020-02-09,"Gothic Rd","w1920","Hybrid",0,"Sun","weekend","sled","East River","3","2","2",8.4,0.1,38,-1,26,22.1,2,5,-1,0,1,6,5,5
"8125",2020-02-10,"Gothic Rd","w1920","Non.motorized",19,"Mon","weekday","no_sled","East River","2","2","1",8.4,0,38,0,22,22.1,-1,2,5,-1,-1,1,6,5
"8126",2020-02-10,"Gothic Rd","w1920","Mechanized",1,"Mon","weekday","no_sled","East River","2","2","1",8.4,0,38,0,22,22.1,-1,2,5,-1,-1,1,6,5
"8127",2020-02-10,"Gothic Rd","w1920","Motorized",1,"Mon","weekday","sled","East River","2","2","1",8.4,0,38,0,22,22.1,-1,2,5,-1,-1,1,6,5
"8128",2020-02-10,"Gothic Rd","w1920","Hybrid",0,"Mon","weekday","sled","East River","2","2","1",8.4,0,38,0,22,22.1,-1,2,5,-1,-1,1,6,5
"8129",2020-02-11,"Gothic Rd","w1920","Non.motorized",15,"Tue","weekday","no_sled","East River","2","2","2",8.5,0.1,40,2,16,21.2,0,-1,2,5,2,1,3,8
"8130",2020-02-11,"Gothic Rd","w1920","Mechanized",0,"Tue","weekday","no_sled","East River","2","2","2",8.5,0.1,40,2,16,21.2,0,-1,2,5,2,1,3,8
"8131",2020-02-11,"Gothic Rd","w1920","Motorized",2,"Tue","weekday","sled","East River","2","2","2",8.5,0.1,40,2,16,21.2,0,-1,2,5,2,1,3,8
"8132",2020-02-11,"Gothic Rd","w1920","Hybrid",0,"Tue","weekday","sled","East River","2","2","2",8.5,0.1,40,2,16,21.2,0,-1,2,5,2,1,3,8
"8133",2020-02-12,"Gothic Rd","w1920","Non.motorized",10,"Wed","weekday","no_sled","East River","2","2","2",8.5,0,39,-1,15,21.8,2,0,-1,2,1,1,0,2
"8134",2020-02-12,"Gothic Rd","w1920","Mechanized",1,"Wed","weekday","no_sled","East River","2","2","2",8.5,0,39,-1,15,21.8,2,0,-1,2,1,1,0,2
"8135",2020-02-12,"Gothic Rd","w1920","Motorized",1,"Wed","weekday","sled","East River","2","2","2",8.5,0,39,-1,15,21.8,2,0,-1,2,1,1,0,2
"8136",2020-02-12,"Gothic Rd","w1920","Hybrid",0,"Wed","weekday","sled","East River","2","2","2",8.5,0,39,-1,15,21.8,2,0,-1,2,1,1,0,2
"8137",2020-02-13,"Gothic Rd","w1920","Non.motorized",8,"Thu","weekday","no_sled","East River","2","2","1",8.5,0,39,0,18,21.8,-1,2,0,-1,-1,1,1,0
"8138",2020-02-13,"Gothic Rd","w1920","Mechanized",0,"Thu","weekday","no_sled","East River","2","2","1",8.5,0,39,0,18,21.8,-1,2,0,-1,-1,1,1,0
"8139",2020-02-13,"Gothic Rd","w1920","Motorized",0,"Thu","weekday","sled","East River","2","2","1",8.5,0,39,0,18,21.8,-1,2,0,-1,-1,1,1,0
"8140",2020-02-13,"Gothic Rd","w1920","Hybrid",0,"Thu","weekday","sled","East River","2","2","1",8.5,0,39,0,18,21.8,-1,2,0,-1,-1,1,1,0
"8141",2020-02-14,"Gothic Rd","w1920","Non.motorized",21,"Fri","weekday","no_sled","East River","2","1","1",8.6,0.1,38,-1,24,22.6,0,-1,2,0,-1,-2,0,0
"8142",2020-02-14,"Gothic Rd","w1920","Mechanized",2,"Fri","weekday","no_sled","East River","2","1","1",8.6,0.1,38,-1,24,22.6,0,-1,2,0,-1,-2,0,0
"8143",2020-02-14,"Gothic Rd","w1920","Motorized",0,"Fri","weekday","sled","East River","2","1","1",8.6,0.1,38,-1,24,22.6,0,-1,2,0,-1,-2,0,0
"8144",2020-02-14,"Gothic Rd","w1920","Hybrid",0,"Fri","weekday","sled","East River","2","1","1",8.6,0.1,38,-1,24,22.6,0,-1,2,0,-1,-2,0,0
"8145",2020-02-15,"Gothic Rd","w1920","Non.motorized",45,"Sat","weekend","no_sled","East River","1","1","1",8.6,0,38,0,26,22.6,-1,0,-1,2,-1,-1,-2,0
"8146",2020-02-15,"Gothic Rd","w1920","Mechanized",6,"Sat","weekend","no_sled","East River","1","1","1",8.6,0,38,0,26,22.6,-1,0,-1,2,-1,-1,-2,0
"8147",2020-02-15,"Gothic Rd","w1920","Motorized",0,"Sat","weekend","sled","East River","1","1","1",8.6,0,38,0,26,22.6,-1,0,-1,2,-1,-1,-2,0
"8148",2020-02-15,"Gothic Rd","w1920","Hybrid",0,"Sat","weekend","sled","East River","1","1","1",8.6,0,38,0,26,22.6,-1,0,-1,2,-1,-1,-2,0
"8149",2020-02-16,"Gothic Rd","w1920","Non.motorized",27,"Sun","weekend","no_sled","East River","1","1","1",8.8,0.2,37,-1,26,23.8,0,-1,0,-1,-1,-2,-2,-3
"8150",2020-02-16,"Gothic Rd","w1920","Mechanized",1,"Sun","weekend","no_sled","East River","1","1","1",8.8,0.2,37,-1,26,23.8,0,-1,0,-1,-1,-2,-2,-3
"8151",2020-02-16,"Gothic Rd","w1920","Motorized",0,"Sun","weekend","sled","East River","1","1","1",8.8,0.2,37,-1,26,23.8,0,-1,0,-1,-1,-2,-2,-3
"8152",2020-02-16,"Gothic Rd","w1920","Hybrid",0,"Sun","weekend","sled","East River","1","1","1",8.8,0.2,37,-1,26,23.8,0,-1,0,-1,-1,-2,-2,-3
"8153",2020-02-17,"Gothic Rd","w1920","Non.motorized",42,"Mon","weekday","no_sled","East River","2","1","1",9.2,0.4,43,6,25,21.4,-1,0,-1,0,5,5,4,4
"8154",2020-02-17,"Gothic Rd","w1920","Mechanized",1,"Mon","weekday","no_sled","East River","2","1","1",9.2,0.4,43,6,25,21.4,-1,0,-1,0,5,5,4,4
"8155",2020-02-17,"Gothic Rd","w1920","Motorized",2,"Mon","weekday","sled","East River","2","1","1",9.2,0.4,43,6,25,21.4,-1,0,-1,0,5,5,4,4
"8156",2020-02-17,"Gothic Rd","w1920","Hybrid",0,"Mon","weekday","sled","East River","2","1","1",9.2,0.4,43,6,25,21.4,-1,0,-1,0,5,5,4,4
"8157",2020-02-18,"Gothic Rd","w1920","Non.motorized",23,"Tue","weekday","no_sled","East River","1","1","1",9.3,0.1,42,-1,18,22.1,6,-1,0,-1,5,4,4,3
"8158",2020-02-18,"Gothic Rd","w1920","Mechanized",0,"Tue","weekday","no_sled","East River","1","1","1",9.3,0.1,42,-1,18,22.1,6,-1,0,-1,5,4,4,3
"8159",2020-02-18,"Gothic Rd","w1920","Motorized",0,"Tue","weekday","sled","East River","1","1","1",9.3,0.1,42,-1,18,22.1,6,-1,0,-1,5,4,4,3
"8160",2020-02-18,"Gothic Rd","w1920","Hybrid",0,"Tue","weekday","sled","East River","1","1","1",9.3,0.1,42,-1,18,22.1,6,-1,0,-1,5,4,4,3
"8161",2020-02-19,"Gothic Rd","w1920","Non.motorized",31,"Wed","weekday","no_sled","East River","1","1","1",9.3,0,41,-1,22,22.7,-1,6,-1,0,-2,4,3,3
"8162",2020-02-19,"Gothic Rd","w1920","Mechanized",2,"Wed","weekday","no_sled","East River","1","1","1",9.3,0,41,-1,22,22.7,-1,6,-1,0,-2,4,3,3
"8163",2020-02-19,"Gothic Rd","w1920","Motorized",0,"Wed","weekday","sled","East River","1","1","1",9.3,0,41,-1,22,22.7,-1,6,-1,0,-2,4,3,3
"8164",2020-02-19,"Gothic Rd","w1920","Hybrid",0,"Wed","weekday","sled","East River","1","1","1",9.3,0,41,-1,22,22.7,-1,6,-1,0,-2,4,3,3
"8165",2020-02-20,"Gothic Rd","w1920","Non.motorized",16,"Thu","weekday","no_sled","East River","1","1","1",9.3,0,41,0,18,22.7,-1,-1,6,-1,-1,-2,4,3
"8166",2020-02-20,"Gothic Rd","w1920","Mechanized",0,"Thu","weekday","no_sled","East River","1","1","1",9.3,0,41,0,18,22.7,-1,-1,6,-1,-1,-2,4,3
"8167",2020-02-20,"Gothic Rd","w1920","Motorized",0,"Thu","weekday","sled","East River","1","1","1",9.3,0,41,0,18,22.7,-1,-1,6,-1,-1,-2,4,3
"8168",2020-02-20,"Gothic Rd","w1920","Hybrid",0,"Thu","weekday","sled","East River","1","1","1",9.3,0,41,0,18,22.7,-1,-1,6,-1,-1,-2,4,3
"8169",2020-02-21,"Gothic Rd","w1920","Non.motorized",33,"Fri","weekday","no_sled","East River","1","1","1",9.3,0,40,-1,26,23.2,0,-1,-1,6,-1,-2,-3,3
"8170",2020-02-21,"Gothic Rd","w1920","Mechanized",0,"Fri","weekday","no_sled","East River","1","1","1",9.3,0,40,-1,26,23.2,0,-1,-1,6,-1,-2,-3,3
"8171",2020-02-21,"Gothic Rd","w1920","Motorized",0,"Fri","weekday","sled","East River","1","1","1",9.3,0,40,-1,26,23.2,0,-1,-1,6,-1,-2,-3,3
"8172",2020-02-21,"Gothic Rd","w1920","Hybrid",0,"Fri","weekday","sled","East River","1","1","1",9.3,0,40,-1,26,23.2,0,-1,-1,6,-1,-2,-3,3
"8173",2020-02-22,"Gothic Rd","w1920","Non.motorized",NA,"Sat","weekend","no_sled","East River","1","1","1",9.4,0.1,39,-1,32,24.1,-1,0,-1,-1,-2,-2,-3,-4
"8174",2020-02-22,"Gothic Rd","w1920","Mechanized",NA,"Sat","weekend","no_sled","East River","1","1","1",9.4,0.1,39,-1,32,24.1,-1,0,-1,-1,-2,-2,-3,-4
"8175",2020-02-22,"Gothic Rd","w1920","Motorized",NA,"Sat","weekend","sled","East River","1","1","1",9.4,0.1,39,-1,32,24.1,-1,0,-1,-1,-2,-2,-3,-4
"8176",2020-02-22,"Gothic Rd","w1920","Hybrid",NA,"Sat","weekend","sled","East River","1","1","1",9.4,0.1,39,-1,32,24.1,-1,0,-1,-1,-2,-2,-3,-4
"8177",2020-02-23,"Gothic Rd","w1920","Non.motorized",NA,"Sun","weekend","no_sled","East River","2","2","2",9.5,0.1,40,1,27,23.8,-1,-1,0,-1,0,-1,-1,-2
"8178",2020-02-23,"Gothic Rd","w1920","Mechanized",NA,"Sun","weekend","no_sled","East River","2","2","2",9.5,0.1,40,1,27,23.8,-1,-1,0,-1,0,-1,-1,-2
"8179",2020-02-23,"Gothic Rd","w1920","Motorized",NA,"Sun","weekend","sled","East River","2","2","2",9.5,0.1,40,1,27,23.8,-1,-1,0,-1,0,-1,-1,-2
"8180",2020-02-23,"Gothic Rd","w1920","Hybrid",NA,"Sun","weekend","sled","East River","2","2","2",9.5,0.1,40,1,27,23.8,-1,-1,0,-1,0,-1,-1,-2
"8181",2020-02-24,"Gothic Rd","w1920","Non.motorized",NA,"Mon","weekday","no_sled","East River","3","3","2",9.8,0.3,43,3,17,22.8,1,-1,-1,0,4,3,2,2
"8182",2020-02-24,"Gothic Rd","w1920","Mechanized",NA,"Mon","weekday","no_sled","East River","3","3","2",9.8,0.3,43,3,17,22.8,1,-1,-1,0,4,3,2,2
"8183",2020-02-24,"Gothic Rd","w1920","Motorized",NA,"Mon","weekday","sled","East River","3","3","2",9.8,0.3,43,3,17,22.8,1,-1,-1,0,4,3,2,2
"8184",2020-02-24,"Gothic Rd","w1920","Hybrid",NA,"Mon","weekday","sled","East River","3","3","2",9.8,0.3,43,3,17,22.8,1,-1,-1,0,4,3,2,2
"8185",2020-02-25,"Gothic Rd","w1920","Non.motorized",NA,"Tue","weekday","no_sled","East River","2","2","1",9.8,0,43,0,8,22.8,3,1,-1,-1,3,4,3,2
"8186",2020-02-25,"Gothic Rd","w1920","Mechanized",NA,"Tue","weekday","no_sled","East River","2","2","1",9.8,0,43,0,8,22.8,3,1,-1,-1,3,4,3,2
"8187",2020-02-25,"Gothic Rd","w1920","Motorized",NA,"Tue","weekday","sled","East River","2","2","1",9.8,0,43,0,8,22.8,3,1,-1,-1,3,4,3,2
"8188",2020-02-25,"Gothic Rd","w1920","Hybrid",NA,"Tue","weekday","sled","East River","2","2","1",9.8,0,43,0,8,22.8,3,1,-1,-1,3,4,3,2
"8189",2020-02-26,"Gothic Rd","w1920","Non.motorized",NA,"Wed","weekday","no_sled","East River","2","2","1",9.8,0,42,-1,15,23.3,0,3,1,-1,-1,2,3,2
"8190",2020-02-26,"Gothic Rd","w1920","Mechanized",NA,"Wed","weekday","no_sled","East River","2","2","1",9.8,0,42,-1,15,23.3,0,3,1,-1,-1,2,3,2
"8191",2020-02-26,"Gothic Rd","w1920","Motorized",NA,"Wed","weekday","sled","East River","2","2","1",9.8,0,42,-1,15,23.3,0,3,1,-1,-1,2,3,2
"8192",2020-02-26,"Gothic Rd","w1920","Hybrid",NA,"Wed","weekday","sled","East River","2","2","1",9.8,0,42,-1,15,23.3,0,3,1,-1,-1,2,3,2
"8193",2020-02-27,"Gothic Rd","w1920","Non.motorized",17,"Thu","weekday","no_sled","East River","2","2","1",9.9,0.1,41,-1,25,24.1,-1,0,3,1,-2,-2,1,2
"8194",2020-02-27,"Gothic Rd","w1920","Mechanized",4,"Thu","weekday","no_sled","East River","2","2","1",9.9,0.1,41,-1,25,24.1,-1,0,3,1,-2,-2,1,2
"8195",2020-02-27,"Gothic Rd","w1920","Motorized",1,"Thu","weekday","sled","East River","2","2","1",9.9,0.1,41,-1,25,24.1,-1,0,3,1,-2,-2,1,2
"8196",2020-02-27,"Gothic Rd","w1920","Hybrid",0,"Thu","weekday","sled","East River","2","2","1",9.9,0.1,41,-1,25,24.1,-1,0,3,1,-2,-2,1,2
"8197",2020-02-28,"Gothic Rd","w1920","Non.motorized",34,"Fri","weekday","no_sled","East River","2","1","1",9.9,0,41,0,28,24.1,-1,-1,0,3,-1,-2,-2,1
"8198",2020-02-28,"Gothic Rd","w1920","Mechanized",0,"Fri","weekday","no_sled","East River","2","1","1",9.9,0,41,0,28,24.1,-1,-1,0,3,-1,-2,-2,1
"8199",2020-02-28,"Gothic Rd","w1920","Motorized",0,"Fri","weekday","sled","East River","2","1","1",9.9,0,41,0,28,24.1,-1,-1,0,3,-1,-2,-2,1
"8200",2020-02-28,"Gothic Rd","w1920","Hybrid",0,"Fri","weekday","sled","East River","2","1","1",9.9,0,41,0,28,24.1,-1,-1,0,3,-1,-2,-2,1
"8201",2020-02-29,"Gothic Rd","w1920","Non.motorized",54,"Sat","weekend","no_sled","East River","1","1","1",9.9,0,40,-1,29,24.8,0,-1,-1,0,-1,-2,-3,-3
"8202",2020-02-29,"Gothic Rd","w1920","Mechanized",4,"Sat","weekend","no_sled","East River","1","1","1",9.9,0,40,-1,29,24.8,0,-1,-1,0,-1,-2,-3,-3
"8203",2020-02-29,"Gothic Rd","w1920","Motorized",2,"Sat","weekend","sled","East River","1","1","1",9.9,0,40,-1,29,24.8,0,-1,-1,0,-1,-2,-3,-3
"8204",2020-02-29,"Gothic Rd","w1920","Hybrid",0,"Sat","weekend","sled","East River","1","1","1",9.9,0,40,-1,29,24.8,0,-1,-1,0,-1,-2,-3,-3
"8205",2020-03-01,"Gothic Rd","w1920","Non.motorized",27,"Sun","weekend","no_sled","East River","1","1","1",10,0.1,40,0,28,25,-1,0,-1,-1,-1,-1,-2,-3
"8206",2020-03-01,"Gothic Rd","w1920","Mechanized",4,"Sun","weekend","no_sled","East River","1","1","1",10,0.1,40,0,28,25,-1,0,-1,-1,-1,-1,-2,-3
"8207",2020-03-01,"Gothic Rd","w1920","Motorized",0,"Sun","weekend","sled","East River","1","1","1",10,0.1,40,0,28,25,-1,0,-1,-1,-1,-1,-2,-3
"8208",2020-03-01,"Gothic Rd","w1920","Hybrid",0,"Sun","weekend","sled","East River","1","1","1",10,0.1,40,0,28,25,-1,0,-1,-1,-1,-1,-2,-3
"8209",2020-03-02,"Gothic Rd","w1920","Non.motorized",27,"Mon","weekday","no_sled","East River","2","2","1",10.4,0.4,45,5,25,23.1,0,-1,0,-1,5,4,4,3
"8210",2020-03-02,"Gothic Rd","w1920","Mechanized",0,"Mon","weekday","no_sled","East River","2","2","1",10.4,0.4,45,5,25,23.1,0,-1,0,-1,5,4,4,3
"8211",2020-03-02,"Gothic Rd","w1920","Motorized",0,"Mon","weekday","sled","East River","2","2","1",10.4,0.4,45,5,25,23.1,0,-1,0,-1,5,4,4,3
"8212",2020-03-02,"Gothic Rd","w1920","Hybrid",0,"Mon","weekday","sled","East River","2","2","1",10.4,0.4,45,5,25,23.1,0,-1,0,-1,5,4,4,3
"8213",2020-03-03,"Gothic Rd","w1920","Non.motorized",9,"Tue","weekday","no_sled","East River","2","1","1",10.9,0.5,50,5,25,21.8,5,0,-1,0,10,10,9,9
"8214",2020-03-03,"Gothic Rd","w1920","Mechanized",3,"Tue","weekday","no_sled","East River","2","1","1",10.9,0.5,50,5,25,21.8,5,0,-1,0,10,10,9,9
"8215",2020-03-03,"Gothic Rd","w1920","Motorized",1,"Tue","weekday","sled","East River","2","1","1",10.9,0.5,50,5,25,21.8,5,0,-1,0,10,10,9,9
"8216",2020-03-03,"Gothic Rd","w1920","Hybrid",0,"Tue","weekday","sled","East River","2","1","1",10.9,0.5,50,5,25,21.8,5,0,-1,0,10,10,9,9
"8217",2020-03-04,"Gothic Rd","w1920","Non.motorized",22,"Wed","weekday","no_sled","East River","2","1","1",10.9,0,48,-2,29,22.7,5,5,0,-1,3,8,8,7
"8218",2020-03-04,"Gothic Rd","w1920","Mechanized",0,"Wed","weekday","no_sled","East River","2","1","1",10.9,0,48,-2,29,22.7,5,5,0,-1,3,8,8,7
"8219",2020-03-04,"Gothic Rd","w1920","Motorized",1,"Wed","weekday","sled","East River","2","1","1",10.9,0,48,-2,29,22.7,5,5,0,-1,3,8,8,7
"8220",2020-03-04,"Gothic Rd","w1920","Hybrid",0,"Wed","weekday","sled","East River","2","1","1",10.9,0,48,-2,29,22.7,5,5,0,-1,3,8,8,7
"8221",2020-03-05,"Gothic Rd","w1920","Non.motorized",12,"Thu","weekday","no_sled","East River","2","1","1",10.9,0,46,-2,32,23.7,-2,5,5,0,-4,1,6,6
"8222",2020-03-05,"Gothic Rd","w1920","Mechanized",0,"Thu","weekday","no_sled","East River","2","1","1",10.9,0,46,-2,32,23.7,-2,5,5,0,-4,1,6,6
"8223",2020-03-05,"Gothic Rd","w1920","Motorized",0,"Thu","weekday","sled","East River","2","1","1",10.9,0,46,-2,32,23.7,-2,5,5,0,-4,1,6,6
"8224",2020-03-05,"Gothic Rd","w1920","Hybrid",0,"Thu","weekday","sled","East River","2","1","1",10.9,0,46,-2,32,23.7,-2,5,5,0,-4,1,6,6
"8225",2020-03-06,"Gothic Rd","w1920","Non.motorized",17,"Fri","weekday","no_sled","East River","1","1","1",10.9,0,45,-1,34,24.2,-2,-2,5,5,-3,-5,0,5
"8226",2020-03-06,"Gothic Rd","w1920","Mechanized",1,"Fri","weekday","no_sled","East River","1","1","1",10.9,0,45,-1,34,24.2,-2,-2,5,5,-3,-5,0,5
"8227",2020-03-06,"Gothic Rd","w1920","Motorized",1,"Fri","weekday","sled","East River","1","1","1",10.9,0,45,-1,34,24.2,-2,-2,5,5,-3,-5,0,5
"8228",2020-03-06,"Gothic Rd","w1920","Hybrid",0,"Fri","weekday","sled","East River","1","1","1",10.9,0,45,-1,34,24.2,-2,-2,5,5,-3,-5,0,5
"8229",2020-03-07,"Gothic Rd","w1920","Non.motorized",16,"Sat","weekend","no_sled","East River","1","1","2",10.9,0,44,-1,35,24.8,-1,-2,-2,5,-2,-4,-6,-1
"8230",2020-03-07,"Gothic Rd","w1920","Mechanized",5,"Sat","weekend","no_sled","East River","1","1","2",10.9,0,44,-1,35,24.8,-1,-2,-2,5,-2,-4,-6,-1
"8231",2020-03-07,"Gothic Rd","w1920","Motorized",2,"Sat","weekend","sled","East River","1","1","2",10.9,0,44,-1,35,24.8,-1,-2,-2,5,-2,-4,-6,-1
"8232",2020-03-07,"Gothic Rd","w1920","Hybrid",0,"Sat","weekend","sled","East River","1","1","2",10.9,0,44,-1,35,24.8,-1,-2,-2,5,-2,-4,-6,-1
"8233",2020-03-08,"Gothic Rd","w1920","Non.motorized",20,"Sun","weekend","no_sled","East River","1","1","1",11,0.1,43,-1,33,25.6,-1,-1,-2,-2,-2,-3,-5,-7
"8234",2020-03-08,"Gothic Rd","w1920","Mechanized",1,"Sun","weekend","no_sled","East River","1","1","1",11,0.1,43,-1,33,25.6,-1,-1,-2,-2,-2,-3,-5,-7
"8235",2020-03-08,"Gothic Rd","w1920","Motorized",2,"Sun","weekend","sled","East River","1","1","1",11,0.1,43,-1,33,25.6,-1,-1,-2,-2,-2,-3,-5,-7
"8236",2020-03-08,"Gothic Rd","w1920","Hybrid",0,"Sun","weekend","sled","East River","1","1","1",11,0.1,43,-1,33,25.6,-1,-1,-2,-2,-2,-3,-5,-7
"8237",2020-03-09,"Gothic Rd","w1920","Non.motorized",15,"Mon","weekday","no_sled","East River","1","1","1",11.1,0.1,42,-1,31,26.4,-1,-1,-1,-2,-2,-3,-4,-6
"8238",2020-03-09,"Gothic Rd","w1920","Mechanized",3,"Mon","weekday","no_sled","East River","1","1","1",11.1,0.1,42,-1,31,26.4,-1,-1,-1,-2,-2,-3,-4,-6
"8239",2020-03-09,"Gothic Rd","w1920","Motorized",0,"Mon","weekday","sled","East River","1","1","1",11.1,0.1,42,-1,31,26.4,-1,-1,-1,-2,-2,-3,-4,-6
"8240",2020-03-09,"Gothic Rd","w1920","Hybrid",0,"Mon","weekday","sled","East River","1","1","1",11.1,0.1,42,-1,31,26.4,-1,-1,-1,-2,-2,-3,-4,-6
"8241",2020-03-10,"Gothic Rd","w1920","Non.motorized",15,"Tue","weekday","no_sled","East River","1","1","2",11.2,0.1,44,2,31,25.5,-1,-1,-1,-1,1,0,-1,-2
"8242",2020-03-10,"Gothic Rd","w1920","Mechanized",1,"Tue","weekday","no_sled","East River","1","1","2",11.2,0.1,44,2,31,25.5,-1,-1,-1,-1,1,0,-1,-2
"8243",2020-03-10,"Gothic Rd","w1920","Motorized",1,"Tue","weekday","sled","East River","1","1","2",11.2,0.1,44,2,31,25.5,-1,-1,-1,-1,1,0,-1,-2
"8244",2020-03-10,"Gothic Rd","w1920","Hybrid",0,"Tue","weekday","sled","East River","1","1","2",11.2,0.1,44,2,31,25.5,-1,-1,-1,-1,1,0,-1,-2
"8245",2020-03-11,"Gothic Rd","w1920","Non.motorized",5,"Wed","weekday","no_sled","East River","2","2","1",11.2,0,44,0,32,25.5,2,-1,-1,-1,2,1,0,-1
"8246",2020-03-11,"Gothic Rd","w1920","Mechanized",0,"Wed","weekday","no_sled","East River","2","2","1",11.2,0,44,0,32,25.5,2,-1,-1,-1,2,1,0,-1
"8247",2020-03-11,"Gothic Rd","w1920","Motorized",0,"Wed","weekday","sled","East River","2","2","1",11.2,0,44,0,32,25.5,2,-1,-1,-1,2,1,0,-1
"8248",2020-03-11,"Gothic Rd","w1920","Hybrid",0,"Wed","weekday","sled","East River","2","2","1",11.2,0,44,0,32,25.5,2,-1,-1,-1,2,1,0,-1
"8249",2020-03-12,"Gothic Rd","w1920","Non.motorized",19,"Thu","weekday","no_sled","East River","2","2","2",11.4,0.2,42,-2,35,27.1,0,2,-1,-1,-2,0,-1,-2
"8250",2020-03-12,"Gothic Rd","w1920","Mechanized",1,"Thu","weekday","no_sled","East River","2","2","2",11.4,0.2,42,-2,35,27.1,0,2,-1,-1,-2,0,-1,-2
"8251",2020-03-12,"Gothic Rd","w1920","Motorized",1,"Thu","weekday","sled","East River","2","2","2",11.4,0.2,42,-2,35,27.1,0,2,-1,-1,-2,0,-1,-2
"8252",2020-03-12,"Gothic Rd","w1920","Hybrid",0,"Thu","weekday","sled","East River","2","2","2",11.4,0.2,42,-2,35,27.1,0,2,-1,-1,-2,0,-1,-2
"8253",2020-03-13,"Gothic Rd","w1920","Non.motorized",13,"Fri","weekday","no_sled","East River","3","3","2",11.5,0.1,44,2,31,26.1,-2,0,2,-1,0,0,2,1
"8254",2020-03-13,"Gothic Rd","w1920","Mechanized",1,"Fri","weekday","no_sled","East River","3","3","2",11.5,0.1,44,2,31,26.1,-2,0,2,-1,0,0,2,1
"8255",2020-03-13,"Gothic Rd","w1920","Motorized",4,"Fri","weekday","sled","East River","3","3","2",11.5,0.1,44,2,31,26.1,-2,0,2,-1,0,0,2,1
"8256",2020-03-13,"Gothic Rd","w1920","Hybrid",0,"Fri","weekday","sled","East River","3","3","2",11.5,0.1,44,2,31,26.1,-2,0,2,-1,0,0,2,1
"8257",2020-03-14,"Gothic Rd","w1920","Non.motorized",25,"Sat","weekend","no_sled","East River","3","3","3",11.7,0.2,44,0,31,26.6,2,-2,0,2,2,0,0,2
"8258",2020-03-14,"Gothic Rd","w1920","Mechanized",1,"Sat","weekend","no_sled","East River","3","3","3",11.7,0.2,44,0,31,26.6,2,-2,0,2,2,0,0,2
"8259",2020-03-14,"Gothic Rd","w1920","Motorized",1,"Sat","weekend","sled","East River","3","3","3",11.7,0.2,44,0,31,26.6,2,-2,0,2,2,0,0,2
"8260",2020-03-14,"Gothic Rd","w1920","Hybrid",0,"Sat","weekend","sled","East River","3","3","3",11.7,0.2,44,0,31,26.6,2,-2,0,2,2,0,0,2
"8261",2020-03-15,"Gothic Rd","w1920","Non.motorized",21,"Sun","weekend","no_sled","East River","2","2","2",11.7,0,45,1,33,26,0,2,-2,0,1,3,1,1
"8262",2020-03-15,"Gothic Rd","w1920","Mechanized",4,"Sun","weekend","no_sled","East River","2","2","2",11.7,0,45,1,33,26,0,2,-2,0,1,3,1,1
"8263",2020-03-15,"Gothic Rd","w1920","Motorized",7,"Sun","weekend","sled","East River","2","2","2",11.7,0,45,1,33,26,0,2,-2,0,1,3,1,1
"8264",2020-03-15,"Gothic Rd","w1920","Hybrid",0,"Sun","weekend","sled","East River","2","2","2",11.7,0,45,1,33,26,0,2,-2,0,1,3,1,1
"8265",2020-03-16,"Gothic Rd","w1920","Non.motorized",12,"Mon","weekday","no_sled","East River","2","2","2",11.7,0,45,0,35,26,1,0,2,-2,1,1,3,1
"8266",2020-03-16,"Gothic Rd","w1920","Mechanized",1,"Mon","weekday","no_sled","East River","2","2","2",11.7,0,45,0,35,26,1,0,2,-2,1,1,3,1
"8267",2020-03-16,"Gothic Rd","w1920","Motorized",0,"Mon","weekday","sled","East River","2","2","2",11.7,0,45,0,35,26,1,0,2,-2,1,1,3,1
"8268",2020-03-16,"Gothic Rd","w1920","Hybrid",0,"Mon","weekday","sled","East River","2","2","2",11.7,0,45,0,35,26,1,0,2,-2,1,1,3,1
"8269",2020-03-17,"Gothic Rd","w1920","Non.motorized",7,"Tue","weekday","no_sled","East River","2","2","2",11.7,0,44,-1,36,26.6,0,1,0,2,-1,0,0,2
"8270",2020-03-17,"Gothic Rd","w1920","Mechanized",4,"Tue","weekday","no_sled","East River","2","2","2",11.7,0,44,-1,36,26.6,0,1,0,2,-1,0,0,2
"8271",2020-03-17,"Gothic Rd","w1920","Motorized",0,"Tue","weekday","sled","East River","2","2","2",11.7,0,44,-1,36,26.6,0,1,0,2,-1,0,0,2
"8272",2020-03-17,"Gothic Rd","w1920","Hybrid",0,"Tue","weekday","sled","East River","2","2","2",11.7,0,44,-1,36,26.6,0,1,0,2,-1,0,0,2
"8273",2020-03-18,"Gothic Rd","w1920","Non.motorized",4,"Wed","weekday","no_sled","East River","2","2","2",11.7,0,43,-1,33,27.2,-1,0,1,0,-2,-2,-1,-1
"8274",2020-03-18,"Gothic Rd","w1920","Mechanized",0,"Wed","weekday","no_sled","East River","2","2","2",11.7,0,43,-1,33,27.2,-1,0,1,0,-2,-2,-1,-1
"8275",2020-03-18,"Gothic Rd","w1920","Motorized",0,"Wed","weekday","sled","East River","2","2","2",11.7,0,43,-1,33,27.2,-1,0,1,0,-2,-2,-1,-1
"8276",2020-03-18,"Gothic Rd","w1920","Hybrid",0,"Wed","weekday","sled","East River","2","2","2",11.7,0,43,-1,33,27.2,-1,0,1,0,-2,-2,-1,-1
"8277",2020-03-19,"Gothic Rd","w1920","Non.motorized",8,"Thu","weekday","no_sled","East River","3","3","3",11.8,0.1,43,0,27,27.4,-1,-1,0,1,-1,-2,-2,-1
"8278",2020-03-19,"Gothic Rd","w1920","Mechanized",0,"Thu","weekday","no_sled","East River","3","3","3",11.8,0.1,43,0,27,27.4,-1,-1,0,1,-1,-2,-2,-1
"8279",2020-03-19,"Gothic Rd","w1920","Motorized",0,"Thu","weekday","sled","East River","3","3","3",11.8,0.1,43,0,27,27.4,-1,-1,0,1,-1,-2,-2,-1
"8280",2020-03-19,"Gothic Rd","w1920","Hybrid",0,"Thu","weekday","sled","East River","3","3","3",11.8,0.1,43,0,27,27.4,-1,-1,0,1,-1,-2,-2,-1
"8281",2020-03-20,"Gothic Rd","w1920","Non.motorized",7,"Fri","weekday","no_sled","East River","3","3","2",12.7,0.9,52,9,26,24.4,0,-1,-1,0,9,8,7,7
"8282",2020-03-20,"Gothic Rd","w1920","Mechanized",1,"Fri","weekday","no_sled","East River","3","3","2",12.7,0.9,52,9,26,24.4,0,-1,-1,0,9,8,7,7
"8283",2020-03-20,"Gothic Rd","w1920","Motorized",1,"Fri","weekday","sled","East River","3","3","2",12.7,0.9,52,9,26,24.4,0,-1,-1,0,9,8,7,7
"8284",2020-03-20,"Gothic Rd","w1920","Hybrid",0,"Fri","weekday","sled","East River","3","3","2",12.7,0.9,52,9,26,24.4,0,-1,-1,0,9,8,7,7
"8285",2020-03-21,"Gothic Rd","w1920","Non.motorized",21,"Sat","weekend","no_sled","East River","3","3","2",12.8,0.1,54,2,26,23.7,9,0,-1,-1,11,11,10,9
"8286",2020-03-21,"Gothic Rd","w1920","Mechanized",2,"Sat","weekend","no_sled","East River","3","3","2",12.8,0.1,54,2,26,23.7,9,0,-1,-1,11,11,10,9
"8287",2020-03-21,"Gothic Rd","w1920","Motorized",0,"Sat","weekend","sled","East River","3","3","2",12.8,0.1,54,2,26,23.7,9,0,-1,-1,11,11,10,9
"8288",2020-03-21,"Gothic Rd","w1920","Hybrid",0,"Sat","weekend","sled","East River","3","3","2",12.8,0.1,54,2,26,23.7,9,0,-1,-1,11,11,10,9
"8289",2020-03-22,"Gothic Rd","w1920","Non.motorized",27,"Sun","weekend","no_sled","East River","2","2","2",13,0.2,53,-1,28,24.5,2,9,0,-1,1,10,10,9
"8290",2020-03-22,"Gothic Rd","w1920","Mechanized",3,"Sun","weekend","no_sled","East River","2","2","2",13,0.2,53,-1,28,24.5,2,9,0,-1,1,10,10,9
"8291",2020-03-22,"Gothic Rd","w1920","Motorized",0,"Sun","weekend","sled","East River","2","2","2",13,0.2,53,-1,28,24.5,2,9,0,-1,1,10,10,9
"8292",2020-03-22,"Gothic Rd","w1920","Hybrid",0,"Sun","weekend","sled","East River","2","2","2",13,0.2,53,-1,28,24.5,2,9,0,-1,1,10,10,9
"8293",2020-03-23,"Gothic Rd","w1920","Non.motorized",13,"Mon","weekday","no_sled","East River","2","2","2",13,0,53,0,28,24.5,-1,2,9,0,-1,1,10,10
"8294",2020-03-23,"Gothic Rd","w1920","Mechanized",1,"Mon","weekday","no_sled","East River","2","2","2",13,0,53,0,28,24.5,-1,2,9,0,-1,1,10,10
"8295",2020-03-23,"Gothic Rd","w1920","Motorized",0,"Mon","weekday","sled","East River","2","2","2",13,0,53,0,28,24.5,-1,2,9,0,-1,1,10,10
"8296",2020-03-23,"Gothic Rd","w1920","Hybrid",0,"Mon","weekday","sled","East River","2","2","2",13,0,53,0,28,24.5,-1,2,9,0,-1,1,10,10
"8297",2020-03-24,"Gothic Rd","w1920","Non.motorized",15,"Tue","weekday","no_sled","East River","2","2","2",13.2,0.2,53,0,32,24.9,0,-1,2,9,0,-1,1,10
"8298",2020-03-24,"Gothic Rd","w1920","Mechanized",1,"Tue","weekday","no_sled","East River","2","2","2",13.2,0.2,53,0,32,24.9,0,-1,2,9,0,-1,1,10
"8299",2020-03-24,"Gothic Rd","w1920","Motorized",0,"Tue","weekday","sled","East River","2","2","2",13.2,0.2,53,0,32,24.9,0,-1,2,9,0,-1,1,10
"8300",2020-03-24,"Gothic Rd","w1920","Hybrid",0,"Tue","weekday","sled","East River","2","2","2",13.2,0.2,53,0,32,24.9,0,-1,2,9,0,-1,1,10
"8301",2020-03-25,"Gothic Rd","w1920","Non.motorized",11,"Wed","weekday","no_sled","East River","2","2","2",13.3,0.1,51,-2,34,26.1,0,0,-1,2,-2,-2,-3,-1
"8302",2020-03-25,"Gothic Rd","w1920","Mechanized",1,"Wed","weekday","no_sled","East River","2","2","2",13.3,0.1,51,-2,34,26.1,0,0,-1,2,-2,-2,-3,-1
"8303",2020-03-25,"Gothic Rd","w1920","Motorized",1,"Wed","weekday","sled","East River","2","2","2",13.3,0.1,51,-2,34,26.1,0,0,-1,2,-2,-2,-3,-1
"8304",2020-03-25,"Gothic Rd","w1920","Hybrid",0,"Wed","weekday","sled","East River","2","2","2",13.3,0.1,51,-2,34,26.1,0,0,-1,2,-2,-2,-3,-1
"8305",2020-03-26,"Gothic Rd","w1920","Non.motorized",9,"Thu","weekday","no_sled","East River","2","2","2",13.3,0,50,-1,36,26.6,-2,0,0,-1,-3,-3,-3,-4
"8306",2020-03-26,"Gothic Rd","w1920","Non.motorized",9,"Thu","weekday","no_sled","East River","3","3","2",13.3,0,50,-1,36,26.6,-2,0,0,-1,-3,-3,-3,-4
"8307",2020-03-26,"Gothic Rd","w1920","Mechanized",1,"Thu","weekday","no_sled","East River","2","2","2",13.3,0,50,-1,36,26.6,-2,0,0,-1,-3,-3,-3,-4
"8308",2020-03-26,"Gothic Rd","w1920","Mechanized",1,"Thu","weekday","no_sled","East River","3","3","2",13.3,0,50,-1,36,26.6,-2,0,0,-1,-3,-3,-3,-4
"8309",2020-03-26,"Gothic Rd","w1920","Motorized",1,"Thu","weekday","sled","East River","2","2","2",13.3,0,50,-1,36,26.6,-2,0,0,-1,-3,-3,-3,-4
"8310",2020-03-26,"Gothic Rd","w1920","Motorized",1,"Thu","weekday","sled","East River","3","3","2",13.3,0,50,-1,36,26.6,-2,0,0,-1,-3,-3,-3,-4
"8311",2020-03-26,"Gothic Rd","w1920","Hybrid",0,"Thu","weekday","sled","East River","2","2","2",13.3,0,50,-1,36,26.6,-2,0,0,-1,-3,-3,-3,-4
"8312",2020-03-26,"Gothic Rd","w1920","Hybrid",0,"Thu","weekday","sled","East River","3","3","2",13.3,0,50,-1,36,26.6,-2,0,0,-1,-3,-3,-3,-4
"8313",2020-03-27,"Gothic Rd","w1920","Non.motorized",NA,"Fri","weekday","no_sled","East River","3","3","2",13.3,0,50,0,23,26.6,-1,-2,0,0,-1,-3,-3,-3
"8314",2020-03-27,"Gothic Rd","w1920","Mechanized",NA,"Fri","weekday","no_sled","East River","3","3","2",13.3,0,50,0,23,26.6,-1,-2,0,0,-1,-3,-3,-3
"8315",2020-03-27,"Gothic Rd","w1920","Motorized",NA,"Fri","weekday","sled","East River","3","3","2",13.3,0,50,0,23,26.6,-1,-2,0,0,-1,-3,-3,-3
"8316",2020-03-27,"Gothic Rd","w1920","Hybrid",NA,"Fri","weekday","sled","East River","3","3","2",13.3,0,50,0,23,26.6,-1,-2,0,0,-1,-3,-3,-3
"8317",2020-03-28,"Gothic Rd","w1920","Non.motorized",27,"Sat","weekend","no_sled","East River","3","3","3",13.3,0,50,0,18,26.6,0,-1,-2,0,0,-1,-3,-3
"8318",2020-03-28,"Gothic Rd","w1920","Mechanized",0,"Sat","weekend","no_sled","East River","3","3","3",13.3,0,50,0,18,26.6,0,-1,-2,0,0,-1,-3,-3
"8319",2020-03-28,"Gothic Rd","w1920","Motorized",0,"Sat","weekend","sled","East River","3","3","3",13.3,0,50,0,18,26.6,0,-1,-2,0,0,-1,-3,-3
"8320",2020-03-28,"Gothic Rd","w1920","Hybrid",0,"Sat","weekend","sled","East River","3","3","3",13.3,0,50,0,18,26.6,0,-1,-2,0,0,-1,-3,-3
"8321",2020-03-29,"Gothic Rd","w1920","Non.motorized",11,"Sun","weekend","no_sled","East River","2","2","2",13.3,0,49,-1,24,27.1,0,0,-1,-2,-1,-1,-2,-4
"8322",2020-03-29,"Gothic Rd","w1920","Mechanized",1,"Sun","weekend","no_sled","East River","2","2","2",13.3,0,49,-1,24,27.1,0,0,-1,-2,-1,-1,-2,-4
"8323",2020-03-29,"Gothic Rd","w1920","Motorized",0,"Sun","weekend","sled","East River","2","2","2",13.3,0,49,-1,24,27.1,0,0,-1,-2,-1,-1,-2,-4
"8324",2020-03-29,"Gothic Rd","w1920","Hybrid",0,"Sun","weekend","sled","East River","2","2","2",13.3,0,49,-1,24,27.1,0,0,-1,-2,-1,-1,-2,-4
"8325",2020-03-30,"Gothic Rd","w1920","Non.motorized",8,"Mon","weekday","no_sled","East River","2","2","2",13.4,0.1,49,0,29,27.3,-1,0,0,-1,-1,-1,-1,-2
"8326",2020-03-30,"Gothic Rd","w1920","Mechanized",0,"Mon","weekday","no_sled","East River","2","2","2",13.4,0.1,49,0,29,27.3,-1,0,0,-1,-1,-1,-1,-2
"8327",2020-03-30,"Gothic Rd","w1920","Motorized",0,"Mon","weekday","sled","East River","2","2","2",13.4,0.1,49,0,29,27.3,-1,0,0,-1,-1,-1,-1,-2
"8328",2020-03-30,"Gothic Rd","w1920","Hybrid",0,"Mon","weekday","sled","East River","2","2","2",13.4,0.1,49,0,29,27.3,-1,0,0,-1,-1,-1,-1,-2
"8329",2020-03-31,"Gothic Rd","w1920","Non.motorized",5,"Tue","weekday","no_sled","East River","2","2","2",13.6,0.2,51,2,35,26.7,0,-1,0,0,2,1,1,1
"8330",2020-03-31,"Gothic Rd","w1920","Mechanized",1,"Tue","weekday","no_sled","East River","2","2","2",13.6,0.2,51,2,35,26.7,0,-1,0,0,2,1,1,1
"8331",2020-03-31,"Gothic Rd","w1920","Motorized",1,"Tue","weekday","sled","East River","2","2","2",13.6,0.2,51,2,35,26.7,0,-1,0,0,2,1,1,1
"8332",2020-03-31,"Gothic Rd","w1920","Hybrid",0,"Tue","weekday","sled","East River","2","2","2",13.6,0.2,51,2,35,26.7,0,-1,0,0,2,1,1,1
"8333",2020-04-01,"Gothic Rd","w1920","Non.motorized",6,"Wed","weekday","no_sled","East River","2","2","2",13.6,0,47,-4,39,28.9,2,0,-1,0,-2,-2,-3,-3
"8334",2020-04-01,"Gothic Rd","w1920","Mechanized",1,"Wed","weekday","no_sled","East River","2","2","2",13.6,0,47,-4,39,28.9,2,0,-1,0,-2,-2,-3,-3
"8335",2020-04-01,"Gothic Rd","w1920","Motorized",1,"Wed","weekday","sled","East River","2","2","2",13.6,0,47,-4,39,28.9,2,0,-1,0,-2,-2,-3,-3
"8336",2020-04-01,"Gothic Rd","w1920","Hybrid",0,"Wed","weekday","sled","East River","2","2","2",13.6,0,47,-4,39,28.9,2,0,-1,0,-2,-2,-3,-3
"8337",2020-04-02,"Gothic Rd","w1920","Non.motorized",5,"Thu","weekday","no_sled","East River","2","2","2",13.6,0,46,-1,31,29.6,-4,2,0,-1,-5,-3,-3,-4
"8338",2020-04-02,"Gothic Rd","w1920","Mechanized",0,"Thu","weekday","no_sled","East River","2","2","2",13.6,0,46,-1,31,29.6,-4,2,0,-1,-5,-3,-3,-4
"8339",2020-04-02,"Gothic Rd","w1920","Motorized",1,"Thu","weekday","sled","East River","2","2","2",13.6,0,46,-1,31,29.6,-4,2,0,-1,-5,-3,-3,-4
"8340",2020-04-02,"Gothic Rd","w1920","Hybrid",0,"Thu","weekday","sled","East River","2","2","2",13.6,0,46,-1,31,29.6,-4,2,0,-1,-5,-3,-3,-4
"8341",2020-04-03,"Gothic Rd","w1920","Non.motorized",5,"Fri","weekday","no_sled","East River","2","2","2",13.6,0,46,0,28,29.6,-1,-4,2,0,-1,-5,-3,-3
"8342",2020-04-03,"Gothic Rd","w1920","Mechanized",0,"Fri","weekday","no_sled","East River","2","2","2",13.6,0,46,0,28,29.6,-1,-4,2,0,-1,-5,-3,-3
"8343",2020-04-03,"Gothic Rd","w1920","Motorized",0,"Fri","weekday","sled","East River","2","2","2",13.6,0,46,0,28,29.6,-1,-4,2,0,-1,-5,-3,-3
"8344",2020-04-03,"Gothic Rd","w1920","Hybrid",0,"Fri","weekday","sled","East River","2","2","2",13.6,0,46,0,28,29.6,-1,-4,2,0,-1,-5,-3,-3
"8345",2020-04-04,"Gothic Rd","w1920","Non.motorized",11,"Sat","weekend","no_sled","East River","2","2","2",13.6,0,45,-1,33,30.2,0,-1,-4,2,-1,-2,-6,-4
"8346",2020-04-04,"Gothic Rd","w1920","Mechanized",0,"Sat","weekend","no_sled","East River","2","2","2",13.6,0,45,-1,33,30.2,0,-1,-4,2,-1,-2,-6,-4
"8347",2020-04-04,"Gothic Rd","w1920","Motorized",1,"Sat","weekend","sled","East River","2","2","2",13.6,0,45,-1,33,30.2,0,-1,-4,2,-1,-2,-6,-4
"8348",2020-04-04,"Gothic Rd","w1920","Hybrid",0,"Sat","weekend","sled","East River","2","2","2",13.6,0,45,-1,33,30.2,0,-1,-4,2,-1,-2,-6,-4
"8349",2020-04-05,"Gothic Rd","w1920","Non.motorized",14,"Sun","weekend","no_sled","East River","2","2","3",13.6,0,45,0,38,30.2,-1,0,-1,-4,-1,-1,-2,-6
"8350",2020-04-05,"Gothic Rd","w1920","Mechanized",0,"Sun","weekend","no_sled","East River","2","2","3",13.6,0,45,0,38,30.2,-1,0,-1,-4,-1,-1,-2,-6
"8351",2020-04-05,"Gothic Rd","w1920","Motorized",0,"Sun","weekend","sled","East River","2","2","3",13.6,0,45,0,38,30.2,-1,0,-1,-4,-1,-1,-2,-6
"8352",2020-04-05,"Gothic Rd","w1920","Hybrid",0,"Sun","weekend","sled","East River","2","2","3",13.6,0,45,0,38,30.2,-1,0,-1,-4,-1,-1,-2,-6
"8353",2020-04-06,"Gothic Rd","w1920","Non.motorized",1,"Mon","weekday","no_sled","East River","2","2","3",13.6,0,44,-1,40,30.9,0,-1,0,-1,-1,-2,-2,-3
"8354",2020-04-06,"Gothic Rd","w1920","Mechanized",2,"Mon","weekday","no_sled","East River","2","2","3",13.6,0,44,-1,40,30.9,0,-1,0,-1,-1,-2,-2,-3
"8355",2020-04-06,"Gothic Rd","w1920","Motorized",0,"Mon","weekday","sled","East River","2","2","3",13.6,0,44,-1,40,30.9,0,-1,0,-1,-1,-2,-2,-3
"8356",2020-04-06,"Gothic Rd","w1920","Hybrid",0,"Mon","weekday","sled","East River","2","2","3",13.6,0,44,-1,40,30.9,0,-1,0,-1,-1,-2,-2,-3
"8357",2020-04-07,"Gothic Rd","w1920","Non.motorized",NA,"Tue","weekday","no_sled","East River","2","2","3",13.4,-0.2,43,-1,39,31.2,-1,0,-1,0,-2,-2,-3,-3
"8358",2020-04-07,"Gothic Rd","w1920","Mechanized",NA,"Tue","weekday","no_sled","East River","2","2","3",13.4,-0.2,43,-1,39,31.2,-1,0,-1,0,-2,-2,-3,-3
"8359",2020-04-07,"Gothic Rd","w1920","Motorized",NA,"Tue","weekday","sled","East River","2","2","3",13.4,-0.2,43,-1,39,31.2,-1,0,-1,0,-2,-2,-3,-3
"8360",2020-04-07,"Gothic Rd","w1920","Hybrid",NA,"Tue","weekday","sled","East River","2","2","3",13.4,-0.2,43,-1,39,31.2,-1,0,-1,0,-2,-2,-3,-3
"8361",2020-04-08,"Gothic Rd","w1920","Non.motorized",NA,"Wed","weekday","no_sled","East River","2","3","3",13.3,-0.1,42,-1,40,31.7,-1,-1,0,-1,-2,-3,-3,-4
"8362",2020-04-08,"Gothic Rd","w1920","Mechanized",NA,"Wed","weekday","no_sled","East River","2","3","3",13.3,-0.1,42,-1,40,31.7,-1,-1,0,-1,-2,-3,-3,-4
"8363",2020-04-08,"Gothic Rd","w1920","Motorized",NA,"Wed","weekday","sled","East River","2","3","3",13.3,-0.1,42,-1,40,31.7,-1,-1,0,-1,-2,-3,-3,-4
"8364",2020-04-08,"Gothic Rd","w1920","Hybrid",NA,"Wed","weekday","sled","East River","2","3","3",13.3,-0.1,42,-1,40,31.7,-1,-1,0,-1,-2,-3,-3,-4
"8365",2020-04-09,"Gothic Rd","w1920","Non.motorized",NA,"Thu","weekday","no_sled","East River","2","3","3",13.1,-0.2,40,-2,42,32.8,-1,-1,-1,0,-3,-4,-5,-5
"8366",2020-04-09,"Gothic Rd","w1920","Mechanized",NA,"Thu","weekday","no_sled","East River","2","3","3",13.1,-0.2,40,-2,42,32.8,-1,-1,-1,0,-3,-4,-5,-5
"8367",2020-04-09,"Gothic Rd","w1920","Motorized",NA,"Thu","weekday","sled","East River","2","3","3",13.1,-0.2,40,-2,42,32.8,-1,-1,-1,0,-3,-4,-5,-5
"8368",2020-04-09,"Gothic Rd","w1920","Hybrid",NA,"Thu","weekday","sled","East River","2","3","3",13.1,-0.2,40,-2,42,32.8,-1,-1,-1,0,-3,-4,-5,-5
"8369",2020-04-10,"Gothic Rd","w1920","Non.motorized",NA,"Fri","weekday","no_sled","East River","3","3","3",12.9,-0.2,39,-1,38,33.1,-2,-1,-1,-1,-3,-4,-5,-6
"8370",2020-04-10,"Gothic Rd","w1920","Mechanized",NA,"Fri","weekday","no_sled","East River","3","3","3",12.9,-0.2,39,-1,38,33.1,-2,-1,-1,-1,-3,-4,-5,-6
"8371",2020-04-10,"Gothic Rd","w1920","Motorized",NA,"Fri","weekday","sled","East River","3","3","3",12.9,-0.2,39,-1,38,33.1,-2,-1,-1,-1,-3,-4,-5,-6
"8372",2020-04-10,"Gothic Rd","w1920","Hybrid",NA,"Fri","weekday","sled","East River","3","3","3",12.9,-0.2,39,-1,38,33.1,-2,-1,-1,-1,-3,-4,-5,-6
"8373",2020-04-11,"Gothic Rd","w1920","Non.motorized",NA,"Sat","weekend","no_sled","East River","2","3","3",12.9,0,39,0,36,33.1,-1,-2,-1,-1,-1,-3,-4,-5
"8374",2020-04-11,"Gothic Rd","w1920","Mechanized",NA,"Sat","weekend","no_sled","East River","2","3","3",12.9,0,39,0,36,33.1,-1,-2,-1,-1,-1,-3,-4,-5
"8375",2020-04-11,"Gothic Rd","w1920","Motorized",NA,"Sat","weekend","sled","East River","2","3","3",12.9,0,39,0,36,33.1,-1,-2,-1,-1,-1,-3,-4,-5
"8376",2020-04-11,"Gothic Rd","w1920","Hybrid",NA,"Sat","weekend","sled","East River","2","3","3",12.9,0,39,0,36,33.1,-1,-2,-1,-1,-1,-3,-4,-5
"8377",2020-04-12,"Gothic Rd","w1920","Non.motorized",NA,"Sun","weekend","no_sled","East River","2","2","2",12.8,-0.1,38,-1,29,33.7,0,-1,-2,-1,-1,-2,-4,-5
"8378",2020-04-12,"Gothic Rd","w1920","Mechanized",NA,"Sun","weekend","no_sled","East River","2","2","2",12.8,-0.1,38,-1,29,33.7,0,-1,-2,-1,-1,-2,-4,-5
"8379",2020-04-12,"Gothic Rd","w1920","Motorized",NA,"Sun","weekend","sled","East River","2","2","2",12.8,-0.1,38,-1,29,33.7,0,-1,-2,-1,-1,-2,-4,-5
"8380",2020-04-12,"Gothic Rd","w1920","Hybrid",NA,"Sun","weekend","sled","East River","2","2","2",12.8,-0.1,38,-1,29,33.7,0,-1,-2,-1,-1,-2,-4,-5
"8381",2020-04-13,"Gothic Rd","w1920","Non.motorized",NA,"Mon","weekday","no_sled","East River",NA,NA,NA,12.9,0.1,39,1,20,33.1,-1,0,-1,-2,0,0,-1,-3
"8382",2020-04-13,"Gothic Rd","w1920","Mechanized",NA,"Mon","weekday","no_sled","East River",NA,NA,NA,12.9,0.1,39,1,20,33.1,-1,0,-1,-2,0,0,-1,-3
"8383",2020-04-13,"Gothic Rd","w1920","Motorized",NA,"Mon","weekday","sled","East River",NA,NA,NA,12.9,0.1,39,1,20,33.1,-1,0,-1,-2,0,0,-1,-3
"8384",2020-04-13,"Gothic Rd","w1920","Hybrid",NA,"Mon","weekday","sled","East River",NA,NA,NA,12.9,0.1,39,1,20,33.1,-1,0,-1,-2,0,0,-1,-3
"8385",2020-04-14,"Gothic Rd","w1920","Non.motorized",NA,"Tue","weekday","no_sled","East River","2","2","2",13,0.1,39,0,18,33.3,1,-1,0,-1,1,0,0,-1
"8386",2020-04-14,"Gothic Rd","w1920","Mechanized",NA,"Tue","weekday","no_sled","East River","2","2","2",13,0.1,39,0,18,33.3,1,-1,0,-1,1,0,0,-1
"8387",2020-04-14,"Gothic Rd","w1920","Motorized",NA,"Tue","weekday","sled","East River","2","2","2",13,0.1,39,0,18,33.3,1,-1,0,-1,1,0,0,-1
"8388",2020-04-14,"Gothic Rd","w1920","Hybrid",NA,"Tue","weekday","sled","East River","2","2","2",13,0.1,39,0,18,33.3,1,-1,0,-1,1,0,0,-1
"8389",2020-04-15,"Gothic Rd","w1920","Non.motorized",NA,"Wed","weekday","no_sled","East River",NA,NA,NA,13.2,0.2,39,0,28,33.8,0,1,-1,0,0,1,0,0
"8390",2020-04-15,"Gothic Rd","w1920","Mechanized",NA,"Wed","weekday","no_sled","East River",NA,NA,NA,13.2,0.2,39,0,28,33.8,0,1,-1,0,0,1,0,0
"8391",2020-04-15,"Gothic Rd","w1920","Motorized",NA,"Wed","weekday","sled","East River",NA,NA,NA,13.2,0.2,39,0,28,33.8,0,1,-1,0,0,1,0,0
"8392",2020-04-15,"Gothic Rd","w1920","Hybrid",NA,"Wed","weekday","sled","East River",NA,NA,NA,13.2,0.2,39,0,28,33.8,0,1,-1,0,0,1,0,0
"8393",2019-12-06,"Kebler","w1920","Non.motorized",6,"Fri","weekday","no_sled","Kebler","2","2","1",2.9,0.4,19,5,24,15.3,0,0,0,0,5,5,5,5
"8394",2019-12-06,"Kebler","w1920","Mechanized",2,"Fri","weekday","no_sled","Kebler","2","2","1",2.9,0.4,19,5,24,15.3,0,0,0,0,5,5,5,5
"8395",2019-12-06,"Kebler","w1920","Motorized",8,"Fri","weekday","sled","Kebler","2","2","1",2.9,0.4,19,5,24,15.3,0,0,0,0,5,5,5,5
"8396",2019-12-06,"Kebler","w1920","Hybrid",1,"Fri","weekday","sled","Kebler","2","2","1",2.9,0.4,19,5,24,15.3,0,0,0,0,5,5,5,5
"8397",2019-12-07,"Kebler","w1920","Non.motorized",9,"Sat","weekend","no_sled","Kebler","2","2","1",3,0.1,18,-1,29,16.7,5,0,0,0,4,4,4,4
"8398",2019-12-07,"Kebler","w1920","Mechanized",0,"Sat","weekend","no_sled","Kebler","2","2","1",3,0.1,18,-1,29,16.7,5,0,0,0,4,4,4,4
"8399",2019-12-07,"Kebler","w1920","Motorized",38,"Sat","weekend","sled","Kebler","2","2","1",3,0.1,18,-1,29,16.7,5,0,0,0,4,4,4,4
"8400",2019-12-07,"Kebler","w1920","Hybrid",7,"Sat","weekend","sled","Kebler","2","2","1",3,0.1,18,-1,29,16.7,5,0,0,0,4,4,4,4
"8401",2019-12-08,"Kebler","w1920","Non.motorized",8,"Sun","weekend","no_sled","Kebler","2","2","1",3,0,17,-1,28,17.6,-1,5,0,0,-2,3,3,3
"8402",2019-12-08,"Kebler","w1920","Mechanized",0,"Sun","weekend","no_sled","Kebler","2","2","1",3,0,17,-1,28,17.6,-1,5,0,0,-2,3,3,3
"8403",2019-12-08,"Kebler","w1920","Motorized",16,"Sun","weekend","sled","Kebler","2","2","1",3,0,17,-1,28,17.6,-1,5,0,0,-2,3,3,3
"8404",2019-12-08,"Kebler","w1920","Hybrid",1,"Sun","weekend","sled","Kebler","2","2","1",3,0,17,-1,28,17.6,-1,5,0,0,-2,3,3,3
"8405",2019-12-09,"Kebler","w1920","Non.motorized",13,"Mon","weekday","no_sled","Kebler","3","3","2",3.4,0.4,22,5,21,15.5,-1,-1,5,0,4,3,8,8
"8406",2019-12-09,"Kebler","w1920","Mechanized",0,"Mon","weekday","no_sled","Kebler","3","3","2",3.4,0.4,22,5,21,15.5,-1,-1,5,0,4,3,8,8
"8407",2019-12-09,"Kebler","w1920","Motorized",36,"Mon","weekday","sled","Kebler","3","3","2",3.4,0.4,22,5,21,15.5,-1,-1,5,0,4,3,8,8
"8408",2019-12-09,"Kebler","w1920","Hybrid",1,"Mon","weekday","sled","Kebler","3","3","2",3.4,0.4,22,5,21,15.5,-1,-1,5,0,4,3,8,8
"8409",2019-12-10,"Kebler","w1920","Non.motorized",16,"Tue","weekday","no_sled","Kebler","2","2","2",3.4,0,21,-1,19,16.2,5,-1,-1,5,4,3,2,7
"8410",2019-12-10,"Kebler","w1920","Mechanized",0,"Tue","weekday","no_sled","Kebler","2","2","2",3.4,0,21,-1,19,16.2,5,-1,-1,5,4,3,2,7
"8411",2019-12-10,"Kebler","w1920","Motorized",36,"Tue","weekday","sled","Kebler","2","2","2",3.4,0,21,-1,19,16.2,5,-1,-1,5,4,3,2,7
"8412",2019-12-10,"Kebler","w1920","Hybrid",3,"Tue","weekday","sled","Kebler","2","2","2",3.4,0,21,-1,19,16.2,5,-1,-1,5,4,3,2,7
"8413",2019-12-11,"Kebler","w1920","Non.motorized",3,"Wed","weekday","no_sled","Kebler","2","2","2",3.4,0,20,-1,22,17,-1,5,-1,-1,-2,3,2,1
"8414",2019-12-11,"Kebler","w1920","Mechanized",0,"Wed","weekday","no_sled","Kebler","2","2","2",3.4,0,20,-1,22,17,-1,5,-1,-1,-2,3,2,1
"8415",2019-12-11,"Kebler","w1920","Motorized",39,"Wed","weekday","sled","Kebler","2","2","2",3.4,0,20,-1,22,17,-1,5,-1,-1,-2,3,2,1
"8416",2019-12-11,"Kebler","w1920","Hybrid",2,"Wed","weekday","sled","Kebler","2","2","2",3.4,0,20,-1,22,17,-1,5,-1,-1,-2,3,2,1
"8417",2019-12-12,"Kebler","w1920","Non.motorized",2,"Thu","weekday","no_sled","Kebler","2","2","2",3.4,0,19,-1,25,17.9,-1,-1,5,-1,-2,-3,2,1
"8418",2019-12-12,"Kebler","w1920","Mechanized",0,"Thu","weekday","no_sled","Kebler","2","2","2",3.4,0,19,-1,25,17.9,-1,-1,5,-1,-2,-3,2,1
"8419",2019-12-12,"Kebler","w1920","Motorized",29,"Thu","weekday","sled","Kebler","2","2","2",3.4,0,19,-1,25,17.9,-1,-1,5,-1,-2,-3,2,1
"8420",2019-12-12,"Kebler","w1920","Hybrid",2,"Thu","weekday","sled","Kebler","2","2","2",3.4,0,19,-1,25,17.9,-1,-1,5,-1,-2,-3,2,1
"8421",2019-12-13,"Kebler","w1920","Non.motorized",10,"Fri","weekday","no_sled","Kebler","2","2","2",3.8,0.4,21,2,24,18.1,-1,-1,-1,5,1,0,-1,4
"8422",2019-12-13,"Kebler","w1920","Mechanized",0,"Fri","weekday","no_sled","Kebler","2","2","2",3.8,0.4,21,2,24,18.1,-1,-1,-1,5,1,0,-1,4
"8423",2019-12-13,"Kebler","w1920","Motorized",32,"Fri","weekday","sled","Kebler","2","2","2",3.8,0.4,21,2,24,18.1,-1,-1,-1,5,1,0,-1,4
"8424",2019-12-13,"Kebler","w1920","Hybrid",2,"Fri","weekday","sled","Kebler","2","2","2",3.8,0.4,21,2,24,18.1,-1,-1,-1,5,1,0,-1,4
"8425",2019-12-14,"Kebler","w1920","Non.motorized",3,"Sat","weekend","no_sled","Kebler","3","3","3",4.2,0.4,27,6,25,15.6,2,-1,-1,-1,8,7,6,5
"8426",2019-12-14,"Kebler","w1920","Mechanized",1,"Sat","weekend","no_sled","Kebler","3","3","3",4.2,0.4,27,6,25,15.6,2,-1,-1,-1,8,7,6,5
"8427",2019-12-14,"Kebler","w1920","Motorized",32,"Sat","weekend","sled","Kebler","3","3","3",4.2,0.4,27,6,25,15.6,2,-1,-1,-1,8,7,6,5
"8428",2019-12-14,"Kebler","w1920","Hybrid",2,"Sat","weekend","sled","Kebler","3","3","3",4.2,0.4,27,6,25,15.6,2,-1,-1,-1,8,7,6,5
"8429",2019-12-15,"Kebler","w1920","Non.motorized",20,"Sun","weekend","no_sled","Kebler","3","3","2",4.8,0.6,31,4,17,15.5,6,2,-1,-1,10,12,11,10
"8430",2019-12-15,"Kebler","w1920","Mechanized",1,"Sun","weekend","no_sled","Kebler","3","3","2",4.8,0.6,31,4,17,15.5,6,2,-1,-1,10,12,11,10
"8431",2019-12-15,"Kebler","w1920","Motorized",70,"Sun","weekend","sled","Kebler","3","3","2",4.8,0.6,31,4,17,15.5,6,2,-1,-1,10,12,11,10
"8432",2019-12-15,"Kebler","w1920","Hybrid",6,"Sun","weekend","sled","Kebler","3","3","2",4.8,0.6,31,4,17,15.5,6,2,-1,-1,10,12,11,10
"8433",2019-12-16,"Kebler","w1920","Non.motorized",12,"Mon","weekday","no_sled","Kebler","3","3","2",4.8,0,29,-2,6,16.6,4,6,2,-1,2,8,10,9
"8434",2019-12-16,"Kebler","w1920","Mechanized",0,"Mon","weekday","no_sled","Kebler","3","3","2",4.8,0,29,-2,6,16.6,4,6,2,-1,2,8,10,9
"8435",2019-12-16,"Kebler","w1920","Motorized",68,"Mon","weekday","sled","Kebler","3","3","2",4.8,0,29,-2,6,16.6,4,6,2,-1,2,8,10,9
"8436",2019-12-16,"Kebler","w1920","Hybrid",9,"Mon","weekday","sled","Kebler","3","3","2",4.8,0,29,-2,6,16.6,4,6,2,-1,2,8,10,9
"8437",2019-12-17,"Kebler","w1920","Non.motorized",10,"Tue","weekday","no_sled","Kebler","2","2","1",4.8,0,27,-2,8,17.8,-2,4,6,2,-4,0,6,8
"8438",2019-12-17,"Kebler","w1920","Mechanized",3,"Tue","weekday","no_sled","Kebler","2","2","1",4.8,0,27,-2,8,17.8,-2,4,6,2,-4,0,6,8
"8439",2019-12-17,"Kebler","w1920","Motorized",36,"Tue","weekday","sled","Kebler","2","2","1",4.8,0,27,-2,8,17.8,-2,4,6,2,-4,0,6,8
"8440",2019-12-17,"Kebler","w1920","Hybrid",0,"Tue","weekday","sled","Kebler","2","2","1",4.8,0,27,-2,8,17.8,-2,4,6,2,-4,0,6,8
"8441",2019-12-18,"Kebler","w1920","Non.motorized",9,"Wed","weekday","no_sled","Kebler","2","2","1",4.8,0,26,-1,20,18.5,-2,-2,4,6,-3,-5,-1,5
"8442",2019-12-18,"Kebler","w1920","Mechanized",0,"Wed","weekday","no_sled","Kebler","2","2","1",4.8,0,26,-1,20,18.5,-2,-2,4,6,-3,-5,-1,5
"8443",2019-12-18,"Kebler","w1920","Motorized",52,"Wed","weekday","sled","Kebler","2","2","1",4.8,0,26,-1,20,18.5,-2,-2,4,6,-3,-5,-1,5
"8444",2019-12-18,"Kebler","w1920","Hybrid",11,"Wed","weekday","sled","Kebler","2","2","1",4.8,0,26,-1,20,18.5,-2,-2,4,6,-3,-5,-1,5
"8445",2019-12-19,"Kebler","w1920","Non.motorized",12,"Thu","weekday","no_sled","Kebler","2","2","1",4.9,0.1,25,-1,21,19.6,-1,-2,-2,4,-2,-4,-6,-2
"8446",2019-12-19,"Kebler","w1920","Mechanized",1,"Thu","weekday","no_sled","Kebler","2","2","1",4.9,0.1,25,-1,21,19.6,-1,-2,-2,4,-2,-4,-6,-2
"8447",2019-12-19,"Kebler","w1920","Motorized",56,"Thu","weekday","sled","Kebler","2","2","1",4.9,0.1,25,-1,21,19.6,-1,-2,-2,4,-2,-4,-6,-2
"8448",2019-12-19,"Kebler","w1920","Hybrid",7,"Thu","weekday","sled","Kebler","2","2","1",4.9,0.1,25,-1,21,19.6,-1,-2,-2,4,-2,-4,-6,-2
"8449",2019-12-20,"Kebler","w1920","Non.motorized",9,"Fri","weekday","no_sled","Kebler","2","2","1",4.9,0,24,-1,21,20.4,-1,-1,-2,-2,-2,-3,-5,-7
"8450",2019-12-20,"Kebler","w1920","Mechanized",0,"Fri","weekday","no_sled","Kebler","2","2","1",4.9,0,24,-1,21,20.4,-1,-1,-2,-2,-2,-3,-5,-7
"8451",2019-12-20,"Kebler","w1920","Motorized",62,"Fri","weekday","sled","Kebler","2","2","1",4.9,0,24,-1,21,20.4,-1,-1,-2,-2,-2,-3,-5,-7
"8452",2019-12-20,"Kebler","w1920","Hybrid",15,"Fri","weekday","sled","Kebler","2","2","1",4.9,0,24,-1,21,20.4,-1,-1,-2,-2,-2,-3,-5,-7
"8453",2019-12-21,"Kebler","w1920","Non.motorized",7,"Sat","weekend","no_sled","Kebler","2","2","1",4.9,0,24,0,27,20.4,-1,-1,-1,-2,-1,-2,-3,-5
"8454",2019-12-21,"Kebler","w1920","Mechanized",0,"Sat","weekend","no_sled","Kebler","2","2","1",4.9,0,24,0,27,20.4,-1,-1,-1,-2,-1,-2,-3,-5
"8455",2019-12-21,"Kebler","w1920","Motorized",100,"Sat","weekend","sled","Kebler","2","2","1",4.9,0,24,0,27,20.4,-1,-1,-1,-2,-1,-2,-3,-5
"8456",2019-12-21,"Kebler","w1920","Hybrid",8,"Sat","weekend","sled","Kebler","2","2","1",4.9,0,24,0,27,20.4,-1,-1,-1,-2,-1,-2,-3,-5
"8457",2019-12-22,"Kebler","w1920","Non.motorized",13,"Sun","weekend","no_sled","Kebler","2","2","1",5,0.1,23,-1,31,21.7,0,-1,-1,-1,-1,-2,-3,-4
"8458",2019-12-22,"Kebler","w1920","Mechanized",0,"Sun","weekend","no_sled","Kebler","2","2","1",5,0.1,23,-1,31,21.7,0,-1,-1,-1,-1,-2,-3,-4
"8459",2019-12-22,"Kebler","w1920","Motorized",16,"Sun","weekend","sled","Kebler","2","2","1",5,0.1,23,-1,31,21.7,0,-1,-1,-1,-1,-2,-3,-4
"8460",2019-12-22,"Kebler","w1920","Hybrid",10,"Sun","weekend","sled","Kebler","2","2","1",5,0.1,23,-1,31,21.7,0,-1,-1,-1,-1,-2,-3,-4
"8461",2019-12-23,"Kebler","w1920","Non.motorized",2,"Mon","weekday","no_sled","Kebler","2","1","1",5,0,23,0,34,21.7,-1,0,-1,-1,-1,-1,-2,-3
"8462",2019-12-23,"Kebler","w1920","Mechanized",1,"Mon","weekday","no_sled","Kebler","2","1","1",5,0,23,0,34,21.7,-1,0,-1,-1,-1,-1,-2,-3
"8463",2019-12-23,"Kebler","w1920","Motorized",124,"Mon","weekday","sled","Kebler","2","1","1",5,0,23,0,34,21.7,-1,0,-1,-1,-1,-1,-2,-3
"8464",2019-12-23,"Kebler","w1920","Hybrid",16,"Mon","weekday","sled","Kebler","2","1","1",5,0,23,0,34,21.7,-1,0,-1,-1,-1,-1,-2,-3
"8465",2019-12-24,"Kebler","w1920","Non.motorized",6,"Tue","weekday","no_sled","Kebler","2","1","1",5,0,22,-1,30,22.7,0,-1,0,-1,-1,-2,-2,-3
"8466",2019-12-24,"Kebler","w1920","Mechanized",0,"Tue","weekday","no_sled","Kebler","2","1","1",5,0,22,-1,30,22.7,0,-1,0,-1,-1,-2,-2,-3
"8467",2019-12-24,"Kebler","w1920","Motorized",141,"Tue","weekday","sled","Kebler","2","1","1",5,0,22,-1,30,22.7,0,-1,0,-1,-1,-2,-2,-3
"8468",2019-12-24,"Kebler","w1920","Hybrid",3,"Tue","weekday","sled","Kebler","2","1","1",5,0,22,-1,30,22.7,0,-1,0,-1,-1,-2,-2,-3
"8469",2019-12-25,"Kebler","w1920","Non.motorized",2,"Wed","weekday","no_sled","Kebler","2","2","2",5,0,23,1,22,21.7,-1,0,-1,0,0,0,-1,-1
"8470",2019-12-25,"Kebler","w1920","Mechanized",0,"Wed","weekday","no_sled","Kebler","2","2","2",5,0,23,1,22,21.7,-1,0,-1,0,0,0,-1,-1
"8471",2019-12-25,"Kebler","w1920","Motorized",154,"Wed","weekday","sled","Kebler","2","2","2",5,0,23,1,22,21.7,-1,0,-1,0,0,0,-1,-1
"8472",2019-12-25,"Kebler","w1920","Hybrid",3,"Wed","weekday","sled","Kebler","2","2","2",5,0,23,1,22,21.7,-1,0,-1,0,0,0,-1,-1
"8473",2019-12-26,"Kebler","w1920","Non.motorized",10,"Thu","weekday","no_sled","Kebler","2","2","1",5,0,23,0,17,21.7,1,-1,0,-1,1,0,0,-1
"8474",2019-12-26,"Kebler","w1920","Mechanized",0,"Thu","weekday","no_sled","Kebler","2","2","1",5,0,23,0,17,21.7,1,-1,0,-1,1,0,0,-1
"8475",2019-12-26,"Kebler","w1920","Motorized",213,"Thu","weekday","sled","Kebler","2","2","1",5,0,23,0,17,21.7,1,-1,0,-1,1,0,0,-1
"8476",2019-12-26,"Kebler","w1920","Hybrid",15,"Thu","weekday","sled","Kebler","2","2","1",5,0,23,0,17,21.7,1,-1,0,-1,1,0,0,-1
"8477",2019-12-27,"Kebler","w1920","Non.motorized",9,"Fri","weekday","no_sled","Kebler","3","3","2",5.1,0.1,24,1,22,21.2,0,1,-1,0,1,2,1,1
"8478",2019-12-27,"Kebler","w1920","Mechanized",0,"Fri","weekday","no_sled","Kebler","3","3","2",5.1,0.1,24,1,22,21.2,0,1,-1,0,1,2,1,1
"8479",2019-12-27,"Kebler","w1920","Motorized",159,"Fri","weekday","sled","Kebler","3","3","2",5.1,0.1,24,1,22,21.2,0,1,-1,0,1,2,1,1
"8480",2019-12-27,"Kebler","w1920","Hybrid",4,"Fri","weekday","sled","Kebler","3","3","2",5.1,0.1,24,1,22,21.2,0,1,-1,0,1,2,1,1
"8481",2019-12-28,"Kebler","w1920","Non.motorized",23,"Sat","weekend","no_sled","Kebler","3","3","2",5.6,0.5,30,6,16,18.7,1,0,1,-1,7,7,8,7
"8482",2019-12-28,"Kebler","w1920","Mechanized",1,"Sat","weekend","no_sled","Kebler","3","3","2",5.6,0.5,30,6,16,18.7,1,0,1,-1,7,7,8,7
"8483",2019-12-28,"Kebler","w1920","Motorized",158,"Sat","weekend","sled","Kebler","3","3","2",5.6,0.5,30,6,16,18.7,1,0,1,-1,7,7,8,7
"8484",2019-12-28,"Kebler","w1920","Hybrid",8,"Sat","weekend","sled","Kebler","3","3","2",5.6,0.5,30,6,16,18.7,1,0,1,-1,7,7,8,7
"8485",2019-12-29,"Kebler","w1920","Non.motorized",9,"Sun","weekend","no_sled","Kebler","3","3","2",5.6,0,29,-1,3,19.3,6,1,0,1,5,6,6,7
"8486",2019-12-29,"Kebler","w1920","Mechanized",0,"Sun","weekend","no_sled","Kebler","3","3","2",5.6,0,29,-1,3,19.3,6,1,0,1,5,6,6,7
"8487",2019-12-29,"Kebler","w1920","Motorized",146,"Sun","weekend","sled","Kebler","3","3","2",5.6,0,29,-1,3,19.3,6,1,0,1,5,6,6,7
"8488",2019-12-29,"Kebler","w1920","Hybrid",4,"Sun","weekend","sled","Kebler","3","3","2",5.6,0,29,-1,3,19.3,6,1,0,1,5,6,6,7
"8489",2019-12-30,"Kebler","w1920","Non.motorized",5,"Mon","weekday","no_sled","Kebler","3","3","2",5.6,0,28,-1,3,20,-1,6,1,0,-2,4,5,5
"8490",2019-12-30,"Kebler","w1920","Mechanized",0,"Mon","weekday","no_sled","Kebler","3","3","2",5.6,0,28,-1,3,20,-1,6,1,0,-2,4,5,5
"8491",2019-12-30,"Kebler","w1920","Motorized",163,"Mon","weekday","sled","Kebler","3","3","2",5.6,0,28,-1,3,20,-1,6,1,0,-2,4,5,5
"8492",2019-12-30,"Kebler","w1920","Hybrid",3,"Mon","weekday","sled","Kebler","3","3","2",5.6,0,28,-1,3,20,-1,6,1,0,-2,4,5,5
"8493",2019-12-31,"Kebler","w1920","Non.motorized",21,"Tue","weekday","no_sled","Kebler","2","2","1",5.6,0,28,0,13,20,-1,-1,6,1,-1,-2,4,5
"8494",2019-12-31,"Kebler","w1920","Mechanized",0,"Tue","weekday","no_sled","Kebler","2","2","1",5.6,0,28,0,13,20,-1,-1,6,1,-1,-2,4,5
"8495",2019-12-31,"Kebler","w1920","Motorized",176,"Tue","weekday","sled","Kebler","2","2","1",5.6,0,28,0,13,20,-1,-1,6,1,-1,-2,4,5
"8496",2019-12-31,"Kebler","w1920","Hybrid",8,"Tue","weekday","sled","Kebler","2","2","1",5.6,0,28,0,13,20,-1,-1,6,1,-1,-2,4,5
"8497",2020-01-01,"Kebler","w1920","Non.motorized",11,"Wed","weekday","no_sled","Kebler","2","1","1",5.6,0,27,-1,21,20.7,0,-1,-1,6,-1,-2,-3,3
"8498",2020-01-01,"Kebler","w1920","Mechanized",0,"Wed","weekday","no_sled","Kebler","2","1","1",5.6,0,27,-1,21,20.7,0,-1,-1,6,-1,-2,-3,3
"8499",2020-01-01,"Kebler","w1920","Motorized",92,"Wed","weekday","sled","Kebler","2","1","1",5.6,0,27,-1,21,20.7,0,-1,-1,6,-1,-2,-3,3
"8500",2020-01-01,"Kebler","w1920","Hybrid",NA,"Wed","weekday","sled","Kebler","2","1","1",5.6,0,27,-1,21,20.7,0,-1,-1,6,-1,-2,-3,3
"8501",2020-01-02,"Kebler","w1920","Non.motorized",12,"Thu","weekday","no_sled","Kebler","3","3","2",5.9,0.3,29,2,16,20.3,-1,0,-1,-1,1,1,0,-1
"8502",2020-01-02,"Kebler","w1920","Mechanized",0,"Thu","weekday","no_sled","Kebler","3","3","2",5.9,0.3,29,2,16,20.3,-1,0,-1,-1,1,1,0,-1
"8503",2020-01-02,"Kebler","w1920","Motorized",125,"Thu","weekday","sled","Kebler","3","3","2",5.9,0.3,29,2,16,20.3,-1,0,-1,-1,1,1,0,-1
"8504",2020-01-02,"Kebler","w1920","Hybrid",14,"Thu","weekday","sled","Kebler","3","3","2",5.9,0.3,29,2,16,20.3,-1,0,-1,-1,1,1,0,-1
"8505",2020-01-03,"Kebler","w1920","Non.motorized",18,"Fri","weekday","no_sled","Kebler","3","2","1",5.9,0,31,2,19,19,2,-1,0,-1,4,3,3,2
"8506",2020-01-03,"Kebler","w1920","Mechanized",0,"Fri","weekday","no_sled","Kebler","3","2","1",5.9,0,31,2,19,19,2,-1,0,-1,4,3,3,2
"8507",2020-01-03,"Kebler","w1920","Motorized",140,"Fri","weekday","sled","Kebler","3","2","1",5.9,0,31,2,19,19,2,-1,0,-1,4,3,3,2
"8508",2020-01-03,"Kebler","w1920","Hybrid",5,"Fri","weekday","sled","Kebler","3","2","1",5.9,0,31,2,19,19,2,-1,0,-1,4,3,3,2
"8509",2020-01-04,"Kebler","w1920","Non.motorized",15,"Sat","weekend","no_sled","Kebler","2","2","1",5.9,0,30,-1,26,19.7,2,2,-1,0,1,3,2,2
"8510",2020-01-04,"Kebler","w1920","Mechanized",1,"Sat","weekend","no_sled","Kebler","2","2","1",5.9,0,30,-1,26,19.7,2,2,-1,0,1,3,2,2
"8511",2020-01-04,"Kebler","w1920","Motorized",90,"Sat","weekend","sled","Kebler","2","2","1",5.9,0,30,-1,26,19.7,2,2,-1,0,1,3,2,2
"8512",2020-01-04,"Kebler","w1920","Hybrid",14,"Sat","weekend","sled","Kebler","2","2","1",5.9,0,30,-1,26,19.7,2,2,-1,0,1,3,2,2
"8513",2020-01-05,"Kebler","w1920","Non.motorized",7,"Sun","weekend","no_sled","Kebler","2","2","1",5.9,0,28,-2,23,21.1,-1,2,2,-1,-3,-1,1,0
"8514",2020-01-05,"Kebler","w1920","Mechanized",0,"Sun","weekend","no_sled","Kebler","2","2","1",5.9,0,28,-2,23,21.1,-1,2,2,-1,-3,-1,1,0
"8515",2020-01-05,"Kebler","w1920","Motorized",24,"Sun","weekend","sled","Kebler","2","2","1",5.9,0,28,-2,23,21.1,-1,2,2,-1,-3,-1,1,0
"8516",2020-01-05,"Kebler","w1920","Hybrid",10,"Sun","weekend","sled","Kebler","2","2","1",5.9,0,28,-2,23,21.1,-1,2,2,-1,-3,-1,1,0
"8517",2020-01-06,"Kebler","w1920","Non.motorized",NA,"Mon","weekday","no_sled","Kebler","2","2","1",5.9,0,28,0,15,21.1,-2,-1,2,2,-2,-3,-1,1
"8518",2020-01-06,"Kebler","w1920","Mechanized",NA,"Mon","weekday","no_sled","Kebler","2","2","1",5.9,0,28,0,15,21.1,-2,-1,2,2,-2,-3,-1,1
"8519",2020-01-06,"Kebler","w1920","Motorized",NA,"Mon","weekday","sled","Kebler","2","2","1",5.9,0,28,0,15,21.1,-2,-1,2,2,-2,-3,-1,1
"8520",2020-01-06,"Kebler","w1920","Hybrid",NA,"Mon","weekday","sled","Kebler","2","2","1",5.9,0,28,0,15,21.1,-2,-1,2,2,-2,-3,-1,1
"8521",2020-01-07,"Kebler","w1920","Non.motorized",NA,"Tue","weekday","no_sled","Kebler","2","1","1",5.9,0,28,0,22,21.1,0,-2,-1,2,0,-2,-3,-1
"8522",2020-01-07,"Kebler","w1920","Mechanized",NA,"Tue","weekday","no_sled","Kebler","2","1","1",5.9,0,28,0,22,21.1,0,-2,-1,2,0,-2,-3,-1
"8523",2020-01-07,"Kebler","w1920","Motorized",NA,"Tue","weekday","sled","Kebler","2","1","1",5.9,0,28,0,22,21.1,0,-2,-1,2,0,-2,-3,-1
"8524",2020-01-07,"Kebler","w1920","Hybrid",NA,"Tue","weekday","sled","Kebler","2","1","1",5.9,0,28,0,22,21.1,0,-2,-1,2,0,-2,-3,-1
"8525",2020-01-08,"Kebler","w1920","Non.motorized",NA,"Wed","weekday","no_sled","Kebler","2","1","1",6,0.1,28,0,23,21.4,0,0,-2,-1,0,0,-2,-3
"8526",2020-01-08,"Kebler","w1920","Mechanized",NA,"Wed","weekday","no_sled","Kebler","2","1","1",6,0.1,28,0,23,21.4,0,0,-2,-1,0,0,-2,-3
"8527",2020-01-08,"Kebler","w1920","Motorized",NA,"Wed","weekday","sled","Kebler","2","1","1",6,0.1,28,0,23,21.4,0,0,-2,-1,0,0,-2,-3
"8528",2020-01-08,"Kebler","w1920","Hybrid",NA,"Wed","weekday","sled","Kebler","2","1","1",6,0.1,28,0,23,21.4,0,0,-2,-1,0,0,-2,-3
"8529",2020-01-09,"Kebler","w1920","Non.motorized",NA,"Thu","weekday","no_sled","Kebler","2","1","1",6,0,27,-1,17,22.2,0,0,0,-2,-1,-1,-1,-3
"8530",2020-01-09,"Kebler","w1920","Mechanized",NA,"Thu","weekday","no_sled","Kebler","2","1","1",6,0,27,-1,17,22.2,0,0,0,-2,-1,-1,-1,-3
"8531",2020-01-09,"Kebler","w1920","Motorized",NA,"Thu","weekday","sled","Kebler","2","1","1",6,0,27,-1,17,22.2,0,0,0,-2,-1,-1,-1,-3
"8532",2020-01-09,"Kebler","w1920","Hybrid",NA,"Thu","weekday","sled","Kebler","2","1","1",6,0,27,-1,17,22.2,0,0,0,-2,-1,-1,-1,-3
"8533",2020-01-10,"Kebler","w1920","Non.motorized",NA,"Fri","weekday","no_sled","Kebler","2","1","1",6,0,29,2,11,20.7,-1,0,0,0,1,1,1,1
"8534",2020-01-10,"Kebler","w1920","Mechanized",NA,"Fri","weekday","no_sled","Kebler","2","1","1",6,0,29,2,11,20.7,-1,0,0,0,1,1,1,1
"8535",2020-01-10,"Kebler","w1920","Motorized",NA,"Fri","weekday","sled","Kebler","2","1","1",6,0,29,2,11,20.7,-1,0,0,0,1,1,1,1
"8536",2020-01-10,"Kebler","w1920","Hybrid",NA,"Fri","weekday","sled","Kebler","2","1","1",6,0,29,2,11,20.7,-1,0,0,0,1,1,1,1
"8537",2020-01-11,"Kebler","w1920","Non.motorized",3,"Sat","weekend","no_sled","Kebler","2","1","1",6,0,29,0,12,20.7,2,-1,0,0,2,1,1,1
"8538",2020-01-11,"Kebler","w1920","Mechanized",0,"Sat","weekend","no_sled","Kebler","2","1","1",6,0,29,0,12,20.7,2,-1,0,0,2,1,1,1
"8539",2020-01-11,"Kebler","w1920","Motorized",23,"Sat","weekend","sled","Kebler","2","1","1",6,0,29,0,12,20.7,2,-1,0,0,2,1,1,1
"8540",2020-01-11,"Kebler","w1920","Hybrid",2,"Sat","weekend","sled","Kebler","2","1","1",6,0,29,0,12,20.7,2,-1,0,0,2,1,1,1
"8541",2020-01-12,"Kebler","w1920","Non.motorized",3,"Sun","weekend","no_sled","Kebler","2","1","1",6.1,0.1,29,0,13,21,0,2,-1,0,0,2,1,1
"8542",2020-01-12,"Kebler","w1920","Mechanized",0,"Sun","weekend","no_sled","Kebler","2","1","1",6.1,0.1,29,0,13,21,0,2,-1,0,0,2,1,1
"8543",2020-01-12,"Kebler","w1920","Motorized",47,"Sun","weekend","sled","Kebler","2","1","1",6.1,0.1,29,0,13,21,0,2,-1,0,0,2,1,1
"8544",2020-01-12,"Kebler","w1920","Hybrid",3,"Sun","weekend","sled","Kebler","2","1","1",6.1,0.1,29,0,13,21,0,2,-1,0,0,2,1,1
"8545",2020-01-13,"Kebler","w1920","Non.motorized",6,"Mon","weekday","no_sled","Kebler","2","2","1",6.2,0.1,29,0,16,21.4,0,0,2,-1,0,0,2,1
"8546",2020-01-13,"Kebler","w1920","Mechanized",0,"Mon","weekday","no_sled","Kebler","2","2","1",6.2,0.1,29,0,16,21.4,0,0,2,-1,0,0,2,1
"8547",2020-01-13,"Kebler","w1920","Motorized",38,"Mon","weekday","sled","Kebler","2","2","1",6.2,0.1,29,0,16,21.4,0,0,2,-1,0,0,2,1
"8548",2020-01-13,"Kebler","w1920","Hybrid",0,"Mon","weekday","sled","Kebler","2","2","1",6.2,0.1,29,0,16,21.4,0,0,2,-1,0,0,2,1
"8549",2020-01-14,"Kebler","w1920","Non.motorized",12,"Tue","weekday","no_sled","Kebler","3","2","1",6.6,0.4,34,5,23,19.4,0,0,0,2,5,5,5,7
"8550",2020-01-14,"Kebler","w1920","Mechanized",0,"Tue","weekday","no_sled","Kebler","3","2","1",6.6,0.4,34,5,23,19.4,0,0,0,2,5,5,5,7
"8551",2020-01-14,"Kebler","w1920","Motorized",37,"Tue","weekday","sled","Kebler","3","2","1",6.6,0.4,34,5,23,19.4,0,0,0,2,5,5,5,7
"8552",2020-01-14,"Kebler","w1920","Hybrid",1,"Tue","weekday","sled","Kebler","3","2","1",6.6,0.4,34,5,23,19.4,0,0,0,2,5,5,5,7
"8553",2020-01-15,"Kebler","w1920","Non.motorized",5,"Wed","weekday","no_sled","Kebler","3","2","1",6.7,0.1,32,-2,23,20.9,5,0,0,0,3,3,3,3
"8554",2020-01-15,"Kebler","w1920","Mechanized",0,"Wed","weekday","no_sled","Kebler","3","2","1",6.7,0.1,32,-2,23,20.9,5,0,0,0,3,3,3,3
"8555",2020-01-15,"Kebler","w1920","Motorized",27,"Wed","weekday","sled","Kebler","3","2","1",6.7,0.1,32,-2,23,20.9,5,0,0,0,3,3,3,3
"8556",2020-01-15,"Kebler","w1920","Hybrid",0,"Wed","weekday","sled","Kebler","3","2","1",6.7,0.1,32,-2,23,20.9,5,0,0,0,3,3,3,3
"8557",2020-01-16,"Kebler","w1920","Non.motorized",1,"Thu","weekday","no_sled","Kebler","2","2","1",6.7,0,31,-1,28,21.6,-2,5,0,0,-3,2,2,2
"8558",2020-01-16,"Kebler","w1920","Mechanized",1,"Thu","weekday","no_sled","Kebler","2","2","1",6.7,0,31,-1,28,21.6,-2,5,0,0,-3,2,2,2
"8559",2020-01-16,"Kebler","w1920","Motorized",43,"Thu","weekday","sled","Kebler","2","2","1",6.7,0,31,-1,28,21.6,-2,5,0,0,-3,2,2,2
"8560",2020-01-16,"Kebler","w1920","Hybrid",2,"Thu","weekday","sled","Kebler","2","2","1",6.7,0,31,-1,28,21.6,-2,5,0,0,-3,2,2,2
"8561",2020-01-17,"Kebler","w1920","Non.motorized",0,"Fri","weekday","no_sled","Kebler","2","2","1",6.8,0.1,29,-2,19,23.4,-1,-2,5,0,-3,-5,0,0
"8562",2020-01-17,"Kebler","w1920","Mechanized",0,"Fri","weekday","no_sled","Kebler","2","2","1",6.8,0.1,29,-2,19,23.4,-1,-2,5,0,-3,-5,0,0
"8563",2020-01-17,"Kebler","w1920","Motorized",6,"Fri","weekday","sled","Kebler","2","2","1",6.8,0.1,29,-2,19,23.4,-1,-2,5,0,-3,-5,0,0
"8564",2020-01-17,"Kebler","w1920","Hybrid",0,"Fri","weekday","sled","Kebler","2","2","1",6.8,0.1,29,-2,19,23.4,-1,-2,5,0,-3,-5,0,0
"8565",2020-01-18,"Kebler","w1920","Non.motorized",5,"Sat","weekend","no_sled","Kebler","2","2","2",7,0.2,34,5,16,20.6,-2,-1,-2,5,3,2,0,5
"8566",2020-01-18,"Kebler","w1920","Mechanized",0,"Sat","weekend","no_sled","Kebler","2","2","2",7,0.2,34,5,16,20.6,-2,-1,-2,5,3,2,0,5
"8567",2020-01-18,"Kebler","w1920","Motorized",30,"Sat","weekend","sled","Kebler","2","2","2",7,0.2,34,5,16,20.6,-2,-1,-2,5,3,2,0,5
"8568",2020-01-18,"Kebler","w1920","Hybrid",2,"Sat","weekend","sled","Kebler","2","2","2",7,0.2,34,5,16,20.6,-2,-1,-2,5,3,2,0,5
"8569",2020-01-19,"Kebler","w1920","Non.motorized",11,"Sun","weekend","no_sled","Kebler","2","2","1",7,0,33,-1,21,21.2,5,-2,-1,-2,4,2,1,-1
"8570",2020-01-19,"Kebler","w1920","Mechanized",0,"Sun","weekend","no_sled","Kebler","2","2","1",7,0,33,-1,21,21.2,5,-2,-1,-2,4,2,1,-1
"8571",2020-01-19,"Kebler","w1920","Motorized",65,"Sun","weekend","sled","Kebler","2","2","1",7,0,33,-1,21,21.2,5,-2,-1,-2,4,2,1,-1
"8572",2020-01-19,"Kebler","w1920","Hybrid",2,"Sun","weekend","sled","Kebler","2","2","1",7,0,33,-1,21,21.2,5,-2,-1,-2,4,2,1,-1
"8573",2020-01-20,"Kebler","w1920","Non.motorized",2,"Mon","weekday","no_sled","Kebler","2","2","1",7.1,0.1,32,-1,25,22.2,-1,5,-2,-1,-2,3,1,0
"8574",2020-01-20,"Kebler","w1920","Mechanized",0,"Mon","weekday","no_sled","Kebler","2","2","1",7.1,0.1,32,-1,25,22.2,-1,5,-2,-1,-2,3,1,0
"8575",2020-01-20,"Kebler","w1920","Motorized",48,"Mon","weekday","sled","Kebler","2","2","1",7.1,0.1,32,-1,25,22.2,-1,5,-2,-1,-2,3,1,0
"8576",2020-01-20,"Kebler","w1920","Hybrid",0,"Mon","weekday","sled","Kebler","2","2","1",7.1,0.1,32,-1,25,22.2,-1,5,-2,-1,-2,3,1,0
"8577",2020-01-21,"Kebler","w1920","Non.motorized",4,"Tue","weekday","no_sled","Kebler","2","2","1",7.1,0,31,-1,28,22.9,-1,-1,5,-2,-2,-3,2,0
"8578",2020-01-21,"Kebler","w1920","Mechanized",1,"Tue","weekday","no_sled","Kebler","2","2","1",7.1,0,31,-1,28,22.9,-1,-1,5,-2,-2,-3,2,0
"8579",2020-01-21,"Kebler","w1920","Motorized",22,"Tue","weekday","sled","Kebler","2","2","1",7.1,0,31,-1,28,22.9,-1,-1,5,-2,-2,-3,2,0
"8580",2020-01-21,"Kebler","w1920","Hybrid",0,"Tue","weekday","sled","Kebler","2","2","1",7.1,0,31,-1,28,22.9,-1,-1,5,-2,-2,-3,2,0
"8581",2020-01-22,"Kebler","w1920","Non.motorized",6,"Wed","weekday","no_sled","Kebler","2","2","2",7.3,0.2,32,1,25,22.8,-1,-1,-1,5,0,-1,-2,3
"8582",2020-01-22,"Kebler","w1920","Mechanized",0,"Wed","weekday","no_sled","Kebler","2","2","2",7.3,0.2,32,1,25,22.8,-1,-1,-1,5,0,-1,-2,3
"8583",2020-01-22,"Kebler","w1920","Motorized",47,"Wed","weekday","sled","Kebler","2","2","2",7.3,0.2,32,1,25,22.8,-1,-1,-1,5,0,-1,-2,3
"8584",2020-01-22,"Kebler","w1920","Hybrid",2,"Wed","weekday","sled","Kebler","2","2","2",7.3,0.2,32,1,25,22.8,-1,-1,-1,5,0,-1,-2,3
"8585",2020-01-23,"Kebler","w1920","Non.motorized",11,"Thu","weekday","no_sled","Kebler","3","2","2",7.3,0,34,2,23,21.5,1,-1,-1,-1,3,2,1,0
"8586",2020-01-23,"Kebler","w1920","Mechanized",0,"Thu","weekday","no_sled","Kebler","3","2","2",7.3,0,34,2,23,21.5,1,-1,-1,-1,3,2,1,0
"8587",2020-01-23,"Kebler","w1920","Motorized",37,"Thu","weekday","sled","Kebler","3","2","2",7.3,0,34,2,23,21.5,1,-1,-1,-1,3,2,1,0
"8588",2020-01-23,"Kebler","w1920","Hybrid",2,"Thu","weekday","sled","Kebler","3","2","2",7.3,0,34,2,23,21.5,1,-1,-1,-1,3,2,1,0
"8589",2020-01-24,"Kebler","w1920","Non.motorized",2,"Fri","weekday","no_sled","Kebler","2","2","1",7.3,0,33,-1,23,22.1,2,1,-1,-1,1,2,1,0
"8590",2020-01-24,"Kebler","w1920","Mechanized",0,"Fri","weekday","no_sled","Kebler","2","2","1",7.3,0,33,-1,23,22.1,2,1,-1,-1,1,2,1,0
"8591",2020-01-24,"Kebler","w1920","Motorized",49,"Fri","weekday","sled","Kebler","2","2","1",7.3,0,33,-1,23,22.1,2,1,-1,-1,1,2,1,0
"8592",2020-01-24,"Kebler","w1920","Hybrid",4,"Fri","weekday","sled","Kebler","2","2","1",7.3,0,33,-1,23,22.1,2,1,-1,-1,1,2,1,0
"8593",2020-01-25,"Kebler","w1920","Non.motorized",6,"Sat","weekend","no_sled","Kebler","2","2","1",7.4,0.1,32,-1,25,23.1,-1,2,1,-1,-2,0,1,0
"8594",2020-01-25,"Kebler","w1920","Mechanized",0,"Sat","weekend","no_sled","Kebler","2","2","1",7.4,0.1,32,-1,25,23.1,-1,2,1,-1,-2,0,1,0
"8595",2020-01-25,"Kebler","w1920","Motorized",77,"Sat","weekend","sled","Kebler","2","2","1",7.4,0.1,32,-1,25,23.1,-1,2,1,-1,-2,0,1,0
"8596",2020-01-25,"Kebler","w1920","Hybrid",0,"Sat","weekend","sled","Kebler","2","2","1",7.4,0.1,32,-1,25,23.1,-1,2,1,-1,-2,0,1,0
"8597",2020-01-26,"Kebler","w1920","Non.motorized",3,"Sun","weekend","no_sled","Kebler","2","1","1",7.4,0,32,0,28,23.1,-1,-1,2,1,-1,-2,0,1
"8598",2020-01-26,"Kebler","w1920","Mechanized",0,"Sun","weekend","no_sled","Kebler","2","1","1",7.4,0,32,0,28,23.1,-1,-1,2,1,-1,-2,0,1
"8599",2020-01-26,"Kebler","w1920","Motorized",68,"Sun","weekend","sled","Kebler","2","1","1",7.4,0,32,0,28,23.1,-1,-1,2,1,-1,-2,0,1
"8600",2020-01-26,"Kebler","w1920","Hybrid",4,"Sun","weekend","sled","Kebler","2","1","1",7.4,0,32,0,28,23.1,-1,-1,2,1,-1,-2,0,1
"8601",2020-01-27,"Kebler","w1920","Non.motorized",3,"Mon","weekday","no_sled","Kebler","2","1","1",7.4,0,32,0,24,23.1,0,-1,-1,2,0,-1,-2,0
"8602",2020-01-27,"Kebler","w1920","Mechanized",0,"Mon","weekday","no_sled","Kebler","2","1","1",7.4,0,32,0,24,23.1,0,-1,-1,2,0,-1,-2,0
"8603",2020-01-27,"Kebler","w1920","Motorized",28,"Mon","weekday","sled","Kebler","2","1","1",7.4,0,32,0,24,23.1,0,-1,-1,2,0,-1,-2,0
"8604",2020-01-27,"Kebler","w1920","Hybrid",1,"Mon","weekday","sled","Kebler","2","1","1",7.4,0,32,0,24,23.1,0,-1,-1,2,0,-1,-2,0
"8605",2020-01-28,"Kebler","w1920","Non.motorized",3,"Tue","weekday","no_sled","Kebler","3","2","2",7.4,0,32,0,19,23.1,0,0,-1,-1,0,0,-1,-2
"8606",2020-01-28,"Kebler","w1920","Mechanized",0,"Tue","weekday","no_sled","Kebler","3","2","2",7.4,0,32,0,19,23.1,0,0,-1,-1,0,0,-1,-2
"8607",2020-01-28,"Kebler","w1920","Motorized",53,"Tue","weekday","sled","Kebler","3","2","2",7.4,0,32,0,19,23.1,0,0,-1,-1,0,0,-1,-2
"8608",2020-01-28,"Kebler","w1920","Hybrid",6,"Tue","weekday","sled","Kebler","3","2","2",7.4,0,32,0,19,23.1,0,0,-1,-1,0,0,-1,-2
"8609",2020-01-29,"Kebler","w1920","Non.motorized",4,"Wed","weekday","no_sled","Kebler","2","2","1",7.4,0,31,-1,20,23.9,0,0,0,-1,-1,-1,-1,-2
"8610",2020-01-29,"Kebler","w1920","Mechanized",0,"Wed","weekday","no_sled","Kebler","2","2","1",7.4,0,31,-1,20,23.9,0,0,0,-1,-1,-1,-1,-2
"8611",2020-01-29,"Kebler","w1920","Motorized",55,"Wed","weekday","sled","Kebler","2","2","1",7.4,0,31,-1,20,23.9,0,0,0,-1,-1,-1,-1,-2
"8612",2020-01-29,"Kebler","w1920","Hybrid",5,"Wed","weekday","sled","Kebler","2","2","1",7.4,0,31,-1,20,23.9,0,0,0,-1,-1,-1,-1,-2
"8613",2020-01-30,"Kebler","w1920","Non.motorized",1,"Thu","weekday","no_sled","Kebler","2","2","1",7.4,0,31,0,17,23.9,-1,0,0,0,-1,-1,-1,-1
"8614",2020-01-30,"Kebler","w1920","Mechanized",0,"Thu","weekday","no_sled","Kebler","2","2","1",7.4,0,31,0,17,23.9,-1,0,0,0,-1,-1,-1,-1
"8615",2020-01-30,"Kebler","w1920","Motorized",71,"Thu","weekday","sled","Kebler","2","2","1",7.4,0,31,0,17,23.9,-1,0,0,0,-1,-1,-1,-1
"8616",2020-01-30,"Kebler","w1920","Hybrid",2,"Thu","weekday","sled","Kebler","2","2","1",7.4,0,31,0,17,23.9,-1,0,0,0,-1,-1,-1,-1
"8617",2020-01-31,"Kebler","w1920","Non.motorized",10,"Fri","weekday","no_sled","Kebler","2","1","1",7.4,0,31,0,20,23.9,0,-1,0,0,0,-1,-1,-1
"8618",2020-01-31,"Kebler","w1920","Mechanized",0,"Fri","weekday","no_sled","Kebler","2","1","1",7.4,0,31,0,20,23.9,0,-1,0,0,0,-1,-1,-1
"8619",2020-01-31,"Kebler","w1920","Motorized",40,"Fri","weekday","sled","Kebler","2","1","1",7.4,0,31,0,20,23.9,0,-1,0,0,0,-1,-1,-1
"8620",2020-01-31,"Kebler","w1920","Hybrid",15,"Fri","weekday","sled","Kebler","2","1","1",7.4,0,31,0,20,23.9,0,-1,0,0,0,-1,-1,-1
"8621",2020-02-01,"Kebler","w1920","Non.motorized",7,"Sat","weekend","no_sled","Kebler","2","1","1",7.4,0,31,0,28,23.9,0,0,-1,0,0,0,-1,-1
"8622",2020-02-01,"Kebler","w1920","Mechanized",0,"Sat","weekend","no_sled","Kebler","2","1","1",7.4,0,31,0,28,23.9,0,0,-1,0,0,0,-1,-1
"8623",2020-02-01,"Kebler","w1920","Motorized",97,"Sat","weekend","sled","Kebler","2","1","1",7.4,0,31,0,28,23.9,0,0,-1,0,0,0,-1,-1
"8624",2020-02-01,"Kebler","w1920","Hybrid",19,"Sat","weekend","sled","Kebler","2","1","1",7.4,0,31,0,28,23.9,0,0,-1,0,0,0,-1,-1
"8625",2020-02-02,"Kebler","w1920","Non.motorized",11,"Sun","weekend","no_sled","Kebler","1","1","1",7.4,0,31,0,33,23.9,0,0,0,-1,0,0,0,-1
"8626",2020-02-02,"Kebler","w1920","Mechanized",0,"Sun","weekend","no_sled","Kebler","1","1","1",7.4,0,31,0,33,23.9,0,0,0,-1,0,0,0,-1
"8627",2020-02-02,"Kebler","w1920","Motorized",92,"Sun","weekend","sled","Kebler","1","1","1",7.4,0,31,0,33,23.9,0,0,0,-1,0,0,0,-1
"8628",2020-02-02,"Kebler","w1920","Hybrid",17,"Sun","weekend","sled","Kebler","1","1","1",7.4,0,31,0,33,23.9,0,0,0,-1,0,0,0,-1
"8629",2020-02-03,"Kebler","w1920","Non.motorized",3,"Mon","weekday","no_sled","Kebler","2","2","1",7.4,0,31,0,24,23.9,0,0,0,0,0,0,0,0
"8630",2020-02-03,"Kebler","w1920","Mechanized",0,"Mon","weekday","no_sled","Kebler","2","2","1",7.4,0,31,0,24,23.9,0,0,0,0,0,0,0,0
"8631",2020-02-03,"Kebler","w1920","Motorized",47,"Mon","weekday","sled","Kebler","2","2","1",7.4,0,31,0,24,23.9,0,0,0,0,0,0,0,0
"8632",2020-02-03,"Kebler","w1920","Hybrid",10,"Mon","weekday","sled","Kebler","2","2","1",7.4,0,31,0,24,23.9,0,0,0,0,0,0,0,0
"8633",2020-02-04,"Kebler","w1920","Non.motorized",1,"Tue","weekday","no_sled","Kebler","2","2","2",7.4,0,33,2,5,22.4,0,0,0,0,2,2,2,2
"8634",2020-02-04,"Kebler","w1920","Mechanized",0,"Tue","weekday","no_sled","Kebler","2","2","2",7.4,0,33,2,5,22.4,0,0,0,0,2,2,2,2
"8635",2020-02-04,"Kebler","w1920","Motorized",34,"Tue","weekday","sled","Kebler","2","2","2",7.4,0,33,2,5,22.4,0,0,0,0,2,2,2,2
"8636",2020-02-04,"Kebler","w1920","Hybrid",3,"Tue","weekday","sled","Kebler","2","2","2",7.4,0,33,2,5,22.4,0,0,0,0,2,2,2,2
"8637",2020-02-05,"Kebler","w1920","Non.motorized",4,"Wed","weekday","no_sled","Kebler","2","2","1",7.4,0,33,0,2,22.4,2,0,0,0,2,2,2,2
"8638",2020-02-05,"Kebler","w1920","Mechanized",0,"Wed","weekday","no_sled","Kebler","2","2","1",7.4,0,33,0,2,22.4,2,0,0,0,2,2,2,2
"8639",2020-02-05,"Kebler","w1920","Motorized",42,"Wed","weekday","sled","Kebler","2","2","1",7.4,0,33,0,2,22.4,2,0,0,0,2,2,2,2
"8640",2020-02-05,"Kebler","w1920","Hybrid",10,"Wed","weekday","sled","Kebler","2","2","1",7.4,0,33,0,2,22.4,2,0,0,0,2,2,2,2
"8641",2020-02-06,"Kebler","w1920","Non.motorized",3,"Thu","weekday","no_sled","Kebler","2","2","1",7.5,0.1,32,-1,16,23.4,0,2,0,0,-1,1,1,1
"8642",2020-02-06,"Kebler","w1920","Mechanized",0,"Thu","weekday","no_sled","Kebler","2","2","1",7.5,0.1,32,-1,16,23.4,0,2,0,0,-1,1,1,1
"8643",2020-02-06,"Kebler","w1920","Motorized",39,"Thu","weekday","sled","Kebler","2","2","1",7.5,0.1,32,-1,16,23.4,0,2,0,0,-1,1,1,1
"8644",2020-02-06,"Kebler","w1920","Hybrid",0,"Thu","weekday","sled","Kebler","2","2","1",7.5,0.1,32,-1,16,23.4,0,2,0,0,-1,1,1,1
"8645",2020-02-07,"Kebler","w1920","Non.motorized",NA,"Fri","weekday","no_sled","Kebler","3","3","3",7.9,0.4,37,5,26,21.4,-1,0,2,0,4,4,6,6
"8646",2020-02-07,"Kebler","w1920","Mechanized",NA,"Fri","weekday","no_sled","Kebler","3","3","3",7.9,0.4,37,5,26,21.4,-1,0,2,0,4,4,6,6
"8647",2020-02-07,"Kebler","w1920","Motorized",NA,"Fri","weekday","sled","Kebler","3","3","3",7.9,0.4,37,5,26,21.4,-1,0,2,0,4,4,6,6
"8648",2020-02-07,"Kebler","w1920","Hybrid",NA,"Fri","weekday","sled","Kebler","3","3","3",7.9,0.4,37,5,26,21.4,-1,0,2,0,4,4,6,6
"8649",2020-02-08,"Kebler","w1920","Non.motorized",3,"Sat","weekend","no_sled","Kebler","3","3","2",8.3,0.4,39,2,30,21.3,5,-1,0,2,7,6,6,8
"8650",2020-02-08,"Kebler","w1920","Mechanized",0,"Sat","weekend","no_sled","Kebler","3","3","2",8.3,0.4,39,2,30,21.3,5,-1,0,2,7,6,6,8
"8651",2020-02-08,"Kebler","w1920","Motorized",13,"Sat","weekend","sled","Kebler","3","3","2",8.3,0.4,39,2,30,21.3,5,-1,0,2,7,6,6,8
"8652",2020-02-08,"Kebler","w1920","Hybrid",0,"Sat","weekend","sled","Kebler","3","3","2",8.3,0.4,39,2,30,21.3,5,-1,0,2,7,6,6,8
"8653",2020-02-09,"Kebler","w1920","Non.motorized",13,"Sun","weekend","no_sled","Kebler","3","2","2",8.4,0.1,38,-1,26,22.1,2,5,-1,0,1,6,5,5
"8654",2020-02-09,"Kebler","w1920","Mechanized",0,"Sun","weekend","no_sled","Kebler","3","2","2",8.4,0.1,38,-1,26,22.1,2,5,-1,0,1,6,5,5
"8655",2020-02-09,"Kebler","w1920","Motorized",56,"Sun","weekend","sled","Kebler","3","2","2",8.4,0.1,38,-1,26,22.1,2,5,-1,0,1,6,5,5
"8656",2020-02-09,"Kebler","w1920","Hybrid",4,"Sun","weekend","sled","Kebler","3","2","2",8.4,0.1,38,-1,26,22.1,2,5,-1,0,1,6,5,5
"8657",2020-02-10,"Kebler","w1920","Non.motorized",17,"Mon","weekday","no_sled","Kebler","2","2","1",8.4,0,38,0,22,22.1,-1,2,5,-1,-1,1,6,5
"8658",2020-02-10,"Kebler","w1920","Mechanized",0,"Mon","weekday","no_sled","Kebler","2","2","1",8.4,0,38,0,22,22.1,-1,2,5,-1,-1,1,6,5
"8659",2020-02-10,"Kebler","w1920","Motorized",16,"Mon","weekday","sled","Kebler","2","2","1",8.4,0,38,0,22,22.1,-1,2,5,-1,-1,1,6,5
"8660",2020-02-10,"Kebler","w1920","Hybrid",2,"Mon","weekday","sled","Kebler","2","2","1",8.4,0,38,0,22,22.1,-1,2,5,-1,-1,1,6,5
"8661",2020-02-11,"Kebler","w1920","Non.motorized",1,"Tue","weekday","no_sled","Kebler","2","2","2",8.5,0.1,40,2,16,21.2,0,-1,2,5,2,1,3,8
"8662",2020-02-11,"Kebler","w1920","Mechanized",0,"Tue","weekday","no_sled","Kebler","2","2","2",8.5,0.1,40,2,16,21.2,0,-1,2,5,2,1,3,8
"8663",2020-02-11,"Kebler","w1920","Motorized",36,"Tue","weekday","sled","Kebler","2","2","2",8.5,0.1,40,2,16,21.2,0,-1,2,5,2,1,3,8
"8664",2020-02-11,"Kebler","w1920","Hybrid",5,"Tue","weekday","sled","Kebler","2","2","2",8.5,0.1,40,2,16,21.2,0,-1,2,5,2,1,3,8
"8665",2020-02-12,"Kebler","w1920","Non.motorized",0,"Wed","weekday","no_sled","Kebler","2","2","2",8.5,0,39,-1,15,21.8,2,0,-1,2,1,1,0,2
"8666",2020-02-12,"Kebler","w1920","Mechanized",0,"Wed","weekday","no_sled","Kebler","2","2","2",8.5,0,39,-1,15,21.8,2,0,-1,2,1,1,0,2
"8667",2020-02-12,"Kebler","w1920","Motorized",23,"Wed","weekday","sled","Kebler","2","2","2",8.5,0,39,-1,15,21.8,2,0,-1,2,1,1,0,2
"8668",2020-02-12,"Kebler","w1920","Hybrid",0,"Wed","weekday","sled","Kebler","2","2","2",8.5,0,39,-1,15,21.8,2,0,-1,2,1,1,0,2
"8669",2020-02-13,"Kebler","w1920","Non.motorized",2,"Thu","weekday","no_sled","Kebler","2","2","1",8.5,0,39,0,18,21.8,-1,2,0,-1,-1,1,1,0
"8670",2020-02-13,"Kebler","w1920","Mechanized",0,"Thu","weekday","no_sled","Kebler","2","2","1",8.5,0,39,0,18,21.8,-1,2,0,-1,-1,1,1,0
"8671",2020-02-13,"Kebler","w1920","Motorized",28,"Thu","weekday","sled","Kebler","2","2","1",8.5,0,39,0,18,21.8,-1,2,0,-1,-1,1,1,0
"8672",2020-02-13,"Kebler","w1920","Hybrid",0,"Thu","weekday","sled","Kebler","2","2","1",8.5,0,39,0,18,21.8,-1,2,0,-1,-1,1,1,0
"8673",2020-02-14,"Kebler","w1920","Non.motorized",3,"Fri","weekday","no_sled","Kebler","2","1","1",8.6,0.1,38,-1,24,22.6,0,-1,2,0,-1,-2,0,0
"8674",2020-02-14,"Kebler","w1920","Mechanized",0,"Fri","weekday","no_sled","Kebler","2","1","1",8.6,0.1,38,-1,24,22.6,0,-1,2,0,-1,-2,0,0
"8675",2020-02-14,"Kebler","w1920","Motorized",33,"Fri","weekday","sled","Kebler","2","1","1",8.6,0.1,38,-1,24,22.6,0,-1,2,0,-1,-2,0,0
"8676",2020-02-14,"Kebler","w1920","Hybrid",4,"Fri","weekday","sled","Kebler","2","1","1",8.6,0.1,38,-1,24,22.6,0,-1,2,0,-1,-2,0,0
"8677",2020-02-15,"Kebler","w1920","Non.motorized",5,"Sat","weekend","no_sled","Kebler","1","1","1",8.6,0,38,0,26,22.6,-1,0,-1,2,-1,-1,-2,0
"8678",2020-02-15,"Kebler","w1920","Mechanized",0,"Sat","weekend","no_sled","Kebler","1","1","1",8.6,0,38,0,26,22.6,-1,0,-1,2,-1,-1,-2,0
"8679",2020-02-15,"Kebler","w1920","Motorized",35,"Sat","weekend","sled","Kebler","1","1","1",8.6,0,38,0,26,22.6,-1,0,-1,2,-1,-1,-2,0
"8680",2020-02-15,"Kebler","w1920","Hybrid",2,"Sat","weekend","sled","Kebler","1","1","1",8.6,0,38,0,26,22.6,-1,0,-1,2,-1,-1,-2,0
"8681",2020-02-16,"Kebler","w1920","Non.motorized",1,"Sun","weekend","no_sled","Kebler","1","1","1",8.8,0.2,37,-1,26,23.8,0,-1,0,-1,-1,-2,-2,-3
"8682",2020-02-16,"Kebler","w1920","Mechanized",1,"Sun","weekend","no_sled","Kebler","1","1","1",8.8,0.2,37,-1,26,23.8,0,-1,0,-1,-1,-2,-2,-3
"8683",2020-02-16,"Kebler","w1920","Motorized",51,"Sun","weekend","sled","Kebler","1","1","1",8.8,0.2,37,-1,26,23.8,0,-1,0,-1,-1,-2,-2,-3
"8684",2020-02-16,"Kebler","w1920","Hybrid",0,"Sun","weekend","sled","Kebler","1","1","1",8.8,0.2,37,-1,26,23.8,0,-1,0,-1,-1,-2,-2,-3
"8685",2020-02-17,"Kebler","w1920","Non.motorized",3,"Mon","weekday","no_sled","Kebler","2","1","1",9.2,0.4,43,6,25,21.4,-1,0,-1,0,5,5,4,4
"8686",2020-02-17,"Kebler","w1920","Mechanized",0,"Mon","weekday","no_sled","Kebler","2","1","1",9.2,0.4,43,6,25,21.4,-1,0,-1,0,5,5,4,4
"8687",2020-02-17,"Kebler","w1920","Motorized",9,"Mon","weekday","sled","Kebler","2","1","1",9.2,0.4,43,6,25,21.4,-1,0,-1,0,5,5,4,4
"8688",2020-02-17,"Kebler","w1920","Hybrid",0,"Mon","weekday","sled","Kebler","2","1","1",9.2,0.4,43,6,25,21.4,-1,0,-1,0,5,5,4,4
"8689",2020-02-18,"Kebler","w1920","Non.motorized",0,"Tue","weekday","no_sled","Kebler","1","1","1",9.3,0.1,42,-1,18,22.1,6,-1,0,-1,5,4,4,3
"8690",2020-02-18,"Kebler","w1920","Mechanized",0,"Tue","weekday","no_sled","Kebler","1","1","1",9.3,0.1,42,-1,18,22.1,6,-1,0,-1,5,4,4,3
"8691",2020-02-18,"Kebler","w1920","Motorized",27,"Tue","weekday","sled","Kebler","1","1","1",9.3,0.1,42,-1,18,22.1,6,-1,0,-1,5,4,4,3
"8692",2020-02-18,"Kebler","w1920","Hybrid",3,"Tue","weekday","sled","Kebler","1","1","1",9.3,0.1,42,-1,18,22.1,6,-1,0,-1,5,4,4,3
"8693",2020-02-19,"Kebler","w1920","Non.motorized",2,"Wed","weekday","no_sled","Kebler","1","1","1",9.3,0,41,-1,22,22.7,-1,6,-1,0,-2,4,3,3
"8694",2020-02-19,"Kebler","w1920","Mechanized",0,"Wed","weekday","no_sled","Kebler","1","1","1",9.3,0,41,-1,22,22.7,-1,6,-1,0,-2,4,3,3
"8695",2020-02-19,"Kebler","w1920","Motorized",40,"Wed","weekday","sled","Kebler","1","1","1",9.3,0,41,-1,22,22.7,-1,6,-1,0,-2,4,3,3
"8696",2020-02-19,"Kebler","w1920","Hybrid",1,"Wed","weekday","sled","Kebler","1","1","1",9.3,0,41,-1,22,22.7,-1,6,-1,0,-2,4,3,3
"8697",2020-02-20,"Kebler","w1920","Non.motorized",3,"Thu","weekday","no_sled","Kebler","1","1","1",9.3,0,41,0,18,22.7,-1,-1,6,-1,-1,-2,4,3
"8698",2020-02-20,"Kebler","w1920","Mechanized",1,"Thu","weekday","no_sled","Kebler","1","1","1",9.3,0,41,0,18,22.7,-1,-1,6,-1,-1,-2,4,3
"8699",2020-02-20,"Kebler","w1920","Motorized",47,"Thu","weekday","sled","Kebler","1","1","1",9.3,0,41,0,18,22.7,-1,-1,6,-1,-1,-2,4,3
"8700",2020-02-20,"Kebler","w1920","Hybrid",0,"Thu","weekday","sled","Kebler","1","1","1",9.3,0,41,0,18,22.7,-1,-1,6,-1,-1,-2,4,3
"8701",2020-02-21,"Kebler","w1920","Non.motorized",4,"Fri","weekday","no_sled","Kebler","1","1","1",9.3,0,40,-1,26,23.2,0,-1,-1,6,-1,-2,-3,3
"8702",2020-02-21,"Kebler","w1920","Mechanized",0,"Fri","weekday","no_sled","Kebler","1","1","1",9.3,0,40,-1,26,23.2,0,-1,-1,6,-1,-2,-3,3
"8703",2020-02-21,"Kebler","w1920","Motorized",80,"Fri","weekday","sled","Kebler","1","1","1",9.3,0,40,-1,26,23.2,0,-1,-1,6,-1,-2,-3,3
"8704",2020-02-21,"Kebler","w1920","Hybrid",3,"Fri","weekday","sled","Kebler","1","1","1",9.3,0,40,-1,26,23.2,0,-1,-1,6,-1,-2,-3,3
"8705",2020-02-22,"Kebler","w1920","Non.motorized",4,"Sat","weekend","no_sled","Kebler","1","1","1",9.4,0.1,39,-1,32,24.1,-1,0,-1,-1,-2,-2,-3,-4
"8706",2020-02-22,"Kebler","w1920","Mechanized",0,"Sat","weekend","no_sled","Kebler","1","1","1",9.4,0.1,39,-1,32,24.1,-1,0,-1,-1,-2,-2,-3,-4
"8707",2020-02-22,"Kebler","w1920","Motorized",86,"Sat","weekend","sled","Kebler","1","1","1",9.4,0.1,39,-1,32,24.1,-1,0,-1,-1,-2,-2,-3,-4
"8708",2020-02-22,"Kebler","w1920","Hybrid",9,"Sat","weekend","sled","Kebler","1","1","1",9.4,0.1,39,-1,32,24.1,-1,0,-1,-1,-2,-2,-3,-4
"8709",2020-02-23,"Kebler","w1920","Non.motorized",1,"Sun","weekend","no_sled","Kebler","2","2","2",9.5,0.1,40,1,27,23.8,-1,-1,0,-1,0,-1,-1,-2
"8710",2020-02-23,"Kebler","w1920","Mechanized",0,"Sun","weekend","no_sled","Kebler","2","2","2",9.5,0.1,40,1,27,23.8,-1,-1,0,-1,0,-1,-1,-2
"8711",2020-02-23,"Kebler","w1920","Motorized",25,"Sun","weekend","sled","Kebler","2","2","2",9.5,0.1,40,1,27,23.8,-1,-1,0,-1,0,-1,-1,-2
"8712",2020-02-23,"Kebler","w1920","Hybrid",0,"Sun","weekend","sled","Kebler","2","2","2",9.5,0.1,40,1,27,23.8,-1,-1,0,-1,0,-1,-1,-2
"8713",2020-02-24,"Kebler","w1920","Non.motorized",4,"Mon","weekday","no_sled","Kebler","3","3","2",9.8,0.3,43,3,17,22.8,1,-1,-1,0,4,3,2,2
"8714",2020-02-24,"Kebler","w1920","Mechanized",0,"Mon","weekday","no_sled","Kebler","3","3","2",9.8,0.3,43,3,17,22.8,1,-1,-1,0,4,3,2,2
"8715",2020-02-24,"Kebler","w1920","Motorized",10,"Mon","weekday","sled","Kebler","3","3","2",9.8,0.3,43,3,17,22.8,1,-1,-1,0,4,3,2,2
"8716",2020-02-24,"Kebler","w1920","Hybrid",1,"Mon","weekday","sled","Kebler","3","3","2",9.8,0.3,43,3,17,22.8,1,-1,-1,0,4,3,2,2
"8717",2020-02-25,"Kebler","w1920","Non.motorized",2,"Tue","weekday","no_sled","Kebler","2","2","1",9.8,0,43,0,8,22.8,3,1,-1,-1,3,4,3,2
"8718",2020-02-25,"Kebler","w1920","Mechanized",0,"Tue","weekday","no_sled","Kebler","2","2","1",9.8,0,43,0,8,22.8,3,1,-1,-1,3,4,3,2
"8719",2020-02-25,"Kebler","w1920","Motorized",35,"Tue","weekday","sled","Kebler","2","2","1",9.8,0,43,0,8,22.8,3,1,-1,-1,3,4,3,2
"8720",2020-02-25,"Kebler","w1920","Hybrid",5,"Tue","weekday","sled","Kebler","2","2","1",9.8,0,43,0,8,22.8,3,1,-1,-1,3,4,3,2
"8721",2020-02-26,"Kebler","w1920","Non.motorized",1,"Wed","weekday","no_sled","Kebler","2","2","1",9.8,0,42,-1,15,23.3,0,3,1,-1,-1,2,3,2
"8722",2020-02-26,"Kebler","w1920","Mechanized",0,"Wed","weekday","no_sled","Kebler","2","2","1",9.8,0,42,-1,15,23.3,0,3,1,-1,-1,2,3,2
"8723",2020-02-26,"Kebler","w1920","Motorized",42,"Wed","weekday","sled","Kebler","2","2","1",9.8,0,42,-1,15,23.3,0,3,1,-1,-1,2,3,2
"8724",2020-02-26,"Kebler","w1920","Hybrid",8,"Wed","weekday","sled","Kebler","2","2","1",9.8,0,42,-1,15,23.3,0,3,1,-1,-1,2,3,2
"8725",2020-02-27,"Kebler","w1920","Non.motorized",12,"Thu","weekday","no_sled","Kebler","2","2","1",9.9,0.1,41,-1,25,24.1,-1,0,3,1,-2,-2,1,2
"8726",2020-02-27,"Kebler","w1920","Mechanized",1,"Thu","weekday","no_sled","Kebler","2","2","1",9.9,0.1,41,-1,25,24.1,-1,0,3,1,-2,-2,1,2
"8727",2020-02-27,"Kebler","w1920","Motorized",56,"Thu","weekday","sled","Kebler","2","2","1",9.9,0.1,41,-1,25,24.1,-1,0,3,1,-2,-2,1,2
"8728",2020-02-27,"Kebler","w1920","Hybrid",14,"Thu","weekday","sled","Kebler","2","2","1",9.9,0.1,41,-1,25,24.1,-1,0,3,1,-2,-2,1,2
"8729",2020-02-28,"Kebler","w1920","Non.motorized",6,"Fri","weekday","no_sled","Kebler","2","1","1",9.9,0,41,0,28,24.1,-1,-1,0,3,-1,-2,-2,1
"8730",2020-02-28,"Kebler","w1920","Mechanized",0,"Fri","weekday","no_sled","Kebler","2","1","1",9.9,0,41,0,28,24.1,-1,-1,0,3,-1,-2,-2,1
"8731",2020-02-28,"Kebler","w1920","Motorized",86,"Fri","weekday","sled","Kebler","2","1","1",9.9,0,41,0,28,24.1,-1,-1,0,3,-1,-2,-2,1
"8732",2020-02-28,"Kebler","w1920","Hybrid",7,"Fri","weekday","sled","Kebler","2","1","1",9.9,0,41,0,28,24.1,-1,-1,0,3,-1,-2,-2,1
"8733",2020-02-29,"Kebler","w1920","Non.motorized",13,"Sat","weekend","no_sled","Kebler","1","1","1",9.9,0,40,-1,29,24.8,0,-1,-1,0,-1,-2,-3,-3
"8734",2020-02-29,"Kebler","w1920","Mechanized",1,"Sat","weekend","no_sled","Kebler","1","1","1",9.9,0,40,-1,29,24.8,0,-1,-1,0,-1,-2,-3,-3
"8735",2020-02-29,"Kebler","w1920","Motorized",147,"Sat","weekend","sled","Kebler","1","1","1",9.9,0,40,-1,29,24.8,0,-1,-1,0,-1,-2,-3,-3
"8736",2020-02-29,"Kebler","w1920","Hybrid",26,"Sat","weekend","sled","Kebler","1","1","1",9.9,0,40,-1,29,24.8,0,-1,-1,0,-1,-2,-3,-3
"8737",2020-03-01,"Kebler","w1920","Non.motorized",3,"Sun","weekend","no_sled","Kebler","1","1","1",10,0.1,40,0,28,25,-1,0,-1,-1,-1,-1,-2,-3
"8738",2020-03-01,"Kebler","w1920","Mechanized",2,"Sun","weekend","no_sled","Kebler","1","1","1",10,0.1,40,0,28,25,-1,0,-1,-1,-1,-1,-2,-3
"8739",2020-03-01,"Kebler","w1920","Motorized",83,"Sun","weekend","sled","Kebler","1","1","1",10,0.1,40,0,28,25,-1,0,-1,-1,-1,-1,-2,-3
"8740",2020-03-01,"Kebler","w1920","Hybrid",11,"Sun","weekend","sled","Kebler","1","1","1",10,0.1,40,0,28,25,-1,0,-1,-1,-1,-1,-2,-3
"8741",2020-03-02,"Kebler","w1920","Non.motorized",8,"Mon","weekday","no_sled","Kebler","2","2","1",10.4,0.4,45,5,25,23.1,0,-1,0,-1,5,4,4,3
"8742",2020-03-02,"Kebler","w1920","Mechanized",1,"Mon","weekday","no_sled","Kebler","2","2","1",10.4,0.4,45,5,25,23.1,0,-1,0,-1,5,4,4,3
"8743",2020-03-02,"Kebler","w1920","Motorized",62,"Mon","weekday","sled","Kebler","2","2","1",10.4,0.4,45,5,25,23.1,0,-1,0,-1,5,4,4,3
"8744",2020-03-02,"Kebler","w1920","Hybrid",0,"Mon","weekday","sled","Kebler","2","2","1",10.4,0.4,45,5,25,23.1,0,-1,0,-1,5,4,4,3
"8745",2020-03-03,"Kebler","w1920","Non.motorized",0,"Tue","weekday","no_sled","Kebler","2","1","1",10.9,0.5,50,5,25,21.8,5,0,-1,0,10,10,9,9
"8746",2020-03-03,"Kebler","w1920","Mechanized",0,"Tue","weekday","no_sled","Kebler","2","1","1",10.9,0.5,50,5,25,21.8,5,0,-1,0,10,10,9,9
"8747",2020-03-03,"Kebler","w1920","Motorized",10,"Tue","weekday","sled","Kebler","2","1","1",10.9,0.5,50,5,25,21.8,5,0,-1,0,10,10,9,9
"8748",2020-03-03,"Kebler","w1920","Hybrid",0,"Tue","weekday","sled","Kebler","2","1","1",10.9,0.5,50,5,25,21.8,5,0,-1,0,10,10,9,9
"8749",2020-03-04,"Kebler","w1920","Non.motorized",2,"Wed","weekday","no_sled","Kebler","2","1","1",10.9,0,48,-2,29,22.7,5,5,0,-1,3,8,8,7
"8750",2020-03-04,"Kebler","w1920","Mechanized",0,"Wed","weekday","no_sled","Kebler","2","1","1",10.9,0,48,-2,29,22.7,5,5,0,-1,3,8,8,7
"8751",2020-03-04,"Kebler","w1920","Motorized",8,"Wed","weekday","sled","Kebler","2","1","1",10.9,0,48,-2,29,22.7,5,5,0,-1,3,8,8,7
"8752",2020-03-04,"Kebler","w1920","Hybrid",0,"Wed","weekday","sled","Kebler","2","1","1",10.9,0,48,-2,29,22.7,5,5,0,-1,3,8,8,7
"8753",2020-03-05,"Kebler","w1920","Non.motorized",1,"Thu","weekday","no_sled","Kebler","2","1","1",10.9,0,46,-2,32,23.7,-2,5,5,0,-4,1,6,6
"8754",2020-03-05,"Kebler","w1920","Mechanized",0,"Thu","weekday","no_sled","Kebler","2","1","1",10.9,0,46,-2,32,23.7,-2,5,5,0,-4,1,6,6
"8755",2020-03-05,"Kebler","w1920","Motorized",57,"Thu","weekday","sled","Kebler","2","1","1",10.9,0,46,-2,32,23.7,-2,5,5,0,-4,1,6,6
"8756",2020-03-05,"Kebler","w1920","Hybrid",21,"Thu","weekday","sled","Kebler","2","1","1",10.9,0,46,-2,32,23.7,-2,5,5,0,-4,1,6,6
"8757",2020-03-06,"Kebler","w1920","Non.motorized",2,"Fri","weekday","no_sled","Kebler","1","1","1",10.9,0,45,-1,34,24.2,-2,-2,5,5,-3,-5,0,5
"8758",2020-03-06,"Kebler","w1920","Mechanized",0,"Fri","weekday","no_sled","Kebler","1","1","1",10.9,0,45,-1,34,24.2,-2,-2,5,5,-3,-5,0,5
"8759",2020-03-06,"Kebler","w1920","Motorized",87,"Fri","weekday","sled","Kebler","1","1","1",10.9,0,45,-1,34,24.2,-2,-2,5,5,-3,-5,0,5
"8760",2020-03-06,"Kebler","w1920","Hybrid",6,"Fri","weekday","sled","Kebler","1","1","1",10.9,0,45,-1,34,24.2,-2,-2,5,5,-3,-5,0,5
"8761",2020-03-07,"Kebler","w1920","Non.motorized",14,"Sat","weekend","no_sled","Kebler","1","1","2",10.9,0,44,-1,35,24.8,-1,-2,-2,5,-2,-4,-6,-1
"8762",2020-03-07,"Kebler","w1920","Mechanized",3,"Sat","weekend","no_sled","Kebler","1","1","2",10.9,0,44,-1,35,24.8,-1,-2,-2,5,-2,-4,-6,-1
"8763",2020-03-07,"Kebler","w1920","Motorized",92,"Sat","weekend","sled","Kebler","1","1","2",10.9,0,44,-1,35,24.8,-1,-2,-2,5,-2,-4,-6,-1
"8764",2020-03-07,"Kebler","w1920","Hybrid",16,"Sat","weekend","sled","Kebler","1","1","2",10.9,0,44,-1,35,24.8,-1,-2,-2,5,-2,-4,-6,-1
"8765",2020-03-08,"Kebler","w1920","Non.motorized",15,"Sun","weekend","no_sled","Kebler","1","1","1",11,0.1,43,-1,33,25.6,-1,-1,-2,-2,-2,-3,-5,-7
"8766",2020-03-08,"Kebler","w1920","Mechanized",0,"Sun","weekend","no_sled","Kebler","1","1","1",11,0.1,43,-1,33,25.6,-1,-1,-2,-2,-2,-3,-5,-7
"8767",2020-03-08,"Kebler","w1920","Motorized",60,"Sun","weekend","sled","Kebler","1","1","1",11,0.1,43,-1,33,25.6,-1,-1,-2,-2,-2,-3,-5,-7
"8768",2020-03-08,"Kebler","w1920","Hybrid",1,"Sun","weekend","sled","Kebler","1","1","1",11,0.1,43,-1,33,25.6,-1,-1,-2,-2,-2,-3,-5,-7
"8769",2020-03-09,"Kebler","w1920","Non.motorized",1,"Mon","weekday","no_sled","Kebler","1","1","1",11.1,0.1,42,-1,31,26.4,-1,-1,-1,-2,-2,-3,-4,-6
"8770",2020-03-09,"Kebler","w1920","Mechanized",0,"Mon","weekday","no_sled","Kebler","1","1","1",11.1,0.1,42,-1,31,26.4,-1,-1,-1,-2,-2,-3,-4,-6
"8771",2020-03-09,"Kebler","w1920","Motorized",47,"Mon","weekday","sled","Kebler","1","1","1",11.1,0.1,42,-1,31,26.4,-1,-1,-1,-2,-2,-3,-4,-6
"8772",2020-03-09,"Kebler","w1920","Hybrid",5,"Mon","weekday","sled","Kebler","1","1","1",11.1,0.1,42,-1,31,26.4,-1,-1,-1,-2,-2,-3,-4,-6
"8773",2020-03-10,"Kebler","w1920","Non.motorized",13,"Tue","weekday","no_sled","Kebler","1","1","2",11.2,0.1,44,2,31,25.5,-1,-1,-1,-1,1,0,-1,-2
"8774",2020-03-10,"Kebler","w1920","Mechanized",0,"Tue","weekday","no_sled","Kebler","1","1","2",11.2,0.1,44,2,31,25.5,-1,-1,-1,-1,1,0,-1,-2
"8775",2020-03-10,"Kebler","w1920","Motorized",102,"Tue","weekday","sled","Kebler","1","1","2",11.2,0.1,44,2,31,25.5,-1,-1,-1,-1,1,0,-1,-2
"8776",2020-03-10,"Kebler","w1920","Hybrid",11,"Tue","weekday","sled","Kebler","1","1","2",11.2,0.1,44,2,31,25.5,-1,-1,-1,-1,1,0,-1,-2
"8777",2020-03-11,"Kebler","w1920","Non.motorized",7,"Wed","weekday","no_sled","Kebler","2","2","1",11.2,0,44,0,32,25.5,2,-1,-1,-1,2,1,0,-1
"8778",2020-03-11,"Kebler","w1920","Mechanized",0,"Wed","weekday","no_sled","Kebler","2","2","1",11.2,0,44,0,32,25.5,2,-1,-1,-1,2,1,0,-1
"8779",2020-03-11,"Kebler","w1920","Motorized",136,"Wed","weekday","sled","Kebler","2","2","1",11.2,0,44,0,32,25.5,2,-1,-1,-1,2,1,0,-1
"8780",2020-03-11,"Kebler","w1920","Hybrid",10,"Wed","weekday","sled","Kebler","2","2","1",11.2,0,44,0,32,25.5,2,-1,-1,-1,2,1,0,-1
"8781",2020-03-12,"Kebler","w1920","Non.motorized",9,"Thu","weekday","no_sled","Kebler","2","2","2",11.4,0.2,42,-2,35,27.1,0,2,-1,-1,-2,0,-1,-2
"8782",2020-03-12,"Kebler","w1920","Mechanized",0,"Thu","weekday","no_sled","Kebler","2","2","2",11.4,0.2,42,-2,35,27.1,0,2,-1,-1,-2,0,-1,-2
"8783",2020-03-12,"Kebler","w1920","Motorized",114,"Thu","weekday","sled","Kebler","2","2","2",11.4,0.2,42,-2,35,27.1,0,2,-1,-1,-2,0,-1,-2
"8784",2020-03-12,"Kebler","w1920","Hybrid",7,"Thu","weekday","sled","Kebler","2","2","2",11.4,0.2,42,-2,35,27.1,0,2,-1,-1,-2,0,-1,-2
"8785",2020-03-13,"Kebler","w1920","Non.motorized",3,"Fri","weekday","no_sled","Kebler","3","3","2",11.5,0.1,44,2,31,26.1,-2,0,2,-1,0,0,2,1
"8786",2020-03-13,"Kebler","w1920","Mechanized",0,"Fri","weekday","no_sled","Kebler","3","3","2",11.5,0.1,44,2,31,26.1,-2,0,2,-1,0,0,2,1
"8787",2020-03-13,"Kebler","w1920","Motorized",62,"Fri","weekday","sled","Kebler","3","3","2",11.5,0.1,44,2,31,26.1,-2,0,2,-1,0,0,2,1
"8788",2020-03-13,"Kebler","w1920","Hybrid",15,"Fri","weekday","sled","Kebler","3","3","2",11.5,0.1,44,2,31,26.1,-2,0,2,-1,0,0,2,1
"8789",2020-03-14,"Kebler","w1920","Non.motorized",1,"Sat","weekend","no_sled","Kebler","3","3","3",11.7,0.2,44,0,31,26.6,2,-2,0,2,2,0,0,2
"8790",2020-03-14,"Kebler","w1920","Mechanized",0,"Sat","weekend","no_sled","Kebler","3","3","3",11.7,0.2,44,0,31,26.6,2,-2,0,2,2,0,0,2
"8791",2020-03-14,"Kebler","w1920","Motorized",26,"Sat","weekend","sled","Kebler","3","3","3",11.7,0.2,44,0,31,26.6,2,-2,0,2,2,0,0,2
"8792",2020-03-14,"Kebler","w1920","Hybrid",20,"Sat","weekend","sled","Kebler","3","3","3",11.7,0.2,44,0,31,26.6,2,-2,0,2,2,0,0,2
"8793",2020-03-15,"Kebler","w1920","Non.motorized",5,"Sun","weekend","no_sled","Kebler","2","2","2",11.7,0,45,1,33,26,0,2,-2,0,1,3,1,1
"8794",2020-03-15,"Kebler","w1920","Mechanized",1,"Sun","weekend","no_sled","Kebler","2","2","2",11.7,0,45,1,33,26,0,2,-2,0,1,3,1,1
"8795",2020-03-15,"Kebler","w1920","Motorized",75,"Sun","weekend","sled","Kebler","2","2","2",11.7,0,45,1,33,26,0,2,-2,0,1,3,1,1
"8796",2020-03-15,"Kebler","w1920","Hybrid",18,"Sun","weekend","sled","Kebler","2","2","2",11.7,0,45,1,33,26,0,2,-2,0,1,3,1,1
"8797",2020-03-16,"Kebler","w1920","Non.motorized",10,"Mon","weekday","no_sled","Kebler","2","2","2",11.7,0,45,0,35,26,1,0,2,-2,1,1,3,1
"8798",2020-03-16,"Kebler","w1920","Mechanized",1,"Mon","weekday","no_sled","Kebler","2","2","2",11.7,0,45,0,35,26,1,0,2,-2,1,1,3,1
"8799",2020-03-16,"Kebler","w1920","Motorized",199,"Mon","weekday","sled","Kebler","2","2","2",11.7,0,45,0,35,26,1,0,2,-2,1,1,3,1
"8800",2020-03-16,"Kebler","w1920","Hybrid",7,"Mon","weekday","sled","Kebler","2","2","2",11.7,0,45,0,35,26,1,0,2,-2,1,1,3,1
"8801",2020-03-17,"Kebler","w1920","Non.motorized",9,"Tue","weekday","no_sled","Kebler","2","2","2",11.7,0,44,-1,36,26.6,0,1,0,2,-1,0,0,2
"8802",2020-03-17,"Kebler","w1920","Mechanized",1,"Tue","weekday","no_sled","Kebler","2","2","2",11.7,0,44,-1,36,26.6,0,1,0,2,-1,0,0,2
"8803",2020-03-17,"Kebler","w1920","Motorized",169,"Tue","weekday","sled","Kebler","2","2","2",11.7,0,44,-1,36,26.6,0,1,0,2,-1,0,0,2
"8804",2020-03-17,"Kebler","w1920","Hybrid",15,"Tue","weekday","sled","Kebler","2","2","2",11.7,0,44,-1,36,26.6,0,1,0,2,-1,0,0,2
"8805",2020-03-18,"Kebler","w1920","Non.motorized",13,"Wed","weekday","no_sled","Kebler","2","2","2",11.7,0,43,-1,33,27.2,-1,0,1,0,-2,-2,-1,-1
"8806",2020-03-18,"Kebler","w1920","Mechanized",0,"Wed","weekday","no_sled","Kebler","2","2","2",11.7,0,43,-1,33,27.2,-1,0,1,0,-2,-2,-1,-1
"8807",2020-03-18,"Kebler","w1920","Motorized",53,"Wed","weekday","sled","Kebler","2","2","2",11.7,0,43,-1,33,27.2,-1,0,1,0,-2,-2,-1,-1
"8808",2020-03-18,"Kebler","w1920","Hybrid",12,"Wed","weekday","sled","Kebler","2","2","2",11.7,0,43,-1,33,27.2,-1,0,1,0,-2,-2,-1,-1
"8809",2020-03-19,"Kebler","w1920","Non.motorized",30,"Thu","weekday","no_sled","Kebler","3","3","3",11.8,0.1,43,0,27,27.4,-1,-1,0,1,-1,-2,-2,-1
"8810",2020-03-19,"Kebler","w1920","Mechanized",1,"Thu","weekday","no_sled","Kebler","3","3","3",11.8,0.1,43,0,27,27.4,-1,-1,0,1,-1,-2,-2,-1
"8811",2020-03-19,"Kebler","w1920","Motorized",44,"Thu","weekday","sled","Kebler","3","3","3",11.8,0.1,43,0,27,27.4,-1,-1,0,1,-1,-2,-2,-1
"8812",2020-03-19,"Kebler","w1920","Hybrid",3,"Thu","weekday","sled","Kebler","3","3","3",11.8,0.1,43,0,27,27.4,-1,-1,0,1,-1,-2,-2,-1
"8813",2020-03-20,"Kebler","w1920","Non.motorized",26,"Fri","weekday","no_sled","Kebler","3","3","2",12.7,0.9,52,9,26,24.4,0,-1,-1,0,9,8,7,7
"8814",2020-03-20,"Kebler","w1920","Mechanized",2,"Fri","weekday","no_sled","Kebler","3","3","2",12.7,0.9,52,9,26,24.4,0,-1,-1,0,9,8,7,7
"8815",2020-03-20,"Kebler","w1920","Motorized",46,"Fri","weekday","sled","Kebler","3","3","2",12.7,0.9,52,9,26,24.4,0,-1,-1,0,9,8,7,7
"8816",2020-03-20,"Kebler","w1920","Hybrid",13,"Fri","weekday","sled","Kebler","3","3","2",12.7,0.9,52,9,26,24.4,0,-1,-1,0,9,8,7,7
"8817",2020-03-21,"Kebler","w1920","Non.motorized",29,"Sat","weekend","no_sled","Kebler","3","3","2",12.8,0.1,54,2,26,23.7,9,0,-1,-1,11,11,10,9
"8818",2020-03-21,"Kebler","w1920","Mechanized",0,"Sat","weekend","no_sled","Kebler","3","3","2",12.8,0.1,54,2,26,23.7,9,0,-1,-1,11,11,10,9
"8819",2020-03-21,"Kebler","w1920","Motorized",49,"Sat","weekend","sled","Kebler","3","3","2",12.8,0.1,54,2,26,23.7,9,0,-1,-1,11,11,10,9
"8820",2020-03-21,"Kebler","w1920","Hybrid",30,"Sat","weekend","sled","Kebler","3","3","2",12.8,0.1,54,2,26,23.7,9,0,-1,-1,11,11,10,9
"8821",2020-03-22,"Kebler","w1920","Non.motorized",10,"Sun","weekend","no_sled","Kebler","2","2","2",13,0.2,53,-1,28,24.5,2,9,0,-1,1,10,10,9
"8822",2020-03-22,"Kebler","w1920","Mechanized",0,"Sun","weekend","no_sled","Kebler","2","2","2",13,0.2,53,-1,28,24.5,2,9,0,-1,1,10,10,9
"8823",2020-03-22,"Kebler","w1920","Motorized",40,"Sun","weekend","sled","Kebler","2","2","2",13,0.2,53,-1,28,24.5,2,9,0,-1,1,10,10,9
"8824",2020-03-22,"Kebler","w1920","Hybrid",15,"Sun","weekend","sled","Kebler","2","2","2",13,0.2,53,-1,28,24.5,2,9,0,-1,1,10,10,9
"8825",2020-03-23,"Kebler","w1920","Non.motorized",7,"Mon","weekday","no_sled","Kebler","2","2","2",13,0,53,0,28,24.5,-1,2,9,0,-1,1,10,10
"8826",2020-03-23,"Kebler","w1920","Mechanized",1,"Mon","weekday","no_sled","Kebler","2","2","2",13,0,53,0,28,24.5,-1,2,9,0,-1,1,10,10
"8827",2020-03-23,"Kebler","w1920","Motorized",40,"Mon","weekday","sled","Kebler","2","2","2",13,0,53,0,28,24.5,-1,2,9,0,-1,1,10,10
"8828",2020-03-23,"Kebler","w1920","Hybrid",11,"Mon","weekday","sled","Kebler","2","2","2",13,0,53,0,28,24.5,-1,2,9,0,-1,1,10,10
"8829",2020-03-24,"Kebler","w1920","Non.motorized",5,"Tue","weekday","no_sled","Kebler","2","2","2",13.2,0.2,53,0,32,24.9,0,-1,2,9,0,-1,1,10
"8830",2020-03-24,"Kebler","w1920","Mechanized",3,"Tue","weekday","no_sled","Kebler","2","2","2",13.2,0.2,53,0,32,24.9,0,-1,2,9,0,-1,1,10
"8831",2020-03-24,"Kebler","w1920","Motorized",58,"Tue","weekday","sled","Kebler","2","2","2",13.2,0.2,53,0,32,24.9,0,-1,2,9,0,-1,1,10
"8832",2020-03-24,"Kebler","w1920","Hybrid",12,"Tue","weekday","sled","Kebler","2","2","2",13.2,0.2,53,0,32,24.9,0,-1,2,9,0,-1,1,10
"8833",2020-03-25,"Kebler","w1920","Non.motorized",14,"Wed","weekday","no_sled","Kebler","2","2","2",13.3,0.1,51,-2,34,26.1,0,0,-1,2,-2,-2,-3,-1
"8834",2020-03-25,"Kebler","w1920","Mechanized",0,"Wed","weekday","no_sled","Kebler","2","2","2",13.3,0.1,51,-2,34,26.1,0,0,-1,2,-2,-2,-3,-1
"8835",2020-03-25,"Kebler","w1920","Motorized",68,"Wed","weekday","sled","Kebler","2","2","2",13.3,0.1,51,-2,34,26.1,0,0,-1,2,-2,-2,-3,-1
"8836",2020-03-25,"Kebler","w1920","Hybrid",14,"Wed","weekday","sled","Kebler","2","2","2",13.3,0.1,51,-2,34,26.1,0,0,-1,2,-2,-2,-3,-1
"8837",2020-03-26,"Kebler","w1920","Non.motorized",12,"Thu","weekday","no_sled","Kebler","2","2","2",13.3,0,50,-1,36,26.6,-2,0,0,-1,-3,-3,-3,-4
"8838",2020-03-26,"Kebler","w1920","Non.motorized",12,"Thu","weekday","no_sled","Kebler","3","3","2",13.3,0,50,-1,36,26.6,-2,0,0,-1,-3,-3,-3,-4
"8839",2020-03-26,"Kebler","w1920","Mechanized",0,"Thu","weekday","no_sled","Kebler","2","2","2",13.3,0,50,-1,36,26.6,-2,0,0,-1,-3,-3,-3,-4
"8840",2020-03-26,"Kebler","w1920","Mechanized",0,"Thu","weekday","no_sled","Kebler","3","3","2",13.3,0,50,-1,36,26.6,-2,0,0,-1,-3,-3,-3,-4
"8841",2020-03-26,"Kebler","w1920","Motorized",95,"Thu","weekday","sled","Kebler","2","2","2",13.3,0,50,-1,36,26.6,-2,0,0,-1,-3,-3,-3,-4
"8842",2020-03-26,"Kebler","w1920","Motorized",95,"Thu","weekday","sled","Kebler","3","3","2",13.3,0,50,-1,36,26.6,-2,0,0,-1,-3,-3,-3,-4
"8843",2020-03-26,"Kebler","w1920","Hybrid",12,"Thu","weekday","sled","Kebler","2","2","2",13.3,0,50,-1,36,26.6,-2,0,0,-1,-3,-3,-3,-4
"8844",2020-03-26,"Kebler","w1920","Hybrid",12,"Thu","weekday","sled","Kebler","3","3","2",13.3,0,50,-1,36,26.6,-2,0,0,-1,-3,-3,-3,-4
"8845",2020-03-27,"Kebler","w1920","Non.motorized",11,"Fri","weekday","no_sled","Kebler","3","3","2",13.3,0,50,0,23,26.6,-1,-2,0,0,-1,-3,-3,-3
"8846",2020-03-27,"Kebler","w1920","Mechanized",0,"Fri","weekday","no_sled","Kebler","3","3","2",13.3,0,50,0,23,26.6,-1,-2,0,0,-1,-3,-3,-3
"8847",2020-03-27,"Kebler","w1920","Motorized",53,"Fri","weekday","sled","Kebler","3","3","2",13.3,0,50,0,23,26.6,-1,-2,0,0,-1,-3,-3,-3
"8848",2020-03-27,"Kebler","w1920","Hybrid",7,"Fri","weekday","sled","Kebler","3","3","2",13.3,0,50,0,23,26.6,-1,-2,0,0,-1,-3,-3,-3
"8849",2020-03-28,"Kebler","w1920","Non.motorized",4,"Sat","weekend","no_sled","Kebler","3","3","3",13.3,0,50,0,18,26.6,0,-1,-2,0,0,-1,-3,-3
"8850",2020-03-28,"Kebler","w1920","Mechanized",0,"Sat","weekend","no_sled","Kebler","3","3","3",13.3,0,50,0,18,26.6,0,-1,-2,0,0,-1,-3,-3
"8851",2020-03-28,"Kebler","w1920","Motorized",46,"Sat","weekend","sled","Kebler","3","3","3",13.3,0,50,0,18,26.6,0,-1,-2,0,0,-1,-3,-3
"8852",2020-03-28,"Kebler","w1920","Hybrid",41,"Sat","weekend","sled","Kebler","3","3","3",13.3,0,50,0,18,26.6,0,-1,-2,0,0,-1,-3,-3
"8853",2020-03-29,"Kebler","w1920","Non.motorized",4,"Sun","weekend","no_sled","Kebler","2","2","2",13.3,0,49,-1,24,27.1,0,0,-1,-2,-1,-1,-2,-4
"8854",2020-03-29,"Kebler","w1920","Mechanized",0,"Sun","weekend","no_sled","Kebler","2","2","2",13.3,0,49,-1,24,27.1,0,0,-1,-2,-1,-1,-2,-4
"8855",2020-03-29,"Kebler","w1920","Motorized",11,"Sun","weekend","sled","Kebler","2","2","2",13.3,0,49,-1,24,27.1,0,0,-1,-2,-1,-1,-2,-4
"8856",2020-03-29,"Kebler","w1920","Hybrid",35,"Sun","weekend","sled","Kebler","2","2","2",13.3,0,49,-1,24,27.1,0,0,-1,-2,-1,-1,-2,-4
"8857",2020-03-30,"Kebler","w1920","Non.motorized",8,"Mon","weekday","no_sled","Kebler","2","2","2",13.4,0.1,49,0,29,27.3,-1,0,0,-1,-1,-1,-1,-2
"8858",2020-03-30,"Kebler","w1920","Mechanized",0,"Mon","weekday","no_sled","Kebler","2","2","2",13.4,0.1,49,0,29,27.3,-1,0,0,-1,-1,-1,-1,-2
"8859",2020-03-30,"Kebler","w1920","Motorized",49,"Mon","weekday","sled","Kebler","2","2","2",13.4,0.1,49,0,29,27.3,-1,0,0,-1,-1,-1,-1,-2
"8860",2020-03-30,"Kebler","w1920","Hybrid",19,"Mon","weekday","sled","Kebler","2","2","2",13.4,0.1,49,0,29,27.3,-1,0,0,-1,-1,-1,-1,-2
"8861",2020-03-31,"Kebler","w1920","Non.motorized",7,"Tue","weekday","no_sled","Kebler","2","2","2",13.6,0.2,51,2,35,26.7,0,-1,0,0,2,1,1,1
"8862",2020-03-31,"Kebler","w1920","Mechanized",0,"Tue","weekday","no_sled","Kebler","2","2","2",13.6,0.2,51,2,35,26.7,0,-1,0,0,2,1,1,1
"8863",2020-03-31,"Kebler","w1920","Motorized",20,"Tue","weekday","sled","Kebler","2","2","2",13.6,0.2,51,2,35,26.7,0,-1,0,0,2,1,1,1
"8864",2020-03-31,"Kebler","w1920","Hybrid",20,"Tue","weekday","sled","Kebler","2","2","2",13.6,0.2,51,2,35,26.7,0,-1,0,0,2,1,1,1
"8865",2020-04-01,"Kebler","w1920","Non.motorized",2,"Wed","weekday","no_sled","Kebler","2","2","2",13.6,0,47,-4,39,28.9,2,0,-1,0,-2,-2,-3,-3
"8866",2020-04-01,"Kebler","w1920","Mechanized",0,"Wed","weekday","no_sled","Kebler","2","2","2",13.6,0,47,-4,39,28.9,2,0,-1,0,-2,-2,-3,-3
"8867",2020-04-01,"Kebler","w1920","Motorized",23,"Wed","weekday","sled","Kebler","2","2","2",13.6,0,47,-4,39,28.9,2,0,-1,0,-2,-2,-3,-3
"8868",2020-04-01,"Kebler","w1920","Hybrid",15,"Wed","weekday","sled","Kebler","2","2","2",13.6,0,47,-4,39,28.9,2,0,-1,0,-2,-2,-3,-3
"8869",2020-04-02,"Kebler","w1920","Non.motorized",17,"Thu","weekday","no_sled","Kebler","2","2","2",13.6,0,46,-1,31,29.6,-4,2,0,-1,-5,-3,-3,-4
"8870",2020-04-02,"Kebler","w1920","Mechanized",0,"Thu","weekday","no_sled","Kebler","2","2","2",13.6,0,46,-1,31,29.6,-4,2,0,-1,-5,-3,-3,-4
"8871",2020-04-02,"Kebler","w1920","Motorized",37,"Thu","weekday","sled","Kebler","2","2","2",13.6,0,46,-1,31,29.6,-4,2,0,-1,-5,-3,-3,-4
"8872",2020-04-02,"Kebler","w1920","Hybrid",14,"Thu","weekday","sled","Kebler","2","2","2",13.6,0,46,-1,31,29.6,-4,2,0,-1,-5,-3,-3,-4
"8873",2020-04-03,"Kebler","w1920","Non.motorized",0,"Fri","weekday","no_sled","Kebler","2","2","2",13.6,0,46,0,28,29.6,-1,-4,2,0,-1,-5,-3,-3
"8874",2020-04-03,"Kebler","w1920","Mechanized",0,"Fri","weekday","no_sled","Kebler","2","2","2",13.6,0,46,0,28,29.6,-1,-4,2,0,-1,-5,-3,-3
"8875",2020-04-03,"Kebler","w1920","Motorized",3,"Fri","weekday","sled","Kebler","2","2","2",13.6,0,46,0,28,29.6,-1,-4,2,0,-1,-5,-3,-3
"8876",2020-04-03,"Kebler","w1920","Hybrid",8,"Fri","weekday","sled","Kebler","2","2","2",13.6,0,46,0,28,29.6,-1,-4,2,0,-1,-5,-3,-3
"8877",2020-04-04,"Kebler","w1920","Non.motorized",0,"Sat","weekend","no_sled","Kebler","2","2","2",13.6,0,45,-1,33,30.2,0,-1,-4,2,-1,-2,-6,-4
"8878",2020-04-04,"Kebler","w1920","Mechanized",0,"Sat","weekend","no_sled","Kebler","2","2","2",13.6,0,45,-1,33,30.2,0,-1,-4,2,-1,-2,-6,-4
"8879",2020-04-04,"Kebler","w1920","Motorized",4,"Sat","weekend","sled","Kebler","2","2","2",13.6,0,45,-1,33,30.2,0,-1,-4,2,-1,-2,-6,-4
"8880",2020-04-04,"Kebler","w1920","Hybrid",11,"Sat","weekend","sled","Kebler","2","2","2",13.6,0,45,-1,33,30.2,0,-1,-4,2,-1,-2,-6,-4
"8881",2020-04-05,"Kebler","w1920","Non.motorized",2,"Sun","weekend","no_sled","Kebler","2","2","3",13.6,0,45,0,38,30.2,-1,0,-1,-4,-1,-1,-2,-6
"8882",2020-04-05,"Kebler","w1920","Mechanized",0,"Sun","weekend","no_sled","Kebler","2","2","3",13.6,0,45,0,38,30.2,-1,0,-1,-4,-1,-1,-2,-6
"8883",2020-04-05,"Kebler","w1920","Motorized",8,"Sun","weekend","sled","Kebler","2","2","3",13.6,0,45,0,38,30.2,-1,0,-1,-4,-1,-1,-2,-6
"8884",2020-04-05,"Kebler","w1920","Hybrid",13,"Sun","weekend","sled","Kebler","2","2","3",13.6,0,45,0,38,30.2,-1,0,-1,-4,-1,-1,-2,-6
"8885",2020-04-06,"Kebler","w1920","Non.motorized",1,"Mon","weekday","no_sled","Kebler","2","2","3",13.6,0,44,-1,40,30.9,0,-1,0,-1,-1,-2,-2,-3
"8886",2020-04-06,"Kebler","w1920","Mechanized",0,"Mon","weekday","no_sled","Kebler","2","2","3",13.6,0,44,-1,40,30.9,0,-1,0,-1,-1,-2,-2,-3
"8887",2020-04-06,"Kebler","w1920","Motorized",7,"Mon","weekday","sled","Kebler","2","2","3",13.6,0,44,-1,40,30.9,0,-1,0,-1,-1,-2,-2,-3
"8888",2020-04-06,"Kebler","w1920","Hybrid",4,"Mon","weekday","sled","Kebler","2","2","3",13.6,0,44,-1,40,30.9,0,-1,0,-1,-1,-2,-2,-3
"8889",2020-04-07,"Kebler","w1920","Non.motorized",5,"Tue","weekday","no_sled","Kebler","2","2","3",13.4,-0.2,43,-1,39,31.2,-1,0,-1,0,-2,-2,-3,-3
"8890",2020-04-07,"Kebler","w1920","Mechanized",1,"Tue","weekday","no_sled","Kebler","2","2","3",13.4,-0.2,43,-1,39,31.2,-1,0,-1,0,-2,-2,-3,-3
"8891",2020-04-07,"Kebler","w1920","Motorized",12,"Tue","weekday","sled","Kebler","2","2","3",13.4,-0.2,43,-1,39,31.2,-1,0,-1,0,-2,-2,-3,-3
"8892",2020-04-07,"Kebler","w1920","Hybrid",3,"Tue","weekday","sled","Kebler","2","2","3",13.4,-0.2,43,-1,39,31.2,-1,0,-1,0,-2,-2,-3,-3
"8893",2020-04-08,"Kebler","w1920","Non.motorized",2,"Wed","weekday","no_sled","Kebler","2","3","3",13.3,-0.1,42,-1,40,31.7,-1,-1,0,-1,-2,-3,-3,-4
"8894",2020-04-08,"Kebler","w1920","Mechanized",0,"Wed","weekday","no_sled","Kebler","2","3","3",13.3,-0.1,42,-1,40,31.7,-1,-1,0,-1,-2,-3,-3,-4
"8895",2020-04-08,"Kebler","w1920","Motorized",32,"Wed","weekday","sled","Kebler","2","3","3",13.3,-0.1,42,-1,40,31.7,-1,-1,0,-1,-2,-3,-3,-4
"8896",2020-04-08,"Kebler","w1920","Hybrid",6,"Wed","weekday","sled","Kebler","2","3","3",13.3,-0.1,42,-1,40,31.7,-1,-1,0,-1,-2,-3,-3,-4
"8897",2020-04-09,"Kebler","w1920","Non.motorized",4,"Thu","weekday","no_sled","Kebler","2","3","3",13.1,-0.2,40,-2,42,32.8,-1,-1,-1,0,-3,-4,-5,-5
"8898",2020-04-09,"Kebler","w1920","Mechanized",0,"Thu","weekday","no_sled","Kebler","2","3","3",13.1,-0.2,40,-2,42,32.8,-1,-1,-1,0,-3,-4,-5,-5
"8899",2020-04-09,"Kebler","w1920","Motorized",17,"Thu","weekday","sled","Kebler","2","3","3",13.1,-0.2,40,-2,42,32.8,-1,-1,-1,0,-3,-4,-5,-5
"8900",2020-04-09,"Kebler","w1920","Hybrid",3,"Thu","weekday","sled","Kebler","2","3","3",13.1,-0.2,40,-2,42,32.8,-1,-1,-1,0,-3,-4,-5,-5
"8901",2020-04-10,"Kebler","w1920","Non.motorized",2,"Fri","weekday","no_sled","Kebler","3","3","3",12.9,-0.2,39,-1,38,33.1,-2,-1,-1,-1,-3,-4,-5,-6
"8902",2020-04-10,"Kebler","w1920","Mechanized",0,"Fri","weekday","no_sled","Kebler","3","3","3",12.9,-0.2,39,-1,38,33.1,-2,-1,-1,-1,-3,-4,-5,-6
"8903",2020-04-10,"Kebler","w1920","Motorized",6,"Fri","weekday","sled","Kebler","3","3","3",12.9,-0.2,39,-1,38,33.1,-2,-1,-1,-1,-3,-4,-5,-6
"8904",2020-04-10,"Kebler","w1920","Hybrid",3,"Fri","weekday","sled","Kebler","3","3","3",12.9,-0.2,39,-1,38,33.1,-2,-1,-1,-1,-3,-4,-5,-6
"8905",2020-04-11,"Kebler","w1920","Non.motorized",3,"Sat","weekend","no_sled","Kebler","2","3","3",12.9,0,39,0,36,33.1,-1,-2,-1,-1,-1,-3,-4,-5
"8906",2020-04-11,"Kebler","w1920","Mechanized",1,"Sat","weekend","no_sled","Kebler","2","3","3",12.9,0,39,0,36,33.1,-1,-2,-1,-1,-1,-3,-4,-5
"8907",2020-04-11,"Kebler","w1920","Motorized",47,"Sat","weekend","sled","Kebler","2","3","3",12.9,0,39,0,36,33.1,-1,-2,-1,-1,-1,-3,-4,-5
"8908",2020-04-11,"Kebler","w1920","Hybrid",5,"Sat","weekend","sled","Kebler","2","3","3",12.9,0,39,0,36,33.1,-1,-2,-1,-1,-1,-3,-4,-5
"8909",2020-04-12,"Kebler","w1920","Non.motorized",5,"Sun","weekend","no_sled","Kebler","2","2","2",12.8,-0.1,38,-1,29,33.7,0,-1,-2,-1,-1,-2,-4,-5
"8910",2020-04-12,"Kebler","w1920","Mechanized",1,"Sun","weekend","no_sled","Kebler","2","2","2",12.8,-0.1,38,-1,29,33.7,0,-1,-2,-1,-1,-2,-4,-5
"8911",2020-04-12,"Kebler","w1920","Motorized",30,"Sun","weekend","sled","Kebler","2","2","2",12.8,-0.1,38,-1,29,33.7,0,-1,-2,-1,-1,-2,-4,-5
"8912",2020-04-12,"Kebler","w1920","Hybrid",24,"Sun","weekend","sled","Kebler","2","2","2",12.8,-0.1,38,-1,29,33.7,0,-1,-2,-1,-1,-2,-4,-5
"8913",2020-04-13,"Kebler","w1920","Non.motorized",3,"Mon","weekday","no_sled","Kebler",NA,NA,NA,12.9,0.1,39,1,20,33.1,-1,0,-1,-2,0,0,-1,-3
"8914",2020-04-13,"Kebler","w1920","Mechanized",0,"Mon","weekday","no_sled","Kebler",NA,NA,NA,12.9,0.1,39,1,20,33.1,-1,0,-1,-2,0,0,-1,-3
"8915",2020-04-13,"Kebler","w1920","Motorized",28,"Mon","weekday","sled","Kebler",NA,NA,NA,12.9,0.1,39,1,20,33.1,-1,0,-1,-2,0,0,-1,-3
"8916",2020-04-13,"Kebler","w1920","Hybrid",18,"Mon","weekday","sled","Kebler",NA,NA,NA,12.9,0.1,39,1,20,33.1,-1,0,-1,-2,0,0,-1,-3
"8917",2020-04-14,"Kebler","w1920","Non.motorized",6,"Tue","weekday","no_sled","Kebler","2","2","2",13,0.1,39,0,18,33.3,1,-1,0,-1,1,0,0,-1
"8918",2020-04-14,"Kebler","w1920","Mechanized",0,"Tue","weekday","no_sled","Kebler","2","2","2",13,0.1,39,0,18,33.3,1,-1,0,-1,1,0,0,-1
"8919",2020-04-14,"Kebler","w1920","Motorized",25,"Tue","weekday","sled","Kebler","2","2","2",13,0.1,39,0,18,33.3,1,-1,0,-1,1,0,0,-1
"8920",2020-04-14,"Kebler","w1920","Hybrid",12,"Tue","weekday","sled","Kebler","2","2","2",13,0.1,39,0,18,33.3,1,-1,0,-1,1,0,0,-1
"8921",2020-04-15,"Kebler","w1920","Non.motorized",8,"Wed","weekday","no_sled","Kebler",NA,NA,NA,13.2,0.2,39,0,28,33.8,0,1,-1,0,0,1,0,0
"8922",2020-04-15,"Kebler","w1920","Mechanized",0,"Wed","weekday","no_sled","Kebler",NA,NA,NA,13.2,0.2,39,0,28,33.8,0,1,-1,0,0,1,0,0
"8923",2020-04-15,"Kebler","w1920","Motorized",19,"Wed","weekday","sled","Kebler",NA,NA,NA,13.2,0.2,39,0,28,33.8,0,1,-1,0,0,1,0,0
"8924",2020-04-15,"Kebler","w1920","Hybrid",8,"Wed","weekday","sled","Kebler",NA,NA,NA,13.2,0.2,39,0,28,33.8,0,1,-1,0,0,1,0,0
"8925",2019-12-06,"Slate River Rd","w1920","Non.motorized",4,"Fri","weekday","no_sled","Slate River Rd","2","2","1",2.9,0.4,19,5,24,15.3,0,0,0,0,5,5,5,5
"8926",2019-12-06,"Slate River Rd","w1920","Mechanized",0,"Fri","weekday","no_sled","Slate River Rd","2","2","1",2.9,0.4,19,5,24,15.3,0,0,0,0,5,5,5,5
"8927",2019-12-06,"Slate River Rd","w1920","Motorized",3,"Fri","weekday","sled","Slate River Rd","2","2","1",2.9,0.4,19,5,24,15.3,0,0,0,0,5,5,5,5
"8928",2019-12-06,"Slate River Rd","w1920","Hybrid",2,"Fri","weekday","sled","Slate River Rd","2","2","1",2.9,0.4,19,5,24,15.3,0,0,0,0,5,5,5,5
"8929",2019-12-07,"Slate River Rd","w1920","Non.motorized",35,"Sat","weekend","no_sled","Slate River Rd","2","2","1",3,0.1,18,-1,29,16.7,5,0,0,0,4,4,4,4
"8930",2019-12-07,"Slate River Rd","w1920","Mechanized",1,"Sat","weekend","no_sled","Slate River Rd","2","2","1",3,0.1,18,-1,29,16.7,5,0,0,0,4,4,4,4
"8931",2019-12-07,"Slate River Rd","w1920","Motorized",5,"Sat","weekend","sled","Slate River Rd","2","2","1",3,0.1,18,-1,29,16.7,5,0,0,0,4,4,4,4
"8932",2019-12-07,"Slate River Rd","w1920","Hybrid",9,"Sat","weekend","sled","Slate River Rd","2","2","1",3,0.1,18,-1,29,16.7,5,0,0,0,4,4,4,4
"8933",2019-12-08,"Slate River Rd","w1920","Non.motorized",6,"Sun","weekend","no_sled","Slate River Rd","2","2","1",3,0,17,-1,28,17.6,-1,5,0,0,-2,3,3,3
"8934",2019-12-08,"Slate River Rd","w1920","Mechanized",1,"Sun","weekend","no_sled","Slate River Rd","2","2","1",3,0,17,-1,28,17.6,-1,5,0,0,-2,3,3,3
"8935",2019-12-08,"Slate River Rd","w1920","Motorized",2,"Sun","weekend","sled","Slate River Rd","2","2","1",3,0,17,-1,28,17.6,-1,5,0,0,-2,3,3,3
"8936",2019-12-08,"Slate River Rd","w1920","Hybrid",4,"Sun","weekend","sled","Slate River Rd","2","2","1",3,0,17,-1,28,17.6,-1,5,0,0,-2,3,3,3
"8937",2019-12-09,"Slate River Rd","w1920","Non.motorized",10,"Mon","weekday","no_sled","Slate River Rd","3","3","2",3.4,0.4,22,5,21,15.5,-1,-1,5,0,4,3,8,8
"8938",2019-12-09,"Slate River Rd","w1920","Mechanized",0,"Mon","weekday","no_sled","Slate River Rd","3","3","2",3.4,0.4,22,5,21,15.5,-1,-1,5,0,4,3,8,8
"8939",2019-12-09,"Slate River Rd","w1920","Motorized",0,"Mon","weekday","sled","Slate River Rd","3","3","2",3.4,0.4,22,5,21,15.5,-1,-1,5,0,4,3,8,8
"8940",2019-12-09,"Slate River Rd","w1920","Hybrid",6,"Mon","weekday","sled","Slate River Rd","3","3","2",3.4,0.4,22,5,21,15.5,-1,-1,5,0,4,3,8,8
"8941",2019-12-10,"Slate River Rd","w1920","Non.motorized",19,"Tue","weekday","no_sled","Slate River Rd","2","2","2",3.4,0,21,-1,19,16.2,5,-1,-1,5,4,3,2,7
"8942",2019-12-10,"Slate River Rd","w1920","Mechanized",0,"Tue","weekday","no_sled","Slate River Rd","2","2","2",3.4,0,21,-1,19,16.2,5,-1,-1,5,4,3,2,7
"8943",2019-12-10,"Slate River Rd","w1920","Motorized",0,"Tue","weekday","sled","Slate River Rd","2","2","2",3.4,0,21,-1,19,16.2,5,-1,-1,5,4,3,2,7
"8944",2019-12-10,"Slate River Rd","w1920","Hybrid",3,"Tue","weekday","sled","Slate River Rd","2","2","2",3.4,0,21,-1,19,16.2,5,-1,-1,5,4,3,2,7
"8945",2019-12-11,"Slate River Rd","w1920","Non.motorized",9,"Wed","weekday","no_sled","Slate River Rd","2","2","2",3.4,0,20,-1,22,17,-1,5,-1,-1,-2,3,2,1
"8946",2019-12-11,"Slate River Rd","w1920","Mechanized",0,"Wed","weekday","no_sled","Slate River Rd","2","2","2",3.4,0,20,-1,22,17,-1,5,-1,-1,-2,3,2,1
"8947",2019-12-11,"Slate River Rd","w1920","Motorized",0,"Wed","weekday","sled","Slate River Rd","2","2","2",3.4,0,20,-1,22,17,-1,5,-1,-1,-2,3,2,1
"8948",2019-12-11,"Slate River Rd","w1920","Hybrid",5,"Wed","weekday","sled","Slate River Rd","2","2","2",3.4,0,20,-1,22,17,-1,5,-1,-1,-2,3,2,1
"8949",2019-12-12,"Slate River Rd","w1920","Non.motorized",18,"Thu","weekday","no_sled","Slate River Rd","2","2","2",3.4,0,19,-1,25,17.9,-1,-1,5,-1,-2,-3,2,1
"8950",2019-12-12,"Slate River Rd","w1920","Mechanized",0,"Thu","weekday","no_sled","Slate River Rd","2","2","2",3.4,0,19,-1,25,17.9,-1,-1,5,-1,-2,-3,2,1
"8951",2019-12-12,"Slate River Rd","w1920","Motorized",0,"Thu","weekday","sled","Slate River Rd","2","2","2",3.4,0,19,-1,25,17.9,-1,-1,5,-1,-2,-3,2,1
"8952",2019-12-12,"Slate River Rd","w1920","Hybrid",4,"Thu","weekday","sled","Slate River Rd","2","2","2",3.4,0,19,-1,25,17.9,-1,-1,5,-1,-2,-3,2,1
"8953",2019-12-13,"Slate River Rd","w1920","Non.motorized",3,"Fri","weekday","no_sled","Slate River Rd","2","2","2",3.8,0.4,21,2,24,18.1,-1,-1,-1,5,1,0,-1,4
"8954",2019-12-13,"Slate River Rd","w1920","Mechanized",0,"Fri","weekday","no_sled","Slate River Rd","2","2","2",3.8,0.4,21,2,24,18.1,-1,-1,-1,5,1,0,-1,4
"8955",2019-12-13,"Slate River Rd","w1920","Motorized",1,"Fri","weekday","sled","Slate River Rd","2","2","2",3.8,0.4,21,2,24,18.1,-1,-1,-1,5,1,0,-1,4
"8956",2019-12-13,"Slate River Rd","w1920","Hybrid",1,"Fri","weekday","sled","Slate River Rd","2","2","2",3.8,0.4,21,2,24,18.1,-1,-1,-1,5,1,0,-1,4
"8957",2019-12-14,"Slate River Rd","w1920","Non.motorized",12,"Sat","weekend","no_sled","Slate River Rd","3","3","3",4.2,0.4,27,6,25,15.6,2,-1,-1,-1,8,7,6,5
"8958",2019-12-14,"Slate River Rd","w1920","Mechanized",0,"Sat","weekend","no_sled","Slate River Rd","3","3","3",4.2,0.4,27,6,25,15.6,2,-1,-1,-1,8,7,6,5
"8959",2019-12-14,"Slate River Rd","w1920","Motorized",1,"Sat","weekend","sled","Slate River Rd","3","3","3",4.2,0.4,27,6,25,15.6,2,-1,-1,-1,8,7,6,5
"8960",2019-12-14,"Slate River Rd","w1920","Hybrid",0,"Sat","weekend","sled","Slate River Rd","3","3","3",4.2,0.4,27,6,25,15.6,2,-1,-1,-1,8,7,6,5
"8961",2019-12-15,"Slate River Rd","w1920","Non.motorized",14,"Sun","weekend","no_sled","Slate River Rd","3","3","2",4.8,0.6,31,4,17,15.5,6,2,-1,-1,10,12,11,10
"8962",2019-12-15,"Slate River Rd","w1920","Mechanized",0,"Sun","weekend","no_sled","Slate River Rd","3","3","2",4.8,0.6,31,4,17,15.5,6,2,-1,-1,10,12,11,10
"8963",2019-12-15,"Slate River Rd","w1920","Motorized",0,"Sun","weekend","sled","Slate River Rd","3","3","2",4.8,0.6,31,4,17,15.5,6,2,-1,-1,10,12,11,10
"8964",2019-12-15,"Slate River Rd","w1920","Hybrid",3,"Sun","weekend","sled","Slate River Rd","3","3","2",4.8,0.6,31,4,17,15.5,6,2,-1,-1,10,12,11,10
"8965",2019-12-16,"Slate River Rd","w1920","Non.motorized",6,"Mon","weekday","no_sled","Slate River Rd","3","3","2",4.8,0,29,-2,6,16.6,4,6,2,-1,2,8,10,9
"8966",2019-12-16,"Slate River Rd","w1920","Mechanized",0,"Mon","weekday","no_sled","Slate River Rd","3","3","2",4.8,0,29,-2,6,16.6,4,6,2,-1,2,8,10,9
"8967",2019-12-16,"Slate River Rd","w1920","Motorized",1,"Mon","weekday","sled","Slate River Rd","3","3","2",4.8,0,29,-2,6,16.6,4,6,2,-1,2,8,10,9
"8968",2019-12-16,"Slate River Rd","w1920","Hybrid",3,"Mon","weekday","sled","Slate River Rd","3","3","2",4.8,0,29,-2,6,16.6,4,6,2,-1,2,8,10,9
"8969",2019-12-17,"Slate River Rd","w1920","Non.motorized",6,"Tue","weekday","no_sled","Slate River Rd","2","2","1",4.8,0,27,-2,8,17.8,-2,4,6,2,-4,0,6,8
"8970",2019-12-17,"Slate River Rd","w1920","Mechanized",0,"Tue","weekday","no_sled","Slate River Rd","2","2","1",4.8,0,27,-2,8,17.8,-2,4,6,2,-4,0,6,8
"8971",2019-12-17,"Slate River Rd","w1920","Motorized",1,"Tue","weekday","sled","Slate River Rd","2","2","1",4.8,0,27,-2,8,17.8,-2,4,6,2,-4,0,6,8
"8972",2019-12-17,"Slate River Rd","w1920","Hybrid",1,"Tue","weekday","sled","Slate River Rd","2","2","1",4.8,0,27,-2,8,17.8,-2,4,6,2,-4,0,6,8
"8973",2019-12-18,"Slate River Rd","w1920","Non.motorized",15,"Wed","weekday","no_sled","Slate River Rd","2","2","1",4.8,0,26,-1,20,18.5,-2,-2,4,6,-3,-5,-1,5
"8974",2019-12-18,"Slate River Rd","w1920","Mechanized",0,"Wed","weekday","no_sled","Slate River Rd","2","2","1",4.8,0,26,-1,20,18.5,-2,-2,4,6,-3,-5,-1,5
"8975",2019-12-18,"Slate River Rd","w1920","Motorized",0,"Wed","weekday","sled","Slate River Rd","2","2","1",4.8,0,26,-1,20,18.5,-2,-2,4,6,-3,-5,-1,5
"8976",2019-12-18,"Slate River Rd","w1920","Hybrid",7,"Wed","weekday","sled","Slate River Rd","2","2","1",4.8,0,26,-1,20,18.5,-2,-2,4,6,-3,-5,-1,5
"8977",2019-12-19,"Slate River Rd","w1920","Non.motorized",16,"Thu","weekday","no_sled","Slate River Rd","2","2","1",4.9,0.1,25,-1,21,19.6,-1,-2,-2,4,-2,-4,-6,-2
"8978",2019-12-19,"Slate River Rd","w1920","Mechanized",0,"Thu","weekday","no_sled","Slate River Rd","2","2","1",4.9,0.1,25,-1,21,19.6,-1,-2,-2,4,-2,-4,-6,-2
"8979",2019-12-19,"Slate River Rd","w1920","Motorized",1,"Thu","weekday","sled","Slate River Rd","2","2","1",4.9,0.1,25,-1,21,19.6,-1,-2,-2,4,-2,-4,-6,-2
"8980",2019-12-19,"Slate River Rd","w1920","Hybrid",3,"Thu","weekday","sled","Slate River Rd","2","2","1",4.9,0.1,25,-1,21,19.6,-1,-2,-2,4,-2,-4,-6,-2
"8981",2019-12-20,"Slate River Rd","w1920","Non.motorized",12,"Fri","weekday","no_sled","Slate River Rd","2","2","1",4.9,0,24,-1,21,20.4,-1,-1,-2,-2,-2,-3,-5,-7
"8982",2019-12-20,"Slate River Rd","w1920","Mechanized",1,"Fri","weekday","no_sled","Slate River Rd","2","2","1",4.9,0,24,-1,21,20.4,-1,-1,-2,-2,-2,-3,-5,-7
"8983",2019-12-20,"Slate River Rd","w1920","Motorized",2,"Fri","weekday","sled","Slate River Rd","2","2","1",4.9,0,24,-1,21,20.4,-1,-1,-2,-2,-2,-3,-5,-7
"8984",2019-12-20,"Slate River Rd","w1920","Hybrid",4,"Fri","weekday","sled","Slate River Rd","2","2","1",4.9,0,24,-1,21,20.4,-1,-1,-2,-2,-2,-3,-5,-7
"8985",2019-12-21,"Slate River Rd","w1920","Non.motorized",24,"Sat","weekend","no_sled","Slate River Rd","2","2","1",4.9,0,24,0,27,20.4,-1,-1,-1,-2,-1,-2,-3,-5
"8986",2019-12-21,"Slate River Rd","w1920","Mechanized",0,"Sat","weekend","no_sled","Slate River Rd","2","2","1",4.9,0,24,0,27,20.4,-1,-1,-1,-2,-1,-2,-3,-5
"8987",2019-12-21,"Slate River Rd","w1920","Motorized",3,"Sat","weekend","sled","Slate River Rd","2","2","1",4.9,0,24,0,27,20.4,-1,-1,-1,-2,-1,-2,-3,-5
"8988",2019-12-21,"Slate River Rd","w1920","Hybrid",7,"Sat","weekend","sled","Slate River Rd","2","2","1",4.9,0,24,0,27,20.4,-1,-1,-1,-2,-1,-2,-3,-5
"8989",2019-12-22,"Slate River Rd","w1920","Non.motorized",40,"Sun","weekend","no_sled","Slate River Rd","2","2","1",5,0.1,23,-1,31,21.7,0,-1,-1,-1,-1,-2,-3,-4
"8990",2019-12-22,"Slate River Rd","w1920","Mechanized",0,"Sun","weekend","no_sled","Slate River Rd","2","2","1",5,0.1,23,-1,31,21.7,0,-1,-1,-1,-1,-2,-3,-4
"8991",2019-12-22,"Slate River Rd","w1920","Motorized",2,"Sun","weekend","sled","Slate River Rd","2","2","1",5,0.1,23,-1,31,21.7,0,-1,-1,-1,-1,-2,-3,-4
"8992",2019-12-22,"Slate River Rd","w1920","Hybrid",13,"Sun","weekend","sled","Slate River Rd","2","2","1",5,0.1,23,-1,31,21.7,0,-1,-1,-1,-1,-2,-3,-4
"8993",2019-12-23,"Slate River Rd","w1920","Non.motorized",26,"Mon","weekday","no_sled","Slate River Rd","2","1","1",5,0,23,0,34,21.7,-1,0,-1,-1,-1,-1,-2,-3
"8994",2019-12-23,"Slate River Rd","w1920","Mechanized",0,"Mon","weekday","no_sled","Slate River Rd","2","1","1",5,0,23,0,34,21.7,-1,0,-1,-1,-1,-1,-2,-3
"8995",2019-12-23,"Slate River Rd","w1920","Motorized",0,"Mon","weekday","sled","Slate River Rd","2","1","1",5,0,23,0,34,21.7,-1,0,-1,-1,-1,-1,-2,-3
"8996",2019-12-23,"Slate River Rd","w1920","Hybrid",3,"Mon","weekday","sled","Slate River Rd","2","1","1",5,0,23,0,34,21.7,-1,0,-1,-1,-1,-1,-2,-3
"8997",2019-12-24,"Slate River Rd","w1920","Non.motorized",29,"Tue","weekday","no_sled","Slate River Rd","2","1","1",5,0,22,-1,30,22.7,0,-1,0,-1,-1,-2,-2,-3
"8998",2019-12-24,"Slate River Rd","w1920","Mechanized",1,"Tue","weekday","no_sled","Slate River Rd","2","1","1",5,0,22,-1,30,22.7,0,-1,0,-1,-1,-2,-2,-3
"8999",2019-12-24,"Slate River Rd","w1920","Motorized",1,"Tue","weekday","sled","Slate River Rd","2","1","1",5,0,22,-1,30,22.7,0,-1,0,-1,-1,-2,-2,-3
"9000",2019-12-24,"Slate River Rd","w1920","Hybrid",4,"Tue","weekday","sled","Slate River Rd","2","1","1",5,0,22,-1,30,22.7,0,-1,0,-1,-1,-2,-2,-3
"9001",2019-12-25,"Slate River Rd","w1920","Non.motorized",31,"Wed","weekday","no_sled","Slate River Rd","2","2","2",5,0,23,1,22,21.7,-1,0,-1,0,0,0,-1,-1
"9002",2019-12-25,"Slate River Rd","w1920","Mechanized",0,"Wed","weekday","no_sled","Slate River Rd","2","2","2",5,0,23,1,22,21.7,-1,0,-1,0,0,0,-1,-1
"9003",2019-12-25,"Slate River Rd","w1920","Motorized",1,"Wed","weekday","sled","Slate River Rd","2","2","2",5,0,23,1,22,21.7,-1,0,-1,0,0,0,-1,-1
"9004",2019-12-25,"Slate River Rd","w1920","Hybrid",5,"Wed","weekday","sled","Slate River Rd","2","2","2",5,0,23,1,22,21.7,-1,0,-1,0,0,0,-1,-1
"9005",2019-12-26,"Slate River Rd","w1920","Non.motorized",42,"Thu","weekday","no_sled","Slate River Rd","2","2","1",5,0,23,0,17,21.7,1,-1,0,-1,1,0,0,-1
"9006",2019-12-26,"Slate River Rd","w1920","Mechanized",0,"Thu","weekday","no_sled","Slate River Rd","2","2","1",5,0,23,0,17,21.7,1,-1,0,-1,1,0,0,-1
"9007",2019-12-26,"Slate River Rd","w1920","Motorized",0,"Thu","weekday","sled","Slate River Rd","2","2","1",5,0,23,0,17,21.7,1,-1,0,-1,1,0,0,-1
"9008",2019-12-26,"Slate River Rd","w1920","Hybrid",4,"Thu","weekday","sled","Slate River Rd","2","2","1",5,0,23,0,17,21.7,1,-1,0,-1,1,0,0,-1
"9009",2019-12-27,"Slate River Rd","w1920","Non.motorized",29,"Fri","weekday","no_sled","Slate River Rd","3","3","2",5.1,0.1,24,1,22,21.2,0,1,-1,0,1,2,1,1
"9010",2019-12-27,"Slate River Rd","w1920","Mechanized",0,"Fri","weekday","no_sled","Slate River Rd","3","3","2",5.1,0.1,24,1,22,21.2,0,1,-1,0,1,2,1,1
"9011",2019-12-27,"Slate River Rd","w1920","Motorized",0,"Fri","weekday","sled","Slate River Rd","3","3","2",5.1,0.1,24,1,22,21.2,0,1,-1,0,1,2,1,1
"9012",2019-12-27,"Slate River Rd","w1920","Hybrid",8,"Fri","weekday","sled","Slate River Rd","3","3","2",5.1,0.1,24,1,22,21.2,0,1,-1,0,1,2,1,1
"9013",2019-12-28,"Slate River Rd","w1920","Non.motorized",25,"Sat","weekend","no_sled","Slate River Rd","3","3","2",5.6,0.5,30,6,16,18.7,1,0,1,-1,7,7,8,7
"9014",2019-12-28,"Slate River Rd","w1920","Mechanized",0,"Sat","weekend","no_sled","Slate River Rd","3","3","2",5.6,0.5,30,6,16,18.7,1,0,1,-1,7,7,8,7
"9015",2019-12-28,"Slate River Rd","w1920","Motorized",0,"Sat","weekend","sled","Slate River Rd","3","3","2",5.6,0.5,30,6,16,18.7,1,0,1,-1,7,7,8,7
"9016",2019-12-28,"Slate River Rd","w1920","Hybrid",5,"Sat","weekend","sled","Slate River Rd","3","3","2",5.6,0.5,30,6,16,18.7,1,0,1,-1,7,7,8,7
"9017",2019-12-29,"Slate River Rd","w1920","Non.motorized",32,"Sun","weekend","no_sled","Slate River Rd","3","3","2",5.6,0,29,-1,3,19.3,6,1,0,1,5,6,6,7
"9018",2019-12-29,"Slate River Rd","w1920","Mechanized",0,"Sun","weekend","no_sled","Slate River Rd","3","3","2",5.6,0,29,-1,3,19.3,6,1,0,1,5,6,6,7
"9019",2019-12-29,"Slate River Rd","w1920","Motorized",0,"Sun","weekend","sled","Slate River Rd","3","3","2",5.6,0,29,-1,3,19.3,6,1,0,1,5,6,6,7
"9020",2019-12-29,"Slate River Rd","w1920","Hybrid",16,"Sun","weekend","sled","Slate River Rd","3","3","2",5.6,0,29,-1,3,19.3,6,1,0,1,5,6,6,7
"9021",2019-12-30,"Slate River Rd","w1920","Non.motorized",NA,"Mon","weekday","no_sled","Slate River Rd","3","3","2",5.6,0,28,-1,3,20,-1,6,1,0,-2,4,5,5
"9022",2019-12-30,"Slate River Rd","w1920","Mechanized",NA,"Mon","weekday","no_sled","Slate River Rd","3","3","2",5.6,0,28,-1,3,20,-1,6,1,0,-2,4,5,5
"9023",2019-12-30,"Slate River Rd","w1920","Motorized",NA,"Mon","weekday","sled","Slate River Rd","3","3","2",5.6,0,28,-1,3,20,-1,6,1,0,-2,4,5,5
"9024",2019-12-30,"Slate River Rd","w1920","Hybrid",NA,"Mon","weekday","sled","Slate River Rd","3","3","2",5.6,0,28,-1,3,20,-1,6,1,0,-2,4,5,5
"9025",2019-12-31,"Slate River Rd","w1920","Non.motorized",NA,"Tue","weekday","no_sled","Slate River Rd","2","2","1",5.6,0,28,0,13,20,-1,-1,6,1,-1,-2,4,5
"9026",2019-12-31,"Slate River Rd","w1920","Mechanized",NA,"Tue","weekday","no_sled","Slate River Rd","2","2","1",5.6,0,28,0,13,20,-1,-1,6,1,-1,-2,4,5
"9027",2019-12-31,"Slate River Rd","w1920","Motorized",NA,"Tue","weekday","sled","Slate River Rd","2","2","1",5.6,0,28,0,13,20,-1,-1,6,1,-1,-2,4,5
"9028",2019-12-31,"Slate River Rd","w1920","Hybrid",NA,"Tue","weekday","sled","Slate River Rd","2","2","1",5.6,0,28,0,13,20,-1,-1,6,1,-1,-2,4,5
"9029",2020-01-01,"Slate River Rd","w1920","Non.motorized",NA,"Wed","weekday","no_sled","Slate River Rd","2","1","1",5.6,0,27,-1,21,20.7,0,-1,-1,6,-1,-2,-3,3
"9030",2020-01-01,"Slate River Rd","w1920","Mechanized",NA,"Wed","weekday","no_sled","Slate River Rd","2","1","1",5.6,0,27,-1,21,20.7,0,-1,-1,6,-1,-2,-3,3
"9031",2020-01-01,"Slate River Rd","w1920","Motorized",NA,"Wed","weekday","sled","Slate River Rd","2","1","1",5.6,0,27,-1,21,20.7,0,-1,-1,6,-1,-2,-3,3
"9032",2020-01-01,"Slate River Rd","w1920","Hybrid",NA,"Wed","weekday","sled","Slate River Rd","2","1","1",5.6,0,27,-1,21,20.7,0,-1,-1,6,-1,-2,-3,3
"9033",2020-01-02,"Slate River Rd","w1920","Non.motorized",NA,"Thu","weekday","no_sled","Slate River Rd","3","3","2",5.9,0.3,29,2,16,20.3,-1,0,-1,-1,1,1,0,-1
"9034",2020-01-02,"Slate River Rd","w1920","Mechanized",NA,"Thu","weekday","no_sled","Slate River Rd","3","3","2",5.9,0.3,29,2,16,20.3,-1,0,-1,-1,1,1,0,-1
"9035",2020-01-02,"Slate River Rd","w1920","Motorized",NA,"Thu","weekday","sled","Slate River Rd","3","3","2",5.9,0.3,29,2,16,20.3,-1,0,-1,-1,1,1,0,-1
"9036",2020-01-02,"Slate River Rd","w1920","Hybrid",NA,"Thu","weekday","sled","Slate River Rd","3","3","2",5.9,0.3,29,2,16,20.3,-1,0,-1,-1,1,1,0,-1
"9037",2020-01-03,"Slate River Rd","w1920","Non.motorized",NA,"Fri","weekday","no_sled","Slate River Rd","3","2","1",5.9,0,31,2,19,19,2,-1,0,-1,4,3,3,2
"9038",2020-01-03,"Slate River Rd","w1920","Mechanized",NA,"Fri","weekday","no_sled","Slate River Rd","3","2","1",5.9,0,31,2,19,19,2,-1,0,-1,4,3,3,2
"9039",2020-01-03,"Slate River Rd","w1920","Motorized",NA,"Fri","weekday","sled","Slate River Rd","3","2","1",5.9,0,31,2,19,19,2,-1,0,-1,4,3,3,2
"9040",2020-01-03,"Slate River Rd","w1920","Hybrid",NA,"Fri","weekday","sled","Slate River Rd","3","2","1",5.9,0,31,2,19,19,2,-1,0,-1,4,3,3,2
"9041",2020-01-04,"Slate River Rd","w1920","Non.motorized",NA,"Sat","weekend","no_sled","Slate River Rd","2","2","1",5.9,0,30,-1,26,19.7,2,2,-1,0,1,3,2,2
"9042",2020-01-04,"Slate River Rd","w1920","Mechanized",NA,"Sat","weekend","no_sled","Slate River Rd","2","2","1",5.9,0,30,-1,26,19.7,2,2,-1,0,1,3,2,2
"9043",2020-01-04,"Slate River Rd","w1920","Motorized",NA,"Sat","weekend","sled","Slate River Rd","2","2","1",5.9,0,30,-1,26,19.7,2,2,-1,0,1,3,2,2
"9044",2020-01-04,"Slate River Rd","w1920","Hybrid",NA,"Sat","weekend","sled","Slate River Rd","2","2","1",5.9,0,30,-1,26,19.7,2,2,-1,0,1,3,2,2
"9045",2020-01-05,"Slate River Rd","w1920","Non.motorized",NA,"Sun","weekend","no_sled","Slate River Rd","2","2","1",5.9,0,28,-2,23,21.1,-1,2,2,-1,-3,-1,1,0
"9046",2020-01-05,"Slate River Rd","w1920","Mechanized",NA,"Sun","weekend","no_sled","Slate River Rd","2","2","1",5.9,0,28,-2,23,21.1,-1,2,2,-1,-3,-1,1,0
"9047",2020-01-05,"Slate River Rd","w1920","Motorized",NA,"Sun","weekend","sled","Slate River Rd","2","2","1",5.9,0,28,-2,23,21.1,-1,2,2,-1,-3,-1,1,0
"9048",2020-01-05,"Slate River Rd","w1920","Hybrid",NA,"Sun","weekend","sled","Slate River Rd","2","2","1",5.9,0,28,-2,23,21.1,-1,2,2,-1,-3,-1,1,0
"9049",2020-01-06,"Slate River Rd","w1920","Non.motorized",NA,"Mon","weekday","no_sled","Slate River Rd","2","2","1",5.9,0,28,0,15,21.1,-2,-1,2,2,-2,-3,-1,1
"9050",2020-01-06,"Slate River Rd","w1920","Mechanized",NA,"Mon","weekday","no_sled","Slate River Rd","2","2","1",5.9,0,28,0,15,21.1,-2,-1,2,2,-2,-3,-1,1
"9051",2020-01-06,"Slate River Rd","w1920","Motorized",NA,"Mon","weekday","sled","Slate River Rd","2","2","1",5.9,0,28,0,15,21.1,-2,-1,2,2,-2,-3,-1,1
"9052",2020-01-06,"Slate River Rd","w1920","Hybrid",NA,"Mon","weekday","sled","Slate River Rd","2","2","1",5.9,0,28,0,15,21.1,-2,-1,2,2,-2,-3,-1,1
"9053",2020-01-07,"Slate River Rd","w1920","Non.motorized",NA,"Tue","weekday","no_sled","Slate River Rd","2","1","1",5.9,0,28,0,22,21.1,0,-2,-1,2,0,-2,-3,-1
"9054",2020-01-07,"Slate River Rd","w1920","Mechanized",NA,"Tue","weekday","no_sled","Slate River Rd","2","1","1",5.9,0,28,0,22,21.1,0,-2,-1,2,0,-2,-3,-1
"9055",2020-01-07,"Slate River Rd","w1920","Motorized",NA,"Tue","weekday","sled","Slate River Rd","2","1","1",5.9,0,28,0,22,21.1,0,-2,-1,2,0,-2,-3,-1
"9056",2020-01-07,"Slate River Rd","w1920","Hybrid",NA,"Tue","weekday","sled","Slate River Rd","2","1","1",5.9,0,28,0,22,21.1,0,-2,-1,2,0,-2,-3,-1
"9057",2020-01-08,"Slate River Rd","w1920","Non.motorized",NA,"Wed","weekday","no_sled","Slate River Rd","2","1","1",6,0.1,28,0,23,21.4,0,0,-2,-1,0,0,-2,-3
"9058",2020-01-08,"Slate River Rd","w1920","Mechanized",NA,"Wed","weekday","no_sled","Slate River Rd","2","1","1",6,0.1,28,0,23,21.4,0,0,-2,-1,0,0,-2,-3
"9059",2020-01-08,"Slate River Rd","w1920","Motorized",NA,"Wed","weekday","sled","Slate River Rd","2","1","1",6,0.1,28,0,23,21.4,0,0,-2,-1,0,0,-2,-3
"9060",2020-01-08,"Slate River Rd","w1920","Hybrid",NA,"Wed","weekday","sled","Slate River Rd","2","1","1",6,0.1,28,0,23,21.4,0,0,-2,-1,0,0,-2,-3
"9061",2020-01-07,"Slate River Rd","w1920","Non.motorized",NA,"Tue","weekday","no_sled","Slate River Rd","2","1","1",5.9,0,28,0,22,21.1,0,-2,-1,2,0,-2,-3,-1
"9062",2020-01-07,"Slate River Rd","w1920","Mechanized",NA,"Tue","weekday","no_sled","Slate River Rd","2","1","1",5.9,0,28,0,22,21.1,0,-2,-1,2,0,-2,-3,-1
"9063",2020-01-07,"Slate River Rd","w1920","Motorized",NA,"Tue","weekday","sled","Slate River Rd","2","1","1",5.9,0,28,0,22,21.1,0,-2,-1,2,0,-2,-3,-1
"9064",2020-01-07,"Slate River Rd","w1920","Hybrid",NA,"Tue","weekday","sled","Slate River Rd","2","1","1",5.9,0,28,0,22,21.1,0,-2,-1,2,0,-2,-3,-1
"9065",2020-01-08,"Slate River Rd","w1920","Non.motorized",NA,"Wed","weekday","no_sled","Slate River Rd","2","1","1",6,0.1,28,0,23,21.4,0,0,-2,-1,0,0,-2,-3
"9066",2020-01-08,"Slate River Rd","w1920","Mechanized",NA,"Wed","weekday","no_sled","Slate River Rd","2","1","1",6,0.1,28,0,23,21.4,0,0,-2,-1,0,0,-2,-3
"9067",2020-01-08,"Slate River Rd","w1920","Motorized",NA,"Wed","weekday","sled","Slate River Rd","2","1","1",6,0.1,28,0,23,21.4,0,0,-2,-1,0,0,-2,-3
"9068",2020-01-08,"Slate River Rd","w1920","Hybrid",NA,"Wed","weekday","sled","Slate River Rd","2","1","1",6,0.1,28,0,23,21.4,0,0,-2,-1,0,0,-2,-3
"9069",2020-01-09,"Slate River Rd","w1920","Non.motorized",NA,"Thu","weekday","no_sled","Slate River Rd","2","1","1",6,0,27,-1,17,22.2,0,0,0,-2,-1,-1,-1,-3
"9070",2020-01-09,"Slate River Rd","w1920","Mechanized",NA,"Thu","weekday","no_sled","Slate River Rd","2","1","1",6,0,27,-1,17,22.2,0,0,0,-2,-1,-1,-1,-3
"9071",2020-01-09,"Slate River Rd","w1920","Motorized",NA,"Thu","weekday","sled","Slate River Rd","2","1","1",6,0,27,-1,17,22.2,0,0,0,-2,-1,-1,-1,-3
"9072",2020-01-09,"Slate River Rd","w1920","Hybrid",NA,"Thu","weekday","sled","Slate River Rd","2","1","1",6,0,27,-1,17,22.2,0,0,0,-2,-1,-1,-1,-3
"9073",2020-01-10,"Slate River Rd","w1920","Non.motorized",NA,"Fri","weekday","no_sled","Slate River Rd","2","1","1",6,0,29,2,11,20.7,-1,0,0,0,1,1,1,1
"9074",2020-01-10,"Slate River Rd","w1920","Mechanized",NA,"Fri","weekday","no_sled","Slate River Rd","2","1","1",6,0,29,2,11,20.7,-1,0,0,0,1,1,1,1
"9075",2020-01-10,"Slate River Rd","w1920","Motorized",NA,"Fri","weekday","sled","Slate River Rd","2","1","1",6,0,29,2,11,20.7,-1,0,0,0,1,1,1,1
"9076",2020-01-10,"Slate River Rd","w1920","Hybrid",NA,"Fri","weekday","sled","Slate River Rd","2","1","1",6,0,29,2,11,20.7,-1,0,0,0,1,1,1,1
"9077",2020-01-11,"Slate River Rd","w1920","Non.motorized",13,"Sat","weekend","no_sled","Slate River Rd","2","1","1",6,0,29,0,12,20.7,2,-1,0,0,2,1,1,1
"9078",2020-01-11,"Slate River Rd","w1920","Mechanized",0,"Sat","weekend","no_sled","Slate River Rd","2","1","1",6,0,29,0,12,20.7,2,-1,0,0,2,1,1,1
"9079",2020-01-11,"Slate River Rd","w1920","Motorized",0,"Sat","weekend","sled","Slate River Rd","2","1","1",6,0,29,0,12,20.7,2,-1,0,0,2,1,1,1
"9080",2020-01-11,"Slate River Rd","w1920","Hybrid",0,"Sat","weekend","sled","Slate River Rd","2","1","1",6,0,29,0,12,20.7,2,-1,0,0,2,1,1,1
"9081",2020-01-12,"Slate River Rd","w1920","Non.motorized",33,"Sun","weekend","no_sled","Slate River Rd","2","1","1",6.1,0.1,29,0,13,21,0,2,-1,0,0,2,1,1
"9082",2020-01-12,"Slate River Rd","w1920","Mechanized",0,"Sun","weekend","no_sled","Slate River Rd","2","1","1",6.1,0.1,29,0,13,21,0,2,-1,0,0,2,1,1
"9083",2020-01-12,"Slate River Rd","w1920","Motorized",1,"Sun","weekend","sled","Slate River Rd","2","1","1",6.1,0.1,29,0,13,21,0,2,-1,0,0,2,1,1
"9084",2020-01-12,"Slate River Rd","w1920","Hybrid",17,"Sun","weekend","sled","Slate River Rd","2","1","1",6.1,0.1,29,0,13,21,0,2,-1,0,0,2,1,1
"9085",2020-01-13,"Slate River Rd","w1920","Non.motorized",0,"Mon","weekday","no_sled","Slate River Rd","2","2","1",6.2,0.1,29,0,16,21.4,0,0,2,-1,0,0,2,1
"9086",2020-01-13,"Slate River Rd","w1920","Mechanized",0,"Mon","weekday","no_sled","Slate River Rd","2","2","1",6.2,0.1,29,0,16,21.4,0,0,2,-1,0,0,2,1
"9087",2020-01-13,"Slate River Rd","w1920","Motorized",1,"Mon","weekday","sled","Slate River Rd","2","2","1",6.2,0.1,29,0,16,21.4,0,0,2,-1,0,0,2,1
"9088",2020-01-13,"Slate River Rd","w1920","Hybrid",1,"Mon","weekday","sled","Slate River Rd","2","2","1",6.2,0.1,29,0,16,21.4,0,0,2,-1,0,0,2,1
"9089",2020-01-14,"Slate River Rd","w1920","Non.motorized",7,"Tue","weekday","no_sled","Slate River Rd","3","2","1",6.6,0.4,34,5,23,19.4,0,0,0,2,5,5,5,7
"9090",2020-01-14,"Slate River Rd","w1920","Mechanized",0,"Tue","weekday","no_sled","Slate River Rd","3","2","1",6.6,0.4,34,5,23,19.4,0,0,0,2,5,5,5,7
"9091",2020-01-14,"Slate River Rd","w1920","Motorized",0,"Tue","weekday","sled","Slate River Rd","3","2","1",6.6,0.4,34,5,23,19.4,0,0,0,2,5,5,5,7
"9092",2020-01-14,"Slate River Rd","w1920","Hybrid",5,"Tue","weekday","sled","Slate River Rd","3","2","1",6.6,0.4,34,5,23,19.4,0,0,0,2,5,5,5,7
"9093",2020-01-15,"Slate River Rd","w1920","Non.motorized",19,"Wed","weekday","no_sled","Slate River Rd","3","2","1",6.7,0.1,32,-2,23,20.9,5,0,0,0,3,3,3,3
"9094",2020-01-15,"Slate River Rd","w1920","Mechanized",0,"Wed","weekday","no_sled","Slate River Rd","3","2","1",6.7,0.1,32,-2,23,20.9,5,0,0,0,3,3,3,3
"9095",2020-01-15,"Slate River Rd","w1920","Motorized",0,"Wed","weekday","sled","Slate River Rd","3","2","1",6.7,0.1,32,-2,23,20.9,5,0,0,0,3,3,3,3
"9096",2020-01-15,"Slate River Rd","w1920","Hybrid",8,"Wed","weekday","sled","Slate River Rd","3","2","1",6.7,0.1,32,-2,23,20.9,5,0,0,0,3,3,3,3
"9097",2020-01-16,"Slate River Rd","w1920","Non.motorized",6,"Thu","weekday","no_sled","Slate River Rd","2","2","1",6.7,0,31,-1,28,21.6,-2,5,0,0,-3,2,2,2
"9098",2020-01-16,"Slate River Rd","w1920","Mechanized",0,"Thu","weekday","no_sled","Slate River Rd","2","2","1",6.7,0,31,-1,28,21.6,-2,5,0,0,-3,2,2,2
"9099",2020-01-16,"Slate River Rd","w1920","Motorized",0,"Thu","weekday","sled","Slate River Rd","2","2","1",6.7,0,31,-1,28,21.6,-2,5,0,0,-3,2,2,2
"9100",2020-01-16,"Slate River Rd","w1920","Hybrid",6,"Thu","weekday","sled","Slate River Rd","2","2","1",6.7,0,31,-1,28,21.6,-2,5,0,0,-3,2,2,2
"9101",2020-01-17,"Slate River Rd","w1920","Non.motorized",NA,"Fri","weekday","no_sled","Slate River Rd","2","2","1",6.8,0.1,29,-2,19,23.4,-1,-2,5,0,-3,-5,0,0
"9102",2020-01-17,"Slate River Rd","w1920","Mechanized",NA,"Fri","weekday","no_sled","Slate River Rd","2","2","1",6.8,0.1,29,-2,19,23.4,-1,-2,5,0,-3,-5,0,0
"9103",2020-01-17,"Slate River Rd","w1920","Motorized",NA,"Fri","weekday","sled","Slate River Rd","2","2","1",6.8,0.1,29,-2,19,23.4,-1,-2,5,0,-3,-5,0,0
"9104",2020-01-17,"Slate River Rd","w1920","Hybrid",NA,"Fri","weekday","sled","Slate River Rd","2","2","1",6.8,0.1,29,-2,19,23.4,-1,-2,5,0,-3,-5,0,0
"9105",2020-01-18,"Slate River Rd","w1920","Non.motorized",NA,"Sat","weekend","no_sled","Slate River Rd","2","2","2",7,0.2,34,5,16,20.6,-2,-1,-2,5,3,2,0,5
"9106",2020-01-18,"Slate River Rd","w1920","Mechanized",NA,"Sat","weekend","no_sled","Slate River Rd","2","2","2",7,0.2,34,5,16,20.6,-2,-1,-2,5,3,2,0,5
"9107",2020-01-18,"Slate River Rd","w1920","Motorized",NA,"Sat","weekend","sled","Slate River Rd","2","2","2",7,0.2,34,5,16,20.6,-2,-1,-2,5,3,2,0,5
"9108",2020-01-18,"Slate River Rd","w1920","Hybrid",NA,"Sat","weekend","sled","Slate River Rd","2","2","2",7,0.2,34,5,16,20.6,-2,-1,-2,5,3,2,0,5
"9109",2020-01-19,"Slate River Rd","w1920","Non.motorized",31,"Sun","weekend","no_sled","Slate River Rd","2","2","1",7,0,33,-1,21,21.2,5,-2,-1,-2,4,2,1,-1
"9110",2020-01-19,"Slate River Rd","w1920","Mechanized",0,"Sun","weekend","no_sled","Slate River Rd","2","2","1",7,0,33,-1,21,21.2,5,-2,-1,-2,4,2,1,-1
"9111",2020-01-19,"Slate River Rd","w1920","Motorized",0,"Sun","weekend","sled","Slate River Rd","2","2","1",7,0,33,-1,21,21.2,5,-2,-1,-2,4,2,1,-1
"9112",2020-01-19,"Slate River Rd","w1920","Hybrid",2,"Sun","weekend","sled","Slate River Rd","2","2","1",7,0,33,-1,21,21.2,5,-2,-1,-2,4,2,1,-1
"9113",2020-01-20,"Slate River Rd","w1920","Non.motorized",17,"Mon","weekday","no_sled","Slate River Rd","2","2","1",7.1,0.1,32,-1,25,22.2,-1,5,-2,-1,-2,3,1,0
"9114",2020-01-20,"Slate River Rd","w1920","Mechanized",2,"Mon","weekday","no_sled","Slate River Rd","2","2","1",7.1,0.1,32,-1,25,22.2,-1,5,-2,-1,-2,3,1,0
"9115",2020-01-20,"Slate River Rd","w1920","Motorized",2,"Mon","weekday","sled","Slate River Rd","2","2","1",7.1,0.1,32,-1,25,22.2,-1,5,-2,-1,-2,3,1,0
"9116",2020-01-20,"Slate River Rd","w1920","Hybrid",7,"Mon","weekday","sled","Slate River Rd","2","2","1",7.1,0.1,32,-1,25,22.2,-1,5,-2,-1,-2,3,1,0
"9117",2020-01-21,"Slate River Rd","w1920","Non.motorized",3,"Tue","weekday","no_sled","Slate River Rd","2","2","1",7.1,0,31,-1,28,22.9,-1,-1,5,-2,-2,-3,2,0
"9118",2020-01-21,"Slate River Rd","w1920","Mechanized",0,"Tue","weekday","no_sled","Slate River Rd","2","2","1",7.1,0,31,-1,28,22.9,-1,-1,5,-2,-2,-3,2,0
"9119",2020-01-21,"Slate River Rd","w1920","Motorized",1,"Tue","weekday","sled","Slate River Rd","2","2","1",7.1,0,31,-1,28,22.9,-1,-1,5,-2,-2,-3,2,0
"9120",2020-01-21,"Slate River Rd","w1920","Hybrid",10,"Tue","weekday","sled","Slate River Rd","2","2","1",7.1,0,31,-1,28,22.9,-1,-1,5,-2,-2,-3,2,0
"9121",2020-01-22,"Slate River Rd","w1920","Non.motorized",10,"Wed","weekday","no_sled","Slate River Rd","2","2","2",7.3,0.2,32,1,25,22.8,-1,-1,-1,5,0,-1,-2,3
"9122",2020-01-22,"Slate River Rd","w1920","Mechanized",0,"Wed","weekday","no_sled","Slate River Rd","2","2","2",7.3,0.2,32,1,25,22.8,-1,-1,-1,5,0,-1,-2,3
"9123",2020-01-22,"Slate River Rd","w1920","Motorized",2,"Wed","weekday","sled","Slate River Rd","2","2","2",7.3,0.2,32,1,25,22.8,-1,-1,-1,5,0,-1,-2,3
"9124",2020-01-22,"Slate River Rd","w1920","Hybrid",1,"Wed","weekday","sled","Slate River Rd","2","2","2",7.3,0.2,32,1,25,22.8,-1,-1,-1,5,0,-1,-2,3
"9125",2020-01-23,"Slate River Rd","w1920","Non.motorized",9,"Thu","weekday","no_sled","Slate River Rd","3","2","2",7.3,0,34,2,23,21.5,1,-1,-1,-1,3,2,1,0
"9126",2020-01-23,"Slate River Rd","w1920","Mechanized",0,"Thu","weekday","no_sled","Slate River Rd","3","2","2",7.3,0,34,2,23,21.5,1,-1,-1,-1,3,2,1,0
"9127",2020-01-23,"Slate River Rd","w1920","Motorized",0,"Thu","weekday","sled","Slate River Rd","3","2","2",7.3,0,34,2,23,21.5,1,-1,-1,-1,3,2,1,0
"9128",2020-01-23,"Slate River Rd","w1920","Hybrid",4,"Thu","weekday","sled","Slate River Rd","3","2","2",7.3,0,34,2,23,21.5,1,-1,-1,-1,3,2,1,0
"9129",2020-01-24,"Slate River Rd","w1920","Non.motorized",19,"Fri","weekday","no_sled","Slate River Rd","2","2","1",7.3,0,33,-1,23,22.1,2,1,-1,-1,1,2,1,0
"9130",2020-01-24,"Slate River Rd","w1920","Mechanized",0,"Fri","weekday","no_sled","Slate River Rd","2","2","1",7.3,0,33,-1,23,22.1,2,1,-1,-1,1,2,1,0
"9131",2020-01-24,"Slate River Rd","w1920","Motorized",2,"Fri","weekday","sled","Slate River Rd","2","2","1",7.3,0,33,-1,23,22.1,2,1,-1,-1,1,2,1,0
"9132",2020-01-24,"Slate River Rd","w1920","Hybrid",5,"Fri","weekday","sled","Slate River Rd","2","2","1",7.3,0,33,-1,23,22.1,2,1,-1,-1,1,2,1,0
"9133",2020-01-25,"Slate River Rd","w1920","Non.motorized",27,"Sat","weekend","no_sled","Slate River Rd","2","2","1",7.4,0.1,32,-1,25,23.1,-1,2,1,-1,-2,0,1,0
"9134",2020-01-25,"Slate River Rd","w1920","Mechanized",1,"Sat","weekend","no_sled","Slate River Rd","2","2","1",7.4,0.1,32,-1,25,23.1,-1,2,1,-1,-2,0,1,0
"9135",2020-01-25,"Slate River Rd","w1920","Motorized",0,"Sat","weekend","sled","Slate River Rd","2","2","1",7.4,0.1,32,-1,25,23.1,-1,2,1,-1,-2,0,1,0
"9136",2020-01-25,"Slate River Rd","w1920","Hybrid",12,"Sat","weekend","sled","Slate River Rd","2","2","1",7.4,0.1,32,-1,25,23.1,-1,2,1,-1,-2,0,1,0
"9137",2020-01-26,"Slate River Rd","w1920","Non.motorized",31,"Sun","weekend","no_sled","Slate River Rd","2","1","1",7.4,0,32,0,28,23.1,-1,-1,2,1,-1,-2,0,1
"9138",2020-01-26,"Slate River Rd","w1920","Mechanized",0,"Sun","weekend","no_sled","Slate River Rd","2","1","1",7.4,0,32,0,28,23.1,-1,-1,2,1,-1,-2,0,1
"9139",2020-01-26,"Slate River Rd","w1920","Motorized",2,"Sun","weekend","sled","Slate River Rd","2","1","1",7.4,0,32,0,28,23.1,-1,-1,2,1,-1,-2,0,1
"9140",2020-01-26,"Slate River Rd","w1920","Hybrid",5,"Sun","weekend","sled","Slate River Rd","2","1","1",7.4,0,32,0,28,23.1,-1,-1,2,1,-1,-2,0,1
"9141",2020-01-27,"Slate River Rd","w1920","Non.motorized",7,"Mon","weekday","no_sled","Slate River Rd","2","1","1",7.4,0,32,0,24,23.1,0,-1,-1,2,0,-1,-2,0
"9142",2020-01-27,"Slate River Rd","w1920","Mechanized",0,"Mon","weekday","no_sled","Slate River Rd","2","1","1",7.4,0,32,0,24,23.1,0,-1,-1,2,0,-1,-2,0
"9143",2020-01-27,"Slate River Rd","w1920","Motorized",0,"Mon","weekday","sled","Slate River Rd","2","1","1",7.4,0,32,0,24,23.1,0,-1,-1,2,0,-1,-2,0
"9144",2020-01-27,"Slate River Rd","w1920","Hybrid",3,"Mon","weekday","sled","Slate River Rd","2","1","1",7.4,0,32,0,24,23.1,0,-1,-1,2,0,-1,-2,0
"9145",2020-01-28,"Slate River Rd","w1920","Non.motorized",11,"Tue","weekday","no_sled","Slate River Rd","3","2","2",7.4,0,32,0,19,23.1,0,0,-1,-1,0,0,-1,-2
"9146",2020-01-28,"Slate River Rd","w1920","Mechanized",0,"Tue","weekday","no_sled","Slate River Rd","3","2","2",7.4,0,32,0,19,23.1,0,0,-1,-1,0,0,-1,-2
"9147",2020-01-28,"Slate River Rd","w1920","Motorized",0,"Tue","weekday","sled","Slate River Rd","3","2","2",7.4,0,32,0,19,23.1,0,0,-1,-1,0,0,-1,-2
"9148",2020-01-28,"Slate River Rd","w1920","Hybrid",6,"Tue","weekday","sled","Slate River Rd","3","2","2",7.4,0,32,0,19,23.1,0,0,-1,-1,0,0,-1,-2
"9149",2020-01-29,"Slate River Rd","w1920","Non.motorized",13,"Wed","weekday","no_sled","Slate River Rd","2","2","1",7.4,0,31,-1,20,23.9,0,0,0,-1,-1,-1,-1,-2
"9150",2020-01-29,"Slate River Rd","w1920","Mechanized",0,"Wed","weekday","no_sled","Slate River Rd","2","2","1",7.4,0,31,-1,20,23.9,0,0,0,-1,-1,-1,-1,-2
"9151",2020-01-29,"Slate River Rd","w1920","Motorized",0,"Wed","weekday","sled","Slate River Rd","2","2","1",7.4,0,31,-1,20,23.9,0,0,0,-1,-1,-1,-1,-2
"9152",2020-01-29,"Slate River Rd","w1920","Hybrid",5,"Wed","weekday","sled","Slate River Rd","2","2","1",7.4,0,31,-1,20,23.9,0,0,0,-1,-1,-1,-1,-2
"9153",2020-01-30,"Slate River Rd","w1920","Non.motorized",17,"Thu","weekday","no_sled","Slate River Rd","2","2","1",7.4,0,31,0,17,23.9,-1,0,0,0,-1,-1,-1,-1
"9154",2020-01-30,"Slate River Rd","w1920","Mechanized",0,"Thu","weekday","no_sled","Slate River Rd","2","2","1",7.4,0,31,0,17,23.9,-1,0,0,0,-1,-1,-1,-1
"9155",2020-01-30,"Slate River Rd","w1920","Motorized",0,"Thu","weekday","sled","Slate River Rd","2","2","1",7.4,0,31,0,17,23.9,-1,0,0,0,-1,-1,-1,-1
"9156",2020-01-30,"Slate River Rd","w1920","Hybrid",12,"Thu","weekday","sled","Slate River Rd","2","2","1",7.4,0,31,0,17,23.9,-1,0,0,0,-1,-1,-1,-1
"9157",2020-01-31,"Slate River Rd","w1920","Non.motorized",27,"Fri","weekday","no_sled","Slate River Rd","2","1","1",7.4,0,31,0,20,23.9,0,-1,0,0,0,-1,-1,-1
"9158",2020-01-31,"Slate River Rd","w1920","Mechanized",0,"Fri","weekday","no_sled","Slate River Rd","2","1","1",7.4,0,31,0,20,23.9,0,-1,0,0,0,-1,-1,-1
"9159",2020-01-31,"Slate River Rd","w1920","Motorized",2,"Fri","weekday","sled","Slate River Rd","2","1","1",7.4,0,31,0,20,23.9,0,-1,0,0,0,-1,-1,-1
"9160",2020-01-31,"Slate River Rd","w1920","Hybrid",14,"Fri","weekday","sled","Slate River Rd","2","1","1",7.4,0,31,0,20,23.9,0,-1,0,0,0,-1,-1,-1
"9161",2020-02-01,"Slate River Rd","w1920","Non.motorized",61,"Sat","weekend","no_sled","Slate River Rd","2","1","1",7.4,0,31,0,28,23.9,0,0,-1,0,0,0,-1,-1
"9162",2020-02-01,"Slate River Rd","w1920","Mechanized",0,"Sat","weekend","no_sled","Slate River Rd","2","1","1",7.4,0,31,0,28,23.9,0,0,-1,0,0,0,-1,-1
"9163",2020-02-01,"Slate River Rd","w1920","Motorized",0,"Sat","weekend","sled","Slate River Rd","2","1","1",7.4,0,31,0,28,23.9,0,0,-1,0,0,0,-1,-1
"9164",2020-02-01,"Slate River Rd","w1920","Hybrid",4,"Sat","weekend","sled","Slate River Rd","2","1","1",7.4,0,31,0,28,23.9,0,0,-1,0,0,0,-1,-1
"9165",2020-02-02,"Slate River Rd","w1920","Non.motorized",46,"Sun","weekend","no_sled","Slate River Rd","1","1","1",7.4,0,31,0,33,23.9,0,0,0,-1,0,0,0,-1
"9166",2020-02-02,"Slate River Rd","w1920","Mechanized",0,"Sun","weekend","no_sled","Slate River Rd","1","1","1",7.4,0,31,0,33,23.9,0,0,0,-1,0,0,0,-1
"9167",2020-02-02,"Slate River Rd","w1920","Motorized",0,"Sun","weekend","sled","Slate River Rd","1","1","1",7.4,0,31,0,33,23.9,0,0,0,-1,0,0,0,-1
"9168",2020-02-02,"Slate River Rd","w1920","Hybrid",4,"Sun","weekend","sled","Slate River Rd","1","1","1",7.4,0,31,0,33,23.9,0,0,0,-1,0,0,0,-1
"9169",2020-02-03,"Slate River Rd","w1920","Non.motorized",16,"Mon","weekday","no_sled","Slate River Rd","2","2","1",7.4,0,31,0,24,23.9,0,0,0,0,0,0,0,0
"9170",2020-02-03,"Slate River Rd","w1920","Mechanized",0,"Mon","weekday","no_sled","Slate River Rd","2","2","1",7.4,0,31,0,24,23.9,0,0,0,0,0,0,0,0
"9171",2020-02-03,"Slate River Rd","w1920","Motorized",0,"Mon","weekday","sled","Slate River Rd","2","2","1",7.4,0,31,0,24,23.9,0,0,0,0,0,0,0,0
"9172",2020-02-03,"Slate River Rd","w1920","Hybrid",7,"Mon","weekday","sled","Slate River Rd","2","2","1",7.4,0,31,0,24,23.9,0,0,0,0,0,0,0,0
"9173",2020-02-04,"Slate River Rd","w1920","Non.motorized",6,"Tue","weekday","no_sled","Slate River Rd","2","2","2",7.4,0,33,2,5,22.4,0,0,0,0,2,2,2,2
"9174",2020-02-04,"Slate River Rd","w1920","Mechanized",0,"Tue","weekday","no_sled","Slate River Rd","2","2","2",7.4,0,33,2,5,22.4,0,0,0,0,2,2,2,2
"9175",2020-02-04,"Slate River Rd","w1920","Motorized",0,"Tue","weekday","sled","Slate River Rd","2","2","2",7.4,0,33,2,5,22.4,0,0,0,0,2,2,2,2
"9176",2020-02-04,"Slate River Rd","w1920","Hybrid",0,"Tue","weekday","sled","Slate River Rd","2","2","2",7.4,0,33,2,5,22.4,0,0,0,0,2,2,2,2
"9177",2020-02-05,"Slate River Rd","w1920","Non.motorized",15,"Wed","weekday","no_sled","Slate River Rd","2","2","1",7.4,0,33,0,2,22.4,2,0,0,0,2,2,2,2
"9178",2020-02-05,"Slate River Rd","w1920","Mechanized",1,"Wed","weekday","no_sled","Slate River Rd","2","2","1",7.4,0,33,0,2,22.4,2,0,0,0,2,2,2,2
"9179",2020-02-05,"Slate River Rd","w1920","Motorized",1,"Wed","weekday","sled","Slate River Rd","2","2","1",7.4,0,33,0,2,22.4,2,0,0,0,2,2,2,2
"9180",2020-02-05,"Slate River Rd","w1920","Hybrid",2,"Wed","weekday","sled","Slate River Rd","2","2","1",7.4,0,33,0,2,22.4,2,0,0,0,2,2,2,2
"9181",2020-02-06,"Slate River Rd","w1920","Non.motorized",25,"Thu","weekday","no_sled","Slate River Rd","2","2","1",7.5,0.1,32,-1,16,23.4,0,2,0,0,-1,1,1,1
"9182",2020-02-06,"Slate River Rd","w1920","Mechanized",0,"Thu","weekday","no_sled","Slate River Rd","2","2","1",7.5,0.1,32,-1,16,23.4,0,2,0,0,-1,1,1,1
"9183",2020-02-06,"Slate River Rd","w1920","Motorized",0,"Thu","weekday","sled","Slate River Rd","2","2","1",7.5,0.1,32,-1,16,23.4,0,2,0,0,-1,1,1,1
"9184",2020-02-06,"Slate River Rd","w1920","Hybrid",3,"Thu","weekday","sled","Slate River Rd","2","2","1",7.5,0.1,32,-1,16,23.4,0,2,0,0,-1,1,1,1
"9185",2020-02-07,"Slate River Rd","w1920","Non.motorized",3,"Fri","weekday","no_sled","Slate River Rd","3","3","3",7.9,0.4,37,5,26,21.4,-1,0,2,0,4,4,6,6
"9186",2020-02-07,"Slate River Rd","w1920","Mechanized",0,"Fri","weekday","no_sled","Slate River Rd","3","3","3",7.9,0.4,37,5,26,21.4,-1,0,2,0,4,4,6,6
"9187",2020-02-07,"Slate River Rd","w1920","Motorized",0,"Fri","weekday","sled","Slate River Rd","3","3","3",7.9,0.4,37,5,26,21.4,-1,0,2,0,4,4,6,6
"9188",2020-02-07,"Slate River Rd","w1920","Hybrid",0,"Fri","weekday","sled","Slate River Rd","3","3","3",7.9,0.4,37,5,26,21.4,-1,0,2,0,4,4,6,6
"9189",2020-02-08,"Slate River Rd","w1920","Non.motorized",24,"Sat","weekend","no_sled","Slate River Rd","3","3","2",8.3,0.4,39,2,30,21.3,5,-1,0,2,7,6,6,8
"9190",2020-02-08,"Slate River Rd","w1920","Mechanized",0,"Sat","weekend","no_sled","Slate River Rd","3","3","2",8.3,0.4,39,2,30,21.3,5,-1,0,2,7,6,6,8
"9191",2020-02-08,"Slate River Rd","w1920","Motorized",0,"Sat","weekend","sled","Slate River Rd","3","3","2",8.3,0.4,39,2,30,21.3,5,-1,0,2,7,6,6,8
"9192",2020-02-08,"Slate River Rd","w1920","Hybrid",1,"Sat","weekend","sled","Slate River Rd","3","3","2",8.3,0.4,39,2,30,21.3,5,-1,0,2,7,6,6,8
"9193",2020-02-09,"Slate River Rd","w1920","Non.motorized",18,"Sun","weekend","no_sled","Slate River Rd","3","2","2",8.4,0.1,38,-1,26,22.1,2,5,-1,0,1,6,5,5
"9194",2020-02-09,"Slate River Rd","w1920","Mechanized",0,"Sun","weekend","no_sled","Slate River Rd","3","2","2",8.4,0.1,38,-1,26,22.1,2,5,-1,0,1,6,5,5
"9195",2020-02-09,"Slate River Rd","w1920","Motorized",0,"Sun","weekend","sled","Slate River Rd","3","2","2",8.4,0.1,38,-1,26,22.1,2,5,-1,0,1,6,5,5
"9196",2020-02-09,"Slate River Rd","w1920","Hybrid",8,"Sun","weekend","sled","Slate River Rd","3","2","2",8.4,0.1,38,-1,26,22.1,2,5,-1,0,1,6,5,5
"9197",2020-02-10,"Slate River Rd","w1920","Non.motorized",14,"Mon","weekday","no_sled","Slate River Rd","2","2","1",8.4,0,38,0,22,22.1,-1,2,5,-1,-1,1,6,5
"9198",2020-02-10,"Slate River Rd","w1920","Mechanized",0,"Mon","weekday","no_sled","Slate River Rd","2","2","1",8.4,0,38,0,22,22.1,-1,2,5,-1,-1,1,6,5
"9199",2020-02-10,"Slate River Rd","w1920","Motorized",0,"Mon","weekday","sled","Slate River Rd","2","2","1",8.4,0,38,0,22,22.1,-1,2,5,-1,-1,1,6,5
"9200",2020-02-10,"Slate River Rd","w1920","Hybrid",9,"Mon","weekday","sled","Slate River Rd","2","2","1",8.4,0,38,0,22,22.1,-1,2,5,-1,-1,1,6,5
"9201",2020-02-11,"Slate River Rd","w1920","Non.motorized",10,"Tue","weekday","no_sled","Slate River Rd","2","2","2",8.5,0.1,40,2,16,21.2,0,-1,2,5,2,1,3,8
"9202",2020-02-11,"Slate River Rd","w1920","Mechanized",0,"Tue","weekday","no_sled","Slate River Rd","2","2","2",8.5,0.1,40,2,16,21.2,0,-1,2,5,2,1,3,8
"9203",2020-02-11,"Slate River Rd","w1920","Motorized",0,"Tue","weekday","sled","Slate River Rd","2","2","2",8.5,0.1,40,2,16,21.2,0,-1,2,5,2,1,3,8
"9204",2020-02-11,"Slate River Rd","w1920","Hybrid",5,"Tue","weekday","sled","Slate River Rd","2","2","2",8.5,0.1,40,2,16,21.2,0,-1,2,5,2,1,3,8
"9205",2020-02-12,"Slate River Rd","w1920","Non.motorized",15,"Wed","weekday","no_sled","Slate River Rd","2","2","2",8.5,0,39,-1,15,21.8,2,0,-1,2,1,1,0,2
"9206",2020-02-12,"Slate River Rd","w1920","Mechanized",0,"Wed","weekday","no_sled","Slate River Rd","2","2","2",8.5,0,39,-1,15,21.8,2,0,-1,2,1,1,0,2
"9207",2020-02-12,"Slate River Rd","w1920","Motorized",1,"Wed","weekday","sled","Slate River Rd","2","2","2",8.5,0,39,-1,15,21.8,2,0,-1,2,1,1,0,2
"9208",2020-02-12,"Slate River Rd","w1920","Hybrid",4,"Wed","weekday","sled","Slate River Rd","2","2","2",8.5,0,39,-1,15,21.8,2,0,-1,2,1,1,0,2
"9209",2020-02-13,"Slate River Rd","w1920","Non.motorized",2,"Thu","weekday","no_sled","Slate River Rd","2","2","1",8.5,0,39,0,18,21.8,-1,2,0,-1,-1,1,1,0
"9210",2020-02-13,"Slate River Rd","w1920","Mechanized",0,"Thu","weekday","no_sled","Slate River Rd","2","2","1",8.5,0,39,0,18,21.8,-1,2,0,-1,-1,1,1,0
"9211",2020-02-13,"Slate River Rd","w1920","Motorized",0,"Thu","weekday","sled","Slate River Rd","2","2","1",8.5,0,39,0,18,21.8,-1,2,0,-1,-1,1,1,0
"9212",2020-02-13,"Slate River Rd","w1920","Hybrid",4,"Thu","weekday","sled","Slate River Rd","2","2","1",8.5,0,39,0,18,21.8,-1,2,0,-1,-1,1,1,0
"9213",2020-02-14,"Slate River Rd","w1920","Non.motorized",13,"Fri","weekday","no_sled","Slate River Rd","2","1","1",8.6,0.1,38,-1,24,22.6,0,-1,2,0,-1,-2,0,0
"9214",2020-02-14,"Slate River Rd","w1920","Mechanized",0,"Fri","weekday","no_sled","Slate River Rd","2","1","1",8.6,0.1,38,-1,24,22.6,0,-1,2,0,-1,-2,0,0
"9215",2020-02-14,"Slate River Rd","w1920","Motorized",1,"Fri","weekday","sled","Slate River Rd","2","1","1",8.6,0.1,38,-1,24,22.6,0,-1,2,0,-1,-2,0,0
"9216",2020-02-14,"Slate River Rd","w1920","Hybrid",5,"Fri","weekday","sled","Slate River Rd","2","1","1",8.6,0.1,38,-1,24,22.6,0,-1,2,0,-1,-2,0,0
"9217",2020-02-15,"Slate River Rd","w1920","Non.motorized",33,"Sat","weekend","no_sled","Slate River Rd","1","1","1",8.6,0,38,0,26,22.6,-1,0,-1,2,-1,-1,-2,0
"9218",2020-02-15,"Slate River Rd","w1920","Mechanized",0,"Sat","weekend","no_sled","Slate River Rd","1","1","1",8.6,0,38,0,26,22.6,-1,0,-1,2,-1,-1,-2,0
"9219",2020-02-15,"Slate River Rd","w1920","Motorized",2,"Sat","weekend","sled","Slate River Rd","1","1","1",8.6,0,38,0,26,22.6,-1,0,-1,2,-1,-1,-2,0
"9220",2020-02-15,"Slate River Rd","w1920","Hybrid",18,"Sat","weekend","sled","Slate River Rd","1","1","1",8.6,0,38,0,26,22.6,-1,0,-1,2,-1,-1,-2,0
"9221",2020-02-16,"Slate River Rd","w1920","Non.motorized",19,"Sun","weekend","no_sled","Slate River Rd","1","1","1",8.8,0.2,37,-1,26,23.8,0,-1,0,-1,-1,-2,-2,-3
"9222",2020-02-16,"Slate River Rd","w1920","Mechanized",0,"Sun","weekend","no_sled","Slate River Rd","1","1","1",8.8,0.2,37,-1,26,23.8,0,-1,0,-1,-1,-2,-2,-3
"9223",2020-02-16,"Slate River Rd","w1920","Motorized",0,"Sun","weekend","sled","Slate River Rd","1","1","1",8.8,0.2,37,-1,26,23.8,0,-1,0,-1,-1,-2,-2,-3
"9224",2020-02-16,"Slate River Rd","w1920","Hybrid",4,"Sun","weekend","sled","Slate River Rd","1","1","1",8.8,0.2,37,-1,26,23.8,0,-1,0,-1,-1,-2,-2,-3
"9225",2020-02-17,"Slate River Rd","w1920","Non.motorized",14,"Mon","weekday","no_sled","Slate River Rd","2","1","1",9.2,0.4,43,6,25,21.4,-1,0,-1,0,5,5,4,4
"9226",2020-02-17,"Slate River Rd","w1920","Mechanized",0,"Mon","weekday","no_sled","Slate River Rd","2","1","1",9.2,0.4,43,6,25,21.4,-1,0,-1,0,5,5,4,4
"9227",2020-02-17,"Slate River Rd","w1920","Motorized",0,"Mon","weekday","sled","Slate River Rd","2","1","1",9.2,0.4,43,6,25,21.4,-1,0,-1,0,5,5,4,4
"9228",2020-02-17,"Slate River Rd","w1920","Hybrid",1,"Mon","weekday","sled","Slate River Rd","2","1","1",9.2,0.4,43,6,25,21.4,-1,0,-1,0,5,5,4,4
"9229",2020-02-18,"Slate River Rd","w1920","Non.motorized",13,"Tue","weekday","no_sled","Slate River Rd","1","1","1",9.3,0.1,42,-1,18,22.1,6,-1,0,-1,5,4,4,3
"9230",2020-02-18,"Slate River Rd","w1920","Mechanized",0,"Tue","weekday","no_sled","Slate River Rd","1","1","1",9.3,0.1,42,-1,18,22.1,6,-1,0,-1,5,4,4,3
"9231",2020-02-18,"Slate River Rd","w1920","Motorized",0,"Tue","weekday","sled","Slate River Rd","1","1","1",9.3,0.1,42,-1,18,22.1,6,-1,0,-1,5,4,4,3
"9232",2020-02-18,"Slate River Rd","w1920","Hybrid",2,"Tue","weekday","sled","Slate River Rd","1","1","1",9.3,0.1,42,-1,18,22.1,6,-1,0,-1,5,4,4,3
"9233",2020-02-19,"Slate River Rd","w1920","Non.motorized",18,"Wed","weekday","no_sled","Slate River Rd","1","1","1",9.3,0,41,-1,22,22.7,-1,6,-1,0,-2,4,3,3
"9234",2020-02-19,"Slate River Rd","w1920","Mechanized",0,"Wed","weekday","no_sled","Slate River Rd","1","1","1",9.3,0,41,-1,22,22.7,-1,6,-1,0,-2,4,3,3
"9235",2020-02-19,"Slate River Rd","w1920","Motorized",0,"Wed","weekday","sled","Slate River Rd","1","1","1",9.3,0,41,-1,22,22.7,-1,6,-1,0,-2,4,3,3
"9236",2020-02-19,"Slate River Rd","w1920","Hybrid",2,"Wed","weekday","sled","Slate River Rd","1","1","1",9.3,0,41,-1,22,22.7,-1,6,-1,0,-2,4,3,3
"9237",2020-02-20,"Slate River Rd","w1920","Non.motorized",26,"Thu","weekday","no_sled","Slate River Rd","1","1","1",9.3,0,41,0,18,22.7,-1,-1,6,-1,-1,-2,4,3
"9238",2020-02-20,"Slate River Rd","w1920","Mechanized",0,"Thu","weekday","no_sled","Slate River Rd","1","1","1",9.3,0,41,0,18,22.7,-1,-1,6,-1,-1,-2,4,3
"9239",2020-02-20,"Slate River Rd","w1920","Motorized",0,"Thu","weekday","sled","Slate River Rd","1","1","1",9.3,0,41,0,18,22.7,-1,-1,6,-1,-1,-2,4,3
"9240",2020-02-20,"Slate River Rd","w1920","Hybrid",3,"Thu","weekday","sled","Slate River Rd","1","1","1",9.3,0,41,0,18,22.7,-1,-1,6,-1,-1,-2,4,3
"9241",2020-02-21,"Slate River Rd","w1920","Non.motorized",31,"Fri","weekday","no_sled","Slate River Rd","1","1","1",9.3,0,40,-1,26,23.2,0,-1,-1,6,-1,-2,-3,3
"9242",2020-02-21,"Slate River Rd","w1920","Mechanized",0,"Fri","weekday","no_sled","Slate River Rd","1","1","1",9.3,0,40,-1,26,23.2,0,-1,-1,6,-1,-2,-3,3
"9243",2020-02-21,"Slate River Rd","w1920","Motorized",2,"Fri","weekday","sled","Slate River Rd","1","1","1",9.3,0,40,-1,26,23.2,0,-1,-1,6,-1,-2,-3,3
"9244",2020-02-21,"Slate River Rd","w1920","Hybrid",4,"Fri","weekday","sled","Slate River Rd","1","1","1",9.3,0,40,-1,26,23.2,0,-1,-1,6,-1,-2,-3,3
"9245",2020-02-22,"Slate River Rd","w1920","Non.motorized",45,"Sat","weekend","no_sled","Slate River Rd","1","1","1",9.4,0.1,39,-1,32,24.1,-1,0,-1,-1,-2,-2,-3,-4
"9246",2020-02-22,"Slate River Rd","w1920","Mechanized",0,"Sat","weekend","no_sled","Slate River Rd","1","1","1",9.4,0.1,39,-1,32,24.1,-1,0,-1,-1,-2,-2,-3,-4
"9247",2020-02-22,"Slate River Rd","w1920","Motorized",2,"Sat","weekend","sled","Slate River Rd","1","1","1",9.4,0.1,39,-1,32,24.1,-1,0,-1,-1,-2,-2,-3,-4
"9248",2020-02-22,"Slate River Rd","w1920","Hybrid",7,"Sat","weekend","sled","Slate River Rd","1","1","1",9.4,0.1,39,-1,32,24.1,-1,0,-1,-1,-2,-2,-3,-4
"9249",2020-02-23,"Slate River Rd","w1920","Non.motorized",8,"Sun","weekend","no_sled","Slate River Rd","2","2","2",9.5,0.1,40,1,27,23.8,-1,-1,0,-1,0,-1,-1,-2
"9250",2020-02-23,"Slate River Rd","w1920","Mechanized",0,"Sun","weekend","no_sled","Slate River Rd","2","2","2",9.5,0.1,40,1,27,23.8,-1,-1,0,-1,0,-1,-1,-2
"9251",2020-02-23,"Slate River Rd","w1920","Motorized",0,"Sun","weekend","sled","Slate River Rd","2","2","2",9.5,0.1,40,1,27,23.8,-1,-1,0,-1,0,-1,-1,-2
"9252",2020-02-23,"Slate River Rd","w1920","Hybrid",1,"Sun","weekend","sled","Slate River Rd","2","2","2",9.5,0.1,40,1,27,23.8,-1,-1,0,-1,0,-1,-1,-2
"9253",2020-02-24,"Slate River Rd","w1920","Non.motorized",NA,"Mon","weekday","no_sled","Slate River Rd","3","3","2",9.8,0.3,43,3,17,22.8,1,-1,-1,0,4,3,2,2
"9254",2020-02-24,"Slate River Rd","w1920","Mechanized",NA,"Mon","weekday","no_sled","Slate River Rd","3","3","2",9.8,0.3,43,3,17,22.8,1,-1,-1,0,4,3,2,2
"9255",2020-02-24,"Slate River Rd","w1920","Motorized",NA,"Mon","weekday","sled","Slate River Rd","3","3","2",9.8,0.3,43,3,17,22.8,1,-1,-1,0,4,3,2,2
"9256",2020-02-24,"Slate River Rd","w1920","Hybrid",NA,"Mon","weekday","sled","Slate River Rd","3","3","2",9.8,0.3,43,3,17,22.8,1,-1,-1,0,4,3,2,2
"9257",2020-02-25,"Slate River Rd","w1920","Non.motorized",4,"Tue","weekday","no_sled","Slate River Rd","2","2","1",9.8,0,43,0,8,22.8,3,1,-1,-1,3,4,3,2
"9258",2020-02-25,"Slate River Rd","w1920","Mechanized",0,"Tue","weekday","no_sled","Slate River Rd","2","2","1",9.8,0,43,0,8,22.8,3,1,-1,-1,3,4,3,2
"9259",2020-02-25,"Slate River Rd","w1920","Motorized",1,"Tue","weekday","sled","Slate River Rd","2","2","1",9.8,0,43,0,8,22.8,3,1,-1,-1,3,4,3,2
"9260",2020-02-25,"Slate River Rd","w1920","Hybrid",1,"Tue","weekday","sled","Slate River Rd","2","2","1",9.8,0,43,0,8,22.8,3,1,-1,-1,3,4,3,2
"9261",2020-02-26,"Slate River Rd","w1920","Non.motorized",14,"Wed","weekday","no_sled","Slate River Rd","2","2","1",9.8,0,42,-1,15,23.3,0,3,1,-1,-1,2,3,2
"9262",2020-02-26,"Slate River Rd","w1920","Mechanized",0,"Wed","weekday","no_sled","Slate River Rd","2","2","1",9.8,0,42,-1,15,23.3,0,3,1,-1,-1,2,3,2
"9263",2020-02-26,"Slate River Rd","w1920","Motorized",1,"Wed","weekday","sled","Slate River Rd","2","2","1",9.8,0,42,-1,15,23.3,0,3,1,-1,-1,2,3,2
"9264",2020-02-26,"Slate River Rd","w1920","Hybrid",4,"Wed","weekday","sled","Slate River Rd","2","2","1",9.8,0,42,-1,15,23.3,0,3,1,-1,-1,2,3,2
"9265",2020-02-27,"Slate River Rd","w1920","Non.motorized",23,"Thu","weekday","no_sled","Slate River Rd","2","2","1",9.9,0.1,41,-1,25,24.1,-1,0,3,1,-2,-2,1,2
"9266",2020-02-27,"Slate River Rd","w1920","Mechanized",0,"Thu","weekday","no_sled","Slate River Rd","2","2","1",9.9,0.1,41,-1,25,24.1,-1,0,3,1,-2,-2,1,2
"9267",2020-02-27,"Slate River Rd","w1920","Motorized",2,"Thu","weekday","sled","Slate River Rd","2","2","1",9.9,0.1,41,-1,25,24.1,-1,0,3,1,-2,-2,1,2
"9268",2020-02-27,"Slate River Rd","w1920","Hybrid",7,"Thu","weekday","sled","Slate River Rd","2","2","1",9.9,0.1,41,-1,25,24.1,-1,0,3,1,-2,-2,1,2
"9269",2020-02-28,"Slate River Rd","w1920","Non.motorized",18,"Fri","weekday","no_sled","Slate River Rd","2","1","1",9.9,0,41,0,28,24.1,-1,-1,0,3,-1,-2,-2,1
"9270",2020-02-28,"Slate River Rd","w1920","Mechanized",0,"Fri","weekday","no_sled","Slate River Rd","2","1","1",9.9,0,41,0,28,24.1,-1,-1,0,3,-1,-2,-2,1
"9271",2020-02-28,"Slate River Rd","w1920","Motorized",0,"Fri","weekday","sled","Slate River Rd","2","1","1",9.9,0,41,0,28,24.1,-1,-1,0,3,-1,-2,-2,1
"9272",2020-02-28,"Slate River Rd","w1920","Hybrid",3,"Fri","weekday","sled","Slate River Rd","2","1","1",9.9,0,41,0,28,24.1,-1,-1,0,3,-1,-2,-2,1
"9273",2020-02-29,"Slate River Rd","w1920","Non.motorized",43,"Sat","weekend","no_sled","Slate River Rd","1","1","1",9.9,0,40,-1,29,24.8,0,-1,-1,0,-1,-2,-3,-3
"9274",2020-02-29,"Slate River Rd","w1920","Mechanized",0,"Sat","weekend","no_sled","Slate River Rd","1","1","1",9.9,0,40,-1,29,24.8,0,-1,-1,0,-1,-2,-3,-3
"9275",2020-02-29,"Slate River Rd","w1920","Motorized",0,"Sat","weekend","sled","Slate River Rd","1","1","1",9.9,0,40,-1,29,24.8,0,-1,-1,0,-1,-2,-3,-3
"9276",2020-02-29,"Slate River Rd","w1920","Hybrid",0,"Sat","weekend","sled","Slate River Rd","1","1","1",9.9,0,40,-1,29,24.8,0,-1,-1,0,-1,-2,-3,-3
"9277",2020-03-01,"Slate River Rd","w1920","Non.motorized",23,"Sun","weekend","no_sled","Slate River Rd","1","1","1",10,0.1,40,0,28,25,-1,0,-1,-1,-1,-1,-2,-3
"9278",2020-03-01,"Slate River Rd","w1920","Mechanized",0,"Sun","weekend","no_sled","Slate River Rd","1","1","1",10,0.1,40,0,28,25,-1,0,-1,-1,-1,-1,-2,-3
"9279",2020-03-01,"Slate River Rd","w1920","Motorized",0,"Sun","weekend","sled","Slate River Rd","1","1","1",10,0.1,40,0,28,25,-1,0,-1,-1,-1,-1,-2,-3
"9280",2020-03-01,"Slate River Rd","w1920","Hybrid",1,"Sun","weekend","sled","Slate River Rd","1","1","1",10,0.1,40,0,28,25,-1,0,-1,-1,-1,-1,-2,-3
"9281",2020-03-02,"Slate River Rd","w1920","Non.motorized",12,"Mon","weekday","no_sled","Slate River Rd","2","2","1",10.4,0.4,45,5,25,23.1,0,-1,0,-1,5,4,4,3
"9282",2020-03-02,"Slate River Rd","w1920","Mechanized",1,"Mon","weekday","no_sled","Slate River Rd","2","2","1",10.4,0.4,45,5,25,23.1,0,-1,0,-1,5,4,4,3
"9283",2020-03-02,"Slate River Rd","w1920","Motorized",1,"Mon","weekday","sled","Slate River Rd","2","2","1",10.4,0.4,45,5,25,23.1,0,-1,0,-1,5,4,4,3
"9284",2020-03-02,"Slate River Rd","w1920","Hybrid",1,"Mon","weekday","sled","Slate River Rd","2","2","1",10.4,0.4,45,5,25,23.1,0,-1,0,-1,5,4,4,3
"9285",2020-03-03,"Slate River Rd","w1920","Non.motorized",13,"Tue","weekday","no_sled","Slate River Rd","2","1","1",10.9,0.5,50,5,25,21.8,5,0,-1,0,10,10,9,9
"9286",2020-03-03,"Slate River Rd","w1920","Mechanized",2,"Tue","weekday","no_sled","Slate River Rd","2","1","1",10.9,0.5,50,5,25,21.8,5,0,-1,0,10,10,9,9
"9287",2020-03-03,"Slate River Rd","w1920","Motorized",0,"Tue","weekday","sled","Slate River Rd","2","1","1",10.9,0.5,50,5,25,21.8,5,0,-1,0,10,10,9,9
"9288",2020-03-03,"Slate River Rd","w1920","Hybrid",4,"Tue","weekday","sled","Slate River Rd","2","1","1",10.9,0.5,50,5,25,21.8,5,0,-1,0,10,10,9,9
"9289",2020-03-04,"Slate River Rd","w1920","Non.motorized",31,"Wed","weekday","no_sled","Slate River Rd","2","1","1",10.9,0,48,-2,29,22.7,5,5,0,-1,3,8,8,7
"9290",2020-03-04,"Slate River Rd","w1920","Mechanized",1,"Wed","weekday","no_sled","Slate River Rd","2","1","1",10.9,0,48,-2,29,22.7,5,5,0,-1,3,8,8,7
"9291",2020-03-04,"Slate River Rd","w1920","Motorized",1,"Wed","weekday","sled","Slate River Rd","2","1","1",10.9,0,48,-2,29,22.7,5,5,0,-1,3,8,8,7
"9292",2020-03-04,"Slate River Rd","w1920","Hybrid",4,"Wed","weekday","sled","Slate River Rd","2","1","1",10.9,0,48,-2,29,22.7,5,5,0,-1,3,8,8,7
"9293",2020-03-05,"Slate River Rd","w1920","Non.motorized",6,"Thu","weekday","no_sled","Slate River Rd","2","1","1",10.9,0,46,-2,32,23.7,-2,5,5,0,-4,1,6,6
"9294",2020-03-05,"Slate River Rd","w1920","Mechanized",0,"Thu","weekday","no_sled","Slate River Rd","2","1","1",10.9,0,46,-2,32,23.7,-2,5,5,0,-4,1,6,6
"9295",2020-03-05,"Slate River Rd","w1920","Motorized",0,"Thu","weekday","sled","Slate River Rd","2","1","1",10.9,0,46,-2,32,23.7,-2,5,5,0,-4,1,6,6
"9296",2020-03-05,"Slate River Rd","w1920","Hybrid",4,"Thu","weekday","sled","Slate River Rd","2","1","1",10.9,0,46,-2,32,23.7,-2,5,5,0,-4,1,6,6
"9297",2020-03-06,"Slate River Rd","w1920","Non.motorized",NA,"Fri","weekday","no_sled","Slate River Rd","1","1","1",10.9,0,45,-1,34,24.2,-2,-2,5,5,-3,-5,0,5
"9298",2020-03-06,"Slate River Rd","w1920","Mechanized",NA,"Fri","weekday","no_sled","Slate River Rd","1","1","1",10.9,0,45,-1,34,24.2,-2,-2,5,5,-3,-5,0,5
"9299",2020-03-06,"Slate River Rd","w1920","Motorized",NA,"Fri","weekday","sled","Slate River Rd","1","1","1",10.9,0,45,-1,34,24.2,-2,-2,5,5,-3,-5,0,5
"9300",2020-03-06,"Slate River Rd","w1920","Hybrid",NA,"Fri","weekday","sled","Slate River Rd","1","1","1",10.9,0,45,-1,34,24.2,-2,-2,5,5,-3,-5,0,5
"9301",2020-03-07,"Slate River Rd","w1920","Non.motorized",NA,"Sat","weekend","no_sled","Slate River Rd","1","1","2",10.9,0,44,-1,35,24.8,-1,-2,-2,5,-2,-4,-6,-1
"9302",2020-03-07,"Slate River Rd","w1920","Mechanized",NA,"Sat","weekend","no_sled","Slate River Rd","1","1","2",10.9,0,44,-1,35,24.8,-1,-2,-2,5,-2,-4,-6,-1
"9303",2020-03-07,"Slate River Rd","w1920","Motorized",NA,"Sat","weekend","sled","Slate River Rd","1","1","2",10.9,0,44,-1,35,24.8,-1,-2,-2,5,-2,-4,-6,-1
"9304",2020-03-07,"Slate River Rd","w1920","Hybrid",NA,"Sat","weekend","sled","Slate River Rd","1","1","2",10.9,0,44,-1,35,24.8,-1,-2,-2,5,-2,-4,-6,-1
"9305",2020-03-08,"Slate River Rd","w1920","Non.motorized",NA,"Sun","weekend","no_sled","Slate River Rd","1","1","1",11,0.1,43,-1,33,25.6,-1,-1,-2,-2,-2,-3,-5,-7
"9306",2020-03-08,"Slate River Rd","w1920","Mechanized",NA,"Sun","weekend","no_sled","Slate River Rd","1","1","1",11,0.1,43,-1,33,25.6,-1,-1,-2,-2,-2,-3,-5,-7
"9307",2020-03-08,"Slate River Rd","w1920","Motorized",NA,"Sun","weekend","sled","Slate River Rd","1","1","1",11,0.1,43,-1,33,25.6,-1,-1,-2,-2,-2,-3,-5,-7
"9308",2020-03-08,"Slate River Rd","w1920","Hybrid",NA,"Sun","weekend","sled","Slate River Rd","1","1","1",11,0.1,43,-1,33,25.6,-1,-1,-2,-2,-2,-3,-5,-7
"9309",2020-03-09,"Slate River Rd","w1920","Non.motorized",NA,"Mon","weekday","no_sled","Slate River Rd","1","1","1",11.1,0.1,42,-1,31,26.4,-1,-1,-1,-2,-2,-3,-4,-6
"9310",2020-03-09,"Slate River Rd","w1920","Mechanized",NA,"Mon","weekday","no_sled","Slate River Rd","1","1","1",11.1,0.1,42,-1,31,26.4,-1,-1,-1,-2,-2,-3,-4,-6
"9311",2020-03-09,"Slate River Rd","w1920","Motorized",NA,"Mon","weekday","sled","Slate River Rd","1","1","1",11.1,0.1,42,-1,31,26.4,-1,-1,-1,-2,-2,-3,-4,-6
"9312",2020-03-09,"Slate River Rd","w1920","Hybrid",NA,"Mon","weekday","sled","Slate River Rd","1","1","1",11.1,0.1,42,-1,31,26.4,-1,-1,-1,-2,-2,-3,-4,-6
"9313",2020-03-10,"Slate River Rd","w1920","Non.motorized",NA,"Tue","weekday","no_sled","Slate River Rd","1","1","2",11.2,0.1,44,2,31,25.5,-1,-1,-1,-1,1,0,-1,-2
"9314",2020-03-10,"Slate River Rd","w1920","Mechanized",NA,"Tue","weekday","no_sled","Slate River Rd","1","1","2",11.2,0.1,44,2,31,25.5,-1,-1,-1,-1,1,0,-1,-2
"9315",2020-03-10,"Slate River Rd","w1920","Motorized",NA,"Tue","weekday","sled","Slate River Rd","1","1","2",11.2,0.1,44,2,31,25.5,-1,-1,-1,-1,1,0,-1,-2
"9316",2020-03-10,"Slate River Rd","w1920","Hybrid",NA,"Tue","weekday","sled","Slate River Rd","1","1","2",11.2,0.1,44,2,31,25.5,-1,-1,-1,-1,1,0,-1,-2
"9317",2020-03-11,"Slate River Rd","w1920","Non.motorized",NA,"Wed","weekday","no_sled","Slate River Rd","2","2","1",11.2,0,44,0,32,25.5,2,-1,-1,-1,2,1,0,-1
"9318",2020-03-11,"Slate River Rd","w1920","Mechanized",NA,"Wed","weekday","no_sled","Slate River Rd","2","2","1",11.2,0,44,0,32,25.5,2,-1,-1,-1,2,1,0,-1
"9319",2020-03-11,"Slate River Rd","w1920","Motorized",NA,"Wed","weekday","sled","Slate River Rd","2","2","1",11.2,0,44,0,32,25.5,2,-1,-1,-1,2,1,0,-1
"9320",2020-03-11,"Slate River Rd","w1920","Hybrid",NA,"Wed","weekday","sled","Slate River Rd","2","2","1",11.2,0,44,0,32,25.5,2,-1,-1,-1,2,1,0,-1
"9321",2020-03-12,"Slate River Rd","w1920","Non.motorized",NA,"Thu","weekday","no_sled","Slate River Rd","2","2","2",11.4,0.2,42,-2,35,27.1,0,2,-1,-1,-2,0,-1,-2
"9322",2020-03-12,"Slate River Rd","w1920","Mechanized",NA,"Thu","weekday","no_sled","Slate River Rd","2","2","2",11.4,0.2,42,-2,35,27.1,0,2,-1,-1,-2,0,-1,-2
"9323",2020-03-12,"Slate River Rd","w1920","Motorized",NA,"Thu","weekday","sled","Slate River Rd","2","2","2",11.4,0.2,42,-2,35,27.1,0,2,-1,-1,-2,0,-1,-2
"9324",2020-03-12,"Slate River Rd","w1920","Hybrid",NA,"Thu","weekday","sled","Slate River Rd","2","2","2",11.4,0.2,42,-2,35,27.1,0,2,-1,-1,-2,0,-1,-2
"9325",2020-03-13,"Slate River Rd","w1920","Non.motorized",NA,"Fri","weekday","no_sled","Slate River Rd","3","3","2",11.5,0.1,44,2,31,26.1,-2,0,2,-1,0,0,2,1
"9326",2020-03-13,"Slate River Rd","w1920","Mechanized",NA,"Fri","weekday","no_sled","Slate River Rd","3","3","2",11.5,0.1,44,2,31,26.1,-2,0,2,-1,0,0,2,1
"9327",2020-03-13,"Slate River Rd","w1920","Motorized",NA,"Fri","weekday","sled","Slate River Rd","3","3","2",11.5,0.1,44,2,31,26.1,-2,0,2,-1,0,0,2,1
"9328",2020-03-13,"Slate River Rd","w1920","Hybrid",NA,"Fri","weekday","sled","Slate River Rd","3","3","2",11.5,0.1,44,2,31,26.1,-2,0,2,-1,0,0,2,1
"9329",2020-03-14,"Slate River Rd","w1920","Non.motorized",NA,"Sat","weekend","no_sled","Slate River Rd","3","3","3",11.7,0.2,44,0,31,26.6,2,-2,0,2,2,0,0,2
"9330",2020-03-14,"Slate River Rd","w1920","Mechanized",NA,"Sat","weekend","no_sled","Slate River Rd","3","3","3",11.7,0.2,44,0,31,26.6,2,-2,0,2,2,0,0,2
"9331",2020-03-14,"Slate River Rd","w1920","Motorized",NA,"Sat","weekend","sled","Slate River Rd","3","3","3",11.7,0.2,44,0,31,26.6,2,-2,0,2,2,0,0,2
"9332",2020-03-14,"Slate River Rd","w1920","Hybrid",NA,"Sat","weekend","sled","Slate River Rd","3","3","3",11.7,0.2,44,0,31,26.6,2,-2,0,2,2,0,0,2
"9333",2020-03-15,"Slate River Rd","w1920","Non.motorized",NA,"Sun","weekend","no_sled","Slate River Rd","2","2","2",11.7,0,45,1,33,26,0,2,-2,0,1,3,1,1
"9334",2020-03-15,"Slate River Rd","w1920","Mechanized",NA,"Sun","weekend","no_sled","Slate River Rd","2","2","2",11.7,0,45,1,33,26,0,2,-2,0,1,3,1,1
"9335",2020-03-15,"Slate River Rd","w1920","Motorized",NA,"Sun","weekend","sled","Slate River Rd","2","2","2",11.7,0,45,1,33,26,0,2,-2,0,1,3,1,1
"9336",2020-03-15,"Slate River Rd","w1920","Hybrid",NA,"Sun","weekend","sled","Slate River Rd","2","2","2",11.7,0,45,1,33,26,0,2,-2,0,1,3,1,1
"9337",2020-03-16,"Slate River Rd","w1920","Non.motorized",NA,"Mon","weekday","no_sled","Slate River Rd","2","2","2",11.7,0,45,0,35,26,1,0,2,-2,1,1,3,1
"9338",2020-03-16,"Slate River Rd","w1920","Mechanized",NA,"Mon","weekday","no_sled","Slate River Rd","2","2","2",11.7,0,45,0,35,26,1,0,2,-2,1,1,3,1
"9339",2020-03-16,"Slate River Rd","w1920","Motorized",NA,"Mon","weekday","sled","Slate River Rd","2","2","2",11.7,0,45,0,35,26,1,0,2,-2,1,1,3,1
"9340",2020-03-16,"Slate River Rd","w1920","Hybrid",NA,"Mon","weekday","sled","Slate River Rd","2","2","2",11.7,0,45,0,35,26,1,0,2,-2,1,1,3,1
"9341",2020-03-17,"Slate River Rd","w1920","Non.motorized",NA,"Tue","weekday","no_sled","Slate River Rd","2","2","2",11.7,0,44,-1,36,26.6,0,1,0,2,-1,0,0,2
"9342",2020-03-17,"Slate River Rd","w1920","Mechanized",NA,"Tue","weekday","no_sled","Slate River Rd","2","2","2",11.7,0,44,-1,36,26.6,0,1,0,2,-1,0,0,2
"9343",2020-03-17,"Slate River Rd","w1920","Motorized",NA,"Tue","weekday","sled","Slate River Rd","2","2","2",11.7,0,44,-1,36,26.6,0,1,0,2,-1,0,0,2
"9344",2020-03-17,"Slate River Rd","w1920","Hybrid",NA,"Tue","weekday","sled","Slate River Rd","2","2","2",11.7,0,44,-1,36,26.6,0,1,0,2,-1,0,0,2
"9345",2020-03-18,"Slate River Rd","w1920","Non.motorized",18,"Wed","weekday","no_sled","Slate River Rd","2","2","2",11.7,0,43,-1,33,27.2,-1,0,1,0,-2,-2,-1,-1
"9346",2020-03-18,"Slate River Rd","w1920","Mechanized",0,"Wed","weekday","no_sled","Slate River Rd","2","2","2",11.7,0,43,-1,33,27.2,-1,0,1,0,-2,-2,-1,-1
"9347",2020-03-18,"Slate River Rd","w1920","Motorized",0,"Wed","weekday","sled","Slate River Rd","2","2","2",11.7,0,43,-1,33,27.2,-1,0,1,0,-2,-2,-1,-1
"9348",2020-03-18,"Slate River Rd","w1920","Hybrid",3,"Wed","weekday","sled","Slate River Rd","2","2","2",11.7,0,43,-1,33,27.2,-1,0,1,0,-2,-2,-1,-1
"9349",2020-03-19,"Slate River Rd","w1920","Non.motorized",4,"Thu","weekday","no_sled","Slate River Rd","3","3","3",11.8,0.1,43,0,27,27.4,-1,-1,0,1,-1,-2,-2,-1
"9350",2020-03-19,"Slate River Rd","w1920","Mechanized",0,"Thu","weekday","no_sled","Slate River Rd","3","3","3",11.8,0.1,43,0,27,27.4,-1,-1,0,1,-1,-2,-2,-1
"9351",2020-03-19,"Slate River Rd","w1920","Motorized",0,"Thu","weekday","sled","Slate River Rd","3","3","3",11.8,0.1,43,0,27,27.4,-1,-1,0,1,-1,-2,-2,-1
"9352",2020-03-19,"Slate River Rd","w1920","Hybrid",1,"Thu","weekday","sled","Slate River Rd","3","3","3",11.8,0.1,43,0,27,27.4,-1,-1,0,1,-1,-2,-2,-1
"9353",2020-03-20,"Slate River Rd","w1920","Non.motorized",10,"Fri","weekday","no_sled","Slate River Rd","3","3","2",12.7,0.9,52,9,26,24.4,0,-1,-1,0,9,8,7,7
"9354",2020-03-20,"Slate River Rd","w1920","Mechanized",0,"Fri","weekday","no_sled","Slate River Rd","3","3","2",12.7,0.9,52,9,26,24.4,0,-1,-1,0,9,8,7,7
"9355",2020-03-20,"Slate River Rd","w1920","Motorized",0,"Fri","weekday","sled","Slate River Rd","3","3","2",12.7,0.9,52,9,26,24.4,0,-1,-1,0,9,8,7,7
"9356",2020-03-20,"Slate River Rd","w1920","Hybrid",12,"Fri","weekday","sled","Slate River Rd","3","3","2",12.7,0.9,52,9,26,24.4,0,-1,-1,0,9,8,7,7
"9357",2020-03-21,"Slate River Rd","w1920","Non.motorized",56,"Sat","weekend","no_sled","Slate River Rd","3","3","2",12.8,0.1,54,2,26,23.7,9,0,-1,-1,11,11,10,9
"9358",2020-03-21,"Slate River Rd","w1920","Mechanized",0,"Sat","weekend","no_sled","Slate River Rd","3","3","2",12.8,0.1,54,2,26,23.7,9,0,-1,-1,11,11,10,9
"9359",2020-03-21,"Slate River Rd","w1920","Motorized",1,"Sat","weekend","sled","Slate River Rd","3","3","2",12.8,0.1,54,2,26,23.7,9,0,-1,-1,11,11,10,9
"9360",2020-03-21,"Slate River Rd","w1920","Hybrid",15,"Sat","weekend","sled","Slate River Rd","3","3","2",12.8,0.1,54,2,26,23.7,9,0,-1,-1,11,11,10,9
"9361",2020-03-22,"Slate River Rd","w1920","Non.motorized",39,"Sun","weekend","no_sled","Slate River Rd","2","2","2",13,0.2,53,-1,28,24.5,2,9,0,-1,1,10,10,9
"9362",2020-03-22,"Slate River Rd","w1920","Mechanized",0,"Sun","weekend","no_sled","Slate River Rd","2","2","2",13,0.2,53,-1,28,24.5,2,9,0,-1,1,10,10,9
"9363",2020-03-22,"Slate River Rd","w1920","Motorized",2,"Sun","weekend","sled","Slate River Rd","2","2","2",13,0.2,53,-1,28,24.5,2,9,0,-1,1,10,10,9
"9364",2020-03-22,"Slate River Rd","w1920","Hybrid",5,"Sun","weekend","sled","Slate River Rd","2","2","2",13,0.2,53,-1,28,24.5,2,9,0,-1,1,10,10,9
"9365",2020-03-23,"Slate River Rd","w1920","Non.motorized",11,"Mon","weekday","no_sled","Slate River Rd","2","2","2",13,0,53,0,28,24.5,-1,2,9,0,-1,1,10,10
"9366",2020-03-23,"Slate River Rd","w1920","Mechanized",1,"Mon","weekday","no_sled","Slate River Rd","2","2","2",13,0,53,0,28,24.5,-1,2,9,0,-1,1,10,10
"9367",2020-03-23,"Slate River Rd","w1920","Motorized",0,"Mon","weekday","sled","Slate River Rd","2","2","2",13,0,53,0,28,24.5,-1,2,9,0,-1,1,10,10
"9368",2020-03-23,"Slate River Rd","w1920","Hybrid",2,"Mon","weekday","sled","Slate River Rd","2","2","2",13,0,53,0,28,24.5,-1,2,9,0,-1,1,10,10
"9369",2020-03-24,"Slate River Rd","w1920","Non.motorized",19,"Tue","weekday","no_sled","Slate River Rd","2","2","2",13.2,0.2,53,0,32,24.9,0,-1,2,9,0,-1,1,10
"9370",2020-03-24,"Slate River Rd","w1920","Mechanized",0,"Tue","weekday","no_sled","Slate River Rd","2","2","2",13.2,0.2,53,0,32,24.9,0,-1,2,9,0,-1,1,10
"9371",2020-03-24,"Slate River Rd","w1920","Motorized",1,"Tue","weekday","sled","Slate River Rd","2","2","2",13.2,0.2,53,0,32,24.9,0,-1,2,9,0,-1,1,10
"9372",2020-03-24,"Slate River Rd","w1920","Hybrid",1,"Tue","weekday","sled","Slate River Rd","2","2","2",13.2,0.2,53,0,32,24.9,0,-1,2,9,0,-1,1,10
"9373",2020-03-25,"Slate River Rd","w1920","Non.motorized",18,"Wed","weekday","no_sled","Slate River Rd","2","2","2",13.3,0.1,51,-2,34,26.1,0,0,-1,2,-2,-2,-3,-1
"9374",2020-03-25,"Slate River Rd","w1920","Mechanized",1,"Wed","weekday","no_sled","Slate River Rd","2","2","2",13.3,0.1,51,-2,34,26.1,0,0,-1,2,-2,-2,-3,-1
"9375",2020-03-25,"Slate River Rd","w1920","Motorized",1,"Wed","weekday","sled","Slate River Rd","2","2","2",13.3,0.1,51,-2,34,26.1,0,0,-1,2,-2,-2,-3,-1
"9376",2020-03-25,"Slate River Rd","w1920","Hybrid",3,"Wed","weekday","sled","Slate River Rd","2","2","2",13.3,0.1,51,-2,34,26.1,0,0,-1,2,-2,-2,-3,-1
"9377",2020-03-26,"Slate River Rd","w1920","Non.motorized",16,"Thu","weekday","no_sled","Slate River Rd","2","2","2",13.3,0,50,-1,36,26.6,-2,0,0,-1,-3,-3,-3,-4
"9378",2020-03-26,"Slate River Rd","w1920","Non.motorized",16,"Thu","weekday","no_sled","Slate River Rd","3","3","2",13.3,0,50,-1,36,26.6,-2,0,0,-1,-3,-3,-3,-4
"9379",2020-03-26,"Slate River Rd","w1920","Mechanized",0,"Thu","weekday","no_sled","Slate River Rd","2","2","2",13.3,0,50,-1,36,26.6,-2,0,0,-1,-3,-3,-3,-4
"9380",2020-03-26,"Slate River Rd","w1920","Mechanized",0,"Thu","weekday","no_sled","Slate River Rd","3","3","2",13.3,0,50,-1,36,26.6,-2,0,0,-1,-3,-3,-3,-4
"9381",2020-03-26,"Slate River Rd","w1920","Motorized",2,"Thu","weekday","sled","Slate River Rd","2","2","2",13.3,0,50,-1,36,26.6,-2,0,0,-1,-3,-3,-3,-4
"9382",2020-03-26,"Slate River Rd","w1920","Motorized",2,"Thu","weekday","sled","Slate River Rd","3","3","2",13.3,0,50,-1,36,26.6,-2,0,0,-1,-3,-3,-3,-4
"9383",2020-03-26,"Slate River Rd","w1920","Hybrid",4,"Thu","weekday","sled","Slate River Rd","2","2","2",13.3,0,50,-1,36,26.6,-2,0,0,-1,-3,-3,-3,-4
"9384",2020-03-26,"Slate River Rd","w1920","Hybrid",4,"Thu","weekday","sled","Slate River Rd","3","3","2",13.3,0,50,-1,36,26.6,-2,0,0,-1,-3,-3,-3,-4
"9385",2020-03-27,"Slate River Rd","w1920","Non.motorized",7,"Fri","weekday","no_sled","Slate River Rd","3","3","2",13.3,0,50,0,23,26.6,-1,-2,0,0,-1,-3,-3,-3
"9386",2020-03-27,"Slate River Rd","w1920","Mechanized",0,"Fri","weekday","no_sled","Slate River Rd","3","3","2",13.3,0,50,0,23,26.6,-1,-2,0,0,-1,-3,-3,-3
"9387",2020-03-27,"Slate River Rd","w1920","Motorized",0,"Fri","weekday","sled","Slate River Rd","3","3","2",13.3,0,50,0,23,26.6,-1,-2,0,0,-1,-3,-3,-3
"9388",2020-03-27,"Slate River Rd","w1920","Hybrid",2,"Fri","weekday","sled","Slate River Rd","3","3","2",13.3,0,50,0,23,26.6,-1,-2,0,0,-1,-3,-3,-3
"9389",2020-03-28,"Slate River Rd","w1920","Non.motorized",24,"Sat","weekend","no_sled","Slate River Rd","3","3","3",13.3,0,50,0,18,26.6,0,-1,-2,0,0,-1,-3,-3
"9390",2020-03-28,"Slate River Rd","w1920","Mechanized",0,"Sat","weekend","no_sled","Slate River Rd","3","3","3",13.3,0,50,0,18,26.6,0,-1,-2,0,0,-1,-3,-3
"9391",2020-03-28,"Slate River Rd","w1920","Motorized",3,"Sat","weekend","sled","Slate River Rd","3","3","3",13.3,0,50,0,18,26.6,0,-1,-2,0,0,-1,-3,-3
"9392",2020-03-28,"Slate River Rd","w1920","Hybrid",1,"Sat","weekend","sled","Slate River Rd","3","3","3",13.3,0,50,0,18,26.6,0,-1,-2,0,0,-1,-3,-3
"9393",2020-03-29,"Slate River Rd","w1920","Non.motorized",22,"Sun","weekend","no_sled","Slate River Rd","2","2","2",13.3,0,49,-1,24,27.1,0,0,-1,-2,-1,-1,-2,-4
"9394",2020-03-29,"Slate River Rd","w1920","Mechanized",1,"Sun","weekend","no_sled","Slate River Rd","2","2","2",13.3,0,49,-1,24,27.1,0,0,-1,-2,-1,-1,-2,-4
"9395",2020-03-29,"Slate River Rd","w1920","Motorized",0,"Sun","weekend","sled","Slate River Rd","2","2","2",13.3,0,49,-1,24,27.1,0,0,-1,-2,-1,-1,-2,-4
"9396",2020-03-29,"Slate River Rd","w1920","Hybrid",4,"Sun","weekend","sled","Slate River Rd","2","2","2",13.3,0,49,-1,24,27.1,0,0,-1,-2,-1,-1,-2,-4
"9397",2020-03-30,"Slate River Rd","w1920","Non.motorized",10,"Mon","weekday","no_sled","Slate River Rd","2","2","2",13.4,0.1,49,0,29,27.3,-1,0,0,-1,-1,-1,-1,-2
"9398",2020-03-30,"Slate River Rd","w1920","Mechanized",0,"Mon","weekday","no_sled","Slate River Rd","2","2","2",13.4,0.1,49,0,29,27.3,-1,0,0,-1,-1,-1,-1,-2
"9399",2020-03-30,"Slate River Rd","w1920","Motorized",1,"Mon","weekday","sled","Slate River Rd","2","2","2",13.4,0.1,49,0,29,27.3,-1,0,0,-1,-1,-1,-1,-2
"9400",2020-03-30,"Slate River Rd","w1920","Hybrid",5,"Mon","weekday","sled","Slate River Rd","2","2","2",13.4,0.1,49,0,29,27.3,-1,0,0,-1,-1,-1,-1,-2
"9401",2020-03-31,"Slate River Rd","w1920","Non.motorized",27,"Tue","weekday","no_sled","Slate River Rd","2","2","2",13.6,0.2,51,2,35,26.7,0,-1,0,0,2,1,1,1
"9402",2020-03-31,"Slate River Rd","w1920","Mechanized",0,"Tue","weekday","no_sled","Slate River Rd","2","2","2",13.6,0.2,51,2,35,26.7,0,-1,0,0,2,1,1,1
"9403",2020-03-31,"Slate River Rd","w1920","Motorized",2,"Tue","weekday","sled","Slate River Rd","2","2","2",13.6,0.2,51,2,35,26.7,0,-1,0,0,2,1,1,1
"9404",2020-03-31,"Slate River Rd","w1920","Hybrid",5,"Tue","weekday","sled","Slate River Rd","2","2","2",13.6,0.2,51,2,35,26.7,0,-1,0,0,2,1,1,1
"9405",2020-04-01,"Slate River Rd","w1920","Non.motorized",15,"Wed","weekday","no_sled","Slate River Rd","2","2","2",13.6,0,47,-4,39,28.9,2,0,-1,0,-2,-2,-3,-3
"9406",2020-04-01,"Slate River Rd","w1920","Mechanized",0,"Wed","weekday","no_sled","Slate River Rd","2","2","2",13.6,0,47,-4,39,28.9,2,0,-1,0,-2,-2,-3,-3
"9407",2020-04-01,"Slate River Rd","w1920","Motorized",0,"Wed","weekday","sled","Slate River Rd","2","2","2",13.6,0,47,-4,39,28.9,2,0,-1,0,-2,-2,-3,-3
"9408",2020-04-01,"Slate River Rd","w1920","Hybrid",3,"Wed","weekday","sled","Slate River Rd","2","2","2",13.6,0,47,-4,39,28.9,2,0,-1,0,-2,-2,-3,-3
"9409",2020-04-02,"Slate River Rd","w1920","Non.motorized",5,"Thu","weekday","no_sled","Slate River Rd","2","2","2",13.6,0,46,-1,31,29.6,-4,2,0,-1,-5,-3,-3,-4
"9410",2020-04-02,"Slate River Rd","w1920","Mechanized",0,"Thu","weekday","no_sled","Slate River Rd","2","2","2",13.6,0,46,-1,31,29.6,-4,2,0,-1,-5,-3,-3,-4
"9411",2020-04-02,"Slate River Rd","w1920","Motorized",0,"Thu","weekday","sled","Slate River Rd","2","2","2",13.6,0,46,-1,31,29.6,-4,2,0,-1,-5,-3,-3,-4
"9412",2020-04-02,"Slate River Rd","w1920","Hybrid",0,"Thu","weekday","sled","Slate River Rd","2","2","2",13.6,0,46,-1,31,29.6,-4,2,0,-1,-5,-3,-3,-4
"9413",2020-04-03,"Slate River Rd","w1920","Non.motorized",17,"Fri","weekday","no_sled","Slate River Rd","2","2","2",13.6,0,46,0,28,29.6,-1,-4,2,0,-1,-5,-3,-3
"9414",2020-04-03,"Slate River Rd","w1920","Mechanized",0,"Fri","weekday","no_sled","Slate River Rd","2","2","2",13.6,0,46,0,28,29.6,-1,-4,2,0,-1,-5,-3,-3
"9415",2020-04-03,"Slate River Rd","w1920","Motorized",2,"Fri","weekday","sled","Slate River Rd","2","2","2",13.6,0,46,0,28,29.6,-1,-4,2,0,-1,-5,-3,-3
"9416",2020-04-03,"Slate River Rd","w1920","Hybrid",4,"Fri","weekday","sled","Slate River Rd","2","2","2",13.6,0,46,0,28,29.6,-1,-4,2,0,-1,-5,-3,-3
"9417",2020-04-04,"Slate River Rd","w1920","Non.motorized",15,"Sat","weekend","no_sled","Slate River Rd","2","2","2",13.6,0,45,-1,33,30.2,0,-1,-4,2,-1,-2,-6,-4
"9418",2020-04-04,"Slate River Rd","w1920","Mechanized",0,"Sat","weekend","no_sled","Slate River Rd","2","2","2",13.6,0,45,-1,33,30.2,0,-1,-4,2,-1,-2,-6,-4
"9419",2020-04-04,"Slate River Rd","w1920","Motorized",3,"Sat","weekend","sled","Slate River Rd","2","2","2",13.6,0,45,-1,33,30.2,0,-1,-4,2,-1,-2,-6,-4
"9420",2020-04-04,"Slate River Rd","w1920","Hybrid",6,"Sat","weekend","sled","Slate River Rd","2","2","2",13.6,0,45,-1,33,30.2,0,-1,-4,2,-1,-2,-6,-4
"9421",2020-04-05,"Slate River Rd","w1920","Non.motorized",42,"Sun","weekend","no_sled","Slate River Rd","2","2","3",13.6,0,45,0,38,30.2,-1,0,-1,-4,-1,-1,-2,-6
"9422",2020-04-05,"Slate River Rd","w1920","Mechanized",1,"Sun","weekend","no_sled","Slate River Rd","2","2","3",13.6,0,45,0,38,30.2,-1,0,-1,-4,-1,-1,-2,-6
"9423",2020-04-05,"Slate River Rd","w1920","Motorized",0,"Sun","weekend","sled","Slate River Rd","2","2","3",13.6,0,45,0,38,30.2,-1,0,-1,-4,-1,-1,-2,-6
"9424",2020-04-05,"Slate River Rd","w1920","Hybrid",6,"Sun","weekend","sled","Slate River Rd","2","2","3",13.6,0,45,0,38,30.2,-1,0,-1,-4,-1,-1,-2,-6
"9425",2020-04-06,"Slate River Rd","w1920","Non.motorized",15,"Mon","weekday","no_sled","Slate River Rd","2","2","3",13.6,0,44,-1,40,30.9,0,-1,0,-1,-1,-2,-2,-3
"9426",2020-04-06,"Slate River Rd","w1920","Mechanized",0,"Mon","weekday","no_sled","Slate River Rd","2","2","3",13.6,0,44,-1,40,30.9,0,-1,0,-1,-1,-2,-2,-3
"9427",2020-04-06,"Slate River Rd","w1920","Motorized",0,"Mon","weekday","sled","Slate River Rd","2","2","3",13.6,0,44,-1,40,30.9,0,-1,0,-1,-1,-2,-2,-3
"9428",2020-04-06,"Slate River Rd","w1920","Hybrid",9,"Mon","weekday","sled","Slate River Rd","2","2","3",13.6,0,44,-1,40,30.9,0,-1,0,-1,-1,-2,-2,-3
"9429",2020-04-07,"Slate River Rd","w1920","Non.motorized",16,"Tue","weekday","no_sled","Slate River Rd","2","2","3",13.4,-0.2,43,-1,39,31.2,-1,0,-1,0,-2,-2,-3,-3
"9430",2020-04-07,"Slate River Rd","w1920","Mechanized",0,"Tue","weekday","no_sled","Slate River Rd","2","2","3",13.4,-0.2,43,-1,39,31.2,-1,0,-1,0,-2,-2,-3,-3
"9431",2020-04-07,"Slate River Rd","w1920","Motorized",1,"Tue","weekday","sled","Slate River Rd","2","2","3",13.4,-0.2,43,-1,39,31.2,-1,0,-1,0,-2,-2,-3,-3
"9432",2020-04-07,"Slate River Rd","w1920","Hybrid",0,"Tue","weekday","sled","Slate River Rd","2","2","3",13.4,-0.2,43,-1,39,31.2,-1,0,-1,0,-2,-2,-3,-3
"9433",2020-04-08,"Slate River Rd","w1920","Non.motorized",4,"Wed","weekday","no_sled","Slate River Rd","2","3","3",13.3,-0.1,42,-1,40,31.7,-1,-1,0,-1,-2,-3,-3,-4
"9434",2020-04-08,"Slate River Rd","w1920","Mechanized",2,"Wed","weekday","no_sled","Slate River Rd","2","3","3",13.3,-0.1,42,-1,40,31.7,-1,-1,0,-1,-2,-3,-3,-4
"9435",2020-04-08,"Slate River Rd","w1920","Motorized",0,"Wed","weekday","sled","Slate River Rd","2","3","3",13.3,-0.1,42,-1,40,31.7,-1,-1,0,-1,-2,-3,-3,-4
"9436",2020-04-08,"Slate River Rd","w1920","Hybrid",2,"Wed","weekday","sled","Slate River Rd","2","3","3",13.3,-0.1,42,-1,40,31.7,-1,-1,0,-1,-2,-3,-3,-4
"9437",2020-04-09,"Slate River Rd","w1920","Non.motorized",NA,"Thu","weekday","no_sled","Slate River Rd","2","3","3",13.1,-0.2,40,-2,42,32.8,-1,-1,-1,0,-3,-4,-5,-5
"9438",2020-04-09,"Slate River Rd","w1920","Mechanized",NA,"Thu","weekday","no_sled","Slate River Rd","2","3","3",13.1,-0.2,40,-2,42,32.8,-1,-1,-1,0,-3,-4,-5,-5
"9439",2020-04-09,"Slate River Rd","w1920","Motorized",NA,"Thu","weekday","sled","Slate River Rd","2","3","3",13.1,-0.2,40,-2,42,32.8,-1,-1,-1,0,-3,-4,-5,-5
"9440",2020-04-09,"Slate River Rd","w1920","Hybrid",NA,"Thu","weekday","sled","Slate River Rd","2","3","3",13.1,-0.2,40,-2,42,32.8,-1,-1,-1,0,-3,-4,-5,-5
"9441",2020-04-10,"Slate River Rd","w1920","Non.motorized",NA,"Fri","weekday","no_sled","Slate River Rd","3","3","3",12.9,-0.2,39,-1,38,33.1,-2,-1,-1,-1,-3,-4,-5,-6
"9442",2020-04-10,"Slate River Rd","w1920","Mechanized",NA,"Fri","weekday","no_sled","Slate River Rd","3","3","3",12.9,-0.2,39,-1,38,33.1,-2,-1,-1,-1,-3,-4,-5,-6
"9443",2020-04-10,"Slate River Rd","w1920","Motorized",NA,"Fri","weekday","sled","Slate River Rd","3","3","3",12.9,-0.2,39,-1,38,33.1,-2,-1,-1,-1,-3,-4,-5,-6
"9444",2020-04-10,"Slate River Rd","w1920","Hybrid",NA,"Fri","weekday","sled","Slate River Rd","3","3","3",12.9,-0.2,39,-1,38,33.1,-2,-1,-1,-1,-3,-4,-5,-6
"9445",2020-04-11,"Slate River Rd","w1920","Non.motorized",0,"Sat","weekend","no_sled","Slate River Rd","2","3","3",12.9,0,39,0,36,33.1,-1,-2,-1,-1,-1,-3,-4,-5
"9446",2020-04-11,"Slate River Rd","w1920","Mechanized",0,"Sat","weekend","no_sled","Slate River Rd","2","3","3",12.9,0,39,0,36,33.1,-1,-2,-1,-1,-1,-3,-4,-5
"9447",2020-04-11,"Slate River Rd","w1920","Motorized",1,"Sat","weekend","sled","Slate River Rd","2","3","3",12.9,0,39,0,36,33.1,-1,-2,-1,-1,-1,-3,-4,-5
"9448",2020-04-11,"Slate River Rd","w1920","Hybrid",4,"Sat","weekend","sled","Slate River Rd","2","3","3",12.9,0,39,0,36,33.1,-1,-2,-1,-1,-1,-3,-4,-5
"9449",2020-04-12,"Slate River Rd","w1920","Non.motorized",7,"Sun","weekend","no_sled","Slate River Rd","2","2","2",12.8,-0.1,38,-1,29,33.7,0,-1,-2,-1,-1,-2,-4,-5
"9450",2020-04-12,"Slate River Rd","w1920","Mechanized",0,"Sun","weekend","no_sled","Slate River Rd","2","2","2",12.8,-0.1,38,-1,29,33.7,0,-1,-2,-1,-1,-2,-4,-5
"9451",2020-04-12,"Slate River Rd","w1920","Motorized",1,"Sun","weekend","sled","Slate River Rd","2","2","2",12.8,-0.1,38,-1,29,33.7,0,-1,-2,-1,-1,-2,-4,-5
"9452",2020-04-12,"Slate River Rd","w1920","Hybrid",2,"Sun","weekend","sled","Slate River Rd","2","2","2",12.8,-0.1,38,-1,29,33.7,0,-1,-2,-1,-1,-2,-4,-5
"9453",2020-04-13,"Slate River Rd","w1920","Non.motorized",13,"Mon","weekday","no_sled","Slate River Rd",NA,NA,NA,12.9,0.1,39,1,20,33.1,-1,0,-1,-2,0,0,-1,-3
"9454",2020-04-13,"Slate River Rd","w1920","Mechanized",0,"Mon","weekday","no_sled","Slate River Rd",NA,NA,NA,12.9,0.1,39,1,20,33.1,-1,0,-1,-2,0,0,-1,-3
"9455",2020-04-13,"Slate River Rd","w1920","Motorized",1,"Mon","weekday","sled","Slate River Rd",NA,NA,NA,12.9,0.1,39,1,20,33.1,-1,0,-1,-2,0,0,-1,-3
"9456",2020-04-13,"Slate River Rd","w1920","Hybrid",5,"Mon","weekday","sled","Slate River Rd",NA,NA,NA,12.9,0.1,39,1,20,33.1,-1,0,-1,-2,0,0,-1,-3
"9457",2020-04-14,"Slate River Rd","w1920","Non.motorized",12,"Tue","weekday","no_sled","Slate River Rd","2","2","2",13,0.1,39,0,18,33.3,1,-1,0,-1,1,0,0,-1
"9458",2020-04-14,"Slate River Rd","w1920","Mechanized",0,"Tue","weekday","no_sled","Slate River Rd","2","2","2",13,0.1,39,0,18,33.3,1,-1,0,-1,1,0,0,-1
"9459",2020-04-14,"Slate River Rd","w1920","Motorized",0,"Tue","weekday","sled","Slate River Rd","2","2","2",13,0.1,39,0,18,33.3,1,-1,0,-1,1,0,0,-1
"9460",2020-04-14,"Slate River Rd","w1920","Hybrid",6,"Tue","weekday","sled","Slate River Rd","2","2","2",13,0.1,39,0,18,33.3,1,-1,0,-1,1,0,0,-1
"9461",2020-04-15,"Slate River Rd","w1920","Non.motorized",9,"Wed","weekday","no_sled","Slate River Rd",NA,NA,NA,13.2,0.2,39,0,28,33.8,0,1,-1,0,0,1,0,0
"9462",2020-04-15,"Slate River Rd","w1920","Mechanized",0,"Wed","weekday","no_sled","Slate River Rd",NA,NA,NA,13.2,0.2,39,0,28,33.8,0,1,-1,0,0,1,0,0
"9463",2020-04-15,"Slate River Rd","w1920","Motorized",1,"Wed","weekday","sled","Slate River Rd",NA,NA,NA,13.2,0.2,39,0,28,33.8,0,1,-1,0,0,1,0,0
"9464",2020-04-15,"Slate River Rd","w1920","Hybrid",7,"Wed","weekday","sled","Slate River Rd",NA,NA,NA,13.2,0.2,39,0,28,33.8,0,1,-1,0,0,1,0,0
"9465",2020-04-16,"Slate River Rd","w1920","Non.motorized",10,"Thu","weekday","no_sled","Slate River Rd",NA,NA,NA,NA,NA,NA,NA,NA,NA,NA,NA,NA,NA,NA,NA,NA,NA
"9466",2020-04-16,"Slate River Rd","w1920","Mechanized",0,"Thu","weekday","no_sled","Slate River Rd",NA,NA,NA,NA,NA,NA,NA,NA,NA,NA,NA,NA,NA,NA,NA,NA,NA
"9467",2020-04-16,"Slate River Rd","w1920","Motorized",1,"Thu","weekday","sled","Slate River Rd",NA,NA,NA,NA,NA,NA,NA,NA,NA,NA,NA,NA,NA,NA,NA,NA,NA
"9468",2020-04-16,"Slate River Rd","w1920","Hybrid",3,"Thu","weekday","sled","Slate River Rd",NA,NA,NA,NA,NA,NA,NA,NA,NA,NA,NA,NA,NA,NA,NA,NA,NA
"9469",2020-04-17,"Slate River Rd","w1920","Non.motorized",13,"Fri","weekday","no_sled","Slate River Rd",NA,NA,NA,NA,NA,NA,NA,NA,NA,NA,NA,NA,NA,NA,NA,NA,NA
"9470",2020-04-17,"Slate River Rd","w1920","Mechanized",0,"Fri","weekday","no_sled","Slate River Rd",NA,NA,NA,NA,NA,NA,NA,NA,NA,NA,NA,NA,NA,NA,NA,NA,NA
"9471",2020-04-17,"Slate River Rd","w1920","Motorized",0,"Fri","weekday","sled","Slate River Rd",NA,NA,NA,NA,NA,NA,NA,NA,NA,NA,NA,NA,NA,NA,NA,NA,NA
"9472",2020-04-17,"Slate River Rd","w1920","Hybrid",5,"Fri","weekday","sled","Slate River Rd",NA,NA,NA,NA,NA,NA,NA,NA,NA,NA,NA,NA,NA,NA,NA,NA,NA
"9473",2020-04-18,"Slate River Rd","w1920","Non.motorized",13,"Sat","weekend","no_sled","Slate River Rd",NA,NA,NA,NA,NA,NA,NA,NA,NA,NA,NA,NA,NA,NA,NA,NA,NA
"9474",2020-04-18,"Slate River Rd","w1920","Mechanized",2,"Sat","weekend","no_sled","Slate River Rd",NA,NA,NA,NA,NA,NA,NA,NA,NA,NA,NA,NA,NA,NA,NA,NA,NA
"9475",2020-04-18,"Slate River Rd","w1920","Motorized",0,"Sat","weekend","sled","Slate River Rd",NA,NA,NA,NA,NA,NA,NA,NA,NA,NA,NA,NA,NA,NA,NA,NA,NA
"9476",2020-04-18,"Slate River Rd","w1920","Hybrid",6,"Sat","weekend","sled","Slate River Rd",NA,NA,NA,NA,NA,NA,NA,NA,NA,NA,NA,NA,NA,NA,NA,NA,NA
"9477",2020-04-19,"Slate River Rd","w1920","Non.motorized",24,"Sun","weekend","no_sled","Slate River Rd",NA,NA,NA,NA,NA,NA,NA,NA,NA,NA,NA,NA,NA,NA,NA,NA,NA
"9478",2020-04-19,"Slate River Rd","w1920","Mechanized",0,"Sun","weekend","no_sled","Slate River Rd",NA,NA,NA,NA,NA,NA,NA,NA,NA,NA,NA,NA,NA,NA,NA,NA,NA
"9479",2020-04-19,"Slate River Rd","w1920","Motorized",0,"Sun","weekend","sled","Slate River Rd",NA,NA,NA,NA,NA,NA,NA,NA,NA,NA,NA,NA,NA,NA,NA,NA,NA
"9480",2020-04-19,"Slate River Rd","w1920","Hybrid",0,"Sun","weekend","sled","Slate River Rd",NA,NA,NA,NA,NA,NA,NA,NA,NA,NA,NA,NA,NA,NA,NA,NA,NA
"9481",2020-04-20,"Slate River Rd","w1920","Non.motorized",7,"Mon","weekday","no_sled","Slate River Rd",NA,NA,NA,NA,NA,NA,NA,NA,NA,NA,NA,NA,NA,NA,NA,NA,NA
"9482",2020-04-20,"Slate River Rd","w1920","Mechanized",0,"Mon","weekday","no_sled","Slate River Rd",NA,NA,NA,NA,NA,NA,NA,NA,NA,NA,NA,NA,NA,NA,NA,NA,NA
"9483",2020-04-20,"Slate River Rd","w1920","Motorized",0,"Mon","weekday","sled","Slate River Rd",NA,NA,NA,NA,NA,NA,NA,NA,NA,NA,NA,NA,NA,NA,NA,NA,NA
"9484",2020-04-20,"Slate River Rd","w1920","Hybrid",0,"Mon","weekday","sled","Slate River Rd",NA,NA,NA,NA,NA,NA,NA,NA,NA,NA,NA,NA,NA,NA,NA,NA,NA
"9485",2020-04-21,"Slate River Rd","w1920","Non.motorized",18,"Tue","weekday","no_sled","Slate River Rd",NA,NA,NA,NA,NA,NA,NA,NA,NA,NA,NA,NA,NA,NA,NA,NA,NA
"9486",2020-04-21,"Slate River Rd","w1920","Mechanized",0,"Tue","weekday","no_sled","Slate River Rd",NA,NA,NA,NA,NA,NA,NA,NA,NA,NA,NA,NA,NA,NA,NA,NA,NA
"9487",2020-04-21,"Slate River Rd","w1920","Motorized",1,"Tue","weekday","sled","Slate River Rd",NA,NA,NA,NA,NA,NA,NA,NA,NA,NA,NA,NA,NA,NA,NA,NA,NA
"9488",2020-04-21,"Slate River Rd","w1920","Hybrid",0,"Tue","weekday","sled","Slate River Rd",NA,NA,NA,NA,NA,NA,NA,NA,NA,NA,NA,NA,NA,NA,NA,NA,NA
"9489",2020-04-22,"Slate River Rd","w1920","Non.motorized",10,"Wed","weekday","no_sled","Slate River Rd",NA,NA,NA,NA,NA,NA,NA,NA,NA,NA,NA,NA,NA,NA,NA,NA,NA
"9490",2020-04-22,"Slate River Rd","w1920","Mechanized",0,"Wed","weekday","no_sled","Slate River Rd",NA,NA,NA,NA,NA,NA,NA,NA,NA,NA,NA,NA,NA,NA,NA,NA,NA
"9491",2020-04-22,"Slate River Rd","w1920","Motorized",1,"Wed","weekday","sled","Slate River Rd",NA,NA,NA,NA,NA,NA,NA,NA,NA,NA,NA,NA,NA,NA,NA,NA,NA
"9492",2020-04-22,"Slate River Rd","w1920","Hybrid",1,"Wed","weekday","sled","Slate River Rd",NA,NA,NA,NA,NA,NA,NA,NA,NA,NA,NA,NA,NA,NA,NA,NA,NA
"9493",2020-04-23,"Slate River Rd","w1920","Non.motorized",8,"Thu","weekday","no_sled","Slate River Rd",NA,NA,NA,NA,NA,NA,NA,NA,NA,NA,NA,NA,NA,NA,NA,NA,NA
"9494",2020-04-23,"Slate River Rd","w1920","Mechanized",0,"Thu","weekday","no_sled","Slate River Rd",NA,NA,NA,NA,NA,NA,NA,NA,NA,NA,NA,NA,NA,NA,NA,NA,NA
"9495",2020-04-23,"Slate River Rd","w1920","Motorized",0,"Thu","weekday","sled","Slate River Rd",NA,NA,NA,NA,NA,NA,NA,NA,NA,NA,NA,NA,NA,NA,NA,NA,NA
"9496",2020-04-23,"Slate River Rd","w1920","Hybrid",1,"Thu","weekday","sled","Slate River Rd",NA,NA,NA,NA,NA,NA,NA,NA,NA,NA,NA,NA,NA,NA,NA,NA,NA
"9497",2020-04-24,"Slate River Rd","w1920","Non.motorized",10,"Fri","weekday","no_sled","Slate River Rd",NA,NA,NA,NA,NA,NA,NA,NA,NA,NA,NA,NA,NA,NA,NA,NA,NA
"9498",2020-04-24,"Slate River Rd","w1920","Mechanized",0,"Fri","weekday","no_sled","Slate River Rd",NA,NA,NA,NA,NA,NA,NA,NA,NA,NA,NA,NA,NA,NA,NA,NA,NA
"9499",2020-04-24,"Slate River Rd","w1920","Motorized",1,"Fri","weekday","sled","Slate River Rd",NA,NA,NA,NA,NA,NA,NA,NA,NA,NA,NA,NA,NA,NA,NA,NA,NA
"9500",2020-04-24,"Slate River Rd","w1920","Hybrid",2,"Fri","weekday","sled","Slate River Rd",NA,NA,NA,NA,NA,NA,NA,NA,NA,NA,NA,NA,NA,NA,NA,NA,NA
"9501",2020-04-25,"Slate River Rd","w1920","Non.motorized",9,"Sat","weekend","no_sled","Slate River Rd",NA,NA,NA,NA,NA,NA,NA,NA,NA,NA,NA,NA,NA,NA,NA,NA,NA
"9502",2020-04-25,"Slate River Rd","w1920","Mechanized",0,"Sat","weekend","no_sled","Slate River Rd",NA,NA,NA,NA,NA,NA,NA,NA,NA,NA,NA,NA,NA,NA,NA,NA,NA
"9503",2020-04-25,"Slate River Rd","w1920","Motorized",0,"Sat","weekend","sled","Slate River Rd",NA,NA,NA,NA,NA,NA,NA,NA,NA,NA,NA,NA,NA,NA,NA,NA,NA
"9504",2020-04-25,"Slate River Rd","w1920","Hybrid",5,"Sat","weekend","sled","Slate River Rd",NA,NA,NA,NA,NA,NA,NA,NA,NA,NA,NA,NA,NA,NA,NA,NA,NA
"9505",2020-04-26,"Slate River Rd","w1920","Non.motorized",10,"Sun","weekend","no_sled","Slate River Rd",NA,NA,NA,NA,NA,NA,NA,NA,NA,NA,NA,NA,NA,NA,NA,NA,NA
"9506",2020-04-26,"Slate River Rd","w1920","Mechanized",0,"Sun","weekend","no_sled","Slate River Rd",NA,NA,NA,NA,NA,NA,NA,NA,NA,NA,NA,NA,NA,NA,NA,NA,NA
"9507",2020-04-26,"Slate River Rd","w1920","Motorized",0,"Sun","weekend","sled","Slate River Rd",NA,NA,NA,NA,NA,NA,NA,NA,NA,NA,NA,NA,NA,NA,NA,NA,NA
"9508",2020-04-26,"Slate River Rd","w1920","Hybrid",4,"Sun","weekend","sled","Slate River Rd",NA,NA,NA,NA,NA,NA,NA,NA,NA,NA,NA,NA,NA,NA,NA,NA,NA
"9509",2020-04-27,"Slate River Rd","w1920","Non.motorized",6,"Mon","weekday","no_sled","Slate River Rd",NA,NA,NA,NA,NA,NA,NA,NA,NA,NA,NA,NA,NA,NA,NA,NA,NA
"9510",2020-04-27,"Slate River Rd","w1920","Mechanized",0,"Mon","weekday","no_sled","Slate River Rd",NA,NA,NA,NA,NA,NA,NA,NA,NA,NA,NA,NA,NA,NA,NA,NA,NA
"9511",2020-04-27,"Slate River Rd","w1920","Motorized",0,"Mon","weekday","sled","Slate River Rd",NA,NA,NA,NA,NA,NA,NA,NA,NA,NA,NA,NA,NA,NA,NA,NA,NA
"9512",2020-04-27,"Slate River Rd","w1920","Hybrid",3,"Mon","weekday","sled","Slate River Rd",NA,NA,NA,NA,NA,NA,NA,NA,NA,NA,NA,NA,NA,NA,NA,NA,NA
"9513",2020-04-28,"Slate River Rd","w1920","Non.motorized",9,"Tue","weekday","no_sled","Slate River Rd",NA,NA,NA,NA,NA,NA,NA,NA,NA,NA,NA,NA,NA,NA,NA,NA,NA
"9514",2020-04-28,"Slate River Rd","w1920","Mechanized",0,"Tue","weekday","no_sled","Slate River Rd",NA,NA,NA,NA,NA,NA,NA,NA,NA,NA,NA,NA,NA,NA,NA,NA,NA
"9515",2020-04-28,"Slate River Rd","w1920","Motorized",4,"Tue","weekday","sled","Slate River Rd",NA,NA,NA,NA,NA,NA,NA,NA,NA,NA,NA,NA,NA,NA,NA,NA,NA
"9516",2020-04-28,"Slate River Rd","w1920","Hybrid",3,"Tue","weekday","sled","Slate River Rd",NA,NA,NA,NA,NA,NA,NA,NA,NA,NA,NA,NA,NA,NA,NA,NA,NA
"9517",2020-04-29,"Slate River Rd","w1920","Non.motorized",12,"Wed","weekday","no_sled","Slate River Rd",NA,NA,NA,NA,NA,NA,NA,NA,NA,NA,NA,NA,NA,NA,NA,NA,NA
"9518",2020-04-29,"Slate River Rd","w1920","Mechanized",0,"Wed","weekday","no_sled","Slate River Rd",NA,NA,NA,NA,NA,NA,NA,NA,NA,NA,NA,NA,NA,NA,NA,NA,NA
"9519",2020-04-29,"Slate River Rd","w1920","Motorized",3,"Wed","weekday","sled","Slate River Rd",NA,NA,NA,NA,NA,NA,NA,NA,NA,NA,NA,NA,NA,NA,NA,NA,NA
"9520",2020-04-29,"Slate River Rd","w1920","Hybrid",5,"Wed","weekday","sled","Slate River Rd",NA,NA,NA,NA,NA,NA,NA,NA,NA,NA,NA,NA,NA,NA,NA,NA,NA
"9521",2020-04-30,"Slate River Rd","w1920","Non.motorized",5,"Thu","weekday","no_sled","Slate River Rd",NA,NA,NA,NA,NA,NA,NA,NA,NA,NA,NA,NA,NA,NA,NA,NA,NA
"9522",2020-04-30,"Slate River Rd","w1920","Mechanized",0,"Thu","weekday","no_sled","Slate River Rd",NA,NA,NA,NA,NA,NA,NA,NA,NA,NA,NA,NA,NA,NA,NA,NA,NA
"9523",2020-04-30,"Slate River Rd","w1920","Motorized",1,"Thu","weekday","sled","Slate River Rd",NA,NA,NA,NA,NA,NA,NA,NA,NA,NA,NA,NA,NA,NA,NA,NA,NA
"9524",2020-04-30,"Slate River Rd","w1920","Hybrid",0,"Thu","weekday","sled","Slate River Rd",NA,NA,NA,NA,NA,NA,NA,NA,NA,NA,NA,NA,NA,NA,NA,NA,NA
"9525",2019-12-06,"Snodgrass","w1920","Non.motorized",NA,"Fri","weekday","no_sled","East River","2","2","1",2.9,0.4,19,5,24,15.3,0,0,0,0,5,5,5,5
"9526",2019-12-06,"Snodgrass","w1920","Mechanized",NA,"Fri","weekday","no_sled","East River","2","2","1",2.9,0.4,19,5,24,15.3,0,0,0,0,5,5,5,5
"9527",2019-12-06,"Snodgrass","w1920","Motorized",NA,"Fri","weekday","sled","East River","2","2","1",2.9,0.4,19,5,24,15.3,0,0,0,0,5,5,5,5
"9528",2019-12-06,"Snodgrass","w1920","Hybrid",NA,"Fri","weekday","sled","East River","2","2","1",2.9,0.4,19,5,24,15.3,0,0,0,0,5,5,5,5
"9529",2019-12-07,"Snodgrass","w1920","Non.motorized",NA,"Sat","weekend","no_sled","East River","2","2","1",3,0.1,18,-1,29,16.7,5,0,0,0,4,4,4,4
"9530",2019-12-07,"Snodgrass","w1920","Mechanized",NA,"Sat","weekend","no_sled","East River","2","2","1",3,0.1,18,-1,29,16.7,5,0,0,0,4,4,4,4
"9531",2019-12-07,"Snodgrass","w1920","Motorized",NA,"Sat","weekend","sled","East River","2","2","1",3,0.1,18,-1,29,16.7,5,0,0,0,4,4,4,4
"9532",2019-12-07,"Snodgrass","w1920","Hybrid",NA,"Sat","weekend","sled","East River","2","2","1",3,0.1,18,-1,29,16.7,5,0,0,0,4,4,4,4
"9533",2019-12-08,"Snodgrass","w1920","Non.motorized",NA,"Sun","weekend","no_sled","East River","2","2","1",3,0,17,-1,28,17.6,-1,5,0,0,-2,3,3,3
"9534",2019-12-08,"Snodgrass","w1920","Mechanized",NA,"Sun","weekend","no_sled","East River","2","2","1",3,0,17,-1,28,17.6,-1,5,0,0,-2,3,3,3
"9535",2019-12-08,"Snodgrass","w1920","Motorized",NA,"Sun","weekend","sled","East River","2","2","1",3,0,17,-1,28,17.6,-1,5,0,0,-2,3,3,3
"9536",2019-12-08,"Snodgrass","w1920","Hybrid",NA,"Sun","weekend","sled","East River","2","2","1",3,0,17,-1,28,17.6,-1,5,0,0,-2,3,3,3
"9537",2019-12-09,"Snodgrass","w1920","Non.motorized",NA,"Mon","weekday","no_sled","East River","3","3","2",3.4,0.4,22,5,21,15.5,-1,-1,5,0,4,3,8,8
"9538",2019-12-09,"Snodgrass","w1920","Mechanized",NA,"Mon","weekday","no_sled","East River","3","3","2",3.4,0.4,22,5,21,15.5,-1,-1,5,0,4,3,8,8
"9539",2019-12-09,"Snodgrass","w1920","Motorized",NA,"Mon","weekday","sled","East River","3","3","2",3.4,0.4,22,5,21,15.5,-1,-1,5,0,4,3,8,8
"9540",2019-12-09,"Snodgrass","w1920","Hybrid",NA,"Mon","weekday","sled","East River","3","3","2",3.4,0.4,22,5,21,15.5,-1,-1,5,0,4,3,8,8
"9541",2020-12-10,"Snodgrass","w1920","Non.motorized",NA,"Thu","weekday","no_sled","East River",NA,NA,NA,2.5,NA,11,0,28,22.7,0,0,0,0,0,0,0,0
"9542",2020-12-10,"Snodgrass","w1920","Mechanized",NA,"Thu","weekday","no_sled","East River",NA,NA,NA,2.5,NA,11,0,28,22.7,0,0,0,0,0,0,0,0
"9543",2020-12-10,"Snodgrass","w1920","Motorized",NA,"Thu","weekday","sled","East River",NA,NA,NA,2.5,NA,11,0,28,22.7,0,0,0,0,0,0,0,0
"9544",2020-12-10,"Snodgrass","w1920","Hybrid",NA,"Thu","weekday","sled","East River",NA,NA,NA,2.5,NA,11,0,28,22.7,0,0,0,0,0,0,0,0
"9545",2019-12-11,"Snodgrass","w1920","Non.motorized",NA,"Wed","weekday","no_sled","East River","2","2","2",3.4,0,20,-1,22,17,-1,5,-1,-1,-2,3,2,1
"9546",2019-12-11,"Snodgrass","w1920","Mechanized",NA,"Wed","weekday","no_sled","East River","2","2","2",3.4,0,20,-1,22,17,-1,5,-1,-1,-2,3,2,1
"9547",2019-12-11,"Snodgrass","w1920","Motorized",NA,"Wed","weekday","sled","East River","2","2","2",3.4,0,20,-1,22,17,-1,5,-1,-1,-2,3,2,1
"9548",2019-12-11,"Snodgrass","w1920","Hybrid",NA,"Wed","weekday","sled","East River","2","2","2",3.4,0,20,-1,22,17,-1,5,-1,-1,-2,3,2,1
"9549",2019-12-12,"Snodgrass","w1920","Non.motorized",NA,"Thu","weekday","no_sled","East River","2","2","2",3.4,0,19,-1,25,17.9,-1,-1,5,-1,-2,-3,2,1
"9550",2019-12-12,"Snodgrass","w1920","Mechanized",NA,"Thu","weekday","no_sled","East River","2","2","2",3.4,0,19,-1,25,17.9,-1,-1,5,-1,-2,-3,2,1
"9551",2019-12-12,"Snodgrass","w1920","Motorized",NA,"Thu","weekday","sled","East River","2","2","2",3.4,0,19,-1,25,17.9,-1,-1,5,-1,-2,-3,2,1
"9552",2019-12-12,"Snodgrass","w1920","Hybrid",NA,"Thu","weekday","sled","East River","2","2","2",3.4,0,19,-1,25,17.9,-1,-1,5,-1,-2,-3,2,1
"9553",2019-12-13,"Snodgrass","w1920","Non.motorized",NA,"Fri","weekday","no_sled","East River","2","2","2",3.8,0.4,21,2,24,18.1,-1,-1,-1,5,1,0,-1,4
"9554",2019-12-13,"Snodgrass","w1920","Mechanized",NA,"Fri","weekday","no_sled","East River","2","2","2",3.8,0.4,21,2,24,18.1,-1,-1,-1,5,1,0,-1,4
"9555",2019-12-13,"Snodgrass","w1920","Motorized",NA,"Fri","weekday","sled","East River","2","2","2",3.8,0.4,21,2,24,18.1,-1,-1,-1,5,1,0,-1,4
"9556",2019-12-13,"Snodgrass","w1920","Hybrid",NA,"Fri","weekday","sled","East River","2","2","2",3.8,0.4,21,2,24,18.1,-1,-1,-1,5,1,0,-1,4
"9557",2019-12-14,"Snodgrass","w1920","Non.motorized",NA,"Sat","weekend","no_sled","East River","3","3","3",4.2,0.4,27,6,25,15.6,2,-1,-1,-1,8,7,6,5
"9558",2019-12-14,"Snodgrass","w1920","Mechanized",NA,"Sat","weekend","no_sled","East River","3","3","3",4.2,0.4,27,6,25,15.6,2,-1,-1,-1,8,7,6,5
"9559",2019-12-14,"Snodgrass","w1920","Motorized",NA,"Sat","weekend","sled","East River","3","3","3",4.2,0.4,27,6,25,15.6,2,-1,-1,-1,8,7,6,5
"9560",2019-12-14,"Snodgrass","w1920","Hybrid",NA,"Sat","weekend","sled","East River","3","3","3",4.2,0.4,27,6,25,15.6,2,-1,-1,-1,8,7,6,5
"9561",2019-12-15,"Snodgrass","w1920","Non.motorized",NA,"Sun","weekend","no_sled","East River","3","3","2",4.8,0.6,31,4,17,15.5,6,2,-1,-1,10,12,11,10
"9562",2019-12-15,"Snodgrass","w1920","Mechanized",NA,"Sun","weekend","no_sled","East River","3","3","2",4.8,0.6,31,4,17,15.5,6,2,-1,-1,10,12,11,10
"9563",2019-12-15,"Snodgrass","w1920","Motorized",NA,"Sun","weekend","sled","East River","3","3","2",4.8,0.6,31,4,17,15.5,6,2,-1,-1,10,12,11,10
"9564",2019-12-15,"Snodgrass","w1920","Hybrid",NA,"Sun","weekend","sled","East River","3","3","2",4.8,0.6,31,4,17,15.5,6,2,-1,-1,10,12,11,10
"9565",2019-12-16,"Snodgrass","w1920","Non.motorized",NA,"Mon","weekday","no_sled","East River","3","3","2",4.8,0,29,-2,6,16.6,4,6,2,-1,2,8,10,9
"9566",2019-12-16,"Snodgrass","w1920","Mechanized",NA,"Mon","weekday","no_sled","East River","3","3","2",4.8,0,29,-2,6,16.6,4,6,2,-1,2,8,10,9
"9567",2019-12-16,"Snodgrass","w1920","Motorized",NA,"Mon","weekday","sled","East River","3","3","2",4.8,0,29,-2,6,16.6,4,6,2,-1,2,8,10,9
"9568",2019-12-16,"Snodgrass","w1920","Hybrid",NA,"Mon","weekday","sled","East River","3","3","2",4.8,0,29,-2,6,16.6,4,6,2,-1,2,8,10,9
"9569",2019-12-17,"Snodgrass","w1920","Non.motorized",NA,"Tue","weekday","no_sled","East River","2","2","1",4.8,0,27,-2,8,17.8,-2,4,6,2,-4,0,6,8
"9570",2019-12-17,"Snodgrass","w1920","Mechanized",NA,"Tue","weekday","no_sled","East River","2","2","1",4.8,0,27,-2,8,17.8,-2,4,6,2,-4,0,6,8
"9571",2019-12-17,"Snodgrass","w1920","Motorized",NA,"Tue","weekday","sled","East River","2","2","1",4.8,0,27,-2,8,17.8,-2,4,6,2,-4,0,6,8
"9572",2019-12-17,"Snodgrass","w1920","Hybrid",NA,"Tue","weekday","sled","East River","2","2","1",4.8,0,27,-2,8,17.8,-2,4,6,2,-4,0,6,8
"9573",2019-12-18,"Snodgrass","w1920","Non.motorized",NA,"Wed","weekday","no_sled","East River","2","2","1",4.8,0,26,-1,20,18.5,-2,-2,4,6,-3,-5,-1,5
"9574",2019-12-18,"Snodgrass","w1920","Mechanized",NA,"Wed","weekday","no_sled","East River","2","2","1",4.8,0,26,-1,20,18.5,-2,-2,4,6,-3,-5,-1,5
"9575",2019-12-18,"Snodgrass","w1920","Motorized",NA,"Wed","weekday","sled","East River","2","2","1",4.8,0,26,-1,20,18.5,-2,-2,4,6,-3,-5,-1,5
"9576",2019-12-18,"Snodgrass","w1920","Hybrid",NA,"Wed","weekday","sled","East River","2","2","1",4.8,0,26,-1,20,18.5,-2,-2,4,6,-3,-5,-1,5
"9577",2019-12-19,"Snodgrass","w1920","Non.motorized",NA,"Thu","weekday","no_sled","East River","2","2","1",4.9,0.1,25,-1,21,19.6,-1,-2,-2,4,-2,-4,-6,-2
"9578",2019-12-19,"Snodgrass","w1920","Mechanized",NA,"Thu","weekday","no_sled","East River","2","2","1",4.9,0.1,25,-1,21,19.6,-1,-2,-2,4,-2,-4,-6,-2
"9579",2019-12-19,"Snodgrass","w1920","Motorized",NA,"Thu","weekday","sled","East River","2","2","1",4.9,0.1,25,-1,21,19.6,-1,-2,-2,4,-2,-4,-6,-2
"9580",2019-12-19,"Snodgrass","w1920","Hybrid",NA,"Thu","weekday","sled","East River","2","2","1",4.9,0.1,25,-1,21,19.6,-1,-2,-2,4,-2,-4,-6,-2
"9581",2019-12-20,"Snodgrass","w1920","Non.motorized",NA,"Fri","weekday","no_sled","East River","2","2","1",4.9,0,24,-1,21,20.4,-1,-1,-2,-2,-2,-3,-5,-7
"9582",2019-12-20,"Snodgrass","w1920","Mechanized",NA,"Fri","weekday","no_sled","East River","2","2","1",4.9,0,24,-1,21,20.4,-1,-1,-2,-2,-2,-3,-5,-7
"9583",2019-12-20,"Snodgrass","w1920","Motorized",NA,"Fri","weekday","sled","East River","2","2","1",4.9,0,24,-1,21,20.4,-1,-1,-2,-2,-2,-3,-5,-7
"9584",2019-12-20,"Snodgrass","w1920","Hybrid",NA,"Fri","weekday","sled","East River","2","2","1",4.9,0,24,-1,21,20.4,-1,-1,-2,-2,-2,-3,-5,-7
"9585",2019-12-21,"Snodgrass","w1920","Non.motorized",NA,"Sat","weekend","no_sled","East River","2","2","1",4.9,0,24,0,27,20.4,-1,-1,-1,-2,-1,-2,-3,-5
"9586",2019-12-21,"Snodgrass","w1920","Mechanized",NA,"Sat","weekend","no_sled","East River","2","2","1",4.9,0,24,0,27,20.4,-1,-1,-1,-2,-1,-2,-3,-5
"9587",2019-12-21,"Snodgrass","w1920","Motorized",NA,"Sat","weekend","sled","East River","2","2","1",4.9,0,24,0,27,20.4,-1,-1,-1,-2,-1,-2,-3,-5
"9588",2019-12-21,"Snodgrass","w1920","Hybrid",NA,"Sat","weekend","sled","East River","2","2","1",4.9,0,24,0,27,20.4,-1,-1,-1,-2,-1,-2,-3,-5
"9589",2019-12-22,"Snodgrass","w1920","Non.motorized",NA,"Sun","weekend","no_sled","East River","2","2","1",5,0.1,23,-1,31,21.7,0,-1,-1,-1,-1,-2,-3,-4
"9590",2019-12-22,"Snodgrass","w1920","Mechanized",NA,"Sun","weekend","no_sled","East River","2","2","1",5,0.1,23,-1,31,21.7,0,-1,-1,-1,-1,-2,-3,-4
"9591",2019-12-22,"Snodgrass","w1920","Motorized",NA,"Sun","weekend","sled","East River","2","2","1",5,0.1,23,-1,31,21.7,0,-1,-1,-1,-1,-2,-3,-4
"9592",2019-12-22,"Snodgrass","w1920","Hybrid",NA,"Sun","weekend","sled","East River","2","2","1",5,0.1,23,-1,31,21.7,0,-1,-1,-1,-1,-2,-3,-4
"9593",2019-12-23,"Snodgrass","w1920","Non.motorized",NA,"Mon","weekday","no_sled","East River","2","1","1",5,0,23,0,34,21.7,-1,0,-1,-1,-1,-1,-2,-3
"9594",2019-12-23,"Snodgrass","w1920","Mechanized",NA,"Mon","weekday","no_sled","East River","2","1","1",5,0,23,0,34,21.7,-1,0,-1,-1,-1,-1,-2,-3
"9595",2019-12-23,"Snodgrass","w1920","Motorized",NA,"Mon","weekday","sled","East River","2","1","1",5,0,23,0,34,21.7,-1,0,-1,-1,-1,-1,-2,-3
"9596",2019-12-23,"Snodgrass","w1920","Hybrid",NA,"Mon","weekday","sled","East River","2","1","1",5,0,23,0,34,21.7,-1,0,-1,-1,-1,-1,-2,-3
"9597",2019-12-24,"Snodgrass","w1920","Non.motorized",NA,"Tue","weekday","no_sled","East River","2","1","1",5,0,22,-1,30,22.7,0,-1,0,-1,-1,-2,-2,-3
"9598",2019-12-24,"Snodgrass","w1920","Mechanized",NA,"Tue","weekday","no_sled","East River","2","1","1",5,0,22,-1,30,22.7,0,-1,0,-1,-1,-2,-2,-3
"9599",2019-12-24,"Snodgrass","w1920","Motorized",NA,"Tue","weekday","sled","East River","2","1","1",5,0,22,-1,30,22.7,0,-1,0,-1,-1,-2,-2,-3
"9600",2019-12-24,"Snodgrass","w1920","Hybrid",NA,"Tue","weekday","sled","East River","2","1","1",5,0,22,-1,30,22.7,0,-1,0,-1,-1,-2,-2,-3
"9601",2019-12-25,"Snodgrass","w1920","Non.motorized",NA,"Wed","weekday","no_sled","East River","2","2","2",5,0,23,1,22,21.7,-1,0,-1,0,0,0,-1,-1
"9602",2019-12-25,"Snodgrass","w1920","Mechanized",NA,"Wed","weekday","no_sled","East River","2","2","2",5,0,23,1,22,21.7,-1,0,-1,0,0,0,-1,-1
"9603",2019-12-25,"Snodgrass","w1920","Motorized",NA,"Wed","weekday","sled","East River","2","2","2",5,0,23,1,22,21.7,-1,0,-1,0,0,0,-1,-1
"9604",2019-12-25,"Snodgrass","w1920","Hybrid",NA,"Wed","weekday","sled","East River","2","2","2",5,0,23,1,22,21.7,-1,0,-1,0,0,0,-1,-1
"9605",2019-12-26,"Snodgrass","w1920","Non.motorized",NA,"Thu","weekday","no_sled","East River","2","2","1",5,0,23,0,17,21.7,1,-1,0,-1,1,0,0,-1
"9606",2019-12-26,"Snodgrass","w1920","Mechanized",NA,"Thu","weekday","no_sled","East River","2","2","1",5,0,23,0,17,21.7,1,-1,0,-1,1,0,0,-1
"9607",2019-12-26,"Snodgrass","w1920","Motorized",NA,"Thu","weekday","sled","East River","2","2","1",5,0,23,0,17,21.7,1,-1,0,-1,1,0,0,-1
"9608",2019-12-26,"Snodgrass","w1920","Hybrid",NA,"Thu","weekday","sled","East River","2","2","1",5,0,23,0,17,21.7,1,-1,0,-1,1,0,0,-1
"9609",2019-12-27,"Snodgrass","w1920","Non.motorized",NA,"Fri","weekday","no_sled","East River","3","3","2",5.1,0.1,24,1,22,21.2,0,1,-1,0,1,2,1,1
"9610",2019-12-27,"Snodgrass","w1920","Mechanized",NA,"Fri","weekday","no_sled","East River","3","3","2",5.1,0.1,24,1,22,21.2,0,1,-1,0,1,2,1,1
"9611",2019-12-27,"Snodgrass","w1920","Motorized",NA,"Fri","weekday","sled","East River","3","3","2",5.1,0.1,24,1,22,21.2,0,1,-1,0,1,2,1,1
"9612",2019-12-27,"Snodgrass","w1920","Hybrid",NA,"Fri","weekday","sled","East River","3","3","2",5.1,0.1,24,1,22,21.2,0,1,-1,0,1,2,1,1
"9613",2019-12-28,"Snodgrass","w1920","Non.motorized",NA,"Sat","weekend","no_sled","East River","3","3","2",5.6,0.5,30,6,16,18.7,1,0,1,-1,7,7,8,7
"9614",2019-12-28,"Snodgrass","w1920","Mechanized",NA,"Sat","weekend","no_sled","East River","3","3","2",5.6,0.5,30,6,16,18.7,1,0,1,-1,7,7,8,7
"9615",2019-12-28,"Snodgrass","w1920","Motorized",NA,"Sat","weekend","sled","East River","3","3","2",5.6,0.5,30,6,16,18.7,1,0,1,-1,7,7,8,7
"9616",2019-12-28,"Snodgrass","w1920","Hybrid",NA,"Sat","weekend","sled","East River","3","3","2",5.6,0.5,30,6,16,18.7,1,0,1,-1,7,7,8,7
"9617",2019-12-29,"Snodgrass","w1920","Non.motorized",NA,"Sun","weekend","no_sled","East River","3","3","2",5.6,0,29,-1,3,19.3,6,1,0,1,5,6,6,7
"9618",2019-12-29,"Snodgrass","w1920","Mechanized",NA,"Sun","weekend","no_sled","East River","3","3","2",5.6,0,29,-1,3,19.3,6,1,0,1,5,6,6,7
"9619",2019-12-29,"Snodgrass","w1920","Motorized",NA,"Sun","weekend","sled","East River","3","3","2",5.6,0,29,-1,3,19.3,6,1,0,1,5,6,6,7
"9620",2019-12-29,"Snodgrass","w1920","Hybrid",NA,"Sun","weekend","sled","East River","3","3","2",5.6,0,29,-1,3,19.3,6,1,0,1,5,6,6,7
"9621",2019-12-30,"Snodgrass","w1920","Non.motorized",NA,"Mon","weekday","no_sled","East River","3","3","2",5.6,0,28,-1,3,20,-1,6,1,0,-2,4,5,5
"9622",2019-12-30,"Snodgrass","w1920","Mechanized",NA,"Mon","weekday","no_sled","East River","3","3","2",5.6,0,28,-1,3,20,-1,6,1,0,-2,4,5,5
"9623",2019-12-30,"Snodgrass","w1920","Motorized",NA,"Mon","weekday","sled","East River","3","3","2",5.6,0,28,-1,3,20,-1,6,1,0,-2,4,5,5
"9624",2019-12-30,"Snodgrass","w1920","Hybrid",NA,"Mon","weekday","sled","East River","3","3","2",5.6,0,28,-1,3,20,-1,6,1,0,-2,4,5,5
"9625",2019-12-31,"Snodgrass","w1920","Non.motorized",NA,"Tue","weekday","no_sled","East River","2","2","1",5.6,0,28,0,13,20,-1,-1,6,1,-1,-2,4,5
"9626",2019-12-31,"Snodgrass","w1920","Mechanized",NA,"Tue","weekday","no_sled","East River","2","2","1",5.6,0,28,0,13,20,-1,-1,6,1,-1,-2,4,5
"9627",2019-12-31,"Snodgrass","w1920","Motorized",NA,"Tue","weekday","sled","East River","2","2","1",5.6,0,28,0,13,20,-1,-1,6,1,-1,-2,4,5
"9628",2019-12-31,"Snodgrass","w1920","Hybrid",NA,"Tue","weekday","sled","East River","2","2","1",5.6,0,28,0,13,20,-1,-1,6,1,-1,-2,4,5
"9629",2020-01-01,"Snodgrass","w1920","Non.motorized",NA,"Wed","weekday","no_sled","East River","2","1","1",5.6,0,27,-1,21,20.7,0,-1,-1,6,-1,-2,-3,3
"9630",2020-01-01,"Snodgrass","w1920","Mechanized",NA,"Wed","weekday","no_sled","East River","2","1","1",5.6,0,27,-1,21,20.7,0,-1,-1,6,-1,-2,-3,3
"9631",2020-01-01,"Snodgrass","w1920","Motorized",NA,"Wed","weekday","sled","East River","2","1","1",5.6,0,27,-1,21,20.7,0,-1,-1,6,-1,-2,-3,3
"9632",2020-01-01,"Snodgrass","w1920","Hybrid",NA,"Wed","weekday","sled","East River","2","1","1",5.6,0,27,-1,21,20.7,0,-1,-1,6,-1,-2,-3,3
"9633",2020-01-02,"Snodgrass","w1920","Non.motorized",NA,"Thu","weekday","no_sled","East River","3","3","2",5.9,0.3,29,2,16,20.3,-1,0,-1,-1,1,1,0,-1
"9634",2020-01-02,"Snodgrass","w1920","Mechanized",NA,"Thu","weekday","no_sled","East River","3","3","2",5.9,0.3,29,2,16,20.3,-1,0,-1,-1,1,1,0,-1
"9635",2020-01-02,"Snodgrass","w1920","Motorized",NA,"Thu","weekday","sled","East River","3","3","2",5.9,0.3,29,2,16,20.3,-1,0,-1,-1,1,1,0,-1
"9636",2020-01-02,"Snodgrass","w1920","Hybrid",NA,"Thu","weekday","sled","East River","3","3","2",5.9,0.3,29,2,16,20.3,-1,0,-1,-1,1,1,0,-1
"9637",2020-01-03,"Snodgrass","w1920","Non.motorized",NA,"Fri","weekday","no_sled","East River","3","2","1",5.9,0,31,2,19,19,2,-1,0,-1,4,3,3,2
"9638",2020-01-03,"Snodgrass","w1920","Mechanized",NA,"Fri","weekday","no_sled","East River","3","2","1",5.9,0,31,2,19,19,2,-1,0,-1,4,3,3,2
"9639",2020-01-03,"Snodgrass","w1920","Motorized",NA,"Fri","weekday","sled","East River","3","2","1",5.9,0,31,2,19,19,2,-1,0,-1,4,3,3,2
"9640",2020-01-03,"Snodgrass","w1920","Hybrid",NA,"Fri","weekday","sled","East River","3","2","1",5.9,0,31,2,19,19,2,-1,0,-1,4,3,3,2
"9641",2020-01-04,"Snodgrass","w1920","Non.motorized",NA,"Sat","weekend","no_sled","East River","2","2","1",5.9,0,30,-1,26,19.7,2,2,-1,0,1,3,2,2
"9642",2020-01-04,"Snodgrass","w1920","Mechanized",NA,"Sat","weekend","no_sled","East River","2","2","1",5.9,0,30,-1,26,19.7,2,2,-1,0,1,3,2,2
"9643",2020-01-04,"Snodgrass","w1920","Motorized",NA,"Sat","weekend","sled","East River","2","2","1",5.9,0,30,-1,26,19.7,2,2,-1,0,1,3,2,2
"9644",2020-01-04,"Snodgrass","w1920","Hybrid",NA,"Sat","weekend","sled","East River","2","2","1",5.9,0,30,-1,26,19.7,2,2,-1,0,1,3,2,2
"9645",2020-01-05,"Snodgrass","w1920","Non.motorized",NA,"Sun","weekend","no_sled","East River","2","2","1",5.9,0,28,-2,23,21.1,-1,2,2,-1,-3,-1,1,0
"9646",2020-01-05,"Snodgrass","w1920","Mechanized",NA,"Sun","weekend","no_sled","East River","2","2","1",5.9,0,28,-2,23,21.1,-1,2,2,-1,-3,-1,1,0
"9647",2020-01-05,"Snodgrass","w1920","Motorized",NA,"Sun","weekend","sled","East River","2","2","1",5.9,0,28,-2,23,21.1,-1,2,2,-1,-3,-1,1,0
"9648",2020-01-05,"Snodgrass","w1920","Hybrid",NA,"Sun","weekend","sled","East River","2","2","1",5.9,0,28,-2,23,21.1,-1,2,2,-1,-3,-1,1,0
"9649",2020-01-06,"Snodgrass","w1920","Non.motorized",NA,"Mon","weekday","no_sled","East River","2","2","1",5.9,0,28,0,15,21.1,-2,-1,2,2,-2,-3,-1,1
"9650",2020-01-06,"Snodgrass","w1920","Mechanized",NA,"Mon","weekday","no_sled","East River","2","2","1",5.9,0,28,0,15,21.1,-2,-1,2,2,-2,-3,-1,1
"9651",2020-01-06,"Snodgrass","w1920","Motorized",NA,"Mon","weekday","sled","East River","2","2","1",5.9,0,28,0,15,21.1,-2,-1,2,2,-2,-3,-1,1
"9652",2020-01-06,"Snodgrass","w1920","Hybrid",NA,"Mon","weekday","sled","East River","2","2","1",5.9,0,28,0,15,21.1,-2,-1,2,2,-2,-3,-1,1
"9653",2020-01-07,"Snodgrass","w1920","Non.motorized",NA,"Tue","weekday","no_sled","East River","2","1","1",5.9,0,28,0,22,21.1,0,-2,-1,2,0,-2,-3,-1
"9654",2020-01-07,"Snodgrass","w1920","Mechanized",NA,"Tue","weekday","no_sled","East River","2","1","1",5.9,0,28,0,22,21.1,0,-2,-1,2,0,-2,-3,-1
"9655",2020-01-07,"Snodgrass","w1920","Motorized",NA,"Tue","weekday","sled","East River","2","1","1",5.9,0,28,0,22,21.1,0,-2,-1,2,0,-2,-3,-1
"9656",2020-01-07,"Snodgrass","w1920","Hybrid",NA,"Tue","weekday","sled","East River","2","1","1",5.9,0,28,0,22,21.1,0,-2,-1,2,0,-2,-3,-1
"9657",2020-01-08,"Snodgrass","w1920","Non.motorized",NA,"Wed","weekday","no_sled","East River","2","1","1",6,0.1,28,0,23,21.4,0,0,-2,-1,0,0,-2,-3
"9658",2020-01-08,"Snodgrass","w1920","Mechanized",NA,"Wed","weekday","no_sled","East River","2","1","1",6,0.1,28,0,23,21.4,0,0,-2,-1,0,0,-2,-3
"9659",2020-01-08,"Snodgrass","w1920","Motorized",NA,"Wed","weekday","sled","East River","2","1","1",6,0.1,28,0,23,21.4,0,0,-2,-1,0,0,-2,-3
"9660",2020-01-08,"Snodgrass","w1920","Hybrid",NA,"Wed","weekday","sled","East River","2","1","1",6,0.1,28,0,23,21.4,0,0,-2,-1,0,0,-2,-3
"9661",2020-01-09,"Snodgrass","w1920","Non.motorized",NA,"Thu","weekday","no_sled","East River","2","1","1",6,0,27,-1,17,22.2,0,0,0,-2,-1,-1,-1,-3
"9662",2020-01-09,"Snodgrass","w1920","Mechanized",NA,"Thu","weekday","no_sled","East River","2","1","1",6,0,27,-1,17,22.2,0,0,0,-2,-1,-1,-1,-3
"9663",2020-01-09,"Snodgrass","w1920","Motorized",NA,"Thu","weekday","sled","East River","2","1","1",6,0,27,-1,17,22.2,0,0,0,-2,-1,-1,-1,-3
"9664",2020-01-09,"Snodgrass","w1920","Hybrid",NA,"Thu","weekday","sled","East River","2","1","1",6,0,27,-1,17,22.2,0,0,0,-2,-1,-1,-1,-3
"9665",2020-01-10,"Snodgrass","w1920","Non.motorized",NA,"Fri","weekday","no_sled","East River","2","1","1",6,0,29,2,11,20.7,-1,0,0,0,1,1,1,1
"9666",2020-01-10,"Snodgrass","w1920","Mechanized",NA,"Fri","weekday","no_sled","East River","2","1","1",6,0,29,2,11,20.7,-1,0,0,0,1,1,1,1
"9667",2020-01-10,"Snodgrass","w1920","Motorized",NA,"Fri","weekday","sled","East River","2","1","1",6,0,29,2,11,20.7,-1,0,0,0,1,1,1,1
"9668",2020-01-10,"Snodgrass","w1920","Hybrid",NA,"Fri","weekday","sled","East River","2","1","1",6,0,29,2,11,20.7,-1,0,0,0,1,1,1,1
"9669",2020-01-11,"Snodgrass","w1920","Non.motorized",10,"Sat","weekend","no_sled","East River","2","1","1",6,0,29,0,12,20.7,2,-1,0,0,2,1,1,1
"9670",2020-01-11,"Snodgrass","w1920","Mechanized",0,"Sat","weekend","no_sled","East River","2","1","1",6,0,29,0,12,20.7,2,-1,0,0,2,1,1,1
"9671",2020-01-11,"Snodgrass","w1920","Motorized",0,"Sat","weekend","sled","East River","2","1","1",6,0,29,0,12,20.7,2,-1,0,0,2,1,1,1
"9672",2020-01-11,"Snodgrass","w1920","Hybrid",0,"Sat","weekend","sled","East River","2","1","1",6,0,29,0,12,20.7,2,-1,0,0,2,1,1,1
"9673",2020-01-12,"Snodgrass","w1920","Non.motorized",96,"Sun","weekend","no_sled","East River","2","1","1",6.1,0.1,29,0,13,21,0,2,-1,0,0,2,1,1
"9674",2020-01-12,"Snodgrass","w1920","Mechanized",2,"Sun","weekend","no_sled","East River","2","1","1",6.1,0.1,29,0,13,21,0,2,-1,0,0,2,1,1
"9675",2020-01-12,"Snodgrass","w1920","Motorized",0,"Sun","weekend","sled","East River","2","1","1",6.1,0.1,29,0,13,21,0,2,-1,0,0,2,1,1
"9676",2020-01-12,"Snodgrass","w1920","Hybrid",0,"Sun","weekend","sled","East River","2","1","1",6.1,0.1,29,0,13,21,0,2,-1,0,0,2,1,1
"9677",2020-01-13,"Snodgrass","w1920","Non.motorized",2,"Mon","weekday","no_sled","East River","2","2","1",6.2,0.1,29,0,16,21.4,0,0,2,-1,0,0,2,1
"9678",2020-01-13,"Snodgrass","w1920","Mechanized",0,"Mon","weekday","no_sled","East River","2","2","1",6.2,0.1,29,0,16,21.4,0,0,2,-1,0,0,2,1
"9679",2020-01-13,"Snodgrass","w1920","Motorized",0,"Mon","weekday","sled","East River","2","2","1",6.2,0.1,29,0,16,21.4,0,0,2,-1,0,0,2,1
"9680",2020-01-13,"Snodgrass","w1920","Hybrid",0,"Mon","weekday","sled","East River","2","2","1",6.2,0.1,29,0,16,21.4,0,0,2,-1,0,0,2,1
"9681",2020-01-14,"Snodgrass","w1920","Non.motorized",69,"Tue","weekday","no_sled","East River","3","2","1",6.6,0.4,34,5,23,19.4,0,0,0,2,5,5,5,7
"9682",2020-01-14,"Snodgrass","w1920","Mechanized",0,"Tue","weekday","no_sled","East River","3","2","1",6.6,0.4,34,5,23,19.4,0,0,0,2,5,5,5,7
"9683",2020-01-14,"Snodgrass","w1920","Motorized",0,"Tue","weekday","sled","East River","3","2","1",6.6,0.4,34,5,23,19.4,0,0,0,2,5,5,5,7
"9684",2020-01-14,"Snodgrass","w1920","Hybrid",0,"Tue","weekday","sled","East River","3","2","1",6.6,0.4,34,5,23,19.4,0,0,0,2,5,5,5,7
"9685",2020-01-15,"Snodgrass","w1920","Non.motorized",46,"Wed","weekday","no_sled","East River","3","2","1",6.7,0.1,32,-2,23,20.9,5,0,0,0,3,3,3,3
"9686",2020-01-15,"Snodgrass","w1920","Mechanized",0,"Wed","weekday","no_sled","East River","3","2","1",6.7,0.1,32,-2,23,20.9,5,0,0,0,3,3,3,3
"9687",2020-01-15,"Snodgrass","w1920","Motorized",0,"Wed","weekday","sled","East River","3","2","1",6.7,0.1,32,-2,23,20.9,5,0,0,0,3,3,3,3
"9688",2020-01-15,"Snodgrass","w1920","Hybrid",0,"Wed","weekday","sled","East River","3","2","1",6.7,0.1,32,-2,23,20.9,5,0,0,0,3,3,3,3
"9689",2020-01-16,"Snodgrass","w1920","Non.motorized",39,"Thu","weekday","no_sled","East River","2","2","1",6.7,0,31,-1,28,21.6,-2,5,0,0,-3,2,2,2
"9690",2020-01-16,"Snodgrass","w1920","Mechanized",3,"Thu","weekday","no_sled","East River","2","2","1",6.7,0,31,-1,28,21.6,-2,5,0,0,-3,2,2,2
"9691",2020-01-16,"Snodgrass","w1920","Motorized",0,"Thu","weekday","sled","East River","2","2","1",6.7,0,31,-1,28,21.6,-2,5,0,0,-3,2,2,2
"9692",2020-01-16,"Snodgrass","w1920","Hybrid",0,"Thu","weekday","sled","East River","2","2","1",6.7,0,31,-1,28,21.6,-2,5,0,0,-3,2,2,2
"9693",2020-01-17,"Snodgrass","w1920","Non.motorized",25,"Fri","weekday","no_sled","East River","2","2","1",6.8,0.1,29,-2,19,23.4,-1,-2,5,0,-3,-5,0,0
"9694",2020-01-17,"Snodgrass","w1920","Mechanized",0,"Fri","weekday","no_sled","East River","2","2","1",6.8,0.1,29,-2,19,23.4,-1,-2,5,0,-3,-5,0,0
"9695",2020-01-17,"Snodgrass","w1920","Motorized",0,"Fri","weekday","sled","East River","2","2","1",6.8,0.1,29,-2,19,23.4,-1,-2,5,0,-3,-5,0,0
"9696",2020-01-17,"Snodgrass","w1920","Hybrid",0,"Fri","weekday","sled","East River","2","2","1",6.8,0.1,29,-2,19,23.4,-1,-2,5,0,-3,-5,0,0
"9697",2020-01-18,"Snodgrass","w1920","Non.motorized",88,"Sat","weekend","no_sled","East River","2","2","2",7,0.2,34,5,16,20.6,-2,-1,-2,5,3,2,0,5
"9698",2020-01-18,"Snodgrass","w1920","Mechanized",1,"Sat","weekend","no_sled","East River","2","2","2",7,0.2,34,5,16,20.6,-2,-1,-2,5,3,2,0,5
"9699",2020-01-18,"Snodgrass","w1920","Motorized",0,"Sat","weekend","sled","East River","2","2","2",7,0.2,34,5,16,20.6,-2,-1,-2,5,3,2,0,5
"9700",2020-01-18,"Snodgrass","w1920","Hybrid",0,"Sat","weekend","sled","East River","2","2","2",7,0.2,34,5,16,20.6,-2,-1,-2,5,3,2,0,5
"9701",2020-01-19,"Snodgrass","w1920","Non.motorized",50,"Sun","weekend","no_sled","East River","2","2","1",7,0,33,-1,21,21.2,5,-2,-1,-2,4,2,1,-1
"9702",2020-01-19,"Snodgrass","w1920","Mechanized",3,"Sun","weekend","no_sled","East River","2","2","1",7,0,33,-1,21,21.2,5,-2,-1,-2,4,2,1,-1
"9703",2020-01-19,"Snodgrass","w1920","Motorized",0,"Sun","weekend","sled","East River","2","2","1",7,0,33,-1,21,21.2,5,-2,-1,-2,4,2,1,-1
"9704",2020-01-19,"Snodgrass","w1920","Hybrid",0,"Sun","weekend","sled","East River","2","2","1",7,0,33,-1,21,21.2,5,-2,-1,-2,4,2,1,-1
"9705",2020-01-20,"Snodgrass","w1920","Non.motorized",39,"Mon","weekday","no_sled","East River","2","2","1",7.1,0.1,32,-1,25,22.2,-1,5,-2,-1,-2,3,1,0
"9706",2020-01-20,"Snodgrass","w1920","Mechanized",1,"Mon","weekday","no_sled","East River","2","2","1",7.1,0.1,32,-1,25,22.2,-1,5,-2,-1,-2,3,1,0
"9707",2020-01-20,"Snodgrass","w1920","Motorized",0,"Mon","weekday","sled","East River","2","2","1",7.1,0.1,32,-1,25,22.2,-1,5,-2,-1,-2,3,1,0
"9708",2020-01-20,"Snodgrass","w1920","Hybrid",0,"Mon","weekday","sled","East River","2","2","1",7.1,0.1,32,-1,25,22.2,-1,5,-2,-1,-2,3,1,0
"9709",2020-01-21,"Snodgrass","w1920","Non.motorized",35,"Tue","weekday","no_sled","East River","2","2","1",7.1,0,31,-1,28,22.9,-1,-1,5,-2,-2,-3,2,0
"9710",2020-01-21,"Snodgrass","w1920","Mechanized",0,"Tue","weekday","no_sled","East River","2","2","1",7.1,0,31,-1,28,22.9,-1,-1,5,-2,-2,-3,2,0
"9711",2020-01-21,"Snodgrass","w1920","Motorized",0,"Tue","weekday","sled","East River","2","2","1",7.1,0,31,-1,28,22.9,-1,-1,5,-2,-2,-3,2,0
"9712",2020-01-21,"Snodgrass","w1920","Hybrid",0,"Tue","weekday","sled","East River","2","2","1",7.1,0,31,-1,28,22.9,-1,-1,5,-2,-2,-3,2,0
"9713",2020-01-22,"Snodgrass","w1920","Non.motorized",36,"Wed","weekday","no_sled","East River","2","2","2",7.3,0.2,32,1,25,22.8,-1,-1,-1,5,0,-1,-2,3
"9714",2020-01-22,"Snodgrass","w1920","Mechanized",1,"Wed","weekday","no_sled","East River","2","2","2",7.3,0.2,32,1,25,22.8,-1,-1,-1,5,0,-1,-2,3
"9715",2020-01-22,"Snodgrass","w1920","Motorized",0,"Wed","weekday","sled","East River","2","2","2",7.3,0.2,32,1,25,22.8,-1,-1,-1,5,0,-1,-2,3
"9716",2020-01-22,"Snodgrass","w1920","Hybrid",0,"Wed","weekday","sled","East River","2","2","2",7.3,0.2,32,1,25,22.8,-1,-1,-1,5,0,-1,-2,3
"9717",2020-01-23,"Snodgrass","w1920","Non.motorized",36,"Thu","weekday","no_sled","East River","3","2","2",7.3,0,34,2,23,21.5,1,-1,-1,-1,3,2,1,0
"9718",2020-01-23,"Snodgrass","w1920","Mechanized",1,"Thu","weekday","no_sled","East River","3","2","2",7.3,0,34,2,23,21.5,1,-1,-1,-1,3,2,1,0
"9719",2020-01-23,"Snodgrass","w1920","Motorized",0,"Thu","weekday","sled","East River","3","2","2",7.3,0,34,2,23,21.5,1,-1,-1,-1,3,2,1,0
"9720",2020-01-23,"Snodgrass","w1920","Hybrid",0,"Thu","weekday","sled","East River","3","2","2",7.3,0,34,2,23,21.5,1,-1,-1,-1,3,2,1,0
"9721",2020-01-24,"Snodgrass","w1920","Non.motorized",74,"Fri","weekday","no_sled","East River","2","2","1",7.3,0,33,-1,23,22.1,2,1,-1,-1,1,2,1,0
"9722",2020-01-24,"Snodgrass","w1920","Mechanized",6,"Fri","weekday","no_sled","East River","2","2","1",7.3,0,33,-1,23,22.1,2,1,-1,-1,1,2,1,0
"9723",2020-01-24,"Snodgrass","w1920","Motorized",0,"Fri","weekday","sled","East River","2","2","1",7.3,0,33,-1,23,22.1,2,1,-1,-1,1,2,1,0
"9724",2020-01-24,"Snodgrass","w1920","Hybrid",0,"Fri","weekday","sled","East River","2","2","1",7.3,0,33,-1,23,22.1,2,1,-1,-1,1,2,1,0
"9725",2020-01-25,"Snodgrass","w1920","Non.motorized",104,"Sat","weekend","no_sled","East River","2","2","1",7.4,0.1,32,-1,25,23.1,-1,2,1,-1,-2,0,1,0
"9726",2020-01-25,"Snodgrass","w1920","Mechanized",3,"Sat","weekend","no_sled","East River","2","2","1",7.4,0.1,32,-1,25,23.1,-1,2,1,-1,-2,0,1,0
"9727",2020-01-25,"Snodgrass","w1920","Motorized",0,"Sat","weekend","sled","East River","2","2","1",7.4,0.1,32,-1,25,23.1,-1,2,1,-1,-2,0,1,0
"9728",2020-01-25,"Snodgrass","w1920","Hybrid",0,"Sat","weekend","sled","East River","2","2","1",7.4,0.1,32,-1,25,23.1,-1,2,1,-1,-2,0,1,0
"9729",2020-01-26,"Snodgrass","w1920","Non.motorized",90,"Sun","weekend","no_sled","East River","2","1","1",7.4,0,32,0,28,23.1,-1,-1,2,1,-1,-2,0,1
"9730",2020-01-26,"Snodgrass","w1920","Mechanized",2,"Sun","weekend","no_sled","East River","2","1","1",7.4,0,32,0,28,23.1,-1,-1,2,1,-1,-2,0,1
"9731",2020-01-26,"Snodgrass","w1920","Motorized",0,"Sun","weekend","sled","East River","2","1","1",7.4,0,32,0,28,23.1,-1,-1,2,1,-1,-2,0,1
"9732",2020-01-26,"Snodgrass","w1920","Hybrid",0,"Sun","weekend","sled","East River","2","1","1",7.4,0,32,0,28,23.1,-1,-1,2,1,-1,-2,0,1
"9733",2020-01-27,"Snodgrass","w1920","Non.motorized",32,"Mon","weekday","no_sled","East River","2","1","1",7.4,0,32,0,24,23.1,0,-1,-1,2,0,-1,-2,0
"9734",2020-01-27,"Snodgrass","w1920","Mechanized",0,"Mon","weekday","no_sled","East River","2","1","1",7.4,0,32,0,24,23.1,0,-1,-1,2,0,-1,-2,0
"9735",2020-01-27,"Snodgrass","w1920","Motorized",0,"Mon","weekday","sled","East River","2","1","1",7.4,0,32,0,24,23.1,0,-1,-1,2,0,-1,-2,0
"9736",2020-01-27,"Snodgrass","w1920","Hybrid",0,"Mon","weekday","sled","East River","2","1","1",7.4,0,32,0,24,23.1,0,-1,-1,2,0,-1,-2,0
"9737",2020-01-28,"Snodgrass","w1920","Non.motorized",67,"Tue","weekday","no_sled","East River","3","2","2",7.4,0,32,0,19,23.1,0,0,-1,-1,0,0,-1,-2
"9738",2020-01-28,"Snodgrass","w1920","Mechanized",1,"Tue","weekday","no_sled","East River","3","2","2",7.4,0,32,0,19,23.1,0,0,-1,-1,0,0,-1,-2
"9739",2020-01-28,"Snodgrass","w1920","Motorized",0,"Tue","weekday","sled","East River","3","2","2",7.4,0,32,0,19,23.1,0,0,-1,-1,0,0,-1,-2
"9740",2020-01-28,"Snodgrass","w1920","Hybrid",0,"Tue","weekday","sled","East River","3","2","2",7.4,0,32,0,19,23.1,0,0,-1,-1,0,0,-1,-2
"9741",2020-01-29,"Snodgrass","w1920","Non.motorized",43,"Wed","weekday","no_sled","East River","2","2","1",7.4,0,31,-1,20,23.9,0,0,0,-1,-1,-1,-1,-2
"9742",2020-01-29,"Snodgrass","w1920","Mechanized",3,"Wed","weekday","no_sled","East River","2","2","1",7.4,0,31,-1,20,23.9,0,0,0,-1,-1,-1,-1,-2
"9743",2020-01-29,"Snodgrass","w1920","Motorized",0,"Wed","weekday","sled","East River","2","2","1",7.4,0,31,-1,20,23.9,0,0,0,-1,-1,-1,-1,-2
"9744",2020-01-29,"Snodgrass","w1920","Hybrid",0,"Wed","weekday","sled","East River","2","2","1",7.4,0,31,-1,20,23.9,0,0,0,-1,-1,-1,-1,-2
"9745",2020-01-30,"Snodgrass","w1920","Non.motorized",33,"Thu","weekday","no_sled","East River","2","2","1",7.4,0,31,0,17,23.9,-1,0,0,0,-1,-1,-1,-1
"9746",2020-01-30,"Snodgrass","w1920","Mechanized",8,"Thu","weekday","no_sled","East River","2","2","1",7.4,0,31,0,17,23.9,-1,0,0,0,-1,-1,-1,-1
"9747",2020-01-30,"Snodgrass","w1920","Motorized",0,"Thu","weekday","sled","East River","2","2","1",7.4,0,31,0,17,23.9,-1,0,0,0,-1,-1,-1,-1
"9748",2020-01-30,"Snodgrass","w1920","Hybrid",0,"Thu","weekday","sled","East River","2","2","1",7.4,0,31,0,17,23.9,-1,0,0,0,-1,-1,-1,-1
"9749",2020-01-31,"Snodgrass","w1920","Non.motorized",53,"Fri","weekday","no_sled","East River","2","1","1",7.4,0,31,0,20,23.9,0,-1,0,0,0,-1,-1,-1
"9750",2020-01-31,"Snodgrass","w1920","Mechanized",11,"Fri","weekday","no_sled","East River","2","1","1",7.4,0,31,0,20,23.9,0,-1,0,0,0,-1,-1,-1
"9751",2020-01-31,"Snodgrass","w1920","Motorized",0,"Fri","weekday","sled","East River","2","1","1",7.4,0,31,0,20,23.9,0,-1,0,0,0,-1,-1,-1
"9752",2020-01-31,"Snodgrass","w1920","Hybrid",0,"Fri","weekday","sled","East River","2","1","1",7.4,0,31,0,20,23.9,0,-1,0,0,0,-1,-1,-1
"9753",2020-02-01,"Snodgrass","w1920","Non.motorized",125,"Sat","weekend","no_sled","East River","2","1","1",7.4,0,31,0,28,23.9,0,0,-1,0,0,0,-1,-1
"9754",2020-02-01,"Snodgrass","w1920","Mechanized",14,"Sat","weekend","no_sled","East River","2","1","1",7.4,0,31,0,28,23.9,0,0,-1,0,0,0,-1,-1
"9755",2020-02-01,"Snodgrass","w1920","Motorized",0,"Sat","weekend","sled","East River","2","1","1",7.4,0,31,0,28,23.9,0,0,-1,0,0,0,-1,-1
"9756",2020-02-01,"Snodgrass","w1920","Hybrid",0,"Sat","weekend","sled","East River","2","1","1",7.4,0,31,0,28,23.9,0,0,-1,0,0,0,-1,-1
"9757",2020-02-02,"Snodgrass","w1920","Non.motorized",108,"Sun","weekend","no_sled","East River","1","1","1",7.4,0,31,0,33,23.9,0,0,0,-1,0,0,0,-1
"9758",2020-02-02,"Snodgrass","w1920","Mechanized",0,"Sun","weekend","no_sled","East River","1","1","1",7.4,0,31,0,33,23.9,0,0,0,-1,0,0,0,-1
"9759",2020-02-02,"Snodgrass","w1920","Motorized",0,"Sun","weekend","sled","East River","1","1","1",7.4,0,31,0,33,23.9,0,0,0,-1,0,0,0,-1
"9760",2020-02-02,"Snodgrass","w1920","Hybrid",0,"Sun","weekend","sled","East River","1","1","1",7.4,0,31,0,33,23.9,0,0,0,-1,0,0,0,-1
"9761",2020-02-03,"Snodgrass","w1920","Non.motorized",25,"Mon","weekday","no_sled","East River","2","2","1",7.4,0,31,0,24,23.9,0,0,0,0,0,0,0,0
"9762",2020-02-03,"Snodgrass","w1920","Mechanized",0,"Mon","weekday","no_sled","East River","2","2","1",7.4,0,31,0,24,23.9,0,0,0,0,0,0,0,0
"9763",2020-02-03,"Snodgrass","w1920","Motorized",0,"Mon","weekday","sled","East River","2","2","1",7.4,0,31,0,24,23.9,0,0,0,0,0,0,0,0
"9764",2020-02-03,"Snodgrass","w1920","Hybrid",0,"Mon","weekday","sled","East River","2","2","1",7.4,0,31,0,24,23.9,0,0,0,0,0,0,0,0
"9765",2020-02-04,"Snodgrass","w1920","Non.motorized",9,"Tue","weekday","no_sled","East River","2","2","2",7.4,0,33,2,5,22.4,0,0,0,0,2,2,2,2
"9766",2020-02-04,"Snodgrass","w1920","Mechanized",0,"Tue","weekday","no_sled","East River","2","2","2",7.4,0,33,2,5,22.4,0,0,0,0,2,2,2,2
"9767",2020-02-04,"Snodgrass","w1920","Motorized",0,"Tue","weekday","sled","East River","2","2","2",7.4,0,33,2,5,22.4,0,0,0,0,2,2,2,2
"9768",2020-02-04,"Snodgrass","w1920","Hybrid",0,"Tue","weekday","sled","East River","2","2","2",7.4,0,33,2,5,22.4,0,0,0,0,2,2,2,2
"9769",2020-02-05,"Snodgrass","w1920","Non.motorized",NA,"Wed","weekday","no_sled","East River","2","2","1",7.4,0,33,0,2,22.4,2,0,0,0,2,2,2,2
"9770",2020-02-05,"Snodgrass","w1920","Mechanized",NA,"Wed","weekday","no_sled","East River","2","2","1",7.4,0,33,0,2,22.4,2,0,0,0,2,2,2,2
"9771",2020-02-05,"Snodgrass","w1920","Motorized",NA,"Wed","weekday","sled","East River","2","2","1",7.4,0,33,0,2,22.4,2,0,0,0,2,2,2,2
"9772",2020-02-05,"Snodgrass","w1920","Hybrid",NA,"Wed","weekday","sled","East River","2","2","1",7.4,0,33,0,2,22.4,2,0,0,0,2,2,2,2
"9773",2020-02-06,"Snodgrass","w1920","Non.motorized",NA,"Thu","weekday","no_sled","East River","2","2","1",7.5,0.1,32,-1,16,23.4,0,2,0,0,-1,1,1,1
"9774",2020-02-06,"Snodgrass","w1920","Mechanized",NA,"Thu","weekday","no_sled","East River","2","2","1",7.5,0.1,32,-1,16,23.4,0,2,0,0,-1,1,1,1
"9775",2020-02-06,"Snodgrass","w1920","Motorized",NA,"Thu","weekday","sled","East River","2","2","1",7.5,0.1,32,-1,16,23.4,0,2,0,0,-1,1,1,1
"9776",2020-02-06,"Snodgrass","w1920","Hybrid",NA,"Thu","weekday","sled","East River","2","2","1",7.5,0.1,32,-1,16,23.4,0,2,0,0,-1,1,1,1
"9777",2020-02-07,"Snodgrass","w1920","Non.motorized",NA,"Fri","weekday","no_sled","East River","3","3","3",7.9,0.4,37,5,26,21.4,-1,0,2,0,4,4,6,6
"9778",2020-02-07,"Snodgrass","w1920","Mechanized",NA,"Fri","weekday","no_sled","East River","3","3","3",7.9,0.4,37,5,26,21.4,-1,0,2,0,4,4,6,6
"9779",2020-02-07,"Snodgrass","w1920","Motorized",NA,"Fri","weekday","sled","East River","3","3","3",7.9,0.4,37,5,26,21.4,-1,0,2,0,4,4,6,6
"9780",2020-02-07,"Snodgrass","w1920","Hybrid",NA,"Fri","weekday","sled","East River","3","3","3",7.9,0.4,37,5,26,21.4,-1,0,2,0,4,4,6,6
"9781",2020-02-08,"Snodgrass","w1920","Non.motorized",NA,"Sat","weekend","no_sled","East River","3","3","2",8.3,0.4,39,2,30,21.3,5,-1,0,2,7,6,6,8
"9782",2020-02-08,"Snodgrass","w1920","Mechanized",NA,"Sat","weekend","no_sled","East River","3","3","2",8.3,0.4,39,2,30,21.3,5,-1,0,2,7,6,6,8
"9783",2020-02-08,"Snodgrass","w1920","Motorized",NA,"Sat","weekend","sled","East River","3","3","2",8.3,0.4,39,2,30,21.3,5,-1,0,2,7,6,6,8
"9784",2020-02-08,"Snodgrass","w1920","Hybrid",NA,"Sat","weekend","sled","East River","3","3","2",8.3,0.4,39,2,30,21.3,5,-1,0,2,7,6,6,8
"9785",2020-02-09,"Snodgrass","w1920","Non.motorized",NA,"Sun","weekend","no_sled","East River","3","2","2",8.4,0.1,38,-1,26,22.1,2,5,-1,0,1,6,5,5
"9786",2020-02-09,"Snodgrass","w1920","Mechanized",NA,"Sun","weekend","no_sled","East River","3","2","2",8.4,0.1,38,-1,26,22.1,2,5,-1,0,1,6,5,5
"9787",2020-02-09,"Snodgrass","w1920","Motorized",NA,"Sun","weekend","sled","East River","3","2","2",8.4,0.1,38,-1,26,22.1,2,5,-1,0,1,6,5,5
"9788",2020-02-09,"Snodgrass","w1920","Hybrid",NA,"Sun","weekend","sled","East River","3","2","2",8.4,0.1,38,-1,26,22.1,2,5,-1,0,1,6,5,5
"9789",2020-02-10,"Snodgrass","w1920","Non.motorized",NA,"Mon","weekday","no_sled","East River","2","2","1",8.4,0,38,0,22,22.1,-1,2,5,-1,-1,1,6,5
"9790",2020-02-10,"Snodgrass","w1920","Mechanized",NA,"Mon","weekday","no_sled","East River","2","2","1",8.4,0,38,0,22,22.1,-1,2,5,-1,-1,1,6,5
"9791",2020-02-10,"Snodgrass","w1920","Motorized",NA,"Mon","weekday","sled","East River","2","2","1",8.4,0,38,0,22,22.1,-1,2,5,-1,-1,1,6,5
"9792",2020-02-10,"Snodgrass","w1920","Hybrid",NA,"Mon","weekday","sled","East River","2","2","1",8.4,0,38,0,22,22.1,-1,2,5,-1,-1,1,6,5
"9793",2020-02-11,"Snodgrass","w1920","Non.motorized",16,"Tue","weekday","no_sled","East River","2","2","2",8.5,0.1,40,2,16,21.2,0,-1,2,5,2,1,3,8
"9794",2020-02-11,"Snodgrass","w1920","Mechanized",0,"Tue","weekday","no_sled","East River","2","2","2",8.5,0.1,40,2,16,21.2,0,-1,2,5,2,1,3,8
"9795",2020-02-11,"Snodgrass","w1920","Motorized",0,"Tue","weekday","sled","East River","2","2","2",8.5,0.1,40,2,16,21.2,0,-1,2,5,2,1,3,8
"9796",2020-02-11,"Snodgrass","w1920","Hybrid",0,"Tue","weekday","sled","East River","2","2","2",8.5,0.1,40,2,16,21.2,0,-1,2,5,2,1,3,8
"9797",2020-02-12,"Snodgrass","w1920","Non.motorized",42,"Wed","weekday","no_sled","East River","2","2","2",8.5,0,39,-1,15,21.8,2,0,-1,2,1,1,0,2
"9798",2020-02-12,"Snodgrass","w1920","Mechanized",1,"Wed","weekday","no_sled","East River","2","2","2",8.5,0,39,-1,15,21.8,2,0,-1,2,1,1,0,2
"9799",2020-02-12,"Snodgrass","w1920","Motorized",0,"Wed","weekday","sled","East River","2","2","2",8.5,0,39,-1,15,21.8,2,0,-1,2,1,1,0,2
"9800",2020-02-12,"Snodgrass","w1920","Hybrid",0,"Wed","weekday","sled","East River","2","2","2",8.5,0,39,-1,15,21.8,2,0,-1,2,1,1,0,2
"9801",2020-02-13,"Snodgrass","w1920","Non.motorized",26,"Thu","weekday","no_sled","East River","2","2","1",8.5,0,39,0,18,21.8,-1,2,0,-1,-1,1,1,0
"9802",2020-02-13,"Snodgrass","w1920","Mechanized",0,"Thu","weekday","no_sled","East River","2","2","1",8.5,0,39,0,18,21.8,-1,2,0,-1,-1,1,1,0
"9803",2020-02-13,"Snodgrass","w1920","Motorized",0,"Thu","weekday","sled","East River","2","2","1",8.5,0,39,0,18,21.8,-1,2,0,-1,-1,1,1,0
"9804",2020-02-13,"Snodgrass","w1920","Hybrid",0,"Thu","weekday","sled","East River","2","2","1",8.5,0,39,0,18,21.8,-1,2,0,-1,-1,1,1,0
"9805",2020-02-14,"Snodgrass","w1920","Non.motorized",54,"Fri","weekday","no_sled","East River","2","1","1",8.6,0.1,38,-1,24,22.6,0,-1,2,0,-1,-2,0,0
"9806",2020-02-14,"Snodgrass","w1920","Mechanized",1,"Fri","weekday","no_sled","East River","2","1","1",8.6,0.1,38,-1,24,22.6,0,-1,2,0,-1,-2,0,0
"9807",2020-02-14,"Snodgrass","w1920","Motorized",0,"Fri","weekday","sled","East River","2","1","1",8.6,0.1,38,-1,24,22.6,0,-1,2,0,-1,-2,0,0
"9808",2020-02-14,"Snodgrass","w1920","Hybrid",0,"Fri","weekday","sled","East River","2","1","1",8.6,0.1,38,-1,24,22.6,0,-1,2,0,-1,-2,0,0
"9809",2020-02-15,"Snodgrass","w1920","Non.motorized",79,"Sat","weekend","no_sled","East River","1","1","1",8.6,0,38,0,26,22.6,-1,0,-1,2,-1,-1,-2,0
"9810",2020-02-15,"Snodgrass","w1920","Mechanized",7,"Sat","weekend","no_sled","East River","1","1","1",8.6,0,38,0,26,22.6,-1,0,-1,2,-1,-1,-2,0
"9811",2020-02-15,"Snodgrass","w1920","Motorized",0,"Sat","weekend","sled","East River","1","1","1",8.6,0,38,0,26,22.6,-1,0,-1,2,-1,-1,-2,0
"9812",2020-02-15,"Snodgrass","w1920","Hybrid",0,"Sat","weekend","sled","East River","1","1","1",8.6,0,38,0,26,22.6,-1,0,-1,2,-1,-1,-2,0
"9813",2020-02-16,"Snodgrass","w1920","Non.motorized",46,"Sun","weekend","no_sled","East River","1","1","1",8.8,0.2,37,-1,26,23.8,0,-1,0,-1,-1,-2,-2,-3
"9814",2020-02-16,"Snodgrass","w1920","Mechanized",0,"Sun","weekend","no_sled","East River","1","1","1",8.8,0.2,37,-1,26,23.8,0,-1,0,-1,-1,-2,-2,-3
"9815",2020-02-16,"Snodgrass","w1920","Motorized",0,"Sun","weekend","sled","East River","1","1","1",8.8,0.2,37,-1,26,23.8,0,-1,0,-1,-1,-2,-2,-3
"9816",2020-02-16,"Snodgrass","w1920","Hybrid",0,"Sun","weekend","sled","East River","1","1","1",8.8,0.2,37,-1,26,23.8,0,-1,0,-1,-1,-2,-2,-3
"9817",2020-02-17,"Snodgrass","w1920","Non.motorized",56,"Mon","weekday","no_sled","East River","2","1","1",9.2,0.4,43,6,25,21.4,-1,0,-1,0,5,5,4,4
"9818",2020-02-17,"Snodgrass","w1920","Mechanized",1,"Mon","weekday","no_sled","East River","2","1","1",9.2,0.4,43,6,25,21.4,-1,0,-1,0,5,5,4,4
"9819",2020-02-17,"Snodgrass","w1920","Motorized",0,"Mon","weekday","sled","East River","2","1","1",9.2,0.4,43,6,25,21.4,-1,0,-1,0,5,5,4,4
"9820",2020-02-17,"Snodgrass","w1920","Hybrid",0,"Mon","weekday","sled","East River","2","1","1",9.2,0.4,43,6,25,21.4,-1,0,-1,0,5,5,4,4
"9821",2020-02-18,"Snodgrass","w1920","Non.motorized",29,"Tue","weekday","no_sled","East River","1","1","1",9.3,0.1,42,-1,18,22.1,6,-1,0,-1,5,4,4,3
"9822",2020-02-18,"Snodgrass","w1920","Mechanized",0,"Tue","weekday","no_sled","East River","1","1","1",9.3,0.1,42,-1,18,22.1,6,-1,0,-1,5,4,4,3
"9823",2020-02-18,"Snodgrass","w1920","Motorized",0,"Tue","weekday","sled","East River","1","1","1",9.3,0.1,42,-1,18,22.1,6,-1,0,-1,5,4,4,3
"9824",2020-02-18,"Snodgrass","w1920","Hybrid",0,"Tue","weekday","sled","East River","1","1","1",9.3,0.1,42,-1,18,22.1,6,-1,0,-1,5,4,4,3
"9825",2020-02-19,"Snodgrass","w1920","Non.motorized",49,"Wed","weekday","no_sled","East River","1","1","1",9.3,0,41,-1,22,22.7,-1,6,-1,0,-2,4,3,3
"9826",2020-02-19,"Snodgrass","w1920","Mechanized",0,"Wed","weekday","no_sled","East River","1","1","1",9.3,0,41,-1,22,22.7,-1,6,-1,0,-2,4,3,3
"9827",2020-02-19,"Snodgrass","w1920","Motorized",0,"Wed","weekday","sled","East River","1","1","1",9.3,0,41,-1,22,22.7,-1,6,-1,0,-2,4,3,3
"9828",2020-02-19,"Snodgrass","w1920","Hybrid",0,"Wed","weekday","sled","East River","1","1","1",9.3,0,41,-1,22,22.7,-1,6,-1,0,-2,4,3,3
"9829",2020-02-20,"Snodgrass","w1920","Non.motorized",52,"Thu","weekday","no_sled","East River","1","1","1",9.3,0,41,0,18,22.7,-1,-1,6,-1,-1,-2,4,3
"9830",2020-02-20,"Snodgrass","w1920","Mechanized",1,"Thu","weekday","no_sled","East River","1","1","1",9.3,0,41,0,18,22.7,-1,-1,6,-1,-1,-2,4,3
"9831",2020-02-20,"Snodgrass","w1920","Motorized",0,"Thu","weekday","sled","East River","1","1","1",9.3,0,41,0,18,22.7,-1,-1,6,-1,-1,-2,4,3
"9832",2020-02-20,"Snodgrass","w1920","Hybrid",0,"Thu","weekday","sled","East River","1","1","1",9.3,0,41,0,18,22.7,-1,-1,6,-1,-1,-2,4,3
"9833",2020-02-21,"Snodgrass","w1920","Non.motorized",67,"Fri","weekday","no_sled","East River","1","1","1",9.3,0,40,-1,26,23.2,0,-1,-1,6,-1,-2,-3,3
"9834",2020-02-21,"Snodgrass","w1920","Mechanized",0,"Fri","weekday","no_sled","East River","1","1","1",9.3,0,40,-1,26,23.2,0,-1,-1,6,-1,-2,-3,3
"9835",2020-02-21,"Snodgrass","w1920","Motorized",0,"Fri","weekday","sled","East River","1","1","1",9.3,0,40,-1,26,23.2,0,-1,-1,6,-1,-2,-3,3
"9836",2020-02-21,"Snodgrass","w1920","Hybrid",0,"Fri","weekday","sled","East River","1","1","1",9.3,0,40,-1,26,23.2,0,-1,-1,6,-1,-2,-3,3
"9837",2020-02-22,"Snodgrass","w1920","Non.motorized",117,"Sat","weekend","no_sled","East River","1","1","1",9.4,0.1,39,-1,32,24.1,-1,0,-1,-1,-2,-2,-3,-4
"9838",2020-02-22,"Snodgrass","w1920","Mechanized",2,"Sat","weekend","no_sled","East River","1","1","1",9.4,0.1,39,-1,32,24.1,-1,0,-1,-1,-2,-2,-3,-4
"9839",2020-02-22,"Snodgrass","w1920","Motorized",0,"Sat","weekend","sled","East River","1","1","1",9.4,0.1,39,-1,32,24.1,-1,0,-1,-1,-2,-2,-3,-4
"9840",2020-02-22,"Snodgrass","w1920","Hybrid",0,"Sat","weekend","sled","East River","1","1","1",9.4,0.1,39,-1,32,24.1,-1,0,-1,-1,-2,-2,-3,-4
"9841",2020-02-23,"Snodgrass","w1920","Non.motorized",159,"Sun","weekend","no_sled","East River","2","2","2",9.5,0.1,40,1,27,23.8,-1,-1,0,-1,0,-1,-1,-2
"9842",2020-02-23,"Snodgrass","w1920","Mechanized",2,"Sun","weekend","no_sled","East River","2","2","2",9.5,0.1,40,1,27,23.8,-1,-1,0,-1,0,-1,-1,-2
"9843",2020-02-23,"Snodgrass","w1920","Motorized",0,"Sun","weekend","sled","East River","2","2","2",9.5,0.1,40,1,27,23.8,-1,-1,0,-1,0,-1,-1,-2
"9844",2020-02-23,"Snodgrass","w1920","Hybrid",0,"Sun","weekend","sled","East River","2","2","2",9.5,0.1,40,1,27,23.8,-1,-1,0,-1,0,-1,-1,-2
"9845",2020-02-24,"Snodgrass","w1920","Non.motorized",12,"Mon","weekday","no_sled","East River","3","3","2",9.8,0.3,43,3,17,22.8,1,-1,-1,0,4,3,2,2
"9846",2020-02-24,"Snodgrass","w1920","Mechanized",0,"Mon","weekday","no_sled","East River","3","3","2",9.8,0.3,43,3,17,22.8,1,-1,-1,0,4,3,2,2
"9847",2020-02-24,"Snodgrass","w1920","Motorized",0,"Mon","weekday","sled","East River","3","3","2",9.8,0.3,43,3,17,22.8,1,-1,-1,0,4,3,2,2
"9848",2020-02-24,"Snodgrass","w1920","Hybrid",0,"Mon","weekday","sled","East River","3","3","2",9.8,0.3,43,3,17,22.8,1,-1,-1,0,4,3,2,2
"9849",2020-02-25,"Snodgrass","w1920","Non.motorized",80,"Tue","weekday","no_sled","East River","2","2","1",9.8,0,43,0,8,22.8,3,1,-1,-1,3,4,3,2
"9850",2020-02-25,"Snodgrass","w1920","Mechanized",0,"Tue","weekday","no_sled","East River","2","2","1",9.8,0,43,0,8,22.8,3,1,-1,-1,3,4,3,2
"9851",2020-02-25,"Snodgrass","w1920","Motorized",0,"Tue","weekday","sled","East River","2","2","1",9.8,0,43,0,8,22.8,3,1,-1,-1,3,4,3,2
"9852",2020-02-25,"Snodgrass","w1920","Hybrid",0,"Tue","weekday","sled","East River","2","2","1",9.8,0,43,0,8,22.8,3,1,-1,-1,3,4,3,2
"9853",2020-02-26,"Snodgrass","w1920","Non.motorized",59,"Wed","weekday","no_sled","East River","2","2","1",9.8,0,42,-1,15,23.3,0,3,1,-1,-1,2,3,2
"9854",2020-02-26,"Snodgrass","w1920","Mechanized",0,"Wed","weekday","no_sled","East River","2","2","1",9.8,0,42,-1,15,23.3,0,3,1,-1,-1,2,3,2
"9855",2020-02-26,"Snodgrass","w1920","Motorized",0,"Wed","weekday","sled","East River","2","2","1",9.8,0,42,-1,15,23.3,0,3,1,-1,-1,2,3,2
"9856",2020-02-26,"Snodgrass","w1920","Hybrid",0,"Wed","weekday","sled","East River","2","2","1",9.8,0,42,-1,15,23.3,0,3,1,-1,-1,2,3,2
"9857",2020-02-27,"Snodgrass","w1920","Non.motorized",70,"Thu","weekday","no_sled","East River","2","2","1",9.9,0.1,41,-1,25,24.1,-1,0,3,1,-2,-2,1,2
"9858",2020-02-27,"Snodgrass","w1920","Mechanized",2,"Thu","weekday","no_sled","East River","2","2","1",9.9,0.1,41,-1,25,24.1,-1,0,3,1,-2,-2,1,2
"9859",2020-02-27,"Snodgrass","w1920","Motorized",0,"Thu","weekday","sled","East River","2","2","1",9.9,0.1,41,-1,25,24.1,-1,0,3,1,-2,-2,1,2
"9860",2020-02-27,"Snodgrass","w1920","Hybrid",0,"Thu","weekday","sled","East River","2","2","1",9.9,0.1,41,-1,25,24.1,-1,0,3,1,-2,-2,1,2
"9861",2020-02-28,"Snodgrass","w1920","Non.motorized",92,"Fri","weekday","no_sled","East River","2","1","1",9.9,0,41,0,28,24.1,-1,-1,0,3,-1,-2,-2,1
"9862",2020-02-28,"Snodgrass","w1920","Mechanized",2,"Fri","weekday","no_sled","East River","2","1","1",9.9,0,41,0,28,24.1,-1,-1,0,3,-1,-2,-2,1
"9863",2020-02-28,"Snodgrass","w1920","Motorized",0,"Fri","weekday","sled","East River","2","1","1",9.9,0,41,0,28,24.1,-1,-1,0,3,-1,-2,-2,1
"9864",2020-02-28,"Snodgrass","w1920","Hybrid",0,"Fri","weekday","sled","East River","2","1","1",9.9,0,41,0,28,24.1,-1,-1,0,3,-1,-2,-2,1
"9865",2020-02-29,"Snodgrass","w1920","Non.motorized",150,"Sat","weekend","no_sled","East River","1","1","1",9.9,0,40,-1,29,24.8,0,-1,-1,0,-1,-2,-3,-3
"9866",2020-02-29,"Snodgrass","w1920","Mechanized",3,"Sat","weekend","no_sled","East River","1","1","1",9.9,0,40,-1,29,24.8,0,-1,-1,0,-1,-2,-3,-3
"9867",2020-02-29,"Snodgrass","w1920","Motorized",0,"Sat","weekend","sled","East River","1","1","1",9.9,0,40,-1,29,24.8,0,-1,-1,0,-1,-2,-3,-3
"9868",2020-02-29,"Snodgrass","w1920","Hybrid",0,"Sat","weekend","sled","East River","1","1","1",9.9,0,40,-1,29,24.8,0,-1,-1,0,-1,-2,-3,-3
"9869",2020-03-01,"Snodgrass","w1920","Non.motorized",71,"Sun","weekend","no_sled","East River","1","1","1",10,0.1,40,0,28,25,-1,0,-1,-1,-1,-1,-2,-3
"9870",2020-03-01,"Snodgrass","w1920","Mechanized",0,"Sun","weekend","no_sled","East River","1","1","1",10,0.1,40,0,28,25,-1,0,-1,-1,-1,-1,-2,-3
"9871",2020-03-01,"Snodgrass","w1920","Motorized",0,"Sun","weekend","sled","East River","1","1","1",10,0.1,40,0,28,25,-1,0,-1,-1,-1,-1,-2,-3
"9872",2020-03-01,"Snodgrass","w1920","Hybrid",0,"Sun","weekend","sled","East River","1","1","1",10,0.1,40,0,28,25,-1,0,-1,-1,-1,-1,-2,-3
"9873",2020-03-02,"Snodgrass","w1920","Non.motorized",42,"Mon","weekday","no_sled","East River","2","2","1",10.4,0.4,45,5,25,23.1,0,-1,0,-1,5,4,4,3
"9874",2020-03-02,"Snodgrass","w1920","Mechanized",0,"Mon","weekday","no_sled","East River","2","2","1",10.4,0.4,45,5,25,23.1,0,-1,0,-1,5,4,4,3
"9875",2020-03-02,"Snodgrass","w1920","Motorized",0,"Mon","weekday","sled","East River","2","2","1",10.4,0.4,45,5,25,23.1,0,-1,0,-1,5,4,4,3
"9876",2020-03-02,"Snodgrass","w1920","Hybrid",0,"Mon","weekday","sled","East River","2","2","1",10.4,0.4,45,5,25,23.1,0,-1,0,-1,5,4,4,3
"9877",2020-03-03,"Snodgrass","w1920","Non.motorized",NA,"Tue","weekday","no_sled","East River","2","1","1",10.9,0.5,50,5,25,21.8,5,0,-1,0,10,10,9,9
"9878",2020-03-03,"Snodgrass","w1920","Mechanized",NA,"Tue","weekday","no_sled","East River","2","1","1",10.9,0.5,50,5,25,21.8,5,0,-1,0,10,10,9,9
"9879",2020-03-03,"Snodgrass","w1920","Motorized",NA,"Tue","weekday","sled","East River","2","1","1",10.9,0.5,50,5,25,21.8,5,0,-1,0,10,10,9,9
"9880",2020-03-03,"Snodgrass","w1920","Hybrid",NA,"Tue","weekday","sled","East River","2","1","1",10.9,0.5,50,5,25,21.8,5,0,-1,0,10,10,9,9
"9881",2020-03-04,"Snodgrass","w1920","Non.motorized",NA,"Wed","weekday","no_sled","East River","2","1","1",10.9,0,48,-2,29,22.7,5,5,0,-1,3,8,8,7
"9882",2020-03-04,"Snodgrass","w1920","Mechanized",NA,"Wed","weekday","no_sled","East River","2","1","1",10.9,0,48,-2,29,22.7,5,5,0,-1,3,8,8,7
"9883",2020-03-04,"Snodgrass","w1920","Motorized",NA,"Wed","weekday","sled","East River","2","1","1",10.9,0,48,-2,29,22.7,5,5,0,-1,3,8,8,7
"9884",2020-03-04,"Snodgrass","w1920","Hybrid",NA,"Wed","weekday","sled","East River","2","1","1",10.9,0,48,-2,29,22.7,5,5,0,-1,3,8,8,7
"9885",2020-03-05,"Snodgrass","w1920","Non.motorized",63,"Thu","weekday","no_sled","East River","2","1","1",10.9,0,46,-2,32,23.7,-2,5,5,0,-4,1,6,6
"9886",2020-03-05,"Snodgrass","w1920","Mechanized",1,"Thu","weekday","no_sled","East River","2","1","1",10.9,0,46,-2,32,23.7,-2,5,5,0,-4,1,6,6
"9887",2020-03-05,"Snodgrass","w1920","Motorized",0,"Thu","weekday","sled","East River","2","1","1",10.9,0,46,-2,32,23.7,-2,5,5,0,-4,1,6,6
"9888",2020-03-05,"Snodgrass","w1920","Hybrid",0,"Thu","weekday","sled","East River","2","1","1",10.9,0,46,-2,32,23.7,-2,5,5,0,-4,1,6,6
"9889",2020-03-06,"Snodgrass","w1920","Non.motorized",68,"Fri","weekday","no_sled","East River","1","1","1",10.9,0,45,-1,34,24.2,-2,-2,5,5,-3,-5,0,5
"9890",2020-03-06,"Snodgrass","w1920","Mechanized",0,"Fri","weekday","no_sled","East River","1","1","1",10.9,0,45,-1,34,24.2,-2,-2,5,5,-3,-5,0,5
"9891",2020-03-06,"Snodgrass","w1920","Motorized",0,"Fri","weekday","sled","East River","1","1","1",10.9,0,45,-1,34,24.2,-2,-2,5,5,-3,-5,0,5
"9892",2020-03-06,"Snodgrass","w1920","Hybrid",0,"Fri","weekday","sled","East River","1","1","1",10.9,0,45,-1,34,24.2,-2,-2,5,5,-3,-5,0,5
"9893",2020-03-07,"Snodgrass","w1920","Non.motorized",121,"Sat","weekend","no_sled","East River","1","1","2",10.9,0,44,-1,35,24.8,-1,-2,-2,5,-2,-4,-6,-1
"9894",2020-03-07,"Snodgrass","w1920","Mechanized",0,"Sat","weekend","no_sled","East River","1","1","2",10.9,0,44,-1,35,24.8,-1,-2,-2,5,-2,-4,-6,-1
"9895",2020-03-07,"Snodgrass","w1920","Motorized",0,"Sat","weekend","sled","East River","1","1","2",10.9,0,44,-1,35,24.8,-1,-2,-2,5,-2,-4,-6,-1
"9896",2020-03-07,"Snodgrass","w1920","Hybrid",0,"Sat","weekend","sled","East River","1","1","2",10.9,0,44,-1,35,24.8,-1,-2,-2,5,-2,-4,-6,-1
"9897",2020-03-08,"Snodgrass","w1920","Non.motorized",86,"Sun","weekend","no_sled","East River","1","1","1",11,0.1,43,-1,33,25.6,-1,-1,-2,-2,-2,-3,-5,-7
"9898",2020-03-08,"Snodgrass","w1920","Mechanized",1,"Sun","weekend","no_sled","East River","1","1","1",11,0.1,43,-1,33,25.6,-1,-1,-2,-2,-2,-3,-5,-7
"9899",2020-03-08,"Snodgrass","w1920","Motorized",0,"Sun","weekend","sled","East River","1","1","1",11,0.1,43,-1,33,25.6,-1,-1,-2,-2,-2,-3,-5,-7
"9900",2020-03-08,"Snodgrass","w1920","Hybrid",0,"Sun","weekend","sled","East River","1","1","1",11,0.1,43,-1,33,25.6,-1,-1,-2,-2,-2,-3,-5,-7
"9901",2020-03-09,"Snodgrass","w1920","Non.motorized",42,"Mon","weekday","no_sled","East River","1","1","1",11.1,0.1,42,-1,31,26.4,-1,-1,-1,-2,-2,-3,-4,-6
"9902",2020-03-09,"Snodgrass","w1920","Mechanized",0,"Mon","weekday","no_sled","East River","1","1","1",11.1,0.1,42,-1,31,26.4,-1,-1,-1,-2,-2,-3,-4,-6
"9903",2020-03-09,"Snodgrass","w1920","Motorized",0,"Mon","weekday","sled","East River","1","1","1",11.1,0.1,42,-1,31,26.4,-1,-1,-1,-2,-2,-3,-4,-6
"9904",2020-03-09,"Snodgrass","w1920","Hybrid",0,"Mon","weekday","sled","East River","1","1","1",11.1,0.1,42,-1,31,26.4,-1,-1,-1,-2,-2,-3,-4,-6
"9905",2020-03-10,"Snodgrass","w1920","Non.motorized",27,"Tue","weekday","no_sled","East River","1","1","2",11.2,0.1,44,2,31,25.5,-1,-1,-1,-1,1,0,-1,-2
"9906",2020-03-10,"Snodgrass","w1920","Mechanized",0,"Tue","weekday","no_sled","East River","1","1","2",11.2,0.1,44,2,31,25.5,-1,-1,-1,-1,1,0,-1,-2
"9907",2020-03-10,"Snodgrass","w1920","Motorized",0,"Tue","weekday","sled","East River","1","1","2",11.2,0.1,44,2,31,25.5,-1,-1,-1,-1,1,0,-1,-2
"9908",2020-03-10,"Snodgrass","w1920","Hybrid",0,"Tue","weekday","sled","East River","1","1","2",11.2,0.1,44,2,31,25.5,-1,-1,-1,-1,1,0,-1,-2
"9909",2020-03-11,"Snodgrass","w1920","Non.motorized",61,"Wed","weekday","no_sled","East River","2","2","1",11.2,0,44,0,32,25.5,2,-1,-1,-1,2,1,0,-1
"9910",2020-03-11,"Snodgrass","w1920","Mechanized",0,"Wed","weekday","no_sled","East River","2","2","1",11.2,0,44,0,32,25.5,2,-1,-1,-1,2,1,0,-1
"9911",2020-03-11,"Snodgrass","w1920","Motorized",0,"Wed","weekday","sled","East River","2","2","1",11.2,0,44,0,32,25.5,2,-1,-1,-1,2,1,0,-1
"9912",2020-03-11,"Snodgrass","w1920","Hybrid",0,"Wed","weekday","sled","East River","2","2","1",11.2,0,44,0,32,25.5,2,-1,-1,-1,2,1,0,-1
"9913",2020-03-12,"Snodgrass","w1920","Non.motorized",48,"Thu","weekday","no_sled","East River","2","2","2",11.4,0.2,42,-2,35,27.1,0,2,-1,-1,-2,0,-1,-2
"9914",2020-03-12,"Snodgrass","w1920","Mechanized",0,"Thu","weekday","no_sled","East River","2","2","2",11.4,0.2,42,-2,35,27.1,0,2,-1,-1,-2,0,-1,-2
"9915",2020-03-12,"Snodgrass","w1920","Motorized",0,"Thu","weekday","sled","East River","2","2","2",11.4,0.2,42,-2,35,27.1,0,2,-1,-1,-2,0,-1,-2
"9916",2020-03-12,"Snodgrass","w1920","Hybrid",0,"Thu","weekday","sled","East River","2","2","2",11.4,0.2,42,-2,35,27.1,0,2,-1,-1,-2,0,-1,-2
"9917",2020-03-13,"Snodgrass","w1920","Non.motorized",11,"Fri","weekday","no_sled","East River","3","3","2",11.5,0.1,44,2,31,26.1,-2,0,2,-1,0,0,2,1
"9918",2020-03-13,"Snodgrass","w1920","Mechanized",0,"Fri","weekday","no_sled","East River","3","3","2",11.5,0.1,44,2,31,26.1,-2,0,2,-1,0,0,2,1
"9919",2020-03-13,"Snodgrass","w1920","Motorized",0,"Fri","weekday","sled","East River","3","3","2",11.5,0.1,44,2,31,26.1,-2,0,2,-1,0,0,2,1
"9920",2020-03-13,"Snodgrass","w1920","Hybrid",0,"Fri","weekday","sled","East River","3","3","2",11.5,0.1,44,2,31,26.1,-2,0,2,-1,0,0,2,1
"9921",2020-03-14,"Snodgrass","w1920","Non.motorized",75,"Sat","weekend","no_sled","East River","3","3","3",11.7,0.2,44,0,31,26.6,2,-2,0,2,2,0,0,2
"9922",2020-03-14,"Snodgrass","w1920","Mechanized",0,"Sat","weekend","no_sled","East River","3","3","3",11.7,0.2,44,0,31,26.6,2,-2,0,2,2,0,0,2
"9923",2020-03-14,"Snodgrass","w1920","Motorized",0,"Sat","weekend","sled","East River","3","3","3",11.7,0.2,44,0,31,26.6,2,-2,0,2,2,0,0,2
"9924",2020-03-14,"Snodgrass","w1920","Hybrid",0,"Sat","weekend","sled","East River","3","3","3",11.7,0.2,44,0,31,26.6,2,-2,0,2,2,0,0,2
"9925",2020-03-15,"Snodgrass","w1920","Non.motorized",166,"Sun","weekend","no_sled","East River","2","2","2",11.7,0,45,1,33,26,0,2,-2,0,1,3,1,1
"9926",2020-03-15,"Snodgrass","w1920","Mechanized",1,"Sun","weekend","no_sled","East River","2","2","2",11.7,0,45,1,33,26,0,2,-2,0,1,3,1,1
"9927",2020-03-15,"Snodgrass","w1920","Motorized",0,"Sun","weekend","sled","East River","2","2","2",11.7,0,45,1,33,26,0,2,-2,0,1,3,1,1
"9928",2020-03-15,"Snodgrass","w1920","Hybrid",0,"Sun","weekend","sled","East River","2","2","2",11.7,0,45,1,33,26,0,2,-2,0,1,3,1,1
"9929",2020-03-16,"Snodgrass","w1920","Non.motorized",104,"Mon","weekday","no_sled","East River","2","2","2",11.7,0,45,0,35,26,1,0,2,-2,1,1,3,1
"9930",2020-03-16,"Snodgrass","w1920","Mechanized",2,"Mon","weekday","no_sled","East River","2","2","2",11.7,0,45,0,35,26,1,0,2,-2,1,1,3,1
"9931",2020-03-16,"Snodgrass","w1920","Motorized",0,"Mon","weekday","sled","East River","2","2","2",11.7,0,45,0,35,26,1,0,2,-2,1,1,3,1
"9932",2020-03-16,"Snodgrass","w1920","Hybrid",0,"Mon","weekday","sled","East River","2","2","2",11.7,0,45,0,35,26,1,0,2,-2,1,1,3,1
"9933",2020-03-17,"Snodgrass","w1920","Non.motorized",NA,"Tue","weekday","no_sled","East River","2","2","2",11.7,0,44,-1,36,26.6,0,1,0,2,-1,0,0,2
"9934",2020-03-17,"Snodgrass","w1920","Mechanized",NA,"Tue","weekday","no_sled","East River","2","2","2",11.7,0,44,-1,36,26.6,0,1,0,2,-1,0,0,2
"9935",2020-03-17,"Snodgrass","w1920","Motorized",NA,"Tue","weekday","sled","East River","2","2","2",11.7,0,44,-1,36,26.6,0,1,0,2,-1,0,0,2
"9936",2020-03-17,"Snodgrass","w1920","Hybrid",NA,"Tue","weekday","sled","East River","2","2","2",11.7,0,44,-1,36,26.6,0,1,0,2,-1,0,0,2
"9937",2020-03-18,"Snodgrass","w1920","Non.motorized",NA,"Wed","weekday","no_sled","East River","2","2","2",11.7,0,43,-1,33,27.2,-1,0,1,0,-2,-2,-1,-1
"9938",2020-03-18,"Snodgrass","w1920","Mechanized",NA,"Wed","weekday","no_sled","East River","2","2","2",11.7,0,43,-1,33,27.2,-1,0,1,0,-2,-2,-1,-1
"9939",2020-03-18,"Snodgrass","w1920","Motorized",NA,"Wed","weekday","sled","East River","2","2","2",11.7,0,43,-1,33,27.2,-1,0,1,0,-2,-2,-1,-1
"9940",2020-03-18,"Snodgrass","w1920","Hybrid",NA,"Wed","weekday","sled","East River","2","2","2",11.7,0,43,-1,33,27.2,-1,0,1,0,-2,-2,-1,-1
"9941",2020-03-19,"Snodgrass","w1920","Non.motorized",NA,"Thu","weekday","no_sled","East River","3","3","3",11.8,0.1,43,0,27,27.4,-1,-1,0,1,-1,-2,-2,-1
"9942",2020-03-19,"Snodgrass","w1920","Mechanized",NA,"Thu","weekday","no_sled","East River","3","3","3",11.8,0.1,43,0,27,27.4,-1,-1,0,1,-1,-2,-2,-1
"9943",2020-03-19,"Snodgrass","w1920","Motorized",NA,"Thu","weekday","sled","East River","3","3","3",11.8,0.1,43,0,27,27.4,-1,-1,0,1,-1,-2,-2,-1
"9944",2020-03-19,"Snodgrass","w1920","Hybrid",NA,"Thu","weekday","sled","East River","3","3","3",11.8,0.1,43,0,27,27.4,-1,-1,0,1,-1,-2,-2,-1
"9945",2020-03-20,"Snodgrass","w1920","Non.motorized",NA,"Fri","weekday","no_sled","East River","3","3","2",12.7,0.9,52,9,26,24.4,0,-1,-1,0,9,8,7,7
"9946",2020-03-20,"Snodgrass","w1920","Mechanized",NA,"Fri","weekday","no_sled","East River","3","3","2",12.7,0.9,52,9,26,24.4,0,-1,-1,0,9,8,7,7
"9947",2020-03-20,"Snodgrass","w1920","Motorized",NA,"Fri","weekday","sled","East River","3","3","2",12.7,0.9,52,9,26,24.4,0,-1,-1,0,9,8,7,7
"9948",2020-03-20,"Snodgrass","w1920","Hybrid",NA,"Fri","weekday","sled","East River","3","3","2",12.7,0.9,52,9,26,24.4,0,-1,-1,0,9,8,7,7
"9949",2020-03-21,"Snodgrass","w1920","Non.motorized",NA,"Sat","weekend","no_sled","East River","3","3","2",12.8,0.1,54,2,26,23.7,9,0,-1,-1,11,11,10,9
"9950",2020-03-21,"Snodgrass","w1920","Mechanized",NA,"Sat","weekend","no_sled","East River","3","3","2",12.8,0.1,54,2,26,23.7,9,0,-1,-1,11,11,10,9
"9951",2020-03-21,"Snodgrass","w1920","Motorized",NA,"Sat","weekend","sled","East River","3","3","2",12.8,0.1,54,2,26,23.7,9,0,-1,-1,11,11,10,9
"9952",2020-03-21,"Snodgrass","w1920","Hybrid",NA,"Sat","weekend","sled","East River","3","3","2",12.8,0.1,54,2,26,23.7,9,0,-1,-1,11,11,10,9
"9953",2020-03-22,"Snodgrass","w1920","Non.motorized",NA,"Sun","weekend","no_sled","East River","2","2","2",13,0.2,53,-1,28,24.5,2,9,0,-1,1,10,10,9
"9954",2020-03-22,"Snodgrass","w1920","Mechanized",NA,"Sun","weekend","no_sled","East River","2","2","2",13,0.2,53,-1,28,24.5,2,9,0,-1,1,10,10,9
"9955",2020-03-22,"Snodgrass","w1920","Motorized",NA,"Sun","weekend","sled","East River","2","2","2",13,0.2,53,-1,28,24.5,2,9,0,-1,1,10,10,9
"9956",2020-03-22,"Snodgrass","w1920","Hybrid",NA,"Sun","weekend","sled","East River","2","2","2",13,0.2,53,-1,28,24.5,2,9,0,-1,1,10,10,9
"9957",2020-03-23,"Snodgrass","w1920","Non.motorized",NA,"Mon","weekday","no_sled","East River","2","2","2",13,0,53,0,28,24.5,-1,2,9,0,-1,1,10,10
"9958",2020-03-23,"Snodgrass","w1920","Mechanized",NA,"Mon","weekday","no_sled","East River","2","2","2",13,0,53,0,28,24.5,-1,2,9,0,-1,1,10,10
"9959",2020-03-23,"Snodgrass","w1920","Motorized",NA,"Mon","weekday","sled","East River","2","2","2",13,0,53,0,28,24.5,-1,2,9,0,-1,1,10,10
"9960",2020-03-23,"Snodgrass","w1920","Hybrid",NA,"Mon","weekday","sled","East River","2","2","2",13,0,53,0,28,24.5,-1,2,9,0,-1,1,10,10
"9961",2020-03-24,"Snodgrass","w1920","Non.motorized",NA,"Tue","weekday","no_sled","East River","2","2","2",13.2,0.2,53,0,32,24.9,0,-1,2,9,0,-1,1,10
"9962",2020-03-24,"Snodgrass","w1920","Mechanized",NA,"Tue","weekday","no_sled","East River","2","2","2",13.2,0.2,53,0,32,24.9,0,-1,2,9,0,-1,1,10
"9963",2020-03-24,"Snodgrass","w1920","Motorized",NA,"Tue","weekday","sled","East River","2","2","2",13.2,0.2,53,0,32,24.9,0,-1,2,9,0,-1,1,10
"9964",2020-03-24,"Snodgrass","w1920","Hybrid",NA,"Tue","weekday","sled","East River","2","2","2",13.2,0.2,53,0,32,24.9,0,-1,2,9,0,-1,1,10
"9965",2020-03-25,"Snodgrass","w1920","Non.motorized",NA,"Wed","weekday","no_sled","East River","2","2","2",13.3,0.1,51,-2,34,26.1,0,0,-1,2,-2,-2,-3,-1
"9966",2020-03-25,"Snodgrass","w1920","Mechanized",NA,"Wed","weekday","no_sled","East River","2","2","2",13.3,0.1,51,-2,34,26.1,0,0,-1,2,-2,-2,-3,-1
"9967",2020-03-25,"Snodgrass","w1920","Motorized",NA,"Wed","weekday","sled","East River","2","2","2",13.3,0.1,51,-2,34,26.1,0,0,-1,2,-2,-2,-3,-1
"9968",2020-03-25,"Snodgrass","w1920","Hybrid",NA,"Wed","weekday","sled","East River","2","2","2",13.3,0.1,51,-2,34,26.1,0,0,-1,2,-2,-2,-3,-1
"9969",2020-03-26,"Snodgrass","w1920","Non.motorized",NA,"Thu","weekday","no_sled","East River","2","2","2",13.3,0,50,-1,36,26.6,-2,0,0,-1,-3,-3,-3,-4
"9970",2020-03-26,"Snodgrass","w1920","Non.motorized",NA,"Thu","weekday","no_sled","East River","3","3","2",13.3,0,50,-1,36,26.6,-2,0,0,-1,-3,-3,-3,-4
"9971",2020-03-26,"Snodgrass","w1920","Mechanized",NA,"Thu","weekday","no_sled","East River","2","2","2",13.3,0,50,-1,36,26.6,-2,0,0,-1,-3,-3,-3,-4
"9972",2020-03-26,"Snodgrass","w1920","Mechanized",NA,"Thu","weekday","no_sled","East River","3","3","2",13.3,0,50,-1,36,26.6,-2,0,0,-1,-3,-3,-3,-4
"9973",2020-03-26,"Snodgrass","w1920","Motorized",NA,"Thu","weekday","sled","East River","2","2","2",13.3,0,50,-1,36,26.6,-2,0,0,-1,-3,-3,-3,-4
"9974",2020-03-26,"Snodgrass","w1920","Motorized",NA,"Thu","weekday","sled","East River","3","3","2",13.3,0,50,-1,36,26.6,-2,0,0,-1,-3,-3,-3,-4
"9975",2020-03-26,"Snodgrass","w1920","Hybrid",NA,"Thu","weekday","sled","East River","2","2","2",13.3,0,50,-1,36,26.6,-2,0,0,-1,-3,-3,-3,-4
"9976",2020-03-26,"Snodgrass","w1920","Hybrid",NA,"Thu","weekday","sled","East River","3","3","2",13.3,0,50,-1,36,26.6,-2,0,0,-1,-3,-3,-3,-4
"9977",2020-03-27,"Snodgrass","w1920","Non.motorized",NA,"Fri","weekday","no_sled","East River","3","3","2",13.3,0,50,0,23,26.6,-1,-2,0,0,-1,-3,-3,-3
"9978",2020-03-27,"Snodgrass","w1920","Mechanized",NA,"Fri","weekday","no_sled","East River","3","3","2",13.3,0,50,0,23,26.6,-1,-2,0,0,-1,-3,-3,-3
"9979",2020-03-27,"Snodgrass","w1920","Motorized",NA,"Fri","weekday","sled","East River","3","3","2",13.3,0,50,0,23,26.6,-1,-2,0,0,-1,-3,-3,-3
"9980",2020-03-27,"Snodgrass","w1920","Hybrid",NA,"Fri","weekday","sled","East River","3","3","2",13.3,0,50,0,23,26.6,-1,-2,0,0,-1,-3,-3,-3
"9981",2020-03-28,"Snodgrass","w1920","Non.motorized",NA,"Sat","weekend","no_sled","East River","3","3","3",13.3,0,50,0,18,26.6,0,-1,-2,0,0,-1,-3,-3
"9982",2020-03-28,"Snodgrass","w1920","Mechanized",NA,"Sat","weekend","no_sled","East River","3","3","3",13.3,0,50,0,18,26.6,0,-1,-2,0,0,-1,-3,-3
"9983",2020-03-28,"Snodgrass","w1920","Motorized",NA,"Sat","weekend","sled","East River","3","3","3",13.3,0,50,0,18,26.6,0,-1,-2,0,0,-1,-3,-3
"9984",2020-03-28,"Snodgrass","w1920","Hybrid",NA,"Sat","weekend","sled","East River","3","3","3",13.3,0,50,0,18,26.6,0,-1,-2,0,0,-1,-3,-3
"9985",2020-03-29,"Snodgrass","w1920","Non.motorized",NA,"Sun","weekend","no_sled","East River","2","2","2",13.3,0,49,-1,24,27.1,0,0,-1,-2,-1,-1,-2,-4
"9986",2020-03-29,"Snodgrass","w1920","Mechanized",NA,"Sun","weekend","no_sled","East River","2","2","2",13.3,0,49,-1,24,27.1,0,0,-1,-2,-1,-1,-2,-4
"9987",2020-03-29,"Snodgrass","w1920","Motorized",NA,"Sun","weekend","sled","East River","2","2","2",13.3,0,49,-1,24,27.1,0,0,-1,-2,-1,-1,-2,-4
"9988",2020-03-29,"Snodgrass","w1920","Hybrid",NA,"Sun","weekend","sled","East River","2","2","2",13.3,0,49,-1,24,27.1,0,0,-1,-2,-1,-1,-2,-4
"9989",2020-03-30,"Snodgrass","w1920","Non.motorized",NA,"Mon","weekday","no_sled","East River","2","2","2",13.4,0.1,49,0,29,27.3,-1,0,0,-1,-1,-1,-1,-2
"9990",2020-03-30,"Snodgrass","w1920","Mechanized",NA,"Mon","weekday","no_sled","East River","2","2","2",13.4,0.1,49,0,29,27.3,-1,0,0,-1,-1,-1,-1,-2
"9991",2020-03-30,"Snodgrass","w1920","Motorized",NA,"Mon","weekday","sled","East River","2","2","2",13.4,0.1,49,0,29,27.3,-1,0,0,-1,-1,-1,-1,-2
"9992",2020-03-30,"Snodgrass","w1920","Hybrid",NA,"Mon","weekday","sled","East River","2","2","2",13.4,0.1,49,0,29,27.3,-1,0,0,-1,-1,-1,-1,-2
"9993",2020-03-31,"Snodgrass","w1920","Non.motorized",NA,"Tue","weekday","no_sled","East River","2","2","2",13.6,0.2,51,2,35,26.7,0,-1,0,0,2,1,1,1
"9994",2020-03-31,"Snodgrass","w1920","Mechanized",NA,"Tue","weekday","no_sled","East River","2","2","2",13.6,0.2,51,2,35,26.7,0,-1,0,0,2,1,1,1
"9995",2020-03-31,"Snodgrass","w1920","Motorized",NA,"Tue","weekday","sled","East River","2","2","2",13.6,0.2,51,2,35,26.7,0,-1,0,0,2,1,1,1
"9996",2020-03-31,"Snodgrass","w1920","Hybrid",NA,"Tue","weekday","sled","East River","2","2","2",13.6,0.2,51,2,35,26.7,0,-1,0,0,2,1,1,1
"9997",2020-04-01,"Snodgrass","w1920","Non.motorized",NA,"Wed","weekday","no_sled","East River","2","2","2",13.6,0,47,-4,39,28.9,2,0,-1,0,-2,-2,-3,-3
"9998",2020-04-01,"Snodgrass","w1920","Mechanized",NA,"Wed","weekday","no_sled","East River","2","2","2",13.6,0,47,-4,39,28.9,2,0,-1,0,-2,-2,-3,-3
"9999",2020-04-01,"Snodgrass","w1920","Motorized",NA,"Wed","weekday","sled","East River","2","2","2",13.6,0,47,-4,39,28.9,2,0,-1,0,-2,-2,-3,-3
"10000",2020-04-01,"Snodgrass","w1920","Hybrid",NA,"Wed","weekday","sled","East River","2","2","2",13.6,0,47,-4,39,28.9,2,0,-1,0,-2,-2,-3,-3
"10001",2020-04-02,"Snodgrass","w1920","Non.motorized",NA,"Thu","weekday","no_sled","East River","2","2","2",13.6,0,46,-1,31,29.6,-4,2,0,-1,-5,-3,-3,-4
"10002",2020-04-02,"Snodgrass","w1920","Mechanized",NA,"Thu","weekday","no_sled","East River","2","2","2",13.6,0,46,-1,31,29.6,-4,2,0,-1,-5,-3,-3,-4
"10003",2020-04-02,"Snodgrass","w1920","Motorized",NA,"Thu","weekday","sled","East River","2","2","2",13.6,0,46,-1,31,29.6,-4,2,0,-1,-5,-3,-3,-4
"10004",2020-04-02,"Snodgrass","w1920","Hybrid",NA,"Thu","weekday","sled","East River","2","2","2",13.6,0,46,-1,31,29.6,-4,2,0,-1,-5,-3,-3,-4
"10005",2020-04-03,"Snodgrass","w1920","Non.motorized",NA,"Fri","weekday","no_sled","East River","2","2","2",13.6,0,46,0,28,29.6,-1,-4,2,0,-1,-5,-3,-3
"10006",2020-04-03,"Snodgrass","w1920","Mechanized",NA,"Fri","weekday","no_sled","East River","2","2","2",13.6,0,46,0,28,29.6,-1,-4,2,0,-1,-5,-3,-3
"10007",2020-04-03,"Snodgrass","w1920","Motorized",NA,"Fri","weekday","sled","East River","2","2","2",13.6,0,46,0,28,29.6,-1,-4,2,0,-1,-5,-3,-3
"10008",2020-04-03,"Snodgrass","w1920","Hybrid",NA,"Fri","weekday","sled","East River","2","2","2",13.6,0,46,0,28,29.6,-1,-4,2,0,-1,-5,-3,-3
"10009",2020-04-04,"Snodgrass","w1920","Non.motorized",NA,"Sat","weekend","no_sled","East River","2","2","2",13.6,0,45,-1,33,30.2,0,-1,-4,2,-1,-2,-6,-4
"10010",2020-04-04,"Snodgrass","w1920","Mechanized",NA,"Sat","weekend","no_sled","East River","2","2","2",13.6,0,45,-1,33,30.2,0,-1,-4,2,-1,-2,-6,-4
"10011",2020-04-04,"Snodgrass","w1920","Motorized",NA,"Sat","weekend","sled","East River","2","2","2",13.6,0,45,-1,33,30.2,0,-1,-4,2,-1,-2,-6,-4
"10012",2020-04-04,"Snodgrass","w1920","Hybrid",NA,"Sat","weekend","sled","East River","2","2","2",13.6,0,45,-1,33,30.2,0,-1,-4,2,-1,-2,-6,-4
"10013",2020-04-05,"Snodgrass","w1920","Non.motorized",NA,"Sun","weekend","no_sled","East River","2","2","3",13.6,0,45,0,38,30.2,-1,0,-1,-4,-1,-1,-2,-6
"10014",2020-04-05,"Snodgrass","w1920","Mechanized",NA,"Sun","weekend","no_sled","East River","2","2","3",13.6,0,45,0,38,30.2,-1,0,-1,-4,-1,-1,-2,-6
"10015",2020-04-05,"Snodgrass","w1920","Motorized",NA,"Sun","weekend","sled","East River","2","2","3",13.6,0,45,0,38,30.2,-1,0,-1,-4,-1,-1,-2,-6
"10016",2020-04-05,"Snodgrass","w1920","Hybrid",NA,"Sun","weekend","sled","East River","2","2","3",13.6,0,45,0,38,30.2,-1,0,-1,-4,-1,-1,-2,-6
"10017",2020-04-06,"Snodgrass","w1920","Non.motorized",NA,"Mon","weekday","no_sled","East River","2","2","3",13.6,0,44,-1,40,30.9,0,-1,0,-1,-1,-2,-2,-3
"10018",2020-04-06,"Snodgrass","w1920","Mechanized",NA,"Mon","weekday","no_sled","East River","2","2","3",13.6,0,44,-1,40,30.9,0,-1,0,-1,-1,-2,-2,-3
"10019",2020-04-06,"Snodgrass","w1920","Motorized",NA,"Mon","weekday","sled","East River","2","2","3",13.6,0,44,-1,40,30.9,0,-1,0,-1,-1,-2,-2,-3
"10020",2020-04-06,"Snodgrass","w1920","Hybrid",NA,"Mon","weekday","sled","East River","2","2","3",13.6,0,44,-1,40,30.9,0,-1,0,-1,-1,-2,-2,-3
"10021",2020-04-07,"Snodgrass","w1920","Non.motorized",NA,"Tue","weekday","no_sled","East River","2","2","3",13.4,-0.2,43,-1,39,31.2,-1,0,-1,0,-2,-2,-3,-3
"10022",2020-04-07,"Snodgrass","w1920","Mechanized",NA,"Tue","weekday","no_sled","East River","2","2","3",13.4,-0.2,43,-1,39,31.2,-1,0,-1,0,-2,-2,-3,-3
"10023",2020-04-07,"Snodgrass","w1920","Motorized",NA,"Tue","weekday","sled","East River","2","2","3",13.4,-0.2,43,-1,39,31.2,-1,0,-1,0,-2,-2,-3,-3
"10024",2020-04-07,"Snodgrass","w1920","Hybrid",NA,"Tue","weekday","sled","East River","2","2","3",13.4,-0.2,43,-1,39,31.2,-1,0,-1,0,-2,-2,-3,-3
"10025",2020-04-08,"Snodgrass","w1920","Non.motorized",NA,"Wed","weekday","no_sled","East River","2","3","3",13.3,-0.1,42,-1,40,31.7,-1,-1,0,-1,-2,-3,-3,-4
"10026",2020-04-08,"Snodgrass","w1920","Mechanized",NA,"Wed","weekday","no_sled","East River","2","3","3",13.3,-0.1,42,-1,40,31.7,-1,-1,0,-1,-2,-3,-3,-4
"10027",2020-04-08,"Snodgrass","w1920","Motorized",NA,"Wed","weekday","sled","East River","2","3","3",13.3,-0.1,42,-1,40,31.7,-1,-1,0,-1,-2,-3,-3,-4
"10028",2020-04-08,"Snodgrass","w1920","Hybrid",NA,"Wed","weekday","sled","East River","2","3","3",13.3,-0.1,42,-1,40,31.7,-1,-1,0,-1,-2,-3,-3,-4
"10029",2020-04-09,"Snodgrass","w1920","Non.motorized",NA,"Thu","weekday","no_sled","East River","2","3","3",13.1,-0.2,40,-2,42,32.8,-1,-1,-1,0,-3,-4,-5,-5
"10030",2020-04-09,"Snodgrass","w1920","Mechanized",NA,"Thu","weekday","no_sled","East River","2","3","3",13.1,-0.2,40,-2,42,32.8,-1,-1,-1,0,-3,-4,-5,-5
"10031",2020-04-09,"Snodgrass","w1920","Motorized",NA,"Thu","weekday","sled","East River","2","3","3",13.1,-0.2,40,-2,42,32.8,-1,-1,-1,0,-3,-4,-5,-5
"10032",2020-04-09,"Snodgrass","w1920","Hybrid",NA,"Thu","weekday","sled","East River","2","3","3",13.1,-0.2,40,-2,42,32.8,-1,-1,-1,0,-3,-4,-5,-5
"10033",2020-04-10,"Snodgrass","w1920","Non.motorized",NA,"Fri","weekday","no_sled","East River","3","3","3",12.9,-0.2,39,-1,38,33.1,-2,-1,-1,-1,-3,-4,-5,-6
"10034",2020-04-10,"Snodgrass","w1920","Mechanized",NA,"Fri","weekday","no_sled","East River","3","3","3",12.9,-0.2,39,-1,38,33.1,-2,-1,-1,-1,-3,-4,-5,-6
"10035",2020-04-10,"Snodgrass","w1920","Motorized",NA,"Fri","weekday","sled","East River","3","3","3",12.9,-0.2,39,-1,38,33.1,-2,-1,-1,-1,-3,-4,-5,-6
"10036",2020-04-10,"Snodgrass","w1920","Hybrid",NA,"Fri","weekday","sled","East River","3","3","3",12.9,-0.2,39,-1,38,33.1,-2,-1,-1,-1,-3,-4,-5,-6
"10037",2020-04-11,"Snodgrass","w1920","Non.motorized",NA,"Sat","weekend","no_sled","East River","2","3","3",12.9,0,39,0,36,33.1,-1,-2,-1,-1,-1,-3,-4,-5
"10038",2020-04-11,"Snodgrass","w1920","Mechanized",NA,"Sat","weekend","no_sled","East River","2","3","3",12.9,0,39,0,36,33.1,-1,-2,-1,-1,-1,-3,-4,-5
"10039",2020-04-11,"Snodgrass","w1920","Motorized",NA,"Sat","weekend","sled","East River","2","3","3",12.9,0,39,0,36,33.1,-1,-2,-1,-1,-1,-3,-4,-5
"10040",2020-04-11,"Snodgrass","w1920","Hybrid",NA,"Sat","weekend","sled","East River","2","3","3",12.9,0,39,0,36,33.1,-1,-2,-1,-1,-1,-3,-4,-5
"10041",2020-04-12,"Snodgrass","w1920","Non.motorized",NA,"Sun","weekend","no_sled","East River","2","2","2",12.8,-0.1,38,-1,29,33.7,0,-1,-2,-1,-1,-2,-4,-5
"10042",2020-04-12,"Snodgrass","w1920","Mechanized",NA,"Sun","weekend","no_sled","East River","2","2","2",12.8,-0.1,38,-1,29,33.7,0,-1,-2,-1,-1,-2,-4,-5
"10043",2020-04-12,"Snodgrass","w1920","Motorized",NA,"Sun","weekend","sled","East River","2","2","2",12.8,-0.1,38,-1,29,33.7,0,-1,-2,-1,-1,-2,-4,-5
"10044",2020-04-12,"Snodgrass","w1920","Hybrid",NA,"Sun","weekend","sled","East River","2","2","2",12.8,-0.1,38,-1,29,33.7,0,-1,-2,-1,-1,-2,-4,-5
"10045",2020-04-13,"Snodgrass","w1920","Non.motorized",NA,"Mon","weekday","no_sled","East River",NA,NA,NA,12.9,0.1,39,1,20,33.1,-1,0,-1,-2,0,0,-1,-3
"10046",2020-04-13,"Snodgrass","w1920","Mechanized",NA,"Mon","weekday","no_sled","East River",NA,NA,NA,12.9,0.1,39,1,20,33.1,-1,0,-1,-2,0,0,-1,-3
"10047",2020-04-13,"Snodgrass","w1920","Motorized",NA,"Mon","weekday","sled","East River",NA,NA,NA,12.9,0.1,39,1,20,33.1,-1,0,-1,-2,0,0,-1,-3
"10048",2020-04-13,"Snodgrass","w1920","Hybrid",NA,"Mon","weekday","sled","East River",NA,NA,NA,12.9,0.1,39,1,20,33.1,-1,0,-1,-2,0,0,-1,-3
"10049",2020-04-14,"Snodgrass","w1920","Non.motorized",NA,"Tue","weekday","no_sled","East River","2","2","2",13,0.1,39,0,18,33.3,1,-1,0,-1,1,0,0,-1
"10050",2020-04-14,"Snodgrass","w1920","Mechanized",NA,"Tue","weekday","no_sled","East River","2","2","2",13,0.1,39,0,18,33.3,1,-1,0,-1,1,0,0,-1
"10051",2020-04-14,"Snodgrass","w1920","Motorized",NA,"Tue","weekday","sled","East River","2","2","2",13,0.1,39,0,18,33.3,1,-1,0,-1,1,0,0,-1
"10052",2020-04-14,"Snodgrass","w1920","Hybrid",NA,"Tue","weekday","sled","East River","2","2","2",13,0.1,39,0,18,33.3,1,-1,0,-1,1,0,0,-1
"10053",2020-04-15,"Snodgrass","w1920","Non.motorized",NA,"Wed","weekday","no_sled","East River",NA,NA,NA,13.2,0.2,39,0,28,33.8,0,1,-1,0,0,1,0,0
"10054",2020-04-15,"Snodgrass","w1920","Mechanized",NA,"Wed","weekday","no_sled","East River",NA,NA,NA,13.2,0.2,39,0,28,33.8,0,1,-1,0,0,1,0,0
"10055",2020-04-15,"Snodgrass","w1920","Motorized",NA,"Wed","weekday","sled","East River",NA,NA,NA,13.2,0.2,39,0,28,33.8,0,1,-1,0,0,1,0,0
"10056",2020-04-15,"Snodgrass","w1920","Hybrid",NA,"Wed","weekday","sled","East River",NA,NA,NA,13.2,0.2,39,0,28,33.8,0,1,-1,0,0,1,0,0
"10057",2019-12-06,"Washington Gulch","w1920","Non.motorized",0,"Fri","weekday","no_sled","Washington Gulch","2","2","1",2.9,0.4,19,5,24,15.3,0,0,0,0,5,5,5,5
"10058",2019-12-06,"Washington Gulch","w1920","Mechanized",0,"Fri","weekday","no_sled","Washington Gulch","2","2","1",2.9,0.4,19,5,24,15.3,0,0,0,0,5,5,5,5
"10059",2019-12-06,"Washington Gulch","w1920","Motorized",0,"Fri","weekday","sled","Washington Gulch","2","2","1",2.9,0.4,19,5,24,15.3,0,0,0,0,5,5,5,5
"10060",2019-12-06,"Washington Gulch","w1920","Hybrid",1,"Fri","weekday","sled","Washington Gulch","2","2","1",2.9,0.4,19,5,24,15.3,0,0,0,0,5,5,5,5
"10061",2019-12-07,"Washington Gulch","w1920","Non.motorized",22,"Sat","weekend","no_sled","Washington Gulch","2","2","1",3,0.1,18,-1,29,16.7,5,0,0,0,4,4,4,4
"10062",2019-12-07,"Washington Gulch","w1920","Mechanized",0,"Sat","weekend","no_sled","Washington Gulch","2","2","1",3,0.1,18,-1,29,16.7,5,0,0,0,4,4,4,4
"10063",2019-12-07,"Washington Gulch","w1920","Motorized",1,"Sat","weekend","sled","Washington Gulch","2","2","1",3,0.1,18,-1,29,16.7,5,0,0,0,4,4,4,4
"10064",2019-12-07,"Washington Gulch","w1920","Hybrid",6,"Sat","weekend","sled","Washington Gulch","2","2","1",3,0.1,18,-1,29,16.7,5,0,0,0,4,4,4,4
"10065",2019-12-08,"Washington Gulch","w1920","Non.motorized",27,"Sun","weekend","no_sled","Washington Gulch","2","2","1",3,0,17,-1,28,17.6,-1,5,0,0,-2,3,3,3
"10066",2019-12-08,"Washington Gulch","w1920","Mechanized",0,"Sun","weekend","no_sled","Washington Gulch","2","2","1",3,0,17,-1,28,17.6,-1,5,0,0,-2,3,3,3
"10067",2019-12-08,"Washington Gulch","w1920","Motorized",3,"Sun","weekend","sled","Washington Gulch","2","2","1",3,0,17,-1,28,17.6,-1,5,0,0,-2,3,3,3
"10068",2019-12-08,"Washington Gulch","w1920","Hybrid",0,"Sun","weekend","sled","Washington Gulch","2","2","1",3,0,17,-1,28,17.6,-1,5,0,0,-2,3,3,3
"10069",2019-12-09,"Washington Gulch","w1920","Non.motorized",3,"Mon","weekday","no_sled","Washington Gulch","3","3","2",3.4,0.4,22,5,21,15.5,-1,-1,5,0,4,3,8,8
"10070",2019-12-09,"Washington Gulch","w1920","Mechanized",0,"Mon","weekday","no_sled","Washington Gulch","3","3","2",3.4,0.4,22,5,21,15.5,-1,-1,5,0,4,3,8,8
"10071",2019-12-09,"Washington Gulch","w1920","Motorized",0,"Mon","weekday","sled","Washington Gulch","3","3","2",3.4,0.4,22,5,21,15.5,-1,-1,5,0,4,3,8,8
"10072",2019-12-09,"Washington Gulch","w1920","Hybrid",3,"Mon","weekday","sled","Washington Gulch","3","3","2",3.4,0.4,22,5,21,15.5,-1,-1,5,0,4,3,8,8
"10073",2019-12-10,"Washington Gulch","w1920","Non.motorized",5,"Tue","weekday","no_sled","Washington Gulch","2","2","2",3.4,0,21,-1,19,16.2,5,-1,-1,5,4,3,2,7
"10074",2019-12-10,"Washington Gulch","w1920","Mechanized",0,"Tue","weekday","no_sled","Washington Gulch","2","2","2",3.4,0,21,-1,19,16.2,5,-1,-1,5,4,3,2,7
"10075",2019-12-10,"Washington Gulch","w1920","Motorized",0,"Tue","weekday","sled","Washington Gulch","2","2","2",3.4,0,21,-1,19,16.2,5,-1,-1,5,4,3,2,7
"10076",2019-12-10,"Washington Gulch","w1920","Hybrid",0,"Tue","weekday","sled","Washington Gulch","2","2","2",3.4,0,21,-1,19,16.2,5,-1,-1,5,4,3,2,7
"10077",2019-12-11,"Washington Gulch","w1920","Non.motorized",11,"Wed","weekday","no_sled","Washington Gulch","2","2","2",3.4,0,20,-1,22,17,-1,5,-1,-1,-2,3,2,1
"10078",2019-12-11,"Washington Gulch","w1920","Mechanized",1,"Wed","weekday","no_sled","Washington Gulch","2","2","2",3.4,0,20,-1,22,17,-1,5,-1,-1,-2,3,2,1
"10079",2019-12-11,"Washington Gulch","w1920","Motorized",0,"Wed","weekday","sled","Washington Gulch","2","2","2",3.4,0,20,-1,22,17,-1,5,-1,-1,-2,3,2,1
"10080",2019-12-11,"Washington Gulch","w1920","Hybrid",3,"Wed","weekday","sled","Washington Gulch","2","2","2",3.4,0,20,-1,22,17,-1,5,-1,-1,-2,3,2,1
"10081",2019-12-12,"Washington Gulch","w1920","Non.motorized",NA,"Thu","weekday","no_sled","Washington Gulch","2","2","2",3.4,0,19,-1,25,17.9,-1,-1,5,-1,-2,-3,2,1
"10082",2019-12-12,"Washington Gulch","w1920","Mechanized",NA,"Thu","weekday","no_sled","Washington Gulch","2","2","2",3.4,0,19,-1,25,17.9,-1,-1,5,-1,-2,-3,2,1
"10083",2019-12-12,"Washington Gulch","w1920","Motorized",NA,"Thu","weekday","sled","Washington Gulch","2","2","2",3.4,0,19,-1,25,17.9,-1,-1,5,-1,-2,-3,2,1
"10084",2019-12-12,"Washington Gulch","w1920","Hybrid",NA,"Thu","weekday","sled","Washington Gulch","2","2","2",3.4,0,19,-1,25,17.9,-1,-1,5,-1,-2,-3,2,1
"10085",2019-12-13,"Washington Gulch","w1920","Non.motorized",NA,"Fri","weekday","no_sled","Washington Gulch","2","2","2",3.8,0.4,21,2,24,18.1,-1,-1,-1,5,1,0,-1,4
"10086",2019-12-13,"Washington Gulch","w1920","Mechanized",NA,"Fri","weekday","no_sled","Washington Gulch","2","2","2",3.8,0.4,21,2,24,18.1,-1,-1,-1,5,1,0,-1,4
"10087",2019-12-13,"Washington Gulch","w1920","Motorized",NA,"Fri","weekday","sled","Washington Gulch","2","2","2",3.8,0.4,21,2,24,18.1,-1,-1,-1,5,1,0,-1,4
"10088",2019-12-13,"Washington Gulch","w1920","Hybrid",NA,"Fri","weekday","sled","Washington Gulch","2","2","2",3.8,0.4,21,2,24,18.1,-1,-1,-1,5,1,0,-1,4
"10089",2019-12-14,"Washington Gulch","w1920","Non.motorized",NA,"Sat","weekend","no_sled","Washington Gulch","3","3","3",4.2,0.4,27,6,25,15.6,2,-1,-1,-1,8,7,6,5
"10090",2019-12-14,"Washington Gulch","w1920","Mechanized",NA,"Sat","weekend","no_sled","Washington Gulch","3","3","3",4.2,0.4,27,6,25,15.6,2,-1,-1,-1,8,7,6,5
"10091",2019-12-14,"Washington Gulch","w1920","Motorized",NA,"Sat","weekend","sled","Washington Gulch","3","3","3",4.2,0.4,27,6,25,15.6,2,-1,-1,-1,8,7,6,5
"10092",2019-12-14,"Washington Gulch","w1920","Hybrid",NA,"Sat","weekend","sled","Washington Gulch","3","3","3",4.2,0.4,27,6,25,15.6,2,-1,-1,-1,8,7,6,5
"10093",2019-12-15,"Washington Gulch","w1920","Non.motorized",NA,"Sun","weekend","no_sled","Washington Gulch","3","3","2",4.8,0.6,31,4,17,15.5,6,2,-1,-1,10,12,11,10
"10094",2019-12-15,"Washington Gulch","w1920","Mechanized",NA,"Sun","weekend","no_sled","Washington Gulch","3","3","2",4.8,0.6,31,4,17,15.5,6,2,-1,-1,10,12,11,10
"10095",2019-12-15,"Washington Gulch","w1920","Motorized",NA,"Sun","weekend","sled","Washington Gulch","3","3","2",4.8,0.6,31,4,17,15.5,6,2,-1,-1,10,12,11,10
"10096",2019-12-15,"Washington Gulch","w1920","Hybrid",NA,"Sun","weekend","sled","Washington Gulch","3","3","2",4.8,0.6,31,4,17,15.5,6,2,-1,-1,10,12,11,10
"10097",2019-12-16,"Washington Gulch","w1920","Non.motorized",NA,"Mon","weekday","no_sled","Washington Gulch","3","3","2",4.8,0,29,-2,6,16.6,4,6,2,-1,2,8,10,9
"10098",2019-12-16,"Washington Gulch","w1920","Mechanized",NA,"Mon","weekday","no_sled","Washington Gulch","3","3","2",4.8,0,29,-2,6,16.6,4,6,2,-1,2,8,10,9
"10099",2019-12-16,"Washington Gulch","w1920","Motorized",NA,"Mon","weekday","sled","Washington Gulch","3","3","2",4.8,0,29,-2,6,16.6,4,6,2,-1,2,8,10,9
"10100",2019-12-16,"Washington Gulch","w1920","Hybrid",NA,"Mon","weekday","sled","Washington Gulch","3","3","2",4.8,0,29,-2,6,16.6,4,6,2,-1,2,8,10,9
"10101",2019-12-17,"Washington Gulch","w1920","Non.motorized",NA,"Tue","weekday","no_sled","Washington Gulch","2","2","1",4.8,0,27,-2,8,17.8,-2,4,6,2,-4,0,6,8
"10102",2019-12-17,"Washington Gulch","w1920","Mechanized",NA,"Tue","weekday","no_sled","Washington Gulch","2","2","1",4.8,0,27,-2,8,17.8,-2,4,6,2,-4,0,6,8
"10103",2019-12-17,"Washington Gulch","w1920","Motorized",NA,"Tue","weekday","sled","Washington Gulch","2","2","1",4.8,0,27,-2,8,17.8,-2,4,6,2,-4,0,6,8
"10104",2019-12-17,"Washington Gulch","w1920","Hybrid",NA,"Tue","weekday","sled","Washington Gulch","2","2","1",4.8,0,27,-2,8,17.8,-2,4,6,2,-4,0,6,8
"10105",2019-12-18,"Washington Gulch","w1920","Non.motorized",NA,"Wed","weekday","no_sled","Washington Gulch","2","2","1",4.8,0,26,-1,20,18.5,-2,-2,4,6,-3,-5,-1,5
"10106",2019-12-18,"Washington Gulch","w1920","Mechanized",NA,"Wed","weekday","no_sled","Washington Gulch","2","2","1",4.8,0,26,-1,20,18.5,-2,-2,4,6,-3,-5,-1,5
"10107",2019-12-18,"Washington Gulch","w1920","Motorized",NA,"Wed","weekday","sled","Washington Gulch","2","2","1",4.8,0,26,-1,20,18.5,-2,-2,4,6,-3,-5,-1,5
"10108",2019-12-18,"Washington Gulch","w1920","Hybrid",NA,"Wed","weekday","sled","Washington Gulch","2","2","1",4.8,0,26,-1,20,18.5,-2,-2,4,6,-3,-5,-1,5
"10109",2019-12-19,"Washington Gulch","w1920","Non.motorized",NA,"Thu","weekday","no_sled","Washington Gulch","2","2","1",4.9,0.1,25,-1,21,19.6,-1,-2,-2,4,-2,-4,-6,-2
"10110",2019-12-19,"Washington Gulch","w1920","Mechanized",NA,"Thu","weekday","no_sled","Washington Gulch","2","2","1",4.9,0.1,25,-1,21,19.6,-1,-2,-2,4,-2,-4,-6,-2
"10111",2019-12-19,"Washington Gulch","w1920","Motorized",NA,"Thu","weekday","sled","Washington Gulch","2","2","1",4.9,0.1,25,-1,21,19.6,-1,-2,-2,4,-2,-4,-6,-2
"10112",2019-12-19,"Washington Gulch","w1920","Hybrid",NA,"Thu","weekday","sled","Washington Gulch","2","2","1",4.9,0.1,25,-1,21,19.6,-1,-2,-2,4,-2,-4,-6,-2
"10113",2019-12-20,"Washington Gulch","w1920","Non.motorized",NA,"Fri","weekday","no_sled","Washington Gulch","2","2","1",4.9,0,24,-1,21,20.4,-1,-1,-2,-2,-2,-3,-5,-7
"10114",2019-12-20,"Washington Gulch","w1920","Mechanized",NA,"Fri","weekday","no_sled","Washington Gulch","2","2","1",4.9,0,24,-1,21,20.4,-1,-1,-2,-2,-2,-3,-5,-7
"10115",2019-12-20,"Washington Gulch","w1920","Motorized",NA,"Fri","weekday","sled","Washington Gulch","2","2","1",4.9,0,24,-1,21,20.4,-1,-1,-2,-2,-2,-3,-5,-7
"10116",2019-12-20,"Washington Gulch","w1920","Hybrid",NA,"Fri","weekday","sled","Washington Gulch","2","2","1",4.9,0,24,-1,21,20.4,-1,-1,-2,-2,-2,-3,-5,-7
"10117",2019-12-21,"Washington Gulch","w1920","Non.motorized",NA,"Sat","weekend","no_sled","Washington Gulch","2","2","1",4.9,0,24,0,27,20.4,-1,-1,-1,-2,-1,-2,-3,-5
"10118",2019-12-21,"Washington Gulch","w1920","Mechanized",NA,"Sat","weekend","no_sled","Washington Gulch","2","2","1",4.9,0,24,0,27,20.4,-1,-1,-1,-2,-1,-2,-3,-5
"10119",2019-12-21,"Washington Gulch","w1920","Motorized",NA,"Sat","weekend","sled","Washington Gulch","2","2","1",4.9,0,24,0,27,20.4,-1,-1,-1,-2,-1,-2,-3,-5
"10120",2019-12-21,"Washington Gulch","w1920","Hybrid",NA,"Sat","weekend","sled","Washington Gulch","2","2","1",4.9,0,24,0,27,20.4,-1,-1,-1,-2,-1,-2,-3,-5
"10121",2019-12-22,"Washington Gulch","w1920","Non.motorized",NA,"Sun","weekend","no_sled","Washington Gulch","2","2","1",5,0.1,23,-1,31,21.7,0,-1,-1,-1,-1,-2,-3,-4
"10122",2019-12-22,"Washington Gulch","w1920","Mechanized",NA,"Sun","weekend","no_sled","Washington Gulch","2","2","1",5,0.1,23,-1,31,21.7,0,-1,-1,-1,-1,-2,-3,-4
"10123",2019-12-22,"Washington Gulch","w1920","Motorized",NA,"Sun","weekend","sled","Washington Gulch","2","2","1",5,0.1,23,-1,31,21.7,0,-1,-1,-1,-1,-2,-3,-4
"10124",2019-12-22,"Washington Gulch","w1920","Hybrid",NA,"Sun","weekend","sled","Washington Gulch","2","2","1",5,0.1,23,-1,31,21.7,0,-1,-1,-1,-1,-2,-3,-4
"10125",2019-12-23,"Washington Gulch","w1920","Non.motorized",NA,"Mon","weekday","no_sled","Washington Gulch","2","1","1",5,0,23,0,34,21.7,-1,0,-1,-1,-1,-1,-2,-3
"10126",2019-12-23,"Washington Gulch","w1920","Mechanized",NA,"Mon","weekday","no_sled","Washington Gulch","2","1","1",5,0,23,0,34,21.7,-1,0,-1,-1,-1,-1,-2,-3
"10127",2019-12-23,"Washington Gulch","w1920","Motorized",NA,"Mon","weekday","sled","Washington Gulch","2","1","1",5,0,23,0,34,21.7,-1,0,-1,-1,-1,-1,-2,-3
"10128",2019-12-23,"Washington Gulch","w1920","Hybrid",NA,"Mon","weekday","sled","Washington Gulch","2","1","1",5,0,23,0,34,21.7,-1,0,-1,-1,-1,-1,-2,-3
"10129",2019-12-24,"Washington Gulch","w1920","Non.motorized",NA,"Tue","weekday","no_sled","Washington Gulch","2","1","1",5,0,22,-1,30,22.7,0,-1,0,-1,-1,-2,-2,-3
"10130",2019-12-24,"Washington Gulch","w1920","Mechanized",NA,"Tue","weekday","no_sled","Washington Gulch","2","1","1",5,0,22,-1,30,22.7,0,-1,0,-1,-1,-2,-2,-3
"10131",2019-12-24,"Washington Gulch","w1920","Motorized",NA,"Tue","weekday","sled","Washington Gulch","2","1","1",5,0,22,-1,30,22.7,0,-1,0,-1,-1,-2,-2,-3
"10132",2019-12-24,"Washington Gulch","w1920","Hybrid",NA,"Tue","weekday","sled","Washington Gulch","2","1","1",5,0,22,-1,30,22.7,0,-1,0,-1,-1,-2,-2,-3
"10133",2019-12-25,"Washington Gulch","w1920","Non.motorized",NA,"Wed","weekday","no_sled","Washington Gulch","2","2","2",5,0,23,1,22,21.7,-1,0,-1,0,0,0,-1,-1
"10134",2019-12-25,"Washington Gulch","w1920","Mechanized",NA,"Wed","weekday","no_sled","Washington Gulch","2","2","2",5,0,23,1,22,21.7,-1,0,-1,0,0,0,-1,-1
"10135",2019-12-25,"Washington Gulch","w1920","Motorized",NA,"Wed","weekday","sled","Washington Gulch","2","2","2",5,0,23,1,22,21.7,-1,0,-1,0,0,0,-1,-1
"10136",2019-12-25,"Washington Gulch","w1920","Hybrid",NA,"Wed","weekday","sled","Washington Gulch","2","2","2",5,0,23,1,22,21.7,-1,0,-1,0,0,0,-1,-1
"10137",2019-12-26,"Washington Gulch","w1920","Non.motorized",NA,"Thu","weekday","no_sled","Washington Gulch","2","2","1",5,0,23,0,17,21.7,1,-1,0,-1,1,0,0,-1
"10138",2019-12-26,"Washington Gulch","w1920","Mechanized",NA,"Thu","weekday","no_sled","Washington Gulch","2","2","1",5,0,23,0,17,21.7,1,-1,0,-1,1,0,0,-1
"10139",2019-12-26,"Washington Gulch","w1920","Motorized",NA,"Thu","weekday","sled","Washington Gulch","2","2","1",5,0,23,0,17,21.7,1,-1,0,-1,1,0,0,-1
"10140",2019-12-26,"Washington Gulch","w1920","Hybrid",NA,"Thu","weekday","sled","Washington Gulch","2","2","1",5,0,23,0,17,21.7,1,-1,0,-1,1,0,0,-1
"10141",2019-12-27,"Washington Gulch","w1920","Non.motorized",NA,"Fri","weekday","no_sled","Washington Gulch","3","3","2",5.1,0.1,24,1,22,21.2,0,1,-1,0,1,2,1,1
"10142",2019-12-27,"Washington Gulch","w1920","Mechanized",NA,"Fri","weekday","no_sled","Washington Gulch","3","3","2",5.1,0.1,24,1,22,21.2,0,1,-1,0,1,2,1,1
"10143",2019-12-27,"Washington Gulch","w1920","Motorized",NA,"Fri","weekday","sled","Washington Gulch","3","3","2",5.1,0.1,24,1,22,21.2,0,1,-1,0,1,2,1,1
"10144",2019-12-27,"Washington Gulch","w1920","Hybrid",NA,"Fri","weekday","sled","Washington Gulch","3","3","2",5.1,0.1,24,1,22,21.2,0,1,-1,0,1,2,1,1
"10145",2019-12-28,"Washington Gulch","w1920","Non.motorized",NA,"Sat","weekend","no_sled","Washington Gulch","3","3","2",5.6,0.5,30,6,16,18.7,1,0,1,-1,7,7,8,7
"10146",2019-12-28,"Washington Gulch","w1920","Mechanized",NA,"Sat","weekend","no_sled","Washington Gulch","3","3","2",5.6,0.5,30,6,16,18.7,1,0,1,-1,7,7,8,7
"10147",2019-12-28,"Washington Gulch","w1920","Motorized",NA,"Sat","weekend","sled","Washington Gulch","3","3","2",5.6,0.5,30,6,16,18.7,1,0,1,-1,7,7,8,7
"10148",2019-12-28,"Washington Gulch","w1920","Hybrid",NA,"Sat","weekend","sled","Washington Gulch","3","3","2",5.6,0.5,30,6,16,18.7,1,0,1,-1,7,7,8,7
"10149",2019-12-29,"Washington Gulch","w1920","Non.motorized",NA,"Sun","weekend","no_sled","Washington Gulch","3","3","2",5.6,0,29,-1,3,19.3,6,1,0,1,5,6,6,7
"10150",2019-12-29,"Washington Gulch","w1920","Mechanized",NA,"Sun","weekend","no_sled","Washington Gulch","3","3","2",5.6,0,29,-1,3,19.3,6,1,0,1,5,6,6,7
"10151",2019-12-29,"Washington Gulch","w1920","Motorized",NA,"Sun","weekend","sled","Washington Gulch","3","3","2",5.6,0,29,-1,3,19.3,6,1,0,1,5,6,6,7
"10152",2019-12-29,"Washington Gulch","w1920","Hybrid",NA,"Sun","weekend","sled","Washington Gulch","3","3","2",5.6,0,29,-1,3,19.3,6,1,0,1,5,6,6,7
"10153",2019-12-30,"Washington Gulch","w1920","Non.motorized",NA,"Mon","weekday","no_sled","Washington Gulch","3","3","2",5.6,0,28,-1,3,20,-1,6,1,0,-2,4,5,5
"10154",2019-12-30,"Washington Gulch","w1920","Mechanized",NA,"Mon","weekday","no_sled","Washington Gulch","3","3","2",5.6,0,28,-1,3,20,-1,6,1,0,-2,4,5,5
"10155",2019-12-30,"Washington Gulch","w1920","Motorized",NA,"Mon","weekday","sled","Washington Gulch","3","3","2",5.6,0,28,-1,3,20,-1,6,1,0,-2,4,5,5
"10156",2019-12-30,"Washington Gulch","w1920","Hybrid",NA,"Mon","weekday","sled","Washington Gulch","3","3","2",5.6,0,28,-1,3,20,-1,6,1,0,-2,4,5,5
"10157",2019-12-31,"Washington Gulch","w1920","Non.motorized",NA,"Tue","weekday","no_sled","Washington Gulch","2","2","1",5.6,0,28,0,13,20,-1,-1,6,1,-1,-2,4,5
"10158",2019-12-31,"Washington Gulch","w1920","Mechanized",NA,"Tue","weekday","no_sled","Washington Gulch","2","2","1",5.6,0,28,0,13,20,-1,-1,6,1,-1,-2,4,5
"10159",2019-12-31,"Washington Gulch","w1920","Motorized",NA,"Tue","weekday","sled","Washington Gulch","2","2","1",5.6,0,28,0,13,20,-1,-1,6,1,-1,-2,4,5
"10160",2019-12-31,"Washington Gulch","w1920","Hybrid",NA,"Tue","weekday","sled","Washington Gulch","2","2","1",5.6,0,28,0,13,20,-1,-1,6,1,-1,-2,4,5
"10161",2020-01-01,"Washington Gulch","w1920","Non.motorized",NA,"Wed","weekday","no_sled","Washington Gulch","2","1","1",5.6,0,27,-1,21,20.7,0,-1,-1,6,-1,-2,-3,3
"10162",2020-01-01,"Washington Gulch","w1920","Mechanized",NA,"Wed","weekday","no_sled","Washington Gulch","2","1","1",5.6,0,27,-1,21,20.7,0,-1,-1,6,-1,-2,-3,3
"10163",2020-01-01,"Washington Gulch","w1920","Motorized",NA,"Wed","weekday","sled","Washington Gulch","2","1","1",5.6,0,27,-1,21,20.7,0,-1,-1,6,-1,-2,-3,3
"10164",2020-01-01,"Washington Gulch","w1920","Hybrid",NA,"Wed","weekday","sled","Washington Gulch","2","1","1",5.6,0,27,-1,21,20.7,0,-1,-1,6,-1,-2,-3,3
"10165",2020-01-02,"Washington Gulch","w1920","Non.motorized",NA,"Thu","weekday","no_sled","Washington Gulch","3","3","2",5.9,0.3,29,2,16,20.3,-1,0,-1,-1,1,1,0,-1
"10166",2020-01-02,"Washington Gulch","w1920","Mechanized",NA,"Thu","weekday","no_sled","Washington Gulch","3","3","2",5.9,0.3,29,2,16,20.3,-1,0,-1,-1,1,1,0,-1
"10167",2020-01-02,"Washington Gulch","w1920","Motorized",NA,"Thu","weekday","sled","Washington Gulch","3","3","2",5.9,0.3,29,2,16,20.3,-1,0,-1,-1,1,1,0,-1
"10168",2020-01-02,"Washington Gulch","w1920","Hybrid",NA,"Thu","weekday","sled","Washington Gulch","3","3","2",5.9,0.3,29,2,16,20.3,-1,0,-1,-1,1,1,0,-1
"10169",2020-01-03,"Washington Gulch","w1920","Non.motorized",NA,"Fri","weekday","no_sled","Washington Gulch","3","2","1",5.9,0,31,2,19,19,2,-1,0,-1,4,3,3,2
"10170",2020-01-03,"Washington Gulch","w1920","Mechanized",NA,"Fri","weekday","no_sled","Washington Gulch","3","2","1",5.9,0,31,2,19,19,2,-1,0,-1,4,3,3,2
"10171",2020-01-03,"Washington Gulch","w1920","Motorized",NA,"Fri","weekday","sled","Washington Gulch","3","2","1",5.9,0,31,2,19,19,2,-1,0,-1,4,3,3,2
"10172",2020-01-03,"Washington Gulch","w1920","Hybrid",NA,"Fri","weekday","sled","Washington Gulch","3","2","1",5.9,0,31,2,19,19,2,-1,0,-1,4,3,3,2
"10173",2020-01-04,"Washington Gulch","w1920","Non.motorized",NA,"Sat","weekend","no_sled","Washington Gulch","2","2","1",5.9,0,30,-1,26,19.7,2,2,-1,0,1,3,2,2
"10174",2020-01-04,"Washington Gulch","w1920","Mechanized",NA,"Sat","weekend","no_sled","Washington Gulch","2","2","1",5.9,0,30,-1,26,19.7,2,2,-1,0,1,3,2,2
"10175",2020-01-04,"Washington Gulch","w1920","Motorized",NA,"Sat","weekend","sled","Washington Gulch","2","2","1",5.9,0,30,-1,26,19.7,2,2,-1,0,1,3,2,2
"10176",2020-01-04,"Washington Gulch","w1920","Hybrid",NA,"Sat","weekend","sled","Washington Gulch","2","2","1",5.9,0,30,-1,26,19.7,2,2,-1,0,1,3,2,2
"10177",2020-01-05,"Washington Gulch","w1920","Non.motorized",NA,"Sun","weekend","no_sled","Washington Gulch","2","2","1",5.9,0,28,-2,23,21.1,-1,2,2,-1,-3,-1,1,0
"10178",2020-01-05,"Washington Gulch","w1920","Mechanized",NA,"Sun","weekend","no_sled","Washington Gulch","2","2","1",5.9,0,28,-2,23,21.1,-1,2,2,-1,-3,-1,1,0
"10179",2020-01-05,"Washington Gulch","w1920","Motorized",NA,"Sun","weekend","sled","Washington Gulch","2","2","1",5.9,0,28,-2,23,21.1,-1,2,2,-1,-3,-1,1,0
"10180",2020-01-05,"Washington Gulch","w1920","Hybrid",NA,"Sun","weekend","sled","Washington Gulch","2","2","1",5.9,0,28,-2,23,21.1,-1,2,2,-1,-3,-1,1,0
"10181",2020-01-06,"Washington Gulch","w1920","Non.motorized",NA,"Mon","weekday","no_sled","Washington Gulch","2","2","1",5.9,0,28,0,15,21.1,-2,-1,2,2,-2,-3,-1,1
"10182",2020-01-06,"Washington Gulch","w1920","Mechanized",NA,"Mon","weekday","no_sled","Washington Gulch","2","2","1",5.9,0,28,0,15,21.1,-2,-1,2,2,-2,-3,-1,1
"10183",2020-01-06,"Washington Gulch","w1920","Motorized",NA,"Mon","weekday","sled","Washington Gulch","2","2","1",5.9,0,28,0,15,21.1,-2,-1,2,2,-2,-3,-1,1
"10184",2020-01-06,"Washington Gulch","w1920","Hybrid",NA,"Mon","weekday","sled","Washington Gulch","2","2","1",5.9,0,28,0,15,21.1,-2,-1,2,2,-2,-3,-1,1
"10185",2020-01-07,"Washington Gulch","w1920","Non.motorized",NA,"Tue","weekday","no_sled","Washington Gulch","2","1","1",5.9,0,28,0,22,21.1,0,-2,-1,2,0,-2,-3,-1
"10186",2020-01-07,"Washington Gulch","w1920","Mechanized",NA,"Tue","weekday","no_sled","Washington Gulch","2","1","1",5.9,0,28,0,22,21.1,0,-2,-1,2,0,-2,-3,-1
"10187",2020-01-07,"Washington Gulch","w1920","Motorized",NA,"Tue","weekday","sled","Washington Gulch","2","1","1",5.9,0,28,0,22,21.1,0,-2,-1,2,0,-2,-3,-1
"10188",2020-01-07,"Washington Gulch","w1920","Hybrid",NA,"Tue","weekday","sled","Washington Gulch","2","1","1",5.9,0,28,0,22,21.1,0,-2,-1,2,0,-2,-3,-1
"10189",2020-01-08,"Washington Gulch","w1920","Non.motorized",NA,"Wed","weekday","no_sled","Washington Gulch","2","1","1",6,0.1,28,0,23,21.4,0,0,-2,-1,0,0,-2,-3
"10190",2020-01-08,"Washington Gulch","w1920","Mechanized",NA,"Wed","weekday","no_sled","Washington Gulch","2","1","1",6,0.1,28,0,23,21.4,0,0,-2,-1,0,0,-2,-3
"10191",2020-01-08,"Washington Gulch","w1920","Motorized",NA,"Wed","weekday","sled","Washington Gulch","2","1","1",6,0.1,28,0,23,21.4,0,0,-2,-1,0,0,-2,-3
"10192",2020-01-08,"Washington Gulch","w1920","Hybrid",NA,"Wed","weekday","sled","Washington Gulch","2","1","1",6,0.1,28,0,23,21.4,0,0,-2,-1,0,0,-2,-3
"10193",2020-01-09,"Washington Gulch","w1920","Non.motorized",NA,"Thu","weekday","no_sled","Washington Gulch","2","1","1",6,0,27,-1,17,22.2,0,0,0,-2,-1,-1,-1,-3
"10194",2020-01-09,"Washington Gulch","w1920","Mechanized",NA,"Thu","weekday","no_sled","Washington Gulch","2","1","1",6,0,27,-1,17,22.2,0,0,0,-2,-1,-1,-1,-3
"10195",2020-01-09,"Washington Gulch","w1920","Motorized",NA,"Thu","weekday","sled","Washington Gulch","2","1","1",6,0,27,-1,17,22.2,0,0,0,-2,-1,-1,-1,-3
"10196",2020-01-09,"Washington Gulch","w1920","Hybrid",NA,"Thu","weekday","sled","Washington Gulch","2","1","1",6,0,27,-1,17,22.2,0,0,0,-2,-1,-1,-1,-3
"10197",2020-01-10,"Washington Gulch","w1920","Non.motorized",NA,"Fri","weekday","no_sled","Washington Gulch","2","1","1",6,0,29,2,11,20.7,-1,0,0,0,1,1,1,1
"10198",2020-01-10,"Washington Gulch","w1920","Mechanized",NA,"Fri","weekday","no_sled","Washington Gulch","2","1","1",6,0,29,2,11,20.7,-1,0,0,0,1,1,1,1
"10199",2020-01-10,"Washington Gulch","w1920","Motorized",NA,"Fri","weekday","sled","Washington Gulch","2","1","1",6,0,29,2,11,20.7,-1,0,0,0,1,1,1,1
"10200",2020-01-10,"Washington Gulch","w1920","Hybrid",NA,"Fri","weekday","sled","Washington Gulch","2","1","1",6,0,29,2,11,20.7,-1,0,0,0,1,1,1,1
"10201",2020-01-11,"Washington Gulch","w1920","Non.motorized",NA,"Sat","weekend","no_sled","Washington Gulch","2","1","1",6,0,29,0,12,20.7,2,-1,0,0,2,1,1,1
"10202",2020-01-11,"Washington Gulch","w1920","Mechanized",NA,"Sat","weekend","no_sled","Washington Gulch","2","1","1",6,0,29,0,12,20.7,2,-1,0,0,2,1,1,1
"10203",2020-01-11,"Washington Gulch","w1920","Motorized",NA,"Sat","weekend","sled","Washington Gulch","2","1","1",6,0,29,0,12,20.7,2,-1,0,0,2,1,1,1
"10204",2020-01-11,"Washington Gulch","w1920","Hybrid",NA,"Sat","weekend","sled","Washington Gulch","2","1","1",6,0,29,0,12,20.7,2,-1,0,0,2,1,1,1
"10205",2020-01-12,"Washington Gulch","w1920","Non.motorized",NA,"Sun","weekend","no_sled","Washington Gulch","2","1","1",6.1,0.1,29,0,13,21,0,2,-1,0,0,2,1,1
"10206",2020-01-12,"Washington Gulch","w1920","Mechanized",NA,"Sun","weekend","no_sled","Washington Gulch","2","1","1",6.1,0.1,29,0,13,21,0,2,-1,0,0,2,1,1
"10207",2020-01-12,"Washington Gulch","w1920","Motorized",NA,"Sun","weekend","sled","Washington Gulch","2","1","1",6.1,0.1,29,0,13,21,0,2,-1,0,0,2,1,1
"10208",2020-01-12,"Washington Gulch","w1920","Hybrid",NA,"Sun","weekend","sled","Washington Gulch","2","1","1",6.1,0.1,29,0,13,21,0,2,-1,0,0,2,1,1
"10209",2020-01-13,"Washington Gulch","w1920","Non.motorized",NA,"Mon","weekday","no_sled","Washington Gulch","2","2","1",6.2,0.1,29,0,16,21.4,0,0,2,-1,0,0,2,1
"10210",2020-01-13,"Washington Gulch","w1920","Mechanized",NA,"Mon","weekday","no_sled","Washington Gulch","2","2","1",6.2,0.1,29,0,16,21.4,0,0,2,-1,0,0,2,1
"10211",2020-01-13,"Washington Gulch","w1920","Motorized",NA,"Mon","weekday","sled","Washington Gulch","2","2","1",6.2,0.1,29,0,16,21.4,0,0,2,-1,0,0,2,1
"10212",2020-01-13,"Washington Gulch","w1920","Hybrid",NA,"Mon","weekday","sled","Washington Gulch","2","2","1",6.2,0.1,29,0,16,21.4,0,0,2,-1,0,0,2,1
"10213",2020-01-14,"Washington Gulch","w1920","Non.motorized",NA,"Tue","weekday","no_sled","Washington Gulch","3","2","1",6.6,0.4,34,5,23,19.4,0,0,0,2,5,5,5,7
"10214",2020-01-14,"Washington Gulch","w1920","Mechanized",NA,"Tue","weekday","no_sled","Washington Gulch","3","2","1",6.6,0.4,34,5,23,19.4,0,0,0,2,5,5,5,7
"10215",2020-01-14,"Washington Gulch","w1920","Motorized",NA,"Tue","weekday","sled","Washington Gulch","3","2","1",6.6,0.4,34,5,23,19.4,0,0,0,2,5,5,5,7
"10216",2020-01-14,"Washington Gulch","w1920","Hybrid",NA,"Tue","weekday","sled","Washington Gulch","3","2","1",6.6,0.4,34,5,23,19.4,0,0,0,2,5,5,5,7
"10217",2020-01-15,"Washington Gulch","w1920","Non.motorized",NA,"Wed","weekday","no_sled","Washington Gulch","3","2","1",6.7,0.1,32,-2,23,20.9,5,0,0,0,3,3,3,3
"10218",2020-01-15,"Washington Gulch","w1920","Mechanized",NA,"Wed","weekday","no_sled","Washington Gulch","3","2","1",6.7,0.1,32,-2,23,20.9,5,0,0,0,3,3,3,3
"10219",2020-01-15,"Washington Gulch","w1920","Motorized",NA,"Wed","weekday","sled","Washington Gulch","3","2","1",6.7,0.1,32,-2,23,20.9,5,0,0,0,3,3,3,3
"10220",2020-01-15,"Washington Gulch","w1920","Hybrid",NA,"Wed","weekday","sled","Washington Gulch","3","2","1",6.7,0.1,32,-2,23,20.9,5,0,0,0,3,3,3,3
"10221",2020-01-16,"Washington Gulch","w1920","Non.motorized",NA,"Thu","weekday","no_sled","Washington Gulch","2","2","1",6.7,0,31,-1,28,21.6,-2,5,0,0,-3,2,2,2
"10222",2020-01-16,"Washington Gulch","w1920","Mechanized",NA,"Thu","weekday","no_sled","Washington Gulch","2","2","1",6.7,0,31,-1,28,21.6,-2,5,0,0,-3,2,2,2
"10223",2020-01-16,"Washington Gulch","w1920","Motorized",NA,"Thu","weekday","sled","Washington Gulch","2","2","1",6.7,0,31,-1,28,21.6,-2,5,0,0,-3,2,2,2
"10224",2020-01-16,"Washington Gulch","w1920","Hybrid",NA,"Thu","weekday","sled","Washington Gulch","2","2","1",6.7,0,31,-1,28,21.6,-2,5,0,0,-3,2,2,2
"10225",2020-01-17,"Washington Gulch","w1920","Non.motorized",NA,"Fri","weekday","no_sled","Washington Gulch","2","2","1",6.8,0.1,29,-2,19,23.4,-1,-2,5,0,-3,-5,0,0
"10226",2020-01-17,"Washington Gulch","w1920","Mechanized",NA,"Fri","weekday","no_sled","Washington Gulch","2","2","1",6.8,0.1,29,-2,19,23.4,-1,-2,5,0,-3,-5,0,0
"10227",2020-01-17,"Washington Gulch","w1920","Motorized",NA,"Fri","weekday","sled","Washington Gulch","2","2","1",6.8,0.1,29,-2,19,23.4,-1,-2,5,0,-3,-5,0,0
"10228",2020-01-17,"Washington Gulch","w1920","Hybrid",NA,"Fri","weekday","sled","Washington Gulch","2","2","1",6.8,0.1,29,-2,19,23.4,-1,-2,5,0,-3,-5,0,0
"10229",2020-01-18,"Washington Gulch","w1920","Non.motorized",NA,"Sat","weekend","no_sled","Washington Gulch","2","2","2",7,0.2,34,5,16,20.6,-2,-1,-2,5,3,2,0,5
"10230",2020-01-18,"Washington Gulch","w1920","Mechanized",NA,"Sat","weekend","no_sled","Washington Gulch","2","2","2",7,0.2,34,5,16,20.6,-2,-1,-2,5,3,2,0,5
"10231",2020-01-18,"Washington Gulch","w1920","Motorized",NA,"Sat","weekend","sled","Washington Gulch","2","2","2",7,0.2,34,5,16,20.6,-2,-1,-2,5,3,2,0,5
"10232",2020-01-18,"Washington Gulch","w1920","Hybrid",NA,"Sat","weekend","sled","Washington Gulch","2","2","2",7,0.2,34,5,16,20.6,-2,-1,-2,5,3,2,0,5
"10233",2020-01-19,"Washington Gulch","w1920","Non.motorized",NA,"Sun","weekend","no_sled","Washington Gulch","2","2","1",7,0,33,-1,21,21.2,5,-2,-1,-2,4,2,1,-1
"10234",2020-01-19,"Washington Gulch","w1920","Mechanized",NA,"Sun","weekend","no_sled","Washington Gulch","2","2","1",7,0,33,-1,21,21.2,5,-2,-1,-2,4,2,1,-1
"10235",2020-01-19,"Washington Gulch","w1920","Motorized",NA,"Sun","weekend","sled","Washington Gulch","2","2","1",7,0,33,-1,21,21.2,5,-2,-1,-2,4,2,1,-1
"10236",2020-01-19,"Washington Gulch","w1920","Hybrid",NA,"Sun","weekend","sled","Washington Gulch","2","2","1",7,0,33,-1,21,21.2,5,-2,-1,-2,4,2,1,-1
"10237",2020-01-20,"Washington Gulch","w1920","Non.motorized",NA,"Mon","weekday","no_sled","Washington Gulch","2","2","1",7.1,0.1,32,-1,25,22.2,-1,5,-2,-1,-2,3,1,0
"10238",2020-01-20,"Washington Gulch","w1920","Mechanized",NA,"Mon","weekday","no_sled","Washington Gulch","2","2","1",7.1,0.1,32,-1,25,22.2,-1,5,-2,-1,-2,3,1,0
"10239",2020-01-20,"Washington Gulch","w1920","Motorized",NA,"Mon","weekday","sled","Washington Gulch","2","2","1",7.1,0.1,32,-1,25,22.2,-1,5,-2,-1,-2,3,1,0
"10240",2020-01-20,"Washington Gulch","w1920","Hybrid",NA,"Mon","weekday","sled","Washington Gulch","2","2","1",7.1,0.1,32,-1,25,22.2,-1,5,-2,-1,-2,3,1,0
"10241",2020-01-21,"Washington Gulch","w1920","Non.motorized",NA,"Tue","weekday","no_sled","Washington Gulch","2","2","1",7.1,0,31,-1,28,22.9,-1,-1,5,-2,-2,-3,2,0
"10242",2020-01-21,"Washington Gulch","w1920","Mechanized",NA,"Tue","weekday","no_sled","Washington Gulch","2","2","1",7.1,0,31,-1,28,22.9,-1,-1,5,-2,-2,-3,2,0
"10243",2020-01-21,"Washington Gulch","w1920","Motorized",NA,"Tue","weekday","sled","Washington Gulch","2","2","1",7.1,0,31,-1,28,22.9,-1,-1,5,-2,-2,-3,2,0
"10244",2020-01-21,"Washington Gulch","w1920","Hybrid",NA,"Tue","weekday","sled","Washington Gulch","2","2","1",7.1,0,31,-1,28,22.9,-1,-1,5,-2,-2,-3,2,0
"10245",2020-01-22,"Washington Gulch","w1920","Non.motorized",NA,"Wed","weekday","no_sled","Washington Gulch","2","2","2",7.3,0.2,32,1,25,22.8,-1,-1,-1,5,0,-1,-2,3
"10246",2020-01-22,"Washington Gulch","w1920","Mechanized",NA,"Wed","weekday","no_sled","Washington Gulch","2","2","2",7.3,0.2,32,1,25,22.8,-1,-1,-1,5,0,-1,-2,3
"10247",2020-01-22,"Washington Gulch","w1920","Motorized",NA,"Wed","weekday","sled","Washington Gulch","2","2","2",7.3,0.2,32,1,25,22.8,-1,-1,-1,5,0,-1,-2,3
"10248",2020-01-22,"Washington Gulch","w1920","Hybrid",NA,"Wed","weekday","sled","Washington Gulch","2","2","2",7.3,0.2,32,1,25,22.8,-1,-1,-1,5,0,-1,-2,3
"10249",2020-01-23,"Washington Gulch","w1920","Non.motorized",NA,"Thu","weekday","no_sled","Washington Gulch","3","2","2",7.3,0,34,2,23,21.5,1,-1,-1,-1,3,2,1,0
"10250",2020-01-23,"Washington Gulch","w1920","Mechanized",NA,"Thu","weekday","no_sled","Washington Gulch","3","2","2",7.3,0,34,2,23,21.5,1,-1,-1,-1,3,2,1,0
"10251",2020-01-23,"Washington Gulch","w1920","Motorized",NA,"Thu","weekday","sled","Washington Gulch","3","2","2",7.3,0,34,2,23,21.5,1,-1,-1,-1,3,2,1,0
"10252",2020-01-23,"Washington Gulch","w1920","Hybrid",NA,"Thu","weekday","sled","Washington Gulch","3","2","2",7.3,0,34,2,23,21.5,1,-1,-1,-1,3,2,1,0
"10253",2020-01-24,"Washington Gulch","w1920","Non.motorized",NA,"Fri","weekday","no_sled","Washington Gulch","2","2","1",7.3,0,33,-1,23,22.1,2,1,-1,-1,1,2,1,0
"10254",2020-01-24,"Washington Gulch","w1920","Mechanized",NA,"Fri","weekday","no_sled","Washington Gulch","2","2","1",7.3,0,33,-1,23,22.1,2,1,-1,-1,1,2,1,0
"10255",2020-01-24,"Washington Gulch","w1920","Motorized",NA,"Fri","weekday","sled","Washington Gulch","2","2","1",7.3,0,33,-1,23,22.1,2,1,-1,-1,1,2,1,0
"10256",2020-01-24,"Washington Gulch","w1920","Hybrid",NA,"Fri","weekday","sled","Washington Gulch","2","2","1",7.3,0,33,-1,23,22.1,2,1,-1,-1,1,2,1,0
"10257",2020-01-25,"Washington Gulch","w1920","Non.motorized",NA,"Sat","weekend","no_sled","Washington Gulch","2","2","1",7.4,0.1,32,-1,25,23.1,-1,2,1,-1,-2,0,1,0
"10258",2020-01-25,"Washington Gulch","w1920","Mechanized",NA,"Sat","weekend","no_sled","Washington Gulch","2","2","1",7.4,0.1,32,-1,25,23.1,-1,2,1,-1,-2,0,1,0
"10259",2020-01-25,"Washington Gulch","w1920","Motorized",NA,"Sat","weekend","sled","Washington Gulch","2","2","1",7.4,0.1,32,-1,25,23.1,-1,2,1,-1,-2,0,1,0
"10260",2020-01-25,"Washington Gulch","w1920","Hybrid",NA,"Sat","weekend","sled","Washington Gulch","2","2","1",7.4,0.1,32,-1,25,23.1,-1,2,1,-1,-2,0,1,0
"10261",2020-01-26,"Washington Gulch","w1920","Non.motorized",NA,"Sun","weekend","no_sled","Washington Gulch","2","1","1",7.4,0,32,0,28,23.1,-1,-1,2,1,-1,-2,0,1
"10262",2020-01-26,"Washington Gulch","w1920","Mechanized",NA,"Sun","weekend","no_sled","Washington Gulch","2","1","1",7.4,0,32,0,28,23.1,-1,-1,2,1,-1,-2,0,1
"10263",2020-01-26,"Washington Gulch","w1920","Motorized",NA,"Sun","weekend","sled","Washington Gulch","2","1","1",7.4,0,32,0,28,23.1,-1,-1,2,1,-1,-2,0,1
"10264",2020-01-26,"Washington Gulch","w1920","Hybrid",NA,"Sun","weekend","sled","Washington Gulch","2","1","1",7.4,0,32,0,28,23.1,-1,-1,2,1,-1,-2,0,1
"10265",2020-01-27,"Washington Gulch","w1920","Non.motorized",NA,"Mon","weekday","no_sled","Washington Gulch","2","1","1",7.4,0,32,0,24,23.1,0,-1,-1,2,0,-1,-2,0
"10266",2020-01-27,"Washington Gulch","w1920","Mechanized",NA,"Mon","weekday","no_sled","Washington Gulch","2","1","1",7.4,0,32,0,24,23.1,0,-1,-1,2,0,-1,-2,0
"10267",2020-01-27,"Washington Gulch","w1920","Motorized",NA,"Mon","weekday","sled","Washington Gulch","2","1","1",7.4,0,32,0,24,23.1,0,-1,-1,2,0,-1,-2,0
"10268",2020-01-27,"Washington Gulch","w1920","Hybrid",NA,"Mon","weekday","sled","Washington Gulch","2","1","1",7.4,0,32,0,24,23.1,0,-1,-1,2,0,-1,-2,0
"10269",2020-01-28,"Washington Gulch","w1920","Non.motorized",NA,"Tue","weekday","no_sled","Washington Gulch","3","2","2",7.4,0,32,0,19,23.1,0,0,-1,-1,0,0,-1,-2
"10270",2020-01-28,"Washington Gulch","w1920","Mechanized",NA,"Tue","weekday","no_sled","Washington Gulch","3","2","2",7.4,0,32,0,19,23.1,0,0,-1,-1,0,0,-1,-2
"10271",2020-01-28,"Washington Gulch","w1920","Motorized",NA,"Tue","weekday","sled","Washington Gulch","3","2","2",7.4,0,32,0,19,23.1,0,0,-1,-1,0,0,-1,-2
"10272",2020-01-28,"Washington Gulch","w1920","Hybrid",NA,"Tue","weekday","sled","Washington Gulch","3","2","2",7.4,0,32,0,19,23.1,0,0,-1,-1,0,0,-1,-2
"10273",2020-01-29,"Washington Gulch","w1920","Non.motorized",NA,"Wed","weekday","no_sled","Washington Gulch","2","2","1",7.4,0,31,-1,20,23.9,0,0,0,-1,-1,-1,-1,-2
"10274",2020-01-29,"Washington Gulch","w1920","Mechanized",NA,"Wed","weekday","no_sled","Washington Gulch","2","2","1",7.4,0,31,-1,20,23.9,0,0,0,-1,-1,-1,-1,-2
"10275",2020-01-29,"Washington Gulch","w1920","Motorized",NA,"Wed","weekday","sled","Washington Gulch","2","2","1",7.4,0,31,-1,20,23.9,0,0,0,-1,-1,-1,-1,-2
"10276",2020-01-29,"Washington Gulch","w1920","Hybrid",NA,"Wed","weekday","sled","Washington Gulch","2","2","1",7.4,0,31,-1,20,23.9,0,0,0,-1,-1,-1,-1,-2
"10277",2020-01-30,"Washington Gulch","w1920","Non.motorized",NA,"Thu","weekday","no_sled","Washington Gulch","2","2","1",7.4,0,31,0,17,23.9,-1,0,0,0,-1,-1,-1,-1
"10278",2020-01-30,"Washington Gulch","w1920","Mechanized",NA,"Thu","weekday","no_sled","Washington Gulch","2","2","1",7.4,0,31,0,17,23.9,-1,0,0,0,-1,-1,-1,-1
"10279",2020-01-30,"Washington Gulch","w1920","Motorized",NA,"Thu","weekday","sled","Washington Gulch","2","2","1",7.4,0,31,0,17,23.9,-1,0,0,0,-1,-1,-1,-1
"10280",2020-01-30,"Washington Gulch","w1920","Hybrid",NA,"Thu","weekday","sled","Washington Gulch","2","2","1",7.4,0,31,0,17,23.9,-1,0,0,0,-1,-1,-1,-1
"10281",2020-01-31,"Washington Gulch","w1920","Non.motorized",25,"Fri","weekday","no_sled","Washington Gulch","2","1","1",7.4,0,31,0,20,23.9,0,-1,0,0,0,-1,-1,-1
"10282",2020-01-31,"Washington Gulch","w1920","Mechanized",0,"Fri","weekday","no_sled","Washington Gulch","2","1","1",7.4,0,31,0,20,23.9,0,-1,0,0,0,-1,-1,-1
"10283",2020-01-31,"Washington Gulch","w1920","Motorized",0,"Fri","weekday","sled","Washington Gulch","2","1","1",7.4,0,31,0,20,23.9,0,-1,0,0,0,-1,-1,-1
"10284",2020-01-31,"Washington Gulch","w1920","Hybrid",0,"Fri","weekday","sled","Washington Gulch","2","1","1",7.4,0,31,0,20,23.9,0,-1,0,0,0,-1,-1,-1
"10285",2020-02-01,"Washington Gulch","w1920","Non.motorized",43,"Sat","weekend","no_sled","Washington Gulch","2","1","1",7.4,0,31,0,28,23.9,0,0,-1,0,0,0,-1,-1
"10286",2020-02-01,"Washington Gulch","w1920","Mechanized",0,"Sat","weekend","no_sled","Washington Gulch","2","1","1",7.4,0,31,0,28,23.9,0,0,-1,0,0,0,-1,-1
"10287",2020-02-01,"Washington Gulch","w1920","Motorized",17,"Sat","weekend","sled","Washington Gulch","2","1","1",7.4,0,31,0,28,23.9,0,0,-1,0,0,0,-1,-1
"10288",2020-02-01,"Washington Gulch","w1920","Hybrid",6,"Sat","weekend","sled","Washington Gulch","2","1","1",7.4,0,31,0,28,23.9,0,0,-1,0,0,0,-1,-1
"10289",2020-02-02,"Washington Gulch","w1920","Non.motorized",78,"Sun","weekend","no_sled","Washington Gulch","1","1","1",7.4,0,31,0,33,23.9,0,0,0,-1,0,0,0,-1
"10290",2020-02-02,"Washington Gulch","w1920","Mechanized",1,"Sun","weekend","no_sled","Washington Gulch","1","1","1",7.4,0,31,0,33,23.9,0,0,0,-1,0,0,0,-1
"10291",2020-02-02,"Washington Gulch","w1920","Motorized",1,"Sun","weekend","sled","Washington Gulch","1","1","1",7.4,0,31,0,33,23.9,0,0,0,-1,0,0,0,-1
"10292",2020-02-02,"Washington Gulch","w1920","Hybrid",3,"Sun","weekend","sled","Washington Gulch","1","1","1",7.4,0,31,0,33,23.9,0,0,0,-1,0,0,0,-1
"10293",2020-02-03,"Washington Gulch","w1920","Non.motorized",11,"Mon","weekday","no_sled","Washington Gulch","2","2","1",7.4,0,31,0,24,23.9,0,0,0,0,0,0,0,0
"10294",2020-02-03,"Washington Gulch","w1920","Mechanized",0,"Mon","weekday","no_sled","Washington Gulch","2","2","1",7.4,0,31,0,24,23.9,0,0,0,0,0,0,0,0
"10295",2020-02-03,"Washington Gulch","w1920","Motorized",1,"Mon","weekday","sled","Washington Gulch","2","2","1",7.4,0,31,0,24,23.9,0,0,0,0,0,0,0,0
"10296",2020-02-03,"Washington Gulch","w1920","Hybrid",0,"Mon","weekday","sled","Washington Gulch","2","2","1",7.4,0,31,0,24,23.9,0,0,0,0,0,0,0,0
"10297",2020-02-04,"Washington Gulch","w1920","Non.motorized",6,"Tue","weekday","no_sled","Washington Gulch","2","2","2",7.4,0,33,2,5,22.4,0,0,0,0,2,2,2,2
"10298",2020-02-04,"Washington Gulch","w1920","Mechanized",0,"Tue","weekday","no_sled","Washington Gulch","2","2","2",7.4,0,33,2,5,22.4,0,0,0,0,2,2,2,2
"10299",2020-02-04,"Washington Gulch","w1920","Motorized",2,"Tue","weekday","sled","Washington Gulch","2","2","2",7.4,0,33,2,5,22.4,0,0,0,0,2,2,2,2
"10300",2020-02-04,"Washington Gulch","w1920","Hybrid",0,"Tue","weekday","sled","Washington Gulch","2","2","2",7.4,0,33,2,5,22.4,0,0,0,0,2,2,2,2
"10301",2020-02-05,"Washington Gulch","w1920","Non.motorized",5,"Wed","weekday","no_sled","Washington Gulch","2","2","1",7.4,0,33,0,2,22.4,2,0,0,0,2,2,2,2
"10302",2020-02-05,"Washington Gulch","w1920","Mechanized",1,"Wed","weekday","no_sled","Washington Gulch","2","2","1",7.4,0,33,0,2,22.4,2,0,0,0,2,2,2,2
"10303",2020-02-05,"Washington Gulch","w1920","Motorized",2,"Wed","weekday","sled","Washington Gulch","2","2","1",7.4,0,33,0,2,22.4,2,0,0,0,2,2,2,2
"10304",2020-02-05,"Washington Gulch","w1920","Hybrid",3,"Wed","weekday","sled","Washington Gulch","2","2","1",7.4,0,33,0,2,22.4,2,0,0,0,2,2,2,2
"10305",2020-02-06,"Washington Gulch","w1920","Non.motorized",NA,"Thu","weekday","no_sled","Washington Gulch","2","2","1",7.5,0.1,32,-1,16,23.4,0,2,0,0,-1,1,1,1
"10306",2020-02-06,"Washington Gulch","w1920","Mechanized",NA,"Thu","weekday","no_sled","Washington Gulch","2","2","1",7.5,0.1,32,-1,16,23.4,0,2,0,0,-1,1,1,1
"10307",2020-02-06,"Washington Gulch","w1920","Motorized",NA,"Thu","weekday","sled","Washington Gulch","2","2","1",7.5,0.1,32,-1,16,23.4,0,2,0,0,-1,1,1,1
"10308",2020-02-06,"Washington Gulch","w1920","Hybrid",NA,"Thu","weekday","sled","Washington Gulch","2","2","1",7.5,0.1,32,-1,16,23.4,0,2,0,0,-1,1,1,1
"10309",2020-02-07,"Washington Gulch","w1920","Non.motorized",NA,"Fri","weekday","no_sled","Washington Gulch","3","3","3",7.9,0.4,37,5,26,21.4,-1,0,2,0,4,4,6,6
"10310",2020-02-07,"Washington Gulch","w1920","Mechanized",NA,"Fri","weekday","no_sled","Washington Gulch","3","3","3",7.9,0.4,37,5,26,21.4,-1,0,2,0,4,4,6,6
"10311",2020-02-07,"Washington Gulch","w1920","Motorized",NA,"Fri","weekday","sled","Washington Gulch","3","3","3",7.9,0.4,37,5,26,21.4,-1,0,2,0,4,4,6,6
"10312",2020-02-07,"Washington Gulch","w1920","Hybrid",NA,"Fri","weekday","sled","Washington Gulch","3","3","3",7.9,0.4,37,5,26,21.4,-1,0,2,0,4,4,6,6
"10313",2020-02-08,"Washington Gulch","w1920","Non.motorized",35,"Sat","weekend","no_sled","Washington Gulch","3","3","2",8.3,0.4,39,2,30,21.3,5,-1,0,2,7,6,6,8
"10314",2020-02-08,"Washington Gulch","w1920","Mechanized",0,"Sat","weekend","no_sled","Washington Gulch","3","3","2",8.3,0.4,39,2,30,21.3,5,-1,0,2,7,6,6,8
"10315",2020-02-08,"Washington Gulch","w1920","Motorized",6,"Sat","weekend","sled","Washington Gulch","3","3","2",8.3,0.4,39,2,30,21.3,5,-1,0,2,7,6,6,8
"10316",2020-02-08,"Washington Gulch","w1920","Hybrid",0,"Sat","weekend","sled","Washington Gulch","3","3","2",8.3,0.4,39,2,30,21.3,5,-1,0,2,7,6,6,8
"10317",2020-02-09,"Washington Gulch","w1920","Non.motorized",36,"Sun","weekend","no_sled","Washington Gulch","3","2","2",8.4,0.1,38,-1,26,22.1,2,5,-1,0,1,6,5,5
"10318",2020-02-09,"Washington Gulch","w1920","Mechanized",0,"Sun","weekend","no_sled","Washington Gulch","3","2","2",8.4,0.1,38,-1,26,22.1,2,5,-1,0,1,6,5,5
"10319",2020-02-09,"Washington Gulch","w1920","Motorized",4,"Sun","weekend","sled","Washington Gulch","3","2","2",8.4,0.1,38,-1,26,22.1,2,5,-1,0,1,6,5,5
"10320",2020-02-09,"Washington Gulch","w1920","Hybrid",0,"Sun","weekend","sled","Washington Gulch","3","2","2",8.4,0.1,38,-1,26,22.1,2,5,-1,0,1,6,5,5
"10321",2020-02-10,"Washington Gulch","w1920","Non.motorized",15,"Mon","weekday","no_sled","Washington Gulch","2","2","1",8.4,0,38,0,22,22.1,-1,2,5,-1,-1,1,6,5
"10322",2020-02-10,"Washington Gulch","w1920","Mechanized",0,"Mon","weekday","no_sled","Washington Gulch","2","2","1",8.4,0,38,0,22,22.1,-1,2,5,-1,-1,1,6,5
"10323",2020-02-10,"Washington Gulch","w1920","Motorized",0,"Mon","weekday","sled","Washington Gulch","2","2","1",8.4,0,38,0,22,22.1,-1,2,5,-1,-1,1,6,5
"10324",2020-02-10,"Washington Gulch","w1920","Hybrid",0,"Mon","weekday","sled","Washington Gulch","2","2","1",8.4,0,38,0,22,22.1,-1,2,5,-1,-1,1,6,5
"10325",2020-02-11,"Washington Gulch","w1920","Non.motorized",11,"Tue","weekday","no_sled","Washington Gulch","2","2","2",8.5,0.1,40,2,16,21.2,0,-1,2,5,2,1,3,8
"10326",2020-02-11,"Washington Gulch","w1920","Mechanized",0,"Tue","weekday","no_sled","Washington Gulch","2","2","2",8.5,0.1,40,2,16,21.2,0,-1,2,5,2,1,3,8
"10327",2020-02-11,"Washington Gulch","w1920","Motorized",4,"Tue","weekday","sled","Washington Gulch","2","2","2",8.5,0.1,40,2,16,21.2,0,-1,2,5,2,1,3,8
"10328",2020-02-11,"Washington Gulch","w1920","Hybrid",2,"Tue","weekday","sled","Washington Gulch","2","2","2",8.5,0.1,40,2,16,21.2,0,-1,2,5,2,1,3,8
"10329",2020-02-12,"Washington Gulch","w1920","Non.motorized",13,"Wed","weekday","no_sled","Washington Gulch","2","2","2",8.5,0,39,-1,15,21.8,2,0,-1,2,1,1,0,2
"10330",2020-02-12,"Washington Gulch","w1920","Mechanized",0,"Wed","weekday","no_sled","Washington Gulch","2","2","2",8.5,0,39,-1,15,21.8,2,0,-1,2,1,1,0,2
"10331",2020-02-12,"Washington Gulch","w1920","Motorized",4,"Wed","weekday","sled","Washington Gulch","2","2","2",8.5,0,39,-1,15,21.8,2,0,-1,2,1,1,0,2
"10332",2020-02-12,"Washington Gulch","w1920","Hybrid",1,"Wed","weekday","sled","Washington Gulch","2","2","2",8.5,0,39,-1,15,21.8,2,0,-1,2,1,1,0,2
"10333",2020-02-13,"Washington Gulch","w1920","Non.motorized",13,"Thu","weekday","no_sled","Washington Gulch","2","2","1",8.5,0,39,0,18,21.8,-1,2,0,-1,-1,1,1,0
"10334",2020-02-13,"Washington Gulch","w1920","Mechanized",0,"Thu","weekday","no_sled","Washington Gulch","2","2","1",8.5,0,39,0,18,21.8,-1,2,0,-1,-1,1,1,0
"10335",2020-02-13,"Washington Gulch","w1920","Motorized",0,"Thu","weekday","sled","Washington Gulch","2","2","1",8.5,0,39,0,18,21.8,-1,2,0,-1,-1,1,1,0
"10336",2020-02-13,"Washington Gulch","w1920","Hybrid",0,"Thu","weekday","sled","Washington Gulch","2","2","1",8.5,0,39,0,18,21.8,-1,2,0,-1,-1,1,1,0
"10337",2020-02-14,"Washington Gulch","w1920","Non.motorized",32,"Fri","weekday","no_sled","Washington Gulch","2","1","1",8.6,0.1,38,-1,24,22.6,0,-1,2,0,-1,-2,0,0
"10338",2020-02-14,"Washington Gulch","w1920","Mechanized",0,"Fri","weekday","no_sled","Washington Gulch","2","1","1",8.6,0.1,38,-1,24,22.6,0,-1,2,0,-1,-2,0,0
"10339",2020-02-14,"Washington Gulch","w1920","Motorized",1,"Fri","weekday","sled","Washington Gulch","2","1","1",8.6,0.1,38,-1,24,22.6,0,-1,2,0,-1,-2,0,0
"10340",2020-02-14,"Washington Gulch","w1920","Hybrid",10,"Fri","weekday","sled","Washington Gulch","2","1","1",8.6,0.1,38,-1,24,22.6,0,-1,2,0,-1,-2,0,0
"10341",2020-02-15,"Washington Gulch","w1920","Non.motorized",57,"Sat","weekend","no_sled","Washington Gulch","1","1","1",8.6,0,38,0,26,22.6,-1,0,-1,2,-1,-1,-2,0
"10342",2020-02-15,"Washington Gulch","w1920","Mechanized",0,"Sat","weekend","no_sled","Washington Gulch","1","1","1",8.6,0,38,0,26,22.6,-1,0,-1,2,-1,-1,-2,0
"10343",2020-02-15,"Washington Gulch","w1920","Motorized",2,"Sat","weekend","sled","Washington Gulch","1","1","1",8.6,0,38,0,26,22.6,-1,0,-1,2,-1,-1,-2,0
"10344",2020-02-15,"Washington Gulch","w1920","Hybrid",2,"Sat","weekend","sled","Washington Gulch","1","1","1",8.6,0,38,0,26,22.6,-1,0,-1,2,-1,-1,-2,0
"10345",2020-02-16,"Washington Gulch","w1920","Non.motorized",53,"Sun","weekend","no_sled","Washington Gulch","1","1","1",8.8,0.2,37,-1,26,23.8,0,-1,0,-1,-1,-2,-2,-3
"10346",2020-02-16,"Washington Gulch","w1920","Mechanized",0,"Sun","weekend","no_sled","Washington Gulch","1","1","1",8.8,0.2,37,-1,26,23.8,0,-1,0,-1,-1,-2,-2,-3
"10347",2020-02-16,"Washington Gulch","w1920","Motorized",0,"Sun","weekend","sled","Washington Gulch","1","1","1",8.8,0.2,37,-1,26,23.8,0,-1,0,-1,-1,-2,-2,-3
"10348",2020-02-16,"Washington Gulch","w1920","Hybrid",0,"Sun","weekend","sled","Washington Gulch","1","1","1",8.8,0.2,37,-1,26,23.8,0,-1,0,-1,-1,-2,-2,-3
"10349",2020-02-17,"Washington Gulch","w1920","Non.motorized",14,"Mon","weekday","no_sled","Washington Gulch","2","1","1",9.2,0.4,43,6,25,21.4,-1,0,-1,0,5,5,4,4
"10350",2020-02-17,"Washington Gulch","w1920","Mechanized",0,"Mon","weekday","no_sled","Washington Gulch","2","1","1",9.2,0.4,43,6,25,21.4,-1,0,-1,0,5,5,4,4
"10351",2020-02-17,"Washington Gulch","w1920","Motorized",0,"Mon","weekday","sled","Washington Gulch","2","1","1",9.2,0.4,43,6,25,21.4,-1,0,-1,0,5,5,4,4
"10352",2020-02-17,"Washington Gulch","w1920","Hybrid",2,"Mon","weekday","sled","Washington Gulch","2","1","1",9.2,0.4,43,6,25,21.4,-1,0,-1,0,5,5,4,4
"10353",2020-02-18,"Washington Gulch","w1920","Non.motorized",31,"Tue","weekday","no_sled","Washington Gulch","1","1","1",9.3,0.1,42,-1,18,22.1,6,-1,0,-1,5,4,4,3
"10354",2020-02-18,"Washington Gulch","w1920","Mechanized",0,"Tue","weekday","no_sled","Washington Gulch","1","1","1",9.3,0.1,42,-1,18,22.1,6,-1,0,-1,5,4,4,3
"10355",2020-02-18,"Washington Gulch","w1920","Motorized",1,"Tue","weekday","sled","Washington Gulch","1","1","1",9.3,0.1,42,-1,18,22.1,6,-1,0,-1,5,4,4,3
"10356",2020-02-18,"Washington Gulch","w1920","Hybrid",0,"Tue","weekday","sled","Washington Gulch","1","1","1",9.3,0.1,42,-1,18,22.1,6,-1,0,-1,5,4,4,3
"10357",2020-02-19,"Washington Gulch","w1920","Non.motorized",19,"Wed","weekday","no_sled","Washington Gulch","1","1","1",9.3,0,41,-1,22,22.7,-1,6,-1,0,-2,4,3,3
"10358",2020-02-19,"Washington Gulch","w1920","Mechanized",1,"Wed","weekday","no_sled","Washington Gulch","1","1","1",9.3,0,41,-1,22,22.7,-1,6,-1,0,-2,4,3,3
"10359",2020-02-19,"Washington Gulch","w1920","Motorized",0,"Wed","weekday","sled","Washington Gulch","1","1","1",9.3,0,41,-1,22,22.7,-1,6,-1,0,-2,4,3,3
"10360",2020-02-19,"Washington Gulch","w1920","Hybrid",5,"Wed","weekday","sled","Washington Gulch","1","1","1",9.3,0,41,-1,22,22.7,-1,6,-1,0,-2,4,3,3
"10361",2020-02-20,"Washington Gulch","w1920","Non.motorized",36,"Thu","weekday","no_sled","Washington Gulch","1","1","1",9.3,0,41,0,18,22.7,-1,-1,6,-1,-1,-2,4,3
"10362",2020-02-20,"Washington Gulch","w1920","Mechanized",0,"Thu","weekday","no_sled","Washington Gulch","1","1","1",9.3,0,41,0,18,22.7,-1,-1,6,-1,-1,-2,4,3
"10363",2020-02-20,"Washington Gulch","w1920","Motorized",0,"Thu","weekday","sled","Washington Gulch","1","1","1",9.3,0,41,0,18,22.7,-1,-1,6,-1,-1,-2,4,3
"10364",2020-02-20,"Washington Gulch","w1920","Hybrid",1,"Thu","weekday","sled","Washington Gulch","1","1","1",9.3,0,41,0,18,22.7,-1,-1,6,-1,-1,-2,4,3
"10365",2020-02-21,"Washington Gulch","w1920","Non.motorized",38,"Fri","weekday","no_sled","Washington Gulch","1","1","1",9.3,0,40,-1,26,23.2,0,-1,-1,6,-1,-2,-3,3
"10366",2020-02-21,"Washington Gulch","w1920","Mechanized",0,"Fri","weekday","no_sled","Washington Gulch","1","1","1",9.3,0,40,-1,26,23.2,0,-1,-1,6,-1,-2,-3,3
"10367",2020-02-21,"Washington Gulch","w1920","Motorized",6,"Fri","weekday","sled","Washington Gulch","1","1","1",9.3,0,40,-1,26,23.2,0,-1,-1,6,-1,-2,-3,3
"10368",2020-02-21,"Washington Gulch","w1920","Hybrid",5,"Fri","weekday","sled","Washington Gulch","1","1","1",9.3,0,40,-1,26,23.2,0,-1,-1,6,-1,-2,-3,3
"10369",2020-02-22,"Washington Gulch","w1920","Non.motorized",58,"Sat","weekend","no_sled","Washington Gulch","1","1","1",9.4,0.1,39,-1,32,24.1,-1,0,-1,-1,-2,-2,-3,-4
"10370",2020-02-22,"Washington Gulch","w1920","Mechanized",0,"Sat","weekend","no_sled","Washington Gulch","1","1","1",9.4,0.1,39,-1,32,24.1,-1,0,-1,-1,-2,-2,-3,-4
"10371",2020-02-22,"Washington Gulch","w1920","Motorized",3,"Sat","weekend","sled","Washington Gulch","1","1","1",9.4,0.1,39,-1,32,24.1,-1,0,-1,-1,-2,-2,-3,-4
"10372",2020-02-22,"Washington Gulch","w1920","Hybrid",6,"Sat","weekend","sled","Washington Gulch","1","1","1",9.4,0.1,39,-1,32,24.1,-1,0,-1,-1,-2,-2,-3,-4
"10373",2020-02-23,"Washington Gulch","w1920","Non.motorized",33,"Sun","weekend","no_sled","Washington Gulch","2","2","2",9.5,0.1,40,1,27,23.8,-1,-1,0,-1,0,-1,-1,-2
"10374",2020-02-23,"Washington Gulch","w1920","Mechanized",0,"Sun","weekend","no_sled","Washington Gulch","2","2","2",9.5,0.1,40,1,27,23.8,-1,-1,0,-1,0,-1,-1,-2
"10375",2020-02-23,"Washington Gulch","w1920","Motorized",3,"Sun","weekend","sled","Washington Gulch","2","2","2",9.5,0.1,40,1,27,23.8,-1,-1,0,-1,0,-1,-1,-2
"10376",2020-02-23,"Washington Gulch","w1920","Hybrid",1,"Sun","weekend","sled","Washington Gulch","2","2","2",9.5,0.1,40,1,27,23.8,-1,-1,0,-1,0,-1,-1,-2
"10377",2020-02-24,"Washington Gulch","w1920","Non.motorized",12,"Mon","weekday","no_sled","Washington Gulch","3","3","2",9.8,0.3,43,3,17,22.8,1,-1,-1,0,4,3,2,2
"10378",2020-02-24,"Washington Gulch","w1920","Mechanized",0,"Mon","weekday","no_sled","Washington Gulch","3","3","2",9.8,0.3,43,3,17,22.8,1,-1,-1,0,4,3,2,2
"10379",2020-02-24,"Washington Gulch","w1920","Motorized",2,"Mon","weekday","sled","Washington Gulch","3","3","2",9.8,0.3,43,3,17,22.8,1,-1,-1,0,4,3,2,2
"10380",2020-02-24,"Washington Gulch","w1920","Hybrid",0,"Mon","weekday","sled","Washington Gulch","3","3","2",9.8,0.3,43,3,17,22.8,1,-1,-1,0,4,3,2,2
"10381",2020-02-25,"Washington Gulch","w1920","Non.motorized",21,"Tue","weekday","no_sled","Washington Gulch","2","2","1",9.8,0,43,0,8,22.8,3,1,-1,-1,3,4,3,2
"10382",2020-02-25,"Washington Gulch","w1920","Mechanized",0,"Tue","weekday","no_sled","Washington Gulch","2","2","1",9.8,0,43,0,8,22.8,3,1,-1,-1,3,4,3,2
"10383",2020-02-25,"Washington Gulch","w1920","Motorized",2,"Tue","weekday","sled","Washington Gulch","2","2","1",9.8,0,43,0,8,22.8,3,1,-1,-1,3,4,3,2
"10384",2020-02-25,"Washington Gulch","w1920","Hybrid",0,"Tue","weekday","sled","Washington Gulch","2","2","1",9.8,0,43,0,8,22.8,3,1,-1,-1,3,4,3,2
"10385",2020-02-26,"Washington Gulch","w1920","Non.motorized",21,"Wed","weekday","no_sled","Washington Gulch","2","2","1",9.8,0,42,-1,15,23.3,0,3,1,-1,-1,2,3,2
"10386",2020-02-26,"Washington Gulch","w1920","Mechanized",0,"Wed","weekday","no_sled","Washington Gulch","2","2","1",9.8,0,42,-1,15,23.3,0,3,1,-1,-1,2,3,2
"10387",2020-02-26,"Washington Gulch","w1920","Motorized",2,"Wed","weekday","sled","Washington Gulch","2","2","1",9.8,0,42,-1,15,23.3,0,3,1,-1,-1,2,3,2
"10388",2020-02-26,"Washington Gulch","w1920","Hybrid",6,"Wed","weekday","sled","Washington Gulch","2","2","1",9.8,0,42,-1,15,23.3,0,3,1,-1,-1,2,3,2
"10389",2020-02-27,"Washington Gulch","w1920","Non.motorized",24,"Thu","weekday","no_sled","Washington Gulch","2","2","1",9.9,0.1,41,-1,25,24.1,-1,0,3,1,-2,-2,1,2
"10390",2020-02-27,"Washington Gulch","w1920","Mechanized",1,"Thu","weekday","no_sled","Washington Gulch","2","2","1",9.9,0.1,41,-1,25,24.1,-1,0,3,1,-2,-2,1,2
"10391",2020-02-27,"Washington Gulch","w1920","Motorized",3,"Thu","weekday","sled","Washington Gulch","2","2","1",9.9,0.1,41,-1,25,24.1,-1,0,3,1,-2,-2,1,2
"10392",2020-02-27,"Washington Gulch","w1920","Hybrid",0,"Thu","weekday","sled","Washington Gulch","2","2","1",9.9,0.1,41,-1,25,24.1,-1,0,3,1,-2,-2,1,2
"10393",2020-02-28,"Washington Gulch","w1920","Non.motorized",29,"Fri","weekday","no_sled","Washington Gulch","2","1","1",9.9,0,41,0,28,24.1,-1,-1,0,3,-1,-2,-2,1
"10394",2020-02-28,"Washington Gulch","w1920","Mechanized",2,"Fri","weekday","no_sled","Washington Gulch","2","1","1",9.9,0,41,0,28,24.1,-1,-1,0,3,-1,-2,-2,1
"10395",2020-02-28,"Washington Gulch","w1920","Motorized",6,"Fri","weekday","sled","Washington Gulch","2","1","1",9.9,0,41,0,28,24.1,-1,-1,0,3,-1,-2,-2,1
"10396",2020-02-28,"Washington Gulch","w1920","Hybrid",4,"Fri","weekday","sled","Washington Gulch","2","1","1",9.9,0,41,0,28,24.1,-1,-1,0,3,-1,-2,-2,1
"10397",2020-02-29,"Washington Gulch","w1920","Non.motorized",47,"Sat","weekend","no_sled","Washington Gulch","1","1","1",9.9,0,40,-1,29,24.8,0,-1,-1,0,-1,-2,-3,-3
"10398",2020-02-29,"Washington Gulch","w1920","Mechanized",1,"Sat","weekend","no_sled","Washington Gulch","1","1","1",9.9,0,40,-1,29,24.8,0,-1,-1,0,-1,-2,-3,-3
"10399",2020-02-29,"Washington Gulch","w1920","Motorized",9,"Sat","weekend","sled","Washington Gulch","1","1","1",9.9,0,40,-1,29,24.8,0,-1,-1,0,-1,-2,-3,-3
"10400",2020-02-29,"Washington Gulch","w1920","Hybrid",6,"Sat","weekend","sled","Washington Gulch","1","1","1",9.9,0,40,-1,29,24.8,0,-1,-1,0,-1,-2,-3,-3
"10401",2020-03-01,"Washington Gulch","w1920","Non.motorized",35,"Sun","weekend","no_sled","Washington Gulch","1","1","1",10,0.1,40,0,28,25,-1,0,-1,-1,-1,-1,-2,-3
"10402",2020-03-01,"Washington Gulch","w1920","Mechanized",1,"Sun","weekend","no_sled","Washington Gulch","1","1","1",10,0.1,40,0,28,25,-1,0,-1,-1,-1,-1,-2,-3
"10403",2020-03-01,"Washington Gulch","w1920","Motorized",3,"Sun","weekend","sled","Washington Gulch","1","1","1",10,0.1,40,0,28,25,-1,0,-1,-1,-1,-1,-2,-3
"10404",2020-03-01,"Washington Gulch","w1920","Hybrid",0,"Sun","weekend","sled","Washington Gulch","1","1","1",10,0.1,40,0,28,25,-1,0,-1,-1,-1,-1,-2,-3
"10405",2020-03-02,"Washington Gulch","w1920","Non.motorized",5,"Mon","weekday","no_sled","Washington Gulch","2","2","1",10.4,0.4,45,5,25,23.1,0,-1,0,-1,5,4,4,3
"10406",2020-03-02,"Washington Gulch","w1920","Mechanized",0,"Mon","weekday","no_sled","Washington Gulch","2","2","1",10.4,0.4,45,5,25,23.1,0,-1,0,-1,5,4,4,3
"10407",2020-03-02,"Washington Gulch","w1920","Motorized",3,"Mon","weekday","sled","Washington Gulch","2","2","1",10.4,0.4,45,5,25,23.1,0,-1,0,-1,5,4,4,3
"10408",2020-03-02,"Washington Gulch","w1920","Hybrid",1,"Mon","weekday","sled","Washington Gulch","2","2","1",10.4,0.4,45,5,25,23.1,0,-1,0,-1,5,4,4,3
"10409",2020-03-03,"Washington Gulch","w1920","Non.motorized",13,"Tue","weekday","no_sled","Washington Gulch","2","1","1",10.9,0.5,50,5,25,21.8,5,0,-1,0,10,10,9,9
"10410",2020-03-03,"Washington Gulch","w1920","Mechanized",0,"Tue","weekday","no_sled","Washington Gulch","2","1","1",10.9,0.5,50,5,25,21.8,5,0,-1,0,10,10,9,9
"10411",2020-03-03,"Washington Gulch","w1920","Motorized",5,"Tue","weekday","sled","Washington Gulch","2","1","1",10.9,0.5,50,5,25,21.8,5,0,-1,0,10,10,9,9
"10412",2020-03-03,"Washington Gulch","w1920","Hybrid",0,"Tue","weekday","sled","Washington Gulch","2","1","1",10.9,0.5,50,5,25,21.8,5,0,-1,0,10,10,9,9
"10413",2020-03-04,"Washington Gulch","w1920","Non.motorized",16,"Wed","weekday","no_sled","Washington Gulch","2","1","1",10.9,0,48,-2,29,22.7,5,5,0,-1,3,8,8,7
"10414",2020-03-04,"Washington Gulch","w1920","Mechanized",0,"Wed","weekday","no_sled","Washington Gulch","2","1","1",10.9,0,48,-2,29,22.7,5,5,0,-1,3,8,8,7
"10415",2020-03-04,"Washington Gulch","w1920","Motorized",0,"Wed","weekday","sled","Washington Gulch","2","1","1",10.9,0,48,-2,29,22.7,5,5,0,-1,3,8,8,7
"10416",2020-03-04,"Washington Gulch","w1920","Hybrid",3,"Wed","weekday","sled","Washington Gulch","2","1","1",10.9,0,48,-2,29,22.7,5,5,0,-1,3,8,8,7
"10417",2020-03-05,"Washington Gulch","w1920","Non.motorized",15,"Thu","weekday","no_sled","Washington Gulch","2","1","1",10.9,0,46,-2,32,23.7,-2,5,5,0,-4,1,6,6
"10418",2020-03-05,"Washington Gulch","w1920","Mechanized",1,"Thu","weekday","no_sled","Washington Gulch","2","1","1",10.9,0,46,-2,32,23.7,-2,5,5,0,-4,1,6,6
"10419",2020-03-05,"Washington Gulch","w1920","Motorized",3,"Thu","weekday","sled","Washington Gulch","2","1","1",10.9,0,46,-2,32,23.7,-2,5,5,0,-4,1,6,6
"10420",2020-03-05,"Washington Gulch","w1920","Hybrid",1,"Thu","weekday","sled","Washington Gulch","2","1","1",10.9,0,46,-2,32,23.7,-2,5,5,0,-4,1,6,6
"10421",2020-03-06,"Washington Gulch","w1920","Non.motorized",26,"Fri","weekday","no_sled","Washington Gulch","1","1","1",10.9,0,45,-1,34,24.2,-2,-2,5,5,-3,-5,0,5
"10422",2020-03-06,"Washington Gulch","w1920","Mechanized",0,"Fri","weekday","no_sled","Washington Gulch","1","1","1",10.9,0,45,-1,34,24.2,-2,-2,5,5,-3,-5,0,5
"10423",2020-03-06,"Washington Gulch","w1920","Motorized",0,"Fri","weekday","sled","Washington Gulch","1","1","1",10.9,0,45,-1,34,24.2,-2,-2,5,5,-3,-5,0,5
"10424",2020-03-06,"Washington Gulch","w1920","Hybrid",0,"Fri","weekday","sled","Washington Gulch","1","1","1",10.9,0,45,-1,34,24.2,-2,-2,5,5,-3,-5,0,5
"10425",2020-03-07,"Washington Gulch","w1920","Non.motorized",36,"Sat","weekend","no_sled","Washington Gulch","1","1","2",10.9,0,44,-1,35,24.8,-1,-2,-2,5,-2,-4,-6,-1
"10426",2020-03-07,"Washington Gulch","w1920","Mechanized",0,"Sat","weekend","no_sled","Washington Gulch","1","1","2",10.9,0,44,-1,35,24.8,-1,-2,-2,5,-2,-4,-6,-1
"10427",2020-03-07,"Washington Gulch","w1920","Motorized",3,"Sat","weekend","sled","Washington Gulch","1","1","2",10.9,0,44,-1,35,24.8,-1,-2,-2,5,-2,-4,-6,-1
"10428",2020-03-07,"Washington Gulch","w1920","Hybrid",1,"Sat","weekend","sled","Washington Gulch","1","1","2",10.9,0,44,-1,35,24.8,-1,-2,-2,5,-2,-4,-6,-1
"10429",2020-03-08,"Washington Gulch","w1920","Non.motorized",35,"Sun","weekend","no_sled","Washington Gulch","1","1","1",11,0.1,43,-1,33,25.6,-1,-1,-2,-2,-2,-3,-5,-7
"10430",2020-03-08,"Washington Gulch","w1920","Mechanized",0,"Sun","weekend","no_sled","Washington Gulch","1","1","1",11,0.1,43,-1,33,25.6,-1,-1,-2,-2,-2,-3,-5,-7
"10431",2020-03-08,"Washington Gulch","w1920","Motorized",4,"Sun","weekend","sled","Washington Gulch","1","1","1",11,0.1,43,-1,33,25.6,-1,-1,-2,-2,-2,-3,-5,-7
"10432",2020-03-08,"Washington Gulch","w1920","Hybrid",1,"Sun","weekend","sled","Washington Gulch","1","1","1",11,0.1,43,-1,33,25.6,-1,-1,-2,-2,-2,-3,-5,-7
"10433",2020-03-09,"Washington Gulch","w1920","Non.motorized",24,"Mon","weekday","no_sled","Washington Gulch","1","1","1",11.1,0.1,42,-1,31,26.4,-1,-1,-1,-2,-2,-3,-4,-6
"10434",2020-03-09,"Washington Gulch","w1920","Mechanized",1,"Mon","weekday","no_sled","Washington Gulch","1","1","1",11.1,0.1,42,-1,31,26.4,-1,-1,-1,-2,-2,-3,-4,-6
"10435",2020-03-09,"Washington Gulch","w1920","Motorized",14,"Mon","weekday","sled","Washington Gulch","1","1","1",11.1,0.1,42,-1,31,26.4,-1,-1,-1,-2,-2,-3,-4,-6
"10436",2020-03-09,"Washington Gulch","w1920","Hybrid",0,"Mon","weekday","sled","Washington Gulch","1","1","1",11.1,0.1,42,-1,31,26.4,-1,-1,-1,-2,-2,-3,-4,-6
"10437",2020-03-10,"Washington Gulch","w1920","Non.motorized",14,"Tue","weekday","no_sled","Washington Gulch","1","1","2",11.2,0.1,44,2,31,25.5,-1,-1,-1,-1,1,0,-1,-2
"10438",2020-03-10,"Washington Gulch","w1920","Mechanized",0,"Tue","weekday","no_sled","Washington Gulch","1","1","2",11.2,0.1,44,2,31,25.5,-1,-1,-1,-1,1,0,-1,-2
"10439",2020-03-10,"Washington Gulch","w1920","Motorized",2,"Tue","weekday","sled","Washington Gulch","1","1","2",11.2,0.1,44,2,31,25.5,-1,-1,-1,-1,1,0,-1,-2
"10440",2020-03-10,"Washington Gulch","w1920","Hybrid",2,"Tue","weekday","sled","Washington Gulch","1","1","2",11.2,0.1,44,2,31,25.5,-1,-1,-1,-1,1,0,-1,-2
"10441",2020-03-11,"Washington Gulch","w1920","Non.motorized",8,"Wed","weekday","no_sled","Washington Gulch","2","2","1",11.2,0,44,0,32,25.5,2,-1,-1,-1,2,1,0,-1
"10442",2020-03-11,"Washington Gulch","w1920","Mechanized",0,"Wed","weekday","no_sled","Washington Gulch","2","2","1",11.2,0,44,0,32,25.5,2,-1,-1,-1,2,1,0,-1
"10443",2020-03-11,"Washington Gulch","w1920","Motorized",0,"Wed","weekday","sled","Washington Gulch","2","2","1",11.2,0,44,0,32,25.5,2,-1,-1,-1,2,1,0,-1
"10444",2020-03-11,"Washington Gulch","w1920","Hybrid",3,"Wed","weekday","sled","Washington Gulch","2","2","1",11.2,0,44,0,32,25.5,2,-1,-1,-1,2,1,0,-1
"10445",2020-03-12,"Washington Gulch","w1920","Non.motorized",9,"Thu","weekday","no_sled","Washington Gulch","2","2","2",11.4,0.2,42,-2,35,27.1,0,2,-1,-1,-2,0,-1,-2
"10446",2020-03-12,"Washington Gulch","w1920","Mechanized",0,"Thu","weekday","no_sled","Washington Gulch","2","2","2",11.4,0.2,42,-2,35,27.1,0,2,-1,-1,-2,0,-1,-2
"10447",2020-03-12,"Washington Gulch","w1920","Motorized",6,"Thu","weekday","sled","Washington Gulch","2","2","2",11.4,0.2,42,-2,35,27.1,0,2,-1,-1,-2,0,-1,-2
"10448",2020-03-12,"Washington Gulch","w1920","Hybrid",3,"Thu","weekday","sled","Washington Gulch","2","2","2",11.4,0.2,42,-2,35,27.1,0,2,-1,-1,-2,0,-1,-2
"10449",2020-03-13,"Washington Gulch","w1920","Non.motorized",10,"Fri","weekday","no_sled","Washington Gulch","3","3","2",11.5,0.1,44,2,31,26.1,-2,0,2,-1,0,0,2,1
"10450",2020-03-13,"Washington Gulch","w1920","Mechanized",0,"Fri","weekday","no_sled","Washington Gulch","3","3","2",11.5,0.1,44,2,31,26.1,-2,0,2,-1,0,0,2,1
"10451",2020-03-13,"Washington Gulch","w1920","Motorized",3,"Fri","weekday","sled","Washington Gulch","3","3","2",11.5,0.1,44,2,31,26.1,-2,0,2,-1,0,0,2,1
"10452",2020-03-13,"Washington Gulch","w1920","Hybrid",1,"Fri","weekday","sled","Washington Gulch","3","3","2",11.5,0.1,44,2,31,26.1,-2,0,2,-1,0,0,2,1
"10453",2020-03-14,"Washington Gulch","w1920","Non.motorized",41,"Sat","weekend","no_sled","Washington Gulch","3","3","3",11.7,0.2,44,0,31,26.6,2,-2,0,2,2,0,0,2
"10454",2020-03-14,"Washington Gulch","w1920","Mechanized",0,"Sat","weekend","no_sled","Washington Gulch","3","3","3",11.7,0.2,44,0,31,26.6,2,-2,0,2,2,0,0,2
"10455",2020-03-14,"Washington Gulch","w1920","Motorized",7,"Sat","weekend","sled","Washington Gulch","3","3","3",11.7,0.2,44,0,31,26.6,2,-2,0,2,2,0,0,2
"10456",2020-03-14,"Washington Gulch","w1920","Hybrid",7,"Sat","weekend","sled","Washington Gulch","3","3","3",11.7,0.2,44,0,31,26.6,2,-2,0,2,2,0,0,2
"10457",2020-03-15,"Washington Gulch","w1920","Non.motorized",85,"Sun","weekend","no_sled","Washington Gulch","2","2","2",11.7,0,45,1,33,26,0,2,-2,0,1,3,1,1
"10458",2020-03-15,"Washington Gulch","w1920","Mechanized",0,"Sun","weekend","no_sled","Washington Gulch","2","2","2",11.7,0,45,1,33,26,0,2,-2,0,1,3,1,1
"10459",2020-03-15,"Washington Gulch","w1920","Motorized",8,"Sun","weekend","sled","Washington Gulch","2","2","2",11.7,0,45,1,33,26,0,2,-2,0,1,3,1,1
"10460",2020-03-15,"Washington Gulch","w1920","Hybrid",10,"Sun","weekend","sled","Washington Gulch","2","2","2",11.7,0,45,1,33,26,0,2,-2,0,1,3,1,1
"10461",2020-03-16,"Washington Gulch","w1920","Non.motorized",56,"Mon","weekday","no_sled","Washington Gulch","2","2","2",11.7,0,45,0,35,26,1,0,2,-2,1,1,3,1
"10462",2020-03-16,"Washington Gulch","w1920","Mechanized",0,"Mon","weekday","no_sled","Washington Gulch","2","2","2",11.7,0,45,0,35,26,1,0,2,-2,1,1,3,1
"10463",2020-03-16,"Washington Gulch","w1920","Motorized",5,"Mon","weekday","sled","Washington Gulch","2","2","2",11.7,0,45,0,35,26,1,0,2,-2,1,1,3,1
"10464",2020-03-16,"Washington Gulch","w1920","Hybrid",0,"Mon","weekday","sled","Washington Gulch","2","2","2",11.7,0,45,0,35,26,1,0,2,-2,1,1,3,1
"10465",2020-03-17,"Washington Gulch","w1920","Non.motorized",23,"Tue","weekday","no_sled","Washington Gulch","2","2","2",11.7,0,44,-1,36,26.6,0,1,0,2,-1,0,0,2
"10466",2020-03-17,"Washington Gulch","w1920","Mechanized",0,"Tue","weekday","no_sled","Washington Gulch","2","2","2",11.7,0,44,-1,36,26.6,0,1,0,2,-1,0,0,2
"10467",2020-03-17,"Washington Gulch","w1920","Motorized",3,"Tue","weekday","sled","Washington Gulch","2","2","2",11.7,0,44,-1,36,26.6,0,1,0,2,-1,0,0,2
"10468",2020-03-17,"Washington Gulch","w1920","Hybrid",1,"Tue","weekday","sled","Washington Gulch","2","2","2",11.7,0,44,-1,36,26.6,0,1,0,2,-1,0,0,2
"10469",2020-03-18,"Washington Gulch","w1920","Non.motorized",14,"Wed","weekday","no_sled","Washington Gulch","2","2","2",11.7,0,43,-1,33,27.2,-1,0,1,0,-2,-2,-1,-1
"10470",2020-03-18,"Washington Gulch","w1920","Mechanized",1,"Wed","weekday","no_sled","Washington Gulch","2","2","2",11.7,0,43,-1,33,27.2,-1,0,1,0,-2,-2,-1,-1
"10471",2020-03-18,"Washington Gulch","w1920","Motorized",8,"Wed","weekday","sled","Washington Gulch","2","2","2",11.7,0,43,-1,33,27.2,-1,0,1,0,-2,-2,-1,-1
"10472",2020-03-18,"Washington Gulch","w1920","Hybrid",8,"Wed","weekday","sled","Washington Gulch","2","2","2",11.7,0,43,-1,33,27.2,-1,0,1,0,-2,-2,-1,-1
"10473",2020-03-19,"Washington Gulch","w1920","Non.motorized",NA,"Thu","weekday","no_sled","Washington Gulch","3","3","3",11.8,0.1,43,0,27,27.4,-1,-1,0,1,-1,-2,-2,-1
"10474",2020-03-19,"Washington Gulch","w1920","Mechanized",NA,"Thu","weekday","no_sled","Washington Gulch","3","3","3",11.8,0.1,43,0,27,27.4,-1,-1,0,1,-1,-2,-2,-1
"10475",2020-03-19,"Washington Gulch","w1920","Motorized",NA,"Thu","weekday","sled","Washington Gulch","3","3","3",11.8,0.1,43,0,27,27.4,-1,-1,0,1,-1,-2,-2,-1
"10476",2020-03-19,"Washington Gulch","w1920","Hybrid",NA,"Thu","weekday","sled","Washington Gulch","3","3","3",11.8,0.1,43,0,27,27.4,-1,-1,0,1,-1,-2,-2,-1
"10477",2020-03-20,"Washington Gulch","w1920","Non.motorized",24,"Fri","weekday","no_sled","Washington Gulch","3","3","2",12.7,0.9,52,9,26,24.4,0,-1,-1,0,9,8,7,7
"10478",2020-03-20,"Washington Gulch","w1920","Mechanized",0,"Fri","weekday","no_sled","Washington Gulch","3","3","2",12.7,0.9,52,9,26,24.4,0,-1,-1,0,9,8,7,7
"10479",2020-03-20,"Washington Gulch","w1920","Motorized",0,"Fri","weekday","sled","Washington Gulch","3","3","2",12.7,0.9,52,9,26,24.4,0,-1,-1,0,9,8,7,7
"10480",2020-03-20,"Washington Gulch","w1920","Hybrid",0,"Fri","weekday","sled","Washington Gulch","3","3","2",12.7,0.9,52,9,26,24.4,0,-1,-1,0,9,8,7,7
"10481",2020-03-21,"Washington Gulch","w1920","Non.motorized",54,"Sat","weekend","no_sled","Washington Gulch","3","3","2",12.8,0.1,54,2,26,23.7,9,0,-1,-1,11,11,10,9
"10482",2020-03-21,"Washington Gulch","w1920","Mechanized",0,"Sat","weekend","no_sled","Washington Gulch","3","3","2",12.8,0.1,54,2,26,23.7,9,0,-1,-1,11,11,10,9
"10483",2020-03-21,"Washington Gulch","w1920","Motorized",5,"Sat","weekend","sled","Washington Gulch","3","3","2",12.8,0.1,54,2,26,23.7,9,0,-1,-1,11,11,10,9
"10484",2020-03-21,"Washington Gulch","w1920","Hybrid",5,"Sat","weekend","sled","Washington Gulch","3","3","2",12.8,0.1,54,2,26,23.7,9,0,-1,-1,11,11,10,9
"10485",2020-03-22,"Washington Gulch","w1920","Non.motorized",48,"Sun","weekend","no_sled","Washington Gulch","2","2","2",13,0.2,53,-1,28,24.5,2,9,0,-1,1,10,10,9
"10486",2020-03-22,"Washington Gulch","w1920","Mechanized",1,"Sun","weekend","no_sled","Washington Gulch","2","2","2",13,0.2,53,-1,28,24.5,2,9,0,-1,1,10,10,9
"10487",2020-03-22,"Washington Gulch","w1920","Motorized",12,"Sun","weekend","sled","Washington Gulch","2","2","2",13,0.2,53,-1,28,24.5,2,9,0,-1,1,10,10,9
"10488",2020-03-22,"Washington Gulch","w1920","Hybrid",3,"Sun","weekend","sled","Washington Gulch","2","2","2",13,0.2,53,-1,28,24.5,2,9,0,-1,1,10,10,9
"10489",2020-03-23,"Washington Gulch","w1920","Non.motorized",13,"Mon","weekday","no_sled","Washington Gulch","2","2","2",13,0,53,0,28,24.5,-1,2,9,0,-1,1,10,10
"10490",2020-03-23,"Washington Gulch","w1920","Mechanized",0,"Mon","weekday","no_sled","Washington Gulch","2","2","2",13,0,53,0,28,24.5,-1,2,9,0,-1,1,10,10
"10491",2020-03-23,"Washington Gulch","w1920","Motorized",3,"Mon","weekday","sled","Washington Gulch","2","2","2",13,0,53,0,28,24.5,-1,2,9,0,-1,1,10,10
"10492",2020-03-23,"Washington Gulch","w1920","Hybrid",2,"Mon","weekday","sled","Washington Gulch","2","2","2",13,0,53,0,28,24.5,-1,2,9,0,-1,1,10,10
"10493",2020-03-24,"Washington Gulch","w1920","Non.motorized",50,"Tue","weekday","no_sled","Washington Gulch","2","2","2",13.2,0.2,53,0,32,24.9,0,-1,2,9,0,-1,1,10
"10494",2020-03-24,"Washington Gulch","w1920","Mechanized",1,"Tue","weekday","no_sled","Washington Gulch","2","2","2",13.2,0.2,53,0,32,24.9,0,-1,2,9,0,-1,1,10
"10495",2020-03-24,"Washington Gulch","w1920","Motorized",1,"Tue","weekday","sled","Washington Gulch","2","2","2",13.2,0.2,53,0,32,24.9,0,-1,2,9,0,-1,1,10
"10496",2020-03-24,"Washington Gulch","w1920","Hybrid",4,"Tue","weekday","sled","Washington Gulch","2","2","2",13.2,0.2,53,0,32,24.9,0,-1,2,9,0,-1,1,10
"10497",2020-03-25,"Washington Gulch","w1920","Non.motorized",19,"Wed","weekday","no_sled","Washington Gulch","2","2","2",13.3,0.1,51,-2,34,26.1,0,0,-1,2,-2,-2,-3,-1
"10498",2020-03-25,"Washington Gulch","w1920","Mechanized",1,"Wed","weekday","no_sled","Washington Gulch","2","2","2",13.3,0.1,51,-2,34,26.1,0,0,-1,2,-2,-2,-3,-1
"10499",2020-03-25,"Washington Gulch","w1920","Motorized",4,"Wed","weekday","sled","Washington Gulch","2","2","2",13.3,0.1,51,-2,34,26.1,0,0,-1,2,-2,-2,-3,-1
"10500",2020-03-25,"Washington Gulch","w1920","Hybrid",1,"Wed","weekday","sled","Washington Gulch","2","2","2",13.3,0.1,51,-2,34,26.1,0,0,-1,2,-2,-2,-3,-1
"10501",2020-03-26,"Washington Gulch","w1920","Non.motorized",11,"Thu","weekday","no_sled","Washington Gulch","2","2","2",13.3,0,50,-1,36,26.6,-2,0,0,-1,-3,-3,-3,-4
"10502",2020-03-26,"Washington Gulch","w1920","Non.motorized",11,"Thu","weekday","no_sled","Washington Gulch","3","3","2",13.3,0,50,-1,36,26.6,-2,0,0,-1,-3,-3,-3,-4
"10503",2020-03-26,"Washington Gulch","w1920","Mechanized",0,"Thu","weekday","no_sled","Washington Gulch","2","2","2",13.3,0,50,-1,36,26.6,-2,0,0,-1,-3,-3,-3,-4
"10504",2020-03-26,"Washington Gulch","w1920","Mechanized",0,"Thu","weekday","no_sled","Washington Gulch","3","3","2",13.3,0,50,-1,36,26.6,-2,0,0,-1,-3,-3,-3,-4
"10505",2020-03-26,"Washington Gulch","w1920","Motorized",4,"Thu","weekday","sled","Washington Gulch","2","2","2",13.3,0,50,-1,36,26.6,-2,0,0,-1,-3,-3,-3,-4
"10506",2020-03-26,"Washington Gulch","w1920","Motorized",4,"Thu","weekday","sled","Washington Gulch","3","3","2",13.3,0,50,-1,36,26.6,-2,0,0,-1,-3,-3,-3,-4
"10507",2020-03-26,"Washington Gulch","w1920","Hybrid",2,"Thu","weekday","sled","Washington Gulch","2","2","2",13.3,0,50,-1,36,26.6,-2,0,0,-1,-3,-3,-3,-4
"10508",2020-03-26,"Washington Gulch","w1920","Hybrid",2,"Thu","weekday","sled","Washington Gulch","3","3","2",13.3,0,50,-1,36,26.6,-2,0,0,-1,-3,-3,-3,-4
"10509",2020-03-27,"Washington Gulch","w1920","Non.motorized",14,"Fri","weekday","no_sled","Washington Gulch","3","3","2",13.3,0,50,0,23,26.6,-1,-2,0,0,-1,-3,-3,-3
"10510",2020-03-27,"Washington Gulch","w1920","Mechanized",0,"Fri","weekday","no_sled","Washington Gulch","3","3","2",13.3,0,50,0,23,26.6,-1,-2,0,0,-1,-3,-3,-3
"10511",2020-03-27,"Washington Gulch","w1920","Motorized",0,"Fri","weekday","sled","Washington Gulch","3","3","2",13.3,0,50,0,23,26.6,-1,-2,0,0,-1,-3,-3,-3
"10512",2020-03-27,"Washington Gulch","w1920","Hybrid",0,"Fri","weekday","sled","Washington Gulch","3","3","2",13.3,0,50,0,23,26.6,-1,-2,0,0,-1,-3,-3,-3
"10513",2020-03-28,"Washington Gulch","w1920","Non.motorized",36,"Sat","weekend","no_sled","Washington Gulch","3","3","3",13.3,0,50,0,18,26.6,0,-1,-2,0,0,-1,-3,-3
"10514",2020-03-28,"Washington Gulch","w1920","Mechanized",1,"Sat","weekend","no_sled","Washington Gulch","3","3","3",13.3,0,50,0,18,26.6,0,-1,-2,0,0,-1,-3,-3
"10515",2020-03-28,"Washington Gulch","w1920","Motorized",1,"Sat","weekend","sled","Washington Gulch","3","3","3",13.3,0,50,0,18,26.6,0,-1,-2,0,0,-1,-3,-3
"10516",2020-03-28,"Washington Gulch","w1920","Hybrid",2,"Sat","weekend","sled","Washington Gulch","3","3","3",13.3,0,50,0,18,26.6,0,-1,-2,0,0,-1,-3,-3
"10517",2020-03-29,"Washington Gulch","w1920","Non.motorized",28,"Sun","weekend","no_sled","Washington Gulch","2","2","2",13.3,0,49,-1,24,27.1,0,0,-1,-2,-1,-1,-2,-4
"10518",2020-03-29,"Washington Gulch","w1920","Mechanized",0,"Sun","weekend","no_sled","Washington Gulch","2","2","2",13.3,0,49,-1,24,27.1,0,0,-1,-2,-1,-1,-2,-4
"10519",2020-03-29,"Washington Gulch","w1920","Motorized",4,"Sun","weekend","sled","Washington Gulch","2","2","2",13.3,0,49,-1,24,27.1,0,0,-1,-2,-1,-1,-2,-4
"10520",2020-03-29,"Washington Gulch","w1920","Hybrid",4,"Sun","weekend","sled","Washington Gulch","2","2","2",13.3,0,49,-1,24,27.1,0,0,-1,-2,-1,-1,-2,-4
"10521",2020-03-30,"Washington Gulch","w1920","Non.motorized",4,"Mon","weekday","no_sled","Washington Gulch","2","2","2",13.4,0.1,49,0,29,27.3,-1,0,0,-1,-1,-1,-1,-2
"10522",2020-03-30,"Washington Gulch","w1920","Mechanized",0,"Mon","weekday","no_sled","Washington Gulch","2","2","2",13.4,0.1,49,0,29,27.3,-1,0,0,-1,-1,-1,-1,-2
"10523",2020-03-30,"Washington Gulch","w1920","Motorized",0,"Mon","weekday","sled","Washington Gulch","2","2","2",13.4,0.1,49,0,29,27.3,-1,0,0,-1,-1,-1,-1,-2
"10524",2020-03-30,"Washington Gulch","w1920","Hybrid",2,"Mon","weekday","sled","Washington Gulch","2","2","2",13.4,0.1,49,0,29,27.3,-1,0,0,-1,-1,-1,-1,-2
"10525",2020-03-31,"Washington Gulch","w1920","Non.motorized",24,"Tue","weekday","no_sled","Washington Gulch","2","2","2",13.6,0.2,51,2,35,26.7,0,-1,0,0,2,1,1,1
"10526",2020-03-31,"Washington Gulch","w1920","Mechanized",0,"Tue","weekday","no_sled","Washington Gulch","2","2","2",13.6,0.2,51,2,35,26.7,0,-1,0,0,2,1,1,1
"10527",2020-03-31,"Washington Gulch","w1920","Motorized",4,"Tue","weekday","sled","Washington Gulch","2","2","2",13.6,0.2,51,2,35,26.7,0,-1,0,0,2,1,1,1
"10528",2020-03-31,"Washington Gulch","w1920","Hybrid",3,"Tue","weekday","sled","Washington Gulch","2","2","2",13.6,0.2,51,2,35,26.7,0,-1,0,0,2,1,1,1
"10529",2020-04-01,"Washington Gulch","w1920","Non.motorized",16,"Wed","weekday","no_sled","Washington Gulch","2","2","2",13.6,0,47,-4,39,28.9,2,0,-1,0,-2,-2,-3,-3
"10530",2020-04-01,"Washington Gulch","w1920","Mechanized",0,"Wed","weekday","no_sled","Washington Gulch","2","2","2",13.6,0,47,-4,39,28.9,2,0,-1,0,-2,-2,-3,-3
"10531",2020-04-01,"Washington Gulch","w1920","Motorized",5,"Wed","weekday","sled","Washington Gulch","2","2","2",13.6,0,47,-4,39,28.9,2,0,-1,0,-2,-2,-3,-3
"10532",2020-04-01,"Washington Gulch","w1920","Hybrid",2,"Wed","weekday","sled","Washington Gulch","2","2","2",13.6,0,47,-4,39,28.9,2,0,-1,0,-2,-2,-3,-3
"10533",2020-04-02,"Washington Gulch","w1920","Non.motorized",11,"Thu","weekday","no_sled","Washington Gulch","2","2","2",13.6,0,46,-1,31,29.6,-4,2,0,-1,-5,-3,-3,-4
"10534",2020-04-02,"Washington Gulch","w1920","Mechanized",0,"Thu","weekday","no_sled","Washington Gulch","2","2","2",13.6,0,46,-1,31,29.6,-4,2,0,-1,-5,-3,-3,-4
"10535",2020-04-02,"Washington Gulch","w1920","Motorized",3,"Thu","weekday","sled","Washington Gulch","2","2","2",13.6,0,46,-1,31,29.6,-4,2,0,-1,-5,-3,-3,-4
"10536",2020-04-02,"Washington Gulch","w1920","Hybrid",1,"Thu","weekday","sled","Washington Gulch","2","2","2",13.6,0,46,-1,31,29.6,-4,2,0,-1,-5,-3,-3,-4
"10537",2020-04-03,"Washington Gulch","w1920","Non.motorized",6,"Fri","weekday","no_sled","Washington Gulch","2","2","2",13.6,0,46,0,28,29.6,-1,-4,2,0,-1,-5,-3,-3
"10538",2020-04-03,"Washington Gulch","w1920","Mechanized",0,"Fri","weekday","no_sled","Washington Gulch","2","2","2",13.6,0,46,0,28,29.6,-1,-4,2,0,-1,-5,-3,-3
"10539",2020-04-03,"Washington Gulch","w1920","Motorized",6,"Fri","weekday","sled","Washington Gulch","2","2","2",13.6,0,46,0,28,29.6,-1,-4,2,0,-1,-5,-3,-3
"10540",2020-04-03,"Washington Gulch","w1920","Hybrid",2,"Fri","weekday","sled","Washington Gulch","2","2","2",13.6,0,46,0,28,29.6,-1,-4,2,0,-1,-5,-3,-3
"10541",2020-04-04,"Washington Gulch","w1920","Non.motorized",16,"Sat","weekend","no_sled","Washington Gulch","2","2","2",13.6,0,45,-1,33,30.2,0,-1,-4,2,-1,-2,-6,-4
"10542",2020-04-04,"Washington Gulch","w1920","Mechanized",0,"Sat","weekend","no_sled","Washington Gulch","2","2","2",13.6,0,45,-1,33,30.2,0,-1,-4,2,-1,-2,-6,-4
"10543",2020-04-04,"Washington Gulch","w1920","Motorized",7,"Sat","weekend","sled","Washington Gulch","2","2","2",13.6,0,45,-1,33,30.2,0,-1,-4,2,-1,-2,-6,-4
"10544",2020-04-04,"Washington Gulch","w1920","Hybrid",1,"Sat","weekend","sled","Washington Gulch","2","2","2",13.6,0,45,-1,33,30.2,0,-1,-4,2,-1,-2,-6,-4
"10545",2020-04-05,"Washington Gulch","w1920","Non.motorized",12,"Sun","weekend","no_sled","Washington Gulch","2","2","3",13.6,0,45,0,38,30.2,-1,0,-1,-4,-1,-1,-2,-6
"10546",2020-04-05,"Washington Gulch","w1920","Mechanized",0,"Sun","weekend","no_sled","Washington Gulch","2","2","3",13.6,0,45,0,38,30.2,-1,0,-1,-4,-1,-1,-2,-6
"10547",2020-04-05,"Washington Gulch","w1920","Motorized",8,"Sun","weekend","sled","Washington Gulch","2","2","3",13.6,0,45,0,38,30.2,-1,0,-1,-4,-1,-1,-2,-6
"10548",2020-04-05,"Washington Gulch","w1920","Hybrid",1,"Sun","weekend","sled","Washington Gulch","2","2","3",13.6,0,45,0,38,30.2,-1,0,-1,-4,-1,-1,-2,-6
"10549",2020-04-06,"Washington Gulch","w1920","Non.motorized",13,"Mon","weekday","no_sled","Washington Gulch","2","2","3",13.6,0,44,-1,40,30.9,0,-1,0,-1,-1,-2,-2,-3
"10550",2020-04-06,"Washington Gulch","w1920","Mechanized",0,"Mon","weekday","no_sled","Washington Gulch","2","2","3",13.6,0,44,-1,40,30.9,0,-1,0,-1,-1,-2,-2,-3
"10551",2020-04-06,"Washington Gulch","w1920","Motorized",4,"Mon","weekday","sled","Washington Gulch","2","2","3",13.6,0,44,-1,40,30.9,0,-1,0,-1,-1,-2,-2,-3
"10552",2020-04-06,"Washington Gulch","w1920","Hybrid",3,"Mon","weekday","sled","Washington Gulch","2","2","3",13.6,0,44,-1,40,30.9,0,-1,0,-1,-1,-2,-2,-3
"10553",2020-04-07,"Washington Gulch","w1920","Non.motorized",10,"Tue","weekday","no_sled","Washington Gulch","2","2","3",13.4,-0.2,43,-1,39,31.2,-1,0,-1,0,-2,-2,-3,-3
"10554",2020-04-07,"Washington Gulch","w1920","Mechanized",0,"Tue","weekday","no_sled","Washington Gulch","2","2","3",13.4,-0.2,43,-1,39,31.2,-1,0,-1,0,-2,-2,-3,-3
"10555",2020-04-07,"Washington Gulch","w1920","Motorized",1,"Tue","weekday","sled","Washington Gulch","2","2","3",13.4,-0.2,43,-1,39,31.2,-1,0,-1,0,-2,-2,-3,-3
"10556",2020-04-07,"Washington Gulch","w1920","Hybrid",5,"Tue","weekday","sled","Washington Gulch","2","2","3",13.4,-0.2,43,-1,39,31.2,-1,0,-1,0,-2,-2,-3,-3
"10557",2020-04-08,"Washington Gulch","w1920","Non.motorized",12,"Wed","weekday","no_sled","Washington Gulch","2","3","3",13.3,-0.1,42,-1,40,31.7,-1,-1,0,-1,-2,-3,-3,-4
"10558",2020-04-08,"Washington Gulch","w1920","Mechanized",0,"Wed","weekday","no_sled","Washington Gulch","2","3","3",13.3,-0.1,42,-1,40,31.7,-1,-1,0,-1,-2,-3,-3,-4
"10559",2020-04-08,"Washington Gulch","w1920","Motorized",1,"Wed","weekday","sled","Washington Gulch","2","3","3",13.3,-0.1,42,-1,40,31.7,-1,-1,0,-1,-2,-3,-3,-4
"10560",2020-04-08,"Washington Gulch","w1920","Hybrid",2,"Wed","weekday","sled","Washington Gulch","2","3","3",13.3,-0.1,42,-1,40,31.7,-1,-1,0,-1,-2,-3,-3,-4
"10561",2020-04-09,"Washington Gulch","w1920","Non.motorized",14,"Thu","weekday","no_sled","Washington Gulch","2","3","3",13.1,-0.2,40,-2,42,32.8,-1,-1,-1,0,-3,-4,-5,-5
"10562",2020-04-09,"Washington Gulch","w1920","Mechanized",2,"Thu","weekday","no_sled","Washington Gulch","2","3","3",13.1,-0.2,40,-2,42,32.8,-1,-1,-1,0,-3,-4,-5,-5
"10563",2020-04-09,"Washington Gulch","w1920","Motorized",3,"Thu","weekday","sled","Washington Gulch","2","3","3",13.1,-0.2,40,-2,42,32.8,-1,-1,-1,0,-3,-4,-5,-5
"10564",2020-04-09,"Washington Gulch","w1920","Hybrid",2,"Thu","weekday","sled","Washington Gulch","2","3","3",13.1,-0.2,40,-2,42,32.8,-1,-1,-1,0,-3,-4,-5,-5
"10565",2020-04-10,"Washington Gulch","w1920","Non.motorized",6,"Fri","weekday","no_sled","Washington Gulch","3","3","3",12.9,-0.2,39,-1,38,33.1,-2,-1,-1,-1,-3,-4,-5,-6
"10566",2020-04-10,"Washington Gulch","w1920","Mechanized",0,"Fri","weekday","no_sled","Washington Gulch","3","3","3",12.9,-0.2,39,-1,38,33.1,-2,-1,-1,-1,-3,-4,-5,-6
"10567",2020-04-10,"Washington Gulch","w1920","Motorized",5,"Fri","weekday","sled","Washington Gulch","3","3","3",12.9,-0.2,39,-1,38,33.1,-2,-1,-1,-1,-3,-4,-5,-6
"10568",2020-04-10,"Washington Gulch","w1920","Hybrid",2,"Fri","weekday","sled","Washington Gulch","3","3","3",12.9,-0.2,39,-1,38,33.1,-2,-1,-1,-1,-3,-4,-5,-6
"10569",2020-04-11,"Washington Gulch","w1920","Non.motorized",NA,"Sat","weekend","no_sled","Washington Gulch","2","3","3",12.9,0,39,0,36,33.1,-1,-2,-1,-1,-1,-3,-4,-5
"10570",2020-04-11,"Washington Gulch","w1920","Mechanized",NA,"Sat","weekend","no_sled","Washington Gulch","2","3","3",12.9,0,39,0,36,33.1,-1,-2,-1,-1,-1,-3,-4,-5
"10571",2020-04-11,"Washington Gulch","w1920","Motorized",NA,"Sat","weekend","sled","Washington Gulch","2","3","3",12.9,0,39,0,36,33.1,-1,-2,-1,-1,-1,-3,-4,-5
"10572",2020-04-11,"Washington Gulch","w1920","Hybrid",NA,"Sat","weekend","sled","Washington Gulch","2","3","3",12.9,0,39,0,36,33.1,-1,-2,-1,-1,-1,-3,-4,-5
"10573",2020-04-12,"Washington Gulch","w1920","Non.motorized",NA,"Sun","weekend","no_sled","Washington Gulch","2","2","2",12.8,-0.1,38,-1,29,33.7,0,-1,-2,-1,-1,-2,-4,-5
"10574",2020-04-12,"Washington Gulch","w1920","Mechanized",NA,"Sun","weekend","no_sled","Washington Gulch","2","2","2",12.8,-0.1,38,-1,29,33.7,0,-1,-2,-1,-1,-2,-4,-5
"10575",2020-04-12,"Washington Gulch","w1920","Motorized",NA,"Sun","weekend","sled","Washington Gulch","2","2","2",12.8,-0.1,38,-1,29,33.7,0,-1,-2,-1,-1,-2,-4,-5
"10576",2020-04-12,"Washington Gulch","w1920","Hybrid",NA,"Sun","weekend","sled","Washington Gulch","2","2","2",12.8,-0.1,38,-1,29,33.7,0,-1,-2,-1,-1,-2,-4,-5
"10577",2020-04-13,"Washington Gulch","w1920","Non.motorized",NA,"Mon","weekday","no_sled","Washington Gulch",NA,NA,NA,12.9,0.1,39,1,20,33.1,-1,0,-1,-2,0,0,-1,-3
"10578",2020-04-13,"Washington Gulch","w1920","Mechanized",NA,"Mon","weekday","no_sled","Washington Gulch",NA,NA,NA,12.9,0.1,39,1,20,33.1,-1,0,-1,-2,0,0,-1,-3
"10579",2020-04-13,"Washington Gulch","w1920","Motorized",NA,"Mon","weekday","sled","Washington Gulch",NA,NA,NA,12.9,0.1,39,1,20,33.1,-1,0,-1,-2,0,0,-1,-3
"10580",2020-04-13,"Washington Gulch","w1920","Hybrid",NA,"Mon","weekday","sled","Washington Gulch",NA,NA,NA,12.9,0.1,39,1,20,33.1,-1,0,-1,-2,0,0,-1,-3
"10581",2020-04-14,"Washington Gulch","w1920","Non.motorized",NA,"Tue","weekday","no_sled","Washington Gulch","2","2","2",13,0.1,39,0,18,33.3,1,-1,0,-1,1,0,0,-1
"10582",2020-04-14,"Washington Gulch","w1920","Mechanized",NA,"Tue","weekday","no_sled","Washington Gulch","2","2","2",13,0.1,39,0,18,33.3,1,-1,0,-1,1,0,0,-1
"10583",2020-04-14,"Washington Gulch","w1920","Motorized",NA,"Tue","weekday","sled","Washington Gulch","2","2","2",13,0.1,39,0,18,33.3,1,-1,0,-1,1,0,0,-1
"10584",2020-04-14,"Washington Gulch","w1920","Hybrid",NA,"Tue","weekday","sled","Washington Gulch","2","2","2",13,0.1,39,0,18,33.3,1,-1,0,-1,1,0,0,-1
"10585",2020-04-15,"Washington Gulch","w1920","Non.motorized",NA,"Wed","weekday","no_sled","Washington Gulch",NA,NA,NA,13.2,0.2,39,0,28,33.8,0,1,-1,0,0,1,0,0
"10586",2020-04-15,"Washington Gulch","w1920","Mechanized",NA,"Wed","weekday","no_sled","Washington Gulch",NA,NA,NA,13.2,0.2,39,0,28,33.8,0,1,-1,0,0,1,0,0
"10587",2020-04-15,"Washington Gulch","w1920","Motorized",NA,"Wed","weekday","sled","Washington Gulch",NA,NA,NA,13.2,0.2,39,0,28,33.8,0,1,-1,0,0,1,0,0
"10588",2020-04-15,"Washington Gulch","w1920","Hybrid",NA,"Wed","weekday","sled","Washington Gulch",NA,NA,NA,13.2,0.2,39,0,28,33.8,0,1,-1,0,0,1,0,0
"10589",2020-04-16,"Washington Gulch","w1920","Non.motorized",NA,"Thu","weekday","no_sled","Washington Gulch",NA,NA,NA,NA,NA,NA,NA,NA,NA,NA,NA,NA,NA,NA,NA,NA,NA
"10590",2020-04-16,"Washington Gulch","w1920","Mechanized",NA,"Thu","weekday","no_sled","Washington Gulch",NA,NA,NA,NA,NA,NA,NA,NA,NA,NA,NA,NA,NA,NA,NA,NA,NA
"10591",2020-04-16,"Washington Gulch","w1920","Motorized",NA,"Thu","weekday","sled","Washington Gulch",NA,NA,NA,NA,NA,NA,NA,NA,NA,NA,NA,NA,NA,NA,NA,NA,NA
"10592",2020-04-16,"Washington Gulch","w1920","Hybrid",NA,"Thu","weekday","sled","Washington Gulch",NA,NA,NA,NA,NA,NA,NA,NA,NA,NA,NA,NA,NA,NA,NA,NA,NA
"10593",2020-04-17,"Washington Gulch","w1920","Non.motorized",NA,"Fri","weekday","no_sled","Washington Gulch",NA,NA,NA,NA,NA,NA,NA,NA,NA,NA,NA,NA,NA,NA,NA,NA,NA
"10594",2020-04-17,"Washington Gulch","w1920","Mechanized",NA,"Fri","weekday","no_sled","Washington Gulch",NA,NA,NA,NA,NA,NA,NA,NA,NA,NA,NA,NA,NA,NA,NA,NA,NA
"10595",2020-04-17,"Washington Gulch","w1920","Motorized",NA,"Fri","weekday","sled","Washington Gulch",NA,NA,NA,NA,NA,NA,NA,NA,NA,NA,NA,NA,NA,NA,NA,NA,NA
"10596",2020-04-17,"Washington Gulch","w1920","Hybrid",NA,"Fri","weekday","sled","Washington Gulch",NA,NA,NA,NA,NA,NA,NA,NA,NA,NA,NA,NA,NA,NA,NA,NA,NA
"10597",2020-04-18,"Washington Gulch","w1920","Non.motorized",NA,"Sat","weekend","no_sled","Washington Gulch",NA,NA,NA,NA,NA,NA,NA,NA,NA,NA,NA,NA,NA,NA,NA,NA,NA
"10598",2020-04-18,"Washington Gulch","w1920","Mechanized",NA,"Sat","weekend","no_sled","Washington Gulch",NA,NA,NA,NA,NA,NA,NA,NA,NA,NA,NA,NA,NA,NA,NA,NA,NA
"10599",2020-04-18,"Washington Gulch","w1920","Motorized",NA,"Sat","weekend","sled","Washington Gulch",NA,NA,NA,NA,NA,NA,NA,NA,NA,NA,NA,NA,NA,NA,NA,NA,NA
"10600",2020-04-18,"Washington Gulch","w1920","Hybrid",NA,"Sat","weekend","sled","Washington Gulch",NA,NA,NA,NA,NA,NA,NA,NA,NA,NA,NA,NA,NA,NA,NA,NA,NA
"10601",2020-04-19,"Washington Gulch","w1920","Non.motorized",NA,"Sun","weekend","no_sled","Washington Gulch",NA,NA,NA,NA,NA,NA,NA,NA,NA,NA,NA,NA,NA,NA,NA,NA,NA
"10602",2020-04-19,"Washington Gulch","w1920","Mechanized",NA,"Sun","weekend","no_sled","Washington Gulch",NA,NA,NA,NA,NA,NA,NA,NA,NA,NA,NA,NA,NA,NA,NA,NA,NA
"10603",2020-04-19,"Washington Gulch","w1920","Motorized",NA,"Sun","weekend","sled","Washington Gulch",NA,NA,NA,NA,NA,NA,NA,NA,NA,NA,NA,NA,NA,NA,NA,NA,NA
"10604",2020-04-19,"Washington Gulch","w1920","Hybrid",NA,"Sun","weekend","sled","Washington Gulch",NA,NA,NA,NA,NA,NA,NA,NA,NA,NA,NA,NA,NA,NA,NA,NA,NA
"10605",2020-04-20,"Washington Gulch","w1920","Non.motorized",NA,"Mon","weekday","no_sled","Washington Gulch",NA,NA,NA,NA,NA,NA,NA,NA,NA,NA,NA,NA,NA,NA,NA,NA,NA
"10606",2020-04-20,"Washington Gulch","w1920","Mechanized",NA,"Mon","weekday","no_sled","Washington Gulch",NA,NA,NA,NA,NA,NA,NA,NA,NA,NA,NA,NA,NA,NA,NA,NA,NA
"10607",2020-04-20,"Washington Gulch","w1920","Motorized",NA,"Mon","weekday","sled","Washington Gulch",NA,NA,NA,NA,NA,NA,NA,NA,NA,NA,NA,NA,NA,NA,NA,NA,NA
"10608",2020-04-20,"Washington Gulch","w1920","Hybrid",NA,"Mon","weekday","sled","Washington Gulch",NA,NA,NA,NA,NA,NA,NA,NA,NA,NA,NA,NA,NA,NA,NA,NA,NA
"10609",2020-04-21,"Washington Gulch","w1920","Non.motorized",NA,"Tue","weekday","no_sled","Washington Gulch",NA,NA,NA,NA,NA,NA,NA,NA,NA,NA,NA,NA,NA,NA,NA,NA,NA
"10610",2020-04-21,"Washington Gulch","w1920","Mechanized",NA,"Tue","weekday","no_sled","Washington Gulch",NA,NA,NA,NA,NA,NA,NA,NA,NA,NA,NA,NA,NA,NA,NA,NA,NA
"10611",2020-04-21,"Washington Gulch","w1920","Motorized",NA,"Tue","weekday","sled","Washington Gulch",NA,NA,NA,NA,NA,NA,NA,NA,NA,NA,NA,NA,NA,NA,NA,NA,NA
"10612",2020-04-21,"Washington Gulch","w1920","Hybrid",NA,"Tue","weekday","sled","Washington Gulch",NA,NA,NA,NA,NA,NA,NA,NA,NA,NA,NA,NA,NA,NA,NA,NA,NA
"10613",2020-04-22,"Washington Gulch","w1920","Non.motorized",NA,"Wed","weekday","no_sled","Washington Gulch",NA,NA,NA,NA,NA,NA,NA,NA,NA,NA,NA,NA,NA,NA,NA,NA,NA
"10614",2020-04-22,"Washington Gulch","w1920","Mechanized",NA,"Wed","weekday","no_sled","Washington Gulch",NA,NA,NA,NA,NA,NA,NA,NA,NA,NA,NA,NA,NA,NA,NA,NA,NA
"10615",2020-04-22,"Washington Gulch","w1920","Motorized",NA,"Wed","weekday","sled","Washington Gulch",NA,NA,NA,NA,NA,NA,NA,NA,NA,NA,NA,NA,NA,NA,NA,NA,NA
"10616",2020-04-22,"Washington Gulch","w1920","Hybrid",NA,"Wed","weekday","sled","Washington Gulch",NA,NA,NA,NA,NA,NA,NA,NA,NA,NA,NA,NA,NA,NA,NA,NA,NA
"10617",2020-04-23,"Washington Gulch","w1920","Non.motorized",NA,"Thu","weekday","no_sled","Washington Gulch",NA,NA,NA,NA,NA,NA,NA,NA,NA,NA,NA,NA,NA,NA,NA,NA,NA
"10618",2020-04-23,"Washington Gulch","w1920","Mechanized",NA,"Thu","weekday","no_sled","Washington Gulch",NA,NA,NA,NA,NA,NA,NA,NA,NA,NA,NA,NA,NA,NA,NA,NA,NA
"10619",2020-04-23,"Washington Gulch","w1920","Motorized",NA,"Thu","weekday","sled","Washington Gulch",NA,NA,NA,NA,NA,NA,NA,NA,NA,NA,NA,NA,NA,NA,NA,NA,NA
"10620",2020-04-23,"Washington Gulch","w1920","Hybrid",NA,"Thu","weekday","sled","Washington Gulch",NA,NA,NA,NA,NA,NA,NA,NA,NA,NA,NA,NA,NA,NA,NA,NA,NA
"10621",2020-04-24,"Washington Gulch","w1920","Non.motorized",NA,"Fri","weekday","no_sled","Washington Gulch",NA,NA,NA,NA,NA,NA,NA,NA,NA,NA,NA,NA,NA,NA,NA,NA,NA
"10622",2020-04-24,"Washington Gulch","w1920","Mechanized",NA,"Fri","weekday","no_sled","Washington Gulch",NA,NA,NA,NA,NA,NA,NA,NA,NA,NA,NA,NA,NA,NA,NA,NA,NA
"10623",2020-04-24,"Washington Gulch","w1920","Motorized",NA,"Fri","weekday","sled","Washington Gulch",NA,NA,NA,NA,NA,NA,NA,NA,NA,NA,NA,NA,NA,NA,NA,NA,NA
"10624",2020-04-24,"Washington Gulch","w1920","Hybrid",NA,"Fri","weekday","sled","Washington Gulch",NA,NA,NA,NA,NA,NA,NA,NA,NA,NA,NA,NA,NA,NA,NA,NA,NA
"10625",2020-04-25,"Washington Gulch","w1920","Non.motorized",NA,"Sat","weekend","no_sled","Washington Gulch",NA,NA,NA,NA,NA,NA,NA,NA,NA,NA,NA,NA,NA,NA,NA,NA,NA
"10626",2020-04-25,"Washington Gulch","w1920","Mechanized",NA,"Sat","weekend","no_sled","Washington Gulch",NA,NA,NA,NA,NA,NA,NA,NA,NA,NA,NA,NA,NA,NA,NA,NA,NA
"10627",2020-04-25,"Washington Gulch","w1920","Motorized",NA,"Sat","weekend","sled","Washington Gulch",NA,NA,NA,NA,NA,NA,NA,NA,NA,NA,NA,NA,NA,NA,NA,NA,NA
"10628",2020-04-25,"Washington Gulch","w1920","Hybrid",NA,"Sat","weekend","sled","Washington Gulch",NA,NA,NA,NA,NA,NA,NA,NA,NA,NA,NA,NA,NA,NA,NA,NA,NA
"10629",2020-04-26,"Washington Gulch","w1920","Non.motorized",NA,"Sun","weekend","no_sled","Washington Gulch",NA,NA,NA,NA,NA,NA,NA,NA,NA,NA,NA,NA,NA,NA,NA,NA,NA
"10630",2020-04-26,"Washington Gulch","w1920","Mechanized",NA,"Sun","weekend","no_sled","Washington Gulch",NA,NA,NA,NA,NA,NA,NA,NA,NA,NA,NA,NA,NA,NA,NA,NA,NA
"10631",2020-04-26,"Washington Gulch","w1920","Motorized",NA,"Sun","weekend","sled","Washington Gulch",NA,NA,NA,NA,NA,NA,NA,NA,NA,NA,NA,NA,NA,NA,NA,NA,NA
"10632",2020-04-26,"Washington Gulch","w1920","Hybrid",NA,"Sun","weekend","sled","Washington Gulch",NA,NA,NA,NA,NA,NA,NA,NA,NA,NA,NA,NA,NA,NA,NA,NA,NA
"10633",2020-04-27,"Washington Gulch","w1920","Non.motorized",NA,"Mon","weekday","no_sled","Washington Gulch",NA,NA,NA,NA,NA,NA,NA,NA,NA,NA,NA,NA,NA,NA,NA,NA,NA
"10634",2020-04-27,"Washington Gulch","w1920","Mechanized",NA,"Mon","weekday","no_sled","Washington Gulch",NA,NA,NA,NA,NA,NA,NA,NA,NA,NA,NA,NA,NA,NA,NA,NA,NA
"10635",2020-04-27,"Washington Gulch","w1920","Motorized",NA,"Mon","weekday","sled","Washington Gulch",NA,NA,NA,NA,NA,NA,NA,NA,NA,NA,NA,NA,NA,NA,NA,NA,NA
"10636",2020-04-27,"Washington Gulch","w1920","Hybrid",NA,"Mon","weekday","sled","Washington Gulch",NA,NA,NA,NA,NA,NA,NA,NA,NA,NA,NA,NA,NA,NA,NA,NA,NA
"10637",2020-04-28,"Washington Gulch","w1920","Non.motorized",7,"Tue","weekday","no_sled","Washington Gulch",NA,NA,NA,NA,NA,NA,NA,NA,NA,NA,NA,NA,NA,NA,NA,NA,NA
"10638",2020-04-28,"Washington Gulch","w1920","Mechanized",0,"Tue","weekday","no_sled","Washington Gulch",NA,NA,NA,NA,NA,NA,NA,NA,NA,NA,NA,NA,NA,NA,NA,NA,NA
"10639",2020-04-28,"Washington Gulch","w1920","Motorized",0,"Tue","weekday","sled","Washington Gulch",NA,NA,NA,NA,NA,NA,NA,NA,NA,NA,NA,NA,NA,NA,NA,NA,NA
"10640",2020-04-28,"Washington Gulch","w1920","Hybrid",2,"Tue","weekday","sled","Washington Gulch",NA,NA,NA,NA,NA,NA,NA,NA,NA,NA,NA,NA,NA,NA,NA,NA,NA
"10641",2020-04-29,"Washington Gulch","w1920","Non.motorized",4,"Wed","weekday","no_sled","Washington Gulch",NA,NA,NA,NA,NA,NA,NA,NA,NA,NA,NA,NA,NA,NA,NA,NA,NA
"10642",2020-04-29,"Washington Gulch","w1920","Mechanized",0,"Wed","weekday","no_sled","Washington Gulch",NA,NA,NA,NA,NA,NA,NA,NA,NA,NA,NA,NA,NA,NA,NA,NA,NA
"10643",2020-04-29,"Washington Gulch","w1920","Motorized",1,"Wed","weekday","sled","Washington Gulch",NA,NA,NA,NA,NA,NA,NA,NA,NA,NA,NA,NA,NA,NA,NA,NA,NA
"10644",2020-04-29,"Washington Gulch","w1920","Hybrid",0,"Wed","weekday","sled","Washington Gulch",NA,NA,NA,NA,NA,NA,NA,NA,NA,NA,NA,NA,NA,NA,NA,NA,NA
"10645",2020-04-30,"Washington Gulch","w1920","Non.motorized",1,"Thu","weekday","no_sled","Washington Gulch",NA,NA,NA,NA,NA,NA,NA,NA,NA,NA,NA,NA,NA,NA,NA,NA,NA
"10646",2020-04-30,"Washington Gulch","w1920","Mechanized",0,"Thu","weekday","no_sled","Washington Gulch",NA,NA,NA,NA,NA,NA,NA,NA,NA,NA,NA,NA,NA,NA,NA,NA,NA
"10647",2020-04-30,"Washington Gulch","w1920","Motorized",0,"Thu","weekday","sled","Washington Gulch",NA,NA,NA,NA,NA,NA,NA,NA,NA,NA,NA,NA,NA,NA,NA,NA,NA
"10648",2020-04-30,"Washington Gulch","w1920","Hybrid",0,"Thu","weekday","sled","Washington Gulch",NA,NA,NA,NA,NA,NA,NA,NA,NA,NA,NA,NA,NA,NA,NA,NA,NA
"10649",2020-12-03,"Brush Creek Trailhead","w2021","Non.motorized",6,"Thu","weekday","no_sled","Brush/Cement",NA,NA,NA,NA,NA,NA,NA,NA,NA,NA,NA,NA,NA,NA,NA,NA,NA
"10650",2020-12-03,"Brush Creek Trailhead","w2021","Mechanized",0,"Thu","weekday","no_sled","Brush/Cement",NA,NA,NA,NA,NA,NA,NA,NA,NA,NA,NA,NA,NA,NA,NA,NA,NA
"10651",2020-12-03,"Brush Creek Trailhead","w2021","Motorized",0,"Thu","weekday","sled","Brush/Cement",NA,NA,NA,NA,NA,NA,NA,NA,NA,NA,NA,NA,NA,NA,NA,NA,NA
"10652",2020-12-03,"Brush Creek Trailhead","w2021","Hybrid",0,"Thu","weekday","sled","Brush/Cement",NA,NA,NA,NA,NA,NA,NA,NA,NA,NA,NA,NA,NA,NA,NA,NA,NA
"10653",2020-12-04,"Brush Creek Trailhead","w2021","Non.motorized",16,"Fri","weekday","no_sled","Brush/Cement",NA,NA,NA,2.4,NA,11,0,29,21.8,0,0,0,0,0,0,0,0
"10654",2020-12-04,"Brush Creek Trailhead","w2021","Mechanized",0,"Fri","weekday","no_sled","Brush/Cement",NA,NA,NA,2.4,NA,11,0,29,21.8,0,0,0,0,0,0,0,0
"10655",2020-12-04,"Brush Creek Trailhead","w2021","Motorized",0,"Fri","weekday","sled","Brush/Cement",NA,NA,NA,2.4,NA,11,0,29,21.8,0,0,0,0,0,0,0,0
"10656",2020-12-04,"Brush Creek Trailhead","w2021","Hybrid",0,"Fri","weekday","sled","Brush/Cement",NA,NA,NA,2.4,NA,11,0,29,21.8,0,0,0,0,0,0,0,0
"10657",2020-12-05,"Brush Creek Trailhead","w2021","Non.motorized",33,"Sat","weekend","no_sled","Brush/Cement",NA,NA,NA,2.5,NA,11,0,32,22.7,0,0,0,0,0,0,0,0
"10658",2020-12-05,"Brush Creek Trailhead","w2021","Mechanized",0,"Sat","weekend","no_sled","Brush/Cement",NA,NA,NA,2.5,NA,11,0,32,22.7,0,0,0,0,0,0,0,0
"10659",2020-12-05,"Brush Creek Trailhead","w2021","Motorized",0,"Sat","weekend","sled","Brush/Cement",NA,NA,NA,2.5,NA,11,0,32,22.7,0,0,0,0,0,0,0,0
"10660",2020-12-05,"Brush Creek Trailhead","w2021","Hybrid",0,"Sat","weekend","sled","Brush/Cement",NA,NA,NA,2.5,NA,11,0,32,22.7,0,0,0,0,0,0,0,0
"10661",2020-12-06,"Brush Creek Trailhead","w2021","Non.motorized",36,"Sun","weekend","no_sled","Brush/Cement",NA,NA,NA,2.5,NA,11,0,30,22.7,0,0,0,0,0,0,0,0
"10662",2020-12-06,"Brush Creek Trailhead","w2021","Mechanized",0,"Sun","weekend","no_sled","Brush/Cement",NA,NA,NA,2.5,NA,11,0,30,22.7,0,0,0,0,0,0,0,0
"10663",2020-12-06,"Brush Creek Trailhead","w2021","Motorized",0,"Sun","weekend","sled","Brush/Cement",NA,NA,NA,2.5,NA,11,0,30,22.7,0,0,0,0,0,0,0,0
"10664",2020-12-06,"Brush Creek Trailhead","w2021","Hybrid",0,"Sun","weekend","sled","Brush/Cement",NA,NA,NA,2.5,NA,11,0,30,22.7,0,0,0,0,0,0,0,0
"10665",2020-12-07,"Brush Creek Trailhead","w2021","Non.motorized",14,"Mon","weekday","no_sled","Brush/Cement",NA,NA,NA,2.5,NA,11,0,33,22.7,0,0,0,0,0,0,0,0
"10666",2020-12-07,"Brush Creek Trailhead","w2021","Mechanized",0,"Mon","weekday","no_sled","Brush/Cement",NA,NA,NA,2.5,NA,11,0,33,22.7,0,0,0,0,0,0,0,0
"10667",2020-12-07,"Brush Creek Trailhead","w2021","Motorized",0,"Mon","weekday","sled","Brush/Cement",NA,NA,NA,2.5,NA,11,0,33,22.7,0,0,0,0,0,0,0,0
"10668",2020-12-07,"Brush Creek Trailhead","w2021","Hybrid",0,"Mon","weekday","sled","Brush/Cement",NA,NA,NA,2.5,NA,11,0,33,22.7,0,0,0,0,0,0,0,0
"10669",2020-12-08,"Brush Creek Trailhead","w2021","Non.motorized",26,"Tue","weekday","no_sled","Brush/Cement",NA,NA,NA,2.5,NA,11,0,34,22.7,0,0,0,0,0,0,0,0
"10670",2020-12-08,"Brush Creek Trailhead","w2021","Mechanized",2,"Tue","weekday","no_sled","Brush/Cement",NA,NA,NA,2.5,NA,11,0,34,22.7,0,0,0,0,0,0,0,0
"10671",2020-12-08,"Brush Creek Trailhead","w2021","Motorized",0,"Tue","weekday","sled","Brush/Cement",NA,NA,NA,2.5,NA,11,0,34,22.7,0,0,0,0,0,0,0,0
"10672",2020-12-08,"Brush Creek Trailhead","w2021","Hybrid",0,"Tue","weekday","sled","Brush/Cement",NA,NA,NA,2.5,NA,11,0,34,22.7,0,0,0,0,0,0,0,0
"10673",2020-12-09,"Brush Creek Trailhead","w2021","Non.motorized",16,"Wed","weekday","no_sled","Brush/Cement",NA,NA,NA,2.5,NA,11,0,32,22.7,0,0,0,0,0,0,0,0
"10674",2020-12-09,"Brush Creek Trailhead","w2021","Mechanized",0,"Wed","weekday","no_sled","Brush/Cement",NA,NA,NA,2.5,NA,11,0,32,22.7,0,0,0,0,0,0,0,0
"10675",2020-12-09,"Brush Creek Trailhead","w2021","Motorized",0,"Wed","weekday","sled","Brush/Cement",NA,NA,NA,2.5,NA,11,0,32,22.7,0,0,0,0,0,0,0,0
"10676",2020-12-09,"Brush Creek Trailhead","w2021","Hybrid",0,"Wed","weekday","sled","Brush/Cement",NA,NA,NA,2.5,NA,11,0,32,22.7,0,0,0,0,0,0,0,0
"10677",2020-12-10,"Brush Creek Trailhead","w2021","Non.motorized",23,"Thu","weekday","no_sled","Brush/Cement",NA,NA,NA,2.5,NA,11,0,28,22.7,0,0,0,0,0,0,0,0
"10678",2020-12-10,"Brush Creek Trailhead","w2021","Mechanized",1,"Thu","weekday","no_sled","Brush/Cement",NA,NA,NA,2.5,NA,11,0,28,22.7,0,0,0,0,0,0,0,0
"10679",2020-12-10,"Brush Creek Trailhead","w2021","Motorized",0,"Thu","weekday","sled","Brush/Cement",NA,NA,NA,2.5,NA,11,0,28,22.7,0,0,0,0,0,0,0,0
"10680",2020-12-10,"Brush Creek Trailhead","w2021","Hybrid",0,"Thu","weekday","sled","Brush/Cement",NA,NA,NA,2.5,NA,11,0,28,22.7,0,0,0,0,0,0,0,0
"10681",2020-12-11,"Brush Creek Trailhead","w2021","Non.motorized",11,"Fri","weekday","no_sled","Brush/Cement",NA,NA,NA,2.6,NA,12,1,20,21.7,0,0,0,0,1,1,1,1
"10682",2020-12-11,"Brush Creek Trailhead","w2021","Mechanized",0,"Fri","weekday","no_sled","Brush/Cement",NA,NA,NA,2.6,NA,12,1,20,21.7,0,0,0,0,1,1,1,1
"10683",2020-12-11,"Brush Creek Trailhead","w2021","Motorized",0,"Fri","weekday","sled","Brush/Cement",NA,NA,NA,2.6,NA,12,1,20,21.7,0,0,0,0,1,1,1,1
"10684",2020-12-11,"Brush Creek Trailhead","w2021","Hybrid",0,"Fri","weekday","sled","Brush/Cement",NA,NA,NA,2.6,NA,12,1,20,21.7,0,0,0,0,1,1,1,1
"10685",2020-12-12,"Brush Creek Trailhead","w2021","Non.motorized",9,"Sat","weekend","no_sled","Brush/Cement",NA,NA,NA,2.9,NA,17,5,12,17.1,1,0,0,0,6,6,6,6
"10686",2020-12-12,"Brush Creek Trailhead","w2021","Mechanized",0,"Sat","weekend","no_sled","Brush/Cement",NA,NA,NA,2.9,NA,17,5,12,17.1,1,0,0,0,6,6,6,6
"10687",2020-12-12,"Brush Creek Trailhead","w2021","Motorized",0,"Sat","weekend","sled","Brush/Cement",NA,NA,NA,2.9,NA,17,5,12,17.1,1,0,0,0,6,6,6,6
"10688",2020-12-12,"Brush Creek Trailhead","w2021","Hybrid",0,"Sat","weekend","sled","Brush/Cement",NA,NA,NA,2.9,NA,17,5,12,17.1,1,0,0,0,6,6,6,6
"10689",2020-12-13,"Brush Creek Trailhead","w2021","Non.motorized",23,"Sun","weekend","no_sled","Brush/Cement",NA,NA,NA,3.3,NA,19,2,10,17.4,5,1,0,0,7,8,8,8
"10690",2020-12-13,"Brush Creek Trailhead","w2021","Mechanized",0,"Sun","weekend","no_sled","Brush/Cement",NA,NA,NA,3.3,NA,19,2,10,17.4,5,1,0,0,7,8,8,8
"10691",2020-12-13,"Brush Creek Trailhead","w2021","Motorized",0,"Sun","weekend","sled","Brush/Cement",NA,NA,NA,3.3,NA,19,2,10,17.4,5,1,0,0,7,8,8,8
"10692",2020-12-13,"Brush Creek Trailhead","w2021","Hybrid",0,"Sun","weekend","sled","Brush/Cement",NA,NA,NA,3.3,NA,19,2,10,17.4,5,1,0,0,7,8,8,8
"10693",2020-12-14,"Brush Creek Trailhead","w2021","Non.motorized",9,"Mon","weekday","no_sled","Brush/Cement",NA,NA,NA,3.3,NA,18,-1,18,18.3,2,5,1,0,1,6,7,7
"10694",2020-12-14,"Brush Creek Trailhead","w2021","Mechanized",1,"Mon","weekday","no_sled","Brush/Cement",NA,NA,NA,3.3,NA,18,-1,18,18.3,2,5,1,0,1,6,7,7
"10695",2020-12-14,"Brush Creek Trailhead","w2021","Motorized",0,"Mon","weekday","sled","Brush/Cement",NA,NA,NA,3.3,NA,18,-1,18,18.3,2,5,1,0,1,6,7,7
"10696",2020-12-14,"Brush Creek Trailhead","w2021","Hybrid",0,"Mon","weekday","sled","Brush/Cement",NA,NA,NA,3.3,NA,18,-1,18,18.3,2,5,1,0,1,6,7,7
"10697",2020-12-15,"Brush Creek Trailhead","w2021","Non.motorized",10,"Tue","weekday","no_sled","Brush/Cement",NA,NA,NA,3.5,NA,19,1,13,18.4,-1,2,5,1,0,2,7,8
"10698",2020-12-15,"Brush Creek Trailhead","w2021","Mechanized",0,"Tue","weekday","no_sled","Brush/Cement",NA,NA,NA,3.5,NA,19,1,13,18.4,-1,2,5,1,0,2,7,8
"10699",2020-12-15,"Brush Creek Trailhead","w2021","Motorized",0,"Tue","weekday","sled","Brush/Cement",NA,NA,NA,3.5,NA,19,1,13,18.4,-1,2,5,1,0,2,7,8
"10700",2020-12-15,"Brush Creek Trailhead","w2021","Hybrid",0,"Tue","weekday","sled","Brush/Cement",NA,NA,NA,3.5,NA,19,1,13,18.4,-1,2,5,1,0,2,7,8
"10701",2020-12-16,"Brush Creek Trailhead","w2021","Non.motorized",5,"Wed","weekday","no_sled","Brush/Cement",NA,NA,NA,3.5,NA,19,0,16,18.4,1,-1,2,5,1,0,2,7
"10702",2020-12-16,"Brush Creek Trailhead","w2021","Mechanized",0,"Wed","weekday","no_sled","Brush/Cement",NA,NA,NA,3.5,NA,19,0,16,18.4,1,-1,2,5,1,0,2,7
"10703",2020-12-16,"Brush Creek Trailhead","w2021","Motorized",0,"Wed","weekday","sled","Brush/Cement",NA,NA,NA,3.5,NA,19,0,16,18.4,1,-1,2,5,1,0,2,7
"10704",2020-12-16,"Brush Creek Trailhead","w2021","Hybrid",0,"Wed","weekday","sled","Brush/Cement",NA,NA,NA,3.5,NA,19,0,16,18.4,1,-1,2,5,1,0,2,7
"10705",2020-12-17,"Brush Creek Trailhead","w2021","Non.motorized",11,"Thu","weekday","no_sled","Brush/Cement",NA,NA,NA,3.5,NA,19,0,20,18.4,0,1,-1,2,0,1,0,2
"10706",2020-12-17,"Brush Creek Trailhead","w2021","Mechanized",1,"Thu","weekday","no_sled","Brush/Cement",NA,NA,NA,3.5,NA,19,0,20,18.4,0,1,-1,2,0,1,0,2
"10707",2020-12-17,"Brush Creek Trailhead","w2021","Motorized",0,"Thu","weekday","sled","Brush/Cement",NA,NA,NA,3.5,NA,19,0,20,18.4,0,1,-1,2,0,1,0,2
"10708",2020-12-17,"Brush Creek Trailhead","w2021","Hybrid",0,"Thu","weekday","sled","Brush/Cement",NA,NA,NA,3.5,NA,19,0,20,18.4,0,1,-1,2,0,1,0,2
"10709",2020-12-18,"Brush Creek Trailhead","w2021","Non.motorized",6,"Fri","weekday","no_sled","Brush/Cement",NA,NA,NA,3.8,NA,22,3,20,17.3,0,0,1,-1,3,3,4,3
"10710",2020-12-18,"Brush Creek Trailhead","w2021","Mechanized",0,"Fri","weekday","no_sled","Brush/Cement",NA,NA,NA,3.8,NA,22,3,20,17.3,0,0,1,-1,3,3,4,3
"10711",2020-12-18,"Brush Creek Trailhead","w2021","Motorized",0,"Fri","weekday","sled","Brush/Cement",NA,NA,NA,3.8,NA,22,3,20,17.3,0,0,1,-1,3,3,4,3
"10712",2020-12-18,"Brush Creek Trailhead","w2021","Hybrid",0,"Fri","weekday","sled","Brush/Cement",NA,NA,NA,3.8,NA,22,3,20,17.3,0,0,1,-1,3,3,4,3
"10713",2020-12-19,"Brush Creek Trailhead","w2021","Non.motorized",18,"Sat","weekend","no_sled","Brush/Cement",NA,NA,NA,3.9,NA,22,0,17,17.7,3,0,0,1,3,3,3,4
"10714",2020-12-19,"Brush Creek Trailhead","w2021","Mechanized",0,"Sat","weekend","no_sled","Brush/Cement",NA,NA,NA,3.9,NA,22,0,17,17.7,3,0,0,1,3,3,3,4
"10715",2020-12-19,"Brush Creek Trailhead","w2021","Motorized",0,"Sat","weekend","sled","Brush/Cement",NA,NA,NA,3.9,NA,22,0,17,17.7,3,0,0,1,3,3,3,4
"10716",2020-12-19,"Brush Creek Trailhead","w2021","Hybrid",0,"Sat","weekend","sled","Brush/Cement",NA,NA,NA,3.9,NA,22,0,17,17.7,3,0,0,1,3,3,3,4
"10717",2020-12-20,"Brush Creek Trailhead","w2021","Non.motorized",18,"Sun","weekend","no_sled","Brush/Cement",NA,NA,NA,3.9,NA,21,-1,26,18.6,0,3,0,0,-1,2,2,2
"10718",2020-12-20,"Brush Creek Trailhead","w2021","Mechanized",1,"Sun","weekend","no_sled","Brush/Cement",NA,NA,NA,3.9,NA,21,-1,26,18.6,0,3,0,0,-1,2,2,2
"10719",2020-12-20,"Brush Creek Trailhead","w2021","Motorized",0,"Sun","weekend","sled","Brush/Cement",NA,NA,NA,3.9,NA,21,-1,26,18.6,0,3,0,0,-1,2,2,2
"10720",2020-12-20,"Brush Creek Trailhead","w2021","Hybrid",0,"Sun","weekend","sled","Brush/Cement",NA,NA,NA,3.9,NA,21,-1,26,18.6,0,3,0,0,-1,2,2,2
"10721",2020-12-21,"Brush Creek Trailhead","w2021","Non.motorized",23,"Mon","weekday","no_sled","Brush/Cement",NA,NA,NA,3.9,NA,20,-1,28,19.5,-1,0,3,0,-2,-2,1,1
"10722",2020-12-21,"Brush Creek Trailhead","w2021","Mechanized",0,"Mon","weekday","no_sled","Brush/Cement",NA,NA,NA,3.9,NA,20,-1,28,19.5,-1,0,3,0,-2,-2,1,1
"10723",2020-12-21,"Brush Creek Trailhead","w2021","Motorized",0,"Mon","weekday","sled","Brush/Cement",NA,NA,NA,3.9,NA,20,-1,28,19.5,-1,0,3,0,-2,-2,1,1
"10724",2020-12-21,"Brush Creek Trailhead","w2021","Hybrid",0,"Mon","weekday","sled","Brush/Cement",NA,NA,NA,3.9,NA,20,-1,28,19.5,-1,0,3,0,-2,-2,1,1
"10725",2020-12-22,"Brush Creek Trailhead","w2021","Non.motorized",15,"Tue","weekday","no_sled","Brush/Cement",NA,NA,NA,4,NA,20,0,24,20,-1,-1,0,3,-1,-2,-2,1
"10726",2020-12-22,"Brush Creek Trailhead","w2021","Mechanized",0,"Tue","weekday","no_sled","Brush/Cement",NA,NA,NA,4,NA,20,0,24,20,-1,-1,0,3,-1,-2,-2,1
"10727",2020-12-22,"Brush Creek Trailhead","w2021","Motorized",0,"Tue","weekday","sled","Brush/Cement",NA,NA,NA,4,NA,20,0,24,20,-1,-1,0,3,-1,-2,-2,1
"10728",2020-12-22,"Brush Creek Trailhead","w2021","Hybrid",0,"Tue","weekday","sled","Brush/Cement",NA,NA,NA,4,NA,20,0,24,20,-1,-1,0,3,-1,-2,-2,1
"10729",2020-12-23,"Brush Creek Trailhead","w2021","Non.motorized",3,"Wed","weekday","no_sled","Brush/Cement",NA,NA,NA,4.1,NA,22,2,6,18.6,0,-1,-1,0,2,1,0,0
"10730",2020-12-23,"Brush Creek Trailhead","w2021","Mechanized",0,"Wed","weekday","no_sled","Brush/Cement",NA,NA,NA,4.1,NA,22,2,6,18.6,0,-1,-1,0,2,1,0,0
"10731",2020-12-23,"Brush Creek Trailhead","w2021","Motorized",0,"Wed","weekday","sled","Brush/Cement",NA,NA,NA,4.1,NA,22,2,6,18.6,0,-1,-1,0,2,1,0,0
"10732",2020-12-23,"Brush Creek Trailhead","w2021","Hybrid",0,"Wed","weekday","sled","Brush/Cement",NA,NA,NA,4.1,NA,22,2,6,18.6,0,-1,-1,0,2,1,0,0
"10733",2020-12-24,"Brush Creek Trailhead","w2021","Non.motorized",26,"Thu","weekday","no_sled","Brush/Cement",NA,NA,NA,4.1,NA,21,-1,15,19.5,2,0,-1,-1,1,1,0,-1
"10734",2020-12-24,"Brush Creek Trailhead","w2021","Mechanized",0,"Thu","weekday","no_sled","Brush/Cement",NA,NA,NA,4.1,NA,21,-1,15,19.5,2,0,-1,-1,1,1,0,-1
"10735",2020-12-24,"Brush Creek Trailhead","w2021","Motorized",0,"Thu","weekday","sled","Brush/Cement",NA,NA,NA,4.1,NA,21,-1,15,19.5,2,0,-1,-1,1,1,0,-1
"10736",2020-12-24,"Brush Creek Trailhead","w2021","Hybrid",0,"Thu","weekday","sled","Brush/Cement",NA,NA,NA,4.1,NA,21,-1,15,19.5,2,0,-1,-1,1,1,0,-1
"10737",2020-12-25,"Brush Creek Trailhead","w2021","Non.motorized",10,"Fri","weekday","no_sled","Brush/Cement",NA,NA,NA,4.1,NA,20,-1,25,20.5,-1,2,0,-1,-2,0,0,-1
"10738",2020-12-25,"Brush Creek Trailhead","w2021","Mechanized",0,"Fri","weekday","no_sled","Brush/Cement",NA,NA,NA,4.1,NA,20,-1,25,20.5,-1,2,0,-1,-2,0,0,-1
"10739",2020-12-25,"Brush Creek Trailhead","w2021","Motorized",0,"Fri","weekday","sled","Brush/Cement",NA,NA,NA,4.1,NA,20,-1,25,20.5,-1,2,0,-1,-2,0,0,-1
"10740",2020-12-25,"Brush Creek Trailhead","w2021","Hybrid",0,"Fri","weekday","sled","Brush/Cement",NA,NA,NA,4.1,NA,20,-1,25,20.5,-1,2,0,-1,-2,0,0,-1
"10741",2020-12-26,"Brush Creek Trailhead","w2021","Non.motorized",47,"Sat","weekend","no_sled","Brush/Cement",NA,NA,NA,4.1,NA,20,0,26,20.5,-1,-1,2,0,-1,-2,0,0
"10742",2020-12-26,"Brush Creek Trailhead","w2021","Mechanized",0,"Sat","weekend","no_sled","Brush/Cement",NA,NA,NA,4.1,NA,20,0,26,20.5,-1,-1,2,0,-1,-2,0,0
"10743",2020-12-26,"Brush Creek Trailhead","w2021","Motorized",0,"Sat","weekend","sled","Brush/Cement",NA,NA,NA,4.1,NA,20,0,26,20.5,-1,-1,2,0,-1,-2,0,0
"10744",2020-12-26,"Brush Creek Trailhead","w2021","Hybrid",0,"Sat","weekend","sled","Brush/Cement",NA,NA,NA,4.1,NA,20,0,26,20.5,-1,-1,2,0,-1,-2,0,0
"10745",2020-12-27,"Brush Creek Trailhead","w2021","Non.motorized",17,"Sun","weekend","no_sled","Brush/Cement",NA,NA,NA,4.2,NA,19,-1,19,22.1,0,-1,-1,2,-1,-2,-3,-1
"10746",2020-12-27,"Brush Creek Trailhead","w2021","Mechanized",0,"Sun","weekend","no_sled","Brush/Cement",NA,NA,NA,4.2,NA,19,-1,19,22.1,0,-1,-1,2,-1,-2,-3,-1
"10747",2020-12-27,"Brush Creek Trailhead","w2021","Motorized",0,"Sun","weekend","sled","Brush/Cement",NA,NA,NA,4.2,NA,19,-1,19,22.1,0,-1,-1,2,-1,-2,-3,-1
"10748",2020-12-27,"Brush Creek Trailhead","w2021","Hybrid",0,"Sun","weekend","sled","Brush/Cement",NA,NA,NA,4.2,NA,19,-1,19,22.1,0,-1,-1,2,-1,-2,-3,-1
"10749",2020-12-28,"Brush Creek Trailhead","w2021","Non.motorized",5,"Mon","weekday","no_sled","Brush/Cement",NA,NA,NA,4.2,NA,20,1,22,21,-1,0,-1,-1,0,0,-1,-2
"10750",2020-12-28,"Brush Creek Trailhead","w2021","Mechanized",0,"Mon","weekday","no_sled","Brush/Cement",NA,NA,NA,4.2,NA,20,1,22,21,-1,0,-1,-1,0,0,-1,-2
"10751",2020-12-28,"Brush Creek Trailhead","w2021","Motorized",0,"Mon","weekday","sled","Brush/Cement",NA,NA,NA,4.2,NA,20,1,22,21,-1,0,-1,-1,0,0,-1,-2
"10752",2020-12-28,"Brush Creek Trailhead","w2021","Hybrid",0,"Mon","weekday","sled","Brush/Cement",NA,NA,NA,4.2,NA,20,1,22,21,-1,0,-1,-1,0,0,-1,-2
"10753",2020-12-29,"Brush Creek Trailhead","w2021","Non.motorized",29,"Tue","weekday","no_sled","Brush/Cement",NA,NA,NA,4.9,NA,27,7,15,18.1,1,-1,0,-1,8,7,7,6
"10754",2020-12-29,"Brush Creek Trailhead","w2021","Mechanized",0,"Tue","weekday","no_sled","Brush/Cement",NA,NA,NA,4.9,NA,27,7,15,18.1,1,-1,0,-1,8,7,7,6
"10755",2020-12-29,"Brush Creek Trailhead","w2021","Motorized",0,"Tue","weekday","sled","Brush/Cement",NA,NA,NA,4.9,NA,27,7,15,18.1,1,-1,0,-1,8,7,7,6
"10756",2020-12-29,"Brush Creek Trailhead","w2021","Hybrid",0,"Tue","weekday","sled","Brush/Cement",NA,NA,NA,4.9,NA,27,7,15,18.1,1,-1,0,-1,8,7,7,6
"10757",2020-12-30,"Brush Creek Trailhead","w2021","Non.motorized",31,"Wed","weekday","no_sled","Brush/Cement",NA,NA,NA,4.9,NA,26,-1,10,18.8,7,1,-1,0,6,7,6,6
"10758",2020-12-30,"Brush Creek Trailhead","w2021","Mechanized",2,"Wed","weekday","no_sled","Brush/Cement",NA,NA,NA,4.9,NA,26,-1,10,18.8,7,1,-1,0,6,7,6,6
"10759",2020-12-30,"Brush Creek Trailhead","w2021","Motorized",0,"Wed","weekday","sled","Brush/Cement",NA,NA,NA,4.9,NA,26,-1,10,18.8,7,1,-1,0,6,7,6,6
"10760",2020-12-30,"Brush Creek Trailhead","w2021","Hybrid",0,"Wed","weekday","sled","Brush/Cement",NA,NA,NA,4.9,NA,26,-1,10,18.8,7,1,-1,0,6,7,6,6
"10761",2020-12-31,"Brush Creek Trailhead","w2021","Non.motorized",41,"Thu","weekday","no_sled","Brush/Cement",NA,NA,NA,4.9,NA,25,-1,19,19.6,-1,7,1,-1,-2,5,6,5
"10762",2020-12-31,"Brush Creek Trailhead","w2021","Mechanized",1,"Thu","weekday","no_sled","Brush/Cement",NA,NA,NA,4.9,NA,25,-1,19,19.6,-1,7,1,-1,-2,5,6,5
"10763",2020-12-31,"Brush Creek Trailhead","w2021","Motorized",0,"Thu","weekday","sled","Brush/Cement",NA,NA,NA,4.9,NA,25,-1,19,19.6,-1,7,1,-1,-2,5,6,5
"10764",2020-12-31,"Brush Creek Trailhead","w2021","Hybrid",0,"Thu","weekday","sled","Brush/Cement",NA,NA,NA,4.9,NA,25,-1,19,19.6,-1,7,1,-1,-2,5,6,5
"10765",2021-01-01,"Brush Creek Trailhead","w2021","Non.motorized",39,"Fri","weekday","no_sled","Brush/Cement",NA,NA,NA,4.9,NA,24,-1,21,20.4,-1,-1,7,1,-2,-3,4,5
"10766",2021-01-01,"Brush Creek Trailhead","w2021","Mechanized",0,"Fri","weekday","no_sled","Brush/Cement",NA,NA,NA,4.9,NA,24,-1,21,20.4,-1,-1,7,1,-2,-3,4,5
"10767",2021-01-01,"Brush Creek Trailhead","w2021","Motorized",0,"Fri","weekday","sled","Brush/Cement",NA,NA,NA,4.9,NA,24,-1,21,20.4,-1,-1,7,1,-2,-3,4,5
"10768",2021-01-01,"Brush Creek Trailhead","w2021","Hybrid",0,"Fri","weekday","sled","Brush/Cement",NA,NA,NA,4.9,NA,24,-1,21,20.4,-1,-1,7,1,-2,-3,4,5
"10769",2021-01-02,"Brush Creek Trailhead","w2021","Non.motorized",33,"Sat","weekend","no_sled","Brush/Cement",NA,NA,NA,4.9,NA,23,-1,19,21.3,-1,-1,-1,7,-2,-3,-4,3
"10770",2021-01-02,"Brush Creek Trailhead","w2021","Mechanized",2,"Sat","weekend","no_sled","Brush/Cement",NA,NA,NA,4.9,NA,23,-1,19,21.3,-1,-1,-1,7,-2,-3,-4,3
"10771",2021-01-02,"Brush Creek Trailhead","w2021","Motorized",0,"Sat","weekend","sled","Brush/Cement",NA,NA,NA,4.9,NA,23,-1,19,21.3,-1,-1,-1,7,-2,-3,-4,3
"10772",2021-01-02,"Brush Creek Trailhead","w2021","Hybrid",0,"Sat","weekend","sled","Brush/Cement",NA,NA,NA,4.9,NA,23,-1,19,21.3,-1,-1,-1,7,-2,-3,-4,3
"10773",2021-01-03,"Brush Creek Trailhead","w2021","Non.motorized",40,"Sun","weekend","no_sled","Brush/Cement",NA,NA,NA,4.9,NA,23,0,21,21.3,-1,-1,-1,-1,-1,-2,-3,-4
"10774",2021-01-03,"Brush Creek Trailhead","w2021","Mechanized",1,"Sun","weekend","no_sled","Brush/Cement",NA,NA,NA,4.9,NA,23,0,21,21.3,-1,-1,-1,-1,-1,-2,-3,-4
"10775",2021-01-03,"Brush Creek Trailhead","w2021","Motorized",0,"Sun","weekend","sled","Brush/Cement",NA,NA,NA,4.9,NA,23,0,21,21.3,-1,-1,-1,-1,-1,-2,-3,-4
"10776",2021-01-03,"Brush Creek Trailhead","w2021","Hybrid",0,"Sun","weekend","sled","Brush/Cement",NA,NA,NA,4.9,NA,23,0,21,21.3,-1,-1,-1,-1,-1,-2,-3,-4
"10777",2021-01-04,"Brush Creek Trailhead","w2021","Non.motorized",13,"Mon","weekday","no_sled","Brush/Cement",NA,NA,NA,4.9,NA,22,-1,25,22.3,0,-1,-1,-1,-1,-2,-3,-4
"10778",2021-01-04,"Brush Creek Trailhead","w2021","Mechanized",0,"Mon","weekday","no_sled","Brush/Cement",NA,NA,NA,4.9,NA,22,-1,25,22.3,0,-1,-1,-1,-1,-2,-3,-4
"10779",2021-01-04,"Brush Creek Trailhead","w2021","Motorized",0,"Mon","weekday","sled","Brush/Cement",NA,NA,NA,4.9,NA,22,-1,25,22.3,0,-1,-1,-1,-1,-2,-3,-4
"10780",2021-01-04,"Brush Creek Trailhead","w2021","Hybrid",0,"Mon","weekday","sled","Brush/Cement",NA,NA,NA,4.9,NA,22,-1,25,22.3,0,-1,-1,-1,-1,-2,-3,-4
"10781",2021-01-05,"Brush Creek Trailhead","w2021","Non.motorized",6,"Tue","weekday","no_sled","Brush/Cement",NA,NA,NA,5,NA,22,0,23,22.7,-1,0,-1,-1,-1,-1,-2,-3
"10782",2021-01-05,"Brush Creek Trailhead","w2021","Mechanized",0,"Tue","weekday","no_sled","Brush/Cement",NA,NA,NA,5,NA,22,0,23,22.7,-1,0,-1,-1,-1,-1,-2,-3
"10783",2021-01-05,"Brush Creek Trailhead","w2021","Motorized",0,"Tue","weekday","sled","Brush/Cement",NA,NA,NA,5,NA,22,0,23,22.7,-1,0,-1,-1,-1,-1,-2,-3
"10784",2021-01-05,"Brush Creek Trailhead","w2021","Hybrid",0,"Tue","weekday","sled","Brush/Cement",NA,NA,NA,5,NA,22,0,23,22.7,-1,0,-1,-1,-1,-1,-2,-3
"10785",2021-01-06,"Brush Creek Trailhead","w2021","Non.motorized",11,"Wed","weekday","no_sled","Brush/Cement",NA,NA,NA,5.1,NA,24,2,18,21.2,0,-1,0,-1,2,1,1,0
"10786",2021-01-06,"Brush Creek Trailhead","w2021","Mechanized",0,"Wed","weekday","no_sled","Brush/Cement",NA,NA,NA,5.1,NA,24,2,18,21.2,0,-1,0,-1,2,1,1,0
"10787",2021-01-06,"Brush Creek Trailhead","w2021","Motorized",0,"Wed","weekday","sled","Brush/Cement",NA,NA,NA,5.1,NA,24,2,18,21.2,0,-1,0,-1,2,1,1,0
"10788",2021-01-06,"Brush Creek Trailhead","w2021","Hybrid",0,"Wed","weekday","sled","Brush/Cement",NA,NA,NA,5.1,NA,24,2,18,21.2,0,-1,0,-1,2,1,1,0
"10789",2021-01-07,"Brush Creek Trailhead","w2021","Non.motorized",15,"Thu","weekday","no_sled","Brush/Cement",NA,NA,NA,5.1,NA,24,0,23,21.2,2,0,-1,0,2,2,1,1
"10790",2021-01-07,"Brush Creek Trailhead","w2021","Mechanized",0,"Thu","weekday","no_sled","Brush/Cement",NA,NA,NA,5.1,NA,24,0,23,21.2,2,0,-1,0,2,2,1,1
"10791",2021-01-07,"Brush Creek Trailhead","w2021","Motorized",0,"Thu","weekday","sled","Brush/Cement",NA,NA,NA,5.1,NA,24,0,23,21.2,2,0,-1,0,2,2,1,1
"10792",2021-01-07,"Brush Creek Trailhead","w2021","Hybrid",0,"Thu","weekday","sled","Brush/Cement",NA,NA,NA,5.1,NA,24,0,23,21.2,2,0,-1,0,2,2,1,1
"10793",2021-01-08,"Brush Creek Trailhead","w2021","Non.motorized",15,"Fri","weekday","no_sled","Brush/Cement",NA,NA,NA,5.1,NA,23,-1,20,22.2,0,2,0,-1,-1,1,1,0
"10794",2021-01-08,"Brush Creek Trailhead","w2021","Mechanized",0,"Fri","weekday","no_sled","Brush/Cement",NA,NA,NA,5.1,NA,23,-1,20,22.2,0,2,0,-1,-1,1,1,0
"10795",2021-01-08,"Brush Creek Trailhead","w2021","Motorized",0,"Fri","weekday","sled","Brush/Cement",NA,NA,NA,5.1,NA,23,-1,20,22.2,0,2,0,-1,-1,1,1,0
"10796",2021-01-08,"Brush Creek Trailhead","w2021","Hybrid",0,"Fri","weekday","sled","Brush/Cement",NA,NA,NA,5.1,NA,23,-1,20,22.2,0,2,0,-1,-1,1,1,0
"10797",2021-01-09,"Brush Creek Trailhead","w2021","Non.motorized",22,"Sat","weekend","no_sled","Brush/Cement",NA,NA,NA,5.1,NA,23,0,19,22.2,-1,0,2,0,-1,-1,1,1
"10798",2021-01-09,"Brush Creek Trailhead","w2021","Mechanized",0,"Sat","weekend","no_sled","Brush/Cement",NA,NA,NA,5.1,NA,23,0,19,22.2,-1,0,2,0,-1,-1,1,1
"10799",2021-01-09,"Brush Creek Trailhead","w2021","Motorized",0,"Sat","weekend","sled","Brush/Cement",NA,NA,NA,5.1,NA,23,0,19,22.2,-1,0,2,0,-1,-1,1,1
"10800",2021-01-09,"Brush Creek Trailhead","w2021","Hybrid",0,"Sat","weekend","sled","Brush/Cement",NA,NA,NA,5.1,NA,23,0,19,22.2,-1,0,2,0,-1,-1,1,1
"10801",2021-01-10,"Brush Creek Trailhead","w2021","Non.motorized",27,"Sun","weekend","no_sled","Brush/Cement",NA,NA,NA,5.1,NA,23,0,14,22.2,0,-1,0,2,0,-1,-1,1
"10802",2021-01-10,"Brush Creek Trailhead","w2021","Mechanized",0,"Sun","weekend","no_sled","Brush/Cement",NA,NA,NA,5.1,NA,23,0,14,22.2,0,-1,0,2,0,-1,-1,1
"10803",2021-01-10,"Brush Creek Trailhead","w2021","Motorized",1,"Sun","weekend","sled","Brush/Cement",NA,NA,NA,5.1,NA,23,0,14,22.2,0,-1,0,2,0,-1,-1,1
"10804",2021-01-10,"Brush Creek Trailhead","w2021","Hybrid",0,"Sun","weekend","sled","Brush/Cement",NA,NA,NA,5.1,NA,23,0,14,22.2,0,-1,0,2,0,-1,-1,1
"10805",2021-01-11,"Brush Creek Trailhead","w2021","Non.motorized",19,"Mon","weekday","no_sled","Brush/Cement",NA,NA,NA,5.1,NA,23,0,15,22.2,0,0,-1,0,0,0,-1,-1
"10806",2021-01-11,"Brush Creek Trailhead","w2021","Mechanized",0,"Mon","weekday","no_sled","Brush/Cement",NA,NA,NA,5.1,NA,23,0,15,22.2,0,0,-1,0,0,0,-1,-1
"10807",2021-01-11,"Brush Creek Trailhead","w2021","Motorized",0,"Mon","weekday","sled","Brush/Cement",NA,NA,NA,5.1,NA,23,0,15,22.2,0,0,-1,0,0,0,-1,-1
"10808",2021-01-11,"Brush Creek Trailhead","w2021","Hybrid",0,"Mon","weekday","sled","Brush/Cement",NA,NA,NA,5.1,NA,23,0,15,22.2,0,0,-1,0,0,0,-1,-1
"10809",2021-01-12,"Brush Creek Trailhead","w2021","Non.motorized",15,"Tue","weekday","no_sled","Brush/Cement",NA,NA,NA,5.1,NA,23,0,23,22.2,0,0,0,-1,0,0,0,-1
"10810",2021-01-12,"Brush Creek Trailhead","w2021","Mechanized",0,"Tue","weekday","no_sled","Brush/Cement",NA,NA,NA,5.1,NA,23,0,23,22.2,0,0,0,-1,0,0,0,-1
"10811",2021-01-12,"Brush Creek Trailhead","w2021","Motorized",0,"Tue","weekday","sled","Brush/Cement",NA,NA,NA,5.1,NA,23,0,23,22.2,0,0,0,-1,0,0,0,-1
"10812",2021-01-12,"Brush Creek Trailhead","w2021","Hybrid",0,"Tue","weekday","sled","Brush/Cement",NA,NA,NA,5.1,NA,23,0,23,22.2,0,0,0,-1,0,0,0,-1
"10813",2021-01-13,"Brush Creek Trailhead","w2021","Non.motorized",15,"Wed","weekday","no_sled","Brush/Cement",NA,NA,NA,5.1,NA,23,0,28,22.2,0,0,0,0,0,0,0,0
"10814",2021-01-13,"Brush Creek Trailhead","w2021","Mechanized",0,"Wed","weekday","no_sled","Brush/Cement",NA,NA,NA,5.1,NA,23,0,28,22.2,0,0,0,0,0,0,0,0
"10815",2021-01-13,"Brush Creek Trailhead","w2021","Motorized",0,"Wed","weekday","sled","Brush/Cement",NA,NA,NA,5.1,NA,23,0,28,22.2,0,0,0,0,0,0,0,0
"10816",2021-01-13,"Brush Creek Trailhead","w2021","Hybrid",0,"Wed","weekday","sled","Brush/Cement",NA,NA,NA,5.1,NA,23,0,28,22.2,0,0,0,0,0,0,0,0
"10817",2021-01-14,"Brush Creek Trailhead","w2021","Non.motorized",17,"Thu","weekday","no_sled","Brush/Cement",NA,NA,NA,5.1,NA,22,-1,20,23.2,0,0,0,0,-1,-1,-1,-1
"10818",2021-01-14,"Brush Creek Trailhead","w2021","Mechanized",0,"Thu","weekday","no_sled","Brush/Cement",NA,NA,NA,5.1,NA,22,-1,20,23.2,0,0,0,0,-1,-1,-1,-1
"10819",2021-01-14,"Brush Creek Trailhead","w2021","Motorized",0,"Thu","weekday","sled","Brush/Cement",NA,NA,NA,5.1,NA,22,-1,20,23.2,0,0,0,0,-1,-1,-1,-1
"10820",2021-01-14,"Brush Creek Trailhead","w2021","Hybrid",0,"Thu","weekday","sled","Brush/Cement",NA,NA,NA,5.1,NA,22,-1,20,23.2,0,0,0,0,-1,-1,-1,-1
"10821",2021-01-15,"Brush Creek Trailhead","w2021","Non.motorized",21,"Fri","weekday","no_sled","Brush/Cement",NA,NA,NA,5.1,NA,22,0,26,23.2,-1,0,0,0,-1,-1,-1,-1
"10822",2021-01-15,"Brush Creek Trailhead","w2021","Mechanized",0,"Fri","weekday","no_sled","Brush/Cement",NA,NA,NA,5.1,NA,22,0,26,23.2,-1,0,0,0,-1,-1,-1,-1
"10823",2021-01-15,"Brush Creek Trailhead","w2021","Motorized",0,"Fri","weekday","sled","Brush/Cement",NA,NA,NA,5.1,NA,22,0,26,23.2,-1,0,0,0,-1,-1,-1,-1
"10824",2021-01-15,"Brush Creek Trailhead","w2021","Hybrid",0,"Fri","weekday","sled","Brush/Cement",NA,NA,NA,5.1,NA,22,0,26,23.2,-1,0,0,0,-1,-1,-1,-1
"10825",2021-01-16,"Brush Creek Trailhead","w2021","Non.motorized",11,"Sat","weekend","no_sled","Brush/Cement",NA,NA,NA,5.1,NA,22,0,26,23.2,0,-1,0,0,0,-1,-1,-1
"10826",2021-01-16,"Brush Creek Trailhead","w2021","Mechanized",1,"Sat","weekend","no_sled","Brush/Cement",NA,NA,NA,5.1,NA,22,0,26,23.2,0,-1,0,0,0,-1,-1,-1
"10827",2021-01-16,"Brush Creek Trailhead","w2021","Motorized",0,"Sat","weekend","sled","Brush/Cement",NA,NA,NA,5.1,NA,22,0,26,23.2,0,-1,0,0,0,-1,-1,-1
"10828",2021-01-16,"Brush Creek Trailhead","w2021","Hybrid",0,"Sat","weekend","sled","Brush/Cement",NA,NA,NA,5.1,NA,22,0,26,23.2,0,-1,0,0,0,-1,-1,-1
"10829",2021-01-17,"Brush Creek Trailhead","w2021","Non.motorized",31,"Sun","weekend","no_sled","Brush/Cement",NA,NA,NA,5.1,NA,22,0,29,23.2,0,0,-1,0,0,0,-1,-1
"10830",2021-01-17,"Brush Creek Trailhead","w2021","Mechanized",0,"Sun","weekend","no_sled","Brush/Cement",NA,NA,NA,5.1,NA,22,0,29,23.2,0,0,-1,0,0,0,-1,-1
"10831",2021-01-17,"Brush Creek Trailhead","w2021","Motorized",0,"Sun","weekend","sled","Brush/Cement",NA,NA,NA,5.1,NA,22,0,29,23.2,0,0,-1,0,0,0,-1,-1
"10832",2021-01-17,"Brush Creek Trailhead","w2021","Hybrid",0,"Sun","weekend","sled","Brush/Cement",NA,NA,NA,5.1,NA,22,0,29,23.2,0,0,-1,0,0,0,-1,-1
"10833",2021-01-18,"Brush Creek Trailhead","w2021","Non.motorized",15,"Mon","weekday","no_sled","Brush/Cement",NA,NA,NA,5.1,NA,22,0,24,23.2,0,0,0,-1,0,0,0,-1
"10834",2021-01-18,"Brush Creek Trailhead","w2021","Mechanized",2,"Mon","weekday","no_sled","Brush/Cement",NA,NA,NA,5.1,NA,22,0,24,23.2,0,0,0,-1,0,0,0,-1
"10835",2021-01-18,"Brush Creek Trailhead","w2021","Motorized",0,"Mon","weekday","sled","Brush/Cement",NA,NA,NA,5.1,NA,22,0,24,23.2,0,0,0,-1,0,0,0,-1
"10836",2021-01-18,"Brush Creek Trailhead","w2021","Hybrid",0,"Mon","weekday","sled","Brush/Cement",NA,NA,NA,5.1,NA,22,0,24,23.2,0,0,0,-1,0,0,0,-1
"10837",2021-01-19,"Brush Creek Trailhead","w2021","Non.motorized",17,"Tue","weekday","no_sled","Brush/Cement",NA,NA,NA,5.1,NA,22,0,19,23.2,0,0,0,0,0,0,0,0
"10838",2021-01-19,"Brush Creek Trailhead","w2021","Mechanized",1,"Tue","weekday","no_sled","Brush/Cement",NA,NA,NA,5.1,NA,22,0,19,23.2,0,0,0,0,0,0,0,0
"10839",2021-01-19,"Brush Creek Trailhead","w2021","Motorized",0,"Tue","weekday","sled","Brush/Cement",NA,NA,NA,5.1,NA,22,0,19,23.2,0,0,0,0,0,0,0,0
"10840",2021-01-19,"Brush Creek Trailhead","w2021","Hybrid",0,"Tue","weekday","sled","Brush/Cement",NA,NA,NA,5.1,NA,22,0,19,23.2,0,0,0,0,0,0,0,0
"10841",2021-01-20,"Brush Creek Trailhead","w2021","Non.motorized",14,"Wed","weekday","no_sled","Brush/Cement",NA,NA,NA,5.2,NA,23,1,26,22.6,0,0,0,0,1,1,1,1
"10842",2021-01-20,"Brush Creek Trailhead","w2021","Mechanized",0,"Wed","weekday","no_sled","Brush/Cement",NA,NA,NA,5.2,NA,23,1,26,22.6,0,0,0,0,1,1,1,1
"10843",2021-01-20,"Brush Creek Trailhead","w2021","Motorized",0,"Wed","weekday","sled","Brush/Cement",NA,NA,NA,5.2,NA,23,1,26,22.6,0,0,0,0,1,1,1,1
"10844",2021-01-20,"Brush Creek Trailhead","w2021","Hybrid",0,"Wed","weekday","sled","Brush/Cement",NA,NA,NA,5.2,NA,23,1,26,22.6,0,0,0,0,1,1,1,1
"10845",2021-01-21,"Brush Creek Trailhead","w2021","Non.motorized",5,"Thu","weekday","no_sled","Brush/Cement",NA,NA,NA,5.2,NA,23,0,26,22.6,1,0,0,0,1,1,1,1
"10846",2021-01-21,"Brush Creek Trailhead","w2021","Mechanized",1,"Thu","weekday","no_sled","Brush/Cement",NA,NA,NA,5.2,NA,23,0,26,22.6,1,0,0,0,1,1,1,1
"10847",2021-01-21,"Brush Creek Trailhead","w2021","Motorized",0,"Thu","weekday","sled","Brush/Cement",NA,NA,NA,5.2,NA,23,0,26,22.6,1,0,0,0,1,1,1,1
"10848",2021-01-21,"Brush Creek Trailhead","w2021","Hybrid",0,"Thu","weekday","sled","Brush/Cement",NA,NA,NA,5.2,NA,23,0,26,22.6,1,0,0,0,1,1,1,1
"10849",2021-01-22,"Brush Creek Trailhead","w2021","Non.motorized",11,"Fri","weekday","no_sled","Brush/Cement",NA,NA,NA,5.3,NA,25,2,25,21.2,0,1,0,0,2,3,3,3
"10850",2021-01-22,"Brush Creek Trailhead","w2021","Mechanized",0,"Fri","weekday","no_sled","Brush/Cement",NA,NA,NA,5.3,NA,25,2,25,21.2,0,1,0,0,2,3,3,3
"10851",2021-01-22,"Brush Creek Trailhead","w2021","Motorized",0,"Fri","weekday","sled","Brush/Cement",NA,NA,NA,5.3,NA,25,2,25,21.2,0,1,0,0,2,3,3,3
"10852",2021-01-22,"Brush Creek Trailhead","w2021","Hybrid",0,"Fri","weekday","sled","Brush/Cement",NA,NA,NA,5.3,NA,25,2,25,21.2,0,1,0,0,2,3,3,3
"10853",2021-01-23,"Brush Creek Trailhead","w2021","Non.motorized",27,"Sat","weekend","no_sled","Brush/Cement",NA,NA,NA,5.4,NA,26,1,22,20.8,2,0,1,0,3,3,4,4
"10854",2021-01-23,"Brush Creek Trailhead","w2021","Mechanized",0,"Sat","weekend","no_sled","Brush/Cement",NA,NA,NA,5.4,NA,26,1,22,20.8,2,0,1,0,3,3,4,4
"10855",2021-01-23,"Brush Creek Trailhead","w2021","Motorized",0,"Sat","weekend","sled","Brush/Cement",NA,NA,NA,5.4,NA,26,1,22,20.8,2,0,1,0,3,3,4,4
"10856",2021-01-23,"Brush Creek Trailhead","w2021","Hybrid",0,"Sat","weekend","sled","Brush/Cement",NA,NA,NA,5.4,NA,26,1,22,20.8,2,0,1,0,3,3,4,4
"10857",2021-01-24,"Brush Creek Trailhead","w2021","Non.motorized",9,"Sun","weekend","no_sled","Brush/Cement",NA,NA,NA,5.6,NA,29,3,18,19.3,1,2,0,1,4,6,6,7
"10858",2021-01-24,"Brush Creek Trailhead","w2021","Mechanized",0,"Sun","weekend","no_sled","Brush/Cement",NA,NA,NA,5.6,NA,29,3,18,19.3,1,2,0,1,4,6,6,7
"10859",2021-01-24,"Brush Creek Trailhead","w2021","Motorized",0,"Sun","weekend","sled","Brush/Cement",NA,NA,NA,5.6,NA,29,3,18,19.3,1,2,0,1,4,6,6,7
"10860",2021-01-24,"Brush Creek Trailhead","w2021","Hybrid",0,"Sun","weekend","sled","Brush/Cement",NA,NA,NA,5.6,NA,29,3,18,19.3,1,2,0,1,4,6,6,7
"10861",2021-01-25,"Brush Creek Trailhead","w2021","Non.motorized",9,"Mon","weekday","no_sled","Brush/Cement",NA,NA,NA,5.8,NA,29,0,15,20,3,1,2,0,3,4,6,6
"10862",2021-01-25,"Brush Creek Trailhead","w2021","Mechanized",0,"Mon","weekday","no_sled","Brush/Cement",NA,NA,NA,5.8,NA,29,0,15,20,3,1,2,0,3,4,6,6
"10863",2021-01-25,"Brush Creek Trailhead","w2021","Motorized",0,"Mon","weekday","sled","Brush/Cement",NA,NA,NA,5.8,NA,29,0,15,20,3,1,2,0,3,4,6,6
"10864",2021-01-25,"Brush Creek Trailhead","w2021","Hybrid",0,"Mon","weekday","sled","Brush/Cement",NA,NA,NA,5.8,NA,29,0,15,20,3,1,2,0,3,4,6,6
"10865",2021-01-26,"Brush Creek Trailhead","w2021","Non.motorized",10,"Tue","weekday","no_sled","Brush/Cement",NA,NA,NA,5.9,NA,29,0,13,20.3,0,3,1,2,0,3,4,6
"10866",2021-01-26,"Brush Creek Trailhead","w2021","Mechanized",0,"Tue","weekday","no_sled","Brush/Cement",NA,NA,NA,5.9,NA,29,0,13,20.3,0,3,1,2,0,3,4,6
"10867",2021-01-26,"Brush Creek Trailhead","w2021","Motorized",0,"Tue","weekday","sled","Brush/Cement",NA,NA,NA,5.9,NA,29,0,13,20.3,0,3,1,2,0,3,4,6
"10868",2021-01-26,"Brush Creek Trailhead","w2021","Hybrid",0,"Tue","weekday","sled","Brush/Cement",NA,NA,NA,5.9,NA,29,0,13,20.3,0,3,1,2,0,3,4,6
"10869",2021-01-27,"Brush Creek Trailhead","w2021","Non.motorized",8,"Wed","weekday","no_sled","Brush/Cement",NA,NA,NA,6,NA,30,1,13,20,0,0,3,1,1,1,4,5
"10870",2021-01-27,"Brush Creek Trailhead","w2021","Mechanized",0,"Wed","weekday","no_sled","Brush/Cement",NA,NA,NA,6,NA,30,1,13,20,0,0,3,1,1,1,4,5
"10871",2021-01-27,"Brush Creek Trailhead","w2021","Motorized",0,"Wed","weekday","sled","Brush/Cement",NA,NA,NA,6,NA,30,1,13,20,0,0,3,1,1,1,4,5
"10872",2021-01-27,"Brush Creek Trailhead","w2021","Hybrid",0,"Wed","weekday","sled","Brush/Cement",NA,NA,NA,6,NA,30,1,13,20,0,0,3,1,1,1,4,5
"10873",2021-01-28,"Brush Creek Trailhead","w2021","Non.motorized",11,"Thu","weekday","no_sled","Brush/Cement",NA,NA,NA,6,NA,28,-2,27,21.4,1,0,0,3,-1,-1,-1,2
"10874",2021-01-28,"Brush Creek Trailhead","w2021","Mechanized",0,"Thu","weekday","no_sled","Brush/Cement",NA,NA,NA,6,NA,28,-2,27,21.4,1,0,0,3,-1,-1,-1,2
"10875",2021-01-28,"Brush Creek Trailhead","w2021","Motorized",0,"Thu","weekday","sled","Brush/Cement",NA,NA,NA,6,NA,28,-2,27,21.4,1,0,0,3,-1,-1,-1,2
"10876",2021-01-28,"Brush Creek Trailhead","w2021","Hybrid",0,"Thu","weekday","sled","Brush/Cement",NA,NA,NA,6,NA,28,-2,27,21.4,1,0,0,3,-1,-1,-1,2
"10877",2021-01-29,"Brush Creek Trailhead","w2021","Non.motorized",14,"Fri","weekday","no_sled","Brush/Cement",NA,NA,NA,6.1,NA,28,0,29,21.8,-2,1,0,0,-2,-1,-1,-1
"10878",2021-01-29,"Brush Creek Trailhead","w2021","Mechanized",0,"Fri","weekday","no_sled","Brush/Cement",NA,NA,NA,6.1,NA,28,0,29,21.8,-2,1,0,0,-2,-1,-1,-1
"10879",2021-01-29,"Brush Creek Trailhead","w2021","Motorized",0,"Fri","weekday","sled","Brush/Cement",NA,NA,NA,6.1,NA,28,0,29,21.8,-2,1,0,0,-2,-1,-1,-1
"10880",2021-01-29,"Brush Creek Trailhead","w2021","Hybrid",0,"Fri","weekday","sled","Brush/Cement",NA,NA,NA,6.1,NA,28,0,29,21.8,-2,1,0,0,-2,-1,-1,-1
"10881",2021-01-30,"Brush Creek Trailhead","w2021","Non.motorized",25,"Sat","weekend","no_sled","Brush/Cement",NA,NA,NA,6.2,NA,29,1,21,21.4,0,-2,1,0,1,-1,0,0
"10882",2021-01-30,"Brush Creek Trailhead","w2021","Mechanized",0,"Sat","weekend","no_sled","Brush/Cement",NA,NA,NA,6.2,NA,29,1,21,21.4,0,-2,1,0,1,-1,0,0
"10883",2021-01-30,"Brush Creek Trailhead","w2021","Motorized",0,"Sat","weekend","sled","Brush/Cement",NA,NA,NA,6.2,NA,29,1,21,21.4,0,-2,1,0,1,-1,0,0
"10884",2021-01-30,"Brush Creek Trailhead","w2021","Hybrid",0,"Sat","weekend","sled","Brush/Cement",NA,NA,NA,6.2,NA,29,1,21,21.4,0,-2,1,0,1,-1,0,0
"10885",2021-01-31,"Brush Creek Trailhead","w2021","Non.motorized",8,"Sun","weekend","no_sled","Brush/Cement",NA,NA,NA,6.3,NA,29,0,21,21.7,1,0,-2,1,1,1,-1,0
"10886",2021-01-31,"Brush Creek Trailhead","w2021","Mechanized",0,"Sun","weekend","no_sled","Brush/Cement",NA,NA,NA,6.3,NA,29,0,21,21.7,1,0,-2,1,1,1,-1,0
"10887",2021-01-31,"Brush Creek Trailhead","w2021","Motorized",0,"Sun","weekend","sled","Brush/Cement",NA,NA,NA,6.3,NA,29,0,21,21.7,1,0,-2,1,1,1,-1,0
"10888",2021-01-31,"Brush Creek Trailhead","w2021","Hybrid",0,"Sun","weekend","sled","Brush/Cement",NA,NA,NA,6.3,NA,29,0,21,21.7,1,0,-2,1,1,1,-1,0
"10889",2021-02-01,"Brush Creek Trailhead","w2021","Non.motorized",12,"Mon","weekday","no_sled","Brush/Cement",NA,NA,NA,6.3,NA,28,-1,30,22.5,0,1,0,-2,-1,0,0,-2
"10890",2021-02-01,"Brush Creek Trailhead","w2021","Mechanized",0,"Mon","weekday","no_sled","Brush/Cement",NA,NA,NA,6.3,NA,28,-1,30,22.5,0,1,0,-2,-1,0,0,-2
"10891",2021-02-01,"Brush Creek Trailhead","w2021","Motorized",0,"Mon","weekday","sled","Brush/Cement",NA,NA,NA,6.3,NA,28,-1,30,22.5,0,1,0,-2,-1,0,0,-2
"10892",2021-02-01,"Brush Creek Trailhead","w2021","Hybrid",0,"Mon","weekday","sled","Brush/Cement",NA,NA,NA,6.3,NA,28,-1,30,22.5,0,1,0,-2,-1,0,0,-2
"10893",2021-02-02,"Brush Creek Trailhead","w2021","Non.motorized",5,"Tue","weekday","no_sled","Brush/Cement",NA,NA,NA,6.3,NA,28,0,34,22.5,-1,0,1,0,-1,-1,0,0
"10894",2021-02-02,"Brush Creek Trailhead","w2021","Mechanized",0,"Tue","weekday","no_sled","Brush/Cement",NA,NA,NA,6.3,NA,28,0,34,22.5,-1,0,1,0,-1,-1,0,0
"10895",2021-02-02,"Brush Creek Trailhead","w2021","Motorized",0,"Tue","weekday","sled","Brush/Cement",NA,NA,NA,6.3,NA,28,0,34,22.5,-1,0,1,0,-1,-1,0,0
"10896",2021-02-02,"Brush Creek Trailhead","w2021","Hybrid",0,"Tue","weekday","sled","Brush/Cement",NA,NA,NA,6.3,NA,28,0,34,22.5,-1,0,1,0,-1,-1,0,0
"10897",2021-02-03,"Brush Creek Trailhead","w2021","Non.motorized",1,"Wed","weekday","no_sled","Brush/Cement",NA,NA,NA,6.3,NA,27,-1,30,23.3,0,-1,0,1,-1,-2,-2,-1
"10898",2021-02-03,"Brush Creek Trailhead","w2021","Mechanized",0,"Wed","weekday","no_sled","Brush/Cement",NA,NA,NA,6.3,NA,27,-1,30,23.3,0,-1,0,1,-1,-2,-2,-1
"10899",2021-02-03,"Brush Creek Trailhead","w2021","Motorized",0,"Wed","weekday","sled","Brush/Cement",NA,NA,NA,6.3,NA,27,-1,30,23.3,0,-1,0,1,-1,-2,-2,-1
"10900",2021-02-03,"Brush Creek Trailhead","w2021","Hybrid",0,"Wed","weekday","sled","Brush/Cement",NA,NA,NA,6.3,NA,27,-1,30,23.3,0,-1,0,1,-1,-2,-2,-1
"10901",2021-02-04,"Brush Creek Trailhead","w2021","Non.motorized",8,"Thu","weekday","no_sled","Brush/Cement",NA,NA,NA,7.2,NA,37,10,14,19.5,-1,0,-1,0,9,9,8,8
"10902",2021-02-04,"Brush Creek Trailhead","w2021","Mechanized",0,"Thu","weekday","no_sled","Brush/Cement",NA,NA,NA,7.2,NA,37,10,14,19.5,-1,0,-1,0,9,9,8,8
"10903",2021-02-04,"Brush Creek Trailhead","w2021","Motorized",0,"Thu","weekday","sled","Brush/Cement",NA,NA,NA,7.2,NA,37,10,14,19.5,-1,0,-1,0,9,9,8,8
"10904",2021-02-04,"Brush Creek Trailhead","w2021","Hybrid",0,"Thu","weekday","sled","Brush/Cement",NA,NA,NA,7.2,NA,37,10,14,19.5,-1,0,-1,0,9,9,8,8
"10905",2021-02-05,"Brush Creek Trailhead","w2021","Non.motorized",10,"Fri","weekday","no_sled","Brush/Cement",NA,NA,NA,7.2,NA,35,-2,16,20.6,10,-1,0,-1,8,7,7,6
"10906",2021-02-05,"Brush Creek Trailhead","w2021","Mechanized",0,"Fri","weekday","no_sled","Brush/Cement",NA,NA,NA,7.2,NA,35,-2,16,20.6,10,-1,0,-1,8,7,7,6
"10907",2021-02-05,"Brush Creek Trailhead","w2021","Motorized",0,"Fri","weekday","sled","Brush/Cement",NA,NA,NA,7.2,NA,35,-2,16,20.6,10,-1,0,-1,8,7,7,6
"10908",2021-02-05,"Brush Creek Trailhead","w2021","Hybrid",0,"Fri","weekday","sled","Brush/Cement",NA,NA,NA,7.2,NA,35,-2,16,20.6,10,-1,0,-1,8,7,7,6
"10909",2021-02-06,"Brush Creek Trailhead","w2021","Non.motorized",23,"Sat","weekend","no_sled","Brush/Cement",NA,NA,NA,7.5,NA,37,2,19,20.3,-2,10,-1,0,0,10,9,9
"10910",2021-02-06,"Brush Creek Trailhead","w2021","Mechanized",0,"Sat","weekend","no_sled","Brush/Cement",NA,NA,NA,7.5,NA,37,2,19,20.3,-2,10,-1,0,0,10,9,9
"10911",2021-02-06,"Brush Creek Trailhead","w2021","Motorized",0,"Sat","weekend","sled","Brush/Cement",NA,NA,NA,7.5,NA,37,2,19,20.3,-2,10,-1,0,0,10,9,9
"10912",2021-02-06,"Brush Creek Trailhead","w2021","Hybrid",0,"Sat","weekend","sled","Brush/Cement",NA,NA,NA,7.5,NA,37,2,19,20.3,-2,10,-1,0,0,10,9,9
"10913",2021-02-07,"Brush Creek Trailhead","w2021","Non.motorized",38,"Sun","weekend","no_sled","Brush/Cement",NA,NA,NA,7.5,NA,36,-1,24,20.8,2,-2,10,-1,1,-1,9,8
"10914",2021-02-07,"Brush Creek Trailhead","w2021","Mechanized",0,"Sun","weekend","no_sled","Brush/Cement",NA,NA,NA,7.5,NA,36,-1,24,20.8,2,-2,10,-1,1,-1,9,8
"10915",2021-02-07,"Brush Creek Trailhead","w2021","Motorized",0,"Sun","weekend","sled","Brush/Cement",NA,NA,NA,7.5,NA,36,-1,24,20.8,2,-2,10,-1,1,-1,9,8
"10916",2021-02-07,"Brush Creek Trailhead","w2021","Hybrid",0,"Sun","weekend","sled","Brush/Cement",NA,NA,NA,7.5,NA,36,-1,24,20.8,2,-2,10,-1,1,-1,9,8
"10917",2021-02-08,"Brush Creek Trailhead","w2021","Non.motorized",7,"Mon","weekday","no_sled","Brush/Cement",NA,NA,NA,7.6,NA,35,-1,28,21.7,-1,2,-2,10,-2,0,-2,8
"10918",2021-02-08,"Brush Creek Trailhead","w2021","Mechanized",0,"Mon","weekday","no_sled","Brush/Cement",NA,NA,NA,7.6,NA,35,-1,28,21.7,-1,2,-2,10,-2,0,-2,8
"10919",2021-02-08,"Brush Creek Trailhead","w2021","Motorized",0,"Mon","weekday","sled","Brush/Cement",NA,NA,NA,7.6,NA,35,-1,28,21.7,-1,2,-2,10,-2,0,-2,8
"10920",2021-02-08,"Brush Creek Trailhead","w2021","Hybrid",0,"Mon","weekday","sled","Brush/Cement",NA,NA,NA,7.6,NA,35,-1,28,21.7,-1,2,-2,10,-2,0,-2,8
"10921",2021-02-09,"Brush Creek Trailhead","w2021","Non.motorized",5,"Tue","weekday","no_sled","Brush/Cement",NA,NA,NA,7.6,NA,34,-1,28,22.4,-1,-1,2,-2,-2,-3,-1,-3
"10922",2021-02-09,"Brush Creek Trailhead","w2021","Mechanized",0,"Tue","weekday","no_sled","Brush/Cement",NA,NA,NA,7.6,NA,34,-1,28,22.4,-1,-1,2,-2,-2,-3,-1,-3
"10923",2021-02-09,"Brush Creek Trailhead","w2021","Motorized",0,"Tue","weekday","sled","Brush/Cement",NA,NA,NA,7.6,NA,34,-1,28,22.4,-1,-1,2,-2,-2,-3,-1,-3
"10924",2021-02-09,"Brush Creek Trailhead","w2021","Hybrid",0,"Tue","weekday","sled","Brush/Cement",NA,NA,NA,7.6,NA,34,-1,28,22.4,-1,-1,2,-2,-2,-3,-1,-3
"10925",2021-02-10,"Brush Creek Trailhead","w2021","Non.motorized",12,"Wed","weekday","no_sled","Brush/Cement",NA,NA,NA,7.7,NA,34,0,26,22.6,-1,-1,-1,2,-1,-2,-3,-1
"10926",2021-02-10,"Brush Creek Trailhead","w2021","Mechanized",0,"Wed","weekday","no_sled","Brush/Cement",NA,NA,NA,7.7,NA,34,0,26,22.6,-1,-1,-1,2,-1,-2,-3,-1
"10927",2021-02-10,"Brush Creek Trailhead","w2021","Motorized",0,"Wed","weekday","sled","Brush/Cement",NA,NA,NA,7.7,NA,34,0,26,22.6,-1,-1,-1,2,-1,-2,-3,-1
"10928",2021-02-10,"Brush Creek Trailhead","w2021","Hybrid",0,"Wed","weekday","sled","Brush/Cement",NA,NA,NA,7.7,NA,34,0,26,22.6,-1,-1,-1,2,-1,-2,-3,-1
"10929",2021-02-11,"Brush Creek Trailhead","w2021","Non.motorized",12,"Thu","weekday","no_sled","Brush/Cement",NA,NA,NA,8,NA,37,3,26,21.6,0,-1,-1,-1,3,2,1,0
"10930",2021-02-11,"Brush Creek Trailhead","w2021","Mechanized",0,"Thu","weekday","no_sled","Brush/Cement",NA,NA,NA,8,NA,37,3,26,21.6,0,-1,-1,-1,3,2,1,0
"10931",2021-02-11,"Brush Creek Trailhead","w2021","Motorized",0,"Thu","weekday","sled","Brush/Cement",NA,NA,NA,8,NA,37,3,26,21.6,0,-1,-1,-1,3,2,1,0
"10932",2021-02-11,"Brush Creek Trailhead","w2021","Hybrid",0,"Thu","weekday","sled","Brush/Cement",NA,NA,NA,8,NA,37,3,26,21.6,0,-1,-1,-1,3,2,1,0
"10933",2021-02-12,"Brush Creek Trailhead","w2021","Non.motorized",6,"Fri","weekday","no_sled","Brush/Cement",NA,NA,NA,8.1,NA,37,0,27,21.9,3,0,-1,-1,3,3,2,1
"10934",2021-02-12,"Brush Creek Trailhead","w2021","Mechanized",0,"Fri","weekday","no_sled","Brush/Cement",NA,NA,NA,8.1,NA,37,0,27,21.9,3,0,-1,-1,3,3,2,1
"10935",2021-02-12,"Brush Creek Trailhead","w2021","Motorized",0,"Fri","weekday","sled","Brush/Cement",NA,NA,NA,8.1,NA,37,0,27,21.9,3,0,-1,-1,3,3,2,1
"10936",2021-02-12,"Brush Creek Trailhead","w2021","Hybrid",0,"Fri","weekday","sled","Brush/Cement",NA,NA,NA,8.1,NA,37,0,27,21.9,3,0,-1,-1,3,3,2,1
"10937",2021-02-13,"Brush Creek Trailhead","w2021","Non.motorized",17,"Sat","weekend","no_sled","Brush/Cement",NA,NA,NA,8.4,NA,38,1,26,22.1,0,3,0,-1,1,4,4,3
"10938",2021-02-13,"Brush Creek Trailhead","w2021","Mechanized",0,"Sat","weekend","no_sled","Brush/Cement",NA,NA,NA,8.4,NA,38,1,26,22.1,0,3,0,-1,1,4,4,3
"10939",2021-02-13,"Brush Creek Trailhead","w2021","Motorized",0,"Sat","weekend","sled","Brush/Cement",NA,NA,NA,8.4,NA,38,1,26,22.1,0,3,0,-1,1,4,4,3
"10940",2021-02-13,"Brush Creek Trailhead","w2021","Hybrid",0,"Sat","weekend","sled","Brush/Cement",NA,NA,NA,8.4,NA,38,1,26,22.1,0,3,0,-1,1,4,4,3
"10941",2021-02-14,"Brush Creek Trailhead","w2021","Non.motorized",14,"Sun","weekend","no_sled","Brush/Cement",NA,NA,NA,8.9,NA,43,5,18,20.7,1,0,3,0,6,6,9,9
"10942",2021-02-14,"Brush Creek Trailhead","w2021","Mechanized",0,"Sun","weekend","no_sled","Brush/Cement",NA,NA,NA,8.9,NA,43,5,18,20.7,1,0,3,0,6,6,9,9
"10943",2021-02-14,"Brush Creek Trailhead","w2021","Motorized",0,"Sun","weekend","sled","Brush/Cement",NA,NA,NA,8.9,NA,43,5,18,20.7,1,0,3,0,6,6,9,9
"10944",2021-02-14,"Brush Creek Trailhead","w2021","Hybrid",0,"Sun","weekend","sled","Brush/Cement",NA,NA,NA,8.9,NA,43,5,18,20.7,1,0,3,0,6,6,9,9
"10945",2021-02-15,"Brush Creek Trailhead","w2021","Non.motorized",10,"Mon","weekday","no_sled","Brush/Cement",NA,NA,NA,8.9,NA,43,0,12,20.7,5,1,0,3,5,6,6,9
"10946",2021-02-15,"Brush Creek Trailhead","w2021","Mechanized",0,"Mon","weekday","no_sled","Brush/Cement",NA,NA,NA,8.9,NA,43,0,12,20.7,5,1,0,3,5,6,6,9
"10947",2021-02-15,"Brush Creek Trailhead","w2021","Motorized",0,"Mon","weekday","sled","Brush/Cement",NA,NA,NA,8.9,NA,43,0,12,20.7,5,1,0,3,5,6,6,9
"10948",2021-02-15,"Brush Creek Trailhead","w2021","Hybrid",0,"Mon","weekday","sled","Brush/Cement",NA,NA,NA,8.9,NA,43,0,12,20.7,5,1,0,3,5,6,6,9
"10949",2021-02-16,"Brush Creek Trailhead","w2021","Non.motorized",5,"Tue","weekday","no_sled","Brush/Cement",NA,NA,NA,9,NA,41,-2,17,22,0,5,1,0,-2,3,4,4
"10950",2021-02-16,"Brush Creek Trailhead","w2021","Mechanized",0,"Tue","weekday","no_sled","Brush/Cement",NA,NA,NA,9,NA,41,-2,17,22,0,5,1,0,-2,3,4,4
"10951",2021-02-16,"Brush Creek Trailhead","w2021","Motorized",0,"Tue","weekday","sled","Brush/Cement",NA,NA,NA,9,NA,41,-2,17,22,0,5,1,0,-2,3,4,4
"10952",2021-02-16,"Brush Creek Trailhead","w2021","Hybrid",0,"Tue","weekday","sled","Brush/Cement",NA,NA,NA,9,NA,41,-2,17,22,0,5,1,0,-2,3,4,4
"10953",2021-02-17,"Brush Creek Trailhead","w2021","Non.motorized",8,"Wed","weekday","no_sled","Brush/Cement",NA,NA,NA,9.1,NA,42,1,13,21.7,-2,0,5,1,-1,-1,4,5
"10954",2021-02-17,"Brush Creek Trailhead","w2021","Mechanized",0,"Wed","weekday","no_sled","Brush/Cement",NA,NA,NA,9.1,NA,42,1,13,21.7,-2,0,5,1,-1,-1,4,5
"10955",2021-02-17,"Brush Creek Trailhead","w2021","Motorized",0,"Wed","weekday","sled","Brush/Cement",NA,NA,NA,9.1,NA,42,1,13,21.7,-2,0,5,1,-1,-1,4,5
"10956",2021-02-17,"Brush Creek Trailhead","w2021","Hybrid",0,"Wed","weekday","sled","Brush/Cement",NA,NA,NA,9.1,NA,42,1,13,21.7,-2,0,5,1,-1,-1,4,5
"10957",2021-02-18,"Brush Creek Trailhead","w2021","Non.motorized",11,"Thu","weekday","no_sled","Brush/Cement",NA,NA,NA,9.1,NA,41,-1,11,22.2,1,-2,0,5,0,-2,-2,3
"10958",2021-02-18,"Brush Creek Trailhead","w2021","Mechanized",0,"Thu","weekday","no_sled","Brush/Cement",NA,NA,NA,9.1,NA,41,-1,11,22.2,1,-2,0,5,0,-2,-2,3
"10959",2021-02-18,"Brush Creek Trailhead","w2021","Motorized",0,"Thu","weekday","sled","Brush/Cement",NA,NA,NA,9.1,NA,41,-1,11,22.2,1,-2,0,5,0,-2,-2,3
"10960",2021-02-18,"Brush Creek Trailhead","w2021","Hybrid",0,"Thu","weekday","sled","Brush/Cement",NA,NA,NA,9.1,NA,41,-1,11,22.2,1,-2,0,5,0,-2,-2,3
"10961",2021-02-19,"Brush Creek Trailhead","w2021","Non.motorized",11,"Fri","weekday","no_sled","Brush/Cement",NA,NA,NA,9.1,NA,40,-1,18,22.8,-1,1,-2,0,-2,-1,-3,-3
"10962",2021-02-19,"Brush Creek Trailhead","w2021","Mechanized",0,"Fri","weekday","no_sled","Brush/Cement",NA,NA,NA,9.1,NA,40,-1,18,22.8,-1,1,-2,0,-2,-1,-3,-3
"10963",2021-02-19,"Brush Creek Trailhead","w2021","Motorized",0,"Fri","weekday","sled","Brush/Cement",NA,NA,NA,9.1,NA,40,-1,18,22.8,-1,1,-2,0,-2,-1,-3,-3
"10964",2021-02-19,"Brush Creek Trailhead","w2021","Hybrid",0,"Fri","weekday","sled","Brush/Cement",NA,NA,NA,9.1,NA,40,-1,18,22.8,-1,1,-2,0,-2,-1,-3,-3
"10965",2021-02-20,"Brush Creek Trailhead","w2021","Non.motorized",18,"Sat","weekend","no_sled","Brush/Cement",NA,NA,NA,9.2,NA,39,-1,23,23.6,-1,-1,1,-2,-2,-3,-2,-4
"10966",2021-02-20,"Brush Creek Trailhead","w2021","Mechanized",0,"Sat","weekend","no_sled","Brush/Cement",NA,NA,NA,9.2,NA,39,-1,23,23.6,-1,-1,1,-2,-2,-3,-2,-4
"10967",2021-02-20,"Brush Creek Trailhead","w2021","Motorized",0,"Sat","weekend","sled","Brush/Cement",NA,NA,NA,9.2,NA,39,-1,23,23.6,-1,-1,1,-2,-2,-3,-2,-4
"10968",2021-02-20,"Brush Creek Trailhead","w2021","Hybrid",0,"Sat","weekend","sled","Brush/Cement",NA,NA,NA,9.2,NA,39,-1,23,23.6,-1,-1,1,-2,-2,-3,-2,-4
"10969",2021-02-21,"Brush Creek Trailhead","w2021","Non.motorized",35,"Sun","weekend","no_sled","Brush/Cement",NA,NA,NA,9.2,NA,39,0,15,23.6,-1,-1,-1,1,-1,-2,-3,-2
"10970",2021-02-21,"Brush Creek Trailhead","w2021","Mechanized",0,"Sun","weekend","no_sled","Brush/Cement",NA,NA,NA,9.2,NA,39,0,15,23.6,-1,-1,-1,1,-1,-2,-3,-2
"10971",2021-02-21,"Brush Creek Trailhead","w2021","Motorized",0,"Sun","weekend","sled","Brush/Cement",NA,NA,NA,9.2,NA,39,0,15,23.6,-1,-1,-1,1,-1,-2,-3,-2
"10972",2021-02-21,"Brush Creek Trailhead","w2021","Hybrid",0,"Sun","weekend","sled","Brush/Cement",NA,NA,NA,9.2,NA,39,0,15,23.6,-1,-1,-1,1,-1,-2,-3,-2
"10973",2021-02-22,"Brush Creek Trailhead","w2021","Non.motorized",16,"Mon","weekday","no_sled","Brush/Cement",NA,NA,NA,9.2,NA,39,0,23,23.6,0,-1,-1,-1,0,-1,-2,-3
"10974",2021-02-22,"Brush Creek Trailhead","w2021","Mechanized",0,"Mon","weekday","no_sled","Brush/Cement",NA,NA,NA,9.2,NA,39,0,23,23.6,0,-1,-1,-1,0,-1,-2,-3
"10975",2021-02-22,"Brush Creek Trailhead","w2021","Motorized",0,"Mon","weekday","sled","Brush/Cement",NA,NA,NA,9.2,NA,39,0,23,23.6,0,-1,-1,-1,0,-1,-2,-3
"10976",2021-02-22,"Brush Creek Trailhead","w2021","Hybrid",0,"Mon","weekday","sled","Brush/Cement",NA,NA,NA,9.2,NA,39,0,23,23.6,0,-1,-1,-1,0,-1,-2,-3
"10977",2021-02-23,"Brush Creek Trailhead","w2021","Non.motorized",12,"Tue","weekday","no_sled","Brush/Cement",NA,NA,NA,9.2,NA,38,-1,28,24.2,0,0,-1,-1,-1,-1,-2,-3
"10978",2021-02-23,"Brush Creek Trailhead","w2021","Mechanized",0,"Tue","weekday","no_sled","Brush/Cement",NA,NA,NA,9.2,NA,38,-1,28,24.2,0,0,-1,-1,-1,-1,-2,-3
"10979",2021-02-23,"Brush Creek Trailhead","w2021","Motorized",0,"Tue","weekday","sled","Brush/Cement",NA,NA,NA,9.2,NA,38,-1,28,24.2,0,0,-1,-1,-1,-1,-2,-3
"10980",2021-02-23,"Brush Creek Trailhead","w2021","Hybrid",0,"Tue","weekday","sled","Brush/Cement",NA,NA,NA,9.2,NA,38,-1,28,24.2,0,0,-1,-1,-1,-1,-2,-3
"10981",2021-02-24,"Brush Creek Trailhead","w2021","Non.motorized",5,"Wed","weekday","no_sled","Brush/Cement",NA,NA,NA,9.2,NA,38,0,23,24.2,-1,0,0,-1,-1,-1,-1,-2
"10982",2021-02-24,"Brush Creek Trailhead","w2021","Mechanized",0,"Wed","weekday","no_sled","Brush/Cement",NA,NA,NA,9.2,NA,38,0,23,24.2,-1,0,0,-1,-1,-1,-1,-2
"10983",2021-02-24,"Brush Creek Trailhead","w2021","Motorized",0,"Wed","weekday","sled","Brush/Cement",NA,NA,NA,9.2,NA,38,0,23,24.2,-1,0,0,-1,-1,-1,-1,-2
"10984",2021-02-24,"Brush Creek Trailhead","w2021","Hybrid",0,"Wed","weekday","sled","Brush/Cement",NA,NA,NA,9.2,NA,38,0,23,24.2,-1,0,0,-1,-1,-1,-1,-2
"10985",2021-02-25,"Brush Creek Trailhead","w2021","Non.motorized",30,"Thu","weekday","no_sled","Brush/Cement",NA,NA,NA,9.2,NA,37,-1,20,24.9,0,-1,0,0,-1,-2,-2,-2
"10986",2021-02-25,"Brush Creek Trailhead","w2021","Mechanized",0,"Thu","weekday","no_sled","Brush/Cement",NA,NA,NA,9.2,NA,37,-1,20,24.9,0,-1,0,0,-1,-2,-2,-2
"10987",2021-02-25,"Brush Creek Trailhead","w2021","Motorized",0,"Thu","weekday","sled","Brush/Cement",NA,NA,NA,9.2,NA,37,-1,20,24.9,0,-1,0,0,-1,-2,-2,-2
"10988",2021-02-25,"Brush Creek Trailhead","w2021","Hybrid",0,"Thu","weekday","sled","Brush/Cement",NA,NA,NA,9.2,NA,37,-1,20,24.9,0,-1,0,0,-1,-2,-2,-2
"10989",2021-02-26,"Brush Creek Trailhead","w2021","Non.motorized",25,"Fri","weekday","no_sled","Brush/Cement",NA,NA,NA,9.2,NA,37,0,21,24.9,-1,0,-1,0,-1,-1,-2,-2
"10990",2021-02-26,"Brush Creek Trailhead","w2021","Mechanized",0,"Fri","weekday","no_sled","Brush/Cement",NA,NA,NA,9.2,NA,37,0,21,24.9,-1,0,-1,0,-1,-1,-2,-2
"10991",2021-02-26,"Brush Creek Trailhead","w2021","Motorized",0,"Fri","weekday","sled","Brush/Cement",NA,NA,NA,9.2,NA,37,0,21,24.9,-1,0,-1,0,-1,-1,-2,-2
"10992",2021-02-26,"Brush Creek Trailhead","w2021","Hybrid",0,"Fri","weekday","sled","Brush/Cement",NA,NA,NA,9.2,NA,37,0,21,24.9,-1,0,-1,0,-1,-1,-2,-2
"10993",2021-02-27,"Brush Creek Trailhead","w2021","Non.motorized",14,"Sat","weekend","no_sled","Brush/Cement",NA,NA,NA,9.2,NA,37,0,15,24.9,0,-1,0,-1,0,-1,-1,-2
"10994",2021-02-27,"Brush Creek Trailhead","w2021","Mechanized",0,"Sat","weekend","no_sled","Brush/Cement",NA,NA,NA,9.2,NA,37,0,15,24.9,0,-1,0,-1,0,-1,-1,-2
"10995",2021-02-27,"Brush Creek Trailhead","w2021","Motorized",0,"Sat","weekend","sled","Brush/Cement",NA,NA,NA,9.2,NA,37,0,15,24.9,0,-1,0,-1,0,-1,-1,-2
"10996",2021-02-27,"Brush Creek Trailhead","w2021","Hybrid",0,"Sat","weekend","sled","Brush/Cement",NA,NA,NA,9.2,NA,37,0,15,24.9,0,-1,0,-1,0,-1,-1,-2
"10997",2021-02-28,"Brush Creek Trailhead","w2021","Non.motorized",16,"Sun","weekend","no_sled","Brush/Cement",NA,NA,NA,9.2,NA,38,1,9,24.2,0,0,-1,0,1,1,0,0
"10998",2021-02-28,"Brush Creek Trailhead","w2021","Mechanized",0,"Sun","weekend","no_sled","Brush/Cement",NA,NA,NA,9.2,NA,38,1,9,24.2,0,0,-1,0,1,1,0,0
"10999",2021-02-28,"Brush Creek Trailhead","w2021","Motorized",0,"Sun","weekend","sled","Brush/Cement",NA,NA,NA,9.2,NA,38,1,9,24.2,0,0,-1,0,1,1,0,0
"11000",2021-02-28,"Brush Creek Trailhead","w2021","Hybrid",0,"Sun","weekend","sled","Brush/Cement",NA,NA,NA,9.2,NA,38,1,9,24.2,0,0,-1,0,1,1,0,0
"11001",2021-03-01,"Brush Creek Trailhead","w2021","Non.motorized",11,"Mon","weekday","no_sled","Brush/Cement",NA,NA,NA,9.2,NA,37,-1,20,24.9,1,0,0,-1,0,0,0,-1
"11002",2021-03-01,"Brush Creek Trailhead","w2021","Mechanized",0,"Mon","weekday","no_sled","Brush/Cement",NA,NA,NA,9.2,NA,37,-1,20,24.9,1,0,0,-1,0,0,0,-1
"11003",2021-03-01,"Brush Creek Trailhead","w2021","Motorized",0,"Mon","weekday","sled","Brush/Cement",NA,NA,NA,9.2,NA,37,-1,20,24.9,1,0,0,-1,0,0,0,-1
"11004",2021-03-01,"Brush Creek Trailhead","w2021","Hybrid",0,"Mon","weekday","sled","Brush/Cement",NA,NA,NA,9.2,NA,37,-1,20,24.9,1,0,0,-1,0,0,0,-1
"11005",2021-03-02,"Brush Creek Trailhead","w2021","Non.motorized",8,"Tue","weekday","no_sled","Brush/Cement",NA,NA,NA,9.2,NA,36,-1,27,25.6,-1,1,0,0,-2,-1,-1,-1
"11006",2021-03-02,"Brush Creek Trailhead","w2021","Mechanized",0,"Tue","weekday","no_sled","Brush/Cement",NA,NA,NA,9.2,NA,36,-1,27,25.6,-1,1,0,0,-2,-1,-1,-1
"11007",2021-03-02,"Brush Creek Trailhead","w2021","Motorized",0,"Tue","weekday","sled","Brush/Cement",NA,NA,NA,9.2,NA,36,-1,27,25.6,-1,1,0,0,-2,-1,-1,-1
"11008",2021-03-02,"Brush Creek Trailhead","w2021","Hybrid",0,"Tue","weekday","sled","Brush/Cement",NA,NA,NA,9.2,NA,36,-1,27,25.6,-1,1,0,0,-2,-1,-1,-1
"11009",2021-03-03,"Brush Creek Trailhead","w2021","Non.motorized",9,"Wed","weekday","no_sled","Brush/Cement",NA,NA,NA,9.2,NA,36,0,31,25.6,-1,-1,1,0,-1,-2,-1,-1
"11010",2021-03-03,"Brush Creek Trailhead","w2021","Mechanized",0,"Wed","weekday","no_sled","Brush/Cement",NA,NA,NA,9.2,NA,36,0,31,25.6,-1,-1,1,0,-1,-2,-1,-1
"11011",2021-03-03,"Brush Creek Trailhead","w2021","Motorized",0,"Wed","weekday","sled","Brush/Cement",NA,NA,NA,9.2,NA,36,0,31,25.6,-1,-1,1,0,-1,-2,-1,-1
"11012",2021-03-03,"Brush Creek Trailhead","w2021","Hybrid",0,"Wed","weekday","sled","Brush/Cement",NA,NA,NA,9.2,NA,36,0,31,25.6,-1,-1,1,0,-1,-2,-1,-1
"11013",2021-03-04,"Brush Creek Trailhead","w2021","Non.motorized",7,"Thu","weekday","no_sled","Brush/Cement",NA,NA,NA,9.2,NA,36,0,28,25.6,0,-1,-1,1,0,-1,-2,-1
"11014",2021-03-04,"Brush Creek Trailhead","w2021","Mechanized",0,"Thu","weekday","no_sled","Brush/Cement",NA,NA,NA,9.2,NA,36,0,28,25.6,0,-1,-1,1,0,-1,-2,-1
"11015",2021-03-04,"Brush Creek Trailhead","w2021","Motorized",0,"Thu","weekday","sled","Brush/Cement",NA,NA,NA,9.2,NA,36,0,28,25.6,0,-1,-1,1,0,-1,-2,-1
"11016",2021-03-04,"Brush Creek Trailhead","w2021","Hybrid",0,"Thu","weekday","sled","Brush/Cement",NA,NA,NA,9.2,NA,36,0,28,25.6,0,-1,-1,1,0,-1,-2,-1
"11017",2021-03-05,"Brush Creek Trailhead","w2021","Non.motorized",14,"Fri","weekday","no_sled","Brush/Cement",NA,NA,NA,9.4,NA,39,3,30,24.1,0,0,-1,-1,3,3,2,1
"11018",2021-03-05,"Brush Creek Trailhead","w2021","Mechanized",1,"Fri","weekday","no_sled","Brush/Cement",NA,NA,NA,9.4,NA,39,3,30,24.1,0,0,-1,-1,3,3,2,1
"11019",2021-03-05,"Brush Creek Trailhead","w2021","Motorized",0,"Fri","weekday","sled","Brush/Cement",NA,NA,NA,9.4,NA,39,3,30,24.1,0,0,-1,-1,3,3,2,1
"11020",2021-03-05,"Brush Creek Trailhead","w2021","Hybrid",0,"Fri","weekday","sled","Brush/Cement",NA,NA,NA,9.4,NA,39,3,30,24.1,0,0,-1,-1,3,3,2,1
"11021",2021-03-06,"Brush Creek Trailhead","w2021","Non.motorized",22,"Sat","weekend","no_sled","Brush/Cement",NA,NA,NA,9.4,NA,38,-1,32,24.7,3,0,0,-1,2,2,2,1
"11022",2021-03-06,"Brush Creek Trailhead","w2021","Mechanized",0,"Sat","weekend","no_sled","Brush/Cement",NA,NA,NA,9.4,NA,38,-1,32,24.7,3,0,0,-1,2,2,2,1
"11023",2021-03-06,"Brush Creek Trailhead","w2021","Motorized",0,"Sat","weekend","sled","Brush/Cement",NA,NA,NA,9.4,NA,38,-1,32,24.7,3,0,0,-1,2,2,2,1
"11024",2021-03-06,"Brush Creek Trailhead","w2021","Hybrid",0,"Sat","weekend","sled","Brush/Cement",NA,NA,NA,9.4,NA,38,-1,32,24.7,3,0,0,-1,2,2,2,1
"11025",2021-03-07,"Brush Creek Trailhead","w2021","Non.motorized",13,"Sun","weekend","no_sled","Brush/Cement",NA,NA,NA,9.4,NA,37,-1,35,25.4,-1,3,0,0,-2,1,1,1
"11026",2021-03-07,"Brush Creek Trailhead","w2021","Mechanized",0,"Sun","weekend","no_sled","Brush/Cement",NA,NA,NA,9.4,NA,37,-1,35,25.4,-1,3,0,0,-2,1,1,1
"11027",2021-03-07,"Brush Creek Trailhead","w2021","Motorized",0,"Sun","weekend","sled","Brush/Cement",NA,NA,NA,9.4,NA,37,-1,35,25.4,-1,3,0,0,-2,1,1,1
"11028",2021-03-07,"Brush Creek Trailhead","w2021","Hybrid",0,"Sun","weekend","sled","Brush/Cement",NA,NA,NA,9.4,NA,37,-1,35,25.4,-1,3,0,0,-2,1,1,1
"11029",2021-03-08,"Brush Creek Trailhead","w2021","Non.motorized",9,"Mon","weekday","no_sled","Brush/Cement",NA,NA,NA,9.5,NA,37,0,33,25.7,-1,-1,3,0,-1,-2,1,1
"11030",2021-03-08,"Brush Creek Trailhead","w2021","Mechanized",0,"Mon","weekday","no_sled","Brush/Cement",NA,NA,NA,9.5,NA,37,0,33,25.7,-1,-1,3,0,-1,-2,1,1
"11031",2021-03-08,"Brush Creek Trailhead","w2021","Motorized",0,"Mon","weekday","sled","Brush/Cement",NA,NA,NA,9.5,NA,37,0,33,25.7,-1,-1,3,0,-1,-2,1,1
"11032",2021-03-08,"Brush Creek Trailhead","w2021","Hybrid",0,"Mon","weekday","sled","Brush/Cement",NA,NA,NA,9.5,NA,37,0,33,25.7,-1,-1,3,0,-1,-2,1,1
"11033",2021-03-09,"Brush Creek Trailhead","w2021","Non.motorized",14,"Tue","weekday","no_sled","Brush/Cement",NA,NA,NA,9.5,NA,37,0,33,25.7,0,-1,-1,3,0,-1,-2,1
"11034",2021-03-09,"Brush Creek Trailhead","w2021","Mechanized",0,"Tue","weekday","no_sled","Brush/Cement",NA,NA,NA,9.5,NA,37,0,33,25.7,0,-1,-1,3,0,-1,-2,1
"11035",2021-03-09,"Brush Creek Trailhead","w2021","Motorized",0,"Tue","weekday","sled","Brush/Cement",NA,NA,NA,9.5,NA,37,0,33,25.7,0,-1,-1,3,0,-1,-2,1
"11036",2021-03-09,"Brush Creek Trailhead","w2021","Hybrid",0,"Tue","weekday","sled","Brush/Cement",NA,NA,NA,9.5,NA,37,0,33,25.7,0,-1,-1,3,0,-1,-2,1
"11037",2021-03-10,"Brush Creek Trailhead","w2021","Non.motorized",7,"Wed","weekday","no_sled","Brush/Cement",NA,NA,NA,9.7,NA,39,2,21,24.9,0,0,-1,-1,2,2,1,0
"11038",2021-03-10,"Brush Creek Trailhead","w2021","Mechanized",0,"Wed","weekday","no_sled","Brush/Cement",NA,NA,NA,9.7,NA,39,2,21,24.9,0,0,-1,-1,2,2,1,0
"11039",2021-03-10,"Brush Creek Trailhead","w2021","Motorized",0,"Wed","weekday","sled","Brush/Cement",NA,NA,NA,9.7,NA,39,2,21,24.9,0,0,-1,-1,2,2,1,0
"11040",2021-03-10,"Brush Creek Trailhead","w2021","Hybrid",0,"Wed","weekday","sled","Brush/Cement",NA,NA,NA,9.7,NA,39,2,21,24.9,0,0,-1,-1,2,2,1,0
"11041",2021-03-11,"Brush Creek Trailhead","w2021","Non.motorized",9,"Thu","weekday","no_sled","Brush/Cement",NA,NA,NA,9.8,NA,40,1,22,24.5,2,0,0,-1,3,3,3,2
"11042",2021-03-11,"Brush Creek Trailhead","w2021","Mechanized",0,"Thu","weekday","no_sled","Brush/Cement",NA,NA,NA,9.8,NA,40,1,22,24.5,2,0,0,-1,3,3,3,2
"11043",2021-03-11,"Brush Creek Trailhead","w2021","Motorized",0,"Thu","weekday","sled","Brush/Cement",NA,NA,NA,9.8,NA,40,1,22,24.5,2,0,0,-1,3,3,3,2
"11044",2021-03-11,"Brush Creek Trailhead","w2021","Hybrid",0,"Thu","weekday","sled","Brush/Cement",NA,NA,NA,9.8,NA,40,1,22,24.5,2,0,0,-1,3,3,3,2
"11045",2021-03-12,"Brush Creek Trailhead","w2021","Non.motorized",11,"Fri","weekday","no_sled","Brush/Cement",NA,NA,NA,9.8,NA,39,-1,29,25.1,1,2,0,0,0,2,2,2
"11046",2021-03-12,"Brush Creek Trailhead","w2021","Mechanized",0,"Fri","weekday","no_sled","Brush/Cement",NA,NA,NA,9.8,NA,39,-1,29,25.1,1,2,0,0,0,2,2,2
"11047",2021-03-12,"Brush Creek Trailhead","w2021","Motorized",0,"Fri","weekday","sled","Brush/Cement",NA,NA,NA,9.8,NA,39,-1,29,25.1,1,2,0,0,0,2,2,2
"11048",2021-03-12,"Brush Creek Trailhead","w2021","Hybrid",0,"Fri","weekday","sled","Brush/Cement",NA,NA,NA,9.8,NA,39,-1,29,25.1,1,2,0,0,0,2,2,2
"11049",2021-03-13,"Brush Creek Trailhead","w2021","Non.motorized",21,"Sat","weekend","no_sled","Brush/Cement",NA,NA,NA,9.8,NA,38,-1,27,25.8,-1,1,2,0,-2,-1,1,1
"11050",2021-03-13,"Brush Creek Trailhead","w2021","Mechanized",0,"Sat","weekend","no_sled","Brush/Cement",NA,NA,NA,9.8,NA,38,-1,27,25.8,-1,1,2,0,-2,-1,1,1
"11051",2021-03-13,"Brush Creek Trailhead","w2021","Motorized",0,"Sat","weekend","sled","Brush/Cement",NA,NA,NA,9.8,NA,38,-1,27,25.8,-1,1,2,0,-2,-1,1,1
"11052",2021-03-13,"Brush Creek Trailhead","w2021","Hybrid",0,"Sat","weekend","sled","Brush/Cement",NA,NA,NA,9.8,NA,38,-1,27,25.8,-1,1,2,0,-2,-1,1,1
"11053",2021-03-14,"Brush Creek Trailhead","w2021","Non.motorized",10,"Sun","weekend","no_sled","Brush/Cement",NA,NA,NA,10.2,NA,42,4,23,24.3,-1,-1,1,2,3,2,3,5
"11054",2021-03-14,"Brush Creek Trailhead","w2021","Mechanized",0,"Sun","weekend","no_sled","Brush/Cement",NA,NA,NA,10.2,NA,42,4,23,24.3,-1,-1,1,2,3,2,3,5
"11055",2021-03-14,"Brush Creek Trailhead","w2021","Motorized",0,"Sun","weekend","sled","Brush/Cement",NA,NA,NA,10.2,NA,42,4,23,24.3,-1,-1,1,2,3,2,3,5
"11056",2021-03-14,"Brush Creek Trailhead","w2021","Hybrid",0,"Sun","weekend","sled","Brush/Cement",NA,NA,NA,10.2,NA,42,4,23,24.3,-1,-1,1,2,3,2,3,5
"11057",2021-03-15,"Brush Creek Trailhead","w2021","Non.motorized",6,"Mon","weekday","no_sled","Brush/Cement",NA,NA,NA,10.2,NA,41,-1,26,24.9,4,-1,-1,1,3,2,1,2
"11058",2021-03-15,"Brush Creek Trailhead","w2021","Mechanized",0,"Mon","weekday","no_sled","Brush/Cement",NA,NA,NA,10.2,NA,41,-1,26,24.9,4,-1,-1,1,3,2,1,2
"11059",2021-03-15,"Brush Creek Trailhead","w2021","Motorized",0,"Mon","weekday","sled","Brush/Cement",NA,NA,NA,10.2,NA,41,-1,26,24.9,4,-1,-1,1,3,2,1,2
"11060",2021-03-15,"Brush Creek Trailhead","w2021","Hybrid",0,"Mon","weekday","sled","Brush/Cement",NA,NA,NA,10.2,NA,41,-1,26,24.9,4,-1,-1,1,3,2,1,2
"11061",2021-03-16,"Brush Creek Trailhead","w2021","Non.motorized",5,"Tue","weekday","no_sled","Brush/Cement",NA,NA,NA,10.3,NA,40,-1,26,25.8,-1,4,-1,-1,-2,2,1,0
"11062",2021-03-16,"Brush Creek Trailhead","w2021","Mechanized",0,"Tue","weekday","no_sled","Brush/Cement",NA,NA,NA,10.3,NA,40,-1,26,25.8,-1,4,-1,-1,-2,2,1,0
"11063",2021-03-16,"Brush Creek Trailhead","w2021","Motorized",0,"Tue","weekday","sled","Brush/Cement",NA,NA,NA,10.3,NA,40,-1,26,25.8,-1,4,-1,-1,-2,2,1,0
"11064",2021-03-16,"Brush Creek Trailhead","w2021","Hybrid",0,"Tue","weekday","sled","Brush/Cement",NA,NA,NA,10.3,NA,40,-1,26,25.8,-1,4,-1,-1,-2,2,1,0
"11065",2021-03-17,"Brush Creek Trailhead","w2021","Non.motorized",4,"Wed","weekday","no_sled","Brush/Cement",NA,NA,NA,10.3,NA,41,1,25,25.1,-1,-1,4,-1,0,-1,3,2
"11066",2021-03-17,"Brush Creek Trailhead","w2021","Mechanized",0,"Wed","weekday","no_sled","Brush/Cement",NA,NA,NA,10.3,NA,41,1,25,25.1,-1,-1,4,-1,0,-1,3,2
"11067",2021-03-17,"Brush Creek Trailhead","w2021","Motorized",0,"Wed","weekday","sled","Brush/Cement",NA,NA,NA,10.3,NA,41,1,25,25.1,-1,-1,4,-1,0,-1,3,2
"11068",2021-03-17,"Brush Creek Trailhead","w2021","Hybrid",0,"Wed","weekday","sled","Brush/Cement",NA,NA,NA,10.3,NA,41,1,25,25.1,-1,-1,4,-1,0,-1,3,2
"11069",2021-03-18,"Brush Creek Trailhead","w2021","Non.motorized",11,"Thu","weekday","no_sled","Brush/Cement",NA,NA,NA,10.3,NA,40,-1,29,25.8,1,-1,-1,4,0,-1,-2,2
"11070",2021-03-18,"Brush Creek Trailhead","w2021","Mechanized",0,"Thu","weekday","no_sled","Brush/Cement",NA,NA,NA,10.3,NA,40,-1,29,25.8,1,-1,-1,4,0,-1,-2,2
"11071",2021-03-18,"Brush Creek Trailhead","w2021","Motorized",0,"Thu","weekday","sled","Brush/Cement",NA,NA,NA,10.3,NA,40,-1,29,25.8,1,-1,-1,4,0,-1,-2,2
"11072",2021-03-18,"Brush Creek Trailhead","w2021","Hybrid",0,"Thu","weekday","sled","Brush/Cement",NA,NA,NA,10.3,NA,40,-1,29,25.8,1,-1,-1,4,0,-1,-2,2
"11073",2021-03-19,"Brush Creek Trailhead","w2021","Non.motorized",14,"Fri","weekday","no_sled","Brush/Cement",NA,NA,NA,10.3,NA,40,0,36,25.8,-1,1,-1,-1,-1,0,-1,-2
"11074",2021-03-19,"Brush Creek Trailhead","w2021","Mechanized",0,"Fri","weekday","no_sled","Brush/Cement",NA,NA,NA,10.3,NA,40,0,36,25.8,-1,1,-1,-1,-1,0,-1,-2
"11075",2021-03-19,"Brush Creek Trailhead","w2021","Motorized",0,"Fri","weekday","sled","Brush/Cement",NA,NA,NA,10.3,NA,40,0,36,25.8,-1,1,-1,-1,-1,0,-1,-2
"11076",2021-03-19,"Brush Creek Trailhead","w2021","Hybrid",0,"Fri","weekday","sled","Brush/Cement",NA,NA,NA,10.3,NA,40,0,36,25.8,-1,1,-1,-1,-1,0,-1,-2
"11077",2021-03-20,"Brush Creek Trailhead","w2021","Non.motorized",22,"Sat","weekend","no_sled","Brush/Cement",NA,NA,NA,10.4,NA,39,-1,37,26.7,0,-1,1,-1,-1,-2,-1,-2
"11078",2021-03-20,"Brush Creek Trailhead","w2021","Mechanized",0,"Sat","weekend","no_sled","Brush/Cement",NA,NA,NA,10.4,NA,39,-1,37,26.7,0,-1,1,-1,-1,-2,-1,-2
"11079",2021-03-20,"Brush Creek Trailhead","w2021","Motorized",0,"Sat","weekend","sled","Brush/Cement",NA,NA,NA,10.4,NA,39,-1,37,26.7,0,-1,1,-1,-1,-2,-1,-2
"11080",2021-03-20,"Brush Creek Trailhead","w2021","Hybrid",0,"Sat","weekend","sled","Brush/Cement",NA,NA,NA,10.4,NA,39,-1,37,26.7,0,-1,1,-1,-1,-2,-1,-2
"11081",2021-03-21,"Brush Creek Trailhead","w2021","Non.motorized",24,"Sun","weekend","no_sled","Brush/Cement",NA,NA,NA,10.4,NA,38,-1,28,27.4,-1,0,-1,1,-2,-2,-3,-2
"11082",2021-03-21,"Brush Creek Trailhead","w2021","Mechanized",0,"Sun","weekend","no_sled","Brush/Cement",NA,NA,NA,10.4,NA,38,-1,28,27.4,-1,0,-1,1,-2,-2,-3,-2
"11083",2021-03-21,"Brush Creek Trailhead","w2021","Motorized",0,"Sun","weekend","sled","Brush/Cement",NA,NA,NA,10.4,NA,38,-1,28,27.4,-1,0,-1,1,-2,-2,-3,-2
"11084",2021-03-21,"Brush Creek Trailhead","w2021","Hybrid",0,"Sun","weekend","sled","Brush/Cement",NA,NA,NA,10.4,NA,38,-1,28,27.4,-1,0,-1,1,-2,-2,-3,-2
"11085",2021-03-22,"Brush Creek Trailhead","w2021","Non.motorized",4,"Mon","weekday","no_sled","Brush/Cement",NA,NA,NA,10.5,NA,41,3,26,25.6,-1,-1,0,-1,2,1,1,0
"11086",2021-03-22,"Brush Creek Trailhead","w2021","Mechanized",0,"Mon","weekday","no_sled","Brush/Cement",NA,NA,NA,10.5,NA,41,3,26,25.6,-1,-1,0,-1,2,1,1,0
"11087",2021-03-22,"Brush Creek Trailhead","w2021","Motorized",0,"Mon","weekday","sled","Brush/Cement",NA,NA,NA,10.5,NA,41,3,26,25.6,-1,-1,0,-1,2,1,1,0
"11088",2021-03-22,"Brush Creek Trailhead","w2021","Hybrid",0,"Mon","weekday","sled","Brush/Cement",NA,NA,NA,10.5,NA,41,3,26,25.6,-1,-1,0,-1,2,1,1,0
"11089",2021-03-23,"Brush Creek Trailhead","w2021","Non.motorized",12,"Tue","weekday","no_sled","Brush/Cement",NA,NA,NA,10.6,NA,41,0,24,25.9,3,-1,-1,0,3,2,1,1
"11090",2021-03-23,"Brush Creek Trailhead","w2021","Mechanized",0,"Tue","weekday","no_sled","Brush/Cement",NA,NA,NA,10.6,NA,41,0,24,25.9,3,-1,-1,0,3,2,1,1
"11091",2021-03-23,"Brush Creek Trailhead","w2021","Motorized",0,"Tue","weekday","sled","Brush/Cement",NA,NA,NA,10.6,NA,41,0,24,25.9,3,-1,-1,0,3,2,1,1
"11092",2021-03-23,"Brush Creek Trailhead","w2021","Hybrid",0,"Tue","weekday","sled","Brush/Cement",NA,NA,NA,10.6,NA,41,0,24,25.9,3,-1,-1,0,3,2,1,1
"11093",2021-03-24,"Brush Creek Trailhead","w2021","Non.motorized",10,"Wed","weekday","no_sled","Brush/Cement",NA,NA,NA,10.8,NA,41,0,24,26.3,0,3,-1,-1,0,3,2,1
"11094",2021-03-24,"Brush Creek Trailhead","w2021","Mechanized",0,"Wed","weekday","no_sled","Brush/Cement",NA,NA,NA,10.8,NA,41,0,24,26.3,0,3,-1,-1,0,3,2,1
"11095",2021-03-24,"Brush Creek Trailhead","w2021","Motorized",0,"Wed","weekday","sled","Brush/Cement",NA,NA,NA,10.8,NA,41,0,24,26.3,0,3,-1,-1,0,3,2,1
"11096",2021-03-24,"Brush Creek Trailhead","w2021","Hybrid",0,"Wed","weekday","sled","Brush/Cement",NA,NA,NA,10.8,NA,41,0,24,26.3,0,3,-1,-1,0,3,2,1
"11097",2021-03-25,"Brush Creek Trailhead","w2021","Non.motorized",9,"Thu","weekday","no_sled","Brush/Cement",NA,NA,NA,10.9,NA,43,2,23,25.3,0,0,3,-1,2,2,5,4
"11098",2021-03-25,"Brush Creek Trailhead","w2021","Mechanized",0,"Thu","weekday","no_sled","Brush/Cement",NA,NA,NA,10.9,NA,43,2,23,25.3,0,0,3,-1,2,2,5,4
"11099",2021-03-25,"Brush Creek Trailhead","w2021","Motorized",0,"Thu","weekday","sled","Brush/Cement",NA,NA,NA,10.9,NA,43,2,23,25.3,0,0,3,-1,2,2,5,4
"11100",2021-03-25,"Brush Creek Trailhead","w2021","Hybrid",0,"Thu","weekday","sled","Brush/Cement",NA,NA,NA,10.9,NA,43,2,23,25.3,0,0,3,-1,2,2,5,4
"11101",2021-03-26,"Brush Creek Trailhead","w2021","Non.motorized",11,"Fri","weekday","no_sled","Brush/Cement",NA,NA,NA,11,NA,44,1,23,25,2,0,0,3,3,3,3,6
"11102",2021-03-26,"Brush Creek Trailhead","w2021","Mechanized",0,"Fri","weekday","no_sled","Brush/Cement",NA,NA,NA,11,NA,44,1,23,25,2,0,0,3,3,3,3,6
"11103",2021-03-26,"Brush Creek Trailhead","w2021","Motorized",0,"Fri","weekday","sled","Brush/Cement",NA,NA,NA,11,NA,44,1,23,25,2,0,0,3,3,3,3,6
"11104",2021-03-26,"Brush Creek Trailhead","w2021","Hybrid",0,"Fri","weekday","sled","Brush/Cement",NA,NA,NA,11,NA,44,1,23,25,2,0,0,3,3,3,3,6
"11105",2021-03-27,"Brush Creek Trailhead","w2021","Non.motorized",16,"Sat","weekend","no_sled","Brush/Cement",NA,NA,NA,11,NA,42,-2,25,26.2,1,2,0,0,-1,1,1,1
"11106",2021-03-27,"Brush Creek Trailhead","w2021","Mechanized",0,"Sat","weekend","no_sled","Brush/Cement",NA,NA,NA,11,NA,42,-2,25,26.2,1,2,0,0,-1,1,1,1
"11107",2021-03-27,"Brush Creek Trailhead","w2021","Motorized",0,"Sat","weekend","sled","Brush/Cement",NA,NA,NA,11,NA,42,-2,25,26.2,1,2,0,0,-1,1,1,1
"11108",2021-03-27,"Brush Creek Trailhead","w2021","Hybrid",0,"Sat","weekend","sled","Brush/Cement",NA,NA,NA,11,NA,42,-2,25,26.2,1,2,0,0,-1,1,1,1
"11109",2021-03-28,"Brush Creek Trailhead","w2021","Non.motorized",17,"Sun","weekend","no_sled","Brush/Cement",NA,NA,NA,11,NA,42,0,31,26.2,-2,1,2,0,-2,-1,1,1
"11110",2021-03-28,"Brush Creek Trailhead","w2021","Mechanized",0,"Sun","weekend","no_sled","Brush/Cement",NA,NA,NA,11,NA,42,0,31,26.2,-2,1,2,0,-2,-1,1,1
"11111",2021-03-28,"Brush Creek Trailhead","w2021","Motorized",0,"Sun","weekend","sled","Brush/Cement",NA,NA,NA,11,NA,42,0,31,26.2,-2,1,2,0,-2,-1,1,1
"11112",2021-03-28,"Brush Creek Trailhead","w2021","Hybrid",0,"Sun","weekend","sled","Brush/Cement",NA,NA,NA,11,NA,42,0,31,26.2,-2,1,2,0,-2,-1,1,1
"11113",2021-03-29,"Brush Creek Trailhead","w2021","Non.motorized",11,"Mon","weekday","no_sled","Brush/Cement",NA,NA,NA,11.1,NA,40,-2,37,27.8,0,-2,1,2,-2,-4,-3,-1
"11114",2021-03-29,"Brush Creek Trailhead","w2021","Mechanized",0,"Mon","weekday","no_sled","Brush/Cement",NA,NA,NA,11.1,NA,40,-2,37,27.8,0,-2,1,2,-2,-4,-3,-1
"11115",2021-03-29,"Brush Creek Trailhead","w2021","Motorized",0,"Mon","weekday","sled","Brush/Cement",NA,NA,NA,11.1,NA,40,-2,37,27.8,0,-2,1,2,-2,-4,-3,-1
"11116",2021-03-29,"Brush Creek Trailhead","w2021","Hybrid",0,"Mon","weekday","sled","Brush/Cement",NA,NA,NA,11.1,NA,40,-2,37,27.8,0,-2,1,2,-2,-4,-3,-1
"11117",2021-03-30,"Brush Creek Trailhead","w2021","Non.motorized",7,"Tue","weekday","no_sled","Brush/Cement",NA,NA,NA,11.1,NA,39,-1,23,28.5,-2,0,-2,1,-3,-3,-5,-4
"11118",2021-03-30,"Brush Creek Trailhead","w2021","Mechanized",0,"Tue","weekday","no_sled","Brush/Cement",NA,NA,NA,11.1,NA,39,-1,23,28.5,-2,0,-2,1,-3,-3,-5,-4
"11119",2021-03-30,"Brush Creek Trailhead","w2021","Motorized",0,"Tue","weekday","sled","Brush/Cement",NA,NA,NA,11.1,NA,39,-1,23,28.5,-2,0,-2,1,-3,-3,-5,-4
"11120",2021-03-30,"Brush Creek Trailhead","w2021","Hybrid",0,"Tue","weekday","sled","Brush/Cement",NA,NA,NA,11.1,NA,39,-1,23,28.5,-2,0,-2,1,-3,-3,-5,-4
"11121",2021-03-31,"Brush Creek Trailhead","w2021","Non.motorized",11,"Wed","weekday","no_sled","Brush/Cement",NA,NA,NA,11.1,NA,39,0,26,28.5,-1,-2,0,-2,-1,-3,-3,-5
"11122",2021-03-31,"Brush Creek Trailhead","w2021","Mechanized",0,"Wed","weekday","no_sled","Brush/Cement",NA,NA,NA,11.1,NA,39,0,26,28.5,-1,-2,0,-2,-1,-3,-3,-5
"11123",2021-03-31,"Brush Creek Trailhead","w2021","Motorized",0,"Wed","weekday","sled","Brush/Cement",NA,NA,NA,11.1,NA,39,0,26,28.5,-1,-2,0,-2,-1,-3,-3,-5
"11124",2021-03-31,"Brush Creek Trailhead","w2021","Hybrid",0,"Wed","weekday","sled","Brush/Cement",NA,NA,NA,11.1,NA,39,0,26,28.5,-1,-2,0,-2,-1,-3,-3,-5
"11125",2021-04-01,"Brush Creek Trailhead","w2021","Non.motorized",13,"Thu","weekday","no_sled","Brush/Cement",NA,NA,NA,11.1,NA,38,-1,36,29.2,0,-1,-2,0,-1,-2,-4,-4
"11126",2021-04-01,"Brush Creek Trailhead","w2021","Mechanized",0,"Thu","weekday","no_sled","Brush/Cement",NA,NA,NA,11.1,NA,38,-1,36,29.2,0,-1,-2,0,-1,-2,-4,-4
"11127",2021-04-01,"Brush Creek Trailhead","w2021","Motorized",0,"Thu","weekday","sled","Brush/Cement",NA,NA,NA,11.1,NA,38,-1,36,29.2,0,-1,-2,0,-1,-2,-4,-4
"11128",2021-04-01,"Brush Creek Trailhead","w2021","Hybrid",0,"Thu","weekday","sled","Brush/Cement",NA,NA,NA,11.1,NA,38,-1,36,29.2,0,-1,-2,0,-1,-2,-4,-4
"11129",2021-04-02,"Brush Creek Trailhead","w2021","Non.motorized",8,"Fri","weekday","no_sled","Brush/Cement",NA,NA,NA,11.1,NA,37,-1,42,30,-1,0,-1,-2,-2,-2,-3,-5
"11130",2021-04-02,"Brush Creek Trailhead","w2021","Mechanized",0,"Fri","weekday","no_sled","Brush/Cement",NA,NA,NA,11.1,NA,37,-1,42,30,-1,0,-1,-2,-2,-2,-3,-5
"11131",2021-04-02,"Brush Creek Trailhead","w2021","Motorized",0,"Fri","weekday","sled","Brush/Cement",NA,NA,NA,11.1,NA,37,-1,42,30,-1,0,-1,-2,-2,-2,-3,-5
"11132",2021-04-02,"Brush Creek Trailhead","w2021","Hybrid",0,"Fri","weekday","sled","Brush/Cement",NA,NA,NA,11.1,NA,37,-1,42,30,-1,0,-1,-2,-2,-2,-3,-5
"11133",2021-04-03,"Brush Creek Trailhead","w2021","Non.motorized",17,"Sat","weekend","no_sled","Brush/Cement",NA,NA,NA,10.8,NA,35,-2,45,30.9,-1,-1,0,-1,-3,-4,-4,-5
"11134",2021-04-03,"Brush Creek Trailhead","w2021","Mechanized",0,"Sat","weekend","no_sled","Brush/Cement",NA,NA,NA,10.8,NA,35,-2,45,30.9,-1,-1,0,-1,-3,-4,-4,-5
"11135",2021-04-03,"Brush Creek Trailhead","w2021","Motorized",0,"Sat","weekend","sled","Brush/Cement",NA,NA,NA,10.8,NA,35,-2,45,30.9,-1,-1,0,-1,-3,-4,-4,-5
"11136",2021-04-03,"Brush Creek Trailhead","w2021","Hybrid",0,"Sat","weekend","sled","Brush/Cement",NA,NA,NA,10.8,NA,35,-2,45,30.9,-1,-1,0,-1,-3,-4,-4,-5
"11137",2021-04-04,"Brush Creek Trailhead","w2021","Non.motorized",4,"Sun","weekend","no_sled","Brush/Cement",NA,NA,NA,10.7,NA,34,-1,44,31.5,-2,-1,-1,0,-3,-4,-5,-5
"11138",2021-04-04,"Brush Creek Trailhead","w2021","Mechanized",0,"Sun","weekend","no_sled","Brush/Cement",NA,NA,NA,10.7,NA,34,-1,44,31.5,-2,-1,-1,0,-3,-4,-5,-5
"11139",2021-04-04,"Brush Creek Trailhead","w2021","Motorized",0,"Sun","weekend","sled","Brush/Cement",NA,NA,NA,10.7,NA,34,-1,44,31.5,-2,-1,-1,0,-3,-4,-5,-5
"11140",2021-04-04,"Brush Creek Trailhead","w2021","Hybrid",0,"Sun","weekend","sled","Brush/Cement",NA,NA,NA,10.7,NA,34,-1,44,31.5,-2,-1,-1,0,-3,-4,-5,-5
"11141",2021-04-05,"Brush Creek Trailhead","w2021","Non.motorized",4,"Mon","weekday","no_sled","Brush/Cement",NA,NA,NA,10.6,NA,33,-1,44,32.1,-1,-2,-1,-1,-2,-4,-5,-6
"11142",2021-04-05,"Brush Creek Trailhead","w2021","Mechanized",0,"Mon","weekday","no_sled","Brush/Cement",NA,NA,NA,10.6,NA,33,-1,44,32.1,-1,-2,-1,-1,-2,-4,-5,-6
"11143",2021-04-05,"Brush Creek Trailhead","w2021","Motorized",0,"Mon","weekday","sled","Brush/Cement",NA,NA,NA,10.6,NA,33,-1,44,32.1,-1,-2,-1,-1,-2,-4,-5,-6
"11144",2021-04-05,"Brush Creek Trailhead","w2021","Hybrid",0,"Mon","weekday","sled","Brush/Cement",NA,NA,NA,10.6,NA,33,-1,44,32.1,-1,-2,-1,-1,-2,-4,-5,-6
"11145",2021-04-06,"Brush Creek Trailhead","w2021","Non.motorized",7,"Tue","weekday","no_sled","Brush/Cement",NA,NA,NA,10.3,NA,31,-2,32,33.2,-1,-1,-2,-1,-3,-4,-6,-7
"11146",2021-04-06,"Brush Creek Trailhead","w2021","Mechanized",0,"Tue","weekday","no_sled","Brush/Cement",NA,NA,NA,10.3,NA,31,-2,32,33.2,-1,-1,-2,-1,-3,-4,-6,-7
"11147",2021-04-06,"Brush Creek Trailhead","w2021","Motorized",0,"Tue","weekday","sled","Brush/Cement",NA,NA,NA,10.3,NA,31,-2,32,33.2,-1,-1,-2,-1,-3,-4,-6,-7
"11148",2021-04-06,"Brush Creek Trailhead","w2021","Hybrid",0,"Tue","weekday","sled","Brush/Cement",NA,NA,NA,10.3,NA,31,-2,32,33.2,-1,-1,-2,-1,-3,-4,-6,-7
"11149",2021-04-07,"Brush Creek Trailhead","w2021","Non.motorized",7,"Wed","weekday","no_sled","Brush/Cement",NA,NA,NA,10,NA,31,0,33,32.3,-2,-1,-1,-2,-2,-3,-4,-6
"11150",2021-04-07,"Brush Creek Trailhead","w2021","Mechanized",0,"Wed","weekday","no_sled","Brush/Cement",NA,NA,NA,10,NA,31,0,33,32.3,-2,-1,-1,-2,-2,-3,-4,-6
"11151",2021-04-07,"Brush Creek Trailhead","w2021","Motorized",0,"Wed","weekday","sled","Brush/Cement",NA,NA,NA,10,NA,31,0,33,32.3,-2,-1,-1,-2,-2,-3,-4,-6
"11152",2021-04-07,"Brush Creek Trailhead","w2021","Hybrid",0,"Wed","weekday","sled","Brush/Cement",NA,NA,NA,10,NA,31,0,33,32.3,-2,-1,-1,-2,-2,-3,-4,-6
"11153",2021-04-08,"Brush Creek Trailhead","w2021","Non.motorized",7,"Thu","weekday","no_sled","Brush/Cement",NA,NA,NA,9.9,NA,29,-2,39,34.1,0,-2,-1,-1,-2,-4,-5,-6
"11154",2021-04-08,"Brush Creek Trailhead","w2021","Mechanized",0,"Thu","weekday","no_sled","Brush/Cement",NA,NA,NA,9.9,NA,29,-2,39,34.1,0,-2,-1,-1,-2,-4,-5,-6
"11155",2021-04-08,"Brush Creek Trailhead","w2021","Motorized",0,"Thu","weekday","sled","Brush/Cement",NA,NA,NA,9.9,NA,29,-2,39,34.1,0,-2,-1,-1,-2,-4,-5,-6
"11156",2021-04-08,"Brush Creek Trailhead","w2021","Hybrid",0,"Thu","weekday","sled","Brush/Cement",NA,NA,NA,9.9,NA,29,-2,39,34.1,0,-2,-1,-1,-2,-4,-5,-6
"11157",2021-04-09,"Brush Creek Trailhead","w2021","Non.motorized",8,"Fri","weekday","no_sled","Brush/Cement",NA,NA,NA,9.6,NA,28,-1,33,34.3,-2,0,-2,-1,-3,-3,-5,-6
"11158",2021-04-09,"Brush Creek Trailhead","w2021","Mechanized",0,"Fri","weekday","no_sled","Brush/Cement",NA,NA,NA,9.6,NA,28,-1,33,34.3,-2,0,-2,-1,-3,-3,-5,-6
"11159",2021-04-09,"Brush Creek Trailhead","w2021","Motorized",0,"Fri","weekday","sled","Brush/Cement",NA,NA,NA,9.6,NA,28,-1,33,34.3,-2,0,-2,-1,-3,-3,-5,-6
"11160",2021-04-09,"Brush Creek Trailhead","w2021","Hybrid",0,"Fri","weekday","sled","Brush/Cement",NA,NA,NA,9.6,NA,28,-1,33,34.3,-2,0,-2,-1,-3,-3,-5,-6
"11161",2021-04-10,"Brush Creek Trailhead","w2021","Non.motorized",34,"Sat","weekend","no_sled","Brush/Cement",NA,NA,NA,9.5,NA,26,-2,37,36.5,-1,-2,0,-2,-3,-5,-5,-7
"11162",2021-04-10,"Brush Creek Trailhead","w2021","Mechanized",2,"Sat","weekend","no_sled","Brush/Cement",NA,NA,NA,9.5,NA,26,-2,37,36.5,-1,-2,0,-2,-3,-5,-5,-7
"11163",2021-04-10,"Brush Creek Trailhead","w2021","Motorized",0,"Sat","weekend","sled","Brush/Cement",NA,NA,NA,9.5,NA,26,-2,37,36.5,-1,-2,0,-2,-3,-5,-5,-7
"11164",2021-04-10,"Brush Creek Trailhead","w2021","Hybrid",0,"Sat","weekend","sled","Brush/Cement",NA,NA,NA,9.5,NA,26,-2,37,36.5,-1,-2,0,-2,-3,-5,-5,-7
"11165",2021-04-11,"Brush Creek Trailhead","w2021","Non.motorized",11,"Sun","weekend","no_sled","Brush/Cement",NA,NA,NA,9.2,NA,26,0,39,35.4,-2,-1,-2,0,-2,-3,-5,-5
"11166",2021-04-11,"Brush Creek Trailhead","w2021","Mechanized",2,"Sun","weekend","no_sled","Brush/Cement",NA,NA,NA,9.2,NA,26,0,39,35.4,-2,-1,-2,0,-2,-3,-5,-5
"11167",2021-04-11,"Brush Creek Trailhead","w2021","Motorized",0,"Sun","weekend","sled","Brush/Cement",NA,NA,NA,9.2,NA,26,0,39,35.4,-2,-1,-2,0,-2,-3,-5,-5
"11168",2021-04-11,"Brush Creek Trailhead","w2021","Hybrid",0,"Sun","weekend","sled","Brush/Cement",NA,NA,NA,9.2,NA,26,0,39,35.4,-2,-1,-2,0,-2,-3,-5,-5
"11169",2021-04-12,"Brush Creek Trailhead","w2021","Non.motorized",9,"Mon","weekday","no_sled","Brush/Cement",NA,NA,NA,8.8,NA,24,-2,38,36.7,0,-2,-1,-2,-2,-4,-5,-7
"11170",2021-04-12,"Brush Creek Trailhead","w2021","Mechanized",0,"Mon","weekday","no_sled","Brush/Cement",NA,NA,NA,8.8,NA,24,-2,38,36.7,0,-2,-1,-2,-2,-4,-5,-7
"11171",2021-04-12,"Brush Creek Trailhead","w2021","Motorized",0,"Mon","weekday","sled","Brush/Cement",NA,NA,NA,8.8,NA,24,-2,38,36.7,0,-2,-1,-2,-2,-4,-5,-7
"11172",2021-04-12,"Brush Creek Trailhead","w2021","Hybrid",0,"Mon","weekday","sled","Brush/Cement",NA,NA,NA,8.8,NA,24,-2,38,36.7,0,-2,-1,-2,-2,-4,-5,-7
"11173",2021-04-13,"Brush Creek Trailhead","w2021","Non.motorized",9,"Tue","weekday","no_sled","Brush/Cement",NA,NA,NA,8.4,NA,23,-1,35,36.5,-2,0,-2,-1,-3,-3,-5,-6
"11174",2021-04-13,"Brush Creek Trailhead","w2021","Mechanized",1,"Tue","weekday","no_sled","Brush/Cement",NA,NA,NA,8.4,NA,23,-1,35,36.5,-2,0,-2,-1,-3,-3,-5,-6
"11175",2021-04-13,"Brush Creek Trailhead","w2021","Motorized",0,"Tue","weekday","sled","Brush/Cement",NA,NA,NA,8.4,NA,23,-1,35,36.5,-2,0,-2,-1,-3,-3,-5,-6
"11176",2021-04-13,"Brush Creek Trailhead","w2021","Hybrid",0,"Tue","weekday","sled","Brush/Cement",NA,NA,NA,8.4,NA,23,-1,35,36.5,-2,0,-2,-1,-3,-3,-5,-6
"11177",2021-04-14,"Brush Creek Trailhead","w2021","Non.motorized",9,"Wed","weekday","no_sled","Brush/Cement",NA,NA,NA,8.4,NA,23,0,41,36.5,-1,-2,0,-2,-1,-3,-3,-5
"11178",2021-04-14,"Brush Creek Trailhead","w2021","Mechanized",0,"Wed","weekday","no_sled","Brush/Cement",NA,NA,NA,8.4,NA,23,0,41,36.5,-1,-2,0,-2,-1,-3,-3,-5
"11179",2021-04-14,"Brush Creek Trailhead","w2021","Motorized",0,"Wed","weekday","sled","Brush/Cement",NA,NA,NA,8.4,NA,23,0,41,36.5,-1,-2,0,-2,-1,-3,-3,-5
"11180",2021-04-14,"Brush Creek Trailhead","w2021","Hybrid",0,"Wed","weekday","sled","Brush/Cement",NA,NA,NA,8.4,NA,23,0,41,36.5,-1,-2,0,-2,-1,-3,-3,-5
"11181",2021-04-15,"Brush Creek Trailhead","w2021","Non.motorized",12,"Thu","weekday","no_sled","Brush/Cement",NA,NA,NA,8.1,NA,22,-1,33,36.8,0,-1,-2,0,-1,-2,-4,-4
"11182",2021-04-15,"Brush Creek Trailhead","w2021","Mechanized",0,"Thu","weekday","no_sled","Brush/Cement",NA,NA,NA,8.1,NA,22,-1,33,36.8,0,-1,-2,0,-1,-2,-4,-4
"11183",2021-04-15,"Brush Creek Trailhead","w2021","Motorized",0,"Thu","weekday","sled","Brush/Cement",NA,NA,NA,8.1,NA,22,-1,33,36.8,0,-1,-2,0,-1,-2,-4,-4
"11184",2021-04-15,"Brush Creek Trailhead","w2021","Hybrid",0,"Thu","weekday","sled","Brush/Cement",NA,NA,NA,8.1,NA,22,-1,33,36.8,0,-1,-2,0,-1,-2,-4,-4
"11185",2021-01-15,"Brush Creek Rd","w2021","Non.motorized",3,"Fri","weekday","no_sled","Brush/Cement",NA,NA,NA,5.1,NA,22,0,26,23.2,-1,0,0,0,-1,-1,-1,-1
"11186",2021-01-15,"Brush Creek Rd","w2021","Mechanized",0,"Fri","weekday","no_sled","Brush/Cement",NA,NA,NA,5.1,NA,22,0,26,23.2,-1,0,0,0,-1,-1,-1,-1
"11187",2021-01-15,"Brush Creek Rd","w2021","Motorized",0,"Fri","weekday","sled","Brush/Cement",NA,NA,NA,5.1,NA,22,0,26,23.2,-1,0,0,0,-1,-1,-1,-1
"11188",2021-01-15,"Brush Creek Rd","w2021","Hybrid",0,"Fri","weekday","sled","Brush/Cement",NA,NA,NA,5.1,NA,22,0,26,23.2,-1,0,0,0,-1,-1,-1,-1
"11189",2021-01-16,"Brush Creek Rd","w2021","Non.motorized",36,"Sat","weekend","no_sled","Brush/Cement",NA,NA,NA,5.1,NA,22,0,26,23.2,0,-1,0,0,0,-1,-1,-1
"11190",2021-01-16,"Brush Creek Rd","w2021","Mechanized",1,"Sat","weekend","no_sled","Brush/Cement",NA,NA,NA,5.1,NA,22,0,26,23.2,0,-1,0,0,0,-1,-1,-1
"11191",2021-01-16,"Brush Creek Rd","w2021","Motorized",4,"Sat","weekend","sled","Brush/Cement",NA,NA,NA,5.1,NA,22,0,26,23.2,0,-1,0,0,0,-1,-1,-1
"11192",2021-01-16,"Brush Creek Rd","w2021","Hybrid",2,"Sat","weekend","sled","Brush/Cement",NA,NA,NA,5.1,NA,22,0,26,23.2,0,-1,0,0,0,-1,-1,-1
"11193",2021-01-17,"Brush Creek Rd","w2021","Non.motorized",35,"Sun","weekend","no_sled","Brush/Cement",NA,NA,NA,5.1,NA,22,0,29,23.2,0,0,-1,0,0,0,-1,-1
"11194",2021-01-17,"Brush Creek Rd","w2021","Mechanized",2,"Sun","weekend","no_sled","Brush/Cement",NA,NA,NA,5.1,NA,22,0,29,23.2,0,0,-1,0,0,0,-1,-1
"11195",2021-01-17,"Brush Creek Rd","w2021","Motorized",1,"Sun","weekend","sled","Brush/Cement",NA,NA,NA,5.1,NA,22,0,29,23.2,0,0,-1,0,0,0,-1,-1
"11196",2021-01-17,"Brush Creek Rd","w2021","Hybrid",2,"Sun","weekend","sled","Brush/Cement",NA,NA,NA,5.1,NA,22,0,29,23.2,0,0,-1,0,0,0,-1,-1
"11197",2021-01-18,"Brush Creek Rd","w2021","Non.motorized",27,"Mon","weekday","no_sled","Brush/Cement",NA,NA,NA,5.1,NA,22,0,24,23.2,0,0,0,-1,0,0,0,-1
"11198",2021-01-18,"Brush Creek Rd","w2021","Mechanized",5,"Mon","weekday","no_sled","Brush/Cement",NA,NA,NA,5.1,NA,22,0,24,23.2,0,0,0,-1,0,0,0,-1
"11199",2021-01-18,"Brush Creek Rd","w2021","Motorized",0,"Mon","weekday","sled","Brush/Cement",NA,NA,NA,5.1,NA,22,0,24,23.2,0,0,0,-1,0,0,0,-1
"11200",2021-01-18,"Brush Creek Rd","w2021","Hybrid",0,"Mon","weekday","sled","Brush/Cement",NA,NA,NA,5.1,NA,22,0,24,23.2,0,0,0,-1,0,0,0,-1
"11201",2021-01-19,"Brush Creek Rd","w2021","Non.motorized",11,"Tue","weekday","no_sled","Brush/Cement",NA,NA,NA,5.1,NA,22,0,19,23.2,0,0,0,0,0,0,0,0
"11202",2021-01-19,"Brush Creek Rd","w2021","Mechanized",0,"Tue","weekday","no_sled","Brush/Cement",NA,NA,NA,5.1,NA,22,0,19,23.2,0,0,0,0,0,0,0,0
"11203",2021-01-19,"Brush Creek Rd","w2021","Motorized",0,"Tue","weekday","sled","Brush/Cement",NA,NA,NA,5.1,NA,22,0,19,23.2,0,0,0,0,0,0,0,0
"11204",2021-01-19,"Brush Creek Rd","w2021","Hybrid",0,"Tue","weekday","sled","Brush/Cement",NA,NA,NA,5.1,NA,22,0,19,23.2,0,0,0,0,0,0,0,0
"11205",2021-01-20,"Brush Creek Rd","w2021","Non.motorized",22,"Wed","weekday","no_sled","Brush/Cement",NA,NA,NA,5.2,NA,23,1,26,22.6,0,0,0,0,1,1,1,1
"11206",2021-01-20,"Brush Creek Rd","w2021","Mechanized",0,"Wed","weekday","no_sled","Brush/Cement",NA,NA,NA,5.2,NA,23,1,26,22.6,0,0,0,0,1,1,1,1
"11207",2021-01-20,"Brush Creek Rd","w2021","Motorized",0,"Wed","weekday","sled","Brush/Cement",NA,NA,NA,5.2,NA,23,1,26,22.6,0,0,0,0,1,1,1,1
"11208",2021-01-20,"Brush Creek Rd","w2021","Hybrid",0,"Wed","weekday","sled","Brush/Cement",NA,NA,NA,5.2,NA,23,1,26,22.6,0,0,0,0,1,1,1,1
"11209",2021-01-21,"Brush Creek Rd","w2021","Non.motorized",24,"Thu","weekday","no_sled","Brush/Cement",NA,NA,NA,5.2,NA,23,0,26,22.6,1,0,0,0,1,1,1,1
"11210",2021-01-21,"Brush Creek Rd","w2021","Mechanized",0,"Thu","weekday","no_sled","Brush/Cement",NA,NA,NA,5.2,NA,23,0,26,22.6,1,0,0,0,1,1,1,1
"11211",2021-01-21,"Brush Creek Rd","w2021","Motorized",0,"Thu","weekday","sled","Brush/Cement",NA,NA,NA,5.2,NA,23,0,26,22.6,1,0,0,0,1,1,1,1
"11212",2021-01-21,"Brush Creek Rd","w2021","Hybrid",0,"Thu","weekday","sled","Brush/Cement",NA,NA,NA,5.2,NA,23,0,26,22.6,1,0,0,0,1,1,1,1
"11213",2021-01-22,"Brush Creek Rd","w2021","Non.motorized",19,"Fri","weekday","no_sled","Brush/Cement",NA,NA,NA,5.3,NA,25,2,25,21.2,0,1,0,0,2,3,3,3
"11214",2021-01-22,"Brush Creek Rd","w2021","Mechanized",0,"Fri","weekday","no_sled","Brush/Cement",NA,NA,NA,5.3,NA,25,2,25,21.2,0,1,0,0,2,3,3,3
"11215",2021-01-22,"Brush Creek Rd","w2021","Motorized",0,"Fri","weekday","sled","Brush/Cement",NA,NA,NA,5.3,NA,25,2,25,21.2,0,1,0,0,2,3,3,3
"11216",2021-01-22,"Brush Creek Rd","w2021","Hybrid",0,"Fri","weekday","sled","Brush/Cement",NA,NA,NA,5.3,NA,25,2,25,21.2,0,1,0,0,2,3,3,3
"11217",2021-01-23,"Brush Creek Rd","w2021","Non.motorized",16,"Sat","weekend","no_sled","Brush/Cement",NA,NA,NA,5.4,NA,26,1,22,20.8,2,0,1,0,3,3,4,4
"11218",2021-01-23,"Brush Creek Rd","w2021","Mechanized",0,"Sat","weekend","no_sled","Brush/Cement",NA,NA,NA,5.4,NA,26,1,22,20.8,2,0,1,0,3,3,4,4
"11219",2021-01-23,"Brush Creek Rd","w2021","Motorized",0,"Sat","weekend","sled","Brush/Cement",NA,NA,NA,5.4,NA,26,1,22,20.8,2,0,1,0,3,3,4,4
"11220",2021-01-23,"Brush Creek Rd","w2021","Hybrid",0,"Sat","weekend","sled","Brush/Cement",NA,NA,NA,5.4,NA,26,1,22,20.8,2,0,1,0,3,3,4,4
"11221",2021-01-24,"Brush Creek Rd","w2021","Non.motorized",11,"Sun","weekend","no_sled","Brush/Cement",NA,NA,NA,5.6,NA,29,3,18,19.3,1,2,0,1,4,6,6,7
"11222",2021-01-24,"Brush Creek Rd","w2021","Mechanized",1,"Sun","weekend","no_sled","Brush/Cement",NA,NA,NA,5.6,NA,29,3,18,19.3,1,2,0,1,4,6,6,7
"11223",2021-01-24,"Brush Creek Rd","w2021","Motorized",2,"Sun","weekend","sled","Brush/Cement",NA,NA,NA,5.6,NA,29,3,18,19.3,1,2,0,1,4,6,6,7
"11224",2021-01-24,"Brush Creek Rd","w2021","Hybrid",0,"Sun","weekend","sled","Brush/Cement",NA,NA,NA,5.6,NA,29,3,18,19.3,1,2,0,1,4,6,6,7
"11225",2021-01-25,"Brush Creek Rd","w2021","Non.motorized",13,"Mon","weekday","no_sled","Brush/Cement",NA,NA,NA,5.8,NA,29,0,15,20,3,1,2,0,3,4,6,6
"11226",2021-01-25,"Brush Creek Rd","w2021","Mechanized",1,"Mon","weekday","no_sled","Brush/Cement",NA,NA,NA,5.8,NA,29,0,15,20,3,1,2,0,3,4,6,6
"11227",2021-01-25,"Brush Creek Rd","w2021","Motorized",0,"Mon","weekday","sled","Brush/Cement",NA,NA,NA,5.8,NA,29,0,15,20,3,1,2,0,3,4,6,6
"11228",2021-01-25,"Brush Creek Rd","w2021","Hybrid",0,"Mon","weekday","sled","Brush/Cement",NA,NA,NA,5.8,NA,29,0,15,20,3,1,2,0,3,4,6,6
"11229",2021-01-26,"Brush Creek Rd","w2021","Non.motorized",10,"Tue","weekday","no_sled","Brush/Cement",NA,NA,NA,5.9,NA,29,0,13,20.3,0,3,1,2,0,3,4,6
"11230",2021-01-26,"Brush Creek Rd","w2021","Mechanized",0,"Tue","weekday","no_sled","Brush/Cement",NA,NA,NA,5.9,NA,29,0,13,20.3,0,3,1,2,0,3,4,6
"11231",2021-01-26,"Brush Creek Rd","w2021","Motorized",0,"Tue","weekday","sled","Brush/Cement",NA,NA,NA,5.9,NA,29,0,13,20.3,0,3,1,2,0,3,4,6
"11232",2021-01-26,"Brush Creek Rd","w2021","Hybrid",0,"Tue","weekday","sled","Brush/Cement",NA,NA,NA,5.9,NA,29,0,13,20.3,0,3,1,2,0,3,4,6
"11233",2021-01-27,"Brush Creek Rd","w2021","Non.motorized",15,"Wed","weekday","no_sled","Brush/Cement",NA,NA,NA,6,NA,30,1,13,20,0,0,3,1,1,1,4,5
"11234",2021-01-27,"Brush Creek Rd","w2021","Mechanized",0,"Wed","weekday","no_sled","Brush/Cement",NA,NA,NA,6,NA,30,1,13,20,0,0,3,1,1,1,4,5
"11235",2021-01-27,"Brush Creek Rd","w2021","Motorized",0,"Wed","weekday","sled","Brush/Cement",NA,NA,NA,6,NA,30,1,13,20,0,0,3,1,1,1,4,5
"11236",2021-01-27,"Brush Creek Rd","w2021","Hybrid",0,"Wed","weekday","sled","Brush/Cement",NA,NA,NA,6,NA,30,1,13,20,0,0,3,1,1,1,4,5
"11237",2021-01-28,"Brush Creek Rd","w2021","Non.motorized",18,"Thu","weekday","no_sled","Brush/Cement",NA,NA,NA,6,NA,28,-2,27,21.4,1,0,0,3,-1,-1,-1,2
"11238",2021-01-28,"Brush Creek Rd","w2021","Mechanized",0,"Thu","weekday","no_sled","Brush/Cement",NA,NA,NA,6,NA,28,-2,27,21.4,1,0,0,3,-1,-1,-1,2
"11239",2021-01-28,"Brush Creek Rd","w2021","Motorized",0,"Thu","weekday","sled","Brush/Cement",NA,NA,NA,6,NA,28,-2,27,21.4,1,0,0,3,-1,-1,-1,2
"11240",2021-01-28,"Brush Creek Rd","w2021","Hybrid",0,"Thu","weekday","sled","Brush/Cement",NA,NA,NA,6,NA,28,-2,27,21.4,1,0,0,3,-1,-1,-1,2
"11241",2021-01-29,"Brush Creek Rd","w2021","Non.motorized",17,"Fri","weekday","no_sled","Brush/Cement",NA,NA,NA,6.1,NA,28,0,29,21.8,-2,1,0,0,-2,-1,-1,-1
"11242",2021-01-29,"Brush Creek Rd","w2021","Mechanized",0,"Fri","weekday","no_sled","Brush/Cement",NA,NA,NA,6.1,NA,28,0,29,21.8,-2,1,0,0,-2,-1,-1,-1
"11243",2021-01-29,"Brush Creek Rd","w2021","Motorized",2,"Fri","weekday","sled","Brush/Cement",NA,NA,NA,6.1,NA,28,0,29,21.8,-2,1,0,0,-2,-1,-1,-1
"11244",2021-01-29,"Brush Creek Rd","w2021","Hybrid",0,"Fri","weekday","sled","Brush/Cement",NA,NA,NA,6.1,NA,28,0,29,21.8,-2,1,0,0,-2,-1,-1,-1
"11245",2021-01-30,"Brush Creek Rd","w2021","Non.motorized",26,"Sat","weekend","no_sled","Brush/Cement",NA,NA,NA,6.2,NA,29,1,21,21.4,0,-2,1,0,1,-1,0,0
"11246",2021-01-30,"Brush Creek Rd","w2021","Mechanized",0,"Sat","weekend","no_sled","Brush/Cement",NA,NA,NA,6.2,NA,29,1,21,21.4,0,-2,1,0,1,-1,0,0
"11247",2021-01-30,"Brush Creek Rd","w2021","Motorized",1,"Sat","weekend","sled","Brush/Cement",NA,NA,NA,6.2,NA,29,1,21,21.4,0,-2,1,0,1,-1,0,0
"11248",2021-01-30,"Brush Creek Rd","w2021","Hybrid",0,"Sat","weekend","sled","Brush/Cement",NA,NA,NA,6.2,NA,29,1,21,21.4,0,-2,1,0,1,-1,0,0
"11249",2021-01-31,"Brush Creek Rd","w2021","Non.motorized",36,"Sun","weekend","no_sled","Brush/Cement",NA,NA,NA,6.3,NA,29,0,21,21.7,1,0,-2,1,1,1,-1,0
"11250",2021-01-31,"Brush Creek Rd","w2021","Mechanized",1,"Sun","weekend","no_sled","Brush/Cement",NA,NA,NA,6.3,NA,29,0,21,21.7,1,0,-2,1,1,1,-1,0
"11251",2021-01-31,"Brush Creek Rd","w2021","Motorized",0,"Sun","weekend","sled","Brush/Cement",NA,NA,NA,6.3,NA,29,0,21,21.7,1,0,-2,1,1,1,-1,0
"11252",2021-01-31,"Brush Creek Rd","w2021","Hybrid",0,"Sun","weekend","sled","Brush/Cement",NA,NA,NA,6.3,NA,29,0,21,21.7,1,0,-2,1,1,1,-1,0
"11253",2021-02-01,"Brush Creek Rd","w2021","Non.motorized",14,"Mon","weekday","no_sled","Brush/Cement",NA,NA,NA,6.3,NA,28,-1,30,22.5,0,1,0,-2,-1,0,0,-2
"11254",2021-02-01,"Brush Creek Rd","w2021","Mechanized",0,"Mon","weekday","no_sled","Brush/Cement",NA,NA,NA,6.3,NA,28,-1,30,22.5,0,1,0,-2,-1,0,0,-2
"11255",2021-02-01,"Brush Creek Rd","w2021","Motorized",0,"Mon","weekday","sled","Brush/Cement",NA,NA,NA,6.3,NA,28,-1,30,22.5,0,1,0,-2,-1,0,0,-2
"11256",2021-02-01,"Brush Creek Rd","w2021","Hybrid",0,"Mon","weekday","sled","Brush/Cement",NA,NA,NA,6.3,NA,28,-1,30,22.5,0,1,0,-2,-1,0,0,-2
"11257",2021-02-02,"Brush Creek Rd","w2021","Non.motorized",10,"Tue","weekday","no_sled","Brush/Cement",NA,NA,NA,6.3,NA,28,0,34,22.5,-1,0,1,0,-1,-1,0,0
"11258",2021-02-02,"Brush Creek Rd","w2021","Mechanized",0,"Tue","weekday","no_sled","Brush/Cement",NA,NA,NA,6.3,NA,28,0,34,22.5,-1,0,1,0,-1,-1,0,0
"11259",2021-02-02,"Brush Creek Rd","w2021","Motorized",0,"Tue","weekday","sled","Brush/Cement",NA,NA,NA,6.3,NA,28,0,34,22.5,-1,0,1,0,-1,-1,0,0
"11260",2021-02-02,"Brush Creek Rd","w2021","Hybrid",0,"Tue","weekday","sled","Brush/Cement",NA,NA,NA,6.3,NA,28,0,34,22.5,-1,0,1,0,-1,-1,0,0
"11261",2021-02-03,"Brush Creek Rd","w2021","Non.motorized",4,"Wed","weekday","no_sled","Brush/Cement",NA,NA,NA,6.3,NA,27,-1,30,23.3,0,-1,0,1,-1,-2,-2,-1
"11262",2021-02-03,"Brush Creek Rd","w2021","Mechanized",0,"Wed","weekday","no_sled","Brush/Cement",NA,NA,NA,6.3,NA,27,-1,30,23.3,0,-1,0,1,-1,-2,-2,-1
"11263",2021-02-03,"Brush Creek Rd","w2021","Motorized",0,"Wed","weekday","sled","Brush/Cement",NA,NA,NA,6.3,NA,27,-1,30,23.3,0,-1,0,1,-1,-2,-2,-1
"11264",2021-02-03,"Brush Creek Rd","w2021","Hybrid",0,"Wed","weekday","sled","Brush/Cement",NA,NA,NA,6.3,NA,27,-1,30,23.3,0,-1,0,1,-1,-2,-2,-1
"11265",2021-02-04,"Brush Creek Rd","w2021","Non.motorized",9,"Thu","weekday","no_sled","Brush/Cement",NA,NA,NA,7.2,NA,37,10,14,19.5,-1,0,-1,0,9,9,8,8
"11266",2021-02-04,"Brush Creek Rd","w2021","Mechanized",0,"Thu","weekday","no_sled","Brush/Cement",NA,NA,NA,7.2,NA,37,10,14,19.5,-1,0,-1,0,9,9,8,8
"11267",2021-02-04,"Brush Creek Rd","w2021","Motorized",0,"Thu","weekday","sled","Brush/Cement",NA,NA,NA,7.2,NA,37,10,14,19.5,-1,0,-1,0,9,9,8,8
"11268",2021-02-04,"Brush Creek Rd","w2021","Hybrid",0,"Thu","weekday","sled","Brush/Cement",NA,NA,NA,7.2,NA,37,10,14,19.5,-1,0,-1,0,9,9,8,8
"11269",2021-02-05,"Brush Creek Rd","w2021","Non.motorized",6,"Fri","weekday","no_sled","Brush/Cement",NA,NA,NA,7.2,NA,35,-2,16,20.6,10,-1,0,-1,8,7,7,6
"11270",2021-02-05,"Brush Creek Rd","w2021","Mechanized",0,"Fri","weekday","no_sled","Brush/Cement",NA,NA,NA,7.2,NA,35,-2,16,20.6,10,-1,0,-1,8,7,7,6
"11271",2021-02-05,"Brush Creek Rd","w2021","Motorized",0,"Fri","weekday","sled","Brush/Cement",NA,NA,NA,7.2,NA,35,-2,16,20.6,10,-1,0,-1,8,7,7,6
"11272",2021-02-05,"Brush Creek Rd","w2021","Hybrid",0,"Fri","weekday","sled","Brush/Cement",NA,NA,NA,7.2,NA,35,-2,16,20.6,10,-1,0,-1,8,7,7,6
"11273",2021-02-06,"Brush Creek Rd","w2021","Non.motorized",NA,"Sat","weekend","no_sled","Brush/Cement",NA,NA,NA,7.5,NA,37,2,19,20.3,-2,10,-1,0,0,10,9,9
"11274",2021-02-06,"Brush Creek Rd","w2021","Mechanized",NA,"Sat","weekend","no_sled","Brush/Cement",NA,NA,NA,7.5,NA,37,2,19,20.3,-2,10,-1,0,0,10,9,9
"11275",2021-02-06,"Brush Creek Rd","w2021","Motorized",NA,"Sat","weekend","sled","Brush/Cement",NA,NA,NA,7.5,NA,37,2,19,20.3,-2,10,-1,0,0,10,9,9
"11276",2021-02-06,"Brush Creek Rd","w2021","Hybrid",NA,"Sat","weekend","sled","Brush/Cement",NA,NA,NA,7.5,NA,37,2,19,20.3,-2,10,-1,0,0,10,9,9
"11277",2021-02-07,"Brush Creek Rd","w2021","Non.motorized",3,"Sun","weekend","no_sled","Brush/Cement",NA,NA,NA,7.5,NA,36,-1,24,20.8,2,-2,10,-1,1,-1,9,8
"11278",2021-02-07,"Brush Creek Rd","w2021","Mechanized",0,"Sun","weekend","no_sled","Brush/Cement",NA,NA,NA,7.5,NA,36,-1,24,20.8,2,-2,10,-1,1,-1,9,8
"11279",2021-02-07,"Brush Creek Rd","w2021","Motorized",1,"Sun","weekend","sled","Brush/Cement",NA,NA,NA,7.5,NA,36,-1,24,20.8,2,-2,10,-1,1,-1,9,8
"11280",2021-02-07,"Brush Creek Rd","w2021","Hybrid",0,"Sun","weekend","sled","Brush/Cement",NA,NA,NA,7.5,NA,36,-1,24,20.8,2,-2,10,-1,1,-1,9,8
"11281",2021-02-08,"Brush Creek Rd","w2021","Non.motorized",18,"Mon","weekday","no_sled","Brush/Cement",NA,NA,NA,7.6,NA,35,-1,28,21.7,-1,2,-2,10,-2,0,-2,8
"11282",2021-02-08,"Brush Creek Rd","w2021","Mechanized",0,"Mon","weekday","no_sled","Brush/Cement",NA,NA,NA,7.6,NA,35,-1,28,21.7,-1,2,-2,10,-2,0,-2,8
"11283",2021-02-08,"Brush Creek Rd","w2021","Motorized",1,"Mon","weekday","sled","Brush/Cement",NA,NA,NA,7.6,NA,35,-1,28,21.7,-1,2,-2,10,-2,0,-2,8
"11284",2021-02-08,"Brush Creek Rd","w2021","Hybrid",2,"Mon","weekday","sled","Brush/Cement",NA,NA,NA,7.6,NA,35,-1,28,21.7,-1,2,-2,10,-2,0,-2,8
"11285",2021-02-09,"Brush Creek Rd","w2021","Non.motorized",13,"Tue","weekday","no_sled","Brush/Cement",NA,NA,NA,7.6,NA,34,-1,28,22.4,-1,-1,2,-2,-2,-3,-1,-3
"11286",2021-02-09,"Brush Creek Rd","w2021","Mechanized",0,"Tue","weekday","no_sled","Brush/Cement",NA,NA,NA,7.6,NA,34,-1,28,22.4,-1,-1,2,-2,-2,-3,-1,-3
"11287",2021-02-09,"Brush Creek Rd","w2021","Motorized",0,"Tue","weekday","sled","Brush/Cement",NA,NA,NA,7.6,NA,34,-1,28,22.4,-1,-1,2,-2,-2,-3,-1,-3
"11288",2021-02-09,"Brush Creek Rd","w2021","Hybrid",0,"Tue","weekday","sled","Brush/Cement",NA,NA,NA,7.6,NA,34,-1,28,22.4,-1,-1,2,-2,-2,-3,-1,-3
"11289",2021-02-10,"Brush Creek Rd","w2021","Non.motorized",8,"Wed","weekday","no_sled","Brush/Cement",NA,NA,NA,7.7,NA,34,0,26,22.6,-1,-1,-1,2,-1,-2,-3,-1
"11290",2021-02-10,"Brush Creek Rd","w2021","Mechanized",0,"Wed","weekday","no_sled","Brush/Cement",NA,NA,NA,7.7,NA,34,0,26,22.6,-1,-1,-1,2,-1,-2,-3,-1
"11291",2021-02-10,"Brush Creek Rd","w2021","Motorized",0,"Wed","weekday","sled","Brush/Cement",NA,NA,NA,7.7,NA,34,0,26,22.6,-1,-1,-1,2,-1,-2,-3,-1
"11292",2021-02-10,"Brush Creek Rd","w2021","Hybrid",0,"Wed","weekday","sled","Brush/Cement",NA,NA,NA,7.7,NA,34,0,26,22.6,-1,-1,-1,2,-1,-2,-3,-1
"11293",2021-02-11,"Brush Creek Rd","w2021","Non.motorized",12,"Thu","weekday","no_sled","Brush/Cement",NA,NA,NA,8,NA,37,3,26,21.6,0,-1,-1,-1,3,2,1,0
"11294",2021-02-11,"Brush Creek Rd","w2021","Mechanized",0,"Thu","weekday","no_sled","Brush/Cement",NA,NA,NA,8,NA,37,3,26,21.6,0,-1,-1,-1,3,2,1,0
"11295",2021-02-11,"Brush Creek Rd","w2021","Motorized",0,"Thu","weekday","sled","Brush/Cement",NA,NA,NA,8,NA,37,3,26,21.6,0,-1,-1,-1,3,2,1,0
"11296",2021-02-11,"Brush Creek Rd","w2021","Hybrid",0,"Thu","weekday","sled","Brush/Cement",NA,NA,NA,8,NA,37,3,26,21.6,0,-1,-1,-1,3,2,1,0
"11297",2021-02-12,"Brush Creek Rd","w2021","Non.motorized",11,"Fri","weekday","no_sled","Brush/Cement",NA,NA,NA,8.1,NA,37,0,27,21.9,3,0,-1,-1,3,3,2,1
"11298",2021-02-12,"Brush Creek Rd","w2021","Mechanized",0,"Fri","weekday","no_sled","Brush/Cement",NA,NA,NA,8.1,NA,37,0,27,21.9,3,0,-1,-1,3,3,2,1
"11299",2021-02-12,"Brush Creek Rd","w2021","Motorized",0,"Fri","weekday","sled","Brush/Cement",NA,NA,NA,8.1,NA,37,0,27,21.9,3,0,-1,-1,3,3,2,1
"11300",2021-02-12,"Brush Creek Rd","w2021","Hybrid",0,"Fri","weekday","sled","Brush/Cement",NA,NA,NA,8.1,NA,37,0,27,21.9,3,0,-1,-1,3,3,2,1
"11301",2021-02-13,"Brush Creek Rd","w2021","Non.motorized",31,"Sat","weekend","no_sled","Brush/Cement",NA,NA,NA,8.4,NA,38,1,26,22.1,0,3,0,-1,1,4,4,3
"11302",2021-02-13,"Brush Creek Rd","w2021","Mechanized",0,"Sat","weekend","no_sled","Brush/Cement",NA,NA,NA,8.4,NA,38,1,26,22.1,0,3,0,-1,1,4,4,3
"11303",2021-02-13,"Brush Creek Rd","w2021","Motorized",1,"Sat","weekend","sled","Brush/Cement",NA,NA,NA,8.4,NA,38,1,26,22.1,0,3,0,-1,1,4,4,3
"11304",2021-02-13,"Brush Creek Rd","w2021","Hybrid",0,"Sat","weekend","sled","Brush/Cement",NA,NA,NA,8.4,NA,38,1,26,22.1,0,3,0,-1,1,4,4,3
"11305",2021-02-14,"Brush Creek Rd","w2021","Non.motorized",24,"Sun","weekend","no_sled","Brush/Cement",NA,NA,NA,8.9,NA,43,5,18,20.7,1,0,3,0,6,6,9,9
"11306",2021-02-14,"Brush Creek Rd","w2021","Mechanized",0,"Sun","weekend","no_sled","Brush/Cement",NA,NA,NA,8.9,NA,43,5,18,20.7,1,0,3,0,6,6,9,9
"11307",2021-02-14,"Brush Creek Rd","w2021","Motorized",1,"Sun","weekend","sled","Brush/Cement",NA,NA,NA,8.9,NA,43,5,18,20.7,1,0,3,0,6,6,9,9
"11308",2021-02-14,"Brush Creek Rd","w2021","Hybrid",0,"Sun","weekend","sled","Brush/Cement",NA,NA,NA,8.9,NA,43,5,18,20.7,1,0,3,0,6,6,9,9
"11309",2021-02-15,"Brush Creek Rd","w2021","Non.motorized",13,"Mon","weekday","no_sled","Brush/Cement",NA,NA,NA,8.9,NA,43,0,12,20.7,5,1,0,3,5,6,6,9
"11310",2021-02-15,"Brush Creek Rd","w2021","Mechanized",0,"Mon","weekday","no_sled","Brush/Cement",NA,NA,NA,8.9,NA,43,0,12,20.7,5,1,0,3,5,6,6,9
"11311",2021-02-15,"Brush Creek Rd","w2021","Motorized",0,"Mon","weekday","sled","Brush/Cement",NA,NA,NA,8.9,NA,43,0,12,20.7,5,1,0,3,5,6,6,9
"11312",2021-02-15,"Brush Creek Rd","w2021","Hybrid",0,"Mon","weekday","sled","Brush/Cement",NA,NA,NA,8.9,NA,43,0,12,20.7,5,1,0,3,5,6,6,9
"11313",2021-02-16,"Brush Creek Rd","w2021","Non.motorized",10,"Tue","weekday","no_sled","Brush/Cement",NA,NA,NA,9,NA,41,-2,17,22,0,5,1,0,-2,3,4,4
"11314",2021-02-16,"Brush Creek Rd","w2021","Mechanized",0,"Tue","weekday","no_sled","Brush/Cement",NA,NA,NA,9,NA,41,-2,17,22,0,5,1,0,-2,3,4,4
"11315",2021-02-16,"Brush Creek Rd","w2021","Motorized",0,"Tue","weekday","sled","Brush/Cement",NA,NA,NA,9,NA,41,-2,17,22,0,5,1,0,-2,3,4,4
"11316",2021-02-16,"Brush Creek Rd","w2021","Hybrid",1,"Tue","weekday","sled","Brush/Cement",NA,NA,NA,9,NA,41,-2,17,22,0,5,1,0,-2,3,4,4
"11317",2021-02-17,"Brush Creek Rd","w2021","Non.motorized",18,"Wed","weekday","no_sled","Brush/Cement",NA,NA,NA,9.1,NA,42,1,13,21.7,-2,0,5,1,-1,-1,4,5
"11318",2021-02-17,"Brush Creek Rd","w2021","Mechanized",0,"Wed","weekday","no_sled","Brush/Cement",NA,NA,NA,9.1,NA,42,1,13,21.7,-2,0,5,1,-1,-1,4,5
"11319",2021-02-17,"Brush Creek Rd","w2021","Motorized",0,"Wed","weekday","sled","Brush/Cement",NA,NA,NA,9.1,NA,42,1,13,21.7,-2,0,5,1,-1,-1,4,5
"11320",2021-02-17,"Brush Creek Rd","w2021","Hybrid",0,"Wed","weekday","sled","Brush/Cement",NA,NA,NA,9.1,NA,42,1,13,21.7,-2,0,5,1,-1,-1,4,5
"11321",2021-02-18,"Brush Creek Rd","w2021","Non.motorized",5,"Thu","weekday","no_sled","Brush/Cement",NA,NA,NA,9.1,NA,41,-1,11,22.2,1,-2,0,5,0,-2,-2,3
"11322",2021-02-18,"Brush Creek Rd","w2021","Mechanized",0,"Thu","weekday","no_sled","Brush/Cement",NA,NA,NA,9.1,NA,41,-1,11,22.2,1,-2,0,5,0,-2,-2,3
"11323",2021-02-18,"Brush Creek Rd","w2021","Motorized",0,"Thu","weekday","sled","Brush/Cement",NA,NA,NA,9.1,NA,41,-1,11,22.2,1,-2,0,5,0,-2,-2,3
"11324",2021-02-18,"Brush Creek Rd","w2021","Hybrid",0,"Thu","weekday","sled","Brush/Cement",NA,NA,NA,9.1,NA,41,-1,11,22.2,1,-2,0,5,0,-2,-2,3
"11325",2021-02-19,"Brush Creek Rd","w2021","Non.motorized",17,"Fri","weekday","no_sled","Brush/Cement",NA,NA,NA,9.1,NA,40,-1,18,22.8,-1,1,-2,0,-2,-1,-3,-3
"11326",2021-02-19,"Brush Creek Rd","w2021","Mechanized",0,"Fri","weekday","no_sled","Brush/Cement",NA,NA,NA,9.1,NA,40,-1,18,22.8,-1,1,-2,0,-2,-1,-3,-3
"11327",2021-02-19,"Brush Creek Rd","w2021","Motorized",0,"Fri","weekday","sled","Brush/Cement",NA,NA,NA,9.1,NA,40,-1,18,22.8,-1,1,-2,0,-2,-1,-3,-3
"11328",2021-02-19,"Brush Creek Rd","w2021","Hybrid",0,"Fri","weekday","sled","Brush/Cement",NA,NA,NA,9.1,NA,40,-1,18,22.8,-1,1,-2,0,-2,-1,-3,-3
"11329",2021-02-20,"Brush Creek Rd","w2021","Non.motorized",27,"Sat","weekend","no_sled","Brush/Cement",NA,NA,NA,9.2,NA,39,-1,23,23.6,-1,-1,1,-2,-2,-3,-2,-4
"11330",2021-02-20,"Brush Creek Rd","w2021","Mechanized",0,"Sat","weekend","no_sled","Brush/Cement",NA,NA,NA,9.2,NA,39,-1,23,23.6,-1,-1,1,-2,-2,-3,-2,-4
"11331",2021-02-20,"Brush Creek Rd","w2021","Motorized",0,"Sat","weekend","sled","Brush/Cement",NA,NA,NA,9.2,NA,39,-1,23,23.6,-1,-1,1,-2,-2,-3,-2,-4
"11332",2021-02-20,"Brush Creek Rd","w2021","Hybrid",0,"Sat","weekend","sled","Brush/Cement",NA,NA,NA,9.2,NA,39,-1,23,23.6,-1,-1,1,-2,-2,-3,-2,-4
"11333",2021-02-21,"Brush Creek Rd","w2021","Non.motorized",27,"Sun","weekend","no_sled","Brush/Cement",NA,NA,NA,9.2,NA,39,0,15,23.6,-1,-1,-1,1,-1,-2,-3,-2
"11334",2021-02-21,"Brush Creek Rd","w2021","Mechanized",0,"Sun","weekend","no_sled","Brush/Cement",NA,NA,NA,9.2,NA,39,0,15,23.6,-1,-1,-1,1,-1,-2,-3,-2
"11335",2021-02-21,"Brush Creek Rd","w2021","Motorized",0,"Sun","weekend","sled","Brush/Cement",NA,NA,NA,9.2,NA,39,0,15,23.6,-1,-1,-1,1,-1,-2,-3,-2
"11336",2021-02-21,"Brush Creek Rd","w2021","Hybrid",0,"Sun","weekend","sled","Brush/Cement",NA,NA,NA,9.2,NA,39,0,15,23.6,-1,-1,-1,1,-1,-2,-3,-2
"11337",2021-02-22,"Brush Creek Rd","w2021","Non.motorized",12,"Mon","weekday","no_sled","Brush/Cement",NA,NA,NA,9.2,NA,39,0,23,23.6,0,-1,-1,-1,0,-1,-2,-3
"11338",2021-02-22,"Brush Creek Rd","w2021","Mechanized",0,"Mon","weekday","no_sled","Brush/Cement",NA,NA,NA,9.2,NA,39,0,23,23.6,0,-1,-1,-1,0,-1,-2,-3
"11339",2021-02-22,"Brush Creek Rd","w2021","Motorized",0,"Mon","weekday","sled","Brush/Cement",NA,NA,NA,9.2,NA,39,0,23,23.6,0,-1,-1,-1,0,-1,-2,-3
"11340",2021-02-22,"Brush Creek Rd","w2021","Hybrid",0,"Mon","weekday","sled","Brush/Cement",NA,NA,NA,9.2,NA,39,0,23,23.6,0,-1,-1,-1,0,-1,-2,-3
"11341",2021-02-23,"Brush Creek Rd","w2021","Non.motorized",10,"Tue","weekday","no_sled","Brush/Cement",NA,NA,NA,9.2,NA,38,-1,28,24.2,0,0,-1,-1,-1,-1,-2,-3
"11342",2021-02-23,"Brush Creek Rd","w2021","Mechanized",0,"Tue","weekday","no_sled","Brush/Cement",NA,NA,NA,9.2,NA,38,-1,28,24.2,0,0,-1,-1,-1,-1,-2,-3
"11343",2021-02-23,"Brush Creek Rd","w2021","Motorized",0,"Tue","weekday","sled","Brush/Cement",NA,NA,NA,9.2,NA,38,-1,28,24.2,0,0,-1,-1,-1,-1,-2,-3
"11344",2021-02-23,"Brush Creek Rd","w2021","Hybrid",0,"Tue","weekday","sled","Brush/Cement",NA,NA,NA,9.2,NA,38,-1,28,24.2,0,0,-1,-1,-1,-1,-2,-3
"11345",2021-02-24,"Brush Creek Rd","w2021","Non.motorized",14,"Wed","weekday","no_sled","Brush/Cement",NA,NA,NA,9.2,NA,38,0,23,24.2,-1,0,0,-1,-1,-1,-1,-2
"11346",2021-02-24,"Brush Creek Rd","w2021","Mechanized",0,"Wed","weekday","no_sled","Brush/Cement",NA,NA,NA,9.2,NA,38,0,23,24.2,-1,0,0,-1,-1,-1,-1,-2
"11347",2021-02-24,"Brush Creek Rd","w2021","Motorized",0,"Wed","weekday","sled","Brush/Cement",NA,NA,NA,9.2,NA,38,0,23,24.2,-1,0,0,-1,-1,-1,-1,-2
"11348",2021-02-24,"Brush Creek Rd","w2021","Hybrid",0,"Wed","weekday","sled","Brush/Cement",NA,NA,NA,9.2,NA,38,0,23,24.2,-1,0,0,-1,-1,-1,-1,-2
"11349",2021-02-25,"Brush Creek Rd","w2021","Non.motorized",27,"Thu","weekday","no_sled","Brush/Cement",NA,NA,NA,9.2,NA,37,-1,20,24.9,0,-1,0,0,-1,-2,-2,-2
"11350",2021-02-25,"Brush Creek Rd","w2021","Mechanized",0,"Thu","weekday","no_sled","Brush/Cement",NA,NA,NA,9.2,NA,37,-1,20,24.9,0,-1,0,0,-1,-2,-2,-2
"11351",2021-02-25,"Brush Creek Rd","w2021","Motorized",0,"Thu","weekday","sled","Brush/Cement",NA,NA,NA,9.2,NA,37,-1,20,24.9,0,-1,0,0,-1,-2,-2,-2
"11352",2021-02-25,"Brush Creek Rd","w2021","Hybrid",0,"Thu","weekday","sled","Brush/Cement",NA,NA,NA,9.2,NA,37,-1,20,24.9,0,-1,0,0,-1,-2,-2,-2
"11353",2021-02-26,"Brush Creek Rd","w2021","Non.motorized",9,"Fri","weekday","no_sled","Brush/Cement",NA,NA,NA,9.2,NA,37,0,21,24.9,-1,0,-1,0,-1,-1,-2,-2
"11354",2021-02-26,"Brush Creek Rd","w2021","Mechanized",0,"Fri","weekday","no_sled","Brush/Cement",NA,NA,NA,9.2,NA,37,0,21,24.9,-1,0,-1,0,-1,-1,-2,-2
"11355",2021-02-26,"Brush Creek Rd","w2021","Motorized",0,"Fri","weekday","sled","Brush/Cement",NA,NA,NA,9.2,NA,37,0,21,24.9,-1,0,-1,0,-1,-1,-2,-2
"11356",2021-02-26,"Brush Creek Rd","w2021","Hybrid",0,"Fri","weekday","sled","Brush/Cement",NA,NA,NA,9.2,NA,37,0,21,24.9,-1,0,-1,0,-1,-1,-2,-2
"11357",2021-02-27,"Brush Creek Rd","w2021","Non.motorized",17,"Sat","weekend","no_sled","Brush/Cement",NA,NA,NA,9.2,NA,37,0,15,24.9,0,-1,0,-1,0,-1,-1,-2
"11358",2021-02-27,"Brush Creek Rd","w2021","Mechanized",0,"Sat","weekend","no_sled","Brush/Cement",NA,NA,NA,9.2,NA,37,0,15,24.9,0,-1,0,-1,0,-1,-1,-2
"11359",2021-02-27,"Brush Creek Rd","w2021","Motorized",1,"Sat","weekend","sled","Brush/Cement",NA,NA,NA,9.2,NA,37,0,15,24.9,0,-1,0,-1,0,-1,-1,-2
"11360",2021-02-27,"Brush Creek Rd","w2021","Hybrid",0,"Sat","weekend","sled","Brush/Cement",NA,NA,NA,9.2,NA,37,0,15,24.9,0,-1,0,-1,0,-1,-1,-2
"11361",2021-02-28,"Brush Creek Rd","w2021","Non.motorized",47,"Sun","weekend","no_sled","Brush/Cement",NA,NA,NA,9.2,NA,38,1,9,24.2,0,0,-1,0,1,1,0,0
"11362",2021-02-28,"Brush Creek Rd","w2021","Mechanized",1,"Sun","weekend","no_sled","Brush/Cement",NA,NA,NA,9.2,NA,38,1,9,24.2,0,0,-1,0,1,1,0,0
"11363",2021-02-28,"Brush Creek Rd","w2021","Motorized",0,"Sun","weekend","sled","Brush/Cement",NA,NA,NA,9.2,NA,38,1,9,24.2,0,0,-1,0,1,1,0,0
"11364",2021-02-28,"Brush Creek Rd","w2021","Hybrid",0,"Sun","weekend","sled","Brush/Cement",NA,NA,NA,9.2,NA,38,1,9,24.2,0,0,-1,0,1,1,0,0
"11365",2021-03-01,"Brush Creek Rd","w2021","Non.motorized",9,"Mon","weekday","no_sled","Brush/Cement",NA,NA,NA,9.2,NA,37,-1,20,24.9,1,0,0,-1,0,0,0,-1
"11366",2021-03-01,"Brush Creek Rd","w2021","Mechanized",0,"Mon","weekday","no_sled","Brush/Cement",NA,NA,NA,9.2,NA,37,-1,20,24.9,1,0,0,-1,0,0,0,-1
"11367",2021-03-01,"Brush Creek Rd","w2021","Motorized",0,"Mon","weekday","sled","Brush/Cement",NA,NA,NA,9.2,NA,37,-1,20,24.9,1,0,0,-1,0,0,0,-1
"11368",2021-03-01,"Brush Creek Rd","w2021","Hybrid",0,"Mon","weekday","sled","Brush/Cement",NA,NA,NA,9.2,NA,37,-1,20,24.9,1,0,0,-1,0,0,0,-1
"11369",2021-03-02,"Brush Creek Rd","w2021","Non.motorized",20,"Tue","weekday","no_sled","Brush/Cement",NA,NA,NA,9.2,NA,36,-1,27,25.6,-1,1,0,0,-2,-1,-1,-1
"11370",2021-03-02,"Brush Creek Rd","w2021","Mechanized",0,"Tue","weekday","no_sled","Brush/Cement",NA,NA,NA,9.2,NA,36,-1,27,25.6,-1,1,0,0,-2,-1,-1,-1
"11371",2021-03-02,"Brush Creek Rd","w2021","Motorized",0,"Tue","weekday","sled","Brush/Cement",NA,NA,NA,9.2,NA,36,-1,27,25.6,-1,1,0,0,-2,-1,-1,-1
"11372",2021-03-02,"Brush Creek Rd","w2021","Hybrid",0,"Tue","weekday","sled","Brush/Cement",NA,NA,NA,9.2,NA,36,-1,27,25.6,-1,1,0,0,-2,-1,-1,-1
"11373",2021-03-03,"Brush Creek Rd","w2021","Non.motorized",17,"Wed","weekday","no_sled","Brush/Cement",NA,NA,NA,9.2,NA,36,0,31,25.6,-1,-1,1,0,-1,-2,-1,-1
"11374",2021-03-03,"Brush Creek Rd","w2021","Mechanized",0,"Wed","weekday","no_sled","Brush/Cement",NA,NA,NA,9.2,NA,36,0,31,25.6,-1,-1,1,0,-1,-2,-1,-1
"11375",2021-03-03,"Brush Creek Rd","w2021","Motorized",0,"Wed","weekday","sled","Brush/Cement",NA,NA,NA,9.2,NA,36,0,31,25.6,-1,-1,1,0,-1,-2,-1,-1
"11376",2021-03-03,"Brush Creek Rd","w2021","Hybrid",0,"Wed","weekday","sled","Brush/Cement",NA,NA,NA,9.2,NA,36,0,31,25.6,-1,-1,1,0,-1,-2,-1,-1
"11377",2021-03-04,"Brush Creek Rd","w2021","Non.motorized",6,"Thu","weekday","no_sled","Brush/Cement",NA,NA,NA,9.2,NA,36,0,28,25.6,0,-1,-1,1,0,-1,-2,-1
"11378",2021-03-04,"Brush Creek Rd","w2021","Mechanized",0,"Thu","weekday","no_sled","Brush/Cement",NA,NA,NA,9.2,NA,36,0,28,25.6,0,-1,-1,1,0,-1,-2,-1
"11379",2021-03-04,"Brush Creek Rd","w2021","Motorized",0,"Thu","weekday","sled","Brush/Cement",NA,NA,NA,9.2,NA,36,0,28,25.6,0,-1,-1,1,0,-1,-2,-1
"11380",2021-03-04,"Brush Creek Rd","w2021","Hybrid",0,"Thu","weekday","sled","Brush/Cement",NA,NA,NA,9.2,NA,36,0,28,25.6,0,-1,-1,1,0,-1,-2,-1
"11381",2021-03-05,"Brush Creek Rd","w2021","Non.motorized",6,"Fri","weekday","no_sled","Brush/Cement",NA,NA,NA,9.4,NA,39,3,30,24.1,0,0,-1,-1,3,3,2,1
"11382",2021-03-05,"Brush Creek Rd","w2021","Mechanized",1,"Fri","weekday","no_sled","Brush/Cement",NA,NA,NA,9.4,NA,39,3,30,24.1,0,0,-1,-1,3,3,2,1
"11383",2021-03-05,"Brush Creek Rd","w2021","Motorized",0,"Fri","weekday","sled","Brush/Cement",NA,NA,NA,9.4,NA,39,3,30,24.1,0,0,-1,-1,3,3,2,1
"11384",2021-03-05,"Brush Creek Rd","w2021","Hybrid",0,"Fri","weekday","sled","Brush/Cement",NA,NA,NA,9.4,NA,39,3,30,24.1,0,0,-1,-1,3,3,2,1
"11385",2021-03-06,"Brush Creek Rd","w2021","Non.motorized",23,"Sat","weekend","no_sled","Brush/Cement",NA,NA,NA,9.4,NA,38,-1,32,24.7,3,0,0,-1,2,2,2,1
"11386",2021-03-06,"Brush Creek Rd","w2021","Mechanized",0,"Sat","weekend","no_sled","Brush/Cement",NA,NA,NA,9.4,NA,38,-1,32,24.7,3,0,0,-1,2,2,2,1
"11387",2021-03-06,"Brush Creek Rd","w2021","Motorized",2,"Sat","weekend","sled","Brush/Cement",NA,NA,NA,9.4,NA,38,-1,32,24.7,3,0,0,-1,2,2,2,1
"11388",2021-03-06,"Brush Creek Rd","w2021","Hybrid",0,"Sat","weekend","sled","Brush/Cement",NA,NA,NA,9.4,NA,38,-1,32,24.7,3,0,0,-1,2,2,2,1
"11389",2021-03-07,"Brush Creek Rd","w2021","Non.motorized",29,"Sun","weekend","no_sled","Brush/Cement",NA,NA,NA,9.4,NA,37,-1,35,25.4,-1,3,0,0,-2,1,1,1
"11390",2021-03-07,"Brush Creek Rd","w2021","Mechanized",0,"Sun","weekend","no_sled","Brush/Cement",NA,NA,NA,9.4,NA,37,-1,35,25.4,-1,3,0,0,-2,1,1,1
"11391",2021-03-07,"Brush Creek Rd","w2021","Motorized",0,"Sun","weekend","sled","Brush/Cement",NA,NA,NA,9.4,NA,37,-1,35,25.4,-1,3,0,0,-2,1,1,1
"11392",2021-03-07,"Brush Creek Rd","w2021","Hybrid",0,"Sun","weekend","sled","Brush/Cement",NA,NA,NA,9.4,NA,37,-1,35,25.4,-1,3,0,0,-2,1,1,1
"11393",2021-03-08,"Brush Creek Rd","w2021","Non.motorized",19,"Mon","weekday","no_sled","Brush/Cement",NA,NA,NA,9.5,NA,37,0,33,25.7,-1,-1,3,0,-1,-2,1,1
"11394",2021-03-08,"Brush Creek Rd","w2021","Mechanized",0,"Mon","weekday","no_sled","Brush/Cement",NA,NA,NA,9.5,NA,37,0,33,25.7,-1,-1,3,0,-1,-2,1,1
"11395",2021-03-08,"Brush Creek Rd","w2021","Motorized",0,"Mon","weekday","sled","Brush/Cement",NA,NA,NA,9.5,NA,37,0,33,25.7,-1,-1,3,0,-1,-2,1,1
"11396",2021-03-08,"Brush Creek Rd","w2021","Hybrid",0,"Mon","weekday","sled","Brush/Cement",NA,NA,NA,9.5,NA,37,0,33,25.7,-1,-1,3,0,-1,-2,1,1
"11397",2021-03-09,"Brush Creek Rd","w2021","Non.motorized",13,"Tue","weekday","no_sled","Brush/Cement",NA,NA,NA,9.5,NA,37,0,33,25.7,0,-1,-1,3,0,-1,-2,1
"11398",2021-03-09,"Brush Creek Rd","w2021","Mechanized",0,"Tue","weekday","no_sled","Brush/Cement",NA,NA,NA,9.5,NA,37,0,33,25.7,0,-1,-1,3,0,-1,-2,1
"11399",2021-03-09,"Brush Creek Rd","w2021","Motorized",0,"Tue","weekday","sled","Brush/Cement",NA,NA,NA,9.5,NA,37,0,33,25.7,0,-1,-1,3,0,-1,-2,1
"11400",2021-03-09,"Brush Creek Rd","w2021","Hybrid",0,"Tue","weekday","sled","Brush/Cement",NA,NA,NA,9.5,NA,37,0,33,25.7,0,-1,-1,3,0,-1,-2,1
"11401",2021-03-10,"Brush Creek Rd","w2021","Non.motorized",14,"Wed","weekday","no_sled","Brush/Cement",NA,NA,NA,9.7,NA,39,2,21,24.9,0,0,-1,-1,2,2,1,0
"11402",2021-03-10,"Brush Creek Rd","w2021","Mechanized",0,"Wed","weekday","no_sled","Brush/Cement",NA,NA,NA,9.7,NA,39,2,21,24.9,0,0,-1,-1,2,2,1,0
"11403",2021-03-10,"Brush Creek Rd","w2021","Motorized",0,"Wed","weekday","sled","Brush/Cement",NA,NA,NA,9.7,NA,39,2,21,24.9,0,0,-1,-1,2,2,1,0
"11404",2021-03-10,"Brush Creek Rd","w2021","Hybrid",0,"Wed","weekday","sled","Brush/Cement",NA,NA,NA,9.7,NA,39,2,21,24.9,0,0,-1,-1,2,2,1,0
"11405",2021-03-11,"Brush Creek Rd","w2021","Non.motorized",17,"Thu","weekday","no_sled","Brush/Cement",NA,NA,NA,9.8,NA,40,1,22,24.5,2,0,0,-1,3,3,3,2
"11406",2021-03-11,"Brush Creek Rd","w2021","Mechanized",0,"Thu","weekday","no_sled","Brush/Cement",NA,NA,NA,9.8,NA,40,1,22,24.5,2,0,0,-1,3,3,3,2
"11407",2021-03-11,"Brush Creek Rd","w2021","Motorized",0,"Thu","weekday","sled","Brush/Cement",NA,NA,NA,9.8,NA,40,1,22,24.5,2,0,0,-1,3,3,3,2
"11408",2021-03-11,"Brush Creek Rd","w2021","Hybrid",0,"Thu","weekday","sled","Brush/Cement",NA,NA,NA,9.8,NA,40,1,22,24.5,2,0,0,-1,3,3,3,2
"11409",2021-03-12,"Brush Creek Rd","w2021","Non.motorized",19,"Fri","weekday","no_sled","Brush/Cement",NA,NA,NA,9.8,NA,39,-1,29,25.1,1,2,0,0,0,2,2,2
"11410",2021-03-12,"Brush Creek Rd","w2021","Mechanized",0,"Fri","weekday","no_sled","Brush/Cement",NA,NA,NA,9.8,NA,39,-1,29,25.1,1,2,0,0,0,2,2,2
"11411",2021-03-12,"Brush Creek Rd","w2021","Motorized",0,"Fri","weekday","sled","Brush/Cement",NA,NA,NA,9.8,NA,39,-1,29,25.1,1,2,0,0,0,2,2,2
"11412",2021-03-12,"Brush Creek Rd","w2021","Hybrid",0,"Fri","weekday","sled","Brush/Cement",NA,NA,NA,9.8,NA,39,-1,29,25.1,1,2,0,0,0,2,2,2
"11413",2021-03-13,"Brush Creek Rd","w2021","Non.motorized",21,"Sat","weekend","no_sled","Brush/Cement",NA,NA,NA,9.8,NA,38,-1,27,25.8,-1,1,2,0,-2,-1,1,1
"11414",2021-03-13,"Brush Creek Rd","w2021","Mechanized",0,"Sat","weekend","no_sled","Brush/Cement",NA,NA,NA,9.8,NA,38,-1,27,25.8,-1,1,2,0,-2,-1,1,1
"11415",2021-03-13,"Brush Creek Rd","w2021","Motorized",2,"Sat","weekend","sled","Brush/Cement",NA,NA,NA,9.8,NA,38,-1,27,25.8,-1,1,2,0,-2,-1,1,1
"11416",2021-03-13,"Brush Creek Rd","w2021","Hybrid",1,"Sat","weekend","sled","Brush/Cement",NA,NA,NA,9.8,NA,38,-1,27,25.8,-1,1,2,0,-2,-1,1,1
"11417",2021-03-14,"Brush Creek Rd","w2021","Non.motorized",26,"Sun","weekend","no_sled","Brush/Cement",NA,NA,NA,10.2,NA,42,4,23,24.3,-1,-1,1,2,3,2,3,5
"11418",2021-03-14,"Brush Creek Rd","w2021","Mechanized",1,"Sun","weekend","no_sled","Brush/Cement",NA,NA,NA,10.2,NA,42,4,23,24.3,-1,-1,1,2,3,2,3,5
"11419",2021-03-14,"Brush Creek Rd","w2021","Motorized",0,"Sun","weekend","sled","Brush/Cement",NA,NA,NA,10.2,NA,42,4,23,24.3,-1,-1,1,2,3,2,3,5
"11420",2021-03-14,"Brush Creek Rd","w2021","Hybrid",0,"Sun","weekend","sled","Brush/Cement",NA,NA,NA,10.2,NA,42,4,23,24.3,-1,-1,1,2,3,2,3,5
"11421",2021-03-15,"Brush Creek Rd","w2021","Non.motorized",22,"Mon","weekday","no_sled","Brush/Cement",NA,NA,NA,10.2,NA,41,-1,26,24.9,4,-1,-1,1,3,2,1,2
"11422",2021-03-15,"Brush Creek Rd","w2021","Mechanized",0,"Mon","weekday","no_sled","Brush/Cement",NA,NA,NA,10.2,NA,41,-1,26,24.9,4,-1,-1,1,3,2,1,2
"11423",2021-03-15,"Brush Creek Rd","w2021","Motorized",0,"Mon","weekday","sled","Brush/Cement",NA,NA,NA,10.2,NA,41,-1,26,24.9,4,-1,-1,1,3,2,1,2
"11424",2021-03-15,"Brush Creek Rd","w2021","Hybrid",0,"Mon","weekday","sled","Brush/Cement",NA,NA,NA,10.2,NA,41,-1,26,24.9,4,-1,-1,1,3,2,1,2
"11425",2021-03-16,"Brush Creek Rd","w2021","Non.motorized",8,"Tue","weekday","no_sled","Brush/Cement",NA,NA,NA,10.3,NA,40,-1,26,25.8,-1,4,-1,-1,-2,2,1,0
"11426",2021-03-16,"Brush Creek Rd","w2021","Mechanized",0,"Tue","weekday","no_sled","Brush/Cement",NA,NA,NA,10.3,NA,40,-1,26,25.8,-1,4,-1,-1,-2,2,1,0
"11427",2021-03-16,"Brush Creek Rd","w2021","Motorized",0,"Tue","weekday","sled","Brush/Cement",NA,NA,NA,10.3,NA,40,-1,26,25.8,-1,4,-1,-1,-2,2,1,0
"11428",2021-03-16,"Brush Creek Rd","w2021","Hybrid",0,"Tue","weekday","sled","Brush/Cement",NA,NA,NA,10.3,NA,40,-1,26,25.8,-1,4,-1,-1,-2,2,1,0
"11429",2021-03-17,"Brush Creek Rd","w2021","Non.motorized",10,"Wed","weekday","no_sled","Brush/Cement",NA,NA,NA,10.3,NA,41,1,25,25.1,-1,-1,4,-1,0,-1,3,2
"11430",2021-03-17,"Brush Creek Rd","w2021","Mechanized",0,"Wed","weekday","no_sled","Brush/Cement",NA,NA,NA,10.3,NA,41,1,25,25.1,-1,-1,4,-1,0,-1,3,2
"11431",2021-03-17,"Brush Creek Rd","w2021","Motorized",0,"Wed","weekday","sled","Brush/Cement",NA,NA,NA,10.3,NA,41,1,25,25.1,-1,-1,4,-1,0,-1,3,2
"11432",2021-03-17,"Brush Creek Rd","w2021","Hybrid",0,"Wed","weekday","sled","Brush/Cement",NA,NA,NA,10.3,NA,41,1,25,25.1,-1,-1,4,-1,0,-1,3,2
"11433",2021-03-18,"Brush Creek Rd","w2021","Non.motorized",8,"Thu","weekday","no_sled","Brush/Cement",NA,NA,NA,10.3,NA,40,-1,29,25.8,1,-1,-1,4,0,-1,-2,2
"11434",2021-03-18,"Brush Creek Rd","w2021","Mechanized",0,"Thu","weekday","no_sled","Brush/Cement",NA,NA,NA,10.3,NA,40,-1,29,25.8,1,-1,-1,4,0,-1,-2,2
"11435",2021-03-18,"Brush Creek Rd","w2021","Motorized",2,"Thu","weekday","sled","Brush/Cement",NA,NA,NA,10.3,NA,40,-1,29,25.8,1,-1,-1,4,0,-1,-2,2
"11436",2021-03-18,"Brush Creek Rd","w2021","Hybrid",2,"Thu","weekday","sled","Brush/Cement",NA,NA,NA,10.3,NA,40,-1,29,25.8,1,-1,-1,4,0,-1,-2,2
"11437",2021-03-19,"Brush Creek Rd","w2021","Non.motorized",16,"Fri","weekday","no_sled","Brush/Cement",NA,NA,NA,10.3,NA,40,0,36,25.8,-1,1,-1,-1,-1,0,-1,-2
"11438",2021-03-19,"Brush Creek Rd","w2021","Mechanized",0,"Fri","weekday","no_sled","Brush/Cement",NA,NA,NA,10.3,NA,40,0,36,25.8,-1,1,-1,-1,-1,0,-1,-2
"11439",2021-03-19,"Brush Creek Rd","w2021","Motorized",1,"Fri","weekday","sled","Brush/Cement",NA,NA,NA,10.3,NA,40,0,36,25.8,-1,1,-1,-1,-1,0,-1,-2
"11440",2021-03-19,"Brush Creek Rd","w2021","Hybrid",0,"Fri","weekday","sled","Brush/Cement",NA,NA,NA,10.3,NA,40,0,36,25.8,-1,1,-1,-1,-1,0,-1,-2
"11441",2021-03-20,"Brush Creek Rd","w2021","Non.motorized",23,"Sat","weekend","no_sled","Brush/Cement",NA,NA,NA,10.4,NA,39,-1,37,26.7,0,-1,1,-1,-1,-2,-1,-2
"11442",2021-03-20,"Brush Creek Rd","w2021","Mechanized",0,"Sat","weekend","no_sled","Brush/Cement",NA,NA,NA,10.4,NA,39,-1,37,26.7,0,-1,1,-1,-1,-2,-1,-2
"11443",2021-03-20,"Brush Creek Rd","w2021","Motorized",0,"Sat","weekend","sled","Brush/Cement",NA,NA,NA,10.4,NA,39,-1,37,26.7,0,-1,1,-1,-1,-2,-1,-2
"11444",2021-03-20,"Brush Creek Rd","w2021","Hybrid",0,"Sat","weekend","sled","Brush/Cement",NA,NA,NA,10.4,NA,39,-1,37,26.7,0,-1,1,-1,-1,-2,-1,-2
"11445",2021-03-21,"Brush Creek Rd","w2021","Non.motorized",24,"Sun","weekend","no_sled","Brush/Cement",NA,NA,NA,10.4,NA,38,-1,28,27.4,-1,0,-1,1,-2,-2,-3,-2
"11446",2021-03-21,"Brush Creek Rd","w2021","Mechanized",1,"Sun","weekend","no_sled","Brush/Cement",NA,NA,NA,10.4,NA,38,-1,28,27.4,-1,0,-1,1,-2,-2,-3,-2
"11447",2021-03-21,"Brush Creek Rd","w2021","Motorized",0,"Sun","weekend","sled","Brush/Cement",NA,NA,NA,10.4,NA,38,-1,28,27.4,-1,0,-1,1,-2,-2,-3,-2
"11448",2021-03-21,"Brush Creek Rd","w2021","Hybrid",0,"Sun","weekend","sled","Brush/Cement",NA,NA,NA,10.4,NA,38,-1,28,27.4,-1,0,-1,1,-2,-2,-3,-2
"11449",2021-03-22,"Brush Creek Rd","w2021","Non.motorized",NA,"Mon","weekday","no_sled","Brush/Cement",NA,NA,NA,10.5,NA,41,3,26,25.6,-1,-1,0,-1,2,1,1,0
"11450",2021-03-22,"Brush Creek Rd","w2021","Mechanized",NA,"Mon","weekday","no_sled","Brush/Cement",NA,NA,NA,10.5,NA,41,3,26,25.6,-1,-1,0,-1,2,1,1,0
"11451",2021-03-22,"Brush Creek Rd","w2021","Motorized",NA,"Mon","weekday","sled","Brush/Cement",NA,NA,NA,10.5,NA,41,3,26,25.6,-1,-1,0,-1,2,1,1,0
"11452",2021-03-22,"Brush Creek Rd","w2021","Hybrid",NA,"Mon","weekday","sled","Brush/Cement",NA,NA,NA,10.5,NA,41,3,26,25.6,-1,-1,0,-1,2,1,1,0
"11453",2021-03-23,"Brush Creek Rd","w2021","Non.motorized",16,"Tue","weekday","no_sled","Brush/Cement",NA,NA,NA,10.6,NA,41,0,24,25.9,3,-1,-1,0,3,2,1,1
"11454",2021-03-23,"Brush Creek Rd","w2021","Mechanized",0,"Tue","weekday","no_sled","Brush/Cement",NA,NA,NA,10.6,NA,41,0,24,25.9,3,-1,-1,0,3,2,1,1
"11455",2021-03-23,"Brush Creek Rd","w2021","Motorized",0,"Tue","weekday","sled","Brush/Cement",NA,NA,NA,10.6,NA,41,0,24,25.9,3,-1,-1,0,3,2,1,1
"11456",2021-03-23,"Brush Creek Rd","w2021","Hybrid",2,"Tue","weekday","sled","Brush/Cement",NA,NA,NA,10.6,NA,41,0,24,25.9,3,-1,-1,0,3,2,1,1
"11457",2021-03-24,"Brush Creek Rd","w2021","Non.motorized",7,"Wed","weekday","no_sled","Brush/Cement",NA,NA,NA,10.8,NA,41,0,24,26.3,0,3,-1,-1,0,3,2,1
"11458",2021-03-24,"Brush Creek Rd","w2021","Mechanized",1,"Wed","weekday","no_sled","Brush/Cement",NA,NA,NA,10.8,NA,41,0,24,26.3,0,3,-1,-1,0,3,2,1
"11459",2021-03-24,"Brush Creek Rd","w2021","Motorized",0,"Wed","weekday","sled","Brush/Cement",NA,NA,NA,10.8,NA,41,0,24,26.3,0,3,-1,-1,0,3,2,1
"11460",2021-03-24,"Brush Creek Rd","w2021","Hybrid",0,"Wed","weekday","sled","Brush/Cement",NA,NA,NA,10.8,NA,41,0,24,26.3,0,3,-1,-1,0,3,2,1
"11461",2021-03-25,"Brush Creek Rd","w2021","Non.motorized",6,"Thu","weekday","no_sled","Brush/Cement",NA,NA,NA,10.9,NA,43,2,23,25.3,0,0,3,-1,2,2,5,4
"11462",2021-03-25,"Brush Creek Rd","w2021","Mechanized",0,"Thu","weekday","no_sled","Brush/Cement",NA,NA,NA,10.9,NA,43,2,23,25.3,0,0,3,-1,2,2,5,4
"11463",2021-03-25,"Brush Creek Rd","w2021","Motorized",0,"Thu","weekday","sled","Brush/Cement",NA,NA,NA,10.9,NA,43,2,23,25.3,0,0,3,-1,2,2,5,4
"11464",2021-03-25,"Brush Creek Rd","w2021","Hybrid",0,"Thu","weekday","sled","Brush/Cement",NA,NA,NA,10.9,NA,43,2,23,25.3,0,0,3,-1,2,2,5,4
"11465",2021-03-26,"Brush Creek Rd","w2021","Non.motorized",10,"Fri","weekday","no_sled","Brush/Cement",NA,NA,NA,11,NA,44,1,23,25,2,0,0,3,3,3,3,6
"11466",2021-03-26,"Brush Creek Rd","w2021","Mechanized",0,"Fri","weekday","no_sled","Brush/Cement",NA,NA,NA,11,NA,44,1,23,25,2,0,0,3,3,3,3,6
"11467",2021-03-26,"Brush Creek Rd","w2021","Motorized",0,"Fri","weekday","sled","Brush/Cement",NA,NA,NA,11,NA,44,1,23,25,2,0,0,3,3,3,3,6
"11468",2021-03-26,"Brush Creek Rd","w2021","Hybrid",2,"Fri","weekday","sled","Brush/Cement",NA,NA,NA,11,NA,44,1,23,25,2,0,0,3,3,3,3,6
"11469",2021-03-27,"Brush Creek Rd","w2021","Non.motorized",18,"Sat","weekend","no_sled","Brush/Cement",NA,NA,NA,11,NA,42,-2,25,26.2,1,2,0,0,-1,1,1,1
"11470",2021-03-27,"Brush Creek Rd","w2021","Mechanized",0,"Sat","weekend","no_sled","Brush/Cement",NA,NA,NA,11,NA,42,-2,25,26.2,1,2,0,0,-1,1,1,1
"11471",2021-03-27,"Brush Creek Rd","w2021","Motorized",0,"Sat","weekend","sled","Brush/Cement",NA,NA,NA,11,NA,42,-2,25,26.2,1,2,0,0,-1,1,1,1
"11472",2021-03-27,"Brush Creek Rd","w2021","Hybrid",2,"Sat","weekend","sled","Brush/Cement",NA,NA,NA,11,NA,42,-2,25,26.2,1,2,0,0,-1,1,1,1
"11473",2021-03-28,"Brush Creek Rd","w2021","Non.motorized",21,"Sun","weekend","no_sled","Brush/Cement",NA,NA,NA,11,NA,42,0,31,26.2,-2,1,2,0,-2,-1,1,1
"11474",2021-03-28,"Brush Creek Rd","w2021","Mechanized",2,"Sun","weekend","no_sled","Brush/Cement",NA,NA,NA,11,NA,42,0,31,26.2,-2,1,2,0,-2,-1,1,1
"11475",2021-03-28,"Brush Creek Rd","w2021","Motorized",0,"Sun","weekend","sled","Brush/Cement",NA,NA,NA,11,NA,42,0,31,26.2,-2,1,2,0,-2,-1,1,1
"11476",2021-03-28,"Brush Creek Rd","w2021","Hybrid",0,"Sun","weekend","sled","Brush/Cement",NA,NA,NA,11,NA,42,0,31,26.2,-2,1,2,0,-2,-1,1,1
"11477",2021-03-29,"Brush Creek Rd","w2021","Non.motorized",14,"Mon","weekday","no_sled","Brush/Cement",NA,NA,NA,11.1,NA,40,-2,37,27.8,0,-2,1,2,-2,-4,-3,-1
"11478",2021-03-29,"Brush Creek Rd","w2021","Mechanized",1,"Mon","weekday","no_sled","Brush/Cement",NA,NA,NA,11.1,NA,40,-2,37,27.8,0,-2,1,2,-2,-4,-3,-1
"11479",2021-03-29,"Brush Creek Rd","w2021","Motorized",0,"Mon","weekday","sled","Brush/Cement",NA,NA,NA,11.1,NA,40,-2,37,27.8,0,-2,1,2,-2,-4,-3,-1
"11480",2021-03-29,"Brush Creek Rd","w2021","Hybrid",1,"Mon","weekday","sled","Brush/Cement",NA,NA,NA,11.1,NA,40,-2,37,27.8,0,-2,1,2,-2,-4,-3,-1
"11481",2021-03-30,"Brush Creek Rd","w2021","Non.motorized",7,"Tue","weekday","no_sled","Brush/Cement",NA,NA,NA,11.1,NA,39,-1,23,28.5,-2,0,-2,1,-3,-3,-5,-4
"11482",2021-03-30,"Brush Creek Rd","w2021","Mechanized",0,"Tue","weekday","no_sled","Brush/Cement",NA,NA,NA,11.1,NA,39,-1,23,28.5,-2,0,-2,1,-3,-3,-5,-4
"11483",2021-03-30,"Brush Creek Rd","w2021","Motorized",0,"Tue","weekday","sled","Brush/Cement",NA,NA,NA,11.1,NA,39,-1,23,28.5,-2,0,-2,1,-3,-3,-5,-4
"11484",2021-03-30,"Brush Creek Rd","w2021","Hybrid",0,"Tue","weekday","sled","Brush/Cement",NA,NA,NA,11.1,NA,39,-1,23,28.5,-2,0,-2,1,-3,-3,-5,-4
"11485",2021-03-31,"Brush Creek Rd","w2021","Non.motorized",19,"Wed","weekday","no_sled","Brush/Cement",NA,NA,NA,11.1,NA,39,0,26,28.5,-1,-2,0,-2,-1,-3,-3,-5
"11486",2021-03-31,"Brush Creek Rd","w2021","Mechanized",0,"Wed","weekday","no_sled","Brush/Cement",NA,NA,NA,11.1,NA,39,0,26,28.5,-1,-2,0,-2,-1,-3,-3,-5
"11487",2021-03-31,"Brush Creek Rd","w2021","Motorized",0,"Wed","weekday","sled","Brush/Cement",NA,NA,NA,11.1,NA,39,0,26,28.5,-1,-2,0,-2,-1,-3,-3,-5
"11488",2021-03-31,"Brush Creek Rd","w2021","Hybrid",0,"Wed","weekday","sled","Brush/Cement",NA,NA,NA,11.1,NA,39,0,26,28.5,-1,-2,0,-2,-1,-3,-3,-5
"11489",2021-04-01,"Brush Creek Rd","w2021","Non.motorized",23,"Thu","weekday","no_sled","Brush/Cement",NA,NA,NA,11.1,NA,38,-1,36,29.2,0,-1,-2,0,-1,-2,-4,-4
"11490",2021-04-01,"Brush Creek Rd","w2021","Mechanized",0,"Thu","weekday","no_sled","Brush/Cement",NA,NA,NA,11.1,NA,38,-1,36,29.2,0,-1,-2,0,-1,-2,-4,-4
"11491",2021-04-01,"Brush Creek Rd","w2021","Motorized",0,"Thu","weekday","sled","Brush/Cement",NA,NA,NA,11.1,NA,38,-1,36,29.2,0,-1,-2,0,-1,-2,-4,-4
"11492",2021-04-01,"Brush Creek Rd","w2021","Hybrid",0,"Thu","weekday","sled","Brush/Cement",NA,NA,NA,11.1,NA,38,-1,36,29.2,0,-1,-2,0,-1,-2,-4,-4
"11493",2021-04-02,"Brush Creek Rd","w2021","Non.motorized",18,"Fri","weekday","no_sled","Brush/Cement",NA,NA,NA,11.1,NA,37,-1,42,30,-1,0,-1,-2,-2,-2,-3,-5
"11494",2021-04-02,"Brush Creek Rd","w2021","Mechanized",1,"Fri","weekday","no_sled","Brush/Cement",NA,NA,NA,11.1,NA,37,-1,42,30,-1,0,-1,-2,-2,-2,-3,-5
"11495",2021-04-02,"Brush Creek Rd","w2021","Motorized",0,"Fri","weekday","sled","Brush/Cement",NA,NA,NA,11.1,NA,37,-1,42,30,-1,0,-1,-2,-2,-2,-3,-5
"11496",2021-04-02,"Brush Creek Rd","w2021","Hybrid",0,"Fri","weekday","sled","Brush/Cement",NA,NA,NA,11.1,NA,37,-1,42,30,-1,0,-1,-2,-2,-2,-3,-5
"11497",2021-04-03,"Brush Creek Rd","w2021","Non.motorized",28,"Sat","weekend","no_sled","Brush/Cement",NA,NA,NA,10.8,NA,35,-2,45,30.9,-1,-1,0,-1,-3,-4,-4,-5
"11498",2021-04-03,"Brush Creek Rd","w2021","Mechanized",4,"Sat","weekend","no_sled","Brush/Cement",NA,NA,NA,10.8,NA,35,-2,45,30.9,-1,-1,0,-1,-3,-4,-4,-5
"11499",2021-04-03,"Brush Creek Rd","w2021","Motorized",0,"Sat","weekend","sled","Brush/Cement",NA,NA,NA,10.8,NA,35,-2,45,30.9,-1,-1,0,-1,-3,-4,-4,-5
"11500",2021-04-03,"Brush Creek Rd","w2021","Hybrid",0,"Sat","weekend","sled","Brush/Cement",NA,NA,NA,10.8,NA,35,-2,45,30.9,-1,-1,0,-1,-3,-4,-4,-5
"11501",2021-04-04,"Brush Creek Rd","w2021","Non.motorized",9,"Sun","weekend","no_sled","Brush/Cement",NA,NA,NA,10.7,NA,34,-1,44,31.5,-2,-1,-1,0,-3,-4,-5,-5
"11502",2021-04-04,"Brush Creek Rd","w2021","Mechanized",1,"Sun","weekend","no_sled","Brush/Cement",NA,NA,NA,10.7,NA,34,-1,44,31.5,-2,-1,-1,0,-3,-4,-5,-5
"11503",2021-04-04,"Brush Creek Rd","w2021","Motorized",0,"Sun","weekend","sled","Brush/Cement",NA,NA,NA,10.7,NA,34,-1,44,31.5,-2,-1,-1,0,-3,-4,-5,-5
"11504",2021-04-04,"Brush Creek Rd","w2021","Hybrid",0,"Sun","weekend","sled","Brush/Cement",NA,NA,NA,10.7,NA,34,-1,44,31.5,-2,-1,-1,0,-3,-4,-5,-5
"11505",2021-04-05,"Brush Creek Rd","w2021","Non.motorized",23,"Mon","weekday","no_sled","Brush/Cement",NA,NA,NA,10.6,NA,33,-1,44,32.1,-1,-2,-1,-1,-2,-4,-5,-6
"11506",2021-04-05,"Brush Creek Rd","w2021","Mechanized",1,"Mon","weekday","no_sled","Brush/Cement",NA,NA,NA,10.6,NA,33,-1,44,32.1,-1,-2,-1,-1,-2,-4,-5,-6
"11507",2021-04-05,"Brush Creek Rd","w2021","Motorized",0,"Mon","weekday","sled","Brush/Cement",NA,NA,NA,10.6,NA,33,-1,44,32.1,-1,-2,-1,-1,-2,-4,-5,-6
"11508",2021-04-05,"Brush Creek Rd","w2021","Hybrid",0,"Mon","weekday","sled","Brush/Cement",NA,NA,NA,10.6,NA,33,-1,44,32.1,-1,-2,-1,-1,-2,-4,-5,-6
"11509",2021-04-06,"Brush Creek Rd","w2021","Non.motorized",11,"Tue","weekday","no_sled","Brush/Cement",NA,NA,NA,10.3,NA,31,-2,32,33.2,-1,-1,-2,-1,-3,-4,-6,-7
"11510",2021-04-06,"Brush Creek Rd","w2021","Mechanized",0,"Tue","weekday","no_sled","Brush/Cement",NA,NA,NA,10.3,NA,31,-2,32,33.2,-1,-1,-2,-1,-3,-4,-6,-7
"11511",2021-04-06,"Brush Creek Rd","w2021","Motorized",0,"Tue","weekday","sled","Brush/Cement",NA,NA,NA,10.3,NA,31,-2,32,33.2,-1,-1,-2,-1,-3,-4,-6,-7
"11512",2021-04-06,"Brush Creek Rd","w2021","Hybrid",0,"Tue","weekday","sled","Brush/Cement",NA,NA,NA,10.3,NA,31,-2,32,33.2,-1,-1,-2,-1,-3,-4,-6,-7
"11513",2021-04-07,"Brush Creek Rd","w2021","Non.motorized",35,"Wed","weekday","no_sled","Brush/Cement",NA,NA,NA,10,NA,31,0,33,32.3,-2,-1,-1,-2,-2,-3,-4,-6
"11514",2021-04-07,"Brush Creek Rd","w2021","Mechanized",1,"Wed","weekday","no_sled","Brush/Cement",NA,NA,NA,10,NA,31,0,33,32.3,-2,-1,-1,-2,-2,-3,-4,-6
"11515",2021-04-07,"Brush Creek Rd","w2021","Motorized",0,"Wed","weekday","sled","Brush/Cement",NA,NA,NA,10,NA,31,0,33,32.3,-2,-1,-1,-2,-2,-3,-4,-6
"11516",2021-04-07,"Brush Creek Rd","w2021","Hybrid",0,"Wed","weekday","sled","Brush/Cement",NA,NA,NA,10,NA,31,0,33,32.3,-2,-1,-1,-2,-2,-3,-4,-6
"11517",2021-04-08,"Brush Creek Rd","w2021","Non.motorized",18,"Thu","weekday","no_sled","Brush/Cement",NA,NA,NA,9.9,NA,29,-2,39,34.1,0,-2,-1,-1,-2,-4,-5,-6
"11518",2021-04-08,"Brush Creek Rd","w2021","Mechanized",2,"Thu","weekday","no_sled","Brush/Cement",NA,NA,NA,9.9,NA,29,-2,39,34.1,0,-2,-1,-1,-2,-4,-5,-6
"11519",2021-04-08,"Brush Creek Rd","w2021","Motorized",0,"Thu","weekday","sled","Brush/Cement",NA,NA,NA,9.9,NA,29,-2,39,34.1,0,-2,-1,-1,-2,-4,-5,-6
"11520",2021-04-08,"Brush Creek Rd","w2021","Hybrid",0,"Thu","weekday","sled","Brush/Cement",NA,NA,NA,9.9,NA,29,-2,39,34.1,0,-2,-1,-1,-2,-4,-5,-6
"11521",2021-04-09,"Brush Creek Rd","w2021","Non.motorized",10,"Fri","weekday","no_sled","Brush/Cement",NA,NA,NA,9.6,NA,28,-1,33,34.3,-2,0,-2,-1,-3,-3,-5,-6
"11522",2021-04-09,"Brush Creek Rd","w2021","Mechanized",0,"Fri","weekday","no_sled","Brush/Cement",NA,NA,NA,9.6,NA,28,-1,33,34.3,-2,0,-2,-1,-3,-3,-5,-6
"11523",2021-04-09,"Brush Creek Rd","w2021","Motorized",0,"Fri","weekday","sled","Brush/Cement",NA,NA,NA,9.6,NA,28,-1,33,34.3,-2,0,-2,-1,-3,-3,-5,-6
"11524",2021-04-09,"Brush Creek Rd","w2021","Hybrid",0,"Fri","weekday","sled","Brush/Cement",NA,NA,NA,9.6,NA,28,-1,33,34.3,-2,0,-2,-1,-3,-3,-5,-6
"11525",2021-04-10,"Brush Creek Rd","w2021","Non.motorized",30,"Sat","weekend","no_sled","Brush/Cement",NA,NA,NA,9.5,NA,26,-2,37,36.5,-1,-2,0,-2,-3,-5,-5,-7
"11526",2021-04-10,"Brush Creek Rd","w2021","Mechanized",1,"Sat","weekend","no_sled","Brush/Cement",NA,NA,NA,9.5,NA,26,-2,37,36.5,-1,-2,0,-2,-3,-5,-5,-7
"11527",2021-04-10,"Brush Creek Rd","w2021","Motorized",0,"Sat","weekend","sled","Brush/Cement",NA,NA,NA,9.5,NA,26,-2,37,36.5,-1,-2,0,-2,-3,-5,-5,-7
"11528",2021-04-10,"Brush Creek Rd","w2021","Hybrid",0,"Sat","weekend","sled","Brush/Cement",NA,NA,NA,9.5,NA,26,-2,37,36.5,-1,-2,0,-2,-3,-5,-5,-7
"11529",2021-04-11,"Brush Creek Rd","w2021","Non.motorized",22,"Sun","weekend","no_sled","Brush/Cement",NA,NA,NA,9.2,NA,26,0,39,35.4,-2,-1,-2,0,-2,-3,-5,-5
"11530",2021-04-11,"Brush Creek Rd","w2021","Mechanized",0,"Sun","weekend","no_sled","Brush/Cement",NA,NA,NA,9.2,NA,26,0,39,35.4,-2,-1,-2,0,-2,-3,-5,-5
"11531",2021-04-11,"Brush Creek Rd","w2021","Motorized",0,"Sun","weekend","sled","Brush/Cement",NA,NA,NA,9.2,NA,26,0,39,35.4,-2,-1,-2,0,-2,-3,-5,-5
"11532",2021-04-11,"Brush Creek Rd","w2021","Hybrid",0,"Sun","weekend","sled","Brush/Cement",NA,NA,NA,9.2,NA,26,0,39,35.4,-2,-1,-2,0,-2,-3,-5,-5
"11533",2021-04-12,"Brush Creek Rd","w2021","Non.motorized",11,"Mon","weekday","no_sled","Brush/Cement",NA,NA,NA,8.8,NA,24,-2,38,36.7,0,-2,-1,-2,-2,-4,-5,-7
"11534",2021-04-12,"Brush Creek Rd","w2021","Mechanized",0,"Mon","weekday","no_sled","Brush/Cement",NA,NA,NA,8.8,NA,24,-2,38,36.7,0,-2,-1,-2,-2,-4,-5,-7
"11535",2021-04-12,"Brush Creek Rd","w2021","Motorized",0,"Mon","weekday","sled","Brush/Cement",NA,NA,NA,8.8,NA,24,-2,38,36.7,0,-2,-1,-2,-2,-4,-5,-7
"11536",2021-04-12,"Brush Creek Rd","w2021","Hybrid",0,"Mon","weekday","sled","Brush/Cement",NA,NA,NA,8.8,NA,24,-2,38,36.7,0,-2,-1,-2,-2,-4,-5,-7
"11537",2021-04-13,"Brush Creek Rd","w2021","Non.motorized",7,"Tue","weekday","no_sled","Brush/Cement",NA,NA,NA,8.4,NA,23,-1,35,36.5,-2,0,-2,-1,-3,-3,-5,-6
"11538",2021-04-13,"Brush Creek Rd","w2021","Mechanized",0,"Tue","weekday","no_sled","Brush/Cement",NA,NA,NA,8.4,NA,23,-1,35,36.5,-2,0,-2,-1,-3,-3,-5,-6
"11539",2021-04-13,"Brush Creek Rd","w2021","Motorized",0,"Tue","weekday","sled","Brush/Cement",NA,NA,NA,8.4,NA,23,-1,35,36.5,-2,0,-2,-1,-3,-3,-5,-6
"11540",2021-04-13,"Brush Creek Rd","w2021","Hybrid",0,"Tue","weekday","sled","Brush/Cement",NA,NA,NA,8.4,NA,23,-1,35,36.5,-2,0,-2,-1,-3,-3,-5,-6
"11541",2021-04-14,"Brush Creek Rd","w2021","Non.motorized",0,"Wed","weekday","no_sled","Brush/Cement",NA,NA,NA,8.4,NA,23,0,41,36.5,-1,-2,0,-2,-1,-3,-3,-5
"11542",2021-04-14,"Brush Creek Rd","w2021","Mechanized",0,"Wed","weekday","no_sled","Brush/Cement",NA,NA,NA,8.4,NA,23,0,41,36.5,-1,-2,0,-2,-1,-3,-3,-5
"11543",2021-04-14,"Brush Creek Rd","w2021","Motorized",0,"Wed","weekday","sled","Brush/Cement",NA,NA,NA,8.4,NA,23,0,41,36.5,-1,-2,0,-2,-1,-3,-3,-5
"11544",2021-04-14,"Brush Creek Rd","w2021","Hybrid",0,"Wed","weekday","sled","Brush/Cement",NA,NA,NA,8.4,NA,23,0,41,36.5,-1,-2,0,-2,-1,-3,-3,-5
"11545",2021-04-15,"Brush Creek Rd","w2021","Non.motorized",5,"Thu","weekday","no_sled","Brush/Cement",NA,NA,NA,8.1,NA,22,-1,33,36.8,0,-1,-2,0,-1,-2,-4,-4
"11546",2021-04-15,"Brush Creek Rd","w2021","Mechanized",0,"Thu","weekday","no_sled","Brush/Cement",NA,NA,NA,8.1,NA,22,-1,33,36.8,0,-1,-2,0,-1,-2,-4,-4
"11547",2021-04-15,"Brush Creek Rd","w2021","Motorized",0,"Thu","weekday","sled","Brush/Cement",NA,NA,NA,8.1,NA,22,-1,33,36.8,0,-1,-2,0,-1,-2,-4,-4
"11548",2021-04-15,"Brush Creek Rd","w2021","Hybrid",0,"Thu","weekday","sled","Brush/Cement",NA,NA,NA,8.1,NA,22,-1,33,36.8,0,-1,-2,0,-1,-2,-4,-4
"11549",2020-12-03,"Cement Creek","w2021","Non.motorized",5,"Thu","weekday","no_sled","Brush/Cement",NA,NA,NA,NA,NA,NA,NA,NA,NA,NA,NA,NA,NA,NA,NA,NA,NA
"11550",2020-12-03,"Cement Creek","w2021","Mechanized",0,"Thu","weekday","no_sled","Brush/Cement",NA,NA,NA,NA,NA,NA,NA,NA,NA,NA,NA,NA,NA,NA,NA,NA,NA
"11551",2020-12-03,"Cement Creek","w2021","Motorized",0,"Thu","weekday","sled","Brush/Cement",NA,NA,NA,NA,NA,NA,NA,NA,NA,NA,NA,NA,NA,NA,NA,NA,NA
"11552",2020-12-03,"Cement Creek","w2021","Hybrid",0,"Thu","weekday","sled","Brush/Cement",NA,NA,NA,NA,NA,NA,NA,NA,NA,NA,NA,NA,NA,NA,NA,NA,NA
"11553",2020-12-04,"Cement Creek","w2021","Non.motorized",12,"Fri","weekday","no_sled","Brush/Cement",NA,NA,NA,2.4,NA,11,0,29,21.8,0,0,0,0,0,0,0,0
"11554",2020-12-04,"Cement Creek","w2021","Mechanized",1,"Fri","weekday","no_sled","Brush/Cement",NA,NA,NA,2.4,NA,11,0,29,21.8,0,0,0,0,0,0,0,0
"11555",2020-12-04,"Cement Creek","w2021","Motorized",2,"Fri","weekday","sled","Brush/Cement",NA,NA,NA,2.4,NA,11,0,29,21.8,0,0,0,0,0,0,0,0
"11556",2020-12-04,"Cement Creek","w2021","Hybrid",1,"Fri","weekday","sled","Brush/Cement",NA,NA,NA,2.4,NA,11,0,29,21.8,0,0,0,0,0,0,0,0
"11557",2020-12-05,"Cement Creek","w2021","Non.motorized",63,"Sat","weekend","no_sled","Brush/Cement",NA,NA,NA,2.5,NA,11,0,32,22.7,0,0,0,0,0,0,0,0
"11558",2020-12-05,"Cement Creek","w2021","Mechanized",0,"Sat","weekend","no_sled","Brush/Cement",NA,NA,NA,2.5,NA,11,0,32,22.7,0,0,0,0,0,0,0,0
"11559",2020-12-05,"Cement Creek","w2021","Motorized",2,"Sat","weekend","sled","Brush/Cement",NA,NA,NA,2.5,NA,11,0,32,22.7,0,0,0,0,0,0,0,0
"11560",2020-12-05,"Cement Creek","w2021","Hybrid",2,"Sat","weekend","sled","Brush/Cement",NA,NA,NA,2.5,NA,11,0,32,22.7,0,0,0,0,0,0,0,0
"11561",2020-12-06,"Cement Creek","w2021","Non.motorized",41,"Sun","weekend","no_sled","Brush/Cement",NA,NA,NA,2.5,NA,11,0,30,22.7,0,0,0,0,0,0,0,0
"11562",2020-12-06,"Cement Creek","w2021","Mechanized",2,"Sun","weekend","no_sled","Brush/Cement",NA,NA,NA,2.5,NA,11,0,30,22.7,0,0,0,0,0,0,0,0
"11563",2020-12-06,"Cement Creek","w2021","Motorized",3,"Sun","weekend","sled","Brush/Cement",NA,NA,NA,2.5,NA,11,0,30,22.7,0,0,0,0,0,0,0,0
"11564",2020-12-06,"Cement Creek","w2021","Hybrid",2,"Sun","weekend","sled","Brush/Cement",NA,NA,NA,2.5,NA,11,0,30,22.7,0,0,0,0,0,0,0,0
"11565",2020-12-07,"Cement Creek","w2021","Non.motorized",20,"Mon","weekday","no_sled","Brush/Cement",NA,NA,NA,2.5,NA,11,0,33,22.7,0,0,0,0,0,0,0,0
"11566",2020-12-07,"Cement Creek","w2021","Mechanized",0,"Mon","weekday","no_sled","Brush/Cement",NA,NA,NA,2.5,NA,11,0,33,22.7,0,0,0,0,0,0,0,0
"11567",2020-12-07,"Cement Creek","w2021","Motorized",1,"Mon","weekday","sled","Brush/Cement",NA,NA,NA,2.5,NA,11,0,33,22.7,0,0,0,0,0,0,0,0
"11568",2020-12-07,"Cement Creek","w2021","Hybrid",0,"Mon","weekday","sled","Brush/Cement",NA,NA,NA,2.5,NA,11,0,33,22.7,0,0,0,0,0,0,0,0
"11569",2020-12-08,"Cement Creek","w2021","Non.motorized",15,"Tue","weekday","no_sled","Brush/Cement",NA,NA,NA,2.5,NA,11,0,34,22.7,0,0,0,0,0,0,0,0
"11570",2020-12-08,"Cement Creek","w2021","Mechanized",3,"Tue","weekday","no_sled","Brush/Cement",NA,NA,NA,2.5,NA,11,0,34,22.7,0,0,0,0,0,0,0,0
"11571",2020-12-08,"Cement Creek","w2021","Motorized",3,"Tue","weekday","sled","Brush/Cement",NA,NA,NA,2.5,NA,11,0,34,22.7,0,0,0,0,0,0,0,0
"11572",2020-12-08,"Cement Creek","w2021","Hybrid",0,"Tue","weekday","sled","Brush/Cement",NA,NA,NA,2.5,NA,11,0,34,22.7,0,0,0,0,0,0,0,0
"11573",2020-12-09,"Cement Creek","w2021","Non.motorized",13,"Wed","weekday","no_sled","Brush/Cement",NA,NA,NA,2.5,NA,11,0,32,22.7,0,0,0,0,0,0,0,0
"11574",2020-12-09,"Cement Creek","w2021","Mechanized",0,"Wed","weekday","no_sled","Brush/Cement",NA,NA,NA,2.5,NA,11,0,32,22.7,0,0,0,0,0,0,0,0
"11575",2020-12-09,"Cement Creek","w2021","Motorized",3,"Wed","weekday","sled","Brush/Cement",NA,NA,NA,2.5,NA,11,0,32,22.7,0,0,0,0,0,0,0,0
"11576",2020-12-09,"Cement Creek","w2021","Hybrid",0,"Wed","weekday","sled","Brush/Cement",NA,NA,NA,2.5,NA,11,0,32,22.7,0,0,0,0,0,0,0,0
"11577",2020-12-10,"Cement Creek","w2021","Non.motorized",2,"Thu","weekday","no_sled","Brush/Cement",NA,NA,NA,2.5,NA,11,0,28,22.7,0,0,0,0,0,0,0,0
"11578",2020-12-10,"Cement Creek","w2021","Mechanized",1,"Thu","weekday","no_sled","Brush/Cement",NA,NA,NA,2.5,NA,11,0,28,22.7,0,0,0,0,0,0,0,0
"11579",2020-12-10,"Cement Creek","w2021","Motorized",5,"Thu","weekday","sled","Brush/Cement",NA,NA,NA,2.5,NA,11,0,28,22.7,0,0,0,0,0,0,0,0
"11580",2020-12-10,"Cement Creek","w2021","Hybrid",0,"Thu","weekday","sled","Brush/Cement",NA,NA,NA,2.5,NA,11,0,28,22.7,0,0,0,0,0,0,0,0
"11581",2020-12-11,"Cement Creek","w2021","Non.motorized",14,"Fri","weekday","no_sled","Brush/Cement",NA,NA,NA,2.6,NA,12,1,20,21.7,0,0,0,0,1,1,1,1
"11582",2020-12-11,"Cement Creek","w2021","Mechanized",1,"Fri","weekday","no_sled","Brush/Cement",NA,NA,NA,2.6,NA,12,1,20,21.7,0,0,0,0,1,1,1,1
"11583",2020-12-11,"Cement Creek","w2021","Motorized",7,"Fri","weekday","sled","Brush/Cement",NA,NA,NA,2.6,NA,12,1,20,21.7,0,0,0,0,1,1,1,1
"11584",2020-12-11,"Cement Creek","w2021","Hybrid",3,"Fri","weekday","sled","Brush/Cement",NA,NA,NA,2.6,NA,12,1,20,21.7,0,0,0,0,1,1,1,1
"11585",2020-12-12,"Cement Creek","w2021","Non.motorized",36,"Sat","weekend","no_sled","Brush/Cement",NA,NA,NA,2.9,NA,17,5,12,17.1,1,0,0,0,6,6,6,6
"11586",2020-12-12,"Cement Creek","w2021","Mechanized",1,"Sat","weekend","no_sled","Brush/Cement",NA,NA,NA,2.9,NA,17,5,12,17.1,1,0,0,0,6,6,6,6
"11587",2020-12-12,"Cement Creek","w2021","Motorized",2,"Sat","weekend","sled","Brush/Cement",NA,NA,NA,2.9,NA,17,5,12,17.1,1,0,0,0,6,6,6,6
"11588",2020-12-12,"Cement Creek","w2021","Hybrid",2,"Sat","weekend","sled","Brush/Cement",NA,NA,NA,2.9,NA,17,5,12,17.1,1,0,0,0,6,6,6,6
"11589",2020-12-13,"Cement Creek","w2021","Non.motorized",60,"Sun","weekend","no_sled","Brush/Cement",NA,NA,NA,3.3,NA,19,2,10,17.4,5,1,0,0,7,8,8,8
"11590",2020-12-13,"Cement Creek","w2021","Mechanized",0,"Sun","weekend","no_sled","Brush/Cement",NA,NA,NA,3.3,NA,19,2,10,17.4,5,1,0,0,7,8,8,8
"11591",2020-12-13,"Cement Creek","w2021","Motorized",7,"Sun","weekend","sled","Brush/Cement",NA,NA,NA,3.3,NA,19,2,10,17.4,5,1,0,0,7,8,8,8
"11592",2020-12-13,"Cement Creek","w2021","Hybrid",2,"Sun","weekend","sled","Brush/Cement",NA,NA,NA,3.3,NA,19,2,10,17.4,5,1,0,0,7,8,8,8
"11593",2020-12-14,"Cement Creek","w2021","Non.motorized",23,"Mon","weekday","no_sled","Brush/Cement",NA,NA,NA,3.3,NA,18,-1,18,18.3,2,5,1,0,1,6,7,7
"11594",2020-12-14,"Cement Creek","w2021","Mechanized",0,"Mon","weekday","no_sled","Brush/Cement",NA,NA,NA,3.3,NA,18,-1,18,18.3,2,5,1,0,1,6,7,7
"11595",2020-12-14,"Cement Creek","w2021","Motorized",1,"Mon","weekday","sled","Brush/Cement",NA,NA,NA,3.3,NA,18,-1,18,18.3,2,5,1,0,1,6,7,7
"11596",2020-12-14,"Cement Creek","w2021","Hybrid",0,"Mon","weekday","sled","Brush/Cement",NA,NA,NA,3.3,NA,18,-1,18,18.3,2,5,1,0,1,6,7,7
"11597",2020-12-15,"Cement Creek","w2021","Non.motorized",16,"Tue","weekday","no_sled","Brush/Cement",NA,NA,NA,3.5,NA,19,1,13,18.4,-1,2,5,1,0,2,7,8
"11598",2020-12-15,"Cement Creek","w2021","Mechanized",1,"Tue","weekday","no_sled","Brush/Cement",NA,NA,NA,3.5,NA,19,1,13,18.4,-1,2,5,1,0,2,7,8
"11599",2020-12-15,"Cement Creek","w2021","Motorized",5,"Tue","weekday","sled","Brush/Cement",NA,NA,NA,3.5,NA,19,1,13,18.4,-1,2,5,1,0,2,7,8
"11600",2020-12-15,"Cement Creek","w2021","Hybrid",0,"Tue","weekday","sled","Brush/Cement",NA,NA,NA,3.5,NA,19,1,13,18.4,-1,2,5,1,0,2,7,8
"11601",2020-12-16,"Cement Creek","w2021","Non.motorized",23,"Wed","weekday","no_sled","Brush/Cement",NA,NA,NA,3.5,NA,19,0,16,18.4,1,-1,2,5,1,0,2,7
"11602",2020-12-16,"Cement Creek","w2021","Mechanized",0,"Wed","weekday","no_sled","Brush/Cement",NA,NA,NA,3.5,NA,19,0,16,18.4,1,-1,2,5,1,0,2,7
"11603",2020-12-16,"Cement Creek","w2021","Motorized",7,"Wed","weekday","sled","Brush/Cement",NA,NA,NA,3.5,NA,19,0,16,18.4,1,-1,2,5,1,0,2,7
"11604",2020-12-16,"Cement Creek","w2021","Hybrid",0,"Wed","weekday","sled","Brush/Cement",NA,NA,NA,3.5,NA,19,0,16,18.4,1,-1,2,5,1,0,2,7
"11605",2020-12-17,"Cement Creek","w2021","Non.motorized",26,"Thu","weekday","no_sled","Brush/Cement",NA,NA,NA,3.5,NA,19,0,20,18.4,0,1,-1,2,0,1,0,2
"11606",2020-12-17,"Cement Creek","w2021","Mechanized",1,"Thu","weekday","no_sled","Brush/Cement",NA,NA,NA,3.5,NA,19,0,20,18.4,0,1,-1,2,0,1,0,2
"11607",2020-12-17,"Cement Creek","w2021","Motorized",5,"Thu","weekday","sled","Brush/Cement",NA,NA,NA,3.5,NA,19,0,20,18.4,0,1,-1,2,0,1,0,2
"11608",2020-12-17,"Cement Creek","w2021","Hybrid",0,"Thu","weekday","sled","Brush/Cement",NA,NA,NA,3.5,NA,19,0,20,18.4,0,1,-1,2,0,1,0,2
"11609",2020-12-18,"Cement Creek","w2021","Non.motorized",15,"Fri","weekday","no_sled","Brush/Cement",NA,NA,NA,3.8,NA,22,3,20,17.3,0,0,1,-1,3,3,4,3
"11610",2020-12-18,"Cement Creek","w2021","Mechanized",0,"Fri","weekday","no_sled","Brush/Cement",NA,NA,NA,3.8,NA,22,3,20,17.3,0,0,1,-1,3,3,4,3
"11611",2020-12-18,"Cement Creek","w2021","Motorized",5,"Fri","weekday","sled","Brush/Cement",NA,NA,NA,3.8,NA,22,3,20,17.3,0,0,1,-1,3,3,4,3
"11612",2020-12-18,"Cement Creek","w2021","Hybrid",0,"Fri","weekday","sled","Brush/Cement",NA,NA,NA,3.8,NA,22,3,20,17.3,0,0,1,-1,3,3,4,3
"11613",2020-12-19,"Cement Creek","w2021","Non.motorized",46,"Sat","weekend","no_sled","Brush/Cement",NA,NA,NA,3.9,NA,22,0,17,17.7,3,0,0,1,3,3,3,4
"11614",2020-12-19,"Cement Creek","w2021","Mechanized",0,"Sat","weekend","no_sled","Brush/Cement",NA,NA,NA,3.9,NA,22,0,17,17.7,3,0,0,1,3,3,3,4
"11615",2020-12-19,"Cement Creek","w2021","Motorized",9,"Sat","weekend","sled","Brush/Cement",NA,NA,NA,3.9,NA,22,0,17,17.7,3,0,0,1,3,3,3,4
"11616",2020-12-19,"Cement Creek","w2021","Hybrid",2,"Sat","weekend","sled","Brush/Cement",NA,NA,NA,3.9,NA,22,0,17,17.7,3,0,0,1,3,3,3,4
"11617",2020-12-20,"Cement Creek","w2021","Non.motorized",69,"Sun","weekend","no_sled","Brush/Cement",NA,NA,NA,3.9,NA,21,-1,26,18.6,0,3,0,0,-1,2,2,2
"11618",2020-12-20,"Cement Creek","w2021","Mechanized",4,"Sun","weekend","no_sled","Brush/Cement",NA,NA,NA,3.9,NA,21,-1,26,18.6,0,3,0,0,-1,2,2,2
"11619",2020-12-20,"Cement Creek","w2021","Motorized",7,"Sun","weekend","sled","Brush/Cement",NA,NA,NA,3.9,NA,21,-1,26,18.6,0,3,0,0,-1,2,2,2
"11620",2020-12-20,"Cement Creek","w2021","Hybrid",0,"Sun","weekend","sled","Brush/Cement",NA,NA,NA,3.9,NA,21,-1,26,18.6,0,3,0,0,-1,2,2,2
"11621",2020-12-21,"Cement Creek","w2021","Non.motorized",20,"Mon","weekday","no_sled","Brush/Cement",NA,NA,NA,3.9,NA,20,-1,28,19.5,-1,0,3,0,-2,-2,1,1
"11622",2020-12-21,"Cement Creek","w2021","Mechanized",1,"Mon","weekday","no_sled","Brush/Cement",NA,NA,NA,3.9,NA,20,-1,28,19.5,-1,0,3,0,-2,-2,1,1
"11623",2020-12-21,"Cement Creek","w2021","Motorized",6,"Mon","weekday","sled","Brush/Cement",NA,NA,NA,3.9,NA,20,-1,28,19.5,-1,0,3,0,-2,-2,1,1
"11624",2020-12-21,"Cement Creek","w2021","Hybrid",0,"Mon","weekday","sled","Brush/Cement",NA,NA,NA,3.9,NA,20,-1,28,19.5,-1,0,3,0,-2,-2,1,1
"11625",2020-12-22,"Cement Creek","w2021","Non.motorized",38,"Tue","weekday","no_sled","Brush/Cement",NA,NA,NA,4,NA,20,0,24,20,-1,-1,0,3,-1,-2,-2,1
"11626",2020-12-22,"Cement Creek","w2021","Mechanized",0,"Tue","weekday","no_sled","Brush/Cement",NA,NA,NA,4,NA,20,0,24,20,-1,-1,0,3,-1,-2,-2,1
"11627",2020-12-22,"Cement Creek","w2021","Motorized",5,"Tue","weekday","sled","Brush/Cement",NA,NA,NA,4,NA,20,0,24,20,-1,-1,0,3,-1,-2,-2,1
"11628",2020-12-22,"Cement Creek","w2021","Hybrid",0,"Tue","weekday","sled","Brush/Cement",NA,NA,NA,4,NA,20,0,24,20,-1,-1,0,3,-1,-2,-2,1
"11629",2020-12-23,"Cement Creek","w2021","Non.motorized",35,"Wed","weekday","no_sled","Brush/Cement",NA,NA,NA,4.1,NA,22,2,6,18.6,0,-1,-1,0,2,1,0,0
"11630",2020-12-23,"Cement Creek","w2021","Mechanized",0,"Wed","weekday","no_sled","Brush/Cement",NA,NA,NA,4.1,NA,22,2,6,18.6,0,-1,-1,0,2,1,0,0
"11631",2020-12-23,"Cement Creek","w2021","Motorized",8,"Wed","weekday","sled","Brush/Cement",NA,NA,NA,4.1,NA,22,2,6,18.6,0,-1,-1,0,2,1,0,0
"11632",2020-12-23,"Cement Creek","w2021","Hybrid",0,"Wed","weekday","sled","Brush/Cement",NA,NA,NA,4.1,NA,22,2,6,18.6,0,-1,-1,0,2,1,0,0
"11633",2020-12-24,"Cement Creek","w2021","Non.motorized",35,"Thu","weekday","no_sled","Brush/Cement",NA,NA,NA,4.1,NA,21,-1,15,19.5,2,0,-1,-1,1,1,0,-1
"11634",2020-12-24,"Cement Creek","w2021","Mechanized",0,"Thu","weekday","no_sled","Brush/Cement",NA,NA,NA,4.1,NA,21,-1,15,19.5,2,0,-1,-1,1,1,0,-1
"11635",2020-12-24,"Cement Creek","w2021","Motorized",6,"Thu","weekday","sled","Brush/Cement",NA,NA,NA,4.1,NA,21,-1,15,19.5,2,0,-1,-1,1,1,0,-1
"11636",2020-12-24,"Cement Creek","w2021","Hybrid",2,"Thu","weekday","sled","Brush/Cement",NA,NA,NA,4.1,NA,21,-1,15,19.5,2,0,-1,-1,1,1,0,-1
"11637",2020-12-25,"Cement Creek","w2021","Non.motorized",52,"Fri","weekday","no_sled","Brush/Cement",NA,NA,NA,4.1,NA,20,-1,25,20.5,-1,2,0,-1,-2,0,0,-1
"11638",2020-12-25,"Cement Creek","w2021","Mechanized",1,"Fri","weekday","no_sled","Brush/Cement",NA,NA,NA,4.1,NA,20,-1,25,20.5,-1,2,0,-1,-2,0,0,-1
"11639",2020-12-25,"Cement Creek","w2021","Motorized",5,"Fri","weekday","sled","Brush/Cement",NA,NA,NA,4.1,NA,20,-1,25,20.5,-1,2,0,-1,-2,0,0,-1
"11640",2020-12-25,"Cement Creek","w2021","Hybrid",1,"Fri","weekday","sled","Brush/Cement",NA,NA,NA,4.1,NA,20,-1,25,20.5,-1,2,0,-1,-2,0,0,-1
"11641",2020-12-26,"Cement Creek","w2021","Non.motorized",48,"Sat","weekend","no_sled","Brush/Cement",NA,NA,NA,4.1,NA,20,0,26,20.5,-1,-1,2,0,-1,-2,0,0
"11642",2020-12-26,"Cement Creek","w2021","Mechanized",2,"Sat","weekend","no_sled","Brush/Cement",NA,NA,NA,4.1,NA,20,0,26,20.5,-1,-1,2,0,-1,-2,0,0
"11643",2020-12-26,"Cement Creek","w2021","Motorized",7,"Sat","weekend","sled","Brush/Cement",NA,NA,NA,4.1,NA,20,0,26,20.5,-1,-1,2,0,-1,-2,0,0
"11644",2020-12-26,"Cement Creek","w2021","Hybrid",0,"Sat","weekend","sled","Brush/Cement",NA,NA,NA,4.1,NA,20,0,26,20.5,-1,-1,2,0,-1,-2,0,0
"11645",2020-12-27,"Cement Creek","w2021","Non.motorized",55,"Sun","weekend","no_sled","Brush/Cement",NA,NA,NA,4.2,NA,19,-1,19,22.1,0,-1,-1,2,-1,-2,-3,-1
"11646",2020-12-27,"Cement Creek","w2021","Mechanized",7,"Sun","weekend","no_sled","Brush/Cement",NA,NA,NA,4.2,NA,19,-1,19,22.1,0,-1,-1,2,-1,-2,-3,-1
"11647",2020-12-27,"Cement Creek","w2021","Motorized",6,"Sun","weekend","sled","Brush/Cement",NA,NA,NA,4.2,NA,19,-1,19,22.1,0,-1,-1,2,-1,-2,-3,-1
"11648",2020-12-27,"Cement Creek","w2021","Hybrid",0,"Sun","weekend","sled","Brush/Cement",NA,NA,NA,4.2,NA,19,-1,19,22.1,0,-1,-1,2,-1,-2,-3,-1
"11649",2020-12-28,"Cement Creek","w2021","Non.motorized",48,"Mon","weekday","no_sled","Brush/Cement",NA,NA,NA,4.2,NA,20,1,22,21,-1,0,-1,-1,0,0,-1,-2
"11650",2020-12-28,"Cement Creek","w2021","Mechanized",3,"Mon","weekday","no_sled","Brush/Cement",NA,NA,NA,4.2,NA,20,1,22,21,-1,0,-1,-1,0,0,-1,-2
"11651",2020-12-28,"Cement Creek","w2021","Motorized",10,"Mon","weekday","sled","Brush/Cement",NA,NA,NA,4.2,NA,20,1,22,21,-1,0,-1,-1,0,0,-1,-2
"11652",2020-12-28,"Cement Creek","w2021","Hybrid",0,"Mon","weekday","sled","Brush/Cement",NA,NA,NA,4.2,NA,20,1,22,21,-1,0,-1,-1,0,0,-1,-2
"11653",2020-12-29,"Cement Creek","w2021","Non.motorized",50,"Tue","weekday","no_sled","Brush/Cement",NA,NA,NA,4.9,NA,27,7,15,18.1,1,-1,0,-1,8,7,7,6
"11654",2020-12-29,"Cement Creek","w2021","Mechanized",0,"Tue","weekday","no_sled","Brush/Cement",NA,NA,NA,4.9,NA,27,7,15,18.1,1,-1,0,-1,8,7,7,6
"11655",2020-12-29,"Cement Creek","w2021","Motorized",10,"Tue","weekday","sled","Brush/Cement",NA,NA,NA,4.9,NA,27,7,15,18.1,1,-1,0,-1,8,7,7,6
"11656",2020-12-29,"Cement Creek","w2021","Hybrid",0,"Tue","weekday","sled","Brush/Cement",NA,NA,NA,4.9,NA,27,7,15,18.1,1,-1,0,-1,8,7,7,6
"11657",2020-12-30,"Cement Creek","w2021","Non.motorized",18,"Wed","weekday","no_sled","Brush/Cement",NA,NA,NA,4.9,NA,26,-1,10,18.8,7,1,-1,0,6,7,6,6
"11658",2020-12-30,"Cement Creek","w2021","Mechanized",0,"Wed","weekday","no_sled","Brush/Cement",NA,NA,NA,4.9,NA,26,-1,10,18.8,7,1,-1,0,6,7,6,6
"11659",2020-12-30,"Cement Creek","w2021","Motorized",7,"Wed","weekday","sled","Brush/Cement",NA,NA,NA,4.9,NA,26,-1,10,18.8,7,1,-1,0,6,7,6,6
"11660",2020-12-30,"Cement Creek","w2021","Hybrid",0,"Wed","weekday","sled","Brush/Cement",NA,NA,NA,4.9,NA,26,-1,10,18.8,7,1,-1,0,6,7,6,6
"11661",2020-12-31,"Cement Creek","w2021","Non.motorized",35,"Thu","weekday","no_sled","Brush/Cement",NA,NA,NA,4.9,NA,25,-1,19,19.6,-1,7,1,-1,-2,5,6,5
"11662",2020-12-31,"Cement Creek","w2021","Mechanized",2,"Thu","weekday","no_sled","Brush/Cement",NA,NA,NA,4.9,NA,25,-1,19,19.6,-1,7,1,-1,-2,5,6,5
"11663",2020-12-31,"Cement Creek","w2021","Motorized",6,"Thu","weekday","sled","Brush/Cement",NA,NA,NA,4.9,NA,25,-1,19,19.6,-1,7,1,-1,-2,5,6,5
"11664",2020-12-31,"Cement Creek","w2021","Hybrid",3,"Thu","weekday","sled","Brush/Cement",NA,NA,NA,4.9,NA,25,-1,19,19.6,-1,7,1,-1,-2,5,6,5
"11665",2021-01-01,"Cement Creek","w2021","Non.motorized",55,"Fri","weekday","no_sled","Brush/Cement",NA,NA,NA,4.9,NA,24,-1,21,20.4,-1,-1,7,1,-2,-3,4,5
"11666",2021-01-01,"Cement Creek","w2021","Mechanized",2,"Fri","weekday","no_sled","Brush/Cement",NA,NA,NA,4.9,NA,24,-1,21,20.4,-1,-1,7,1,-2,-3,4,5
"11667",2021-01-01,"Cement Creek","w2021","Motorized",10,"Fri","weekday","sled","Brush/Cement",NA,NA,NA,4.9,NA,24,-1,21,20.4,-1,-1,7,1,-2,-3,4,5
"11668",2021-01-01,"Cement Creek","w2021","Hybrid",1,"Fri","weekday","sled","Brush/Cement",NA,NA,NA,4.9,NA,24,-1,21,20.4,-1,-1,7,1,-2,-3,4,5
"11669",2021-01-02,"Cement Creek","w2021","Non.motorized",59,"Sat","weekend","no_sled","Brush/Cement",NA,NA,NA,4.9,NA,23,-1,19,21.3,-1,-1,-1,7,-2,-3,-4,3
"11670",2021-01-02,"Cement Creek","w2021","Mechanized",2,"Sat","weekend","no_sled","Brush/Cement",NA,NA,NA,4.9,NA,23,-1,19,21.3,-1,-1,-1,7,-2,-3,-4,3
"11671",2021-01-02,"Cement Creek","w2021","Motorized",4,"Sat","weekend","sled","Brush/Cement",NA,NA,NA,4.9,NA,23,-1,19,21.3,-1,-1,-1,7,-2,-3,-4,3
"11672",2021-01-02,"Cement Creek","w2021","Hybrid",1,"Sat","weekend","sled","Brush/Cement",NA,NA,NA,4.9,NA,23,-1,19,21.3,-1,-1,-1,7,-2,-3,-4,3
"11673",2021-01-03,"Cement Creek","w2021","Non.motorized",46,"Sun","weekend","no_sled","Brush/Cement",NA,NA,NA,4.9,NA,23,0,21,21.3,-1,-1,-1,-1,-1,-2,-3,-4
"11674",2021-01-03,"Cement Creek","w2021","Mechanized",3,"Sun","weekend","no_sled","Brush/Cement",NA,NA,NA,4.9,NA,23,0,21,21.3,-1,-1,-1,-1,-1,-2,-3,-4
"11675",2021-01-03,"Cement Creek","w2021","Motorized",5,"Sun","weekend","sled","Brush/Cement",NA,NA,NA,4.9,NA,23,0,21,21.3,-1,-1,-1,-1,-1,-2,-3,-4
"11676",2021-01-03,"Cement Creek","w2021","Hybrid",1,"Sun","weekend","sled","Brush/Cement",NA,NA,NA,4.9,NA,23,0,21,21.3,-1,-1,-1,-1,-1,-2,-3,-4
"11677",2021-01-04,"Cement Creek","w2021","Non.motorized",29,"Mon","weekday","no_sled","Brush/Cement",NA,NA,NA,4.9,NA,22,-1,25,22.3,0,-1,-1,-1,-1,-2,-3,-4
"11678",2021-01-04,"Cement Creek","w2021","Mechanized",4,"Mon","weekday","no_sled","Brush/Cement",NA,NA,NA,4.9,NA,22,-1,25,22.3,0,-1,-1,-1,-1,-2,-3,-4
"11679",2021-01-04,"Cement Creek","w2021","Motorized",6,"Mon","weekday","sled","Brush/Cement",NA,NA,NA,4.9,NA,22,-1,25,22.3,0,-1,-1,-1,-1,-2,-3,-4
"11680",2021-01-04,"Cement Creek","w2021","Hybrid",0,"Mon","weekday","sled","Brush/Cement",NA,NA,NA,4.9,NA,22,-1,25,22.3,0,-1,-1,-1,-1,-2,-3,-4
"11681",2021-01-05,"Cement Creek","w2021","Non.motorized",7,"Tue","weekday","no_sled","Brush/Cement",NA,NA,NA,5,NA,22,0,23,22.7,-1,0,-1,-1,-1,-1,-2,-3
"11682",2021-01-05,"Cement Creek","w2021","Mechanized",0,"Tue","weekday","no_sled","Brush/Cement",NA,NA,NA,5,NA,22,0,23,22.7,-1,0,-1,-1,-1,-1,-2,-3
"11683",2021-01-05,"Cement Creek","w2021","Motorized",5,"Tue","weekday","sled","Brush/Cement",NA,NA,NA,5,NA,22,0,23,22.7,-1,0,-1,-1,-1,-1,-2,-3
"11684",2021-01-05,"Cement Creek","w2021","Hybrid",1,"Tue","weekday","sled","Brush/Cement",NA,NA,NA,5,NA,22,0,23,22.7,-1,0,-1,-1,-1,-1,-2,-3
"11685",2021-01-06,"Cement Creek","w2021","Non.motorized",24,"Wed","weekday","no_sled","Brush/Cement",NA,NA,NA,5.1,NA,24,2,18,21.2,0,-1,0,-1,2,1,1,0
"11686",2021-01-06,"Cement Creek","w2021","Mechanized",4,"Wed","weekday","no_sled","Brush/Cement",NA,NA,NA,5.1,NA,24,2,18,21.2,0,-1,0,-1,2,1,1,0
"11687",2021-01-06,"Cement Creek","w2021","Motorized",7,"Wed","weekday","sled","Brush/Cement",NA,NA,NA,5.1,NA,24,2,18,21.2,0,-1,0,-1,2,1,1,0
"11688",2021-01-06,"Cement Creek","w2021","Hybrid",0,"Wed","weekday","sled","Brush/Cement",NA,NA,NA,5.1,NA,24,2,18,21.2,0,-1,0,-1,2,1,1,0
"11689",2021-01-07,"Cement Creek","w2021","Non.motorized",25,"Thu","weekday","no_sled","Brush/Cement",NA,NA,NA,5.1,NA,24,0,23,21.2,2,0,-1,0,2,2,1,1
"11690",2021-01-07,"Cement Creek","w2021","Mechanized",3,"Thu","weekday","no_sled","Brush/Cement",NA,NA,NA,5.1,NA,24,0,23,21.2,2,0,-1,0,2,2,1,1
"11691",2021-01-07,"Cement Creek","w2021","Motorized",5,"Thu","weekday","sled","Brush/Cement",NA,NA,NA,5.1,NA,24,0,23,21.2,2,0,-1,0,2,2,1,1
"11692",2021-01-07,"Cement Creek","w2021","Hybrid",0,"Thu","weekday","sled","Brush/Cement",NA,NA,NA,5.1,NA,24,0,23,21.2,2,0,-1,0,2,2,1,1
"11693",2021-01-08,"Cement Creek","w2021","Non.motorized",22,"Fri","weekday","no_sled","Brush/Cement",NA,NA,NA,5.1,NA,23,-1,20,22.2,0,2,0,-1,-1,1,1,0
"11694",2021-01-08,"Cement Creek","w2021","Mechanized",2,"Fri","weekday","no_sled","Brush/Cement",NA,NA,NA,5.1,NA,23,-1,20,22.2,0,2,0,-1,-1,1,1,0
"11695",2021-01-08,"Cement Creek","w2021","Motorized",5,"Fri","weekday","sled","Brush/Cement",NA,NA,NA,5.1,NA,23,-1,20,22.2,0,2,0,-1,-1,1,1,0
"11696",2021-01-08,"Cement Creek","w2021","Hybrid",0,"Fri","weekday","sled","Brush/Cement",NA,NA,NA,5.1,NA,23,-1,20,22.2,0,2,0,-1,-1,1,1,0
"11697",2021-01-09,"Cement Creek","w2021","Non.motorized",52,"Sat","weekend","no_sled","Brush/Cement",NA,NA,NA,5.1,NA,23,0,19,22.2,-1,0,2,0,-1,-1,1,1
"11698",2021-01-09,"Cement Creek","w2021","Mechanized",3,"Sat","weekend","no_sled","Brush/Cement",NA,NA,NA,5.1,NA,23,0,19,22.2,-1,0,2,0,-1,-1,1,1
"11699",2021-01-09,"Cement Creek","w2021","Motorized",7,"Sat","weekend","sled","Brush/Cement",NA,NA,NA,5.1,NA,23,0,19,22.2,-1,0,2,0,-1,-1,1,1
"11700",2021-01-09,"Cement Creek","w2021","Hybrid",2,"Sat","weekend","sled","Brush/Cement",NA,NA,NA,5.1,NA,23,0,19,22.2,-1,0,2,0,-1,-1,1,1
"11701",2021-01-10,"Cement Creek","w2021","Non.motorized",69,"Sun","weekend","no_sled","Brush/Cement",NA,NA,NA,5.1,NA,23,0,14,22.2,0,-1,0,2,0,-1,-1,1
"11702",2021-01-10,"Cement Creek","w2021","Mechanized",1,"Sun","weekend","no_sled","Brush/Cement",NA,NA,NA,5.1,NA,23,0,14,22.2,0,-1,0,2,0,-1,-1,1
"11703",2021-01-10,"Cement Creek","w2021","Motorized",8,"Sun","weekend","sled","Brush/Cement",NA,NA,NA,5.1,NA,23,0,14,22.2,0,-1,0,2,0,-1,-1,1
"11704",2021-01-10,"Cement Creek","w2021","Hybrid",3,"Sun","weekend","sled","Brush/Cement",NA,NA,NA,5.1,NA,23,0,14,22.2,0,-1,0,2,0,-1,-1,1
"11705",2021-01-11,"Cement Creek","w2021","Non.motorized",15,"Mon","weekday","no_sled","Brush/Cement",NA,NA,NA,5.1,NA,23,0,15,22.2,0,0,-1,0,0,0,-1,-1
"11706",2021-01-11,"Cement Creek","w2021","Mechanized",1,"Mon","weekday","no_sled","Brush/Cement",NA,NA,NA,5.1,NA,23,0,15,22.2,0,0,-1,0,0,0,-1,-1
"11707",2021-01-11,"Cement Creek","w2021","Motorized",7,"Mon","weekday","sled","Brush/Cement",NA,NA,NA,5.1,NA,23,0,15,22.2,0,0,-1,0,0,0,-1,-1
"11708",2021-01-11,"Cement Creek","w2021","Hybrid",0,"Mon","weekday","sled","Brush/Cement",NA,NA,NA,5.1,NA,23,0,15,22.2,0,0,-1,0,0,0,-1,-1
"11709",2021-01-12,"Cement Creek","w2021","Non.motorized",19,"Tue","weekday","no_sled","Brush/Cement",NA,NA,NA,5.1,NA,23,0,23,22.2,0,0,0,-1,0,0,0,-1
"11710",2021-01-12,"Cement Creek","w2021","Mechanized",2,"Tue","weekday","no_sled","Brush/Cement",NA,NA,NA,5.1,NA,23,0,23,22.2,0,0,0,-1,0,0,0,-1
"11711",2021-01-12,"Cement Creek","w2021","Motorized",7,"Tue","weekday","sled","Brush/Cement",NA,NA,NA,5.1,NA,23,0,23,22.2,0,0,0,-1,0,0,0,-1
"11712",2021-01-12,"Cement Creek","w2021","Hybrid",0,"Tue","weekday","sled","Brush/Cement",NA,NA,NA,5.1,NA,23,0,23,22.2,0,0,0,-1,0,0,0,-1
"11713",2021-01-13,"Cement Creek","w2021","Non.motorized",9,"Wed","weekday","no_sled","Brush/Cement",NA,NA,NA,5.1,NA,23,0,28,22.2,0,0,0,0,0,0,0,0
"11714",2021-01-13,"Cement Creek","w2021","Mechanized",0,"Wed","weekday","no_sled","Brush/Cement",NA,NA,NA,5.1,NA,23,0,28,22.2,0,0,0,0,0,0,0,0
"11715",2021-01-13,"Cement Creek","w2021","Motorized",5,"Wed","weekday","sled","Brush/Cement",NA,NA,NA,5.1,NA,23,0,28,22.2,0,0,0,0,0,0,0,0
"11716",2021-01-13,"Cement Creek","w2021","Hybrid",0,"Wed","weekday","sled","Brush/Cement",NA,NA,NA,5.1,NA,23,0,28,22.2,0,0,0,0,0,0,0,0
"11717",2021-01-14,"Cement Creek","w2021","Non.motorized",28,"Thu","weekday","no_sled","Brush/Cement",NA,NA,NA,5.1,NA,22,-1,20,23.2,0,0,0,0,-1,-1,-1,-1
"11718",2021-01-14,"Cement Creek","w2021","Mechanized",1,"Thu","weekday","no_sled","Brush/Cement",NA,NA,NA,5.1,NA,22,-1,20,23.2,0,0,0,0,-1,-1,-1,-1
"11719",2021-01-14,"Cement Creek","w2021","Motorized",1,"Thu","weekday","sled","Brush/Cement",NA,NA,NA,5.1,NA,22,-1,20,23.2,0,0,0,0,-1,-1,-1,-1
"11720",2021-01-14,"Cement Creek","w2021","Hybrid",2,"Thu","weekday","sled","Brush/Cement",NA,NA,NA,5.1,NA,22,-1,20,23.2,0,0,0,0,-1,-1,-1,-1
"11721",2021-01-15,"Cement Creek","w2021","Non.motorized",29,"Fri","weekday","no_sled","Brush/Cement",NA,NA,NA,5.1,NA,22,0,26,23.2,-1,0,0,0,-1,-1,-1,-1
"11722",2021-01-15,"Cement Creek","w2021","Mechanized",4,"Fri","weekday","no_sled","Brush/Cement",NA,NA,NA,5.1,NA,22,0,26,23.2,-1,0,0,0,-1,-1,-1,-1
"11723",2021-01-15,"Cement Creek","w2021","Motorized",7,"Fri","weekday","sled","Brush/Cement",NA,NA,NA,5.1,NA,22,0,26,23.2,-1,0,0,0,-1,-1,-1,-1
"11724",2021-01-15,"Cement Creek","w2021","Hybrid",0,"Fri","weekday","sled","Brush/Cement",NA,NA,NA,5.1,NA,22,0,26,23.2,-1,0,0,0,-1,-1,-1,-1
"11725",2021-01-16,"Cement Creek","w2021","Non.motorized",65,"Sat","weekend","no_sled","Brush/Cement",NA,NA,NA,5.1,NA,22,0,26,23.2,0,-1,0,0,0,-1,-1,-1
"11726",2021-01-16,"Cement Creek","w2021","Mechanized",0,"Sat","weekend","no_sled","Brush/Cement",NA,NA,NA,5.1,NA,22,0,26,23.2,0,-1,0,0,0,-1,-1,-1
"11727",2021-01-16,"Cement Creek","w2021","Motorized",9,"Sat","weekend","sled","Brush/Cement",NA,NA,NA,5.1,NA,22,0,26,23.2,0,-1,0,0,0,-1,-1,-1
"11728",2021-01-16,"Cement Creek","w2021","Hybrid",0,"Sat","weekend","sled","Brush/Cement",NA,NA,NA,5.1,NA,22,0,26,23.2,0,-1,0,0,0,-1,-1,-1
"11729",2021-01-17,"Cement Creek","w2021","Non.motorized",64,"Sun","weekend","no_sled","Brush/Cement",NA,NA,NA,5.1,NA,22,0,29,23.2,0,0,-1,0,0,0,-1,-1
"11730",2021-01-17,"Cement Creek","w2021","Mechanized",1,"Sun","weekend","no_sled","Brush/Cement",NA,NA,NA,5.1,NA,22,0,29,23.2,0,0,-1,0,0,0,-1,-1
"11731",2021-01-17,"Cement Creek","w2021","Motorized",12,"Sun","weekend","sled","Brush/Cement",NA,NA,NA,5.1,NA,22,0,29,23.2,0,0,-1,0,0,0,-1,-1
"11732",2021-01-17,"Cement Creek","w2021","Hybrid",5,"Sun","weekend","sled","Brush/Cement",NA,NA,NA,5.1,NA,22,0,29,23.2,0,0,-1,0,0,0,-1,-1
"11733",2021-01-18,"Cement Creek","w2021","Non.motorized",59,"Mon","weekday","no_sled","Brush/Cement",NA,NA,NA,5.1,NA,22,0,24,23.2,0,0,0,-1,0,0,0,-1
"11734",2021-01-18,"Cement Creek","w2021","Mechanized",3,"Mon","weekday","no_sled","Brush/Cement",NA,NA,NA,5.1,NA,22,0,24,23.2,0,0,0,-1,0,0,0,-1
"11735",2021-01-18,"Cement Creek","w2021","Motorized",6,"Mon","weekday","sled","Brush/Cement",NA,NA,NA,5.1,NA,22,0,24,23.2,0,0,0,-1,0,0,0,-1
"11736",2021-01-18,"Cement Creek","w2021","Hybrid",1,"Mon","weekday","sled","Brush/Cement",NA,NA,NA,5.1,NA,22,0,24,23.2,0,0,0,-1,0,0,0,-1
"11737",2021-01-19,"Cement Creek","w2021","Non.motorized",19,"Tue","weekday","no_sled","Brush/Cement",NA,NA,NA,5.1,NA,22,0,19,23.2,0,0,0,0,0,0,0,0
"11738",2021-01-19,"Cement Creek","w2021","Mechanized",0,"Tue","weekday","no_sled","Brush/Cement",NA,NA,NA,5.1,NA,22,0,19,23.2,0,0,0,0,0,0,0,0
"11739",2021-01-19,"Cement Creek","w2021","Motorized",7,"Tue","weekday","sled","Brush/Cement",NA,NA,NA,5.1,NA,22,0,19,23.2,0,0,0,0,0,0,0,0
"11740",2021-01-19,"Cement Creek","w2021","Hybrid",0,"Tue","weekday","sled","Brush/Cement",NA,NA,NA,5.1,NA,22,0,19,23.2,0,0,0,0,0,0,0,0
"11741",2021-01-20,"Cement Creek","w2021","Non.motorized",22,"Wed","weekday","no_sled","Brush/Cement",NA,NA,NA,5.2,NA,23,1,26,22.6,0,0,0,0,1,1,1,1
"11742",2021-01-20,"Cement Creek","w2021","Mechanized",1,"Wed","weekday","no_sled","Brush/Cement",NA,NA,NA,5.2,NA,23,1,26,22.6,0,0,0,0,1,1,1,1
"11743",2021-01-20,"Cement Creek","w2021","Motorized",5,"Wed","weekday","sled","Brush/Cement",NA,NA,NA,5.2,NA,23,1,26,22.6,0,0,0,0,1,1,1,1
"11744",2021-01-20,"Cement Creek","w2021","Hybrid",0,"Wed","weekday","sled","Brush/Cement",NA,NA,NA,5.2,NA,23,1,26,22.6,0,0,0,0,1,1,1,1
"11745",2021-01-21,"Cement Creek","w2021","Non.motorized",20,"Thu","weekday","no_sled","Brush/Cement",NA,NA,NA,5.2,NA,23,0,26,22.6,1,0,0,0,1,1,1,1
"11746",2021-01-21,"Cement Creek","w2021","Mechanized",2,"Thu","weekday","no_sled","Brush/Cement",NA,NA,NA,5.2,NA,23,0,26,22.6,1,0,0,0,1,1,1,1
"11747",2021-01-21,"Cement Creek","w2021","Motorized",2,"Thu","weekday","sled","Brush/Cement",NA,NA,NA,5.2,NA,23,0,26,22.6,1,0,0,0,1,1,1,1
"11748",2021-01-21,"Cement Creek","w2021","Hybrid",1,"Thu","weekday","sled","Brush/Cement",NA,NA,NA,5.2,NA,23,0,26,22.6,1,0,0,0,1,1,1,1
"11749",2021-01-22,"Cement Creek","w2021","Non.motorized",14,"Fri","weekday","no_sled","Brush/Cement",NA,NA,NA,5.3,NA,25,2,25,21.2,0,1,0,0,2,3,3,3
"11750",2021-01-22,"Cement Creek","w2021","Mechanized",0,"Fri","weekday","no_sled","Brush/Cement",NA,NA,NA,5.3,NA,25,2,25,21.2,0,1,0,0,2,3,3,3
"11751",2021-01-22,"Cement Creek","w2021","Motorized",1,"Fri","weekday","sled","Brush/Cement",NA,NA,NA,5.3,NA,25,2,25,21.2,0,1,0,0,2,3,3,3
"11752",2021-01-22,"Cement Creek","w2021","Hybrid",0,"Fri","weekday","sled","Brush/Cement",NA,NA,NA,5.3,NA,25,2,25,21.2,0,1,0,0,2,3,3,3
"11753",2021-01-23,"Cement Creek","w2021","Non.motorized",38,"Sat","weekend","no_sled","Brush/Cement",NA,NA,NA,5.4,NA,26,1,22,20.8,2,0,1,0,3,3,4,4
"11754",2021-01-23,"Cement Creek","w2021","Mechanized",0,"Sat","weekend","no_sled","Brush/Cement",NA,NA,NA,5.4,NA,26,1,22,20.8,2,0,1,0,3,3,4,4
"11755",2021-01-23,"Cement Creek","w2021","Motorized",3,"Sat","weekend","sled","Brush/Cement",NA,NA,NA,5.4,NA,26,1,22,20.8,2,0,1,0,3,3,4,4
"11756",2021-01-23,"Cement Creek","w2021","Hybrid",0,"Sat","weekend","sled","Brush/Cement",NA,NA,NA,5.4,NA,26,1,22,20.8,2,0,1,0,3,3,4,4
"11757",2021-01-24,"Cement Creek","w2021","Non.motorized",52,"Sun","weekend","no_sled","Brush/Cement",NA,NA,NA,5.6,NA,29,3,18,19.3,1,2,0,1,4,6,6,7
"11758",2021-01-24,"Cement Creek","w2021","Mechanized",1,"Sun","weekend","no_sled","Brush/Cement",NA,NA,NA,5.6,NA,29,3,18,19.3,1,2,0,1,4,6,6,7
"11759",2021-01-24,"Cement Creek","w2021","Motorized",4,"Sun","weekend","sled","Brush/Cement",NA,NA,NA,5.6,NA,29,3,18,19.3,1,2,0,1,4,6,6,7
"11760",2021-01-24,"Cement Creek","w2021","Hybrid",0,"Sun","weekend","sled","Brush/Cement",NA,NA,NA,5.6,NA,29,3,18,19.3,1,2,0,1,4,6,6,7
"11761",2021-01-25,"Cement Creek","w2021","Non.motorized",23,"Mon","weekday","no_sled","Brush/Cement",NA,NA,NA,5.8,NA,29,0,15,20,3,1,2,0,3,4,6,6
"11762",2021-01-25,"Cement Creek","w2021","Mechanized",0,"Mon","weekday","no_sled","Brush/Cement",NA,NA,NA,5.8,NA,29,0,15,20,3,1,2,0,3,4,6,6
"11763",2021-01-25,"Cement Creek","w2021","Motorized",4,"Mon","weekday","sled","Brush/Cement",NA,NA,NA,5.8,NA,29,0,15,20,3,1,2,0,3,4,6,6
"11764",2021-01-25,"Cement Creek","w2021","Hybrid",0,"Mon","weekday","sled","Brush/Cement",NA,NA,NA,5.8,NA,29,0,15,20,3,1,2,0,3,4,6,6
"11765",2021-01-26,"Cement Creek","w2021","Non.motorized",14,"Tue","weekday","no_sled","Brush/Cement",NA,NA,NA,5.9,NA,29,0,13,20.3,0,3,1,2,0,3,4,6
"11766",2021-01-26,"Cement Creek","w2021","Mechanized",1,"Tue","weekday","no_sled","Brush/Cement",NA,NA,NA,5.9,NA,29,0,13,20.3,0,3,1,2,0,3,4,6
"11767",2021-01-26,"Cement Creek","w2021","Motorized",5,"Tue","weekday","sled","Brush/Cement",NA,NA,NA,5.9,NA,29,0,13,20.3,0,3,1,2,0,3,4,6
"11768",2021-01-26,"Cement Creek","w2021","Hybrid",0,"Tue","weekday","sled","Brush/Cement",NA,NA,NA,5.9,NA,29,0,13,20.3,0,3,1,2,0,3,4,6
"11769",2021-01-27,"Cement Creek","w2021","Non.motorized",13,"Wed","weekday","no_sled","Brush/Cement",NA,NA,NA,6,NA,30,1,13,20,0,0,3,1,1,1,4,5
"11770",2021-01-27,"Cement Creek","w2021","Mechanized",1,"Wed","weekday","no_sled","Brush/Cement",NA,NA,NA,6,NA,30,1,13,20,0,0,3,1,1,1,4,5
"11771",2021-01-27,"Cement Creek","w2021","Motorized",1,"Wed","weekday","sled","Brush/Cement",NA,NA,NA,6,NA,30,1,13,20,0,0,3,1,1,1,4,5
"11772",2021-01-27,"Cement Creek","w2021","Hybrid",0,"Wed","weekday","sled","Brush/Cement",NA,NA,NA,6,NA,30,1,13,20,0,0,3,1,1,1,4,5
"11773",2021-01-28,"Cement Creek","w2021","Non.motorized",18,"Thu","weekday","no_sled","Brush/Cement",NA,NA,NA,6,NA,28,-2,27,21.4,1,0,0,3,-1,-1,-1,2
"11774",2021-01-28,"Cement Creek","w2021","Mechanized",1,"Thu","weekday","no_sled","Brush/Cement",NA,NA,NA,6,NA,28,-2,27,21.4,1,0,0,3,-1,-1,-1,2
"11775",2021-01-28,"Cement Creek","w2021","Motorized",5,"Thu","weekday","sled","Brush/Cement",NA,NA,NA,6,NA,28,-2,27,21.4,1,0,0,3,-1,-1,-1,2
"11776",2021-01-28,"Cement Creek","w2021","Hybrid",0,"Thu","weekday","sled","Brush/Cement",NA,NA,NA,6,NA,28,-2,27,21.4,1,0,0,3,-1,-1,-1,2
"11777",2021-01-29,"Cement Creek","w2021","Non.motorized",27,"Fri","weekday","no_sled","Brush/Cement",NA,NA,NA,6.1,NA,28,0,29,21.8,-2,1,0,0,-2,-1,-1,-1
"11778",2021-01-29,"Cement Creek","w2021","Mechanized",1,"Fri","weekday","no_sled","Brush/Cement",NA,NA,NA,6.1,NA,28,0,29,21.8,-2,1,0,0,-2,-1,-1,-1
"11779",2021-01-29,"Cement Creek","w2021","Motorized",4,"Fri","weekday","sled","Brush/Cement",NA,NA,NA,6.1,NA,28,0,29,21.8,-2,1,0,0,-2,-1,-1,-1
"11780",2021-01-29,"Cement Creek","w2021","Hybrid",0,"Fri","weekday","sled","Brush/Cement",NA,NA,NA,6.1,NA,28,0,29,21.8,-2,1,0,0,-2,-1,-1,-1
"11781",2021-01-30,"Cement Creek","w2021","Non.motorized",38,"Sat","weekend","no_sled","Brush/Cement",NA,NA,NA,6.2,NA,29,1,21,21.4,0,-2,1,0,1,-1,0,0
"11782",2021-01-30,"Cement Creek","w2021","Mechanized",1,"Sat","weekend","no_sled","Brush/Cement",NA,NA,NA,6.2,NA,29,1,21,21.4,0,-2,1,0,1,-1,0,0
"11783",2021-01-30,"Cement Creek","w2021","Motorized",12,"Sat","weekend","sled","Brush/Cement",NA,NA,NA,6.2,NA,29,1,21,21.4,0,-2,1,0,1,-1,0,0
"11784",2021-01-30,"Cement Creek","w2021","Hybrid",2,"Sat","weekend","sled","Brush/Cement",NA,NA,NA,6.2,NA,29,1,21,21.4,0,-2,1,0,1,-1,0,0
"11785",2021-01-31,"Cement Creek","w2021","Non.motorized",69,"Sun","weekend","no_sled","Brush/Cement",NA,NA,NA,6.3,NA,29,0,21,21.7,1,0,-2,1,1,1,-1,0
"11786",2021-01-31,"Cement Creek","w2021","Mechanized",1,"Sun","weekend","no_sled","Brush/Cement",NA,NA,NA,6.3,NA,29,0,21,21.7,1,0,-2,1,1,1,-1,0
"11787",2021-01-31,"Cement Creek","w2021","Motorized",9,"Sun","weekend","sled","Brush/Cement",NA,NA,NA,6.3,NA,29,0,21,21.7,1,0,-2,1,1,1,-1,0
"11788",2021-01-31,"Cement Creek","w2021","Hybrid",1,"Sun","weekend","sled","Brush/Cement",NA,NA,NA,6.3,NA,29,0,21,21.7,1,0,-2,1,1,1,-1,0
"11789",2021-02-01,"Cement Creek","w2021","Non.motorized",28,"Mon","weekday","no_sled","Brush/Cement",NA,NA,NA,6.3,NA,28,-1,30,22.5,0,1,0,-2,-1,0,0,-2
"11790",2021-02-01,"Cement Creek","w2021","Mechanized",4,"Mon","weekday","no_sled","Brush/Cement",NA,NA,NA,6.3,NA,28,-1,30,22.5,0,1,0,-2,-1,0,0,-2
"11791",2021-02-01,"Cement Creek","w2021","Motorized",4,"Mon","weekday","sled","Brush/Cement",NA,NA,NA,6.3,NA,28,-1,30,22.5,0,1,0,-2,-1,0,0,-2
"11792",2021-02-01,"Cement Creek","w2021","Hybrid",0,"Mon","weekday","sled","Brush/Cement",NA,NA,NA,6.3,NA,28,-1,30,22.5,0,1,0,-2,-1,0,0,-2
"11793",2021-02-02,"Cement Creek","w2021","Non.motorized",22,"Tue","weekday","no_sled","Brush/Cement",NA,NA,NA,6.3,NA,28,0,34,22.5,-1,0,1,0,-1,-1,0,0
"11794",2021-02-02,"Cement Creek","w2021","Mechanized",2,"Tue","weekday","no_sled","Brush/Cement",NA,NA,NA,6.3,NA,28,0,34,22.5,-1,0,1,0,-1,-1,0,0
"11795",2021-02-02,"Cement Creek","w2021","Motorized",4,"Tue","weekday","sled","Brush/Cement",NA,NA,NA,6.3,NA,28,0,34,22.5,-1,0,1,0,-1,-1,0,0
"11796",2021-02-02,"Cement Creek","w2021","Hybrid",0,"Tue","weekday","sled","Brush/Cement",NA,NA,NA,6.3,NA,28,0,34,22.5,-1,0,1,0,-1,-1,0,0
"11797",2021-02-03,"Cement Creek","w2021","Non.motorized",20,"Wed","weekday","no_sled","Brush/Cement",NA,NA,NA,6.3,NA,27,-1,30,23.3,0,-1,0,1,-1,-2,-2,-1
"11798",2021-02-03,"Cement Creek","w2021","Mechanized",3,"Wed","weekday","no_sled","Brush/Cement",NA,NA,NA,6.3,NA,27,-1,30,23.3,0,-1,0,1,-1,-2,-2,-1
"11799",2021-02-03,"Cement Creek","w2021","Motorized",5,"Wed","weekday","sled","Brush/Cement",NA,NA,NA,6.3,NA,27,-1,30,23.3,0,-1,0,1,-1,-2,-2,-1
"11800",2021-02-03,"Cement Creek","w2021","Hybrid",0,"Wed","weekday","sled","Brush/Cement",NA,NA,NA,6.3,NA,27,-1,30,23.3,0,-1,0,1,-1,-2,-2,-1
"11801",2021-02-04,"Cement Creek","w2021","Non.motorized",9,"Thu","weekday","no_sled","Brush/Cement",NA,NA,NA,7.2,NA,37,10,14,19.5,-1,0,-1,0,9,9,8,8
"11802",2021-02-04,"Cement Creek","w2021","Mechanized",0,"Thu","weekday","no_sled","Brush/Cement",NA,NA,NA,7.2,NA,37,10,14,19.5,-1,0,-1,0,9,9,8,8
"11803",2021-02-04,"Cement Creek","w2021","Motorized",3,"Thu","weekday","sled","Brush/Cement",NA,NA,NA,7.2,NA,37,10,14,19.5,-1,0,-1,0,9,9,8,8
"11804",2021-02-04,"Cement Creek","w2021","Hybrid",0,"Thu","weekday","sled","Brush/Cement",NA,NA,NA,7.2,NA,37,10,14,19.5,-1,0,-1,0,9,9,8,8
"11805",2021-02-05,"Cement Creek","w2021","Non.motorized",28,"Fri","weekday","no_sled","Brush/Cement",NA,NA,NA,7.2,NA,35,-2,16,20.6,10,-1,0,-1,8,7,7,6
"11806",2021-02-05,"Cement Creek","w2021","Mechanized",1,"Fri","weekday","no_sled","Brush/Cement",NA,NA,NA,7.2,NA,35,-2,16,20.6,10,-1,0,-1,8,7,7,6
"11807",2021-02-05,"Cement Creek","w2021","Motorized",2,"Fri","weekday","sled","Brush/Cement",NA,NA,NA,7.2,NA,35,-2,16,20.6,10,-1,0,-1,8,7,7,6
"11808",2021-02-05,"Cement Creek","w2021","Hybrid",0,"Fri","weekday","sled","Brush/Cement",NA,NA,NA,7.2,NA,35,-2,16,20.6,10,-1,0,-1,8,7,7,6
"11809",2021-02-06,"Cement Creek","w2021","Non.motorized",66,"Sat","weekend","no_sled","Brush/Cement",NA,NA,NA,7.5,NA,37,2,19,20.3,-2,10,-1,0,0,10,9,9
"11810",2021-02-06,"Cement Creek","w2021","Mechanized",0,"Sat","weekend","no_sled","Brush/Cement",NA,NA,NA,7.5,NA,37,2,19,20.3,-2,10,-1,0,0,10,9,9
"11811",2021-02-06,"Cement Creek","w2021","Motorized",4,"Sat","weekend","sled","Brush/Cement",NA,NA,NA,7.5,NA,37,2,19,20.3,-2,10,-1,0,0,10,9,9
"11812",2021-02-06,"Cement Creek","w2021","Hybrid",0,"Sat","weekend","sled","Brush/Cement",NA,NA,NA,7.5,NA,37,2,19,20.3,-2,10,-1,0,0,10,9,9
"11813",2021-02-07,"Cement Creek","w2021","Non.motorized",57,"Sun","weekend","no_sled","Brush/Cement",NA,NA,NA,7.5,NA,36,-1,24,20.8,2,-2,10,-1,1,-1,9,8
"11814",2021-02-07,"Cement Creek","w2021","Mechanized",5,"Sun","weekend","no_sled","Brush/Cement",NA,NA,NA,7.5,NA,36,-1,24,20.8,2,-2,10,-1,1,-1,9,8
"11815",2021-02-07,"Cement Creek","w2021","Motorized",9,"Sun","weekend","sled","Brush/Cement",NA,NA,NA,7.5,NA,36,-1,24,20.8,2,-2,10,-1,1,-1,9,8
"11816",2021-02-07,"Cement Creek","w2021","Hybrid",0,"Sun","weekend","sled","Brush/Cement",NA,NA,NA,7.5,NA,36,-1,24,20.8,2,-2,10,-1,1,-1,9,8
"11817",2021-02-08,"Cement Creek","w2021","Non.motorized",27,"Mon","weekday","no_sled","Brush/Cement",NA,NA,NA,7.6,NA,35,-1,28,21.7,-1,2,-2,10,-2,0,-2,8
"11818",2021-02-08,"Cement Creek","w2021","Mechanized",2,"Mon","weekday","no_sled","Brush/Cement",NA,NA,NA,7.6,NA,35,-1,28,21.7,-1,2,-2,10,-2,0,-2,8
"11819",2021-02-08,"Cement Creek","w2021","Motorized",1,"Mon","weekday","sled","Brush/Cement",NA,NA,NA,7.6,NA,35,-1,28,21.7,-1,2,-2,10,-2,0,-2,8
"11820",2021-02-08,"Cement Creek","w2021","Hybrid",1,"Mon","weekday","sled","Brush/Cement",NA,NA,NA,7.6,NA,35,-1,28,21.7,-1,2,-2,10,-2,0,-2,8
"11821",2021-02-09,"Cement Creek","w2021","Non.motorized",14,"Tue","weekday","no_sled","Brush/Cement",NA,NA,NA,7.6,NA,34,-1,28,22.4,-1,-1,2,-2,-2,-3,-1,-3
"11822",2021-02-09,"Cement Creek","w2021","Mechanized",2,"Tue","weekday","no_sled","Brush/Cement",NA,NA,NA,7.6,NA,34,-1,28,22.4,-1,-1,2,-2,-2,-3,-1,-3
"11823",2021-02-09,"Cement Creek","w2021","Motorized",3,"Tue","weekday","sled","Brush/Cement",NA,NA,NA,7.6,NA,34,-1,28,22.4,-1,-1,2,-2,-2,-3,-1,-3
"11824",2021-02-09,"Cement Creek","w2021","Hybrid",0,"Tue","weekday","sled","Brush/Cement",NA,NA,NA,7.6,NA,34,-1,28,22.4,-1,-1,2,-2,-2,-3,-1,-3
"11825",2021-02-10,"Cement Creek","w2021","Non.motorized",17,"Wed","weekday","no_sled","Brush/Cement",NA,NA,NA,7.7,NA,34,0,26,22.6,-1,-1,-1,2,-1,-2,-3,-1
"11826",2021-02-10,"Cement Creek","w2021","Mechanized",0,"Wed","weekday","no_sled","Brush/Cement",NA,NA,NA,7.7,NA,34,0,26,22.6,-1,-1,-1,2,-1,-2,-3,-1
"11827",2021-02-10,"Cement Creek","w2021","Motorized",3,"Wed","weekday","sled","Brush/Cement",NA,NA,NA,7.7,NA,34,0,26,22.6,-1,-1,-1,2,-1,-2,-3,-1
"11828",2021-02-10,"Cement Creek","w2021","Hybrid",0,"Wed","weekday","sled","Brush/Cement",NA,NA,NA,7.7,NA,34,0,26,22.6,-1,-1,-1,2,-1,-2,-3,-1
"11829",2021-02-11,"Cement Creek","w2021","Non.motorized",17,"Thu","weekday","no_sled","Brush/Cement",NA,NA,NA,8,NA,37,3,26,21.6,0,-1,-1,-1,3,2,1,0
"11830",2021-02-11,"Cement Creek","w2021","Mechanized",1,"Thu","weekday","no_sled","Brush/Cement",NA,NA,NA,8,NA,37,3,26,21.6,0,-1,-1,-1,3,2,1,0
"11831",2021-02-11,"Cement Creek","w2021","Motorized",5,"Thu","weekday","sled","Brush/Cement",NA,NA,NA,8,NA,37,3,26,21.6,0,-1,-1,-1,3,2,1,0
"11832",2021-02-11,"Cement Creek","w2021","Hybrid",0,"Thu","weekday","sled","Brush/Cement",NA,NA,NA,8,NA,37,3,26,21.6,0,-1,-1,-1,3,2,1,0
"11833",2021-02-12,"Cement Creek","w2021","Non.motorized",26,"Fri","weekday","no_sled","Brush/Cement",NA,NA,NA,8.1,NA,37,0,27,21.9,3,0,-1,-1,3,3,2,1
"11834",2021-02-12,"Cement Creek","w2021","Mechanized",1,"Fri","weekday","no_sled","Brush/Cement",NA,NA,NA,8.1,NA,37,0,27,21.9,3,0,-1,-1,3,3,2,1
"11835",2021-02-12,"Cement Creek","w2021","Motorized",1,"Fri","weekday","sled","Brush/Cement",NA,NA,NA,8.1,NA,37,0,27,21.9,3,0,-1,-1,3,3,2,1
"11836",2021-02-12,"Cement Creek","w2021","Hybrid",3,"Fri","weekday","sled","Brush/Cement",NA,NA,NA,8.1,NA,37,0,27,21.9,3,0,-1,-1,3,3,2,1
"11837",2021-02-13,"Cement Creek","w2021","Non.motorized",58,"Sat","weekend","no_sled","Brush/Cement",NA,NA,NA,8.4,NA,38,1,26,22.1,0,3,0,-1,1,4,4,3
"11838",2021-02-13,"Cement Creek","w2021","Mechanized",0,"Sat","weekend","no_sled","Brush/Cement",NA,NA,NA,8.4,NA,38,1,26,22.1,0,3,0,-1,1,4,4,3
"11839",2021-02-13,"Cement Creek","w2021","Motorized",4,"Sat","weekend","sled","Brush/Cement",NA,NA,NA,8.4,NA,38,1,26,22.1,0,3,0,-1,1,4,4,3
"11840",2021-02-13,"Cement Creek","w2021","Hybrid",0,"Sat","weekend","sled","Brush/Cement",NA,NA,NA,8.4,NA,38,1,26,22.1,0,3,0,-1,1,4,4,3
"11841",2021-02-14,"Cement Creek","w2021","Non.motorized",34,"Sun","weekend","no_sled","Brush/Cement",NA,NA,NA,8.9,NA,43,5,18,20.7,1,0,3,0,6,6,9,9
"11842",2021-02-14,"Cement Creek","w2021","Mechanized",0,"Sun","weekend","no_sled","Brush/Cement",NA,NA,NA,8.9,NA,43,5,18,20.7,1,0,3,0,6,6,9,9
"11843",2021-02-14,"Cement Creek","w2021","Motorized",3,"Sun","weekend","sled","Brush/Cement",NA,NA,NA,8.9,NA,43,5,18,20.7,1,0,3,0,6,6,9,9
"11844",2021-02-14,"Cement Creek","w2021","Hybrid",0,"Sun","weekend","sled","Brush/Cement",NA,NA,NA,8.9,NA,43,5,18,20.7,1,0,3,0,6,6,9,9
"11845",2021-02-15,"Cement Creek","w2021","Non.motorized",18,"Mon","weekday","no_sled","Brush/Cement",NA,NA,NA,8.9,NA,43,0,12,20.7,5,1,0,3,5,6,6,9
"11846",2021-02-15,"Cement Creek","w2021","Mechanized",0,"Mon","weekday","no_sled","Brush/Cement",NA,NA,NA,8.9,NA,43,0,12,20.7,5,1,0,3,5,6,6,9
"11847",2021-02-15,"Cement Creek","w2021","Motorized",2,"Mon","weekday","sled","Brush/Cement",NA,NA,NA,8.9,NA,43,0,12,20.7,5,1,0,3,5,6,6,9
"11848",2021-02-15,"Cement Creek","w2021","Hybrid",0,"Mon","weekday","sled","Brush/Cement",NA,NA,NA,8.9,NA,43,0,12,20.7,5,1,0,3,5,6,6,9
"11849",2001-02-16,"Cement Creek","w2021","Non.motorized",12,"Fri","weekday","no_sled","Brush/Cement",NA,NA,NA,NA,NA,NA,NA,NA,NA,NA,NA,NA,NA,NA,NA,NA,NA
"11850",2001-02-16,"Cement Creek","w2021","Mechanized",0,"Fri","weekday","no_sled","Brush/Cement",NA,NA,NA,NA,NA,NA,NA,NA,NA,NA,NA,NA,NA,NA,NA,NA,NA
"11851",2001-02-16,"Cement Creek","w2021","Motorized",3,"Fri","weekday","sled","Brush/Cement",NA,NA,NA,NA,NA,NA,NA,NA,NA,NA,NA,NA,NA,NA,NA,NA,NA
"11852",2001-02-16,"Cement Creek","w2021","Hybrid",0,"Fri","weekday","sled","Brush/Cement",NA,NA,NA,NA,NA,NA,NA,NA,NA,NA,NA,NA,NA,NA,NA,NA,NA
"11853",2021-02-17,"Cement Creek","w2021","Non.motorized",17,"Wed","weekday","no_sled","Brush/Cement",NA,NA,NA,9.1,NA,42,1,13,21.7,-2,0,5,1,-1,-1,4,5
"11854",2021-02-17,"Cement Creek","w2021","Mechanized",3,"Wed","weekday","no_sled","Brush/Cement",NA,NA,NA,9.1,NA,42,1,13,21.7,-2,0,5,1,-1,-1,4,5
"11855",2021-02-17,"Cement Creek","w2021","Motorized",1,"Wed","weekday","sled","Brush/Cement",NA,NA,NA,9.1,NA,42,1,13,21.7,-2,0,5,1,-1,-1,4,5
"11856",2021-02-17,"Cement Creek","w2021","Hybrid",0,"Wed","weekday","sled","Brush/Cement",NA,NA,NA,9.1,NA,42,1,13,21.7,-2,0,5,1,-1,-1,4,5
"11857",2021-02-18,"Cement Creek","w2021","Non.motorized",26,"Thu","weekday","no_sled","Brush/Cement",NA,NA,NA,9.1,NA,41,-1,11,22.2,1,-2,0,5,0,-2,-2,3
"11858",2021-02-18,"Cement Creek","w2021","Mechanized",1,"Thu","weekday","no_sled","Brush/Cement",NA,NA,NA,9.1,NA,41,-1,11,22.2,1,-2,0,5,0,-2,-2,3
"11859",2021-02-18,"Cement Creek","w2021","Motorized",5,"Thu","weekday","sled","Brush/Cement",NA,NA,NA,9.1,NA,41,-1,11,22.2,1,-2,0,5,0,-2,-2,3
"11860",2021-02-18,"Cement Creek","w2021","Hybrid",0,"Thu","weekday","sled","Brush/Cement",NA,NA,NA,9.1,NA,41,-1,11,22.2,1,-2,0,5,0,-2,-2,3
"11861",2021-02-19,"Cement Creek","w2021","Non.motorized",20,"Fri","weekday","no_sled","Brush/Cement",NA,NA,NA,9.1,NA,40,-1,18,22.8,-1,1,-2,0,-2,-1,-3,-3
"11862",2021-02-19,"Cement Creek","w2021","Mechanized",0,"Fri","weekday","no_sled","Brush/Cement",NA,NA,NA,9.1,NA,40,-1,18,22.8,-1,1,-2,0,-2,-1,-3,-3
"11863",2021-02-19,"Cement Creek","w2021","Motorized",4,"Fri","weekday","sled","Brush/Cement",NA,NA,NA,9.1,NA,40,-1,18,22.8,-1,1,-2,0,-2,-1,-3,-3
"11864",2021-02-19,"Cement Creek","w2021","Hybrid",0,"Fri","weekday","sled","Brush/Cement",NA,NA,NA,9.1,NA,40,-1,18,22.8,-1,1,-2,0,-2,-1,-3,-3
"11865",2021-02-20,"Cement Creek","w2021","Non.motorized",41,"Sat","weekend","no_sled","Brush/Cement",NA,NA,NA,9.2,NA,39,-1,23,23.6,-1,-1,1,-2,-2,-3,-2,-4
"11866",2021-02-20,"Cement Creek","w2021","Mechanized",1,"Sat","weekend","no_sled","Brush/Cement",NA,NA,NA,9.2,NA,39,-1,23,23.6,-1,-1,1,-2,-2,-3,-2,-4
"11867",2021-02-20,"Cement Creek","w2021","Motorized",2,"Sat","weekend","sled","Brush/Cement",NA,NA,NA,9.2,NA,39,-1,23,23.6,-1,-1,1,-2,-2,-3,-2,-4
"11868",2021-02-20,"Cement Creek","w2021","Hybrid",1,"Sat","weekend","sled","Brush/Cement",NA,NA,NA,9.2,NA,39,-1,23,23.6,-1,-1,1,-2,-2,-3,-2,-4
"11869",2021-02-21,"Cement Creek","w2021","Non.motorized",63,"Sun","weekend","no_sled","Brush/Cement",NA,NA,NA,9.2,NA,39,0,15,23.6,-1,-1,-1,1,-1,-2,-3,-2
"11870",2021-02-21,"Cement Creek","w2021","Mechanized",4,"Sun","weekend","no_sled","Brush/Cement",NA,NA,NA,9.2,NA,39,0,15,23.6,-1,-1,-1,1,-1,-2,-3,-2
"11871",2021-02-21,"Cement Creek","w2021","Motorized",3,"Sun","weekend","sled","Brush/Cement",NA,NA,NA,9.2,NA,39,0,15,23.6,-1,-1,-1,1,-1,-2,-3,-2
"11872",2021-02-21,"Cement Creek","w2021","Hybrid",3,"Sun","weekend","sled","Brush/Cement",NA,NA,NA,9.2,NA,39,0,15,23.6,-1,-1,-1,1,-1,-2,-3,-2
"11873",2021-02-22,"Cement Creek","w2021","Non.motorized",20,"Mon","weekday","no_sled","Brush/Cement",NA,NA,NA,9.2,NA,39,0,23,23.6,0,-1,-1,-1,0,-1,-2,-3
"11874",2021-02-22,"Cement Creek","w2021","Mechanized",3,"Mon","weekday","no_sled","Brush/Cement",NA,NA,NA,9.2,NA,39,0,23,23.6,0,-1,-1,-1,0,-1,-2,-3
"11875",2021-02-22,"Cement Creek","w2021","Motorized",2,"Mon","weekday","sled","Brush/Cement",NA,NA,NA,9.2,NA,39,0,23,23.6,0,-1,-1,-1,0,-1,-2,-3
"11876",2021-02-22,"Cement Creek","w2021","Hybrid",0,"Mon","weekday","sled","Brush/Cement",NA,NA,NA,9.2,NA,39,0,23,23.6,0,-1,-1,-1,0,-1,-2,-3
"11877",2021-02-23,"Cement Creek","w2021","Non.motorized",21,"Tue","weekday","no_sled","Brush/Cement",NA,NA,NA,9.2,NA,38,-1,28,24.2,0,0,-1,-1,-1,-1,-2,-3
"11878",2021-02-23,"Cement Creek","w2021","Mechanized",2,"Tue","weekday","no_sled","Brush/Cement",NA,NA,NA,9.2,NA,38,-1,28,24.2,0,0,-1,-1,-1,-1,-2,-3
"11879",2021-02-23,"Cement Creek","w2021","Motorized",5,"Tue","weekday","sled","Brush/Cement",NA,NA,NA,9.2,NA,38,-1,28,24.2,0,0,-1,-1,-1,-1,-2,-3
"11880",2021-02-23,"Cement Creek","w2021","Hybrid",0,"Tue","weekday","sled","Brush/Cement",NA,NA,NA,9.2,NA,38,-1,28,24.2,0,0,-1,-1,-1,-1,-2,-3
"11881",2021-02-24,"Cement Creek","w2021","Non.motorized",17,"Wed","weekday","no_sled","Brush/Cement",NA,NA,NA,9.2,NA,38,0,23,24.2,-1,0,0,-1,-1,-1,-1,-2
"11882",2021-02-24,"Cement Creek","w2021","Mechanized",0,"Wed","weekday","no_sled","Brush/Cement",NA,NA,NA,9.2,NA,38,0,23,24.2,-1,0,0,-1,-1,-1,-1,-2
"11883",2021-02-24,"Cement Creek","w2021","Motorized",2,"Wed","weekday","sled","Brush/Cement",NA,NA,NA,9.2,NA,38,0,23,24.2,-1,0,0,-1,-1,-1,-1,-2
"11884",2021-02-24,"Cement Creek","w2021","Hybrid",1,"Wed","weekday","sled","Brush/Cement",NA,NA,NA,9.2,NA,38,0,23,24.2,-1,0,0,-1,-1,-1,-1,-2
"11885",2021-02-25,"Cement Creek","w2021","Non.motorized",23,"Thu","weekday","no_sled","Brush/Cement",NA,NA,NA,9.2,NA,37,-1,20,24.9,0,-1,0,0,-1,-2,-2,-2
"11886",2021-02-25,"Cement Creek","w2021","Mechanized",1,"Thu","weekday","no_sled","Brush/Cement",NA,NA,NA,9.2,NA,37,-1,20,24.9,0,-1,0,0,-1,-2,-2,-2
"11887",2021-02-25,"Cement Creek","w2021","Motorized",5,"Thu","weekday","sled","Brush/Cement",NA,NA,NA,9.2,NA,37,-1,20,24.9,0,-1,0,0,-1,-2,-2,-2
"11888",2021-02-25,"Cement Creek","w2021","Hybrid",1,"Thu","weekday","sled","Brush/Cement",NA,NA,NA,9.2,NA,37,-1,20,24.9,0,-1,0,0,-1,-2,-2,-2
"11889",2021-02-26,"Cement Creek","w2021","Non.motorized",26,"Fri","weekday","no_sled","Brush/Cement",NA,NA,NA,9.2,NA,37,0,21,24.9,-1,0,-1,0,-1,-1,-2,-2
"11890",2021-02-26,"Cement Creek","w2021","Mechanized",3,"Fri","weekday","no_sled","Brush/Cement",NA,NA,NA,9.2,NA,37,0,21,24.9,-1,0,-1,0,-1,-1,-2,-2
"11891",2021-02-26,"Cement Creek","w2021","Motorized",1,"Fri","weekday","sled","Brush/Cement",NA,NA,NA,9.2,NA,37,0,21,24.9,-1,0,-1,0,-1,-1,-2,-2
"11892",2021-02-26,"Cement Creek","w2021","Hybrid",2,"Fri","weekday","sled","Brush/Cement",NA,NA,NA,9.2,NA,37,0,21,24.9,-1,0,-1,0,-1,-1,-2,-2
"11893",2021-02-27,"Cement Creek","w2021","Non.motorized",31,"Sat","weekend","no_sled","Brush/Cement",NA,NA,NA,9.2,NA,37,0,15,24.9,0,-1,0,-1,0,-1,-1,-2
"11894",2021-02-27,"Cement Creek","w2021","Mechanized",0,"Sat","weekend","no_sled","Brush/Cement",NA,NA,NA,9.2,NA,37,0,15,24.9,0,-1,0,-1,0,-1,-1,-2
"11895",2021-02-27,"Cement Creek","w2021","Motorized",4,"Sat","weekend","sled","Brush/Cement",NA,NA,NA,9.2,NA,37,0,15,24.9,0,-1,0,-1,0,-1,-1,-2
"11896",2021-02-27,"Cement Creek","w2021","Hybrid",1,"Sat","weekend","sled","Brush/Cement",NA,NA,NA,9.2,NA,37,0,15,24.9,0,-1,0,-1,0,-1,-1,-2
"11897",2021-02-28,"Cement Creek","w2021","Non.motorized",63,"Sun","weekend","no_sled","Brush/Cement",NA,NA,NA,9.2,NA,38,1,9,24.2,0,0,-1,0,1,1,0,0
"11898",2021-02-28,"Cement Creek","w2021","Mechanized",2,"Sun","weekend","no_sled","Brush/Cement",NA,NA,NA,9.2,NA,38,1,9,24.2,0,0,-1,0,1,1,0,0
"11899",2021-02-28,"Cement Creek","w2021","Motorized",3,"Sun","weekend","sled","Brush/Cement",NA,NA,NA,9.2,NA,38,1,9,24.2,0,0,-1,0,1,1,0,0
"11900",2021-02-28,"Cement Creek","w2021","Hybrid",1,"Sun","weekend","sled","Brush/Cement",NA,NA,NA,9.2,NA,38,1,9,24.2,0,0,-1,0,1,1,0,0
"11901",2021-03-01,"Cement Creek","w2021","Non.motorized",18,"Mon","weekday","no_sled","Brush/Cement",NA,NA,NA,9.2,NA,37,-1,20,24.9,1,0,0,-1,0,0,0,-1
"11902",2021-03-01,"Cement Creek","w2021","Mechanized",5,"Mon","weekday","no_sled","Brush/Cement",NA,NA,NA,9.2,NA,37,-1,20,24.9,1,0,0,-1,0,0,0,-1
"11903",2021-03-01,"Cement Creek","w2021","Motorized",6,"Mon","weekday","sled","Brush/Cement",NA,NA,NA,9.2,NA,37,-1,20,24.9,1,0,0,-1,0,0,0,-1
"11904",2021-03-01,"Cement Creek","w2021","Hybrid",1,"Mon","weekday","sled","Brush/Cement",NA,NA,NA,9.2,NA,37,-1,20,24.9,1,0,0,-1,0,0,0,-1
"11905",2021-03-02,"Cement Creek","w2021","Non.motorized",22,"Tue","weekday","no_sled","Brush/Cement",NA,NA,NA,9.2,NA,36,-1,27,25.6,-1,1,0,0,-2,-1,-1,-1
"11906",2021-03-02,"Cement Creek","w2021","Mechanized",4,"Tue","weekday","no_sled","Brush/Cement",NA,NA,NA,9.2,NA,36,-1,27,25.6,-1,1,0,0,-2,-1,-1,-1
"11907",2021-03-02,"Cement Creek","w2021","Motorized",3,"Tue","weekday","sled","Brush/Cement",NA,NA,NA,9.2,NA,36,-1,27,25.6,-1,1,0,0,-2,-1,-1,-1
"11908",2021-03-02,"Cement Creek","w2021","Hybrid",0,"Tue","weekday","sled","Brush/Cement",NA,NA,NA,9.2,NA,36,-1,27,25.6,-1,1,0,0,-2,-1,-1,-1
"11909",2021-03-03,"Cement Creek","w2021","Non.motorized",24,"Wed","weekday","no_sled","Brush/Cement",NA,NA,NA,9.2,NA,36,0,31,25.6,-1,-1,1,0,-1,-2,-1,-1
"11910",2021-03-03,"Cement Creek","w2021","Mechanized",3,"Wed","weekday","no_sled","Brush/Cement",NA,NA,NA,9.2,NA,36,0,31,25.6,-1,-1,1,0,-1,-2,-1,-1
"11911",2021-03-03,"Cement Creek","w2021","Motorized",5,"Wed","weekday","sled","Brush/Cement",NA,NA,NA,9.2,NA,36,0,31,25.6,-1,-1,1,0,-1,-2,-1,-1
"11912",2021-03-03,"Cement Creek","w2021","Hybrid",0,"Wed","weekday","sled","Brush/Cement",NA,NA,NA,9.2,NA,36,0,31,25.6,-1,-1,1,0,-1,-2,-1,-1
"11913",2021-03-04,"Cement Creek","w2021","Non.motorized",19,"Thu","weekday","no_sled","Brush/Cement",NA,NA,NA,9.2,NA,36,0,28,25.6,0,-1,-1,1,0,-1,-2,-1
"11914",2021-03-04,"Cement Creek","w2021","Mechanized",1,"Thu","weekday","no_sled","Brush/Cement",NA,NA,NA,9.2,NA,36,0,28,25.6,0,-1,-1,1,0,-1,-2,-1
"11915",2021-03-04,"Cement Creek","w2021","Motorized",1,"Thu","weekday","sled","Brush/Cement",NA,NA,NA,9.2,NA,36,0,28,25.6,0,-1,-1,1,0,-1,-2,-1
"11916",2021-03-04,"Cement Creek","w2021","Hybrid",0,"Thu","weekday","sled","Brush/Cement",NA,NA,NA,9.2,NA,36,0,28,25.6,0,-1,-1,1,0,-1,-2,-1
"11917",2021-03-05,"Cement Creek","w2021","Non.motorized",23,"Fri","weekday","no_sled","Brush/Cement",NA,NA,NA,9.4,NA,39,3,30,24.1,0,0,-1,-1,3,3,2,1
"11918",2021-03-05,"Cement Creek","w2021","Mechanized",2,"Fri","weekday","no_sled","Brush/Cement",NA,NA,NA,9.4,NA,39,3,30,24.1,0,0,-1,-1,3,3,2,1
"11919",2021-03-05,"Cement Creek","w2021","Motorized",5,"Fri","weekday","sled","Brush/Cement",NA,NA,NA,9.4,NA,39,3,30,24.1,0,0,-1,-1,3,3,2,1
"11920",2021-03-05,"Cement Creek","w2021","Hybrid",0,"Fri","weekday","sled","Brush/Cement",NA,NA,NA,9.4,NA,39,3,30,24.1,0,0,-1,-1,3,3,2,1
"11921",2021-03-06,"Cement Creek","w2021","Non.motorized",54,"Sat","weekend","no_sled","Brush/Cement",NA,NA,NA,9.4,NA,38,-1,32,24.7,3,0,0,-1,2,2,2,1
"11922",2021-03-06,"Cement Creek","w2021","Mechanized",3,"Sat","weekend","no_sled","Brush/Cement",NA,NA,NA,9.4,NA,38,-1,32,24.7,3,0,0,-1,2,2,2,1
"11923",2021-03-06,"Cement Creek","w2021","Motorized",5,"Sat","weekend","sled","Brush/Cement",NA,NA,NA,9.4,NA,38,-1,32,24.7,3,0,0,-1,2,2,2,1
"11924",2021-03-06,"Cement Creek","w2021","Hybrid",0,"Sat","weekend","sled","Brush/Cement",NA,NA,NA,9.4,NA,38,-1,32,24.7,3,0,0,-1,2,2,2,1
"11925",2021-03-07,"Cement Creek","w2021","Non.motorized",50,"Sun","weekend","no_sled","Brush/Cement",NA,NA,NA,9.4,NA,37,-1,35,25.4,-1,3,0,0,-2,1,1,1
"11926",2021-03-07,"Cement Creek","w2021","Mechanized",1,"Sun","weekend","no_sled","Brush/Cement",NA,NA,NA,9.4,NA,37,-1,35,25.4,-1,3,0,0,-2,1,1,1
"11927",2021-03-07,"Cement Creek","w2021","Motorized",5,"Sun","weekend","sled","Brush/Cement",NA,NA,NA,9.4,NA,37,-1,35,25.4,-1,3,0,0,-2,1,1,1
"11928",2021-03-07,"Cement Creek","w2021","Hybrid",0,"Sun","weekend","sled","Brush/Cement",NA,NA,NA,9.4,NA,37,-1,35,25.4,-1,3,0,0,-2,1,1,1
"11929",2021-03-08,"Cement Creek","w2021","Non.motorized",21,"Mon","weekday","no_sled","Brush/Cement",NA,NA,NA,9.5,NA,37,0,33,25.7,-1,-1,3,0,-1,-2,1,1
"11930",2021-03-08,"Cement Creek","w2021","Mechanized",0,"Mon","weekday","no_sled","Brush/Cement",NA,NA,NA,9.5,NA,37,0,33,25.7,-1,-1,3,0,-1,-2,1,1
"11931",2021-03-08,"Cement Creek","w2021","Motorized",5,"Mon","weekday","sled","Brush/Cement",NA,NA,NA,9.5,NA,37,0,33,25.7,-1,-1,3,0,-1,-2,1,1
"11932",2021-03-08,"Cement Creek","w2021","Hybrid",0,"Mon","weekday","sled","Brush/Cement",NA,NA,NA,9.5,NA,37,0,33,25.7,-1,-1,3,0,-1,-2,1,1
"11933",2021-03-09,"Cement Creek","w2021","Non.motorized",13,"Tue","weekday","no_sled","Brush/Cement",NA,NA,NA,9.5,NA,37,0,33,25.7,0,-1,-1,3,0,-1,-2,1
"11934",2021-03-09,"Cement Creek","w2021","Mechanized",2,"Tue","weekday","no_sled","Brush/Cement",NA,NA,NA,9.5,NA,37,0,33,25.7,0,-1,-1,3,0,-1,-2,1
"11935",2021-03-09,"Cement Creek","w2021","Motorized",6,"Tue","weekday","sled","Brush/Cement",NA,NA,NA,9.5,NA,37,0,33,25.7,0,-1,-1,3,0,-1,-2,1
"11936",2021-03-09,"Cement Creek","w2021","Hybrid",0,"Tue","weekday","sled","Brush/Cement",NA,NA,NA,9.5,NA,37,0,33,25.7,0,-1,-1,3,0,-1,-2,1
"11937",2021-03-10,"Cement Creek","w2021","Non.motorized",15,"Wed","weekday","no_sled","Brush/Cement",NA,NA,NA,9.7,NA,39,2,21,24.9,0,0,-1,-1,2,2,1,0
"11938",2021-03-10,"Cement Creek","w2021","Mechanized",0,"Wed","weekday","no_sled","Brush/Cement",NA,NA,NA,9.7,NA,39,2,21,24.9,0,0,-1,-1,2,2,1,0
"11939",2021-03-10,"Cement Creek","w2021","Motorized",8,"Wed","weekday","sled","Brush/Cement",NA,NA,NA,9.7,NA,39,2,21,24.9,0,0,-1,-1,2,2,1,0
"11940",2021-03-10,"Cement Creek","w2021","Hybrid",0,"Wed","weekday","sled","Brush/Cement",NA,NA,NA,9.7,NA,39,2,21,24.9,0,0,-1,-1,2,2,1,0
"11941",2021-03-11,"Cement Creek","w2021","Non.motorized",12,"Thu","weekday","no_sled","Brush/Cement",NA,NA,NA,9.8,NA,40,1,22,24.5,2,0,0,-1,3,3,3,2
"11942",2021-03-11,"Cement Creek","w2021","Mechanized",3,"Thu","weekday","no_sled","Brush/Cement",NA,NA,NA,9.8,NA,40,1,22,24.5,2,0,0,-1,3,3,3,2
"11943",2021-03-11,"Cement Creek","w2021","Motorized",4,"Thu","weekday","sled","Brush/Cement",NA,NA,NA,9.8,NA,40,1,22,24.5,2,0,0,-1,3,3,3,2
"11944",2021-03-11,"Cement Creek","w2021","Hybrid",0,"Thu","weekday","sled","Brush/Cement",NA,NA,NA,9.8,NA,40,1,22,24.5,2,0,0,-1,3,3,3,2
"11945",2021-03-12,"Cement Creek","w2021","Non.motorized",25,"Fri","weekday","no_sled","Brush/Cement",NA,NA,NA,9.8,NA,39,-1,29,25.1,1,2,0,0,0,2,2,2
"11946",2021-03-12,"Cement Creek","w2021","Mechanized",1,"Fri","weekday","no_sled","Brush/Cement",NA,NA,NA,9.8,NA,39,-1,29,25.1,1,2,0,0,0,2,2,2
"11947",2021-03-12,"Cement Creek","w2021","Motorized",4,"Fri","weekday","sled","Brush/Cement",NA,NA,NA,9.8,NA,39,-1,29,25.1,1,2,0,0,0,2,2,2
"11948",2021-03-12,"Cement Creek","w2021","Hybrid",2,"Fri","weekday","sled","Brush/Cement",NA,NA,NA,9.8,NA,39,-1,29,25.1,1,2,0,0,0,2,2,2
"11949",2021-03-13,"Cement Creek","w2021","Non.motorized",27,"Sat","weekend","no_sled","Brush/Cement",NA,NA,NA,9.8,NA,38,-1,27,25.8,-1,1,2,0,-2,-1,1,1
"11950",2021-03-13,"Cement Creek","w2021","Mechanized",5,"Sat","weekend","no_sled","Brush/Cement",NA,NA,NA,9.8,NA,38,-1,27,25.8,-1,1,2,0,-2,-1,1,1
"11951",2021-03-13,"Cement Creek","w2021","Motorized",4,"Sat","weekend","sled","Brush/Cement",NA,NA,NA,9.8,NA,38,-1,27,25.8,-1,1,2,0,-2,-1,1,1
"11952",2021-03-13,"Cement Creek","w2021","Hybrid",0,"Sat","weekend","sled","Brush/Cement",NA,NA,NA,9.8,NA,38,-1,27,25.8,-1,1,2,0,-2,-1,1,1
"11953",2021-03-14,"Cement Creek","w2021","Non.motorized",49,"Sun","weekend","no_sled","Brush/Cement",NA,NA,NA,10.2,NA,42,4,23,24.3,-1,-1,1,2,3,2,3,5
"11954",2021-03-14,"Cement Creek","w2021","Mechanized",2,"Sun","weekend","no_sled","Brush/Cement",NA,NA,NA,10.2,NA,42,4,23,24.3,-1,-1,1,2,3,2,3,5
"11955",2021-03-14,"Cement Creek","w2021","Motorized",6,"Sun","weekend","sled","Brush/Cement",NA,NA,NA,10.2,NA,42,4,23,24.3,-1,-1,1,2,3,2,3,5
"11956",2021-03-14,"Cement Creek","w2021","Hybrid",0,"Sun","weekend","sled","Brush/Cement",NA,NA,NA,10.2,NA,42,4,23,24.3,-1,-1,1,2,3,2,3,5
"11957",2021-03-15,"Cement Creek","w2021","Non.motorized",13,"Mon","weekday","no_sled","Brush/Cement",NA,NA,NA,10.2,NA,41,-1,26,24.9,4,-1,-1,1,3,2,1,2
"11958",2021-03-15,"Cement Creek","w2021","Mechanized",0,"Mon","weekday","no_sled","Brush/Cement",NA,NA,NA,10.2,NA,41,-1,26,24.9,4,-1,-1,1,3,2,1,2
"11959",2021-03-15,"Cement Creek","w2021","Motorized",2,"Mon","weekday","sled","Brush/Cement",NA,NA,NA,10.2,NA,41,-1,26,24.9,4,-1,-1,1,3,2,1,2
"11960",2021-03-15,"Cement Creek","w2021","Hybrid",0,"Mon","weekday","sled","Brush/Cement",NA,NA,NA,10.2,NA,41,-1,26,24.9,4,-1,-1,1,3,2,1,2
"11961",2021-03-16,"Cement Creek","w2021","Non.motorized",16,"Tue","weekday","no_sled","Brush/Cement",NA,NA,NA,10.3,NA,40,-1,26,25.8,-1,4,-1,-1,-2,2,1,0
"11962",2021-03-16,"Cement Creek","w2021","Mechanized",1,"Tue","weekday","no_sled","Brush/Cement",NA,NA,NA,10.3,NA,40,-1,26,25.8,-1,4,-1,-1,-2,2,1,0
"11963",2021-03-16,"Cement Creek","w2021","Motorized",5,"Tue","weekday","sled","Brush/Cement",NA,NA,NA,10.3,NA,40,-1,26,25.8,-1,4,-1,-1,-2,2,1,0
"11964",2021-03-16,"Cement Creek","w2021","Hybrid",0,"Tue","weekday","sled","Brush/Cement",NA,NA,NA,10.3,NA,40,-1,26,25.8,-1,4,-1,-1,-2,2,1,0
"11965",2021-03-17,"Cement Creek","w2021","Non.motorized",25,"Wed","weekday","no_sled","Brush/Cement",NA,NA,NA,10.3,NA,41,1,25,25.1,-1,-1,4,-1,0,-1,3,2
"11966",2021-03-17,"Cement Creek","w2021","Mechanized",0,"Wed","weekday","no_sled","Brush/Cement",NA,NA,NA,10.3,NA,41,1,25,25.1,-1,-1,4,-1,0,-1,3,2
"11967",2021-03-17,"Cement Creek","w2021","Motorized",5,"Wed","weekday","sled","Brush/Cement",NA,NA,NA,10.3,NA,41,1,25,25.1,-1,-1,4,-1,0,-1,3,2
"11968",2021-03-17,"Cement Creek","w2021","Hybrid",0,"Wed","weekday","sled","Brush/Cement",NA,NA,NA,10.3,NA,41,1,25,25.1,-1,-1,4,-1,0,-1,3,2
"11969",2021-03-18,"Cement Creek","w2021","Non.motorized",18,"Thu","weekday","no_sled","Brush/Cement",NA,NA,NA,10.3,NA,40,-1,29,25.8,1,-1,-1,4,0,-1,-2,2
"11970",2021-03-18,"Cement Creek","w2021","Mechanized",2,"Thu","weekday","no_sled","Brush/Cement",NA,NA,NA,10.3,NA,40,-1,29,25.8,1,-1,-1,4,0,-1,-2,2
"11971",2021-03-18,"Cement Creek","w2021","Motorized",3,"Thu","weekday","sled","Brush/Cement",NA,NA,NA,10.3,NA,40,-1,29,25.8,1,-1,-1,4,0,-1,-2,2
"11972",2021-03-18,"Cement Creek","w2021","Hybrid",0,"Thu","weekday","sled","Brush/Cement",NA,NA,NA,10.3,NA,40,-1,29,25.8,1,-1,-1,4,0,-1,-2,2
"11973",2021-03-19,"Cement Creek","w2021","Non.motorized",27,"Fri","weekday","no_sled","Brush/Cement",NA,NA,NA,10.3,NA,40,0,36,25.8,-1,1,-1,-1,-1,0,-1,-2
"11974",2021-03-19,"Cement Creek","w2021","Mechanized",1,"Fri","weekday","no_sled","Brush/Cement",NA,NA,NA,10.3,NA,40,0,36,25.8,-1,1,-1,-1,-1,0,-1,-2
"11975",2021-03-19,"Cement Creek","w2021","Motorized",8,"Fri","weekday","sled","Brush/Cement",NA,NA,NA,10.3,NA,40,0,36,25.8,-1,1,-1,-1,-1,0,-1,-2
"11976",2021-03-19,"Cement Creek","w2021","Hybrid",2,"Fri","weekday","sled","Brush/Cement",NA,NA,NA,10.3,NA,40,0,36,25.8,-1,1,-1,-1,-1,0,-1,-2
"11977",2021-03-20,"Cement Creek","w2021","Non.motorized",35,"Sat","weekend","no_sled","Brush/Cement",NA,NA,NA,10.4,NA,39,-1,37,26.7,0,-1,1,-1,-1,-2,-1,-2
"11978",2021-03-20,"Cement Creek","w2021","Mechanized",0,"Sat","weekend","no_sled","Brush/Cement",NA,NA,NA,10.4,NA,39,-1,37,26.7,0,-1,1,-1,-1,-2,-1,-2
"11979",2021-03-20,"Cement Creek","w2021","Motorized",4,"Sat","weekend","sled","Brush/Cement",NA,NA,NA,10.4,NA,39,-1,37,26.7,0,-1,1,-1,-1,-2,-1,-2
"11980",2021-03-20,"Cement Creek","w2021","Hybrid",2,"Sat","weekend","sled","Brush/Cement",NA,NA,NA,10.4,NA,39,-1,37,26.7,0,-1,1,-1,-1,-2,-1,-2
"11981",2021-03-21,"Cement Creek","w2021","Non.motorized",48,"Sun","weekend","no_sled","Brush/Cement",NA,NA,NA,10.4,NA,38,-1,28,27.4,-1,0,-1,1,-2,-2,-3,-2
"11982",2021-03-21,"Cement Creek","w2021","Mechanized",0,"Sun","weekend","no_sled","Brush/Cement",NA,NA,NA,10.4,NA,38,-1,28,27.4,-1,0,-1,1,-2,-2,-3,-2
"11983",2021-03-21,"Cement Creek","w2021","Motorized",2,"Sun","weekend","sled","Brush/Cement",NA,NA,NA,10.4,NA,38,-1,28,27.4,-1,0,-1,1,-2,-2,-3,-2
"11984",2021-03-21,"Cement Creek","w2021","Hybrid",0,"Sun","weekend","sled","Brush/Cement",NA,NA,NA,10.4,NA,38,-1,28,27.4,-1,0,-1,1,-2,-2,-3,-2
"11985",2021-03-22,"Cement Creek","w2021","Non.motorized",30,"Mon","weekday","no_sled","Brush/Cement",NA,NA,NA,10.5,NA,41,3,26,25.6,-1,-1,0,-1,2,1,1,0
"11986",2021-03-22,"Cement Creek","w2021","Mechanized",0,"Mon","weekday","no_sled","Brush/Cement",NA,NA,NA,10.5,NA,41,3,26,25.6,-1,-1,0,-1,2,1,1,0
"11987",2021-03-22,"Cement Creek","w2021","Motorized",10,"Mon","weekday","sled","Brush/Cement",NA,NA,NA,10.5,NA,41,3,26,25.6,-1,-1,0,-1,2,1,1,0
"11988",2021-03-22,"Cement Creek","w2021","Hybrid",0,"Mon","weekday","sled","Brush/Cement",NA,NA,NA,10.5,NA,41,3,26,25.6,-1,-1,0,-1,2,1,1,0
"11989",2021-03-23,"Cement Creek","w2021","Non.motorized",27,"Tue","weekday","no_sled","Brush/Cement",NA,NA,NA,10.6,NA,41,0,24,25.9,3,-1,-1,0,3,2,1,1
"11990",2021-03-23,"Cement Creek","w2021","Mechanized",3,"Tue","weekday","no_sled","Brush/Cement",NA,NA,NA,10.6,NA,41,0,24,25.9,3,-1,-1,0,3,2,1,1
"11991",2021-03-23,"Cement Creek","w2021","Motorized",3,"Tue","weekday","sled","Brush/Cement",NA,NA,NA,10.6,NA,41,0,24,25.9,3,-1,-1,0,3,2,1,1
"11992",2021-03-23,"Cement Creek","w2021","Hybrid",2,"Tue","weekday","sled","Brush/Cement",NA,NA,NA,10.6,NA,41,0,24,25.9,3,-1,-1,0,3,2,1,1
"11993",2021-03-24,"Cement Creek","w2021","Non.motorized",31,"Wed","weekday","no_sled","Brush/Cement",NA,NA,NA,10.8,NA,41,0,24,26.3,0,3,-1,-1,0,3,2,1
"11994",2021-03-24,"Cement Creek","w2021","Mechanized",1,"Wed","weekday","no_sled","Brush/Cement",NA,NA,NA,10.8,NA,41,0,24,26.3,0,3,-1,-1,0,3,2,1
"11995",2021-03-24,"Cement Creek","w2021","Motorized",8,"Wed","weekday","sled","Brush/Cement",NA,NA,NA,10.8,NA,41,0,24,26.3,0,3,-1,-1,0,3,2,1
"11996",2021-03-24,"Cement Creek","w2021","Hybrid",0,"Wed","weekday","sled","Brush/Cement",NA,NA,NA,10.8,NA,41,0,24,26.3,0,3,-1,-1,0,3,2,1
"11997",2021-03-25,"Cement Creek","w2021","Non.motorized",16,"Thu","weekday","no_sled","Brush/Cement",NA,NA,NA,10.9,NA,43,2,23,25.3,0,0,3,-1,2,2,5,4
"11998",2021-03-25,"Cement Creek","w2021","Mechanized",2,"Thu","weekday","no_sled","Brush/Cement",NA,NA,NA,10.9,NA,43,2,23,25.3,0,0,3,-1,2,2,5,4
"11999",2021-03-25,"Cement Creek","w2021","Motorized",6,"Thu","weekday","sled","Brush/Cement",NA,NA,NA,10.9,NA,43,2,23,25.3,0,0,3,-1,2,2,5,4
"12000",2021-03-25,"Cement Creek","w2021","Hybrid",1,"Thu","weekday","sled","Brush/Cement",NA,NA,NA,10.9,NA,43,2,23,25.3,0,0,3,-1,2,2,5,4
"12001",2021-03-26,"Cement Creek","w2021","Non.motorized",11,"Fri","weekday","no_sled","Brush/Cement",NA,NA,NA,11,NA,44,1,23,25,2,0,0,3,3,3,3,6
"12002",2021-03-26,"Cement Creek","w2021","Mechanized",0,"Fri","weekday","no_sled","Brush/Cement",NA,NA,NA,11,NA,44,1,23,25,2,0,0,3,3,3,3,6
"12003",2021-03-26,"Cement Creek","w2021","Motorized",2,"Fri","weekday","sled","Brush/Cement",NA,NA,NA,11,NA,44,1,23,25,2,0,0,3,3,3,3,6
"12004",2021-03-26,"Cement Creek","w2021","Hybrid",0,"Fri","weekday","sled","Brush/Cement",NA,NA,NA,11,NA,44,1,23,25,2,0,0,3,3,3,3,6
"12005",2021-03-27,"Cement Creek","w2021","Non.motorized",46,"Sat","weekend","no_sled","Brush/Cement",NA,NA,NA,11,NA,42,-2,25,26.2,1,2,0,0,-1,1,1,1
"12006",2021-03-27,"Cement Creek","w2021","Mechanized",0,"Sat","weekend","no_sled","Brush/Cement",NA,NA,NA,11,NA,42,-2,25,26.2,1,2,0,0,-1,1,1,1
"12007",2021-03-27,"Cement Creek","w2021","Motorized",3,"Sat","weekend","sled","Brush/Cement",NA,NA,NA,11,NA,42,-2,25,26.2,1,2,0,0,-1,1,1,1
"12008",2021-03-27,"Cement Creek","w2021","Hybrid",0,"Sat","weekend","sled","Brush/Cement",NA,NA,NA,11,NA,42,-2,25,26.2,1,2,0,0,-1,1,1,1
"12009",2021-03-28,"Cement Creek","w2021","Non.motorized",39,"Sun","weekend","no_sled","Brush/Cement",NA,NA,NA,11,NA,42,0,31,26.2,-2,1,2,0,-2,-1,1,1
"12010",2021-03-28,"Cement Creek","w2021","Mechanized",1,"Sun","weekend","no_sled","Brush/Cement",NA,NA,NA,11,NA,42,0,31,26.2,-2,1,2,0,-2,-1,1,1
"12011",2021-03-28,"Cement Creek","w2021","Motorized",0,"Sun","weekend","sled","Brush/Cement",NA,NA,NA,11,NA,42,0,31,26.2,-2,1,2,0,-2,-1,1,1
"12012",2021-03-28,"Cement Creek","w2021","Hybrid",0,"Sun","weekend","sled","Brush/Cement",NA,NA,NA,11,NA,42,0,31,26.2,-2,1,2,0,-2,-1,1,1
"12013",2021-03-29,"Cement Creek","w2021","Non.motorized",11,"Mon","weekday","no_sled","Brush/Cement",NA,NA,NA,11.1,NA,40,-2,37,27.8,0,-2,1,2,-2,-4,-3,-1
"12014",2021-03-29,"Cement Creek","w2021","Mechanized",2,"Mon","weekday","no_sled","Brush/Cement",NA,NA,NA,11.1,NA,40,-2,37,27.8,0,-2,1,2,-2,-4,-3,-1
"12015",2021-03-29,"Cement Creek","w2021","Motorized",2,"Mon","weekday","sled","Brush/Cement",NA,NA,NA,11.1,NA,40,-2,37,27.8,0,-2,1,2,-2,-4,-3,-1
"12016",2021-03-29,"Cement Creek","w2021","Hybrid",0,"Mon","weekday","sled","Brush/Cement",NA,NA,NA,11.1,NA,40,-2,37,27.8,0,-2,1,2,-2,-4,-3,-1
"12017",2021-03-30,"Cement Creek","w2021","Non.motorized",16,"Tue","weekday","no_sled","Brush/Cement",NA,NA,NA,11.1,NA,39,-1,23,28.5,-2,0,-2,1,-3,-3,-5,-4
"12018",2021-03-30,"Cement Creek","w2021","Mechanized",1,"Tue","weekday","no_sled","Brush/Cement",NA,NA,NA,11.1,NA,39,-1,23,28.5,-2,0,-2,1,-3,-3,-5,-4
"12019",2021-03-30,"Cement Creek","w2021","Motorized",3,"Tue","weekday","sled","Brush/Cement",NA,NA,NA,11.1,NA,39,-1,23,28.5,-2,0,-2,1,-3,-3,-5,-4
"12020",2021-03-30,"Cement Creek","w2021","Hybrid",0,"Tue","weekday","sled","Brush/Cement",NA,NA,NA,11.1,NA,39,-1,23,28.5,-2,0,-2,1,-3,-3,-5,-4
"12021",2021-03-31,"Cement Creek","w2021","Non.motorized",19,"Wed","weekday","no_sled","Brush/Cement",NA,NA,NA,11.1,NA,39,0,26,28.5,-1,-2,0,-2,-1,-3,-3,-5
"12022",2021-03-31,"Cement Creek","w2021","Mechanized",0,"Wed","weekday","no_sled","Brush/Cement",NA,NA,NA,11.1,NA,39,0,26,28.5,-1,-2,0,-2,-1,-3,-3,-5
"12023",2021-03-31,"Cement Creek","w2021","Motorized",5,"Wed","weekday","sled","Brush/Cement",NA,NA,NA,11.1,NA,39,0,26,28.5,-1,-2,0,-2,-1,-3,-3,-5
"12024",2021-03-31,"Cement Creek","w2021","Hybrid",0,"Wed","weekday","sled","Brush/Cement",NA,NA,NA,11.1,NA,39,0,26,28.5,-1,-2,0,-2,-1,-3,-3,-5
"12025",2021-04-01,"Cement Creek","w2021","Non.motorized",20,"Thu","weekday","no_sled","Brush/Cement",NA,NA,NA,11.1,NA,38,-1,36,29.2,0,-1,-2,0,-1,-2,-4,-4
"12026",2021-04-01,"Cement Creek","w2021","Mechanized",1,"Thu","weekday","no_sled","Brush/Cement",NA,NA,NA,11.1,NA,38,-1,36,29.2,0,-1,-2,0,-1,-2,-4,-4
"12027",2021-04-01,"Cement Creek","w2021","Motorized",0,"Thu","weekday","sled","Brush/Cement",NA,NA,NA,11.1,NA,38,-1,36,29.2,0,-1,-2,0,-1,-2,-4,-4
"12028",2021-04-01,"Cement Creek","w2021","Hybrid",1,"Thu","weekday","sled","Brush/Cement",NA,NA,NA,11.1,NA,38,-1,36,29.2,0,-1,-2,0,-1,-2,-4,-4
"12029",2021-04-02,"Cement Creek","w2021","Non.motorized",11,"Fri","weekday","no_sled","Brush/Cement",NA,NA,NA,11.1,NA,37,-1,42,30,-1,0,-1,-2,-2,-2,-3,-5
"12030",2021-04-02,"Cement Creek","w2021","Mechanized",0,"Fri","weekday","no_sled","Brush/Cement",NA,NA,NA,11.1,NA,37,-1,42,30,-1,0,-1,-2,-2,-2,-3,-5
"12031",2021-04-02,"Cement Creek","w2021","Motorized",4,"Fri","weekday","sled","Brush/Cement",NA,NA,NA,11.1,NA,37,-1,42,30,-1,0,-1,-2,-2,-2,-3,-5
"12032",2021-04-02,"Cement Creek","w2021","Hybrid",0,"Fri","weekday","sled","Brush/Cement",NA,NA,NA,11.1,NA,37,-1,42,30,-1,0,-1,-2,-2,-2,-3,-5
"12033",2021-04-03,"Cement Creek","w2021","Non.motorized",21,"Sat","weekend","no_sled","Brush/Cement",NA,NA,NA,10.8,NA,35,-2,45,30.9,-1,-1,0,-1,-3,-4,-4,-5
"12034",2021-04-03,"Cement Creek","w2021","Mechanized",0,"Sat","weekend","no_sled","Brush/Cement",NA,NA,NA,10.8,NA,35,-2,45,30.9,-1,-1,0,-1,-3,-4,-4,-5
"12035",2021-04-03,"Cement Creek","w2021","Motorized",0,"Sat","weekend","sled","Brush/Cement",NA,NA,NA,10.8,NA,35,-2,45,30.9,-1,-1,0,-1,-3,-4,-4,-5
"12036",2021-04-03,"Cement Creek","w2021","Hybrid",0,"Sat","weekend","sled","Brush/Cement",NA,NA,NA,10.8,NA,35,-2,45,30.9,-1,-1,0,-1,-3,-4,-4,-5
"12037",2021-04-04,"Cement Creek","w2021","Non.motorized",20,"Sun","weekend","no_sled","Brush/Cement",NA,NA,NA,10.7,NA,34,-1,44,31.5,-2,-1,-1,0,-3,-4,-5,-5
"12038",2021-04-04,"Cement Creek","w2021","Mechanized",0,"Sun","weekend","no_sled","Brush/Cement",NA,NA,NA,10.7,NA,34,-1,44,31.5,-2,-1,-1,0,-3,-4,-5,-5
"12039",2021-04-04,"Cement Creek","w2021","Motorized",2,"Sun","weekend","sled","Brush/Cement",NA,NA,NA,10.7,NA,34,-1,44,31.5,-2,-1,-1,0,-3,-4,-5,-5
"12040",2021-04-04,"Cement Creek","w2021","Hybrid",0,"Sun","weekend","sled","Brush/Cement",NA,NA,NA,10.7,NA,34,-1,44,31.5,-2,-1,-1,0,-3,-4,-5,-5
"12041",2021-04-05,"Cement Creek","w2021","Non.motorized",8,"Mon","weekday","no_sled","Brush/Cement",NA,NA,NA,10.6,NA,33,-1,44,32.1,-1,-2,-1,-1,-2,-4,-5,-6
"12042",2021-04-05,"Cement Creek","w2021","Mechanized",0,"Mon","weekday","no_sled","Brush/Cement",NA,NA,NA,10.6,NA,33,-1,44,32.1,-1,-2,-1,-1,-2,-4,-5,-6
"12043",2021-04-05,"Cement Creek","w2021","Motorized",3,"Mon","weekday","sled","Brush/Cement",NA,NA,NA,10.6,NA,33,-1,44,32.1,-1,-2,-1,-1,-2,-4,-5,-6
"12044",2021-04-05,"Cement Creek","w2021","Hybrid",0,"Mon","weekday","sled","Brush/Cement",NA,NA,NA,10.6,NA,33,-1,44,32.1,-1,-2,-1,-1,-2,-4,-5,-6
"12045",2021-04-06,"Cement Creek","w2021","Non.motorized",6,"Tue","weekday","no_sled","Brush/Cement",NA,NA,NA,10.3,NA,31,-2,32,33.2,-1,-1,-2,-1,-3,-4,-6,-7
"12046",2021-04-06,"Cement Creek","w2021","Mechanized",0,"Tue","weekday","no_sled","Brush/Cement",NA,NA,NA,10.3,NA,31,-2,32,33.2,-1,-1,-2,-1,-3,-4,-6,-7
"12047",2021-04-06,"Cement Creek","w2021","Motorized",3,"Tue","weekday","sled","Brush/Cement",NA,NA,NA,10.3,NA,31,-2,32,33.2,-1,-1,-2,-1,-3,-4,-6,-7
"12048",2021-04-06,"Cement Creek","w2021","Hybrid",1,"Tue","weekday","sled","Brush/Cement",NA,NA,NA,10.3,NA,31,-2,32,33.2,-1,-1,-2,-1,-3,-4,-6,-7
"12049",2021-04-07,"Cement Creek","w2021","Non.motorized",5,"Wed","weekday","no_sled","Brush/Cement",NA,NA,NA,10,NA,31,0,33,32.3,-2,-1,-1,-2,-2,-3,-4,-6
"12050",2021-04-07,"Cement Creek","w2021","Mechanized",1,"Wed","weekday","no_sled","Brush/Cement",NA,NA,NA,10,NA,31,0,33,32.3,-2,-1,-1,-2,-2,-3,-4,-6
"12051",2021-04-07,"Cement Creek","w2021","Motorized",0,"Wed","weekday","sled","Brush/Cement",NA,NA,NA,10,NA,31,0,33,32.3,-2,-1,-1,-2,-2,-3,-4,-6
"12052",2021-04-07,"Cement Creek","w2021","Hybrid",0,"Wed","weekday","sled","Brush/Cement",NA,NA,NA,10,NA,31,0,33,32.3,-2,-1,-1,-2,-2,-3,-4,-6
"12053",2021-04-08,"Cement Creek","w2021","Non.motorized",9,"Thu","weekday","no_sled","Brush/Cement",NA,NA,NA,9.9,NA,29,-2,39,34.1,0,-2,-1,-1,-2,-4,-5,-6
"12054",2021-04-08,"Cement Creek","w2021","Mechanized",0,"Thu","weekday","no_sled","Brush/Cement",NA,NA,NA,9.9,NA,29,-2,39,34.1,0,-2,-1,-1,-2,-4,-5,-6
"12055",2021-04-08,"Cement Creek","w2021","Motorized",2,"Thu","weekday","sled","Brush/Cement",NA,NA,NA,9.9,NA,29,-2,39,34.1,0,-2,-1,-1,-2,-4,-5,-6
"12056",2021-04-08,"Cement Creek","w2021","Hybrid",1,"Thu","weekday","sled","Brush/Cement",NA,NA,NA,9.9,NA,29,-2,39,34.1,0,-2,-1,-1,-2,-4,-5,-6
"12057",2021-04-09,"Cement Creek","w2021","Non.motorized",13,"Fri","weekday","no_sled","Brush/Cement",NA,NA,NA,9.6,NA,28,-1,33,34.3,-2,0,-2,-1,-3,-3,-5,-6
"12058",2021-04-09,"Cement Creek","w2021","Mechanized",0,"Fri","weekday","no_sled","Brush/Cement",NA,NA,NA,9.6,NA,28,-1,33,34.3,-2,0,-2,-1,-3,-3,-5,-6
"12059",2021-04-09,"Cement Creek","w2021","Motorized",2,"Fri","weekday","sled","Brush/Cement",NA,NA,NA,9.6,NA,28,-1,33,34.3,-2,0,-2,-1,-3,-3,-5,-6
"12060",2021-04-09,"Cement Creek","w2021","Hybrid",1,"Fri","weekday","sled","Brush/Cement",NA,NA,NA,9.6,NA,28,-1,33,34.3,-2,0,-2,-1,-3,-3,-5,-6
"12061",2021-04-10,"Cement Creek","w2021","Non.motorized",18,"Sat","weekend","no_sled","Brush/Cement",NA,NA,NA,9.5,NA,26,-2,37,36.5,-1,-2,0,-2,-3,-5,-5,-7
"12062",2021-04-10,"Cement Creek","w2021","Mechanized",0,"Sat","weekend","no_sled","Brush/Cement",NA,NA,NA,9.5,NA,26,-2,37,36.5,-1,-2,0,-2,-3,-5,-5,-7
"12063",2021-04-10,"Cement Creek","w2021","Motorized",2,"Sat","weekend","sled","Brush/Cement",NA,NA,NA,9.5,NA,26,-2,37,36.5,-1,-2,0,-2,-3,-5,-5,-7
"12064",2021-04-10,"Cement Creek","w2021","Hybrid",0,"Sat","weekend","sled","Brush/Cement",NA,NA,NA,9.5,NA,26,-2,37,36.5,-1,-2,0,-2,-3,-5,-5,-7
"12065",2021-04-11,"Cement Creek","w2021","Non.motorized",19,"Sun","weekend","no_sled","Brush/Cement",NA,NA,NA,9.2,NA,26,0,39,35.4,-2,-1,-2,0,-2,-3,-5,-5
"12066",2021-04-11,"Cement Creek","w2021","Mechanized",2,"Sun","weekend","no_sled","Brush/Cement",NA,NA,NA,9.2,NA,26,0,39,35.4,-2,-1,-2,0,-2,-3,-5,-5
"12067",2021-04-11,"Cement Creek","w2021","Motorized",3,"Sun","weekend","sled","Brush/Cement",NA,NA,NA,9.2,NA,26,0,39,35.4,-2,-1,-2,0,-2,-3,-5,-5
"12068",2021-04-11,"Cement Creek","w2021","Hybrid",0,"Sun","weekend","sled","Brush/Cement",NA,NA,NA,9.2,NA,26,0,39,35.4,-2,-1,-2,0,-2,-3,-5,-5
"12069",2021-04-12,"Cement Creek","w2021","Non.motorized",5,"Mon","weekday","no_sled","Brush/Cement",NA,NA,NA,8.8,NA,24,-2,38,36.7,0,-2,-1,-2,-2,-4,-5,-7
"12070",2021-04-12,"Cement Creek","w2021","Mechanized",2,"Mon","weekday","no_sled","Brush/Cement",NA,NA,NA,8.8,NA,24,-2,38,36.7,0,-2,-1,-2,-2,-4,-5,-7
"12071",2021-04-12,"Cement Creek","w2021","Motorized",2,"Mon","weekday","sled","Brush/Cement",NA,NA,NA,8.8,NA,24,-2,38,36.7,0,-2,-1,-2,-2,-4,-5,-7
"12072",2021-04-12,"Cement Creek","w2021","Hybrid",0,"Mon","weekday","sled","Brush/Cement",NA,NA,NA,8.8,NA,24,-2,38,36.7,0,-2,-1,-2,-2,-4,-5,-7
"12073",2021-04-13,"Cement Creek","w2021","Non.motorized",8,"Tue","weekday","no_sled","Brush/Cement",NA,NA,NA,8.4,NA,23,-1,35,36.5,-2,0,-2,-1,-3,-3,-5,-6
"12074",2021-04-13,"Cement Creek","w2021","Mechanized",0,"Tue","weekday","no_sled","Brush/Cement",NA,NA,NA,8.4,NA,23,-1,35,36.5,-2,0,-2,-1,-3,-3,-5,-6
"12075",2021-04-13,"Cement Creek","w2021","Motorized",3,"Tue","weekday","sled","Brush/Cement",NA,NA,NA,8.4,NA,23,-1,35,36.5,-2,0,-2,-1,-3,-3,-5,-6
"12076",2021-04-13,"Cement Creek","w2021","Hybrid",2,"Tue","weekday","sled","Brush/Cement",NA,NA,NA,8.4,NA,23,-1,35,36.5,-2,0,-2,-1,-3,-3,-5,-6
"12077",2021-04-14,"Cement Creek","w2021","Non.motorized",8,"Wed","weekday","no_sled","Brush/Cement",NA,NA,NA,8.4,NA,23,0,41,36.5,-1,-2,0,-2,-1,-3,-3,-5
"12078",2021-04-14,"Cement Creek","w2021","Mechanized",0,"Wed","weekday","no_sled","Brush/Cement",NA,NA,NA,8.4,NA,23,0,41,36.5,-1,-2,0,-2,-1,-3,-3,-5
"12079",2021-04-14,"Cement Creek","w2021","Motorized",4,"Wed","weekday","sled","Brush/Cement",NA,NA,NA,8.4,NA,23,0,41,36.5,-1,-2,0,-2,-1,-3,-3,-5
"12080",2021-04-14,"Cement Creek","w2021","Hybrid",0,"Wed","weekday","sled","Brush/Cement",NA,NA,NA,8.4,NA,23,0,41,36.5,-1,-2,0,-2,-1,-3,-3,-5
"12081",2021-04-15,"Cement Creek","w2021","Non.motorized",9,"Thu","weekday","no_sled","Brush/Cement",NA,NA,NA,8.1,NA,22,-1,33,36.8,0,-1,-2,0,-1,-2,-4,-4
"12082",2021-04-15,"Cement Creek","w2021","Mechanized",2,"Thu","weekday","no_sled","Brush/Cement",NA,NA,NA,8.1,NA,22,-1,33,36.8,0,-1,-2,0,-1,-2,-4,-4
"12083",2021-04-15,"Cement Creek","w2021","Motorized",6,"Thu","weekday","sled","Brush/Cement",NA,NA,NA,8.1,NA,22,-1,33,36.8,0,-1,-2,0,-1,-2,-4,-4
"12084",2021-04-15,"Cement Creek","w2021","Hybrid",0,"Thu","weekday","sled","Brush/Cement",NA,NA,NA,8.1,NA,22,-1,33,36.8,0,-1,-2,0,-1,-2,-4,-4
"12085",2020-12-03,"Gothic Rd","w2021","Non.motorized",1,"Thu","weekday","no_sled","East River",NA,NA,NA,NA,NA,NA,NA,NA,NA,NA,NA,NA,NA,NA,NA,NA,NA
"12086",2020-12-03,"Gothic Rd","w2021","Mechanized",1,"Thu","weekday","no_sled","East River",NA,NA,NA,NA,NA,NA,NA,NA,NA,NA,NA,NA,NA,NA,NA,NA,NA
"12087",2020-12-03,"Gothic Rd","w2021","Motorized",0,"Thu","weekday","sled","East River",NA,NA,NA,NA,NA,NA,NA,NA,NA,NA,NA,NA,NA,NA,NA,NA,NA
"12088",2020-12-03,"Gothic Rd","w2021","Hybrid",0,"Thu","weekday","sled","East River",NA,NA,NA,NA,NA,NA,NA,NA,NA,NA,NA,NA,NA,NA,NA,NA,NA
"12089",2020-12-04,"Gothic Rd","w2021","Non.motorized",22,"Fri","weekday","no_sled","East River",NA,NA,NA,2.4,NA,11,0,29,21.8,0,0,0,0,0,0,0,0
"12090",2020-12-04,"Gothic Rd","w2021","Mechanized",1,"Fri","weekday","no_sled","East River",NA,NA,NA,2.4,NA,11,0,29,21.8,0,0,0,0,0,0,0,0
"12091",2020-12-04,"Gothic Rd","w2021","Motorized",0,"Fri","weekday","sled","East River",NA,NA,NA,2.4,NA,11,0,29,21.8,0,0,0,0,0,0,0,0
"12092",2020-12-04,"Gothic Rd","w2021","Hybrid",0,"Fri","weekday","sled","East River",NA,NA,NA,2.4,NA,11,0,29,21.8,0,0,0,0,0,0,0,0
"12093",2020-12-05,"Gothic Rd","w2021","Non.motorized",48,"Sat","weekend","no_sled","East River",NA,NA,NA,2.5,NA,11,0,32,22.7,0,0,0,0,0,0,0,0
"12094",2020-12-05,"Gothic Rd","w2021","Mechanized",1,"Sat","weekend","no_sled","East River",NA,NA,NA,2.5,NA,11,0,32,22.7,0,0,0,0,0,0,0,0
"12095",2020-12-05,"Gothic Rd","w2021","Motorized",0,"Sat","weekend","sled","East River",NA,NA,NA,2.5,NA,11,0,32,22.7,0,0,0,0,0,0,0,0
"12096",2020-12-05,"Gothic Rd","w2021","Hybrid",0,"Sat","weekend","sled","East River",NA,NA,NA,2.5,NA,11,0,32,22.7,0,0,0,0,0,0,0,0
"12097",2020-12-06,"Gothic Rd","w2021","Non.motorized",30,"Sun","weekend","no_sled","East River",NA,NA,NA,2.5,NA,11,0,30,22.7,0,0,0,0,0,0,0,0
"12098",2020-12-06,"Gothic Rd","w2021","Mechanized",3,"Sun","weekend","no_sled","East River",NA,NA,NA,2.5,NA,11,0,30,22.7,0,0,0,0,0,0,0,0
"12099",2020-12-06,"Gothic Rd","w2021","Motorized",0,"Sun","weekend","sled","East River",NA,NA,NA,2.5,NA,11,0,30,22.7,0,0,0,0,0,0,0,0
"12100",2020-12-06,"Gothic Rd","w2021","Hybrid",0,"Sun","weekend","sled","East River",NA,NA,NA,2.5,NA,11,0,30,22.7,0,0,0,0,0,0,0,0
"12101",2020-12-07,"Gothic Rd","w2021","Non.motorized",29,"Mon","weekday","no_sled","East River",NA,NA,NA,2.5,NA,11,0,33,22.7,0,0,0,0,0,0,0,0
"12102",2020-12-07,"Gothic Rd","w2021","Mechanized",1,"Mon","weekday","no_sled","East River",NA,NA,NA,2.5,NA,11,0,33,22.7,0,0,0,0,0,0,0,0
"12103",2020-12-07,"Gothic Rd","w2021","Motorized",0,"Mon","weekday","sled","East River",NA,NA,NA,2.5,NA,11,0,33,22.7,0,0,0,0,0,0,0,0
"12104",2020-12-07,"Gothic Rd","w2021","Hybrid",0,"Mon","weekday","sled","East River",NA,NA,NA,2.5,NA,11,0,33,22.7,0,0,0,0,0,0,0,0
"12105",2020-12-08,"Gothic Rd","w2021","Non.motorized",22,"Tue","weekday","no_sled","East River",NA,NA,NA,2.5,NA,11,0,34,22.7,0,0,0,0,0,0,0,0
"12106",2020-12-08,"Gothic Rd","w2021","Mechanized",2,"Tue","weekday","no_sled","East River",NA,NA,NA,2.5,NA,11,0,34,22.7,0,0,0,0,0,0,0,0
"12107",2020-12-08,"Gothic Rd","w2021","Motorized",0,"Tue","weekday","sled","East River",NA,NA,NA,2.5,NA,11,0,34,22.7,0,0,0,0,0,0,0,0
"12108",2020-12-08,"Gothic Rd","w2021","Hybrid",0,"Tue","weekday","sled","East River",NA,NA,NA,2.5,NA,11,0,34,22.7,0,0,0,0,0,0,0,0
"12109",2020-12-09,"Gothic Rd","w2021","Non.motorized",25,"Wed","weekday","no_sled","East River",NA,NA,NA,2.5,NA,11,0,32,22.7,0,0,0,0,0,0,0,0
"12110",2020-12-09,"Gothic Rd","w2021","Mechanized",2,"Wed","weekday","no_sled","East River",NA,NA,NA,2.5,NA,11,0,32,22.7,0,0,0,0,0,0,0,0
"12111",2020-12-09,"Gothic Rd","w2021","Motorized",0,"Wed","weekday","sled","East River",NA,NA,NA,2.5,NA,11,0,32,22.7,0,0,0,0,0,0,0,0
"12112",2020-12-09,"Gothic Rd","w2021","Hybrid",0,"Wed","weekday","sled","East River",NA,NA,NA,2.5,NA,11,0,32,22.7,0,0,0,0,0,0,0,0
"12113",2020-12-10,"Gothic Rd","w2021","Non.motorized",12,"Thu","weekday","no_sled","East River",NA,NA,NA,2.5,NA,11,0,28,22.7,0,0,0,0,0,0,0,0
"12114",2020-12-10,"Gothic Rd","w2021","Mechanized",5,"Thu","weekday","no_sled","East River",NA,NA,NA,2.5,NA,11,0,28,22.7,0,0,0,0,0,0,0,0
"12115",2020-12-10,"Gothic Rd","w2021","Motorized",0,"Thu","weekday","sled","East River",NA,NA,NA,2.5,NA,11,0,28,22.7,0,0,0,0,0,0,0,0
"12116",2020-12-10,"Gothic Rd","w2021","Hybrid",0,"Thu","weekday","sled","East River",NA,NA,NA,2.5,NA,11,0,28,22.7,0,0,0,0,0,0,0,0
"12117",2020-12-11,"Gothic Rd","w2021","Non.motorized",NA,"Fri","weekday","no_sled","East River",NA,NA,NA,2.6,NA,12,1,20,21.7,0,0,0,0,1,1,1,1
"12118",2020-12-11,"Gothic Rd","w2021","Mechanized",NA,"Fri","weekday","no_sled","East River",NA,NA,NA,2.6,NA,12,1,20,21.7,0,0,0,0,1,1,1,1
"12119",2020-12-11,"Gothic Rd","w2021","Motorized",NA,"Fri","weekday","sled","East River",NA,NA,NA,2.6,NA,12,1,20,21.7,0,0,0,0,1,1,1,1
"12120",2020-12-11,"Gothic Rd","w2021","Hybrid",NA,"Fri","weekday","sled","East River",NA,NA,NA,2.6,NA,12,1,20,21.7,0,0,0,0,1,1,1,1
"12121",2020-12-12,"Gothic Rd","w2021","Non.motorized",63,"Sat","weekend","no_sled","East River",NA,NA,NA,2.9,NA,17,5,12,17.1,1,0,0,0,6,6,6,6
"12122",2020-12-12,"Gothic Rd","w2021","Mechanized",2,"Sat","weekend","no_sled","East River",NA,NA,NA,2.9,NA,17,5,12,17.1,1,0,0,0,6,6,6,6
"12123",2020-12-12,"Gothic Rd","w2021","Motorized",0,"Sat","weekend","sled","East River",NA,NA,NA,2.9,NA,17,5,12,17.1,1,0,0,0,6,6,6,6
"12124",2020-12-12,"Gothic Rd","w2021","Hybrid",0,"Sat","weekend","sled","East River",NA,NA,NA,2.9,NA,17,5,12,17.1,1,0,0,0,6,6,6,6
"12125",2020-12-13,"Gothic Rd","w2021","Non.motorized",12,"Sun","weekend","no_sled","East River",NA,NA,NA,3.3,NA,19,2,10,17.4,5,1,0,0,7,8,8,8
"12126",2020-12-13,"Gothic Rd","w2021","Mechanized",0,"Sun","weekend","no_sled","East River",NA,NA,NA,3.3,NA,19,2,10,17.4,5,1,0,0,7,8,8,8
"12127",2020-12-13,"Gothic Rd","w2021","Motorized",0,"Sun","weekend","sled","East River",NA,NA,NA,3.3,NA,19,2,10,17.4,5,1,0,0,7,8,8,8
"12128",2020-12-13,"Gothic Rd","w2021","Hybrid",0,"Sun","weekend","sled","East River",NA,NA,NA,3.3,NA,19,2,10,17.4,5,1,0,0,7,8,8,8
"12129",2020-12-14,"Gothic Rd","w2021","Non.motorized",6,"Mon","weekday","no_sled","East River",NA,NA,NA,3.3,NA,18,-1,18,18.3,2,5,1,0,1,6,7,7
"12130",2020-12-14,"Gothic Rd","w2021","Mechanized",0,"Mon","weekday","no_sled","East River",NA,NA,NA,3.3,NA,18,-1,18,18.3,2,5,1,0,1,6,7,7
"12131",2020-12-14,"Gothic Rd","w2021","Motorized",3,"Mon","weekday","sled","East River",NA,NA,NA,3.3,NA,18,-1,18,18.3,2,5,1,0,1,6,7,7
"12132",2020-12-14,"Gothic Rd","w2021","Hybrid",4,"Mon","weekday","sled","East River",NA,NA,NA,3.3,NA,18,-1,18,18.3,2,5,1,0,1,6,7,7
"12133",2020-12-15,"Gothic Rd","w2021","Non.motorized",23,"Tue","weekday","no_sled","East River",NA,NA,NA,3.5,NA,19,1,13,18.4,-1,2,5,1,0,2,7,8
"12134",2020-12-15,"Gothic Rd","w2021","Mechanized",1,"Tue","weekday","no_sled","East River",NA,NA,NA,3.5,NA,19,1,13,18.4,-1,2,5,1,0,2,7,8
"12135",2020-12-15,"Gothic Rd","w2021","Motorized",2,"Tue","weekday","sled","East River",NA,NA,NA,3.5,NA,19,1,13,18.4,-1,2,5,1,0,2,7,8
"12136",2020-12-15,"Gothic Rd","w2021","Hybrid",0,"Tue","weekday","sled","East River",NA,NA,NA,3.5,NA,19,1,13,18.4,-1,2,5,1,0,2,7,8
"12137",2020-12-16,"Gothic Rd","w2021","Non.motorized",24,"Wed","weekday","no_sled","East River",NA,NA,NA,3.5,NA,19,0,16,18.4,1,-1,2,5,1,0,2,7
"12138",2020-12-16,"Gothic Rd","w2021","Mechanized",1,"Wed","weekday","no_sled","East River",NA,NA,NA,3.5,NA,19,0,16,18.4,1,-1,2,5,1,0,2,7
"12139",2020-12-16,"Gothic Rd","w2021","Motorized",0,"Wed","weekday","sled","East River",NA,NA,NA,3.5,NA,19,0,16,18.4,1,-1,2,5,1,0,2,7
"12140",2020-12-16,"Gothic Rd","w2021","Hybrid",0,"Wed","weekday","sled","East River",NA,NA,NA,3.5,NA,19,0,16,18.4,1,-1,2,5,1,0,2,7
"12141",2020-12-17,"Gothic Rd","w2021","Non.motorized",36,"Thu","weekday","no_sled","East River",NA,NA,NA,3.5,NA,19,0,20,18.4,0,1,-1,2,0,1,0,2
"12142",2020-12-17,"Gothic Rd","w2021","Mechanized",1,"Thu","weekday","no_sled","East River",NA,NA,NA,3.5,NA,19,0,20,18.4,0,1,-1,2,0,1,0,2
"12143",2020-12-17,"Gothic Rd","w2021","Motorized",1,"Thu","weekday","sled","East River",NA,NA,NA,3.5,NA,19,0,20,18.4,0,1,-1,2,0,1,0,2
"12144",2020-12-17,"Gothic Rd","w2021","Hybrid",0,"Thu","weekday","sled","East River",NA,NA,NA,3.5,NA,19,0,20,18.4,0,1,-1,2,0,1,0,2
"12145",2020-12-18,"Gothic Rd","w2021","Non.motorized",39,"Fri","weekday","no_sled","East River",NA,NA,NA,3.8,NA,22,3,20,17.3,0,0,1,-1,3,3,4,3
"12146",2020-12-18,"Gothic Rd","w2021","Mechanized",5,"Fri","weekday","no_sled","East River",NA,NA,NA,3.8,NA,22,3,20,17.3,0,0,1,-1,3,3,4,3
"12147",2020-12-18,"Gothic Rd","w2021","Motorized",1,"Fri","weekday","sled","East River",NA,NA,NA,3.8,NA,22,3,20,17.3,0,0,1,-1,3,3,4,3
"12148",2020-12-18,"Gothic Rd","w2021","Hybrid",0,"Fri","weekday","sled","East River",NA,NA,NA,3.8,NA,22,3,20,17.3,0,0,1,-1,3,3,4,3
"12149",2020-12-19,"Gothic Rd","w2021","Non.motorized",78,"Sat","weekend","no_sled","East River",NA,NA,NA,3.9,NA,22,0,17,17.7,3,0,0,1,3,3,3,4
"12150",2020-12-19,"Gothic Rd","w2021","Mechanized",5,"Sat","weekend","no_sled","East River",NA,NA,NA,3.9,NA,22,0,17,17.7,3,0,0,1,3,3,3,4
"12151",2020-12-19,"Gothic Rd","w2021","Motorized",0,"Sat","weekend","sled","East River",NA,NA,NA,3.9,NA,22,0,17,17.7,3,0,0,1,3,3,3,4
"12152",2020-12-19,"Gothic Rd","w2021","Hybrid",0,"Sat","weekend","sled","East River",NA,NA,NA,3.9,NA,22,0,17,17.7,3,0,0,1,3,3,3,4
"12153",2020-12-20,"Gothic Rd","w2021","Non.motorized",37,"Sun","weekend","no_sled","East River",NA,NA,NA,3.9,NA,21,-1,26,18.6,0,3,0,0,-1,2,2,2
"12154",2020-12-20,"Gothic Rd","w2021","Mechanized",1,"Sun","weekend","no_sled","East River",NA,NA,NA,3.9,NA,21,-1,26,18.6,0,3,0,0,-1,2,2,2
"12155",2020-12-20,"Gothic Rd","w2021","Motorized",0,"Sun","weekend","sled","East River",NA,NA,NA,3.9,NA,21,-1,26,18.6,0,3,0,0,-1,2,2,2
"12156",2020-12-20,"Gothic Rd","w2021","Hybrid",0,"Sun","weekend","sled","East River",NA,NA,NA,3.9,NA,21,-1,26,18.6,0,3,0,0,-1,2,2,2
"12157",2020-12-21,"Gothic Rd","w2021","Non.motorized",10,"Mon","weekday","no_sled","East River",NA,NA,NA,3.9,NA,20,-1,28,19.5,-1,0,3,0,-2,-2,1,1
"12158",2020-12-21,"Gothic Rd","w2021","Mechanized",1,"Mon","weekday","no_sled","East River",NA,NA,NA,3.9,NA,20,-1,28,19.5,-1,0,3,0,-2,-2,1,1
"12159",2020-12-21,"Gothic Rd","w2021","Motorized",0,"Mon","weekday","sled","East River",NA,NA,NA,3.9,NA,20,-1,28,19.5,-1,0,3,0,-2,-2,1,1
"12160",2020-12-21,"Gothic Rd","w2021","Hybrid",0,"Mon","weekday","sled","East River",NA,NA,NA,3.9,NA,20,-1,28,19.5,-1,0,3,0,-2,-2,1,1
"12161",2020-12-22,"Gothic Rd","w2021","Non.motorized",NA,"Tue","weekday","no_sled","East River",NA,NA,NA,4,NA,20,0,24,20,-1,-1,0,3,-1,-2,-2,1
"12162",2020-12-22,"Gothic Rd","w2021","Mechanized",NA,"Tue","weekday","no_sled","East River",NA,NA,NA,4,NA,20,0,24,20,-1,-1,0,3,-1,-2,-2,1
"12163",2020-12-22,"Gothic Rd","w2021","Motorized",NA,"Tue","weekday","sled","East River",NA,NA,NA,4,NA,20,0,24,20,-1,-1,0,3,-1,-2,-2,1
"12164",2020-12-22,"Gothic Rd","w2021","Hybrid",NA,"Tue","weekday","sled","East River",NA,NA,NA,4,NA,20,0,24,20,-1,-1,0,3,-1,-2,-2,1
"12165",2020-12-23,"Gothic Rd","w2021","Non.motorized",21,"Wed","weekday","no_sled","East River",NA,NA,NA,4.1,NA,22,2,6,18.6,0,-1,-1,0,2,1,0,0
"12166",2020-12-23,"Gothic Rd","w2021","Mechanized",3,"Wed","weekday","no_sled","East River",NA,NA,NA,4.1,NA,22,2,6,18.6,0,-1,-1,0,2,1,0,0
"12167",2020-12-23,"Gothic Rd","w2021","Motorized",0,"Wed","weekday","sled","East River",NA,NA,NA,4.1,NA,22,2,6,18.6,0,-1,-1,0,2,1,0,0
"12168",2020-12-23,"Gothic Rd","w2021","Hybrid",0,"Wed","weekday","sled","East River",NA,NA,NA,4.1,NA,22,2,6,18.6,0,-1,-1,0,2,1,0,0
"12169",2020-12-24,"Gothic Rd","w2021","Non.motorized",54,"Thu","weekday","no_sled","East River",NA,NA,NA,4.1,NA,21,-1,15,19.5,2,0,-1,-1,1,1,0,-1
"12170",2020-12-24,"Gothic Rd","w2021","Mechanized",3,"Thu","weekday","no_sled","East River",NA,NA,NA,4.1,NA,21,-1,15,19.5,2,0,-1,-1,1,1,0,-1
"12171",2020-12-24,"Gothic Rd","w2021","Motorized",0,"Thu","weekday","sled","East River",NA,NA,NA,4.1,NA,21,-1,15,19.5,2,0,-1,-1,1,1,0,-1
"12172",2020-12-24,"Gothic Rd","w2021","Hybrid",0,"Thu","weekday","sled","East River",NA,NA,NA,4.1,NA,21,-1,15,19.5,2,0,-1,-1,1,1,0,-1
"12173",2020-12-25,"Gothic Rd","w2021","Non.motorized",41,"Fri","weekday","no_sled","East River",NA,NA,NA,4.1,NA,20,-1,25,20.5,-1,2,0,-1,-2,0,0,-1
"12174",2020-12-25,"Gothic Rd","w2021","Mechanized",4,"Fri","weekday","no_sled","East River",NA,NA,NA,4.1,NA,20,-1,25,20.5,-1,2,0,-1,-2,0,0,-1
"12175",2020-12-25,"Gothic Rd","w2021","Motorized",0,"Fri","weekday","sled","East River",NA,NA,NA,4.1,NA,20,-1,25,20.5,-1,2,0,-1,-2,0,0,-1
"12176",2020-12-25,"Gothic Rd","w2021","Hybrid",0,"Fri","weekday","sled","East River",NA,NA,NA,4.1,NA,20,-1,25,20.5,-1,2,0,-1,-2,0,0,-1
"12177",2020-12-26,"Gothic Rd","w2021","Non.motorized",53,"Sat","weekend","no_sled","East River",NA,NA,NA,4.1,NA,20,0,26,20.5,-1,-1,2,0,-1,-2,0,0
"12178",2020-12-26,"Gothic Rd","w2021","Mechanized",2,"Sat","weekend","no_sled","East River",NA,NA,NA,4.1,NA,20,0,26,20.5,-1,-1,2,0,-1,-2,0,0
"12179",2020-12-26,"Gothic Rd","w2021","Motorized",0,"Sat","weekend","sled","East River",NA,NA,NA,4.1,NA,20,0,26,20.5,-1,-1,2,0,-1,-2,0,0
"12180",2020-12-26,"Gothic Rd","w2021","Hybrid",0,"Sat","weekend","sled","East River",NA,NA,NA,4.1,NA,20,0,26,20.5,-1,-1,2,0,-1,-2,0,0
"12181",2020-12-27,"Gothic Rd","w2021","Non.motorized",31,"Sun","weekend","no_sled","East River",NA,NA,NA,4.2,NA,19,-1,19,22.1,0,-1,-1,2,-1,-2,-3,-1
"12182",2020-12-27,"Gothic Rd","w2021","Mechanized",0,"Sun","weekend","no_sled","East River",NA,NA,NA,4.2,NA,19,-1,19,22.1,0,-1,-1,2,-1,-2,-3,-1
"12183",2020-12-27,"Gothic Rd","w2021","Motorized",0,"Sun","weekend","sled","East River",NA,NA,NA,4.2,NA,19,-1,19,22.1,0,-1,-1,2,-1,-2,-3,-1
"12184",2020-12-27,"Gothic Rd","w2021","Hybrid",0,"Sun","weekend","sled","East River",NA,NA,NA,4.2,NA,19,-1,19,22.1,0,-1,-1,2,-1,-2,-3,-1
"12185",2020-12-28,"Gothic Rd","w2021","Non.motorized",23,"Mon","weekday","no_sled","East River",NA,NA,NA,4.2,NA,20,1,22,21,-1,0,-1,-1,0,0,-1,-2
"12186",2020-12-28,"Gothic Rd","w2021","Mechanized",2,"Mon","weekday","no_sled","East River",NA,NA,NA,4.2,NA,20,1,22,21,-1,0,-1,-1,0,0,-1,-2
"12187",2020-12-28,"Gothic Rd","w2021","Motorized",0,"Mon","weekday","sled","East River",NA,NA,NA,4.2,NA,20,1,22,21,-1,0,-1,-1,0,0,-1,-2
"12188",2020-12-28,"Gothic Rd","w2021","Hybrid",0,"Mon","weekday","sled","East River",NA,NA,NA,4.2,NA,20,1,22,21,-1,0,-1,-1,0,0,-1,-2
"12189",2020-12-29,"Gothic Rd","w2021","Non.motorized",29,"Tue","weekday","no_sled","East River",NA,NA,NA,4.9,NA,27,7,15,18.1,1,-1,0,-1,8,7,7,6
"12190",2020-12-29,"Gothic Rd","w2021","Mechanized",3,"Tue","weekday","no_sled","East River",NA,NA,NA,4.9,NA,27,7,15,18.1,1,-1,0,-1,8,7,7,6
"12191",2020-12-29,"Gothic Rd","w2021","Motorized",1,"Tue","weekday","sled","East River",NA,NA,NA,4.9,NA,27,7,15,18.1,1,-1,0,-1,8,7,7,6
"12192",2020-12-29,"Gothic Rd","w2021","Hybrid",0,"Tue","weekday","sled","East River",NA,NA,NA,4.9,NA,27,7,15,18.1,1,-1,0,-1,8,7,7,6
"12193",2021-12-30,"Gothic Rd","w2021","Non.motorized",72,"Thu","weekday","no_sled","East River",NA,NA,NA,NA,NA,NA,NA,NA,NA,NA,NA,NA,NA,NA,NA,NA,NA
"12194",2021-12-30,"Gothic Rd","w2021","Mechanized",0,"Thu","weekday","no_sled","East River",NA,NA,NA,NA,NA,NA,NA,NA,NA,NA,NA,NA,NA,NA,NA,NA,NA
"12195",2021-12-30,"Gothic Rd","w2021","Motorized",0,"Thu","weekday","sled","East River",NA,NA,NA,NA,NA,NA,NA,NA,NA,NA,NA,NA,NA,NA,NA,NA,NA
"12196",2021-12-30,"Gothic Rd","w2021","Hybrid",0,"Thu","weekday","sled","East River",NA,NA,NA,NA,NA,NA,NA,NA,NA,NA,NA,NA,NA,NA,NA,NA,NA
"12197",2020-12-31,"Gothic Rd","w2021","Non.motorized",70,"Thu","weekday","no_sled","East River",NA,NA,NA,4.9,NA,25,-1,19,19.6,-1,7,1,-1,-2,5,6,5
"12198",2020-12-31,"Gothic Rd","w2021","Mechanized",6,"Thu","weekday","no_sled","East River",NA,NA,NA,4.9,NA,25,-1,19,19.6,-1,7,1,-1,-2,5,6,5
"12199",2020-12-31,"Gothic Rd","w2021","Motorized",0,"Thu","weekday","sled","East River",NA,NA,NA,4.9,NA,25,-1,19,19.6,-1,7,1,-1,-2,5,6,5
"12200",2020-12-31,"Gothic Rd","w2021","Hybrid",0,"Thu","weekday","sled","East River",NA,NA,NA,4.9,NA,25,-1,19,19.6,-1,7,1,-1,-2,5,6,5
"12201",2021-01-01,"Gothic Rd","w2021","Non.motorized",69,"Fri","weekday","no_sled","East River",NA,NA,NA,4.9,NA,24,-1,21,20.4,-1,-1,7,1,-2,-3,4,5
"12202",2021-01-01,"Gothic Rd","w2021","Mechanized",6,"Fri","weekday","no_sled","East River",NA,NA,NA,4.9,NA,24,-1,21,20.4,-1,-1,7,1,-2,-3,4,5
"12203",2021-01-01,"Gothic Rd","w2021","Motorized",0,"Fri","weekday","sled","East River",NA,NA,NA,4.9,NA,24,-1,21,20.4,-1,-1,7,1,-2,-3,4,5
"12204",2021-01-01,"Gothic Rd","w2021","Hybrid",0,"Fri","weekday","sled","East River",NA,NA,NA,4.9,NA,24,-1,21,20.4,-1,-1,7,1,-2,-3,4,5
"12205",2021-01-02,"Gothic Rd","w2021","Non.motorized",50,"Sat","weekend","no_sled","East River",NA,NA,NA,4.9,NA,23,-1,19,21.3,-1,-1,-1,7,-2,-3,-4,3
"12206",2021-01-02,"Gothic Rd","w2021","Mechanized",3,"Sat","weekend","no_sled","East River",NA,NA,NA,4.9,NA,23,-1,19,21.3,-1,-1,-1,7,-2,-3,-4,3
"12207",2021-01-02,"Gothic Rd","w2021","Motorized",0,"Sat","weekend","sled","East River",NA,NA,NA,4.9,NA,23,-1,19,21.3,-1,-1,-1,7,-2,-3,-4,3
"12208",2021-01-02,"Gothic Rd","w2021","Hybrid",0,"Sat","weekend","sled","East River",NA,NA,NA,4.9,NA,23,-1,19,21.3,-1,-1,-1,7,-2,-3,-4,3
"12209",2021-01-03,"Gothic Rd","w2021","Non.motorized",39,"Sun","weekend","no_sled","East River",NA,NA,NA,4.9,NA,23,0,21,21.3,-1,-1,-1,-1,-1,-2,-3,-4
"12210",2021-01-03,"Gothic Rd","w2021","Mechanized",2,"Sun","weekend","no_sled","East River",NA,NA,NA,4.9,NA,23,0,21,21.3,-1,-1,-1,-1,-1,-2,-3,-4
"12211",2021-01-03,"Gothic Rd","w2021","Motorized",0,"Sun","weekend","sled","East River",NA,NA,NA,4.9,NA,23,0,21,21.3,-1,-1,-1,-1,-1,-2,-3,-4
"12212",2021-01-03,"Gothic Rd","w2021","Hybrid",0,"Sun","weekend","sled","East River",NA,NA,NA,4.9,NA,23,0,21,21.3,-1,-1,-1,-1,-1,-2,-3,-4
"12213",2021-01-04,"Gothic Rd","w2021","Non.motorized",NA,"Mon","weekday","no_sled","East River",NA,NA,NA,4.9,NA,22,-1,25,22.3,0,-1,-1,-1,-1,-2,-3,-4
"12214",2021-01-04,"Gothic Rd","w2021","Mechanized",NA,"Mon","weekday","no_sled","East River",NA,NA,NA,4.9,NA,22,-1,25,22.3,0,-1,-1,-1,-1,-2,-3,-4
"12215",2021-01-04,"Gothic Rd","w2021","Motorized",NA,"Mon","weekday","sled","East River",NA,NA,NA,4.9,NA,22,-1,25,22.3,0,-1,-1,-1,-1,-2,-3,-4
"12216",2021-01-04,"Gothic Rd","w2021","Hybrid",NA,"Mon","weekday","sled","East River",NA,NA,NA,4.9,NA,22,-1,25,22.3,0,-1,-1,-1,-1,-2,-3,-4
"12217",2021-01-05,"Gothic Rd","w2021","Non.motorized",NA,"Tue","weekday","no_sled","East River",NA,NA,NA,5,NA,22,0,23,22.7,-1,0,-1,-1,-1,-1,-2,-3
"12218",2021-01-05,"Gothic Rd","w2021","Mechanized",NA,"Tue","weekday","no_sled","East River",NA,NA,NA,5,NA,22,0,23,22.7,-1,0,-1,-1,-1,-1,-2,-3
"12219",2021-01-05,"Gothic Rd","w2021","Motorized",NA,"Tue","weekday","sled","East River",NA,NA,NA,5,NA,22,0,23,22.7,-1,0,-1,-1,-1,-1,-2,-3
"12220",2021-01-05,"Gothic Rd","w2021","Hybrid",NA,"Tue","weekday","sled","East River",NA,NA,NA,5,NA,22,0,23,22.7,-1,0,-1,-1,-1,-1,-2,-3
"12221",2021-01-06,"Gothic Rd","w2021","Non.motorized",26,"Wed","weekday","no_sled","East River",NA,NA,NA,5.1,NA,24,2,18,21.2,0,-1,0,-1,2,1,1,0
"12222",2021-01-06,"Gothic Rd","w2021","Mechanized",0,"Wed","weekday","no_sled","East River",NA,NA,NA,5.1,NA,24,2,18,21.2,0,-1,0,-1,2,1,1,0
"12223",2021-01-06,"Gothic Rd","w2021","Motorized",3,"Wed","weekday","sled","East River",NA,NA,NA,5.1,NA,24,2,18,21.2,0,-1,0,-1,2,1,1,0
"12224",2021-01-06,"Gothic Rd","w2021","Hybrid",0,"Wed","weekday","sled","East River",NA,NA,NA,5.1,NA,24,2,18,21.2,0,-1,0,-1,2,1,1,0
"12225",2021-01-07,"Gothic Rd","w2021","Non.motorized",22,"Thu","weekday","no_sled","East River",NA,NA,NA,5.1,NA,24,0,23,21.2,2,0,-1,0,2,2,1,1
"12226",2021-01-07,"Gothic Rd","w2021","Mechanized",2,"Thu","weekday","no_sled","East River",NA,NA,NA,5.1,NA,24,0,23,21.2,2,0,-1,0,2,2,1,1
"12227",2021-01-07,"Gothic Rd","w2021","Motorized",0,"Thu","weekday","sled","East River",NA,NA,NA,5.1,NA,24,0,23,21.2,2,0,-1,0,2,2,1,1
"12228",2021-01-07,"Gothic Rd","w2021","Hybrid",0,"Thu","weekday","sled","East River",NA,NA,NA,5.1,NA,24,0,23,21.2,2,0,-1,0,2,2,1,1
"12229",2021-01-08,"Gothic Rd","w2021","Non.motorized",35,"Fri","weekday","no_sled","East River",NA,NA,NA,5.1,NA,23,-1,20,22.2,0,2,0,-1,-1,1,1,0
"12230",2021-01-08,"Gothic Rd","w2021","Mechanized",4,"Fri","weekday","no_sled","East River",NA,NA,NA,5.1,NA,23,-1,20,22.2,0,2,0,-1,-1,1,1,0
"12231",2021-01-08,"Gothic Rd","w2021","Motorized",0,"Fri","weekday","sled","East River",NA,NA,NA,5.1,NA,23,-1,20,22.2,0,2,0,-1,-1,1,1,0
"12232",2021-01-08,"Gothic Rd","w2021","Hybrid",0,"Fri","weekday","sled","East River",NA,NA,NA,5.1,NA,23,-1,20,22.2,0,2,0,-1,-1,1,1,0
"12233",2021-01-09,"Gothic Rd","w2021","Non.motorized",59,"Sat","weekend","no_sled","East River",NA,NA,NA,5.1,NA,23,0,19,22.2,-1,0,2,0,-1,-1,1,1
"12234",2021-01-09,"Gothic Rd","w2021","Mechanized",1,"Sat","weekend","no_sled","East River",NA,NA,NA,5.1,NA,23,0,19,22.2,-1,0,2,0,-1,-1,1,1
"12235",2021-01-09,"Gothic Rd","w2021","Motorized",0,"Sat","weekend","sled","East River",NA,NA,NA,5.1,NA,23,0,19,22.2,-1,0,2,0,-1,-1,1,1
"12236",2021-01-09,"Gothic Rd","w2021","Hybrid",0,"Sat","weekend","sled","East River",NA,NA,NA,5.1,NA,23,0,19,22.2,-1,0,2,0,-1,-1,1,1
"12237",2021-01-10,"Gothic Rd","w2021","Non.motorized",44,"Sun","weekend","no_sled","East River",NA,NA,NA,5.1,NA,23,0,14,22.2,0,-1,0,2,0,-1,-1,1
"12238",2021-01-10,"Gothic Rd","w2021","Mechanized",2,"Sun","weekend","no_sled","East River",NA,NA,NA,5.1,NA,23,0,14,22.2,0,-1,0,2,0,-1,-1,1
"12239",2021-01-10,"Gothic Rd","w2021","Motorized",0,"Sun","weekend","sled","East River",NA,NA,NA,5.1,NA,23,0,14,22.2,0,-1,0,2,0,-1,-1,1
"12240",2021-01-10,"Gothic Rd","w2021","Hybrid",0,"Sun","weekend","sled","East River",NA,NA,NA,5.1,NA,23,0,14,22.2,0,-1,0,2,0,-1,-1,1
"12241",2021-01-11,"Gothic Rd","w2021","Non.motorized",41,"Mon","weekday","no_sled","East River",NA,NA,NA,5.1,NA,23,0,15,22.2,0,0,-1,0,0,0,-1,-1
"12242",2021-01-11,"Gothic Rd","w2021","Mechanized",3,"Mon","weekday","no_sled","East River",NA,NA,NA,5.1,NA,23,0,15,22.2,0,0,-1,0,0,0,-1,-1
"12243",2021-01-11,"Gothic Rd","w2021","Motorized",0,"Mon","weekday","sled","East River",NA,NA,NA,5.1,NA,23,0,15,22.2,0,0,-1,0,0,0,-1,-1
"12244",2021-01-11,"Gothic Rd","w2021","Hybrid",0,"Mon","weekday","sled","East River",NA,NA,NA,5.1,NA,23,0,15,22.2,0,0,-1,0,0,0,-1,-1
"12245",2021-01-12,"Gothic Rd","w2021","Non.motorized",22,"Tue","weekday","no_sled","East River",NA,NA,NA,5.1,NA,23,0,23,22.2,0,0,0,-1,0,0,0,-1
"12246",2021-01-12,"Gothic Rd","w2021","Mechanized",1,"Tue","weekday","no_sled","East River",NA,NA,NA,5.1,NA,23,0,23,22.2,0,0,0,-1,0,0,0,-1
"12247",2021-01-12,"Gothic Rd","w2021","Motorized",0,"Tue","weekday","sled","East River",NA,NA,NA,5.1,NA,23,0,23,22.2,0,0,0,-1,0,0,0,-1
"12248",2021-01-12,"Gothic Rd","w2021","Hybrid",0,"Tue","weekday","sled","East River",NA,NA,NA,5.1,NA,23,0,23,22.2,0,0,0,-1,0,0,0,-1
"12249",2021-01-13,"Gothic Rd","w2021","Non.motorized",22,"Wed","weekday","no_sled","East River",NA,NA,NA,5.1,NA,23,0,28,22.2,0,0,0,0,0,0,0,0
"12250",2021-01-13,"Gothic Rd","w2021","Mechanized",0,"Wed","weekday","no_sled","East River",NA,NA,NA,5.1,NA,23,0,28,22.2,0,0,0,0,0,0,0,0
"12251",2021-01-13,"Gothic Rd","w2021","Motorized",0,"Wed","weekday","sled","East River",NA,NA,NA,5.1,NA,23,0,28,22.2,0,0,0,0,0,0,0,0
"12252",2021-01-13,"Gothic Rd","w2021","Hybrid",0,"Wed","weekday","sled","East River",NA,NA,NA,5.1,NA,23,0,28,22.2,0,0,0,0,0,0,0,0
"12253",2021-01-14,"Gothic Rd","w2021","Non.motorized",14,"Thu","weekday","no_sled","East River",NA,NA,NA,5.1,NA,22,-1,20,23.2,0,0,0,0,-1,-1,-1,-1
"12254",2021-01-14,"Gothic Rd","w2021","Mechanized",1,"Thu","weekday","no_sled","East River",NA,NA,NA,5.1,NA,22,-1,20,23.2,0,0,0,0,-1,-1,-1,-1
"12255",2021-01-14,"Gothic Rd","w2021","Motorized",0,"Thu","weekday","sled","East River",NA,NA,NA,5.1,NA,22,-1,20,23.2,0,0,0,0,-1,-1,-1,-1
"12256",2021-01-14,"Gothic Rd","w2021","Hybrid",0,"Thu","weekday","sled","East River",NA,NA,NA,5.1,NA,22,-1,20,23.2,0,0,0,0,-1,-1,-1,-1
"12257",2021-01-15,"Gothic Rd","w2021","Non.motorized",47,"Fri","weekday","no_sled","East River",NA,NA,NA,5.1,NA,22,0,26,23.2,-1,0,0,0,-1,-1,-1,-1
"12258",2021-01-15,"Gothic Rd","w2021","Mechanized",2,"Fri","weekday","no_sled","East River",NA,NA,NA,5.1,NA,22,0,26,23.2,-1,0,0,0,-1,-1,-1,-1
"12259",2021-01-15,"Gothic Rd","w2021","Motorized",0,"Fri","weekday","sled","East River",NA,NA,NA,5.1,NA,22,0,26,23.2,-1,0,0,0,-1,-1,-1,-1
"12260",2021-01-15,"Gothic Rd","w2021","Hybrid",0,"Fri","weekday","sled","East River",NA,NA,NA,5.1,NA,22,0,26,23.2,-1,0,0,0,-1,-1,-1,-1
"12261",2021-01-16,"Gothic Rd","w2021","Non.motorized",82,"Sat","weekend","no_sled","East River",NA,NA,NA,5.1,NA,22,0,26,23.2,0,-1,0,0,0,-1,-1,-1
"12262",2021-01-16,"Gothic Rd","w2021","Mechanized",6,"Sat","weekend","no_sled","East River",NA,NA,NA,5.1,NA,22,0,26,23.2,0,-1,0,0,0,-1,-1,-1
"12263",2021-01-16,"Gothic Rd","w2021","Motorized",0,"Sat","weekend","sled","East River",NA,NA,NA,5.1,NA,22,0,26,23.2,0,-1,0,0,0,-1,-1,-1
"12264",2021-01-16,"Gothic Rd","w2021","Hybrid",0,"Sat","weekend","sled","East River",NA,NA,NA,5.1,NA,22,0,26,23.2,0,-1,0,0,0,-1,-1,-1
"12265",2021-01-17,"Gothic Rd","w2021","Non.motorized",93,"Sun","weekend","no_sled","East River",NA,NA,NA,5.1,NA,22,0,29,23.2,0,0,-1,0,0,0,-1,-1
"12266",2021-01-17,"Gothic Rd","w2021","Mechanized",5,"Sun","weekend","no_sled","East River",NA,NA,NA,5.1,NA,22,0,29,23.2,0,0,-1,0,0,0,-1,-1
"12267",2021-01-17,"Gothic Rd","w2021","Motorized",0,"Sun","weekend","sled","East River",NA,NA,NA,5.1,NA,22,0,29,23.2,0,0,-1,0,0,0,-1,-1
"12268",2021-01-17,"Gothic Rd","w2021","Hybrid",0,"Sun","weekend","sled","East River",NA,NA,NA,5.1,NA,22,0,29,23.2,0,0,-1,0,0,0,-1,-1
"12269",2021-01-18,"Gothic Rd","w2021","Non.motorized",44,"Mon","weekday","no_sled","East River",NA,NA,NA,5.1,NA,22,0,24,23.2,0,0,0,-1,0,0,0,-1
"12270",2021-01-18,"Gothic Rd","w2021","Mechanized",6,"Mon","weekday","no_sled","East River",NA,NA,NA,5.1,NA,22,0,24,23.2,0,0,0,-1,0,0,0,-1
"12271",2021-01-18,"Gothic Rd","w2021","Motorized",0,"Mon","weekday","sled","East River",NA,NA,NA,5.1,NA,22,0,24,23.2,0,0,0,-1,0,0,0,-1
"12272",2021-01-18,"Gothic Rd","w2021","Hybrid",0,"Mon","weekday","sled","East River",NA,NA,NA,5.1,NA,22,0,24,23.2,0,0,0,-1,0,0,0,-1
"12273",2021-01-19,"Gothic Rd","w2021","Non.motorized",21,"Tue","weekday","no_sled","East River",NA,NA,NA,5.1,NA,22,0,19,23.2,0,0,0,0,0,0,0,0
"12274",2021-01-19,"Gothic Rd","w2021","Mechanized",1,"Tue","weekday","no_sled","East River",NA,NA,NA,5.1,NA,22,0,19,23.2,0,0,0,0,0,0,0,0
"12275",2021-01-19,"Gothic Rd","w2021","Motorized",0,"Tue","weekday","sled","East River",NA,NA,NA,5.1,NA,22,0,19,23.2,0,0,0,0,0,0,0,0
"12276",2021-01-19,"Gothic Rd","w2021","Hybrid",0,"Tue","weekday","sled","East River",NA,NA,NA,5.1,NA,22,0,19,23.2,0,0,0,0,0,0,0,0
"12277",2021-01-20,"Gothic Rd","w2021","Non.motorized",30,"Wed","weekday","no_sled","East River",NA,NA,NA,5.2,NA,23,1,26,22.6,0,0,0,0,1,1,1,1
"12278",2021-01-20,"Gothic Rd","w2021","Mechanized",0,"Wed","weekday","no_sled","East River",NA,NA,NA,5.2,NA,23,1,26,22.6,0,0,0,0,1,1,1,1
"12279",2021-01-20,"Gothic Rd","w2021","Motorized",0,"Wed","weekday","sled","East River",NA,NA,NA,5.2,NA,23,1,26,22.6,0,0,0,0,1,1,1,1
"12280",2021-01-20,"Gothic Rd","w2021","Hybrid",0,"Wed","weekday","sled","East River",NA,NA,NA,5.2,NA,23,1,26,22.6,0,0,0,0,1,1,1,1
"12281",2021-01-21,"Gothic Rd","w2021","Non.motorized",27,"Thu","weekday","no_sled","East River",NA,NA,NA,5.2,NA,23,0,26,22.6,1,0,0,0,1,1,1,1
"12282",2021-01-21,"Gothic Rd","w2021","Mechanized",1,"Thu","weekday","no_sled","East River",NA,NA,NA,5.2,NA,23,0,26,22.6,1,0,0,0,1,1,1,1
"12283",2021-01-21,"Gothic Rd","w2021","Motorized",0,"Thu","weekday","sled","East River",NA,NA,NA,5.2,NA,23,0,26,22.6,1,0,0,0,1,1,1,1
"12284",2021-01-21,"Gothic Rd","w2021","Hybrid",0,"Thu","weekday","sled","East River",NA,NA,NA,5.2,NA,23,0,26,22.6,1,0,0,0,1,1,1,1
"12285",2021-01-22,"Gothic Rd","w2021","Non.motorized",32,"Fri","weekday","no_sled","East River",NA,NA,NA,5.3,NA,25,2,25,21.2,0,1,0,0,2,3,3,3
"12286",2021-01-22,"Gothic Rd","w2021","Mechanized",1,"Fri","weekday","no_sled","East River",NA,NA,NA,5.3,NA,25,2,25,21.2,0,1,0,0,2,3,3,3
"12287",2021-01-22,"Gothic Rd","w2021","Motorized",1,"Fri","weekday","sled","East River",NA,NA,NA,5.3,NA,25,2,25,21.2,0,1,0,0,2,3,3,3
"12288",2021-01-22,"Gothic Rd","w2021","Hybrid",0,"Fri","weekday","sled","East River",NA,NA,NA,5.3,NA,25,2,25,21.2,0,1,0,0,2,3,3,3
"12289",2021-01-23,"Gothic Rd","w2021","Non.motorized",66,"Sat","weekend","no_sled","East River",NA,NA,NA,5.4,NA,26,1,22,20.8,2,0,1,0,3,3,4,4
"12290",2021-01-23,"Gothic Rd","w2021","Mechanized",5,"Sat","weekend","no_sled","East River",NA,NA,NA,5.4,NA,26,1,22,20.8,2,0,1,0,3,3,4,4
"12291",2021-01-23,"Gothic Rd","w2021","Motorized",1,"Sat","weekend","sled","East River",NA,NA,NA,5.4,NA,26,1,22,20.8,2,0,1,0,3,3,4,4
"12292",2021-01-23,"Gothic Rd","w2021","Hybrid",0,"Sat","weekend","sled","East River",NA,NA,NA,5.4,NA,26,1,22,20.8,2,0,1,0,3,3,4,4
"12293",2021-01-24,"Gothic Rd","w2021","Non.motorized",30,"Sun","weekend","no_sled","East River",NA,NA,NA,5.6,NA,29,3,18,19.3,1,2,0,1,4,6,6,7
"12294",2021-01-24,"Gothic Rd","w2021","Mechanized",3,"Sun","weekend","no_sled","East River",NA,NA,NA,5.6,NA,29,3,18,19.3,1,2,0,1,4,6,6,7
"12295",2021-01-24,"Gothic Rd","w2021","Motorized",1,"Sun","weekend","sled","East River",NA,NA,NA,5.6,NA,29,3,18,19.3,1,2,0,1,4,6,6,7
"12296",2021-01-24,"Gothic Rd","w2021","Hybrid",0,"Sun","weekend","sled","East River",NA,NA,NA,5.6,NA,29,3,18,19.3,1,2,0,1,4,6,6,7
"12297",2021-01-25,"Gothic Rd","w2021","Non.motorized",19,"Mon","weekday","no_sled","East River",NA,NA,NA,5.8,NA,29,0,15,20,3,1,2,0,3,4,6,6
"12298",2021-01-25,"Gothic Rd","w2021","Mechanized",0,"Mon","weekday","no_sled","East River",NA,NA,NA,5.8,NA,29,0,15,20,3,1,2,0,3,4,6,6
"12299",2021-01-25,"Gothic Rd","w2021","Motorized",3,"Mon","weekday","sled","East River",NA,NA,NA,5.8,NA,29,0,15,20,3,1,2,0,3,4,6,6
"12300",2021-01-25,"Gothic Rd","w2021","Hybrid",0,"Mon","weekday","sled","East River",NA,NA,NA,5.8,NA,29,0,15,20,3,1,2,0,3,4,6,6
"12301",2021-01-26,"Gothic Rd","w2021","Non.motorized",25,"Tue","weekday","no_sled","East River",NA,NA,NA,5.9,NA,29,0,13,20.3,0,3,1,2,0,3,4,6
"12302",2021-01-26,"Gothic Rd","w2021","Mechanized",1,"Tue","weekday","no_sled","East River",NA,NA,NA,5.9,NA,29,0,13,20.3,0,3,1,2,0,3,4,6
"12303",2021-01-26,"Gothic Rd","w2021","Motorized",1,"Tue","weekday","sled","East River",NA,NA,NA,5.9,NA,29,0,13,20.3,0,3,1,2,0,3,4,6
"12304",2021-01-26,"Gothic Rd","w2021","Hybrid",0,"Tue","weekday","sled","East River",NA,NA,NA,5.9,NA,29,0,13,20.3,0,3,1,2,0,3,4,6
"12305",2021-01-27,"Gothic Rd","w2021","Non.motorized",13,"Wed","weekday","no_sled","East River",NA,NA,NA,6,NA,30,1,13,20,0,0,3,1,1,1,4,5
"12306",2021-01-27,"Gothic Rd","w2021","Mechanized",0,"Wed","weekday","no_sled","East River",NA,NA,NA,6,NA,30,1,13,20,0,0,3,1,1,1,4,5
"12307",2021-01-27,"Gothic Rd","w2021","Motorized",3,"Wed","weekday","sled","East River",NA,NA,NA,6,NA,30,1,13,20,0,0,3,1,1,1,4,5
"12308",2021-01-27,"Gothic Rd","w2021","Hybrid",0,"Wed","weekday","sled","East River",NA,NA,NA,6,NA,30,1,13,20,0,0,3,1,1,1,4,5
"12309",2021-01-28,"Gothic Rd","w2021","Non.motorized",46,"Thu","weekday","no_sled","East River",NA,NA,NA,6,NA,28,-2,27,21.4,1,0,0,3,-1,-1,-1,2
"12310",2021-01-28,"Gothic Rd","w2021","Mechanized",4,"Thu","weekday","no_sled","East River",NA,NA,NA,6,NA,28,-2,27,21.4,1,0,0,3,-1,-1,-1,2
"12311",2021-01-28,"Gothic Rd","w2021","Motorized",4,"Thu","weekday","sled","East River",NA,NA,NA,6,NA,28,-2,27,21.4,1,0,0,3,-1,-1,-1,2
"12312",2021-01-28,"Gothic Rd","w2021","Hybrid",0,"Thu","weekday","sled","East River",NA,NA,NA,6,NA,28,-2,27,21.4,1,0,0,3,-1,-1,-1,2
"12313",2021-01-29,"Gothic Rd","w2021","Non.motorized",37,"Fri","weekday","no_sled","East River",NA,NA,NA,6.1,NA,28,0,29,21.8,-2,1,0,0,-2,-1,-1,-1
"12314",2021-01-29,"Gothic Rd","w2021","Mechanized",7,"Fri","weekday","no_sled","East River",NA,NA,NA,6.1,NA,28,0,29,21.8,-2,1,0,0,-2,-1,-1,-1
"12315",2021-01-29,"Gothic Rd","w2021","Motorized",1,"Fri","weekday","sled","East River",NA,NA,NA,6.1,NA,28,0,29,21.8,-2,1,0,0,-2,-1,-1,-1
"12316",2021-01-29,"Gothic Rd","w2021","Hybrid",0,"Fri","weekday","sled","East River",NA,NA,NA,6.1,NA,28,0,29,21.8,-2,1,0,0,-2,-1,-1,-1
"12317",2021-01-30,"Gothic Rd","w2021","Non.motorized",62,"Sat","weekend","no_sled","East River",NA,NA,NA,6.2,NA,29,1,21,21.4,0,-2,1,0,1,-1,0,0
"12318",2021-01-30,"Gothic Rd","w2021","Mechanized",1,"Sat","weekend","no_sled","East River",NA,NA,NA,6.2,NA,29,1,21,21.4,0,-2,1,0,1,-1,0,0
"12319",2021-01-30,"Gothic Rd","w2021","Motorized",0,"Sat","weekend","sled","East River",NA,NA,NA,6.2,NA,29,1,21,21.4,0,-2,1,0,1,-1,0,0
"12320",2021-01-30,"Gothic Rd","w2021","Hybrid",0,"Sat","weekend","sled","East River",NA,NA,NA,6.2,NA,29,1,21,21.4,0,-2,1,0,1,-1,0,0
"12321",2021-01-31,"Gothic Rd","w2021","Non.motorized",75,"Sun","weekend","no_sled","East River",NA,NA,NA,6.3,NA,29,0,21,21.7,1,0,-2,1,1,1,-1,0
"12322",2021-01-31,"Gothic Rd","w2021","Mechanized",2,"Sun","weekend","no_sled","East River",NA,NA,NA,6.3,NA,29,0,21,21.7,1,0,-2,1,1,1,-1,0
"12323",2021-01-31,"Gothic Rd","w2021","Motorized",0,"Sun","weekend","sled","East River",NA,NA,NA,6.3,NA,29,0,21,21.7,1,0,-2,1,1,1,-1,0
"12324",2021-01-31,"Gothic Rd","w2021","Hybrid",0,"Sun","weekend","sled","East River",NA,NA,NA,6.3,NA,29,0,21,21.7,1,0,-2,1,1,1,-1,0
"12325",2021-02-01,"Gothic Rd","w2021","Non.motorized",40,"Mon","weekday","no_sled","East River",NA,NA,NA,6.3,NA,28,-1,30,22.5,0,1,0,-2,-1,0,0,-2
"12326",2021-02-01,"Gothic Rd","w2021","Mechanized",0,"Mon","weekday","no_sled","East River",NA,NA,NA,6.3,NA,28,-1,30,22.5,0,1,0,-2,-1,0,0,-2
"12327",2021-02-01,"Gothic Rd","w2021","Motorized",3,"Mon","weekday","sled","East River",NA,NA,NA,6.3,NA,28,-1,30,22.5,0,1,0,-2,-1,0,0,-2
"12328",2021-02-01,"Gothic Rd","w2021","Hybrid",0,"Mon","weekday","sled","East River",NA,NA,NA,6.3,NA,28,-1,30,22.5,0,1,0,-2,-1,0,0,-2
"12329",2021-02-02,"Gothic Rd","w2021","Non.motorized",29,"Tue","weekday","no_sled","East River",NA,NA,NA,6.3,NA,28,0,34,22.5,-1,0,1,0,-1,-1,0,0
"12330",2021-02-02,"Gothic Rd","w2021","Mechanized",11,"Tue","weekday","no_sled","East River",NA,NA,NA,6.3,NA,28,0,34,22.5,-1,0,1,0,-1,-1,0,0
"12331",2021-02-02,"Gothic Rd","w2021","Motorized",2,"Tue","weekday","sled","East River",NA,NA,NA,6.3,NA,28,0,34,22.5,-1,0,1,0,-1,-1,0,0
"12332",2021-02-02,"Gothic Rd","w2021","Hybrid",0,"Tue","weekday","sled","East River",NA,NA,NA,6.3,NA,28,0,34,22.5,-1,0,1,0,-1,-1,0,0
"12333",2021-02-03,"Gothic Rd","w2021","Non.motorized",9,"Wed","weekday","no_sled","East River",NA,NA,NA,6.3,NA,27,-1,30,23.3,0,-1,0,1,-1,-2,-2,-1
"12334",2021-02-03,"Gothic Rd","w2021","Mechanized",0,"Wed","weekday","no_sled","East River",NA,NA,NA,6.3,NA,27,-1,30,23.3,0,-1,0,1,-1,-2,-2,-1
"12335",2021-02-03,"Gothic Rd","w2021","Motorized",0,"Wed","weekday","sled","East River",NA,NA,NA,6.3,NA,27,-1,30,23.3,0,-1,0,1,-1,-2,-2,-1
"12336",2021-02-03,"Gothic Rd","w2021","Hybrid",0,"Wed","weekday","sled","East River",NA,NA,NA,6.3,NA,27,-1,30,23.3,0,-1,0,1,-1,-2,-2,-1
"12337",2021-02-04,"Gothic Rd","w2021","Non.motorized",17,"Thu","weekday","no_sled","East River",NA,NA,NA,7.2,NA,37,10,14,19.5,-1,0,-1,0,9,9,8,8
"12338",2021-02-04,"Gothic Rd","w2021","Mechanized",0,"Thu","weekday","no_sled","East River",NA,NA,NA,7.2,NA,37,10,14,19.5,-1,0,-1,0,9,9,8,8
"12339",2021-02-04,"Gothic Rd","w2021","Motorized",0,"Thu","weekday","sled","East River",NA,NA,NA,7.2,NA,37,10,14,19.5,-1,0,-1,0,9,9,8,8
"12340",2021-02-04,"Gothic Rd","w2021","Hybrid",0,"Thu","weekday","sled","East River",NA,NA,NA,7.2,NA,37,10,14,19.5,-1,0,-1,0,9,9,8,8
"12341",2021-02-05,"Gothic Rd","w2021","Non.motorized",35,"Fri","weekday","no_sled","East River",NA,NA,NA,7.2,NA,35,-2,16,20.6,10,-1,0,-1,8,7,7,6
"12342",2021-02-05,"Gothic Rd","w2021","Mechanized",0,"Fri","weekday","no_sled","East River",NA,NA,NA,7.2,NA,35,-2,16,20.6,10,-1,0,-1,8,7,7,6
"12343",2021-02-05,"Gothic Rd","w2021","Motorized",0,"Fri","weekday","sled","East River",NA,NA,NA,7.2,NA,35,-2,16,20.6,10,-1,0,-1,8,7,7,6
"12344",2021-02-05,"Gothic Rd","w2021","Hybrid",0,"Fri","weekday","sled","East River",NA,NA,NA,7.2,NA,35,-2,16,20.6,10,-1,0,-1,8,7,7,6
"12345",2021-02-06,"Gothic Rd","w2021","Non.motorized",61,"Sat","weekend","no_sled","East River",NA,NA,NA,7.5,NA,37,2,19,20.3,-2,10,-1,0,0,10,9,9
"12346",2021-02-06,"Gothic Rd","w2021","Mechanized",4,"Sat","weekend","no_sled","East River",NA,NA,NA,7.5,NA,37,2,19,20.3,-2,10,-1,0,0,10,9,9
"12347",2021-02-06,"Gothic Rd","w2021","Motorized",0,"Sat","weekend","sled","East River",NA,NA,NA,7.5,NA,37,2,19,20.3,-2,10,-1,0,0,10,9,9
"12348",2021-02-06,"Gothic Rd","w2021","Hybrid",0,"Sat","weekend","sled","East River",NA,NA,NA,7.5,NA,37,2,19,20.3,-2,10,-1,0,0,10,9,9
"12349",2021-02-07,"Gothic Rd","w2021","Non.motorized",57,"Sun","weekend","no_sled","East River",NA,NA,NA,7.5,NA,36,-1,24,20.8,2,-2,10,-1,1,-1,9,8
"12350",2021-02-07,"Gothic Rd","w2021","Mechanized",0,"Sun","weekend","no_sled","East River",NA,NA,NA,7.5,NA,36,-1,24,20.8,2,-2,10,-1,1,-1,9,8
"12351",2021-02-07,"Gothic Rd","w2021","Motorized",2,"Sun","weekend","sled","East River",NA,NA,NA,7.5,NA,36,-1,24,20.8,2,-2,10,-1,1,-1,9,8
"12352",2021-02-07,"Gothic Rd","w2021","Hybrid",0,"Sun","weekend","sled","East River",NA,NA,NA,7.5,NA,36,-1,24,20.8,2,-2,10,-1,1,-1,9,8
"12353",2021-02-08,"Gothic Rd","w2021","Non.motorized",57,"Mon","weekday","no_sled","East River",NA,NA,NA,7.6,NA,35,-1,28,21.7,-1,2,-2,10,-2,0,-2,8
"12354",2021-02-08,"Gothic Rd","w2021","Mechanized",0,"Mon","weekday","no_sled","East River",NA,NA,NA,7.6,NA,35,-1,28,21.7,-1,2,-2,10,-2,0,-2,8
"12355",2021-02-08,"Gothic Rd","w2021","Motorized",2,"Mon","weekday","sled","East River",NA,NA,NA,7.6,NA,35,-1,28,21.7,-1,2,-2,10,-2,0,-2,8
"12356",2021-02-08,"Gothic Rd","w2021","Hybrid",0,"Mon","weekday","sled","East River",NA,NA,NA,7.6,NA,35,-1,28,21.7,-1,2,-2,10,-2,0,-2,8
"12357",2021-02-09,"Gothic Rd","w2021","Non.motorized",23,"Tue","weekday","no_sled","East River",NA,NA,NA,7.6,NA,34,-1,28,22.4,-1,-1,2,-2,-2,-3,-1,-3
"12358",2021-02-09,"Gothic Rd","w2021","Mechanized",2,"Tue","weekday","no_sled","East River",NA,NA,NA,7.6,NA,34,-1,28,22.4,-1,-1,2,-2,-2,-3,-1,-3
"12359",2021-02-09,"Gothic Rd","w2021","Motorized",0,"Tue","weekday","sled","East River",NA,NA,NA,7.6,NA,34,-1,28,22.4,-1,-1,2,-2,-2,-3,-1,-3
"12360",2021-02-09,"Gothic Rd","w2021","Hybrid",0,"Tue","weekday","sled","East River",NA,NA,NA,7.6,NA,34,-1,28,22.4,-1,-1,2,-2,-2,-3,-1,-3
"12361",2021-02-10,"Gothic Rd","w2021","Non.motorized",15,"Wed","weekday","no_sled","East River",NA,NA,NA,7.7,NA,34,0,26,22.6,-1,-1,-1,2,-1,-2,-3,-1
"12362",2021-02-10,"Gothic Rd","w2021","Mechanized",0,"Wed","weekday","no_sled","East River",NA,NA,NA,7.7,NA,34,0,26,22.6,-1,-1,-1,2,-1,-2,-3,-1
"12363",2021-02-10,"Gothic Rd","w2021","Motorized",1,"Wed","weekday","sled","East River",NA,NA,NA,7.7,NA,34,0,26,22.6,-1,-1,-1,2,-1,-2,-3,-1
"12364",2021-02-10,"Gothic Rd","w2021","Hybrid",0,"Wed","weekday","sled","East River",NA,NA,NA,7.7,NA,34,0,26,22.6,-1,-1,-1,2,-1,-2,-3,-1
"12365",2021-02-11,"Gothic Rd","w2021","Non.motorized",NA,"Thu","weekday","no_sled","East River",NA,NA,NA,8,NA,37,3,26,21.6,0,-1,-1,-1,3,2,1,0
"12366",2021-02-11,"Gothic Rd","w2021","Mechanized",NA,"Thu","weekday","no_sled","East River",NA,NA,NA,8,NA,37,3,26,21.6,0,-1,-1,-1,3,2,1,0
"12367",2021-02-11,"Gothic Rd","w2021","Motorized",NA,"Thu","weekday","sled","East River",NA,NA,NA,8,NA,37,3,26,21.6,0,-1,-1,-1,3,2,1,0
"12368",2021-02-11,"Gothic Rd","w2021","Hybrid",NA,"Thu","weekday","sled","East River",NA,NA,NA,8,NA,37,3,26,21.6,0,-1,-1,-1,3,2,1,0
"12369",2021-02-12,"Gothic Rd","w2021","Non.motorized",38,"Fri","weekday","no_sled","East River",NA,NA,NA,8.1,NA,37,0,27,21.9,3,0,-1,-1,3,3,2,1
"12370",2021-02-12,"Gothic Rd","w2021","Mechanized",1,"Fri","weekday","no_sled","East River",NA,NA,NA,8.1,NA,37,0,27,21.9,3,0,-1,-1,3,3,2,1
"12371",2021-02-12,"Gothic Rd","w2021","Motorized",1,"Fri","weekday","sled","East River",NA,NA,NA,8.1,NA,37,0,27,21.9,3,0,-1,-1,3,3,2,1
"12372",2021-02-12,"Gothic Rd","w2021","Hybrid",0,"Fri","weekday","sled","East River",NA,NA,NA,8.1,NA,37,0,27,21.9,3,0,-1,-1,3,3,2,1
"12373",2021-02-13,"Gothic Rd","w2021","Non.motorized",21,"Sat","weekend","no_sled","East River",NA,NA,NA,8.4,NA,38,1,26,22.1,0,3,0,-1,1,4,4,3
"12374",2021-02-13,"Gothic Rd","w2021","Mechanized",1,"Sat","weekend","no_sled","East River",NA,NA,NA,8.4,NA,38,1,26,22.1,0,3,0,-1,1,4,4,3
"12375",2021-02-13,"Gothic Rd","w2021","Motorized",0,"Sat","weekend","sled","East River",NA,NA,NA,8.4,NA,38,1,26,22.1,0,3,0,-1,1,4,4,3
"12376",2021-02-13,"Gothic Rd","w2021","Hybrid",0,"Sat","weekend","sled","East River",NA,NA,NA,8.4,NA,38,1,26,22.1,0,3,0,-1,1,4,4,3
"12377",2021-02-14,"Gothic Rd","w2021","Non.motorized",49,"Sun","weekend","no_sled","East River",NA,NA,NA,8.9,NA,43,5,18,20.7,1,0,3,0,6,6,9,9
"12378",2021-02-14,"Gothic Rd","w2021","Mechanized",6,"Sun","weekend","no_sled","East River",NA,NA,NA,8.9,NA,43,5,18,20.7,1,0,3,0,6,6,9,9
"12379",2021-02-14,"Gothic Rd","w2021","Motorized",0,"Sun","weekend","sled","East River",NA,NA,NA,8.9,NA,43,5,18,20.7,1,0,3,0,6,6,9,9
"12380",2021-02-14,"Gothic Rd","w2021","Hybrid",0,"Sun","weekend","sled","East River",NA,NA,NA,8.9,NA,43,5,18,20.7,1,0,3,0,6,6,9,9
"12381",2021-02-15,"Gothic Rd","w2021","Non.motorized",25,"Mon","weekday","no_sled","East River",NA,NA,NA,8.9,NA,43,0,12,20.7,5,1,0,3,5,6,6,9
"12382",2021-02-15,"Gothic Rd","w2021","Mechanized",3,"Mon","weekday","no_sled","East River",NA,NA,NA,8.9,NA,43,0,12,20.7,5,1,0,3,5,6,6,9
"12383",2021-02-15,"Gothic Rd","w2021","Motorized",0,"Mon","weekday","sled","East River",NA,NA,NA,8.9,NA,43,0,12,20.7,5,1,0,3,5,6,6,9
"12384",2021-02-15,"Gothic Rd","w2021","Hybrid",0,"Mon","weekday","sled","East River",NA,NA,NA,8.9,NA,43,0,12,20.7,5,1,0,3,5,6,6,9
"12385",2021-02-16,"Gothic Rd","w2021","Non.motorized",30,"Tue","weekday","no_sled","East River",NA,NA,NA,9,NA,41,-2,17,22,0,5,1,0,-2,3,4,4
"12386",2021-02-16,"Gothic Rd","w2021","Mechanized",2,"Tue","weekday","no_sled","East River",NA,NA,NA,9,NA,41,-2,17,22,0,5,1,0,-2,3,4,4
"12387",2021-02-16,"Gothic Rd","w2021","Motorized",0,"Tue","weekday","sled","East River",NA,NA,NA,9,NA,41,-2,17,22,0,5,1,0,-2,3,4,4
"12388",2021-02-16,"Gothic Rd","w2021","Hybrid",0,"Tue","weekday","sled","East River",NA,NA,NA,9,NA,41,-2,17,22,0,5,1,0,-2,3,4,4
"12389",2021-02-17,"Gothic Rd","w2021","Non.motorized",11,"Wed","weekday","no_sled","East River",NA,NA,NA,9.1,NA,42,1,13,21.7,-2,0,5,1,-1,-1,4,5
"12390",2021-02-17,"Gothic Rd","w2021","Mechanized",1,"Wed","weekday","no_sled","East River",NA,NA,NA,9.1,NA,42,1,13,21.7,-2,0,5,1,-1,-1,4,5
"12391",2021-02-17,"Gothic Rd","w2021","Motorized",0,"Wed","weekday","sled","East River",NA,NA,NA,9.1,NA,42,1,13,21.7,-2,0,5,1,-1,-1,4,5
"12392",2021-02-17,"Gothic Rd","w2021","Hybrid",0,"Wed","weekday","sled","East River",NA,NA,NA,9.1,NA,42,1,13,21.7,-2,0,5,1,-1,-1,4,5
"12393",2021-02-18,"Gothic Rd","w2021","Non.motorized",22,"Thu","weekday","no_sled","East River",NA,NA,NA,9.1,NA,41,-1,11,22.2,1,-2,0,5,0,-2,-2,3
"12394",2021-02-18,"Gothic Rd","w2021","Mechanized",0,"Thu","weekday","no_sled","East River",NA,NA,NA,9.1,NA,41,-1,11,22.2,1,-2,0,5,0,-2,-2,3
"12395",2021-02-18,"Gothic Rd","w2021","Motorized",0,"Thu","weekday","sled","East River",NA,NA,NA,9.1,NA,41,-1,11,22.2,1,-2,0,5,0,-2,-2,3
"12396",2021-02-18,"Gothic Rd","w2021","Hybrid",0,"Thu","weekday","sled","East River",NA,NA,NA,9.1,NA,41,-1,11,22.2,1,-2,0,5,0,-2,-2,3
"12397",2021-02-19,"Gothic Rd","w2021","Non.motorized",31,"Fri","weekday","no_sled","East River",NA,NA,NA,9.1,NA,40,-1,18,22.8,-1,1,-2,0,-2,-1,-3,-3
"12398",2021-02-19,"Gothic Rd","w2021","Mechanized",7,"Fri","weekday","no_sled","East River",NA,NA,NA,9.1,NA,40,-1,18,22.8,-1,1,-2,0,-2,-1,-3,-3
"12399",2021-02-19,"Gothic Rd","w2021","Motorized",1,"Fri","weekday","sled","East River",NA,NA,NA,9.1,NA,40,-1,18,22.8,-1,1,-2,0,-2,-1,-3,-3
"12400",2021-02-19,"Gothic Rd","w2021","Hybrid",0,"Fri","weekday","sled","East River",NA,NA,NA,9.1,NA,40,-1,18,22.8,-1,1,-2,0,-2,-1,-3,-3
"12401",2021-02-20,"Gothic Rd","w2021","Non.motorized",35,"Sat","weekend","no_sled","East River",NA,NA,NA,9.2,NA,39,-1,23,23.6,-1,-1,1,-2,-2,-3,-2,-4
"12402",2021-02-20,"Gothic Rd","w2021","Mechanized",3,"Sat","weekend","no_sled","East River",NA,NA,NA,9.2,NA,39,-1,23,23.6,-1,-1,1,-2,-2,-3,-2,-4
"12403",2021-02-20,"Gothic Rd","w2021","Motorized",2,"Sat","weekend","sled","East River",NA,NA,NA,9.2,NA,39,-1,23,23.6,-1,-1,1,-2,-2,-3,-2,-4
"12404",2021-02-20,"Gothic Rd","w2021","Hybrid",0,"Sat","weekend","sled","East River",NA,NA,NA,9.2,NA,39,-1,23,23.6,-1,-1,1,-2,-2,-3,-2,-4
"12405",2021-02-21,"Gothic Rd","w2021","Non.motorized",51,"Sun","weekend","no_sled","East River",NA,NA,NA,9.2,NA,39,0,15,23.6,-1,-1,-1,1,-1,-2,-3,-2
"12406",2021-02-21,"Gothic Rd","w2021","Mechanized",7,"Sun","weekend","no_sled","East River",NA,NA,NA,9.2,NA,39,0,15,23.6,-1,-1,-1,1,-1,-2,-3,-2
"12407",2021-02-21,"Gothic Rd","w2021","Motorized",0,"Sun","weekend","sled","East River",NA,NA,NA,9.2,NA,39,0,15,23.6,-1,-1,-1,1,-1,-2,-3,-2
"12408",2021-02-21,"Gothic Rd","w2021","Hybrid",0,"Sun","weekend","sled","East River",NA,NA,NA,9.2,NA,39,0,15,23.6,-1,-1,-1,1,-1,-2,-3,-2
"12409",2021-02-22,"Gothic Rd","w2021","Non.motorized",52,"Mon","weekday","no_sled","East River",NA,NA,NA,9.2,NA,39,0,23,23.6,0,-1,-1,-1,0,-1,-2,-3
"12410",2021-02-22,"Gothic Rd","w2021","Mechanized",5,"Mon","weekday","no_sled","East River",NA,NA,NA,9.2,NA,39,0,23,23.6,0,-1,-1,-1,0,-1,-2,-3
"12411",2021-02-22,"Gothic Rd","w2021","Motorized",0,"Mon","weekday","sled","East River",NA,NA,NA,9.2,NA,39,0,23,23.6,0,-1,-1,-1,0,-1,-2,-3
"12412",2021-02-22,"Gothic Rd","w2021","Hybrid",0,"Mon","weekday","sled","East River",NA,NA,NA,9.2,NA,39,0,23,23.6,0,-1,-1,-1,0,-1,-2,-3
"12413",2021-02-23,"Gothic Rd","w2021","Non.motorized",10,"Tue","weekday","no_sled","East River",NA,NA,NA,9.2,NA,38,-1,28,24.2,0,0,-1,-1,-1,-1,-2,-3
"12414",2021-02-23,"Gothic Rd","w2021","Mechanized",0,"Tue","weekday","no_sled","East River",NA,NA,NA,9.2,NA,38,-1,28,24.2,0,0,-1,-1,-1,-1,-2,-3
"12415",2021-02-23,"Gothic Rd","w2021","Motorized",1,"Tue","weekday","sled","East River",NA,NA,NA,9.2,NA,38,-1,28,24.2,0,0,-1,-1,-1,-1,-2,-3
"12416",2021-02-23,"Gothic Rd","w2021","Hybrid",0,"Tue","weekday","sled","East River",NA,NA,NA,9.2,NA,38,-1,28,24.2,0,0,-1,-1,-1,-1,-2,-3
"12417",2021-02-24,"Gothic Rd","w2021","Non.motorized",27,"Wed","weekday","no_sled","East River",NA,NA,NA,9.2,NA,38,0,23,24.2,-1,0,0,-1,-1,-1,-1,-2
"12418",2021-02-24,"Gothic Rd","w2021","Mechanized",5,"Wed","weekday","no_sled","East River",NA,NA,NA,9.2,NA,38,0,23,24.2,-1,0,0,-1,-1,-1,-1,-2
"12419",2021-02-24,"Gothic Rd","w2021","Motorized",0,"Wed","weekday","sled","East River",NA,NA,NA,9.2,NA,38,0,23,24.2,-1,0,0,-1,-1,-1,-1,-2
"12420",2021-02-24,"Gothic Rd","w2021","Hybrid",0,"Wed","weekday","sled","East River",NA,NA,NA,9.2,NA,38,0,23,24.2,-1,0,0,-1,-1,-1,-1,-2
"12421",2021-02-25,"Gothic Rd","w2021","Non.motorized",36,"Thu","weekday","no_sled","East River",NA,NA,NA,9.2,NA,37,-1,20,24.9,0,-1,0,0,-1,-2,-2,-2
"12422",2021-02-25,"Gothic Rd","w2021","Mechanized",2,"Thu","weekday","no_sled","East River",NA,NA,NA,9.2,NA,37,-1,20,24.9,0,-1,0,0,-1,-2,-2,-2
"12423",2021-02-25,"Gothic Rd","w2021","Motorized",0,"Thu","weekday","sled","East River",NA,NA,NA,9.2,NA,37,-1,20,24.9,0,-1,0,0,-1,-2,-2,-2
"12424",2021-02-25,"Gothic Rd","w2021","Hybrid",0,"Thu","weekday","sled","East River",NA,NA,NA,9.2,NA,37,-1,20,24.9,0,-1,0,0,-1,-2,-2,-2
"12425",2021-02-26,"Gothic Rd","w2021","Non.motorized",23,"Fri","weekday","no_sled","East River",NA,NA,NA,9.2,NA,37,0,21,24.9,-1,0,-1,0,-1,-1,-2,-2
"12426",2021-02-26,"Gothic Rd","w2021","Mechanized",1,"Fri","weekday","no_sled","East River",NA,NA,NA,9.2,NA,37,0,21,24.9,-1,0,-1,0,-1,-1,-2,-2
"12427",2021-02-26,"Gothic Rd","w2021","Motorized",0,"Fri","weekday","sled","East River",NA,NA,NA,9.2,NA,37,0,21,24.9,-1,0,-1,0,-1,-1,-2,-2
"12428",2021-02-26,"Gothic Rd","w2021","Hybrid",0,"Fri","weekday","sled","East River",NA,NA,NA,9.2,NA,37,0,21,24.9,-1,0,-1,0,-1,-1,-2,-2
"12429",2021-02-27,"Gothic Rd","w2021","Non.motorized",63,"Sat","weekend","no_sled","East River",NA,NA,NA,9.2,NA,37,0,15,24.9,0,-1,0,-1,0,-1,-1,-2
"12430",2021-02-27,"Gothic Rd","w2021","Mechanized",3,"Sat","weekend","no_sled","East River",NA,NA,NA,9.2,NA,37,0,15,24.9,0,-1,0,-1,0,-1,-1,-2
"12431",2021-02-27,"Gothic Rd","w2021","Motorized",0,"Sat","weekend","sled","East River",NA,NA,NA,9.2,NA,37,0,15,24.9,0,-1,0,-1,0,-1,-1,-2
"12432",2021-02-27,"Gothic Rd","w2021","Hybrid",0,"Sat","weekend","sled","East River",NA,NA,NA,9.2,NA,37,0,15,24.9,0,-1,0,-1,0,-1,-1,-2
"12433",2021-02-28,"Gothic Rd","w2021","Non.motorized",107,"Sun","weekend","no_sled","East River",NA,NA,NA,9.2,NA,38,1,9,24.2,0,0,-1,0,1,1,0,0
"12434",2021-02-28,"Gothic Rd","w2021","Mechanized",3,"Sun","weekend","no_sled","East River",NA,NA,NA,9.2,NA,38,1,9,24.2,0,0,-1,0,1,1,0,0
"12435",2021-02-28,"Gothic Rd","w2021","Motorized",0,"Sun","weekend","sled","East River",NA,NA,NA,9.2,NA,38,1,9,24.2,0,0,-1,0,1,1,0,0
"12436",2021-02-28,"Gothic Rd","w2021","Hybrid",0,"Sun","weekend","sled","East River",NA,NA,NA,9.2,NA,38,1,9,24.2,0,0,-1,0,1,1,0,0
"12437",2021-03-01,"Gothic Rd","w2021","Non.motorized",25,"Mon","weekday","no_sled","East River",NA,NA,NA,9.2,NA,37,-1,20,24.9,1,0,0,-1,0,0,0,-1
"12438",2021-03-01,"Gothic Rd","w2021","Mechanized",0,"Mon","weekday","no_sled","East River",NA,NA,NA,9.2,NA,37,-1,20,24.9,1,0,0,-1,0,0,0,-1
"12439",2021-03-01,"Gothic Rd","w2021","Motorized",0,"Mon","weekday","sled","East River",NA,NA,NA,9.2,NA,37,-1,20,24.9,1,0,0,-1,0,0,0,-1
"12440",2021-03-01,"Gothic Rd","w2021","Hybrid",0,"Mon","weekday","sled","East River",NA,NA,NA,9.2,NA,37,-1,20,24.9,1,0,0,-1,0,0,0,-1
"12441",2021-03-02,"Gothic Rd","w2021","Non.motorized",24,"Tue","weekday","no_sled","East River",NA,NA,NA,9.2,NA,36,-1,27,25.6,-1,1,0,0,-2,-1,-1,-1
"12442",2021-03-02,"Gothic Rd","w2021","Mechanized",1,"Tue","weekday","no_sled","East River",NA,NA,NA,9.2,NA,36,-1,27,25.6,-1,1,0,0,-2,-1,-1,-1
"12443",2021-03-02,"Gothic Rd","w2021","Motorized",0,"Tue","weekday","sled","East River",NA,NA,NA,9.2,NA,36,-1,27,25.6,-1,1,0,0,-2,-1,-1,-1
"12444",2021-03-02,"Gothic Rd","w2021","Hybrid",1,"Tue","weekday","sled","East River",NA,NA,NA,9.2,NA,36,-1,27,25.6,-1,1,0,0,-2,-1,-1,-1
"12445",2021-03-03,"Gothic Rd","w2021","Non.motorized",33,"Wed","weekday","no_sled","East River",NA,NA,NA,9.2,NA,36,0,31,25.6,-1,-1,1,0,-1,-2,-1,-1
"12446",2021-03-03,"Gothic Rd","w2021","Mechanized",3,"Wed","weekday","no_sled","East River",NA,NA,NA,9.2,NA,36,0,31,25.6,-1,-1,1,0,-1,-2,-1,-1
"12447",2021-03-03,"Gothic Rd","w2021","Motorized",0,"Wed","weekday","sled","East River",NA,NA,NA,9.2,NA,36,0,31,25.6,-1,-1,1,0,-1,-2,-1,-1
"12448",2021-03-03,"Gothic Rd","w2021","Hybrid",1,"Wed","weekday","sled","East River",NA,NA,NA,9.2,NA,36,0,31,25.6,-1,-1,1,0,-1,-2,-1,-1
"12449",2021-03-04,"Gothic Rd","w2021","Non.motorized",7,"Thu","weekday","no_sled","East River",NA,NA,NA,9.2,NA,36,0,28,25.6,0,-1,-1,1,0,-1,-2,-1
"12450",2021-03-04,"Gothic Rd","w2021","Mechanized",1,"Thu","weekday","no_sled","East River",NA,NA,NA,9.2,NA,36,0,28,25.6,0,-1,-1,1,0,-1,-2,-1
"12451",2021-03-04,"Gothic Rd","w2021","Motorized",0,"Thu","weekday","sled","East River",NA,NA,NA,9.2,NA,36,0,28,25.6,0,-1,-1,1,0,-1,-2,-1
"12452",2021-03-04,"Gothic Rd","w2021","Hybrid",0,"Thu","weekday","sled","East River",NA,NA,NA,9.2,NA,36,0,28,25.6,0,-1,-1,1,0,-1,-2,-1
"12453",2021-03-05,"Gothic Rd","w2021","Non.motorized",52,"Fri","weekday","no_sled","East River",NA,NA,NA,9.4,NA,39,3,30,24.1,0,0,-1,-1,3,3,2,1
"12454",2021-03-05,"Gothic Rd","w2021","Mechanized",2,"Fri","weekday","no_sled","East River",NA,NA,NA,9.4,NA,39,3,30,24.1,0,0,-1,-1,3,3,2,1
"12455",2021-03-05,"Gothic Rd","w2021","Motorized",0,"Fri","weekday","sled","East River",NA,NA,NA,9.4,NA,39,3,30,24.1,0,0,-1,-1,3,3,2,1
"12456",2021-03-05,"Gothic Rd","w2021","Hybrid",1,"Fri","weekday","sled","East River",NA,NA,NA,9.4,NA,39,3,30,24.1,0,0,-1,-1,3,3,2,1
"12457",2021-03-06,"Gothic Rd","w2021","Non.motorized",47,"Sat","weekend","no_sled","East River",NA,NA,NA,9.4,NA,38,-1,32,24.7,3,0,0,-1,2,2,2,1
"12458",2021-03-06,"Gothic Rd","w2021","Mechanized",6,"Sat","weekend","no_sled","East River",NA,NA,NA,9.4,NA,38,-1,32,24.7,3,0,0,-1,2,2,2,1
"12459",2021-03-06,"Gothic Rd","w2021","Motorized",0,"Sat","weekend","sled","East River",NA,NA,NA,9.4,NA,38,-1,32,24.7,3,0,0,-1,2,2,2,1
"12460",2021-03-06,"Gothic Rd","w2021","Hybrid",0,"Sat","weekend","sled","East River",NA,NA,NA,9.4,NA,38,-1,32,24.7,3,0,0,-1,2,2,2,1
"12461",2021-03-07,"Gothic Rd","w2021","Non.motorized",31,"Sun","weekend","no_sled","East River",NA,NA,NA,9.4,NA,37,-1,35,25.4,-1,3,0,0,-2,1,1,1
"12462",2021-03-07,"Gothic Rd","w2021","Mechanized",3,"Sun","weekend","no_sled","East River",NA,NA,NA,9.4,NA,37,-1,35,25.4,-1,3,0,0,-2,1,1,1
"12463",2021-03-07,"Gothic Rd","w2021","Motorized",0,"Sun","weekend","sled","East River",NA,NA,NA,9.4,NA,37,-1,35,25.4,-1,3,0,0,-2,1,1,1
"12464",2021-03-07,"Gothic Rd","w2021","Hybrid",1,"Sun","weekend","sled","East River",NA,NA,NA,9.4,NA,37,-1,35,25.4,-1,3,0,0,-2,1,1,1
"12465",2021-03-08,"Gothic Rd","w2021","Non.motorized",7,"Mon","weekday","no_sled","East River",NA,NA,NA,9.5,NA,37,0,33,25.7,-1,-1,3,0,-1,-2,1,1
"12466",2021-03-08,"Gothic Rd","w2021","Mechanized",2,"Mon","weekday","no_sled","East River",NA,NA,NA,9.5,NA,37,0,33,25.7,-1,-1,3,0,-1,-2,1,1
"12467",2021-03-08,"Gothic Rd","w2021","Motorized",0,"Mon","weekday","sled","East River",NA,NA,NA,9.5,NA,37,0,33,25.7,-1,-1,3,0,-1,-2,1,1
"12468",2021-03-08,"Gothic Rd","w2021","Hybrid",0,"Mon","weekday","sled","East River",NA,NA,NA,9.5,NA,37,0,33,25.7,-1,-1,3,0,-1,-2,1,1
"12469",2021-03-09,"Gothic Rd","w2021","Non.motorized",27,"Tue","weekday","no_sled","East River",NA,NA,NA,9.5,NA,37,0,33,25.7,0,-1,-1,3,0,-1,-2,1
"12470",2021-03-09,"Gothic Rd","w2021","Mechanized",4,"Tue","weekday","no_sled","East River",NA,NA,NA,9.5,NA,37,0,33,25.7,0,-1,-1,3,0,-1,-2,1
"12471",2021-03-09,"Gothic Rd","w2021","Motorized",0,"Tue","weekday","sled","East River",NA,NA,NA,9.5,NA,37,0,33,25.7,0,-1,-1,3,0,-1,-2,1
"12472",2021-03-09,"Gothic Rd","w2021","Hybrid",0,"Tue","weekday","sled","East River",NA,NA,NA,9.5,NA,37,0,33,25.7,0,-1,-1,3,0,-1,-2,1
"12473",2021-03-10,"Gothic Rd","w2021","Non.motorized",17,"Wed","weekday","no_sled","East River",NA,NA,NA,9.7,NA,39,2,21,24.9,0,0,-1,-1,2,2,1,0
"12474",2021-03-10,"Gothic Rd","w2021","Mechanized",2,"Wed","weekday","no_sled","East River",NA,NA,NA,9.7,NA,39,2,21,24.9,0,0,-1,-1,2,2,1,0
"12475",2021-03-10,"Gothic Rd","w2021","Motorized",0,"Wed","weekday","sled","East River",NA,NA,NA,9.7,NA,39,2,21,24.9,0,0,-1,-1,2,2,1,0
"12476",2021-03-10,"Gothic Rd","w2021","Hybrid",0,"Wed","weekday","sled","East River",NA,NA,NA,9.7,NA,39,2,21,24.9,0,0,-1,-1,2,2,1,0
"12477",2021-03-11,"Gothic Rd","w2021","Non.motorized",24,"Thu","weekday","no_sled","East River",NA,NA,NA,9.8,NA,40,1,22,24.5,2,0,0,-1,3,3,3,2
"12478",2021-03-11,"Gothic Rd","w2021","Mechanized",0,"Thu","weekday","no_sled","East River",NA,NA,NA,9.8,NA,40,1,22,24.5,2,0,0,-1,3,3,3,2
"12479",2021-03-11,"Gothic Rd","w2021","Motorized",0,"Thu","weekday","sled","East River",NA,NA,NA,9.8,NA,40,1,22,24.5,2,0,0,-1,3,3,3,2
"12480",2021-03-11,"Gothic Rd","w2021","Hybrid",1,"Thu","weekday","sled","East River",NA,NA,NA,9.8,NA,40,1,22,24.5,2,0,0,-1,3,3,3,2
"12481",2021-03-12,"Gothic Rd","w2021","Non.motorized",26,"Fri","weekday","no_sled","East River",NA,NA,NA,9.8,NA,39,-1,29,25.1,1,2,0,0,0,2,2,2
"12482",2021-03-12,"Gothic Rd","w2021","Mechanized",4,"Fri","weekday","no_sled","East River",NA,NA,NA,9.8,NA,39,-1,29,25.1,1,2,0,0,0,2,2,2
"12483",2021-03-12,"Gothic Rd","w2021","Motorized",0,"Fri","weekday","sled","East River",NA,NA,NA,9.8,NA,39,-1,29,25.1,1,2,0,0,0,2,2,2
"12484",2021-03-12,"Gothic Rd","w2021","Hybrid",0,"Fri","weekday","sled","East River",NA,NA,NA,9.8,NA,39,-1,29,25.1,1,2,0,0,0,2,2,2
"12485",2021-03-13,"Gothic Rd","w2021","Non.motorized",37,"Sat","weekend","no_sled","East River",NA,NA,NA,9.8,NA,38,-1,27,25.8,-1,1,2,0,-2,-1,1,1
"12486",2021-03-13,"Gothic Rd","w2021","Mechanized",1,"Sat","weekend","no_sled","East River",NA,NA,NA,9.8,NA,38,-1,27,25.8,-1,1,2,0,-2,-1,1,1
"12487",2021-03-13,"Gothic Rd","w2021","Motorized",0,"Sat","weekend","sled","East River",NA,NA,NA,9.8,NA,38,-1,27,25.8,-1,1,2,0,-2,-1,1,1
"12488",2021-03-13,"Gothic Rd","w2021","Hybrid",0,"Sat","weekend","sled","East River",NA,NA,NA,9.8,NA,38,-1,27,25.8,-1,1,2,0,-2,-1,1,1
"12489",2021-03-14,"Gothic Rd","w2021","Non.motorized",17,"Sun","weekend","no_sled","East River",NA,NA,NA,10.2,NA,42,4,23,24.3,-1,-1,1,2,3,2,3,5
"12490",2021-03-14,"Gothic Rd","w2021","Mechanized",0,"Sun","weekend","no_sled","East River",NA,NA,NA,10.2,NA,42,4,23,24.3,-1,-1,1,2,3,2,3,5
"12491",2021-03-14,"Gothic Rd","w2021","Motorized",0,"Sun","weekend","sled","East River",NA,NA,NA,10.2,NA,42,4,23,24.3,-1,-1,1,2,3,2,3,5
"12492",2021-03-14,"Gothic Rd","w2021","Hybrid",0,"Sun","weekend","sled","East River",NA,NA,NA,10.2,NA,42,4,23,24.3,-1,-1,1,2,3,2,3,5
"12493",2021-03-15,"Gothic Rd","w2021","Non.motorized",17,"Mon","weekday","no_sled","East River",NA,NA,NA,10.2,NA,41,-1,26,24.9,4,-1,-1,1,3,2,1,2
"12494",2021-03-15,"Gothic Rd","w2021","Mechanized",2,"Mon","weekday","no_sled","East River",NA,NA,NA,10.2,NA,41,-1,26,24.9,4,-1,-1,1,3,2,1,2
"12495",2021-03-15,"Gothic Rd","w2021","Motorized",0,"Mon","weekday","sled","East River",NA,NA,NA,10.2,NA,41,-1,26,24.9,4,-1,-1,1,3,2,1,2
"12496",2021-03-15,"Gothic Rd","w2021","Hybrid",0,"Mon","weekday","sled","East River",NA,NA,NA,10.2,NA,41,-1,26,24.9,4,-1,-1,1,3,2,1,2
"12497",2021-03-16,"Gothic Rd","w2021","Non.motorized",24,"Tue","weekday","no_sled","East River",NA,NA,NA,10.3,NA,40,-1,26,25.8,-1,4,-1,-1,-2,2,1,0
"12498",2021-03-16,"Gothic Rd","w2021","Mechanized",2,"Tue","weekday","no_sled","East River",NA,NA,NA,10.3,NA,40,-1,26,25.8,-1,4,-1,-1,-2,2,1,0
"12499",2021-03-16,"Gothic Rd","w2021","Motorized",0,"Tue","weekday","sled","East River",NA,NA,NA,10.3,NA,40,-1,26,25.8,-1,4,-1,-1,-2,2,1,0
"12500",2021-03-16,"Gothic Rd","w2021","Hybrid",0,"Tue","weekday","sled","East River",NA,NA,NA,10.3,NA,40,-1,26,25.8,-1,4,-1,-1,-2,2,1,0
"12501",2021-03-17,"Gothic Rd","w2021","Non.motorized",9,"Wed","weekday","no_sled","East River",NA,NA,NA,10.3,NA,41,1,25,25.1,-1,-1,4,-1,0,-1,3,2
"12502",2021-03-17,"Gothic Rd","w2021","Mechanized",0,"Wed","weekday","no_sled","East River",NA,NA,NA,10.3,NA,41,1,25,25.1,-1,-1,4,-1,0,-1,3,2
"12503",2021-03-17,"Gothic Rd","w2021","Motorized",0,"Wed","weekday","sled","East River",NA,NA,NA,10.3,NA,41,1,25,25.1,-1,-1,4,-1,0,-1,3,2
"12504",2021-03-17,"Gothic Rd","w2021","Hybrid",0,"Wed","weekday","sled","East River",NA,NA,NA,10.3,NA,41,1,25,25.1,-1,-1,4,-1,0,-1,3,2
"12505",2021-03-18,"Gothic Rd","w2021","Non.motorized",26,"Thu","weekday","no_sled","East River",NA,NA,NA,10.3,NA,40,-1,29,25.8,1,-1,-1,4,0,-1,-2,2
"12506",2021-03-18,"Gothic Rd","w2021","Mechanized",0,"Thu","weekday","no_sled","East River",NA,NA,NA,10.3,NA,40,-1,29,25.8,1,-1,-1,4,0,-1,-2,2
"12507",2021-03-18,"Gothic Rd","w2021","Motorized",0,"Thu","weekday","sled","East River",NA,NA,NA,10.3,NA,40,-1,29,25.8,1,-1,-1,4,0,-1,-2,2
"12508",2021-03-18,"Gothic Rd","w2021","Hybrid",0,"Thu","weekday","sled","East River",NA,NA,NA,10.3,NA,40,-1,29,25.8,1,-1,-1,4,0,-1,-2,2
"12509",2021-03-19,"Gothic Rd","w2021","Non.motorized",38,"Fri","weekday","no_sled","East River",NA,NA,NA,10.3,NA,40,0,36,25.8,-1,1,-1,-1,-1,0,-1,-2
"12510",2021-03-19,"Gothic Rd","w2021","Mechanized",2,"Fri","weekday","no_sled","East River",NA,NA,NA,10.3,NA,40,0,36,25.8,-1,1,-1,-1,-1,0,-1,-2
"12511",2021-03-19,"Gothic Rd","w2021","Motorized",0,"Fri","weekday","sled","East River",NA,NA,NA,10.3,NA,40,0,36,25.8,-1,1,-1,-1,-1,0,-1,-2
"12512",2021-03-19,"Gothic Rd","w2021","Hybrid",0,"Fri","weekday","sled","East River",NA,NA,NA,10.3,NA,40,0,36,25.8,-1,1,-1,-1,-1,0,-1,-2
"12513",2021-03-20,"Gothic Rd","w2021","Non.motorized",23,"Sat","weekend","no_sled","East River",NA,NA,NA,10.4,NA,39,-1,37,26.7,0,-1,1,-1,-1,-2,-1,-2
"12514",2021-03-20,"Gothic Rd","w2021","Mechanized",2,"Sat","weekend","no_sled","East River",NA,NA,NA,10.4,NA,39,-1,37,26.7,0,-1,1,-1,-1,-2,-1,-2
"12515",2021-03-20,"Gothic Rd","w2021","Motorized",0,"Sat","weekend","sled","East River",NA,NA,NA,10.4,NA,39,-1,37,26.7,0,-1,1,-1,-1,-2,-1,-2
"12516",2021-03-20,"Gothic Rd","w2021","Hybrid",0,"Sat","weekend","sled","East River",NA,NA,NA,10.4,NA,39,-1,37,26.7,0,-1,1,-1,-1,-2,-1,-2
"12517",2021-03-21,"Gothic Rd","w2021","Non.motorized",19,"Sun","weekend","no_sled","East River",NA,NA,NA,10.4,NA,38,-1,28,27.4,-1,0,-1,1,-2,-2,-3,-2
"12518",2021-03-21,"Gothic Rd","w2021","Mechanized",1,"Sun","weekend","no_sled","East River",NA,NA,NA,10.4,NA,38,-1,28,27.4,-1,0,-1,1,-2,-2,-3,-2
"12519",2021-03-21,"Gothic Rd","w2021","Motorized",0,"Sun","weekend","sled","East River",NA,NA,NA,10.4,NA,38,-1,28,27.4,-1,0,-1,1,-2,-2,-3,-2
"12520",2021-03-21,"Gothic Rd","w2021","Hybrid",0,"Sun","weekend","sled","East River",NA,NA,NA,10.4,NA,38,-1,28,27.4,-1,0,-1,1,-2,-2,-3,-2
"12521",2021-03-22,"Gothic Rd","w2021","Non.motorized",23,"Mon","weekday","no_sled","East River",NA,NA,NA,10.5,NA,41,3,26,25.6,-1,-1,0,-1,2,1,1,0
"12522",2021-03-22,"Gothic Rd","w2021","Mechanized",0,"Mon","weekday","no_sled","East River",NA,NA,NA,10.5,NA,41,3,26,25.6,-1,-1,0,-1,2,1,1,0
"12523",2021-03-22,"Gothic Rd","w2021","Motorized",1,"Mon","weekday","sled","East River",NA,NA,NA,10.5,NA,41,3,26,25.6,-1,-1,0,-1,2,1,1,0
"12524",2021-03-22,"Gothic Rd","w2021","Hybrid",0,"Mon","weekday","sled","East River",NA,NA,NA,10.5,NA,41,3,26,25.6,-1,-1,0,-1,2,1,1,0
"12525",2021-03-23,"Gothic Rd","w2021","Non.motorized",14,"Tue","weekday","no_sled","East River",NA,NA,NA,10.6,NA,41,0,24,25.9,3,-1,-1,0,3,2,1,1
"12526",2021-03-23,"Gothic Rd","w2021","Mechanized",0,"Tue","weekday","no_sled","East River",NA,NA,NA,10.6,NA,41,0,24,25.9,3,-1,-1,0,3,2,1,1
"12527",2021-03-23,"Gothic Rd","w2021","Motorized",0,"Tue","weekday","sled","East River",NA,NA,NA,10.6,NA,41,0,24,25.9,3,-1,-1,0,3,2,1,1
"12528",2021-03-23,"Gothic Rd","w2021","Hybrid",0,"Tue","weekday","sled","East River",NA,NA,NA,10.6,NA,41,0,24,25.9,3,-1,-1,0,3,2,1,1
"12529",2021-03-24,"Gothic Rd","w2021","Non.motorized",32,"Wed","weekday","no_sled","East River",NA,NA,NA,10.8,NA,41,0,24,26.3,0,3,-1,-1,0,3,2,1
"12530",2021-03-24,"Gothic Rd","w2021","Mechanized",2,"Wed","weekday","no_sled","East River",NA,NA,NA,10.8,NA,41,0,24,26.3,0,3,-1,-1,0,3,2,1
"12531",2021-03-24,"Gothic Rd","w2021","Motorized",0,"Wed","weekday","sled","East River",NA,NA,NA,10.8,NA,41,0,24,26.3,0,3,-1,-1,0,3,2,1
"12532",2021-03-24,"Gothic Rd","w2021","Hybrid",0,"Wed","weekday","sled","East River",NA,NA,NA,10.8,NA,41,0,24,26.3,0,3,-1,-1,0,3,2,1
"12533",2021-03-25,"Gothic Rd","w2021","Non.motorized",32,"Thu","weekday","no_sled","East River",NA,NA,NA,10.9,NA,43,2,23,25.3,0,0,3,-1,2,2,5,4
"12534",2021-03-25,"Gothic Rd","w2021","Mechanized",0,"Thu","weekday","no_sled","East River",NA,NA,NA,10.9,NA,43,2,23,25.3,0,0,3,-1,2,2,5,4
"12535",2021-03-25,"Gothic Rd","w2021","Motorized",0,"Thu","weekday","sled","East River",NA,NA,NA,10.9,NA,43,2,23,25.3,0,0,3,-1,2,2,5,4
"12536",2021-03-25,"Gothic Rd","w2021","Hybrid",0,"Thu","weekday","sled","East River",NA,NA,NA,10.9,NA,43,2,23,25.3,0,0,3,-1,2,2,5,4
"12537",2021-03-26,"Gothic Rd","w2021","Non.motorized",26,"Fri","weekday","no_sled","East River",NA,NA,NA,11,NA,44,1,23,25,2,0,0,3,3,3,3,6
"12538",2021-03-26,"Gothic Rd","w2021","Mechanized",0,"Fri","weekday","no_sled","East River",NA,NA,NA,11,NA,44,1,23,25,2,0,0,3,3,3,3,6
"12539",2021-03-26,"Gothic Rd","w2021","Motorized",5,"Fri","weekday","sled","East River",NA,NA,NA,11,NA,44,1,23,25,2,0,0,3,3,3,3,6
"12540",2021-03-26,"Gothic Rd","w2021","Hybrid",0,"Fri","weekday","sled","East River",NA,NA,NA,11,NA,44,1,23,25,2,0,0,3,3,3,3,6
"12541",2021-03-27,"Gothic Rd","w2021","Non.motorized",43,"Sat","weekend","no_sled","East River",NA,NA,NA,11,NA,42,-2,25,26.2,1,2,0,0,-1,1,1,1
"12542",2021-03-27,"Gothic Rd","w2021","Mechanized",4,"Sat","weekend","no_sled","East River",NA,NA,NA,11,NA,42,-2,25,26.2,1,2,0,0,-1,1,1,1
"12543",2021-03-27,"Gothic Rd","w2021","Motorized",0,"Sat","weekend","sled","East River",NA,NA,NA,11,NA,42,-2,25,26.2,1,2,0,0,-1,1,1,1
"12544",2021-03-27,"Gothic Rd","w2021","Hybrid",0,"Sat","weekend","sled","East River",NA,NA,NA,11,NA,42,-2,25,26.2,1,2,0,0,-1,1,1,1
"12545",2021-03-28,"Gothic Rd","w2021","Non.motorized",27,"Sun","weekend","no_sled","East River",NA,NA,NA,11,NA,42,0,31,26.2,-2,1,2,0,-2,-1,1,1
"12546",2021-03-28,"Gothic Rd","w2021","Mechanized",3,"Sun","weekend","no_sled","East River",NA,NA,NA,11,NA,42,0,31,26.2,-2,1,2,0,-2,-1,1,1
"12547",2021-03-28,"Gothic Rd","w2021","Motorized",0,"Sun","weekend","sled","East River",NA,NA,NA,11,NA,42,0,31,26.2,-2,1,2,0,-2,-1,1,1
"12548",2021-03-28,"Gothic Rd","w2021","Hybrid",0,"Sun","weekend","sled","East River",NA,NA,NA,11,NA,42,0,31,26.2,-2,1,2,0,-2,-1,1,1
"12549",2021-03-29,"Gothic Rd","w2021","Non.motorized",14,"Mon","weekday","no_sled","East River",NA,NA,NA,11.1,NA,40,-2,37,27.8,0,-2,1,2,-2,-4,-3,-1
"12550",2021-03-29,"Gothic Rd","w2021","Mechanized",0,"Mon","weekday","no_sled","East River",NA,NA,NA,11.1,NA,40,-2,37,27.8,0,-2,1,2,-2,-4,-3,-1
"12551",2021-03-29,"Gothic Rd","w2021","Motorized",0,"Mon","weekday","sled","East River",NA,NA,NA,11.1,NA,40,-2,37,27.8,0,-2,1,2,-2,-4,-3,-1
"12552",2021-03-29,"Gothic Rd","w2021","Hybrid",0,"Mon","weekday","sled","East River",NA,NA,NA,11.1,NA,40,-2,37,27.8,0,-2,1,2,-2,-4,-3,-1
"12553",2021-03-30,"Gothic Rd","w2021","Non.motorized",12,"Tue","weekday","no_sled","East River",NA,NA,NA,11.1,NA,39,-1,23,28.5,-2,0,-2,1,-3,-3,-5,-4
"12554",2021-03-30,"Gothic Rd","w2021","Mechanized",2,"Tue","weekday","no_sled","East River",NA,NA,NA,11.1,NA,39,-1,23,28.5,-2,0,-2,1,-3,-3,-5,-4
"12555",2021-03-30,"Gothic Rd","w2021","Motorized",0,"Tue","weekday","sled","East River",NA,NA,NA,11.1,NA,39,-1,23,28.5,-2,0,-2,1,-3,-3,-5,-4
"12556",2021-03-30,"Gothic Rd","w2021","Hybrid",0,"Tue","weekday","sled","East River",NA,NA,NA,11.1,NA,39,-1,23,28.5,-2,0,-2,1,-3,-3,-5,-4
"12557",2021-03-31,"Gothic Rd","w2021","Non.motorized",15,"Wed","weekday","no_sled","East River",NA,NA,NA,11.1,NA,39,0,26,28.5,-1,-2,0,-2,-1,-3,-3,-5
"12558",2021-03-31,"Gothic Rd","w2021","Mechanized",0,"Wed","weekday","no_sled","East River",NA,NA,NA,11.1,NA,39,0,26,28.5,-1,-2,0,-2,-1,-3,-3,-5
"12559",2021-03-31,"Gothic Rd","w2021","Motorized",0,"Wed","weekday","sled","East River",NA,NA,NA,11.1,NA,39,0,26,28.5,-1,-2,0,-2,-1,-3,-3,-5
"12560",2021-03-31,"Gothic Rd","w2021","Hybrid",0,"Wed","weekday","sled","East River",NA,NA,NA,11.1,NA,39,0,26,28.5,-1,-2,0,-2,-1,-3,-3,-5
"12561",2021-04-01,"Gothic Rd","w2021","Non.motorized",27,"Thu","weekday","no_sled","East River",NA,NA,NA,11.1,NA,38,-1,36,29.2,0,-1,-2,0,-1,-2,-4,-4
"12562",2021-04-01,"Gothic Rd","w2021","Mechanized",1,"Thu","weekday","no_sled","East River",NA,NA,NA,11.1,NA,38,-1,36,29.2,0,-1,-2,0,-1,-2,-4,-4
"12563",2021-04-01,"Gothic Rd","w2021","Motorized",0,"Thu","weekday","sled","East River",NA,NA,NA,11.1,NA,38,-1,36,29.2,0,-1,-2,0,-1,-2,-4,-4
"12564",2021-04-01,"Gothic Rd","w2021","Hybrid",0,"Thu","weekday","sled","East River",NA,NA,NA,11.1,NA,38,-1,36,29.2,0,-1,-2,0,-1,-2,-4,-4
"12565",2021-04-02,"Gothic Rd","w2021","Non.motorized",23,"Fri","weekday","no_sled","East River",NA,NA,NA,11.1,NA,37,-1,42,30,-1,0,-1,-2,-2,-2,-3,-5
"12566",2021-04-02,"Gothic Rd","w2021","Mechanized",0,"Fri","weekday","no_sled","East River",NA,NA,NA,11.1,NA,37,-1,42,30,-1,0,-1,-2,-2,-2,-3,-5
"12567",2021-04-02,"Gothic Rd","w2021","Motorized",0,"Fri","weekday","sled","East River",NA,NA,NA,11.1,NA,37,-1,42,30,-1,0,-1,-2,-2,-2,-3,-5
"12568",2021-04-02,"Gothic Rd","w2021","Hybrid",0,"Fri","weekday","sled","East River",NA,NA,NA,11.1,NA,37,-1,42,30,-1,0,-1,-2,-2,-2,-3,-5
"12569",2021-04-03,"Gothic Rd","w2021","Non.motorized",37,"Sat","weekend","no_sled","East River",NA,NA,NA,10.8,NA,35,-2,45,30.9,-1,-1,0,-1,-3,-4,-4,-5
"12570",2021-04-03,"Gothic Rd","w2021","Mechanized",1,"Sat","weekend","no_sled","East River",NA,NA,NA,10.8,NA,35,-2,45,30.9,-1,-1,0,-1,-3,-4,-4,-5
"12571",2021-04-03,"Gothic Rd","w2021","Motorized",0,"Sat","weekend","sled","East River",NA,NA,NA,10.8,NA,35,-2,45,30.9,-1,-1,0,-1,-3,-4,-4,-5
"12572",2021-04-03,"Gothic Rd","w2021","Hybrid",0,"Sat","weekend","sled","East River",NA,NA,NA,10.8,NA,35,-2,45,30.9,-1,-1,0,-1,-3,-4,-4,-5
"12573",2021-04-04,"Gothic Rd","w2021","Non.motorized",26,"Sun","weekend","no_sled","East River",NA,NA,NA,10.7,NA,34,-1,44,31.5,-2,-1,-1,0,-3,-4,-5,-5
"12574",2021-04-04,"Gothic Rd","w2021","Mechanized",4,"Sun","weekend","no_sled","East River",NA,NA,NA,10.7,NA,34,-1,44,31.5,-2,-1,-1,0,-3,-4,-5,-5
"12575",2021-04-04,"Gothic Rd","w2021","Motorized",0,"Sun","weekend","sled","East River",NA,NA,NA,10.7,NA,34,-1,44,31.5,-2,-1,-1,0,-3,-4,-5,-5
"12576",2021-04-04,"Gothic Rd","w2021","Hybrid",0,"Sun","weekend","sled","East River",NA,NA,NA,10.7,NA,34,-1,44,31.5,-2,-1,-1,0,-3,-4,-5,-5
"12577",2021-04-05,"Gothic Rd","w2021","Non.motorized",16,"Mon","weekday","no_sled","East River",NA,NA,NA,10.6,NA,33,-1,44,32.1,-1,-2,-1,-1,-2,-4,-5,-6
"12578",2021-04-05,"Gothic Rd","w2021","Mechanized",2,"Mon","weekday","no_sled","East River",NA,NA,NA,10.6,NA,33,-1,44,32.1,-1,-2,-1,-1,-2,-4,-5,-6
"12579",2021-04-05,"Gothic Rd","w2021","Motorized",0,"Mon","weekday","sled","East River",NA,NA,NA,10.6,NA,33,-1,44,32.1,-1,-2,-1,-1,-2,-4,-5,-6
"12580",2021-04-05,"Gothic Rd","w2021","Hybrid",0,"Mon","weekday","sled","East River",NA,NA,NA,10.6,NA,33,-1,44,32.1,-1,-2,-1,-1,-2,-4,-5,-6
"12581",2021-04-06,"Gothic Rd","w2021","Non.motorized",12,"Tue","weekday","no_sled","East River",NA,NA,NA,10.3,NA,31,-2,32,33.2,-1,-1,-2,-1,-3,-4,-6,-7
"12582",2021-04-06,"Gothic Rd","w2021","Mechanized",0,"Tue","weekday","no_sled","East River",NA,NA,NA,10.3,NA,31,-2,32,33.2,-1,-1,-2,-1,-3,-4,-6,-7
"12583",2021-04-06,"Gothic Rd","w2021","Motorized",0,"Tue","weekday","sled","East River",NA,NA,NA,10.3,NA,31,-2,32,33.2,-1,-1,-2,-1,-3,-4,-6,-7
"12584",2021-04-06,"Gothic Rd","w2021","Hybrid",0,"Tue","weekday","sled","East River",NA,NA,NA,10.3,NA,31,-2,32,33.2,-1,-1,-2,-1,-3,-4,-6,-7
"12585",2021-04-07,"Gothic Rd","w2021","Non.motorized",10,"Wed","weekday","no_sled","East River",NA,NA,NA,10,NA,31,0,33,32.3,-2,-1,-1,-2,-2,-3,-4,-6
"12586",2021-04-07,"Gothic Rd","w2021","Mechanized",4,"Wed","weekday","no_sled","East River",NA,NA,NA,10,NA,31,0,33,32.3,-2,-1,-1,-2,-2,-3,-4,-6
"12587",2021-04-07,"Gothic Rd","w2021","Motorized",0,"Wed","weekday","sled","East River",NA,NA,NA,10,NA,31,0,33,32.3,-2,-1,-1,-2,-2,-3,-4,-6
"12588",2021-04-07,"Gothic Rd","w2021","Hybrid",0,"Wed","weekday","sled","East River",NA,NA,NA,10,NA,31,0,33,32.3,-2,-1,-1,-2,-2,-3,-4,-6
"12589",2021-04-08,"Gothic Rd","w2021","Non.motorized",14,"Thu","weekday","no_sled","East River",NA,NA,NA,9.9,NA,29,-2,39,34.1,0,-2,-1,-1,-2,-4,-5,-6
"12590",2021-04-08,"Gothic Rd","w2021","Mechanized",3,"Thu","weekday","no_sled","East River",NA,NA,NA,9.9,NA,29,-2,39,34.1,0,-2,-1,-1,-2,-4,-5,-6
"12591",2021-04-08,"Gothic Rd","w2021","Motorized",0,"Thu","weekday","sled","East River",NA,NA,NA,9.9,NA,29,-2,39,34.1,0,-2,-1,-1,-2,-4,-5,-6
"12592",2021-04-08,"Gothic Rd","w2021","Hybrid",0,"Thu","weekday","sled","East River",NA,NA,NA,9.9,NA,29,-2,39,34.1,0,-2,-1,-1,-2,-4,-5,-6
"12593",2021-04-09,"Gothic Rd","w2021","Non.motorized",17,"Fri","weekday","no_sled","East River",NA,NA,NA,9.6,NA,28,-1,33,34.3,-2,0,-2,-1,-3,-3,-5,-6
"12594",2021-04-09,"Gothic Rd","w2021","Mechanized",3,"Fri","weekday","no_sled","East River",NA,NA,NA,9.6,NA,28,-1,33,34.3,-2,0,-2,-1,-3,-3,-5,-6
"12595",2021-04-09,"Gothic Rd","w2021","Motorized",0,"Fri","weekday","sled","East River",NA,NA,NA,9.6,NA,28,-1,33,34.3,-2,0,-2,-1,-3,-3,-5,-6
"12596",2021-04-09,"Gothic Rd","w2021","Hybrid",0,"Fri","weekday","sled","East River",NA,NA,NA,9.6,NA,28,-1,33,34.3,-2,0,-2,-1,-3,-3,-5,-6
"12597",2021-04-10,"Gothic Rd","w2021","Non.motorized",21,"Sat","weekend","no_sled","East River",NA,NA,NA,9.5,NA,26,-2,37,36.5,-1,-2,0,-2,-3,-5,-5,-7
"12598",2021-04-10,"Gothic Rd","w2021","Mechanized",7,"Sat","weekend","no_sled","East River",NA,NA,NA,9.5,NA,26,-2,37,36.5,-1,-2,0,-2,-3,-5,-5,-7
"12599",2021-04-10,"Gothic Rd","w2021","Motorized",0,"Sat","weekend","sled","East River",NA,NA,NA,9.5,NA,26,-2,37,36.5,-1,-2,0,-2,-3,-5,-5,-7
"12600",2021-04-10,"Gothic Rd","w2021","Hybrid",0,"Sat","weekend","sled","East River",NA,NA,NA,9.5,NA,26,-2,37,36.5,-1,-2,0,-2,-3,-5,-5,-7
"12601",2021-04-11,"Gothic Rd","w2021","Non.motorized",27,"Sun","weekend","no_sled","East River",NA,NA,NA,9.2,NA,26,0,39,35.4,-2,-1,-2,0,-2,-3,-5,-5
"12602",2021-04-11,"Gothic Rd","w2021","Mechanized",4,"Sun","weekend","no_sled","East River",NA,NA,NA,9.2,NA,26,0,39,35.4,-2,-1,-2,0,-2,-3,-5,-5
"12603",2021-04-11,"Gothic Rd","w2021","Motorized",0,"Sun","weekend","sled","East River",NA,NA,NA,9.2,NA,26,0,39,35.4,-2,-1,-2,0,-2,-3,-5,-5
"12604",2021-04-11,"Gothic Rd","w2021","Hybrid",0,"Sun","weekend","sled","East River",NA,NA,NA,9.2,NA,26,0,39,35.4,-2,-1,-2,0,-2,-3,-5,-5
"12605",2021-04-12,"Gothic Rd","w2021","Non.motorized",10,"Mon","weekday","no_sled","East River",NA,NA,NA,8.8,NA,24,-2,38,36.7,0,-2,-1,-2,-2,-4,-5,-7
"12606",2021-04-12,"Gothic Rd","w2021","Mechanized",3,"Mon","weekday","no_sled","East River",NA,NA,NA,8.8,NA,24,-2,38,36.7,0,-2,-1,-2,-2,-4,-5,-7
"12607",2021-04-12,"Gothic Rd","w2021","Motorized",0,"Mon","weekday","sled","East River",NA,NA,NA,8.8,NA,24,-2,38,36.7,0,-2,-1,-2,-2,-4,-5,-7
"12608",2021-04-12,"Gothic Rd","w2021","Hybrid",0,"Mon","weekday","sled","East River",NA,NA,NA,8.8,NA,24,-2,38,36.7,0,-2,-1,-2,-2,-4,-5,-7
"12609",2021-04-13,"Gothic Rd","w2021","Non.motorized",7,"Tue","weekday","no_sled","East River",NA,NA,NA,8.4,NA,23,-1,35,36.5,-2,0,-2,-1,-3,-3,-5,-6
"12610",2021-04-13,"Gothic Rd","w2021","Mechanized",2,"Tue","weekday","no_sled","East River",NA,NA,NA,8.4,NA,23,-1,35,36.5,-2,0,-2,-1,-3,-3,-5,-6
"12611",2021-04-13,"Gothic Rd","w2021","Motorized",0,"Tue","weekday","sled","East River",NA,NA,NA,8.4,NA,23,-1,35,36.5,-2,0,-2,-1,-3,-3,-5,-6
"12612",2021-04-13,"Gothic Rd","w2021","Hybrid",0,"Tue","weekday","sled","East River",NA,NA,NA,8.4,NA,23,-1,35,36.5,-2,0,-2,-1,-3,-3,-5,-6
"12613",2021-04-14,"Gothic Rd","w2021","Non.motorized",11,"Wed","weekday","no_sled","East River",NA,NA,NA,8.4,NA,23,0,41,36.5,-1,-2,0,-2,-1,-3,-3,-5
"12614",2021-04-14,"Gothic Rd","w2021","Mechanized",0,"Wed","weekday","no_sled","East River",NA,NA,NA,8.4,NA,23,0,41,36.5,-1,-2,0,-2,-1,-3,-3,-5
"12615",2021-04-14,"Gothic Rd","w2021","Motorized",0,"Wed","weekday","sled","East River",NA,NA,NA,8.4,NA,23,0,41,36.5,-1,-2,0,-2,-1,-3,-3,-5
"12616",2021-04-14,"Gothic Rd","w2021","Hybrid",0,"Wed","weekday","sled","East River",NA,NA,NA,8.4,NA,23,0,41,36.5,-1,-2,0,-2,-1,-3,-3,-5
"12617",2021-04-15,"Gothic Rd","w2021","Non.motorized",10,"Thu","weekday","no_sled","East River",NA,NA,NA,8.1,NA,22,-1,33,36.8,0,-1,-2,0,-1,-2,-4,-4
"12618",2021-04-15,"Gothic Rd","w2021","Mechanized",0,"Thu","weekday","no_sled","East River",NA,NA,NA,8.1,NA,22,-1,33,36.8,0,-1,-2,0,-1,-2,-4,-4
"12619",2021-04-15,"Gothic Rd","w2021","Motorized",0,"Thu","weekday","sled","East River",NA,NA,NA,8.1,NA,22,-1,33,36.8,0,-1,-2,0,-1,-2,-4,-4
"12620",2021-04-15,"Gothic Rd","w2021","Hybrid",0,"Thu","weekday","sled","East River",NA,NA,NA,8.1,NA,22,-1,33,36.8,0,-1,-2,0,-1,-2,-4,-4
"12621",2020-12-03,"Kebler","w2021","Non.motorized",0,"Thu","weekday","no_sled","Kebler",NA,NA,NA,NA,NA,NA,NA,NA,NA,NA,NA,NA,NA,NA,NA,NA,NA
"12622",2020-12-03,"Kebler","w2021","Mechanized",2,"Thu","weekday","no_sled","Kebler",NA,NA,NA,NA,NA,NA,NA,NA,NA,NA,NA,NA,NA,NA,NA,NA,NA
"12623",2020-12-03,"Kebler","w2021","Motorized",17,"Thu","weekday","sled","Kebler",NA,NA,NA,NA,NA,NA,NA,NA,NA,NA,NA,NA,NA,NA,NA,NA,NA
"12624",2020-12-03,"Kebler","w2021","Hybrid",0,"Thu","weekday","sled","Kebler",NA,NA,NA,NA,NA,NA,NA,NA,NA,NA,NA,NA,NA,NA,NA,NA,NA
"12625",2020-12-04,"Kebler","w2021","Non.motorized",0,"Fri","weekday","no_sled","Kebler",NA,NA,NA,2.4,NA,11,0,29,21.8,0,0,0,0,0,0,0,0
"12626",2020-12-04,"Kebler","w2021","Mechanized",1,"Fri","weekday","no_sled","Kebler",NA,NA,NA,2.4,NA,11,0,29,21.8,0,0,0,0,0,0,0,0
"12627",2020-12-04,"Kebler","w2021","Motorized",5,"Fri","weekday","sled","Kebler",NA,NA,NA,2.4,NA,11,0,29,21.8,0,0,0,0,0,0,0,0
"12628",2020-12-04,"Kebler","w2021","Hybrid",0,"Fri","weekday","sled","Kebler",NA,NA,NA,2.4,NA,11,0,29,21.8,0,0,0,0,0,0,0,0
"12629",2020-12-05,"Kebler","w2021","Non.motorized",0,"Sat","weekend","no_sled","Kebler",NA,NA,NA,2.5,NA,11,0,32,22.7,0,0,0,0,0,0,0,0
"12630",2020-12-05,"Kebler","w2021","Mechanized",1,"Sat","weekend","no_sled","Kebler",NA,NA,NA,2.5,NA,11,0,32,22.7,0,0,0,0,0,0,0,0
"12631",2020-12-05,"Kebler","w2021","Motorized",12,"Sat","weekend","sled","Kebler",NA,NA,NA,2.5,NA,11,0,32,22.7,0,0,0,0,0,0,0,0
"12632",2020-12-05,"Kebler","w2021","Hybrid",0,"Sat","weekend","sled","Kebler",NA,NA,NA,2.5,NA,11,0,32,22.7,0,0,0,0,0,0,0,0
"12633",2020-12-06,"Kebler","w2021","Non.motorized",2,"Sun","weekend","no_sled","Kebler",NA,NA,NA,2.5,NA,11,0,30,22.7,0,0,0,0,0,0,0,0
"12634",2020-12-06,"Kebler","w2021","Mechanized",2,"Sun","weekend","no_sled","Kebler",NA,NA,NA,2.5,NA,11,0,30,22.7,0,0,0,0,0,0,0,0
"12635",2020-12-06,"Kebler","w2021","Motorized",9,"Sun","weekend","sled","Kebler",NA,NA,NA,2.5,NA,11,0,30,22.7,0,0,0,0,0,0,0,0
"12636",2020-12-06,"Kebler","w2021","Hybrid",0,"Sun","weekend","sled","Kebler",NA,NA,NA,2.5,NA,11,0,30,22.7,0,0,0,0,0,0,0,0
"12637",2020-12-07,"Kebler","w2021","Non.motorized",0,"Mon","weekday","no_sled","Kebler",NA,NA,NA,2.5,NA,11,0,33,22.7,0,0,0,0,0,0,0,0
"12638",2020-12-07,"Kebler","w2021","Mechanized",1,"Mon","weekday","no_sled","Kebler",NA,NA,NA,2.5,NA,11,0,33,22.7,0,0,0,0,0,0,0,0
"12639",2020-12-07,"Kebler","w2021","Motorized",5,"Mon","weekday","sled","Kebler",NA,NA,NA,2.5,NA,11,0,33,22.7,0,0,0,0,0,0,0,0
"12640",2020-12-07,"Kebler","w2021","Hybrid",0,"Mon","weekday","sled","Kebler",NA,NA,NA,2.5,NA,11,0,33,22.7,0,0,0,0,0,0,0,0
"12641",2020-12-08,"Kebler","w2021","Non.motorized",0,"Tue","weekday","no_sled","Kebler",NA,NA,NA,2.5,NA,11,0,34,22.7,0,0,0,0,0,0,0,0
"12642",2020-12-08,"Kebler","w2021","Mechanized",0,"Tue","weekday","no_sled","Kebler",NA,NA,NA,2.5,NA,11,0,34,22.7,0,0,0,0,0,0,0,0
"12643",2020-12-08,"Kebler","w2021","Motorized",0,"Tue","weekday","sled","Kebler",NA,NA,NA,2.5,NA,11,0,34,22.7,0,0,0,0,0,0,0,0
"12644",2020-12-08,"Kebler","w2021","Hybrid",0,"Tue","weekday","sled","Kebler",NA,NA,NA,2.5,NA,11,0,34,22.7,0,0,0,0,0,0,0,0
"12645",2020-12-09,"Kebler","w2021","Non.motorized",0,"Wed","weekday","no_sled","Kebler",NA,NA,NA,2.5,NA,11,0,32,22.7,0,0,0,0,0,0,0,0
"12646",2020-12-09,"Kebler","w2021","Mechanized",0,"Wed","weekday","no_sled","Kebler",NA,NA,NA,2.5,NA,11,0,32,22.7,0,0,0,0,0,0,0,0
"12647",2020-12-09,"Kebler","w2021","Motorized",0,"Wed","weekday","sled","Kebler",NA,NA,NA,2.5,NA,11,0,32,22.7,0,0,0,0,0,0,0,0
"12648",2020-12-09,"Kebler","w2021","Hybrid",0,"Wed","weekday","sled","Kebler",NA,NA,NA,2.5,NA,11,0,32,22.7,0,0,0,0,0,0,0,0
"12649",2020-12-10,"Kebler","w2021","Non.motorized",0,"Thu","weekday","no_sled","Kebler",NA,NA,NA,2.5,NA,11,0,28,22.7,0,0,0,0,0,0,0,0
"12650",2020-12-10,"Kebler","w2021","Mechanized",0,"Thu","weekday","no_sled","Kebler",NA,NA,NA,2.5,NA,11,0,28,22.7,0,0,0,0,0,0,0,0
"12651",2020-12-10,"Kebler","w2021","Motorized",0,"Thu","weekday","sled","Kebler",NA,NA,NA,2.5,NA,11,0,28,22.7,0,0,0,0,0,0,0,0
"12652",2020-12-10,"Kebler","w2021","Hybrid",0,"Thu","weekday","sled","Kebler",NA,NA,NA,2.5,NA,11,0,28,22.7,0,0,0,0,0,0,0,0
"12653",2020-12-11,"Kebler","w2021","Non.motorized",0,"Fri","weekday","no_sled","Kebler",NA,NA,NA,2.6,NA,12,1,20,21.7,0,0,0,0,1,1,1,1
"12654",2020-12-11,"Kebler","w2021","Mechanized",0,"Fri","weekday","no_sled","Kebler",NA,NA,NA,2.6,NA,12,1,20,21.7,0,0,0,0,1,1,1,1
"12655",2020-12-11,"Kebler","w2021","Motorized",16,"Fri","weekday","sled","Kebler",NA,NA,NA,2.6,NA,12,1,20,21.7,0,0,0,0,1,1,1,1
"12656",2020-12-11,"Kebler","w2021","Hybrid",0,"Fri","weekday","sled","Kebler",NA,NA,NA,2.6,NA,12,1,20,21.7,0,0,0,0,1,1,1,1
"12657",2020-12-12,"Kebler","w2021","Non.motorized",5,"Sat","weekend","no_sled","Kebler",NA,NA,NA,2.9,NA,17,5,12,17.1,1,0,0,0,6,6,6,6
"12658",2020-12-12,"Kebler","w2021","Mechanized",2,"Sat","weekend","no_sled","Kebler",NA,NA,NA,2.9,NA,17,5,12,17.1,1,0,0,0,6,6,6,6
"12659",2020-12-12,"Kebler","w2021","Motorized",31,"Sat","weekend","sled","Kebler",NA,NA,NA,2.9,NA,17,5,12,17.1,1,0,0,0,6,6,6,6
"12660",2020-12-12,"Kebler","w2021","Hybrid",3,"Sat","weekend","sled","Kebler",NA,NA,NA,2.9,NA,17,5,12,17.1,1,0,0,0,6,6,6,6
"12661",2020-12-13,"Kebler","w2021","Non.motorized",4,"Sun","weekend","no_sled","Kebler",NA,NA,NA,3.3,NA,19,2,10,17.4,5,1,0,0,7,8,8,8
"12662",2020-12-13,"Kebler","w2021","Mechanized",0,"Sun","weekend","no_sled","Kebler",NA,NA,NA,3.3,NA,19,2,10,17.4,5,1,0,0,7,8,8,8
"12663",2020-12-13,"Kebler","w2021","Motorized",82,"Sun","weekend","sled","Kebler",NA,NA,NA,3.3,NA,19,2,10,17.4,5,1,0,0,7,8,8,8
"12664",2020-12-13,"Kebler","w2021","Hybrid",10,"Sun","weekend","sled","Kebler",NA,NA,NA,3.3,NA,19,2,10,17.4,5,1,0,0,7,8,8,8
"12665",2020-12-14,"Kebler","w2021","Non.motorized",0,"Mon","weekday","no_sled","Kebler",NA,NA,NA,3.3,NA,18,-1,18,18.3,2,5,1,0,1,6,7,7
"12666",2020-12-14,"Kebler","w2021","Mechanized",0,"Mon","weekday","no_sled","Kebler",NA,NA,NA,3.3,NA,18,-1,18,18.3,2,5,1,0,1,6,7,7
"12667",2020-12-14,"Kebler","w2021","Motorized",21,"Mon","weekday","sled","Kebler",NA,NA,NA,3.3,NA,18,-1,18,18.3,2,5,1,0,1,6,7,7
"12668",2020-12-14,"Kebler","w2021","Hybrid",2,"Mon","weekday","sled","Kebler",NA,NA,NA,3.3,NA,18,-1,18,18.3,2,5,1,0,1,6,7,7
"12669",2020-12-15,"Kebler","w2021","Non.motorized",6,"Tue","weekday","no_sled","Kebler",NA,NA,NA,3.5,NA,19,1,13,18.4,-1,2,5,1,0,2,7,8
"12670",2020-12-15,"Kebler","w2021","Mechanized",0,"Tue","weekday","no_sled","Kebler",NA,NA,NA,3.5,NA,19,1,13,18.4,-1,2,5,1,0,2,7,8
"12671",2020-12-15,"Kebler","w2021","Motorized",34,"Tue","weekday","sled","Kebler",NA,NA,NA,3.5,NA,19,1,13,18.4,-1,2,5,1,0,2,7,8
"12672",2020-12-15,"Kebler","w2021","Hybrid",5,"Tue","weekday","sled","Kebler",NA,NA,NA,3.5,NA,19,1,13,18.4,-1,2,5,1,0,2,7,8
"12673",2020-12-16,"Kebler","w2021","Non.motorized",2,"Wed","weekday","no_sled","Kebler",NA,NA,NA,3.5,NA,19,0,16,18.4,1,-1,2,5,1,0,2,7
"12674",2020-12-16,"Kebler","w2021","Mechanized",1,"Wed","weekday","no_sled","Kebler",NA,NA,NA,3.5,NA,19,0,16,18.4,1,-1,2,5,1,0,2,7
"12675",2020-12-16,"Kebler","w2021","Motorized",58,"Wed","weekday","sled","Kebler",NA,NA,NA,3.5,NA,19,0,16,18.4,1,-1,2,5,1,0,2,7
"12676",2020-12-16,"Kebler","w2021","Hybrid",5,"Wed","weekday","sled","Kebler",NA,NA,NA,3.5,NA,19,0,16,18.4,1,-1,2,5,1,0,2,7
"12677",2020-12-17,"Kebler","w2021","Non.motorized",3,"Thu","weekday","no_sled","Kebler",NA,NA,NA,3.5,NA,19,0,20,18.4,0,1,-1,2,0,1,0,2
"12678",2020-12-17,"Kebler","w2021","Mechanized",0,"Thu","weekday","no_sled","Kebler",NA,NA,NA,3.5,NA,19,0,20,18.4,0,1,-1,2,0,1,0,2
"12679",2020-12-17,"Kebler","w2021","Motorized",77,"Thu","weekday","sled","Kebler",NA,NA,NA,3.5,NA,19,0,20,18.4,0,1,-1,2,0,1,0,2
"12680",2020-12-17,"Kebler","w2021","Hybrid",0,"Thu","weekday","sled","Kebler",NA,NA,NA,3.5,NA,19,0,20,18.4,0,1,-1,2,0,1,0,2
"12681",2020-12-18,"Kebler","w2021","Non.motorized",5,"Fri","weekday","no_sled","Kebler",NA,NA,NA,3.8,NA,22,3,20,17.3,0,0,1,-1,3,3,4,3
"12682",2020-12-18,"Kebler","w2021","Mechanized",0,"Fri","weekday","no_sled","Kebler",NA,NA,NA,3.8,NA,22,3,20,17.3,0,0,1,-1,3,3,4,3
"12683",2020-12-18,"Kebler","w2021","Motorized",33,"Fri","weekday","sled","Kebler",NA,NA,NA,3.8,NA,22,3,20,17.3,0,0,1,-1,3,3,4,3
"12684",2020-12-18,"Kebler","w2021","Hybrid",10,"Fri","weekday","sled","Kebler",NA,NA,NA,3.8,NA,22,3,20,17.3,0,0,1,-1,3,3,4,3
"12685",2020-12-19,"Kebler","w2021","Non.motorized",8,"Sat","weekend","no_sled","Kebler",NA,NA,NA,3.9,NA,22,0,17,17.7,3,0,0,1,3,3,3,4
"12686",2020-12-19,"Kebler","w2021","Mechanized",0,"Sat","weekend","no_sled","Kebler",NA,NA,NA,3.9,NA,22,0,17,17.7,3,0,0,1,3,3,3,4
"12687",2020-12-19,"Kebler","w2021","Motorized",108,"Sat","weekend","sled","Kebler",NA,NA,NA,3.9,NA,22,0,17,17.7,3,0,0,1,3,3,3,4
"12688",2020-12-19,"Kebler","w2021","Hybrid",8,"Sat","weekend","sled","Kebler",NA,NA,NA,3.9,NA,22,0,17,17.7,3,0,0,1,3,3,3,4
"12689",2020-12-20,"Kebler","w2021","Non.motorized",8,"Sun","weekend","no_sled","Kebler",NA,NA,NA,3.9,NA,21,-1,26,18.6,0,3,0,0,-1,2,2,2
"12690",2020-12-20,"Kebler","w2021","Mechanized",0,"Sun","weekend","no_sled","Kebler",NA,NA,NA,3.9,NA,21,-1,26,18.6,0,3,0,0,-1,2,2,2
"12691",2020-12-20,"Kebler","w2021","Motorized",127,"Sun","weekend","sled","Kebler",NA,NA,NA,3.9,NA,21,-1,26,18.6,0,3,0,0,-1,2,2,2
"12692",2020-12-20,"Kebler","w2021","Hybrid",5,"Sun","weekend","sled","Kebler",NA,NA,NA,3.9,NA,21,-1,26,18.6,0,3,0,0,-1,2,2,2
"12693",2020-12-21,"Kebler","w2021","Non.motorized",1,"Mon","weekday","no_sled","Kebler",NA,NA,NA,3.9,NA,20,-1,28,19.5,-1,0,3,0,-2,-2,1,1
"12694",2020-12-21,"Kebler","w2021","Mechanized",1,"Mon","weekday","no_sled","Kebler",NA,NA,NA,3.9,NA,20,-1,28,19.5,-1,0,3,0,-2,-2,1,1
"12695",2020-12-21,"Kebler","w2021","Motorized",132,"Mon","weekday","sled","Kebler",NA,NA,NA,3.9,NA,20,-1,28,19.5,-1,0,3,0,-2,-2,1,1
"12696",2020-12-21,"Kebler","w2021","Hybrid",3,"Mon","weekday","sled","Kebler",NA,NA,NA,3.9,NA,20,-1,28,19.5,-1,0,3,0,-2,-2,1,1
"12697",2020-12-22,"Kebler","w2021","Non.motorized",1,"Tue","weekday","no_sled","Kebler",NA,NA,NA,4,NA,20,0,24,20,-1,-1,0,3,-1,-2,-2,1
"12698",2020-12-22,"Kebler","w2021","Mechanized",0,"Tue","weekday","no_sled","Kebler",NA,NA,NA,4,NA,20,0,24,20,-1,-1,0,3,-1,-2,-2,1
"12699",2020-12-22,"Kebler","w2021","Motorized",112,"Tue","weekday","sled","Kebler",NA,NA,NA,4,NA,20,0,24,20,-1,-1,0,3,-1,-2,-2,1
"12700",2020-12-22,"Kebler","w2021","Hybrid",1,"Tue","weekday","sled","Kebler",NA,NA,NA,4,NA,20,0,24,20,-1,-1,0,3,-1,-2,-2,1
"12701",2020-12-23,"Kebler","w2021","Non.motorized",5,"Wed","weekday","no_sled","Kebler",NA,NA,NA,4.1,NA,22,2,6,18.6,0,-1,-1,0,2,1,0,0
"12702",2020-12-23,"Kebler","w2021","Mechanized",0,"Wed","weekday","no_sled","Kebler",NA,NA,NA,4.1,NA,22,2,6,18.6,0,-1,-1,0,2,1,0,0
"12703",2020-12-23,"Kebler","w2021","Motorized",118,"Wed","weekday","sled","Kebler",NA,NA,NA,4.1,NA,22,2,6,18.6,0,-1,-1,0,2,1,0,0
"12704",2020-12-23,"Kebler","w2021","Hybrid",1,"Wed","weekday","sled","Kebler",NA,NA,NA,4.1,NA,22,2,6,18.6,0,-1,-1,0,2,1,0,0
"12705",2020-12-24,"Kebler","w2021","Non.motorized",9,"Thu","weekday","no_sled","Kebler",NA,NA,NA,4.1,NA,21,-1,15,19.5,2,0,-1,-1,1,1,0,-1
"12706",2020-12-24,"Kebler","w2021","Mechanized",1,"Thu","weekday","no_sled","Kebler",NA,NA,NA,4.1,NA,21,-1,15,19.5,2,0,-1,-1,1,1,0,-1
"12707",2020-12-24,"Kebler","w2021","Motorized",141,"Thu","weekday","sled","Kebler",NA,NA,NA,4.1,NA,21,-1,15,19.5,2,0,-1,-1,1,1,0,-1
"12708",2020-12-24,"Kebler","w2021","Hybrid",14,"Thu","weekday","sled","Kebler",NA,NA,NA,4.1,NA,21,-1,15,19.5,2,0,-1,-1,1,1,0,-1
"12709",2020-12-25,"Kebler","w2021","Non.motorized",8,"Fri","weekday","no_sled","Kebler",NA,NA,NA,4.1,NA,20,-1,25,20.5,-1,2,0,-1,-2,0,0,-1
"12710",2020-12-25,"Kebler","w2021","Mechanized",0,"Fri","weekday","no_sled","Kebler",NA,NA,NA,4.1,NA,20,-1,25,20.5,-1,2,0,-1,-2,0,0,-1
"12711",2020-12-25,"Kebler","w2021","Motorized",164,"Fri","weekday","sled","Kebler",NA,NA,NA,4.1,NA,20,-1,25,20.5,-1,2,0,-1,-2,0,0,-1
"12712",2020-12-25,"Kebler","w2021","Hybrid",17,"Fri","weekday","sled","Kebler",NA,NA,NA,4.1,NA,20,-1,25,20.5,-1,2,0,-1,-2,0,0,-1
"12713",2020-12-26,"Kebler","w2021","Non.motorized",5,"Sat","weekend","no_sled","Kebler",NA,NA,NA,4.1,NA,20,0,26,20.5,-1,-1,2,0,-1,-2,0,0
"12714",2020-12-26,"Kebler","w2021","Mechanized",0,"Sat","weekend","no_sled","Kebler",NA,NA,NA,4.1,NA,20,0,26,20.5,-1,-1,2,0,-1,-2,0,0
"12715",2020-12-26,"Kebler","w2021","Motorized",198,"Sat","weekend","sled","Kebler",NA,NA,NA,4.1,NA,20,0,26,20.5,-1,-1,2,0,-1,-2,0,0
"12716",2020-12-26,"Kebler","w2021","Hybrid",4,"Sat","weekend","sled","Kebler",NA,NA,NA,4.1,NA,20,0,26,20.5,-1,-1,2,0,-1,-2,0,0
"12717",2020-12-27,"Kebler","w2021","Non.motorized",8,"Sun","weekend","no_sled","Kebler",NA,NA,NA,4.2,NA,19,-1,19,22.1,0,-1,-1,2,-1,-2,-3,-1
"12718",2020-12-27,"Kebler","w2021","Mechanized",0,"Sun","weekend","no_sled","Kebler",NA,NA,NA,4.2,NA,19,-1,19,22.1,0,-1,-1,2,-1,-2,-3,-1
"12719",2020-12-27,"Kebler","w2021","Motorized",172,"Sun","weekend","sled","Kebler",NA,NA,NA,4.2,NA,19,-1,19,22.1,0,-1,-1,2,-1,-2,-3,-1
"12720",2020-12-27,"Kebler","w2021","Hybrid",8,"Sun","weekend","sled","Kebler",NA,NA,NA,4.2,NA,19,-1,19,22.1,0,-1,-1,2,-1,-2,-3,-1
"12721",2020-12-28,"Kebler","w2021","Non.motorized",3,"Mon","weekday","no_sled","Kebler",NA,NA,NA,4.2,NA,20,1,22,21,-1,0,-1,-1,0,0,-1,-2
"12722",2020-12-28,"Kebler","w2021","Mechanized",1,"Mon","weekday","no_sled","Kebler",NA,NA,NA,4.2,NA,20,1,22,21,-1,0,-1,-1,0,0,-1,-2
"12723",2020-12-28,"Kebler","w2021","Motorized",142,"Mon","weekday","sled","Kebler",NA,NA,NA,4.2,NA,20,1,22,21,-1,0,-1,-1,0,0,-1,-2
"12724",2020-12-28,"Kebler","w2021","Hybrid",3,"Mon","weekday","sled","Kebler",NA,NA,NA,4.2,NA,20,1,22,21,-1,0,-1,-1,0,0,-1,-2
"12725",2020-12-29,"Kebler","w2021","Non.motorized",14,"Tue","weekday","no_sled","Kebler",NA,NA,NA,4.9,NA,27,7,15,18.1,1,-1,0,-1,8,7,7,6
"12726",2020-12-29,"Kebler","w2021","Mechanized",0,"Tue","weekday","no_sled","Kebler",NA,NA,NA,4.9,NA,27,7,15,18.1,1,-1,0,-1,8,7,7,6
"12727",2020-12-29,"Kebler","w2021","Motorized",170,"Tue","weekday","sled","Kebler",NA,NA,NA,4.9,NA,27,7,15,18.1,1,-1,0,-1,8,7,7,6
"12728",2020-12-29,"Kebler","w2021","Hybrid",3,"Tue","weekday","sled","Kebler",NA,NA,NA,4.9,NA,27,7,15,18.1,1,-1,0,-1,8,7,7,6
"12729",2020-12-30,"Kebler","w2021","Non.motorized",13,"Wed","weekday","no_sled","Kebler",NA,NA,NA,4.9,NA,26,-1,10,18.8,7,1,-1,0,6,7,6,6
"12730",2020-12-30,"Kebler","w2021","Mechanized",0,"Wed","weekday","no_sled","Kebler",NA,NA,NA,4.9,NA,26,-1,10,18.8,7,1,-1,0,6,7,6,6
"12731",2020-12-30,"Kebler","w2021","Motorized",214,"Wed","weekday","sled","Kebler",NA,NA,NA,4.9,NA,26,-1,10,18.8,7,1,-1,0,6,7,6,6
"12732",2020-12-30,"Kebler","w2021","Hybrid",9,"Wed","weekday","sled","Kebler",NA,NA,NA,4.9,NA,26,-1,10,18.8,7,1,-1,0,6,7,6,6
"12733",2020-12-31,"Kebler","w2021","Non.motorized",15,"Thu","weekday","no_sled","Kebler",NA,NA,NA,4.9,NA,25,-1,19,19.6,-1,7,1,-1,-2,5,6,5
"12734",2020-12-31,"Kebler","w2021","Mechanized",0,"Thu","weekday","no_sled","Kebler",NA,NA,NA,4.9,NA,25,-1,19,19.6,-1,7,1,-1,-2,5,6,5
"12735",2020-12-31,"Kebler","w2021","Motorized",222,"Thu","weekday","sled","Kebler",NA,NA,NA,4.9,NA,25,-1,19,19.6,-1,7,1,-1,-2,5,6,5
"12736",2020-12-31,"Kebler","w2021","Hybrid",12,"Thu","weekday","sled","Kebler",NA,NA,NA,4.9,NA,25,-1,19,19.6,-1,7,1,-1,-2,5,6,5
"12737",2021-01-01,"Kebler","w2021","Non.motorized",7,"Fri","weekday","no_sled","Kebler",NA,NA,NA,4.9,NA,24,-1,21,20.4,-1,-1,7,1,-2,-3,4,5
"12738",2021-01-01,"Kebler","w2021","Mechanized",0,"Fri","weekday","no_sled","Kebler",NA,NA,NA,4.9,NA,24,-1,21,20.4,-1,-1,7,1,-2,-3,4,5
"12739",2021-01-01,"Kebler","w2021","Motorized",200,"Fri","weekday","sled","Kebler",NA,NA,NA,4.9,NA,24,-1,21,20.4,-1,-1,7,1,-2,-3,4,5
"12740",2021-01-01,"Kebler","w2021","Hybrid",12,"Fri","weekday","sled","Kebler",NA,NA,NA,4.9,NA,24,-1,21,20.4,-1,-1,7,1,-2,-3,4,5
"12741",2021-01-02,"Kebler","w2021","Non.motorized",16,"Sat","weekend","no_sled","Kebler",NA,NA,NA,4.9,NA,23,-1,19,21.3,-1,-1,-1,7,-2,-3,-4,3
"12742",2021-01-02,"Kebler","w2021","Mechanized",1,"Sat","weekend","no_sled","Kebler",NA,NA,NA,4.9,NA,23,-1,19,21.3,-1,-1,-1,7,-2,-3,-4,3
"12743",2021-01-02,"Kebler","w2021","Motorized",197,"Sat","weekend","sled","Kebler",NA,NA,NA,4.9,NA,23,-1,19,21.3,-1,-1,-1,7,-2,-3,-4,3
"12744",2021-01-02,"Kebler","w2021","Hybrid",11,"Sat","weekend","sled","Kebler",NA,NA,NA,4.9,NA,23,-1,19,21.3,-1,-1,-1,7,-2,-3,-4,3
"12745",2021-01-03,"Kebler","w2021","Non.motorized",15,"Sun","weekend","no_sled","Kebler",NA,NA,NA,4.9,NA,23,0,21,21.3,-1,-1,-1,-1,-1,-2,-3,-4
"12746",2021-01-03,"Kebler","w2021","Mechanized",1,"Sun","weekend","no_sled","Kebler",NA,NA,NA,4.9,NA,23,0,21,21.3,-1,-1,-1,-1,-1,-2,-3,-4
"12747",2021-01-03,"Kebler","w2021","Motorized",125,"Sun","weekend","sled","Kebler",NA,NA,NA,4.9,NA,23,0,21,21.3,-1,-1,-1,-1,-1,-2,-3,-4
"12748",2021-01-03,"Kebler","w2021","Hybrid",11,"Sun","weekend","sled","Kebler",NA,NA,NA,4.9,NA,23,0,21,21.3,-1,-1,-1,-1,-1,-2,-3,-4
"12749",2021-01-04,"Kebler","w2021","Non.motorized",9,"Mon","weekday","no_sled","Kebler",NA,NA,NA,4.9,NA,22,-1,25,22.3,0,-1,-1,-1,-1,-2,-3,-4
"12750",2021-01-04,"Kebler","w2021","Mechanized",2,"Mon","weekday","no_sled","Kebler",NA,NA,NA,4.9,NA,22,-1,25,22.3,0,-1,-1,-1,-1,-2,-3,-4
"12751",2021-01-04,"Kebler","w2021","Motorized",84,"Mon","weekday","sled","Kebler",NA,NA,NA,4.9,NA,22,-1,25,22.3,0,-1,-1,-1,-1,-2,-3,-4
"12752",2021-01-04,"Kebler","w2021","Hybrid",10,"Mon","weekday","sled","Kebler",NA,NA,NA,4.9,NA,22,-1,25,22.3,0,-1,-1,-1,-1,-2,-3,-4
"12753",2021-01-05,"Kebler","w2021","Non.motorized",1,"Tue","weekday","no_sled","Kebler",NA,NA,NA,5,NA,22,0,23,22.7,-1,0,-1,-1,-1,-1,-2,-3
"12754",2021-01-05,"Kebler","w2021","Mechanized",0,"Tue","weekday","no_sled","Kebler",NA,NA,NA,5,NA,22,0,23,22.7,-1,0,-1,-1,-1,-1,-2,-3
"12755",2021-01-05,"Kebler","w2021","Motorized",54,"Tue","weekday","sled","Kebler",NA,NA,NA,5,NA,22,0,23,22.7,-1,0,-1,-1,-1,-1,-2,-3
"12756",2021-01-05,"Kebler","w2021","Hybrid",2,"Tue","weekday","sled","Kebler",NA,NA,NA,5,NA,22,0,23,22.7,-1,0,-1,-1,-1,-1,-2,-3
"12757",2021-01-06,"Kebler","w2021","Non.motorized",9,"Wed","weekday","no_sled","Kebler",NA,NA,NA,5.1,NA,24,2,18,21.2,0,-1,0,-1,2,1,1,0
"12758",2021-01-06,"Kebler","w2021","Mechanized",1,"Wed","weekday","no_sled","Kebler",NA,NA,NA,5.1,NA,24,2,18,21.2,0,-1,0,-1,2,1,1,0
"12759",2021-01-06,"Kebler","w2021","Motorized",86,"Wed","weekday","sled","Kebler",NA,NA,NA,5.1,NA,24,2,18,21.2,0,-1,0,-1,2,1,1,0
"12760",2021-01-06,"Kebler","w2021","Hybrid",7,"Wed","weekday","sled","Kebler",NA,NA,NA,5.1,NA,24,2,18,21.2,0,-1,0,-1,2,1,1,0
"12761",2021-01-07,"Kebler","w2021","Non.motorized",3,"Thu","weekday","no_sled","Kebler",NA,NA,NA,5.1,NA,24,0,23,21.2,2,0,-1,0,2,2,1,1
"12762",2021-01-07,"Kebler","w2021","Mechanized",1,"Thu","weekday","no_sled","Kebler",NA,NA,NA,5.1,NA,24,0,23,21.2,2,0,-1,0,2,2,1,1
"12763",2021-01-07,"Kebler","w2021","Motorized",108,"Thu","weekday","sled","Kebler",NA,NA,NA,5.1,NA,24,0,23,21.2,2,0,-1,0,2,2,1,1
"12764",2021-01-07,"Kebler","w2021","Hybrid",2,"Thu","weekday","sled","Kebler",NA,NA,NA,5.1,NA,24,0,23,21.2,2,0,-1,0,2,2,1,1
"12765",2021-01-08,"Kebler","w2021","Non.motorized",0,"Fri","weekday","no_sled","Kebler",NA,NA,NA,5.1,NA,23,-1,20,22.2,0,2,0,-1,-1,1,1,0
"12766",2021-01-08,"Kebler","w2021","Mechanized",1,"Fri","weekday","no_sled","Kebler",NA,NA,NA,5.1,NA,23,-1,20,22.2,0,2,0,-1,-1,1,1,0
"12767",2021-01-08,"Kebler","w2021","Motorized",53,"Fri","weekday","sled","Kebler",NA,NA,NA,5.1,NA,23,-1,20,22.2,0,2,0,-1,-1,1,1,0
"12768",2021-01-08,"Kebler","w2021","Hybrid",3,"Fri","weekday","sled","Kebler",NA,NA,NA,5.1,NA,23,-1,20,22.2,0,2,0,-1,-1,1,1,0
"12769",2021-01-09,"Kebler","w2021","Non.motorized",2,"Sat","weekend","no_sled","Kebler",NA,NA,NA,5.1,NA,23,0,19,22.2,-1,0,2,0,-1,-1,1,1
"12770",2021-01-09,"Kebler","w2021","Mechanized",1,"Sat","weekend","no_sled","Kebler",NA,NA,NA,5.1,NA,23,0,19,22.2,-1,0,2,0,-1,-1,1,1
"12771",2021-01-09,"Kebler","w2021","Motorized",123,"Sat","weekend","sled","Kebler",NA,NA,NA,5.1,NA,23,0,19,22.2,-1,0,2,0,-1,-1,1,1
"12772",2021-01-09,"Kebler","w2021","Hybrid",6,"Sat","weekend","sled","Kebler",NA,NA,NA,5.1,NA,23,0,19,22.2,-1,0,2,0,-1,-1,1,1
"12773",2021-01-10,"Kebler","w2021","Non.motorized",3,"Sun","weekend","no_sled","Kebler",NA,NA,NA,5.1,NA,23,0,14,22.2,0,-1,0,2,0,-1,-1,1
"12774",2021-01-10,"Kebler","w2021","Mechanized",0,"Sun","weekend","no_sled","Kebler",NA,NA,NA,5.1,NA,23,0,14,22.2,0,-1,0,2,0,-1,-1,1
"12775",2021-01-10,"Kebler","w2021","Motorized",77,"Sun","weekend","sled","Kebler",NA,NA,NA,5.1,NA,23,0,14,22.2,0,-1,0,2,0,-1,-1,1
"12776",2021-01-10,"Kebler","w2021","Hybrid",13,"Sun","weekend","sled","Kebler",NA,NA,NA,5.1,NA,23,0,14,22.2,0,-1,0,2,0,-1,-1,1
"12777",2021-01-11,"Kebler","w2021","Non.motorized",1,"Mon","weekday","no_sled","Kebler",NA,NA,NA,5.1,NA,23,0,15,22.2,0,0,-1,0,0,0,-1,-1
"12778",2021-01-11,"Kebler","w2021","Mechanized",0,"Mon","weekday","no_sled","Kebler",NA,NA,NA,5.1,NA,23,0,15,22.2,0,0,-1,0,0,0,-1,-1
"12779",2021-01-11,"Kebler","w2021","Motorized",30,"Mon","weekday","sled","Kebler",NA,NA,NA,5.1,NA,23,0,15,22.2,0,0,-1,0,0,0,-1,-1
"12780",2021-01-11,"Kebler","w2021","Hybrid",2,"Mon","weekday","sled","Kebler",NA,NA,NA,5.1,NA,23,0,15,22.2,0,0,-1,0,0,0,-1,-1
"12781",2021-01-12,"Kebler","w2021","Non.motorized",2,"Tue","weekday","no_sled","Kebler",NA,NA,NA,5.1,NA,23,0,23,22.2,0,0,0,-1,0,0,0,-1
"12782",2021-01-12,"Kebler","w2021","Mechanized",0,"Tue","weekday","no_sled","Kebler",NA,NA,NA,5.1,NA,23,0,23,22.2,0,0,0,-1,0,0,0,-1
"12783",2021-01-12,"Kebler","w2021","Motorized",65,"Tue","weekday","sled","Kebler",NA,NA,NA,5.1,NA,23,0,23,22.2,0,0,0,-1,0,0,0,-1
"12784",2021-01-12,"Kebler","w2021","Hybrid",7,"Tue","weekday","sled","Kebler",NA,NA,NA,5.1,NA,23,0,23,22.2,0,0,0,-1,0,0,0,-1
"12785",2021-01-13,"Kebler","w2021","Non.motorized",1,"Wed","weekday","no_sled","Kebler",NA,NA,NA,5.1,NA,23,0,28,22.2,0,0,0,0,0,0,0,0
"12786",2021-01-13,"Kebler","w2021","Mechanized",0,"Wed","weekday","no_sled","Kebler",NA,NA,NA,5.1,NA,23,0,28,22.2,0,0,0,0,0,0,0,0
"12787",2021-01-13,"Kebler","w2021","Motorized",89,"Wed","weekday","sled","Kebler",NA,NA,NA,5.1,NA,23,0,28,22.2,0,0,0,0,0,0,0,0
"12788",2021-01-13,"Kebler","w2021","Hybrid",0,"Wed","weekday","sled","Kebler",NA,NA,NA,5.1,NA,23,0,28,22.2,0,0,0,0,0,0,0,0
"12789",2021-01-14,"Kebler","w2021","Non.motorized",0,"Thu","weekday","no_sled","Kebler",NA,NA,NA,5.1,NA,22,-1,20,23.2,0,0,0,0,-1,-1,-1,-1
"12790",2021-01-14,"Kebler","w2021","Mechanized",0,"Thu","weekday","no_sled","Kebler",NA,NA,NA,5.1,NA,22,-1,20,23.2,0,0,0,0,-1,-1,-1,-1
"12791",2021-01-14,"Kebler","w2021","Motorized",52,"Thu","weekday","sled","Kebler",NA,NA,NA,5.1,NA,22,-1,20,23.2,0,0,0,0,-1,-1,-1,-1
"12792",2021-01-14,"Kebler","w2021","Hybrid",3,"Thu","weekday","sled","Kebler",NA,NA,NA,5.1,NA,22,-1,20,23.2,0,0,0,0,-1,-1,-1,-1
"12793",2021-01-15,"Kebler","w2021","Non.motorized",5,"Fri","weekday","no_sled","Kebler",NA,NA,NA,5.1,NA,22,0,26,23.2,-1,0,0,0,-1,-1,-1,-1
"12794",2021-01-15,"Kebler","w2021","Mechanized",1,"Fri","weekday","no_sled","Kebler",NA,NA,NA,5.1,NA,22,0,26,23.2,-1,0,0,0,-1,-1,-1,-1
"12795",2021-01-15,"Kebler","w2021","Motorized",82,"Fri","weekday","sled","Kebler",NA,NA,NA,5.1,NA,22,0,26,23.2,-1,0,0,0,-1,-1,-1,-1
"12796",2021-01-15,"Kebler","w2021","Hybrid",5,"Fri","weekday","sled","Kebler",NA,NA,NA,5.1,NA,22,0,26,23.2,-1,0,0,0,-1,-1,-1,-1
"12797",2021-01-16,"Kebler","w2021","Non.motorized",3,"Sat","weekend","no_sled","Kebler",NA,NA,NA,5.1,NA,22,0,26,23.2,0,-1,0,0,0,-1,-1,-1
"12798",2021-01-16,"Kebler","w2021","Mechanized",0,"Sat","weekend","no_sled","Kebler",NA,NA,NA,5.1,NA,22,0,26,23.2,0,-1,0,0,0,-1,-1,-1
"12799",2021-01-16,"Kebler","w2021","Motorized",170,"Sat","weekend","sled","Kebler",NA,NA,NA,5.1,NA,22,0,26,23.2,0,-1,0,0,0,-1,-1,-1
"12800",2021-01-16,"Kebler","w2021","Hybrid",4,"Sat","weekend","sled","Kebler",NA,NA,NA,5.1,NA,22,0,26,23.2,0,-1,0,0,0,-1,-1,-1
"12801",2021-01-17,"Kebler","w2021","Non.motorized",7,"Sun","weekend","no_sled","Kebler",NA,NA,NA,5.1,NA,22,0,29,23.2,0,0,-1,0,0,0,-1,-1
"12802",2021-01-17,"Kebler","w2021","Mechanized",1,"Sun","weekend","no_sled","Kebler",NA,NA,NA,5.1,NA,22,0,29,23.2,0,0,-1,0,0,0,-1,-1
"12803",2021-01-17,"Kebler","w2021","Motorized",118,"Sun","weekend","sled","Kebler",NA,NA,NA,5.1,NA,22,0,29,23.2,0,0,-1,0,0,0,-1,-1
"12804",2021-01-17,"Kebler","w2021","Hybrid",11,"Sun","weekend","sled","Kebler",NA,NA,NA,5.1,NA,22,0,29,23.2,0,0,-1,0,0,0,-1,-1
"12805",2021-01-18,"Kebler","w2021","Non.motorized",8,"Mon","weekday","no_sled","Kebler",NA,NA,NA,5.1,NA,22,0,24,23.2,0,0,0,-1,0,0,0,-1
"12806",2021-01-18,"Kebler","w2021","Mechanized",0,"Mon","weekday","no_sled","Kebler",NA,NA,NA,5.1,NA,22,0,24,23.2,0,0,0,-1,0,0,0,-1
"12807",2021-01-18,"Kebler","w2021","Motorized",81,"Mon","weekday","sled","Kebler",NA,NA,NA,5.1,NA,22,0,24,23.2,0,0,0,-1,0,0,0,-1
"12808",2021-01-18,"Kebler","w2021","Hybrid",3,"Mon","weekday","sled","Kebler",NA,NA,NA,5.1,NA,22,0,24,23.2,0,0,0,-1,0,0,0,-1
"12809",2021-01-19,"Kebler","w2021","Non.motorized",1,"Tue","weekday","no_sled","Kebler",NA,NA,NA,5.1,NA,22,0,19,23.2,0,0,0,0,0,0,0,0
"12810",2021-01-19,"Kebler","w2021","Mechanized",0,"Tue","weekday","no_sled","Kebler",NA,NA,NA,5.1,NA,22,0,19,23.2,0,0,0,0,0,0,0,0
"12811",2021-01-19,"Kebler","w2021","Motorized",60,"Tue","weekday","sled","Kebler",NA,NA,NA,5.1,NA,22,0,19,23.2,0,0,0,0,0,0,0,0
"12812",2021-01-19,"Kebler","w2021","Hybrid",2,"Tue","weekday","sled","Kebler",NA,NA,NA,5.1,NA,22,0,19,23.2,0,0,0,0,0,0,0,0
"12813",2021-01-20,"Kebler","w2021","Non.motorized",2,"Wed","weekday","no_sled","Kebler",NA,NA,NA,5.2,NA,23,1,26,22.6,0,0,0,0,1,1,1,1
"12814",2021-01-20,"Kebler","w2021","Mechanized",2,"Wed","weekday","no_sled","Kebler",NA,NA,NA,5.2,NA,23,1,26,22.6,0,0,0,0,1,1,1,1
"12815",2021-01-20,"Kebler","w2021","Motorized",84,"Wed","weekday","sled","Kebler",NA,NA,NA,5.2,NA,23,1,26,22.6,0,0,0,0,1,1,1,1
"12816",2021-01-20,"Kebler","w2021","Hybrid",0,"Wed","weekday","sled","Kebler",NA,NA,NA,5.2,NA,23,1,26,22.6,0,0,0,0,1,1,1,1
"12817",2021-01-21,"Kebler","w2021","Non.motorized",7,"Thu","weekday","no_sled","Kebler",NA,NA,NA,5.2,NA,23,0,26,22.6,1,0,0,0,1,1,1,1
"12818",2021-01-21,"Kebler","w2021","Mechanized",0,"Thu","weekday","no_sled","Kebler",NA,NA,NA,5.2,NA,23,0,26,22.6,1,0,0,0,1,1,1,1
"12819",2021-01-21,"Kebler","w2021","Motorized",38,"Thu","weekday","sled","Kebler",NA,NA,NA,5.2,NA,23,0,26,22.6,1,0,0,0,1,1,1,1
"12820",2021-01-21,"Kebler","w2021","Hybrid",0,"Thu","weekday","sled","Kebler",NA,NA,NA,5.2,NA,23,0,26,22.6,1,0,0,0,1,1,1,1
"12821",2021-01-22,"Kebler","w2021","Non.motorized",6,"Fri","weekday","no_sled","Kebler",NA,NA,NA,5.3,NA,25,2,25,21.2,0,1,0,0,2,3,3,3
"12822",2021-01-22,"Kebler","w2021","Mechanized",1,"Fri","weekday","no_sled","Kebler",NA,NA,NA,5.3,NA,25,2,25,21.2,0,1,0,0,2,3,3,3
"12823",2021-01-22,"Kebler","w2021","Motorized",54,"Fri","weekday","sled","Kebler",NA,NA,NA,5.3,NA,25,2,25,21.2,0,1,0,0,2,3,3,3
"12824",2021-01-22,"Kebler","w2021","Hybrid",14,"Fri","weekday","sled","Kebler",NA,NA,NA,5.3,NA,25,2,25,21.2,0,1,0,0,2,3,3,3
"12825",2021-01-23,"Kebler","w2021","Non.motorized",3,"Sat","weekend","no_sled","Kebler",NA,NA,NA,5.4,NA,26,1,22,20.8,2,0,1,0,3,3,4,4
"12826",2021-01-23,"Kebler","w2021","Mechanized",0,"Sat","weekend","no_sled","Kebler",NA,NA,NA,5.4,NA,26,1,22,20.8,2,0,1,0,3,3,4,4
"12827",2021-01-23,"Kebler","w2021","Motorized",53,"Sat","weekend","sled","Kebler",NA,NA,NA,5.4,NA,26,1,22,20.8,2,0,1,0,3,3,4,4
"12828",2021-01-23,"Kebler","w2021","Hybrid",3,"Sat","weekend","sled","Kebler",NA,NA,NA,5.4,NA,26,1,22,20.8,2,0,1,0,3,3,4,4
"12829",2021-01-24,"Kebler","w2021","Non.motorized",8,"Sun","weekend","no_sled","Kebler",NA,NA,NA,5.6,NA,29,3,18,19.3,1,2,0,1,4,6,6,7
"12830",2021-01-24,"Kebler","w2021","Mechanized",0,"Sun","weekend","no_sled","Kebler",NA,NA,NA,5.6,NA,29,3,18,19.3,1,2,0,1,4,6,6,7
"12831",2021-01-24,"Kebler","w2021","Motorized",77,"Sun","weekend","sled","Kebler",NA,NA,NA,5.6,NA,29,3,18,19.3,1,2,0,1,4,6,6,7
"12832",2021-01-24,"Kebler","w2021","Hybrid",6,"Sun","weekend","sled","Kebler",NA,NA,NA,5.6,NA,29,3,18,19.3,1,2,0,1,4,6,6,7
"12833",2021-01-25,"Kebler","w2021","Non.motorized",6,"Mon","weekday","no_sled","Kebler",NA,NA,NA,5.8,NA,29,0,15,20,3,1,2,0,3,4,6,6
"12834",2021-01-25,"Kebler","w2021","Mechanized",0,"Mon","weekday","no_sled","Kebler",NA,NA,NA,5.8,NA,29,0,15,20,3,1,2,0,3,4,6,6
"12835",2021-01-25,"Kebler","w2021","Motorized",29,"Mon","weekday","sled","Kebler",NA,NA,NA,5.8,NA,29,0,15,20,3,1,2,0,3,4,6,6
"12836",2021-01-25,"Kebler","w2021","Hybrid",7,"Mon","weekday","sled","Kebler",NA,NA,NA,5.8,NA,29,0,15,20,3,1,2,0,3,4,6,6
"12837",2021-01-26,"Kebler","w2021","Non.motorized",4,"Tue","weekday","no_sled","Kebler",NA,NA,NA,5.9,NA,29,0,13,20.3,0,3,1,2,0,3,4,6
"12838",2021-01-26,"Kebler","w2021","Mechanized",2,"Tue","weekday","no_sled","Kebler",NA,NA,NA,5.9,NA,29,0,13,20.3,0,3,1,2,0,3,4,6
"12839",2021-01-26,"Kebler","w2021","Motorized",27,"Tue","weekday","sled","Kebler",NA,NA,NA,5.9,NA,29,0,13,20.3,0,3,1,2,0,3,4,6
"12840",2021-01-26,"Kebler","w2021","Hybrid",3,"Tue","weekday","sled","Kebler",NA,NA,NA,5.9,NA,29,0,13,20.3,0,3,1,2,0,3,4,6
"12841",2021-01-27,"Kebler","w2021","Non.motorized",3,"Wed","weekday","no_sled","Kebler",NA,NA,NA,6,NA,30,1,13,20,0,0,3,1,1,1,4,5
"12842",2021-01-27,"Kebler","w2021","Mechanized",1,"Wed","weekday","no_sled","Kebler",NA,NA,NA,6,NA,30,1,13,20,0,0,3,1,1,1,4,5
"12843",2021-01-27,"Kebler","w2021","Motorized",102,"Wed","weekday","sled","Kebler",NA,NA,NA,6,NA,30,1,13,20,0,0,3,1,1,1,4,5
"12844",2021-01-27,"Kebler","w2021","Hybrid",9,"Wed","weekday","sled","Kebler",NA,NA,NA,6,NA,30,1,13,20,0,0,3,1,1,1,4,5
"12845",2021-01-28,"Kebler","w2021","Non.motorized",1,"Thu","weekday","no_sled","Kebler",NA,NA,NA,6,NA,28,-2,27,21.4,1,0,0,3,-1,-1,-1,2
"12846",2021-01-28,"Kebler","w2021","Mechanized",1,"Thu","weekday","no_sled","Kebler",NA,NA,NA,6,NA,28,-2,27,21.4,1,0,0,3,-1,-1,-1,2
"12847",2021-01-28,"Kebler","w2021","Motorized",50,"Thu","weekday","sled","Kebler",NA,NA,NA,6,NA,28,-2,27,21.4,1,0,0,3,-1,-1,-1,2
"12848",2021-01-28,"Kebler","w2021","Hybrid",4,"Thu","weekday","sled","Kebler",NA,NA,NA,6,NA,28,-2,27,21.4,1,0,0,3,-1,-1,-1,2
"12849",2021-01-29,"Kebler","w2021","Non.motorized",2,"Fri","weekday","no_sled","Kebler",NA,NA,NA,6.1,NA,28,0,29,21.8,-2,1,0,0,-2,-1,-1,-1
"12850",2021-01-29,"Kebler","w2021","Mechanized",0,"Fri","weekday","no_sled","Kebler",NA,NA,NA,6.1,NA,28,0,29,21.8,-2,1,0,0,-2,-1,-1,-1
"12851",2021-01-29,"Kebler","w2021","Motorized",116,"Fri","weekday","sled","Kebler",NA,NA,NA,6.1,NA,28,0,29,21.8,-2,1,0,0,-2,-1,-1,-1
"12852",2021-01-29,"Kebler","w2021","Hybrid",14,"Fri","weekday","sled","Kebler",NA,NA,NA,6.1,NA,28,0,29,21.8,-2,1,0,0,-2,-1,-1,-1
"12853",2021-01-30,"Kebler","w2021","Non.motorized",5,"Sat","weekend","no_sled","Kebler",NA,NA,NA,6.2,NA,29,1,21,21.4,0,-2,1,0,1,-1,0,0
"12854",2021-01-30,"Kebler","w2021","Mechanized",0,"Sat","weekend","no_sled","Kebler",NA,NA,NA,6.2,NA,29,1,21,21.4,0,-2,1,0,1,-1,0,0
"12855",2021-01-30,"Kebler","w2021","Motorized",149,"Sat","weekend","sled","Kebler",NA,NA,NA,6.2,NA,29,1,21,21.4,0,-2,1,0,1,-1,0,0
"12856",2021-01-30,"Kebler","w2021","Hybrid",18,"Sat","weekend","sled","Kebler",NA,NA,NA,6.2,NA,29,1,21,21.4,0,-2,1,0,1,-1,0,0
"12857",2021-02-01,"Kebler","w2021","Non.motorized",1,"Mon","weekday","no_sled","Kebler",NA,NA,NA,6.3,NA,28,-1,30,22.5,0,1,0,-2,-1,0,0,-2
"12858",2021-02-01,"Kebler","w2021","Mechanized",1,"Mon","weekday","no_sled","Kebler",NA,NA,NA,6.3,NA,28,-1,30,22.5,0,1,0,-2,-1,0,0,-2
"12859",2021-02-01,"Kebler","w2021","Motorized",46,"Mon","weekday","sled","Kebler",NA,NA,NA,6.3,NA,28,-1,30,22.5,0,1,0,-2,-1,0,0,-2
"12860",2021-02-01,"Kebler","w2021","Hybrid",7,"Mon","weekday","sled","Kebler",NA,NA,NA,6.3,NA,28,-1,30,22.5,0,1,0,-2,-1,0,0,-2
"12861",2021-02-02,"Kebler","w2021","Non.motorized",0,"Tue","weekday","no_sled","Kebler",NA,NA,NA,6.3,NA,28,0,34,22.5,-1,0,1,0,-1,-1,0,0
"12862",2021-02-02,"Kebler","w2021","Mechanized",0,"Tue","weekday","no_sled","Kebler",NA,NA,NA,6.3,NA,28,0,34,22.5,-1,0,1,0,-1,-1,0,0
"12863",2021-02-02,"Kebler","w2021","Motorized",73,"Tue","weekday","sled","Kebler",NA,NA,NA,6.3,NA,28,0,34,22.5,-1,0,1,0,-1,-1,0,0
"12864",2021-02-02,"Kebler","w2021","Hybrid",8,"Tue","weekday","sled","Kebler",NA,NA,NA,6.3,NA,28,0,34,22.5,-1,0,1,0,-1,-1,0,0
"12865",2021-02-03,"Kebler","w2021","Non.motorized",3,"Wed","weekday","no_sled","Kebler",NA,NA,NA,6.3,NA,27,-1,30,23.3,0,-1,0,1,-1,-2,-2,-1
"12866",2021-02-03,"Kebler","w2021","Mechanized",0,"Wed","weekday","no_sled","Kebler",NA,NA,NA,6.3,NA,27,-1,30,23.3,0,-1,0,1,-1,-2,-2,-1
"12867",2021-02-03,"Kebler","w2021","Motorized",56,"Wed","weekday","sled","Kebler",NA,NA,NA,6.3,NA,27,-1,30,23.3,0,-1,0,1,-1,-2,-2,-1
"12868",2021-02-03,"Kebler","w2021","Hybrid",2,"Wed","weekday","sled","Kebler",NA,NA,NA,6.3,NA,27,-1,30,23.3,0,-1,0,1,-1,-2,-2,-1
"12869",2021-02-04,"Kebler","w2021","Non.motorized",6,"Thu","weekday","no_sled","Kebler",NA,NA,NA,7.2,NA,37,10,14,19.5,-1,0,-1,0,9,9,8,8
"12870",2021-02-04,"Kebler","w2021","Mechanized",0,"Thu","weekday","no_sled","Kebler",NA,NA,NA,7.2,NA,37,10,14,19.5,-1,0,-1,0,9,9,8,8
"12871",2021-02-04,"Kebler","w2021","Motorized",64,"Thu","weekday","sled","Kebler",NA,NA,NA,7.2,NA,37,10,14,19.5,-1,0,-1,0,9,9,8,8
"12872",2021-02-04,"Kebler","w2021","Hybrid",9,"Thu","weekday","sled","Kebler",NA,NA,NA,7.2,NA,37,10,14,19.5,-1,0,-1,0,9,9,8,8
"12873",2021-02-05,"Kebler","w2021","Non.motorized",0,"Fri","weekday","no_sled","Kebler",NA,NA,NA,7.2,NA,35,-2,16,20.6,10,-1,0,-1,8,7,7,6
"12874",2021-02-05,"Kebler","w2021","Mechanized",0,"Fri","weekday","no_sled","Kebler",NA,NA,NA,7.2,NA,35,-2,16,20.6,10,-1,0,-1,8,7,7,6
"12875",2021-02-05,"Kebler","w2021","Motorized",101,"Fri","weekday","sled","Kebler",NA,NA,NA,7.2,NA,35,-2,16,20.6,10,-1,0,-1,8,7,7,6
"12876",2021-02-05,"Kebler","w2021","Hybrid",6,"Fri","weekday","sled","Kebler",NA,NA,NA,7.2,NA,35,-2,16,20.6,10,-1,0,-1,8,7,7,6
"12877",2021-02-06,"Kebler","w2021","Non.motorized",11,"Sat","weekend","no_sled","Kebler",NA,NA,NA,7.5,NA,37,2,19,20.3,-2,10,-1,0,0,10,9,9
"12878",2021-02-06,"Kebler","w2021","Mechanized",0,"Sat","weekend","no_sled","Kebler",NA,NA,NA,7.5,NA,37,2,19,20.3,-2,10,-1,0,0,10,9,9
"12879",2021-02-06,"Kebler","w2021","Motorized",208,"Sat","weekend","sled","Kebler",NA,NA,NA,7.5,NA,37,2,19,20.3,-2,10,-1,0,0,10,9,9
"12880",2021-02-06,"Kebler","w2021","Hybrid",19,"Sat","weekend","sled","Kebler",NA,NA,NA,7.5,NA,37,2,19,20.3,-2,10,-1,0,0,10,9,9
"12881",2021-02-07,"Kebler","w2021","Non.motorized",8,"Sun","weekend","no_sled","Kebler",NA,NA,NA,7.5,NA,36,-1,24,20.8,2,-2,10,-1,1,-1,9,8
"12882",2021-02-07,"Kebler","w2021","Mechanized",0,"Sun","weekend","no_sled","Kebler",NA,NA,NA,7.5,NA,36,-1,24,20.8,2,-2,10,-1,1,-1,9,8
"12883",2021-02-07,"Kebler","w2021","Motorized",130,"Sun","weekend","sled","Kebler",NA,NA,NA,7.5,NA,36,-1,24,20.8,2,-2,10,-1,1,-1,9,8
"12884",2021-02-07,"Kebler","w2021","Hybrid",15,"Sun","weekend","sled","Kebler",NA,NA,NA,7.5,NA,36,-1,24,20.8,2,-2,10,-1,1,-1,9,8
"12885",2021-02-08,"Kebler","w2021","Non.motorized",1,"Mon","weekday","no_sled","Kebler",NA,NA,NA,7.6,NA,35,-1,28,21.7,-1,2,-2,10,-2,0,-2,8
"12886",2021-02-08,"Kebler","w2021","Mechanized",0,"Mon","weekday","no_sled","Kebler",NA,NA,NA,7.6,NA,35,-1,28,21.7,-1,2,-2,10,-2,0,-2,8
"12887",2021-02-08,"Kebler","w2021","Motorized",85,"Mon","weekday","sled","Kebler",NA,NA,NA,7.6,NA,35,-1,28,21.7,-1,2,-2,10,-2,0,-2,8
"12888",2021-02-08,"Kebler","w2021","Hybrid",8,"Mon","weekday","sled","Kebler",NA,NA,NA,7.6,NA,35,-1,28,21.7,-1,2,-2,10,-2,0,-2,8
"12889",2021-02-09,"Kebler","w2021","Non.motorized",4,"Tue","weekday","no_sled","Kebler",NA,NA,NA,7.6,NA,34,-1,28,22.4,-1,-1,2,-2,-2,-3,-1,-3
"12890",2021-02-09,"Kebler","w2021","Mechanized",0,"Tue","weekday","no_sled","Kebler",NA,NA,NA,7.6,NA,34,-1,28,22.4,-1,-1,2,-2,-2,-3,-1,-3
"12891",2021-02-09,"Kebler","w2021","Motorized",37,"Tue","weekday","sled","Kebler",NA,NA,NA,7.6,NA,34,-1,28,22.4,-1,-1,2,-2,-2,-3,-1,-3
"12892",2021-02-09,"Kebler","w2021","Hybrid",1,"Tue","weekday","sled","Kebler",NA,NA,NA,7.6,NA,34,-1,28,22.4,-1,-1,2,-2,-2,-3,-1,-3
"12893",2021-02-10,"Kebler","w2021","Non.motorized",2,"Wed","weekday","no_sled","Kebler",NA,NA,NA,7.7,NA,34,0,26,22.6,-1,-1,-1,2,-1,-2,-3,-1
"12894",2021-02-10,"Kebler","w2021","Mechanized",0,"Wed","weekday","no_sled","Kebler",NA,NA,NA,7.7,NA,34,0,26,22.6,-1,-1,-1,2,-1,-2,-3,-1
"12895",2021-02-10,"Kebler","w2021","Motorized",59,"Wed","weekday","sled","Kebler",NA,NA,NA,7.7,NA,34,0,26,22.6,-1,-1,-1,2,-1,-2,-3,-1
"12896",2021-02-10,"Kebler","w2021","Hybrid",1,"Wed","weekday","sled","Kebler",NA,NA,NA,7.7,NA,34,0,26,22.6,-1,-1,-1,2,-1,-2,-3,-1
"12897",2021-02-11,"Kebler","w2021","Non.motorized",5,"Thu","weekday","no_sled","Kebler",NA,NA,NA,8,NA,37,3,26,21.6,0,-1,-1,-1,3,2,1,0
"12898",2021-02-11,"Kebler","w2021","Mechanized",3,"Thu","weekday","no_sled","Kebler",NA,NA,NA,8,NA,37,3,26,21.6,0,-1,-1,-1,3,2,1,0
"12899",2021-02-11,"Kebler","w2021","Motorized",77,"Thu","weekday","sled","Kebler",NA,NA,NA,8,NA,37,3,26,21.6,0,-1,-1,-1,3,2,1,0
"12900",2021-02-11,"Kebler","w2021","Hybrid",9,"Thu","weekday","sled","Kebler",NA,NA,NA,8,NA,37,3,26,21.6,0,-1,-1,-1,3,2,1,0
"12901",2021-02-12,"Kebler","w2021","Non.motorized",8,"Fri","weekday","no_sled","Kebler",NA,NA,NA,8.1,NA,37,0,27,21.9,3,0,-1,-1,3,3,2,1
"12902",2021-02-12,"Kebler","w2021","Mechanized",0,"Fri","weekday","no_sled","Kebler",NA,NA,NA,8.1,NA,37,0,27,21.9,3,0,-1,-1,3,3,2,1
"12903",2021-02-12,"Kebler","w2021","Motorized",89,"Fri","weekday","sled","Kebler",NA,NA,NA,8.1,NA,37,0,27,21.9,3,0,-1,-1,3,3,2,1
"12904",2021-02-12,"Kebler","w2021","Hybrid",6,"Fri","weekday","sled","Kebler",NA,NA,NA,8.1,NA,37,0,27,21.9,3,0,-1,-1,3,3,2,1
"12905",2021-02-13,"Kebler","w2021","Non.motorized",6,"Sat","weekend","no_sled","Kebler",NA,NA,NA,8.4,NA,38,1,26,22.1,0,3,0,-1,1,4,4,3
"12906",2021-02-13,"Kebler","w2021","Mechanized",0,"Sat","weekend","no_sled","Kebler",NA,NA,NA,8.4,NA,38,1,26,22.1,0,3,0,-1,1,4,4,3
"12907",2021-02-13,"Kebler","w2021","Motorized",142,"Sat","weekend","sled","Kebler",NA,NA,NA,8.4,NA,38,1,26,22.1,0,3,0,-1,1,4,4,3
"12908",2021-02-13,"Kebler","w2021","Hybrid",16,"Sat","weekend","sled","Kebler",NA,NA,NA,8.4,NA,38,1,26,22.1,0,3,0,-1,1,4,4,3
"12909",2021-02-14,"Kebler","w2021","Non.motorized",11,"Sun","weekend","no_sled","Kebler",NA,NA,NA,8.9,NA,43,5,18,20.7,1,0,3,0,6,6,9,9
"12910",2021-02-14,"Kebler","w2021","Mechanized",0,"Sun","weekend","no_sled","Kebler",NA,NA,NA,8.9,NA,43,5,18,20.7,1,0,3,0,6,6,9,9
"12911",2021-02-14,"Kebler","w2021","Motorized",152,"Sun","weekend","sled","Kebler",NA,NA,NA,8.9,NA,43,5,18,20.7,1,0,3,0,6,6,9,9
"12912",2021-02-14,"Kebler","w2021","Hybrid",14,"Sun","weekend","sled","Kebler",NA,NA,NA,8.9,NA,43,5,18,20.7,1,0,3,0,6,6,9,9
"12913",2021-02-15,"Kebler","w2021","Non.motorized",3,"Mon","weekday","no_sled","Kebler",NA,NA,NA,8.9,NA,43,0,12,20.7,5,1,0,3,5,6,6,9
"12914",2021-02-15,"Kebler","w2021","Mechanized",0,"Mon","weekday","no_sled","Kebler",NA,NA,NA,8.9,NA,43,0,12,20.7,5,1,0,3,5,6,6,9
"12915",2021-02-15,"Kebler","w2021","Motorized",62,"Mon","weekday","sled","Kebler",NA,NA,NA,8.9,NA,43,0,12,20.7,5,1,0,3,5,6,6,9
"12916",2021-02-15,"Kebler","w2021","Hybrid",5,"Mon","weekday","sled","Kebler",NA,NA,NA,8.9,NA,43,0,12,20.7,5,1,0,3,5,6,6,9
"12917",2021-02-16,"Kebler","w2021","Non.motorized",4,"Tue","weekday","no_sled","Kebler",NA,NA,NA,9,NA,41,-2,17,22,0,5,1,0,-2,3,4,4
"12918",2021-02-16,"Kebler","w2021","Mechanized",0,"Tue","weekday","no_sled","Kebler",NA,NA,NA,9,NA,41,-2,17,22,0,5,1,0,-2,3,4,4
"12919",2021-02-16,"Kebler","w2021","Motorized",51,"Tue","weekday","sled","Kebler",NA,NA,NA,9,NA,41,-2,17,22,0,5,1,0,-2,3,4,4
"12920",2021-02-16,"Kebler","w2021","Hybrid",9,"Tue","weekday","sled","Kebler",NA,NA,NA,9,NA,41,-2,17,22,0,5,1,0,-2,3,4,4
"12921",2021-02-17,"Kebler","w2021","Non.motorized",8,"Wed","weekday","no_sled","Kebler",NA,NA,NA,9.1,NA,42,1,13,21.7,-2,0,5,1,-1,-1,4,5
"12922",2021-02-17,"Kebler","w2021","Mechanized",0,"Wed","weekday","no_sled","Kebler",NA,NA,NA,9.1,NA,42,1,13,21.7,-2,0,5,1,-1,-1,4,5
"12923",2021-02-17,"Kebler","w2021","Motorized",118,"Wed","weekday","sled","Kebler",NA,NA,NA,9.1,NA,42,1,13,21.7,-2,0,5,1,-1,-1,4,5
"12924",2021-02-17,"Kebler","w2021","Hybrid",8,"Wed","weekday","sled","Kebler",NA,NA,NA,9.1,NA,42,1,13,21.7,-2,0,5,1,-1,-1,4,5
"12925",2021-02-18,"Kebler","w2021","Non.motorized",9,"Thu","weekday","no_sled","Kebler",NA,NA,NA,9.1,NA,41,-1,11,22.2,1,-2,0,5,0,-2,-2,3
"12926",2021-02-18,"Kebler","w2021","Mechanized",0,"Thu","weekday","no_sled","Kebler",NA,NA,NA,9.1,NA,41,-1,11,22.2,1,-2,0,5,0,-2,-2,3
"12927",2021-02-18,"Kebler","w2021","Motorized",67,"Thu","weekday","sled","Kebler",NA,NA,NA,9.1,NA,41,-1,11,22.2,1,-2,0,5,0,-2,-2,3
"12928",2021-02-18,"Kebler","w2021","Hybrid",6,"Thu","weekday","sled","Kebler",NA,NA,NA,9.1,NA,41,-1,11,22.2,1,-2,0,5,0,-2,-2,3
"12929",2021-02-19,"Kebler","w2021","Non.motorized",6,"Fri","weekday","no_sled","Kebler",NA,NA,NA,9.1,NA,40,-1,18,22.8,-1,1,-2,0,-2,-1,-3,-3
"12930",2021-02-19,"Kebler","w2021","Mechanized",0,"Fri","weekday","no_sled","Kebler",NA,NA,NA,9.1,NA,40,-1,18,22.8,-1,1,-2,0,-2,-1,-3,-3
"12931",2021-02-19,"Kebler","w2021","Motorized",131,"Fri","weekday","sled","Kebler",NA,NA,NA,9.1,NA,40,-1,18,22.8,-1,1,-2,0,-2,-1,-3,-3
"12932",2021-02-19,"Kebler","w2021","Hybrid",10,"Fri","weekday","sled","Kebler",NA,NA,NA,9.1,NA,40,-1,18,22.8,-1,1,-2,0,-2,-1,-3,-3
"12933",2021-02-20,"Kebler","w2021","Non.motorized",23,"Sat","weekend","no_sled","Kebler",NA,NA,NA,9.2,NA,39,-1,23,23.6,-1,-1,1,-2,-2,-3,-2,-4
"12934",2021-02-20,"Kebler","w2021","Mechanized",0,"Sat","weekend","no_sled","Kebler",NA,NA,NA,9.2,NA,39,-1,23,23.6,-1,-1,1,-2,-2,-3,-2,-4
"12935",2021-02-20,"Kebler","w2021","Motorized",156,"Sat","weekend","sled","Kebler",NA,NA,NA,9.2,NA,39,-1,23,23.6,-1,-1,1,-2,-2,-3,-2,-4
"12936",2021-02-20,"Kebler","w2021","Hybrid",14,"Sat","weekend","sled","Kebler",NA,NA,NA,9.2,NA,39,-1,23,23.6,-1,-1,1,-2,-2,-3,-2,-4
"12937",2021-02-21,"Kebler","w2021","Non.motorized",10,"Sun","weekend","no_sled","Kebler",NA,NA,NA,9.2,NA,39,0,15,23.6,-1,-1,-1,1,-1,-2,-3,-2
"12938",2021-02-21,"Kebler","w2021","Mechanized",0,"Sun","weekend","no_sled","Kebler",NA,NA,NA,9.2,NA,39,0,15,23.6,-1,-1,-1,1,-1,-2,-3,-2
"12939",2021-02-21,"Kebler","w2021","Motorized",100,"Sun","weekend","sled","Kebler",NA,NA,NA,9.2,NA,39,0,15,23.6,-1,-1,-1,1,-1,-2,-3,-2
"12940",2021-02-21,"Kebler","w2021","Hybrid",20,"Sun","weekend","sled","Kebler",NA,NA,NA,9.2,NA,39,0,15,23.6,-1,-1,-1,1,-1,-2,-3,-2
"12941",2021-02-22,"Kebler","w2021","Non.motorized",6,"Mon","weekday","no_sled","Kebler",NA,NA,NA,9.2,NA,39,0,23,23.6,0,-1,-1,-1,0,-1,-2,-3
"12942",2021-02-22,"Kebler","w2021","Mechanized",1,"Mon","weekday","no_sled","Kebler",NA,NA,NA,9.2,NA,39,0,23,23.6,0,-1,-1,-1,0,-1,-2,-3
"12943",2021-02-22,"Kebler","w2021","Motorized",58,"Mon","weekday","sled","Kebler",NA,NA,NA,9.2,NA,39,0,23,23.6,0,-1,-1,-1,0,-1,-2,-3
"12944",2021-02-22,"Kebler","w2021","Hybrid",9,"Mon","weekday","sled","Kebler",NA,NA,NA,9.2,NA,39,0,23,23.6,0,-1,-1,-1,0,-1,-2,-3
"12945",2021-02-23,"Kebler","w2021","Non.motorized",1,"Tue","weekday","no_sled","Kebler",NA,NA,NA,9.2,NA,38,-1,28,24.2,0,0,-1,-1,-1,-1,-2,-3
"12946",2021-02-23,"Kebler","w2021","Mechanized",0,"Tue","weekday","no_sled","Kebler",NA,NA,NA,9.2,NA,38,-1,28,24.2,0,0,-1,-1,-1,-1,-2,-3
"12947",2021-02-23,"Kebler","w2021","Motorized",100,"Tue","weekday","sled","Kebler",NA,NA,NA,9.2,NA,38,-1,28,24.2,0,0,-1,-1,-1,-1,-2,-3
"12948",2021-02-23,"Kebler","w2021","Hybrid",10,"Tue","weekday","sled","Kebler",NA,NA,NA,9.2,NA,38,-1,28,24.2,0,0,-1,-1,-1,-1,-2,-3
"12949",2021-02-24,"Kebler","w2021","Non.motorized",2,"Wed","weekday","no_sled","Kebler",NA,NA,NA,9.2,NA,38,0,23,24.2,-1,0,0,-1,-1,-1,-1,-2
"12950",2021-02-24,"Kebler","w2021","Mechanized",0,"Wed","weekday","no_sled","Kebler",NA,NA,NA,9.2,NA,38,0,23,24.2,-1,0,0,-1,-1,-1,-1,-2
"12951",2021-02-24,"Kebler","w2021","Motorized",74,"Wed","weekday","sled","Kebler",NA,NA,NA,9.2,NA,38,0,23,24.2,-1,0,0,-1,-1,-1,-1,-2
"12952",2021-02-24,"Kebler","w2021","Hybrid",15,"Wed","weekday","sled","Kebler",NA,NA,NA,9.2,NA,38,0,23,24.2,-1,0,0,-1,-1,-1,-1,-2
"12953",2021-02-25,"Kebler","w2021","Non.motorized",3,"Thu","weekday","no_sled","Kebler",NA,NA,NA,9.2,NA,37,-1,20,24.9,0,-1,0,0,-1,-2,-2,-2
"12954",2021-02-25,"Kebler","w2021","Mechanized",0,"Thu","weekday","no_sled","Kebler",NA,NA,NA,9.2,NA,37,-1,20,24.9,0,-1,0,0,-1,-2,-2,-2
"12955",2021-02-25,"Kebler","w2021","Motorized",133,"Thu","weekday","sled","Kebler",NA,NA,NA,9.2,NA,37,-1,20,24.9,0,-1,0,0,-1,-2,-2,-2
"12956",2021-02-25,"Kebler","w2021","Hybrid",18,"Thu","weekday","sled","Kebler",NA,NA,NA,9.2,NA,37,-1,20,24.9,0,-1,0,0,-1,-2,-2,-2
"12957",2021-02-26,"Kebler","w2021","Non.motorized",0,"Fri","weekday","no_sled","Kebler",NA,NA,NA,9.2,NA,37,0,21,24.9,-1,0,-1,0,-1,-1,-2,-2
"12958",2021-02-26,"Kebler","w2021","Mechanized",0,"Fri","weekday","no_sled","Kebler",NA,NA,NA,9.2,NA,37,0,21,24.9,-1,0,-1,0,-1,-1,-2,-2
"12959",2021-02-26,"Kebler","w2021","Motorized",91,"Fri","weekday","sled","Kebler",NA,NA,NA,9.2,NA,37,0,21,24.9,-1,0,-1,0,-1,-1,-2,-2
"12960",2021-02-26,"Kebler","w2021","Hybrid",6,"Fri","weekday","sled","Kebler",NA,NA,NA,9.2,NA,37,0,21,24.9,-1,0,-1,0,-1,-1,-2,-2
"12961",2021-02-27,"Kebler","w2021","Non.motorized",4,"Sat","weekend","no_sled","Kebler",NA,NA,NA,9.2,NA,37,0,15,24.9,0,-1,0,-1,0,-1,-1,-2
"12962",2021-02-27,"Kebler","w2021","Mechanized",0,"Sat","weekend","no_sled","Kebler",NA,NA,NA,9.2,NA,37,0,15,24.9,0,-1,0,-1,0,-1,-1,-2
"12963",2021-02-27,"Kebler","w2021","Motorized",103,"Sat","weekend","sled","Kebler",NA,NA,NA,9.2,NA,37,0,15,24.9,0,-1,0,-1,0,-1,-1,-2
"12964",2021-02-27,"Kebler","w2021","Hybrid",12,"Sat","weekend","sled","Kebler",NA,NA,NA,9.2,NA,37,0,15,24.9,0,-1,0,-1,0,-1,-1,-2
"12965",2021-02-28,"Kebler","w2021","Non.motorized",8,"Sun","weekend","no_sled","Kebler",NA,NA,NA,9.2,NA,38,1,9,24.2,0,0,-1,0,1,1,0,0
"12966",2021-02-28,"Kebler","w2021","Mechanized",0,"Sun","weekend","no_sled","Kebler",NA,NA,NA,9.2,NA,38,1,9,24.2,0,0,-1,0,1,1,0,0
"12967",2021-02-28,"Kebler","w2021","Motorized",128,"Sun","weekend","sled","Kebler",NA,NA,NA,9.2,NA,38,1,9,24.2,0,0,-1,0,1,1,0,0
"12968",2021-02-28,"Kebler","w2021","Hybrid",16,"Sun","weekend","sled","Kebler",NA,NA,NA,9.2,NA,38,1,9,24.2,0,0,-1,0,1,1,0,0
"12969",2021-03-01,"Kebler","w2021","Non.motorized",2,"Mon","weekday","no_sled","Kebler",NA,NA,NA,9.2,NA,37,-1,20,24.9,1,0,0,-1,0,0,0,-1
"12970",2021-03-01,"Kebler","w2021","Mechanized",0,"Mon","weekday","no_sled","Kebler",NA,NA,NA,9.2,NA,37,-1,20,24.9,1,0,0,-1,0,0,0,-1
"12971",2021-03-01,"Kebler","w2021","Motorized",59,"Mon","weekday","sled","Kebler",NA,NA,NA,9.2,NA,37,-1,20,24.9,1,0,0,-1,0,0,0,-1
"12972",2021-03-01,"Kebler","w2021","Hybrid",3,"Mon","weekday","sled","Kebler",NA,NA,NA,9.2,NA,37,-1,20,24.9,1,0,0,-1,0,0,0,-1
"12973",2021-03-02,"Kebler","w2021","Non.motorized",4,"Tue","weekday","no_sled","Kebler",NA,NA,NA,9.2,NA,36,-1,27,25.6,-1,1,0,0,-2,-1,-1,-1
"12974",2021-03-02,"Kebler","w2021","Mechanized",2,"Tue","weekday","no_sled","Kebler",NA,NA,NA,9.2,NA,36,-1,27,25.6,-1,1,0,0,-2,-1,-1,-1
"12975",2021-03-02,"Kebler","w2021","Motorized",55,"Tue","weekday","sled","Kebler",NA,NA,NA,9.2,NA,36,-1,27,25.6,-1,1,0,0,-2,-1,-1,-1
"12976",2021-03-02,"Kebler","w2021","Hybrid",8,"Tue","weekday","sled","Kebler",NA,NA,NA,9.2,NA,36,-1,27,25.6,-1,1,0,0,-2,-1,-1,-1
"12977",2021-03-03,"Kebler","w2021","Non.motorized",2,"Wed","weekday","no_sled","Kebler",NA,NA,NA,9.2,NA,36,0,31,25.6,-1,-1,1,0,-1,-2,-1,-1
"12978",2021-03-03,"Kebler","w2021","Mechanized",0,"Wed","weekday","no_sled","Kebler",NA,NA,NA,9.2,NA,36,0,31,25.6,-1,-1,1,0,-1,-2,-1,-1
"12979",2021-03-03,"Kebler","w2021","Motorized",77,"Wed","weekday","sled","Kebler",NA,NA,NA,9.2,NA,36,0,31,25.6,-1,-1,1,0,-1,-2,-1,-1
"12980",2021-03-03,"Kebler","w2021","Hybrid",11,"Wed","weekday","sled","Kebler",NA,NA,NA,9.2,NA,36,0,31,25.6,-1,-1,1,0,-1,-2,-1,-1
"12981",2021-03-04,"Kebler","w2021","Non.motorized",4,"Thu","weekday","no_sled","Kebler",NA,NA,NA,9.2,NA,36,0,28,25.6,0,-1,-1,1,0,-1,-2,-1
"12982",2021-03-04,"Kebler","w2021","Mechanized",0,"Thu","weekday","no_sled","Kebler",NA,NA,NA,9.2,NA,36,0,28,25.6,0,-1,-1,1,0,-1,-2,-1
"12983",2021-03-04,"Kebler","w2021","Motorized",43,"Thu","weekday","sled","Kebler",NA,NA,NA,9.2,NA,36,0,28,25.6,0,-1,-1,1,0,-1,-2,-1
"12984",2021-03-04,"Kebler","w2021","Hybrid",3,"Thu","weekday","sled","Kebler",NA,NA,NA,9.2,NA,36,0,28,25.6,0,-1,-1,1,0,-1,-2,-1
"12985",2021-03-05,"Kebler","w2021","Non.motorized",5,"Fri","weekday","no_sled","Kebler",NA,NA,NA,9.4,NA,39,3,30,24.1,0,0,-1,-1,3,3,2,1
"12986",2021-03-05,"Kebler","w2021","Mechanized",0,"Fri","weekday","no_sled","Kebler",NA,NA,NA,9.4,NA,39,3,30,24.1,0,0,-1,-1,3,3,2,1
"12987",2021-03-05,"Kebler","w2021","Motorized",73,"Fri","weekday","sled","Kebler",NA,NA,NA,9.4,NA,39,3,30,24.1,0,0,-1,-1,3,3,2,1
"12988",2021-03-05,"Kebler","w2021","Hybrid",14,"Fri","weekday","sled","Kebler",NA,NA,NA,9.4,NA,39,3,30,24.1,0,0,-1,-1,3,3,2,1
"12989",2021-03-06,"Kebler","w2021","Non.motorized",7,"Sat","weekend","no_sled","Kebler",NA,NA,NA,9.4,NA,38,-1,32,24.7,3,0,0,-1,2,2,2,1
"12990",2021-03-06,"Kebler","w2021","Mechanized",3,"Sat","weekend","no_sled","Kebler",NA,NA,NA,9.4,NA,38,-1,32,24.7,3,0,0,-1,2,2,2,1
"12991",2021-03-06,"Kebler","w2021","Motorized",169,"Sat","weekend","sled","Kebler",NA,NA,NA,9.4,NA,38,-1,32,24.7,3,0,0,-1,2,2,2,1
"12992",2021-03-06,"Kebler","w2021","Hybrid",20,"Sat","weekend","sled","Kebler",NA,NA,NA,9.4,NA,38,-1,32,24.7,3,0,0,-1,2,2,2,1
"12993",2021-03-07,"Kebler","w2021","Non.motorized",6,"Sun","weekend","no_sled","Kebler",NA,NA,NA,9.4,NA,37,-1,35,25.4,-1,3,0,0,-2,1,1,1
"12994",2021-03-07,"Kebler","w2021","Mechanized",3,"Sun","weekend","no_sled","Kebler",NA,NA,NA,9.4,NA,37,-1,35,25.4,-1,3,0,0,-2,1,1,1
"12995",2021-03-07,"Kebler","w2021","Motorized",126,"Sun","weekend","sled","Kebler",NA,NA,NA,9.4,NA,37,-1,35,25.4,-1,3,0,0,-2,1,1,1
"12996",2021-03-07,"Kebler","w2021","Hybrid",7,"Sun","weekend","sled","Kebler",NA,NA,NA,9.4,NA,37,-1,35,25.4,-1,3,0,0,-2,1,1,1
"12997",2021-03-08,"Kebler","w2021","Non.motorized",2,"Mon","weekday","no_sled","Kebler",NA,NA,NA,9.5,NA,37,0,33,25.7,-1,-1,3,0,-1,-2,1,1
"12998",2021-03-08,"Kebler","w2021","Mechanized",0,"Mon","weekday","no_sled","Kebler",NA,NA,NA,9.5,NA,37,0,33,25.7,-1,-1,3,0,-1,-2,1,1
"12999",2021-03-08,"Kebler","w2021","Motorized",57,"Mon","weekday","sled","Kebler",NA,NA,NA,9.5,NA,37,0,33,25.7,-1,-1,3,0,-1,-2,1,1
"13000",2021-03-08,"Kebler","w2021","Hybrid",6,"Mon","weekday","sled","Kebler",NA,NA,NA,9.5,NA,37,0,33,25.7,-1,-1,3,0,-1,-2,1,1
"13001",2021-03-09,"Kebler","w2021","Non.motorized",6,"Tue","weekday","no_sled","Kebler",NA,NA,NA,9.5,NA,37,0,33,25.7,0,-1,-1,3,0,-1,-2,1
"13002",2021-03-09,"Kebler","w2021","Mechanized",0,"Tue","weekday","no_sled","Kebler",NA,NA,NA,9.5,NA,37,0,33,25.7,0,-1,-1,3,0,-1,-2,1
"13003",2021-03-09,"Kebler","w2021","Motorized",87,"Tue","weekday","sled","Kebler",NA,NA,NA,9.5,NA,37,0,33,25.7,0,-1,-1,3,0,-1,-2,1
"13004",2021-03-09,"Kebler","w2021","Hybrid",4,"Tue","weekday","sled","Kebler",NA,NA,NA,9.5,NA,37,0,33,25.7,0,-1,-1,3,0,-1,-2,1
"13005",2021-03-10,"Kebler","w2021","Non.motorized",3,"Wed","weekday","no_sled","Kebler",NA,NA,NA,9.7,NA,39,2,21,24.9,0,0,-1,-1,2,2,1,0
"13006",2021-03-10,"Kebler","w2021","Mechanized",0,"Wed","weekday","no_sled","Kebler",NA,NA,NA,9.7,NA,39,2,21,24.9,0,0,-1,-1,2,2,1,0
"13007",2021-03-10,"Kebler","w2021","Motorized",121,"Wed","weekday","sled","Kebler",NA,NA,NA,9.7,NA,39,2,21,24.9,0,0,-1,-1,2,2,1,0
"13008",2021-03-10,"Kebler","w2021","Hybrid",3,"Wed","weekday","sled","Kebler",NA,NA,NA,9.7,NA,39,2,21,24.9,0,0,-1,-1,2,2,1,0
"13009",2021-03-11,"Kebler","w2021","Non.motorized",5,"Thu","weekday","no_sled","Kebler",NA,NA,NA,9.8,NA,40,1,22,24.5,2,0,0,-1,3,3,3,2
"13010",2021-03-11,"Kebler","w2021","Mechanized",0,"Thu","weekday","no_sled","Kebler",NA,NA,NA,9.8,NA,40,1,22,24.5,2,0,0,-1,3,3,3,2
"13011",2021-03-11,"Kebler","w2021","Motorized",88,"Thu","weekday","sled","Kebler",NA,NA,NA,9.8,NA,40,1,22,24.5,2,0,0,-1,3,3,3,2
"13012",2021-03-11,"Kebler","w2021","Hybrid",2,"Thu","weekday","sled","Kebler",NA,NA,NA,9.8,NA,40,1,22,24.5,2,0,0,-1,3,3,3,2
"13013",2021-03-12,"Kebler","w2021","Non.motorized",1,"Fri","weekday","no_sled","Kebler",NA,NA,NA,9.8,NA,39,-1,29,25.1,1,2,0,0,0,2,2,2
"13014",2021-03-12,"Kebler","w2021","Mechanized",1,"Fri","weekday","no_sled","Kebler",NA,NA,NA,9.8,NA,39,-1,29,25.1,1,2,0,0,0,2,2,2
"13015",2021-03-12,"Kebler","w2021","Motorized",123,"Fri","weekday","sled","Kebler",NA,NA,NA,9.8,NA,39,-1,29,25.1,1,2,0,0,0,2,2,2
"13016",2021-03-12,"Kebler","w2021","Hybrid",4,"Fri","weekday","sled","Kebler",NA,NA,NA,9.8,NA,39,-1,29,25.1,1,2,0,0,0,2,2,2
"13017",2021-03-13,"Kebler","w2021","Non.motorized",7,"Sat","weekend","no_sled","Kebler",NA,NA,NA,9.8,NA,38,-1,27,25.8,-1,1,2,0,-2,-1,1,1
"13018",2021-03-13,"Kebler","w2021","Mechanized",0,"Sat","weekend","no_sled","Kebler",NA,NA,NA,9.8,NA,38,-1,27,25.8,-1,1,2,0,-2,-1,1,1
"13019",2021-03-13,"Kebler","w2021","Motorized",126,"Sat","weekend","sled","Kebler",NA,NA,NA,9.8,NA,38,-1,27,25.8,-1,1,2,0,-2,-1,1,1
"13020",2021-03-13,"Kebler","w2021","Hybrid",8,"Sat","weekend","sled","Kebler",NA,NA,NA,9.8,NA,38,-1,27,25.8,-1,1,2,0,-2,-1,1,1
"13021",2021-03-14,"Kebler","w2021","Non.motorized",3,"Sun","weekend","no_sled","Kebler",NA,NA,NA,10.2,NA,42,4,23,24.3,-1,-1,1,2,3,2,3,5
"13022",2021-03-14,"Kebler","w2021","Mechanized",0,"Sun","weekend","no_sled","Kebler",NA,NA,NA,10.2,NA,42,4,23,24.3,-1,-1,1,2,3,2,3,5
"13023",2021-03-14,"Kebler","w2021","Motorized",195,"Sun","weekend","sled","Kebler",NA,NA,NA,10.2,NA,42,4,23,24.3,-1,-1,1,2,3,2,3,5
"13024",2021-03-14,"Kebler","w2021","Hybrid",2,"Sun","weekend","sled","Kebler",NA,NA,NA,10.2,NA,42,4,23,24.3,-1,-1,1,2,3,2,3,5
"13025",2021-03-15,"Kebler","w2021","Non.motorized",4,"Mon","weekday","no_sled","Kebler",NA,NA,NA,10.2,NA,41,-1,26,24.9,4,-1,-1,1,3,2,1,2
"13026",2021-03-15,"Kebler","w2021","Mechanized",0,"Mon","weekday","no_sled","Kebler",NA,NA,NA,10.2,NA,41,-1,26,24.9,4,-1,-1,1,3,2,1,2
"13027",2021-03-15,"Kebler","w2021","Motorized",193,"Mon","weekday","sled","Kebler",NA,NA,NA,10.2,NA,41,-1,26,24.9,4,-1,-1,1,3,2,1,2
"13028",2021-03-15,"Kebler","w2021","Hybrid",6,"Mon","weekday","sled","Kebler",NA,NA,NA,10.2,NA,41,-1,26,24.9,4,-1,-1,1,3,2,1,2
"13029",2021-03-16,"Kebler","w2021","Non.motorized",2,"Tue","weekday","no_sled","Kebler",NA,NA,NA,10.3,NA,40,-1,26,25.8,-1,4,-1,-1,-2,2,1,0
"13030",2021-03-16,"Kebler","w2021","Mechanized",1,"Tue","weekday","no_sled","Kebler",NA,NA,NA,10.3,NA,40,-1,26,25.8,-1,4,-1,-1,-2,2,1,0
"13031",2021-03-16,"Kebler","w2021","Motorized",190,"Tue","weekday","sled","Kebler",NA,NA,NA,10.3,NA,40,-1,26,25.8,-1,4,-1,-1,-2,2,1,0
"13032",2021-03-16,"Kebler","w2021","Hybrid",9,"Tue","weekday","sled","Kebler",NA,NA,NA,10.3,NA,40,-1,26,25.8,-1,4,-1,-1,-2,2,1,0
"13033",2021-03-17,"Kebler","w2021","Non.motorized",0,"Wed","weekday","no_sled","Kebler",NA,NA,NA,10.3,NA,41,1,25,25.1,-1,-1,4,-1,0,-1,3,2
"13034",2021-03-17,"Kebler","w2021","Mechanized",0,"Wed","weekday","no_sled","Kebler",NA,NA,NA,10.3,NA,41,1,25,25.1,-1,-1,4,-1,0,-1,3,2
"13035",2021-03-17,"Kebler","w2021","Motorized",194,"Wed","weekday","sled","Kebler",NA,NA,NA,10.3,NA,41,1,25,25.1,-1,-1,4,-1,0,-1,3,2
"13036",2021-03-17,"Kebler","w2021","Hybrid",8,"Wed","weekday","sled","Kebler",NA,NA,NA,10.3,NA,41,1,25,25.1,-1,-1,4,-1,0,-1,3,2
"13037",2021-03-18,"Kebler","w2021","Non.motorized",2,"Thu","weekday","no_sled","Kebler",NA,NA,NA,10.3,NA,40,-1,29,25.8,1,-1,-1,4,0,-1,-2,2
"13038",2021-03-18,"Kebler","w2021","Mechanized",0,"Thu","weekday","no_sled","Kebler",NA,NA,NA,10.3,NA,40,-1,29,25.8,1,-1,-1,4,0,-1,-2,2
"13039",2021-03-18,"Kebler","w2021","Motorized",231,"Thu","weekday","sled","Kebler",NA,NA,NA,10.3,NA,40,-1,29,25.8,1,-1,-1,4,0,-1,-2,2
"13040",2021-03-18,"Kebler","w2021","Hybrid",9,"Thu","weekday","sled","Kebler",NA,NA,NA,10.3,NA,40,-1,29,25.8,1,-1,-1,4,0,-1,-2,2
"13041",2021-03-19,"Kebler","w2021","Non.motorized",1,"Fri","weekday","no_sled","Kebler",NA,NA,NA,10.3,NA,40,0,36,25.8,-1,1,-1,-1,-1,0,-1,-2
"13042",2021-03-19,"Kebler","w2021","Mechanized",0,"Fri","weekday","no_sled","Kebler",NA,NA,NA,10.3,NA,40,0,36,25.8,-1,1,-1,-1,-1,0,-1,-2
"13043",2021-03-19,"Kebler","w2021","Motorized",193,"Fri","weekday","sled","Kebler",NA,NA,NA,10.3,NA,40,0,36,25.8,-1,1,-1,-1,-1,0,-1,-2
"13044",2021-03-19,"Kebler","w2021","Hybrid",6,"Fri","weekday","sled","Kebler",NA,NA,NA,10.3,NA,40,0,36,25.8,-1,1,-1,-1,-1,0,-1,-2
"13045",2021-03-20,"Kebler","w2021","Non.motorized",4,"Sat","weekend","no_sled","Kebler",NA,NA,NA,10.4,NA,39,-1,37,26.7,0,-1,1,-1,-1,-2,-1,-2
"13046",2021-03-20,"Kebler","w2021","Mechanized",0,"Sat","weekend","no_sled","Kebler",NA,NA,NA,10.4,NA,39,-1,37,26.7,0,-1,1,-1,-1,-2,-1,-2
"13047",2021-03-20,"Kebler","w2021","Motorized",135,"Sat","weekend","sled","Kebler",NA,NA,NA,10.4,NA,39,-1,37,26.7,0,-1,1,-1,-1,-2,-1,-2
"13048",2021-03-20,"Kebler","w2021","Hybrid",12,"Sat","weekend","sled","Kebler",NA,NA,NA,10.4,NA,39,-1,37,26.7,0,-1,1,-1,-1,-2,-1,-2
"13049",2021-03-21,"Kebler","w2021","Non.motorized",0,"Sun","weekend","no_sled","Kebler",NA,NA,NA,10.4,NA,38,-1,28,27.4,-1,0,-1,1,-2,-2,-3,-2
"13050",2021-03-21,"Kebler","w2021","Mechanized",0,"Sun","weekend","no_sled","Kebler",NA,NA,NA,10.4,NA,38,-1,28,27.4,-1,0,-1,1,-2,-2,-3,-2
"13051",2021-03-21,"Kebler","w2021","Motorized",46,"Sun","weekend","sled","Kebler",NA,NA,NA,10.4,NA,38,-1,28,27.4,-1,0,-1,1,-2,-2,-3,-2
"13052",2021-03-21,"Kebler","w2021","Hybrid",12,"Sun","weekend","sled","Kebler",NA,NA,NA,10.4,NA,38,-1,28,27.4,-1,0,-1,1,-2,-2,-3,-2
"13053",2021-03-22,"Kebler","w2021","Non.motorized",1,"Mon","weekday","no_sled","Kebler",NA,NA,NA,10.5,NA,41,3,26,25.6,-1,-1,0,-1,2,1,1,0
"13054",2021-03-22,"Kebler","w2021","Mechanized",0,"Mon","weekday","no_sled","Kebler",NA,NA,NA,10.5,NA,41,3,26,25.6,-1,-1,0,-1,2,1,1,0
"13055",2021-03-22,"Kebler","w2021","Motorized",28,"Mon","weekday","sled","Kebler",NA,NA,NA,10.5,NA,41,3,26,25.6,-1,-1,0,-1,2,1,1,0
"13056",2021-03-22,"Kebler","w2021","Hybrid",3,"Mon","weekday","sled","Kebler",NA,NA,NA,10.5,NA,41,3,26,25.6,-1,-1,0,-1,2,1,1,0
"13057",2021-03-23,"Kebler","w2021","Non.motorized",NA,"Tue","weekday","no_sled","Kebler",NA,NA,NA,10.6,NA,41,0,24,25.9,3,-1,-1,0,3,2,1,1
"13058",2021-03-23,"Kebler","w2021","Mechanized",NA,"Tue","weekday","no_sled","Kebler",NA,NA,NA,10.6,NA,41,0,24,25.9,3,-1,-1,0,3,2,1,1
"13059",2021-03-23,"Kebler","w2021","Motorized",NA,"Tue","weekday","sled","Kebler",NA,NA,NA,10.6,NA,41,0,24,25.9,3,-1,-1,0,3,2,1,1
"13060",2021-03-23,"Kebler","w2021","Hybrid",NA,"Tue","weekday","sled","Kebler",NA,NA,NA,10.6,NA,41,0,24,25.9,3,-1,-1,0,3,2,1,1
"13061",2021-03-24,"Kebler","w2021","Non.motorized",NA,"Wed","weekday","no_sled","Kebler",NA,NA,NA,10.8,NA,41,0,24,26.3,0,3,-1,-1,0,3,2,1
"13062",2021-03-24,"Kebler","w2021","Mechanized",NA,"Wed","weekday","no_sled","Kebler",NA,NA,NA,10.8,NA,41,0,24,26.3,0,3,-1,-1,0,3,2,1
"13063",2021-03-24,"Kebler","w2021","Motorized",NA,"Wed","weekday","sled","Kebler",NA,NA,NA,10.8,NA,41,0,24,26.3,0,3,-1,-1,0,3,2,1
"13064",2021-03-24,"Kebler","w2021","Hybrid",NA,"Wed","weekday","sled","Kebler",NA,NA,NA,10.8,NA,41,0,24,26.3,0,3,-1,-1,0,3,2,1
"13065",2021-03-25,"Kebler","w2021","Non.motorized",NA,"Thu","weekday","no_sled","Kebler",NA,NA,NA,10.9,NA,43,2,23,25.3,0,0,3,-1,2,2,5,4
"13066",2021-03-25,"Kebler","w2021","Mechanized",NA,"Thu","weekday","no_sled","Kebler",NA,NA,NA,10.9,NA,43,2,23,25.3,0,0,3,-1,2,2,5,4
"13067",2021-03-25,"Kebler","w2021","Motorized",NA,"Thu","weekday","sled","Kebler",NA,NA,NA,10.9,NA,43,2,23,25.3,0,0,3,-1,2,2,5,4
"13068",2021-03-25,"Kebler","w2021","Hybrid",NA,"Thu","weekday","sled","Kebler",NA,NA,NA,10.9,NA,43,2,23,25.3,0,0,3,-1,2,2,5,4
"13069",2021-03-26,"Kebler","w2021","Non.motorized",NA,"Fri","weekday","no_sled","Kebler",NA,NA,NA,11,NA,44,1,23,25,2,0,0,3,3,3,3,6
"13070",2021-03-26,"Kebler","w2021","Mechanized",NA,"Fri","weekday","no_sled","Kebler",NA,NA,NA,11,NA,44,1,23,25,2,0,0,3,3,3,3,6
"13071",2021-03-26,"Kebler","w2021","Motorized",NA,"Fri","weekday","sled","Kebler",NA,NA,NA,11,NA,44,1,23,25,2,0,0,3,3,3,3,6
"13072",2021-03-26,"Kebler","w2021","Hybrid",NA,"Fri","weekday","sled","Kebler",NA,NA,NA,11,NA,44,1,23,25,2,0,0,3,3,3,3,6
"13073",2021-03-27,"Kebler","w2021","Non.motorized",NA,"Sat","weekend","no_sled","Kebler",NA,NA,NA,11,NA,42,-2,25,26.2,1,2,0,0,-1,1,1,1
"13074",2021-03-27,"Kebler","w2021","Mechanized",NA,"Sat","weekend","no_sled","Kebler",NA,NA,NA,11,NA,42,-2,25,26.2,1,2,0,0,-1,1,1,1
"13075",2021-03-27,"Kebler","w2021","Motorized",NA,"Sat","weekend","sled","Kebler",NA,NA,NA,11,NA,42,-2,25,26.2,1,2,0,0,-1,1,1,1
"13076",2021-03-27,"Kebler","w2021","Hybrid",NA,"Sat","weekend","sled","Kebler",NA,NA,NA,11,NA,42,-2,25,26.2,1,2,0,0,-1,1,1,1
"13077",2021-03-28,"Kebler","w2021","Non.motorized",NA,"Sun","weekend","no_sled","Kebler",NA,NA,NA,11,NA,42,0,31,26.2,-2,1,2,0,-2,-1,1,1
"13078",2021-03-28,"Kebler","w2021","Mechanized",NA,"Sun","weekend","no_sled","Kebler",NA,NA,NA,11,NA,42,0,31,26.2,-2,1,2,0,-2,-1,1,1
"13079",2021-03-28,"Kebler","w2021","Motorized",NA,"Sun","weekend","sled","Kebler",NA,NA,NA,11,NA,42,0,31,26.2,-2,1,2,0,-2,-1,1,1
"13080",2021-03-28,"Kebler","w2021","Hybrid",NA,"Sun","weekend","sled","Kebler",NA,NA,NA,11,NA,42,0,31,26.2,-2,1,2,0,-2,-1,1,1
"13081",2021-03-29,"Kebler","w2021","Non.motorized",NA,"Mon","weekday","no_sled","Kebler",NA,NA,NA,11.1,NA,40,-2,37,27.8,0,-2,1,2,-2,-4,-3,-1
"13082",2021-03-29,"Kebler","w2021","Mechanized",NA,"Mon","weekday","no_sled","Kebler",NA,NA,NA,11.1,NA,40,-2,37,27.8,0,-2,1,2,-2,-4,-3,-1
"13083",2021-03-29,"Kebler","w2021","Motorized",NA,"Mon","weekday","sled","Kebler",NA,NA,NA,11.1,NA,40,-2,37,27.8,0,-2,1,2,-2,-4,-3,-1
"13084",2021-03-29,"Kebler","w2021","Hybrid",NA,"Mon","weekday","sled","Kebler",NA,NA,NA,11.1,NA,40,-2,37,27.8,0,-2,1,2,-2,-4,-3,-1
"13085",2021-03-30,"Kebler","w2021","Non.motorized",NA,"Tue","weekday","no_sled","Kebler",NA,NA,NA,11.1,NA,39,-1,23,28.5,-2,0,-2,1,-3,-3,-5,-4
"13086",2021-03-30,"Kebler","w2021","Mechanized",NA,"Tue","weekday","no_sled","Kebler",NA,NA,NA,11.1,NA,39,-1,23,28.5,-2,0,-2,1,-3,-3,-5,-4
"13087",2021-03-30,"Kebler","w2021","Motorized",NA,"Tue","weekday","sled","Kebler",NA,NA,NA,11.1,NA,39,-1,23,28.5,-2,0,-2,1,-3,-3,-5,-4
"13088",2021-03-30,"Kebler","w2021","Hybrid",NA,"Tue","weekday","sled","Kebler",NA,NA,NA,11.1,NA,39,-1,23,28.5,-2,0,-2,1,-3,-3,-5,-4
"13089",2021-03-31,"Kebler","w2021","Non.motorized",NA,"Wed","weekday","no_sled","Kebler",NA,NA,NA,11.1,NA,39,0,26,28.5,-1,-2,0,-2,-1,-3,-3,-5
"13090",2021-03-31,"Kebler","w2021","Mechanized",NA,"Wed","weekday","no_sled","Kebler",NA,NA,NA,11.1,NA,39,0,26,28.5,-1,-2,0,-2,-1,-3,-3,-5
"13091",2021-03-31,"Kebler","w2021","Motorized",NA,"Wed","weekday","sled","Kebler",NA,NA,NA,11.1,NA,39,0,26,28.5,-1,-2,0,-2,-1,-3,-3,-5
"13092",2021-03-31,"Kebler","w2021","Hybrid",NA,"Wed","weekday","sled","Kebler",NA,NA,NA,11.1,NA,39,0,26,28.5,-1,-2,0,-2,-1,-3,-3,-5
"13093",2021-04-01,"Kebler","w2021","Non.motorized",NA,"Thu","weekday","no_sled","Kebler",NA,NA,NA,11.1,NA,38,-1,36,29.2,0,-1,-2,0,-1,-2,-4,-4
"13094",2021-04-01,"Kebler","w2021","Mechanized",NA,"Thu","weekday","no_sled","Kebler",NA,NA,NA,11.1,NA,38,-1,36,29.2,0,-1,-2,0,-1,-2,-4,-4
"13095",2021-04-01,"Kebler","w2021","Motorized",NA,"Thu","weekday","sled","Kebler",NA,NA,NA,11.1,NA,38,-1,36,29.2,0,-1,-2,0,-1,-2,-4,-4
"13096",2021-04-01,"Kebler","w2021","Hybrid",NA,"Thu","weekday","sled","Kebler",NA,NA,NA,11.1,NA,38,-1,36,29.2,0,-1,-2,0,-1,-2,-4,-4
"13097",2021-04-02,"Kebler","w2021","Non.motorized",NA,"Fri","weekday","no_sled","Kebler",NA,NA,NA,11.1,NA,37,-1,42,30,-1,0,-1,-2,-2,-2,-3,-5
"13098",2021-04-02,"Kebler","w2021","Mechanized",NA,"Fri","weekday","no_sled","Kebler",NA,NA,NA,11.1,NA,37,-1,42,30,-1,0,-1,-2,-2,-2,-3,-5
"13099",2021-04-02,"Kebler","w2021","Motorized",NA,"Fri","weekday","sled","Kebler",NA,NA,NA,11.1,NA,37,-1,42,30,-1,0,-1,-2,-2,-2,-3,-5
"13100",2021-04-02,"Kebler","w2021","Hybrid",NA,"Fri","weekday","sled","Kebler",NA,NA,NA,11.1,NA,37,-1,42,30,-1,0,-1,-2,-2,-2,-3,-5
"13101",2021-04-03,"Kebler","w2021","Non.motorized",NA,"Sat","weekend","no_sled","Kebler",NA,NA,NA,10.8,NA,35,-2,45,30.9,-1,-1,0,-1,-3,-4,-4,-5
"13102",2021-04-03,"Kebler","w2021","Mechanized",NA,"Sat","weekend","no_sled","Kebler",NA,NA,NA,10.8,NA,35,-2,45,30.9,-1,-1,0,-1,-3,-4,-4,-5
"13103",2021-04-03,"Kebler","w2021","Motorized",NA,"Sat","weekend","sled","Kebler",NA,NA,NA,10.8,NA,35,-2,45,30.9,-1,-1,0,-1,-3,-4,-4,-5
"13104",2021-04-03,"Kebler","w2021","Hybrid",NA,"Sat","weekend","sled","Kebler",NA,NA,NA,10.8,NA,35,-2,45,30.9,-1,-1,0,-1,-3,-4,-4,-5
"13105",2021-04-04,"Kebler","w2021","Non.motorized",NA,"Sun","weekend","no_sled","Kebler",NA,NA,NA,10.7,NA,34,-1,44,31.5,-2,-1,-1,0,-3,-4,-5,-5
"13106",2021-04-04,"Kebler","w2021","Mechanized",NA,"Sun","weekend","no_sled","Kebler",NA,NA,NA,10.7,NA,34,-1,44,31.5,-2,-1,-1,0,-3,-4,-5,-5
"13107",2021-04-04,"Kebler","w2021","Motorized",NA,"Sun","weekend","sled","Kebler",NA,NA,NA,10.7,NA,34,-1,44,31.5,-2,-1,-1,0,-3,-4,-5,-5
"13108",2021-04-04,"Kebler","w2021","Hybrid",NA,"Sun","weekend","sled","Kebler",NA,NA,NA,10.7,NA,34,-1,44,31.5,-2,-1,-1,0,-3,-4,-5,-5
"13109",2021-04-05,"Kebler","w2021","Non.motorized",NA,"Mon","weekday","no_sled","Kebler",NA,NA,NA,10.6,NA,33,-1,44,32.1,-1,-2,-1,-1,-2,-4,-5,-6
"13110",2021-04-05,"Kebler","w2021","Mechanized",NA,"Mon","weekday","no_sled","Kebler",NA,NA,NA,10.6,NA,33,-1,44,32.1,-1,-2,-1,-1,-2,-4,-5,-6
"13111",2021-04-05,"Kebler","w2021","Motorized",NA,"Mon","weekday","sled","Kebler",NA,NA,NA,10.6,NA,33,-1,44,32.1,-1,-2,-1,-1,-2,-4,-5,-6
"13112",2021-04-05,"Kebler","w2021","Hybrid",NA,"Mon","weekday","sled","Kebler",NA,NA,NA,10.6,NA,33,-1,44,32.1,-1,-2,-1,-1,-2,-4,-5,-6
"13113",2021-04-06,"Kebler","w2021","Non.motorized",NA,"Tue","weekday","no_sled","Kebler",NA,NA,NA,10.3,NA,31,-2,32,33.2,-1,-1,-2,-1,-3,-4,-6,-7
"13114",2021-04-06,"Kebler","w2021","Mechanized",NA,"Tue","weekday","no_sled","Kebler",NA,NA,NA,10.3,NA,31,-2,32,33.2,-1,-1,-2,-1,-3,-4,-6,-7
"13115",2021-04-06,"Kebler","w2021","Motorized",NA,"Tue","weekday","sled","Kebler",NA,NA,NA,10.3,NA,31,-2,32,33.2,-1,-1,-2,-1,-3,-4,-6,-7
"13116",2021-04-06,"Kebler","w2021","Hybrid",NA,"Tue","weekday","sled","Kebler",NA,NA,NA,10.3,NA,31,-2,32,33.2,-1,-1,-2,-1,-3,-4,-6,-7
"13117",2021-04-07,"Kebler","w2021","Non.motorized",NA,"Wed","weekday","no_sled","Kebler",NA,NA,NA,10,NA,31,0,33,32.3,-2,-1,-1,-2,-2,-3,-4,-6
"13118",2021-04-07,"Kebler","w2021","Mechanized",NA,"Wed","weekday","no_sled","Kebler",NA,NA,NA,10,NA,31,0,33,32.3,-2,-1,-1,-2,-2,-3,-4,-6
"13119",2021-04-07,"Kebler","w2021","Motorized",NA,"Wed","weekday","sled","Kebler",NA,NA,NA,10,NA,31,0,33,32.3,-2,-1,-1,-2,-2,-3,-4,-6
"13120",2021-04-07,"Kebler","w2021","Hybrid",NA,"Wed","weekday","sled","Kebler",NA,NA,NA,10,NA,31,0,33,32.3,-2,-1,-1,-2,-2,-3,-4,-6
"13121",2021-04-08,"Kebler","w2021","Non.motorized",NA,"Thu","weekday","no_sled","Kebler",NA,NA,NA,9.9,NA,29,-2,39,34.1,0,-2,-1,-1,-2,-4,-5,-6
"13122",2021-04-08,"Kebler","w2021","Mechanized",NA,"Thu","weekday","no_sled","Kebler",NA,NA,NA,9.9,NA,29,-2,39,34.1,0,-2,-1,-1,-2,-4,-5,-6
"13123",2021-04-08,"Kebler","w2021","Motorized",NA,"Thu","weekday","sled","Kebler",NA,NA,NA,9.9,NA,29,-2,39,34.1,0,-2,-1,-1,-2,-4,-5,-6
"13124",2021-04-08,"Kebler","w2021","Hybrid",NA,"Thu","weekday","sled","Kebler",NA,NA,NA,9.9,NA,29,-2,39,34.1,0,-2,-1,-1,-2,-4,-5,-6
"13125",2021-04-09,"Kebler","w2021","Non.motorized",NA,"Fri","weekday","no_sled","Kebler",NA,NA,NA,9.6,NA,28,-1,33,34.3,-2,0,-2,-1,-3,-3,-5,-6
"13126",2021-04-09,"Kebler","w2021","Mechanized",NA,"Fri","weekday","no_sled","Kebler",NA,NA,NA,9.6,NA,28,-1,33,34.3,-2,0,-2,-1,-3,-3,-5,-6
"13127",2021-04-09,"Kebler","w2021","Motorized",NA,"Fri","weekday","sled","Kebler",NA,NA,NA,9.6,NA,28,-1,33,34.3,-2,0,-2,-1,-3,-3,-5,-6
"13128",2021-04-09,"Kebler","w2021","Hybrid",NA,"Fri","weekday","sled","Kebler",NA,NA,NA,9.6,NA,28,-1,33,34.3,-2,0,-2,-1,-3,-3,-5,-6
"13129",2021-04-10,"Kebler","w2021","Non.motorized",NA,"Sat","weekend","no_sled","Kebler",NA,NA,NA,9.5,NA,26,-2,37,36.5,-1,-2,0,-2,-3,-5,-5,-7
"13130",2021-04-10,"Kebler","w2021","Mechanized",NA,"Sat","weekend","no_sled","Kebler",NA,NA,NA,9.5,NA,26,-2,37,36.5,-1,-2,0,-2,-3,-5,-5,-7
"13131",2021-04-10,"Kebler","w2021","Motorized",NA,"Sat","weekend","sled","Kebler",NA,NA,NA,9.5,NA,26,-2,37,36.5,-1,-2,0,-2,-3,-5,-5,-7
"13132",2021-04-10,"Kebler","w2021","Hybrid",NA,"Sat","weekend","sled","Kebler",NA,NA,NA,9.5,NA,26,-2,37,36.5,-1,-2,0,-2,-3,-5,-5,-7
"13133",2021-04-11,"Kebler","w2021","Non.motorized",NA,"Sun","weekend","no_sled","Kebler",NA,NA,NA,9.2,NA,26,0,39,35.4,-2,-1,-2,0,-2,-3,-5,-5
"13134",2021-04-11,"Kebler","w2021","Mechanized",NA,"Sun","weekend","no_sled","Kebler",NA,NA,NA,9.2,NA,26,0,39,35.4,-2,-1,-2,0,-2,-3,-5,-5
"13135",2021-04-11,"Kebler","w2021","Motorized",NA,"Sun","weekend","sled","Kebler",NA,NA,NA,9.2,NA,26,0,39,35.4,-2,-1,-2,0,-2,-3,-5,-5
"13136",2021-04-11,"Kebler","w2021","Hybrid",NA,"Sun","weekend","sled","Kebler",NA,NA,NA,9.2,NA,26,0,39,35.4,-2,-1,-2,0,-2,-3,-5,-5
"13137",2021-04-12,"Kebler","w2021","Non.motorized",3,"Mon","weekday","no_sled","Kebler",NA,NA,NA,8.8,NA,24,-2,38,36.7,0,-2,-1,-2,-2,-4,-5,-7
"13138",2021-04-12,"Kebler","w2021","Mechanized",1,"Mon","weekday","no_sled","Kebler",NA,NA,NA,8.8,NA,24,-2,38,36.7,0,-2,-1,-2,-2,-4,-5,-7
"13139",2021-04-12,"Kebler","w2021","Motorized",5,"Mon","weekday","sled","Kebler",NA,NA,NA,8.8,NA,24,-2,38,36.7,0,-2,-1,-2,-2,-4,-5,-7
"13140",2021-04-12,"Kebler","w2021","Hybrid",4,"Mon","weekday","sled","Kebler",NA,NA,NA,8.8,NA,24,-2,38,36.7,0,-2,-1,-2,-2,-4,-5,-7
"13141",2021-04-13,"Kebler","w2021","Non.motorized",5,"Tue","weekday","no_sled","Kebler",NA,NA,NA,8.4,NA,23,-1,35,36.5,-2,0,-2,-1,-3,-3,-5,-6
"13142",2021-04-13,"Kebler","w2021","Mechanized",1,"Tue","weekday","no_sled","Kebler",NA,NA,NA,8.4,NA,23,-1,35,36.5,-2,0,-2,-1,-3,-3,-5,-6
"13143",2021-04-13,"Kebler","w2021","Motorized",2,"Tue","weekday","sled","Kebler",NA,NA,NA,8.4,NA,23,-1,35,36.5,-2,0,-2,-1,-3,-3,-5,-6
"13144",2021-04-13,"Kebler","w2021","Hybrid",0,"Tue","weekday","sled","Kebler",NA,NA,NA,8.4,NA,23,-1,35,36.5,-2,0,-2,-1,-3,-3,-5,-6
"13145",2021-04-14,"Kebler","w2021","Non.motorized",3,"Wed","weekday","no_sled","Kebler",NA,NA,NA,8.4,NA,23,0,41,36.5,-1,-2,0,-2,-1,-3,-3,-5
"13146",2021-04-14,"Kebler","w2021","Mechanized",2,"Wed","weekday","no_sled","Kebler",NA,NA,NA,8.4,NA,23,0,41,36.5,-1,-2,0,-2,-1,-3,-3,-5
"13147",2021-04-14,"Kebler","w2021","Motorized",1,"Wed","weekday","sled","Kebler",NA,NA,NA,8.4,NA,23,0,41,36.5,-1,-2,0,-2,-1,-3,-3,-5
"13148",2021-04-14,"Kebler","w2021","Hybrid",0,"Wed","weekday","sled","Kebler",NA,NA,NA,8.4,NA,23,0,41,36.5,-1,-2,0,-2,-1,-3,-3,-5
"13149",2021-04-15,"Kebler","w2021","Non.motorized",1,"Thu","weekday","no_sled","Kebler",NA,NA,NA,8.1,NA,22,-1,33,36.8,0,-1,-2,0,-1,-2,-4,-4
"13150",2021-04-15,"Kebler","w2021","Mechanized",0,"Thu","weekday","no_sled","Kebler",NA,NA,NA,8.1,NA,22,-1,33,36.8,0,-1,-2,0,-1,-2,-4,-4
"13151",2021-04-15,"Kebler","w2021","Motorized",0,"Thu","weekday","sled","Kebler",NA,NA,NA,8.1,NA,22,-1,33,36.8,0,-1,-2,0,-1,-2,-4,-4
"13152",2021-04-15,"Kebler","w2021","Hybrid",0,"Thu","weekday","sled","Kebler",NA,NA,NA,8.1,NA,22,-1,33,36.8,0,-1,-2,0,-1,-2,-4,-4
"13153",2020-12-03,"Slate River Rd","w2021","Non.motorized",3,"Thu","weekday","no_sled","Slate River Rd",NA,NA,NA,NA,NA,NA,NA,NA,NA,NA,NA,NA,NA,NA,NA,NA,NA
"13154",2020-12-03,"Slate River Rd","w2021","Mechanized",1,"Thu","weekday","no_sled","Slate River Rd",NA,NA,NA,NA,NA,NA,NA,NA,NA,NA,NA,NA,NA,NA,NA,NA,NA
"13155",2020-12-03,"Slate River Rd","w2021","Motorized",0,"Thu","weekday","sled","Slate River Rd",NA,NA,NA,NA,NA,NA,NA,NA,NA,NA,NA,NA,NA,NA,NA,NA,NA
"13156",2020-12-03,"Slate River Rd","w2021","Hybrid",0,"Thu","weekday","sled","Slate River Rd",NA,NA,NA,NA,NA,NA,NA,NA,NA,NA,NA,NA,NA,NA,NA,NA,NA
"13157",2020-12-04,"Slate River Rd","w2021","Non.motorized",2,"Fri","weekday","no_sled","Slate River Rd",NA,NA,NA,2.4,NA,11,0,29,21.8,0,0,0,0,0,0,0,0
"13158",2020-12-04,"Slate River Rd","w2021","Mechanized",1,"Fri","weekday","no_sled","Slate River Rd",NA,NA,NA,2.4,NA,11,0,29,21.8,0,0,0,0,0,0,0,0
"13159",2020-12-04,"Slate River Rd","w2021","Motorized",1,"Fri","weekday","sled","Slate River Rd",NA,NA,NA,2.4,NA,11,0,29,21.8,0,0,0,0,0,0,0,0
"13160",2020-12-04,"Slate River Rd","w2021","Hybrid",1,"Fri","weekday","sled","Slate River Rd",NA,NA,NA,2.4,NA,11,0,29,21.8,0,0,0,0,0,0,0,0
"13161",2020-12-05,"Slate River Rd","w2021","Non.motorized",12,"Sat","weekend","no_sled","Slate River Rd",NA,NA,NA,2.5,NA,11,0,32,22.7,0,0,0,0,0,0,0,0
"13162",2020-12-05,"Slate River Rd","w2021","Mechanized",0,"Sat","weekend","no_sled","Slate River Rd",NA,NA,NA,2.5,NA,11,0,32,22.7,0,0,0,0,0,0,0,0
"13163",2020-12-05,"Slate River Rd","w2021","Motorized",2,"Sat","weekend","sled","Slate River Rd",NA,NA,NA,2.5,NA,11,0,32,22.7,0,0,0,0,0,0,0,0
"13164",2020-12-05,"Slate River Rd","w2021","Hybrid",1,"Sat","weekend","sled","Slate River Rd",NA,NA,NA,2.5,NA,11,0,32,22.7,0,0,0,0,0,0,0,0
"13165",2020-12-06,"Slate River Rd","w2021","Non.motorized",10,"Sun","weekend","no_sled","Slate River Rd",NA,NA,NA,2.5,NA,11,0,30,22.7,0,0,0,0,0,0,0,0
"13166",2020-12-06,"Slate River Rd","w2021","Mechanized",1,"Sun","weekend","no_sled","Slate River Rd",NA,NA,NA,2.5,NA,11,0,30,22.7,0,0,0,0,0,0,0,0
"13167",2020-12-06,"Slate River Rd","w2021","Motorized",2,"Sun","weekend","sled","Slate River Rd",NA,NA,NA,2.5,NA,11,0,30,22.7,0,0,0,0,0,0,0,0
"13168",2020-12-06,"Slate River Rd","w2021","Hybrid",0,"Sun","weekend","sled","Slate River Rd",NA,NA,NA,2.5,NA,11,0,30,22.7,0,0,0,0,0,0,0,0
"13169",2020-12-07,"Slate River Rd","w2021","Non.motorized",6,"Mon","weekday","no_sled","Slate River Rd",NA,NA,NA,2.5,NA,11,0,33,22.7,0,0,0,0,0,0,0,0
"13170",2020-12-07,"Slate River Rd","w2021","Mechanized",3,"Mon","weekday","no_sled","Slate River Rd",NA,NA,NA,2.5,NA,11,0,33,22.7,0,0,0,0,0,0,0,0
"13171",2020-12-07,"Slate River Rd","w2021","Motorized",1,"Mon","weekday","sled","Slate River Rd",NA,NA,NA,2.5,NA,11,0,33,22.7,0,0,0,0,0,0,0,0
"13172",2020-12-07,"Slate River Rd","w2021","Hybrid",0,"Mon","weekday","sled","Slate River Rd",NA,NA,NA,2.5,NA,11,0,33,22.7,0,0,0,0,0,0,0,0
"13173",2020-12-08,"Slate River Rd","w2021","Non.motorized",4,"Tue","weekday","no_sled","Slate River Rd",NA,NA,NA,2.5,NA,11,0,34,22.7,0,0,0,0,0,0,0,0
"13174",2020-12-08,"Slate River Rd","w2021","Mechanized",0,"Tue","weekday","no_sled","Slate River Rd",NA,NA,NA,2.5,NA,11,0,34,22.7,0,0,0,0,0,0,0,0
"13175",2020-12-08,"Slate River Rd","w2021","Motorized",0,"Tue","weekday","sled","Slate River Rd",NA,NA,NA,2.5,NA,11,0,34,22.7,0,0,0,0,0,0,0,0
"13176",2020-12-08,"Slate River Rd","w2021","Hybrid",0,"Tue","weekday","sled","Slate River Rd",NA,NA,NA,2.5,NA,11,0,34,22.7,0,0,0,0,0,0,0,0
"13177",2020-12-09,"Slate River Rd","w2021","Non.motorized",5,"Wed","weekday","no_sled","Slate River Rd",NA,NA,NA,2.5,NA,11,0,32,22.7,0,0,0,0,0,0,0,0
"13178",2020-12-09,"Slate River Rd","w2021","Mechanized",0,"Wed","weekday","no_sled","Slate River Rd",NA,NA,NA,2.5,NA,11,0,32,22.7,0,0,0,0,0,0,0,0
"13179",2020-12-09,"Slate River Rd","w2021","Motorized",0,"Wed","weekday","sled","Slate River Rd",NA,NA,NA,2.5,NA,11,0,32,22.7,0,0,0,0,0,0,0,0
"13180",2020-12-09,"Slate River Rd","w2021","Hybrid",0,"Wed","weekday","sled","Slate River Rd",NA,NA,NA,2.5,NA,11,0,32,22.7,0,0,0,0,0,0,0,0
"13181",2020-12-10,"Slate River Rd","w2021","Non.motorized",6,"Thu","weekday","no_sled","Slate River Rd",NA,NA,NA,2.5,NA,11,0,28,22.7,0,0,0,0,0,0,0,0
"13182",2020-12-10,"Slate River Rd","w2021","Mechanized",0,"Thu","weekday","no_sled","Slate River Rd",NA,NA,NA,2.5,NA,11,0,28,22.7,0,0,0,0,0,0,0,0
"13183",2020-12-10,"Slate River Rd","w2021","Motorized",0,"Thu","weekday","sled","Slate River Rd",NA,NA,NA,2.5,NA,11,0,28,22.7,0,0,0,0,0,0,0,0
"13184",2020-12-10,"Slate River Rd","w2021","Hybrid",0,"Thu","weekday","sled","Slate River Rd",NA,NA,NA,2.5,NA,11,0,28,22.7,0,0,0,0,0,0,0,0
"13185",2020-12-11,"Slate River Rd","w2021","Non.motorized",5,"Fri","weekday","no_sled","Slate River Rd",NA,NA,NA,2.6,NA,12,1,20,21.7,0,0,0,0,1,1,1,1
"13186",2020-12-11,"Slate River Rd","w2021","Mechanized",0,"Fri","weekday","no_sled","Slate River Rd",NA,NA,NA,2.6,NA,12,1,20,21.7,0,0,0,0,1,1,1,1
"13187",2020-12-11,"Slate River Rd","w2021","Motorized",2,"Fri","weekday","sled","Slate River Rd",NA,NA,NA,2.6,NA,12,1,20,21.7,0,0,0,0,1,1,1,1
"13188",2020-12-11,"Slate River Rd","w2021","Hybrid",0,"Fri","weekday","sled","Slate River Rd",NA,NA,NA,2.6,NA,12,1,20,21.7,0,0,0,0,1,1,1,1
"13189",2020-12-12,"Slate River Rd","w2021","Non.motorized",NA,"Sat","weekend","no_sled","Slate River Rd",NA,NA,NA,2.9,NA,17,5,12,17.1,1,0,0,0,6,6,6,6
"13190",2020-12-12,"Slate River Rd","w2021","Mechanized",NA,"Sat","weekend","no_sled","Slate River Rd",NA,NA,NA,2.9,NA,17,5,12,17.1,1,0,0,0,6,6,6,6
"13191",2020-12-12,"Slate River Rd","w2021","Motorized",NA,"Sat","weekend","sled","Slate River Rd",NA,NA,NA,2.9,NA,17,5,12,17.1,1,0,0,0,6,6,6,6
"13192",2020-12-12,"Slate River Rd","w2021","Hybrid",NA,"Sat","weekend","sled","Slate River Rd",NA,NA,NA,2.9,NA,17,5,12,17.1,1,0,0,0,6,6,6,6
"13193",2020-12-13,"Slate River Rd","w2021","Non.motorized",28,"Sun","weekend","no_sled","Slate River Rd",NA,NA,NA,3.3,NA,19,2,10,17.4,5,1,0,0,7,8,8,8
"13194",2020-12-13,"Slate River Rd","w2021","Mechanized",0,"Sun","weekend","no_sled","Slate River Rd",NA,NA,NA,3.3,NA,19,2,10,17.4,5,1,0,0,7,8,8,8
"13195",2020-12-13,"Slate River Rd","w2021","Motorized",0,"Sun","weekend","sled","Slate River Rd",NA,NA,NA,3.3,NA,19,2,10,17.4,5,1,0,0,7,8,8,8
"13196",2020-12-13,"Slate River Rd","w2021","Hybrid",4,"Sun","weekend","sled","Slate River Rd",NA,NA,NA,3.3,NA,19,2,10,17.4,5,1,0,0,7,8,8,8
"13197",2020-12-14,"Slate River Rd","w2021","Non.motorized",NA,"Mon","weekday","no_sled","Slate River Rd",NA,NA,NA,3.3,NA,18,-1,18,18.3,2,5,1,0,1,6,7,7
"13198",2020-12-14,"Slate River Rd","w2021","Mechanized",NA,"Mon","weekday","no_sled","Slate River Rd",NA,NA,NA,3.3,NA,18,-1,18,18.3,2,5,1,0,1,6,7,7
"13199",2020-12-14,"Slate River Rd","w2021","Motorized",NA,"Mon","weekday","sled","Slate River Rd",NA,NA,NA,3.3,NA,18,-1,18,18.3,2,5,1,0,1,6,7,7
"13200",2020-12-14,"Slate River Rd","w2021","Hybrid",NA,"Mon","weekday","sled","Slate River Rd",NA,NA,NA,3.3,NA,18,-1,18,18.3,2,5,1,0,1,6,7,7
"13201",2020-12-15,"Slate River Rd","w2021","Non.motorized",NA,"Tue","weekday","no_sled","Slate River Rd",NA,NA,NA,3.5,NA,19,1,13,18.4,-1,2,5,1,0,2,7,8
"13202",2020-12-15,"Slate River Rd","w2021","Mechanized",NA,"Tue","weekday","no_sled","Slate River Rd",NA,NA,NA,3.5,NA,19,1,13,18.4,-1,2,5,1,0,2,7,8
"13203",2020-12-15,"Slate River Rd","w2021","Motorized",NA,"Tue","weekday","sled","Slate River Rd",NA,NA,NA,3.5,NA,19,1,13,18.4,-1,2,5,1,0,2,7,8
"13204",2020-12-15,"Slate River Rd","w2021","Hybrid",NA,"Tue","weekday","sled","Slate River Rd",NA,NA,NA,3.5,NA,19,1,13,18.4,-1,2,5,1,0,2,7,8
"13205",2020-12-16,"Slate River Rd","w2021","Non.motorized",8,"Wed","weekday","no_sled","Slate River Rd",NA,NA,NA,3.5,NA,19,0,16,18.4,1,-1,2,5,1,0,2,7
"13206",2020-12-16,"Slate River Rd","w2021","Mechanized",0,"Wed","weekday","no_sled","Slate River Rd",NA,NA,NA,3.5,NA,19,0,16,18.4,1,-1,2,5,1,0,2,7
"13207",2020-12-16,"Slate River Rd","w2021","Motorized",0,"Wed","weekday","sled","Slate River Rd",NA,NA,NA,3.5,NA,19,0,16,18.4,1,-1,2,5,1,0,2,7
"13208",2020-12-16,"Slate River Rd","w2021","Hybrid",1,"Wed","weekday","sled","Slate River Rd",NA,NA,NA,3.5,NA,19,0,16,18.4,1,-1,2,5,1,0,2,7
"13209",2020-12-17,"Slate River Rd","w2021","Non.motorized",16,"Thu","weekday","no_sled","Slate River Rd",NA,NA,NA,3.5,NA,19,0,20,18.4,0,1,-1,2,0,1,0,2
"13210",2020-12-17,"Slate River Rd","w2021","Mechanized",0,"Thu","weekday","no_sled","Slate River Rd",NA,NA,NA,3.5,NA,19,0,20,18.4,0,1,-1,2,0,1,0,2
"13211",2020-12-17,"Slate River Rd","w2021","Motorized",0,"Thu","weekday","sled","Slate River Rd",NA,NA,NA,3.5,NA,19,0,20,18.4,0,1,-1,2,0,1,0,2
"13212",2020-12-17,"Slate River Rd","w2021","Hybrid",2,"Thu","weekday","sled","Slate River Rd",NA,NA,NA,3.5,NA,19,0,20,18.4,0,1,-1,2,0,1,0,2
"13213",2020-12-18,"Slate River Rd","w2021","Non.motorized",23,"Fri","weekday","no_sled","Slate River Rd",NA,NA,NA,3.8,NA,22,3,20,17.3,0,0,1,-1,3,3,4,3
"13214",2020-12-18,"Slate River Rd","w2021","Mechanized",0,"Fri","weekday","no_sled","Slate River Rd",NA,NA,NA,3.8,NA,22,3,20,17.3,0,0,1,-1,3,3,4,3
"13215",2020-12-18,"Slate River Rd","w2021","Motorized",0,"Fri","weekday","sled","Slate River Rd",NA,NA,NA,3.8,NA,22,3,20,17.3,0,0,1,-1,3,3,4,3
"13216",2020-12-18,"Slate River Rd","w2021","Hybrid",3,"Fri","weekday","sled","Slate River Rd",NA,NA,NA,3.8,NA,22,3,20,17.3,0,0,1,-1,3,3,4,3
"13217",2020-12-19,"Slate River Rd","w2021","Non.motorized",17,"Sat","weekend","no_sled","Slate River Rd",NA,NA,NA,3.9,NA,22,0,17,17.7,3,0,0,1,3,3,3,4
"13218",2020-12-19,"Slate River Rd","w2021","Mechanized",0,"Sat","weekend","no_sled","Slate River Rd",NA,NA,NA,3.9,NA,22,0,17,17.7,3,0,0,1,3,3,3,4
"13219",2020-12-19,"Slate River Rd","w2021","Motorized",2,"Sat","weekend","sled","Slate River Rd",NA,NA,NA,3.9,NA,22,0,17,17.7,3,0,0,1,3,3,3,4
"13220",2020-12-19,"Slate River Rd","w2021","Hybrid",7,"Sat","weekend","sled","Slate River Rd",NA,NA,NA,3.9,NA,22,0,17,17.7,3,0,0,1,3,3,3,4
"13221",2020-12-20,"Slate River Rd","w2021","Non.motorized",46,"Sun","weekend","no_sled","Slate River Rd",NA,NA,NA,3.9,NA,21,-1,26,18.6,0,3,0,0,-1,2,2,2
"13222",2020-12-20,"Slate River Rd","w2021","Mechanized",0,"Sun","weekend","no_sled","Slate River Rd",NA,NA,NA,3.9,NA,21,-1,26,18.6,0,3,0,0,-1,2,2,2
"13223",2020-12-20,"Slate River Rd","w2021","Motorized",0,"Sun","weekend","sled","Slate River Rd",NA,NA,NA,3.9,NA,21,-1,26,18.6,0,3,0,0,-1,2,2,2
"13224",2020-12-20,"Slate River Rd","w2021","Hybrid",2,"Sun","weekend","sled","Slate River Rd",NA,NA,NA,3.9,NA,21,-1,26,18.6,0,3,0,0,-1,2,2,2
"13225",2020-12-21,"Slate River Rd","w2021","Non.motorized",29,"Mon","weekday","no_sled","Slate River Rd",NA,NA,NA,3.9,NA,20,-1,28,19.5,-1,0,3,0,-2,-2,1,1
"13226",2020-12-21,"Slate River Rd","w2021","Mechanized",0,"Mon","weekday","no_sled","Slate River Rd",NA,NA,NA,3.9,NA,20,-1,28,19.5,-1,0,3,0,-2,-2,1,1
"13227",2020-12-21,"Slate River Rd","w2021","Motorized",0,"Mon","weekday","sled","Slate River Rd",NA,NA,NA,3.9,NA,20,-1,28,19.5,-1,0,3,0,-2,-2,1,1
"13228",2020-12-21,"Slate River Rd","w2021","Hybrid",5,"Mon","weekday","sled","Slate River Rd",NA,NA,NA,3.9,NA,20,-1,28,19.5,-1,0,3,0,-2,-2,1,1
"13229",2020-12-22,"Slate River Rd","w2021","Non.motorized",31,"Tue","weekday","no_sled","Slate River Rd",NA,NA,NA,4,NA,20,0,24,20,-1,-1,0,3,-1,-2,-2,1
"13230",2020-12-22,"Slate River Rd","w2021","Mechanized",0,"Tue","weekday","no_sled","Slate River Rd",NA,NA,NA,4,NA,20,0,24,20,-1,-1,0,3,-1,-2,-2,1
"13231",2020-12-22,"Slate River Rd","w2021","Motorized",0,"Tue","weekday","sled","Slate River Rd",NA,NA,NA,4,NA,20,0,24,20,-1,-1,0,3,-1,-2,-2,1
"13232",2020-12-22,"Slate River Rd","w2021","Hybrid",1,"Tue","weekday","sled","Slate River Rd",NA,NA,NA,4,NA,20,0,24,20,-1,-1,0,3,-1,-2,-2,1
"13233",2020-12-23,"Slate River Rd","w2021","Non.motorized",24,"Wed","weekday","no_sled","Slate River Rd",NA,NA,NA,4.1,NA,22,2,6,18.6,0,-1,-1,0,2,1,0,0
"13234",2020-12-23,"Slate River Rd","w2021","Mechanized",0,"Wed","weekday","no_sled","Slate River Rd",NA,NA,NA,4.1,NA,22,2,6,18.6,0,-1,-1,0,2,1,0,0
"13235",2020-12-23,"Slate River Rd","w2021","Motorized",0,"Wed","weekday","sled","Slate River Rd",NA,NA,NA,4.1,NA,22,2,6,18.6,0,-1,-1,0,2,1,0,0
"13236",2020-12-23,"Slate River Rd","w2021","Hybrid",4,"Wed","weekday","sled","Slate River Rd",NA,NA,NA,4.1,NA,22,2,6,18.6,0,-1,-1,0,2,1,0,0
"13237",2020-12-24,"Slate River Rd","w2021","Non.motorized",32,"Thu","weekday","no_sled","Slate River Rd",NA,NA,NA,4.1,NA,21,-1,15,19.5,2,0,-1,-1,1,1,0,-1
"13238",2020-12-24,"Slate River Rd","w2021","Mechanized",0,"Thu","weekday","no_sled","Slate River Rd",NA,NA,NA,4.1,NA,21,-1,15,19.5,2,0,-1,-1,1,1,0,-1
"13239",2020-12-24,"Slate River Rd","w2021","Motorized",1,"Thu","weekday","sled","Slate River Rd",NA,NA,NA,4.1,NA,21,-1,15,19.5,2,0,-1,-1,1,1,0,-1
"13240",2020-12-24,"Slate River Rd","w2021","Hybrid",2,"Thu","weekday","sled","Slate River Rd",NA,NA,NA,4.1,NA,21,-1,15,19.5,2,0,-1,-1,1,1,0,-1
"13241",2020-12-25,"Slate River Rd","w2021","Non.motorized",68,"Fri","weekday","no_sled","Slate River Rd",NA,NA,NA,4.1,NA,20,-1,25,20.5,-1,2,0,-1,-2,0,0,-1
"13242",2020-12-25,"Slate River Rd","w2021","Mechanized",1,"Fri","weekday","no_sled","Slate River Rd",NA,NA,NA,4.1,NA,20,-1,25,20.5,-1,2,0,-1,-2,0,0,-1
"13243",2020-12-25,"Slate River Rd","w2021","Motorized",0,"Fri","weekday","sled","Slate River Rd",NA,NA,NA,4.1,NA,20,-1,25,20.5,-1,2,0,-1,-2,0,0,-1
"13244",2020-12-25,"Slate River Rd","w2021","Hybrid",9,"Fri","weekday","sled","Slate River Rd",NA,NA,NA,4.1,NA,20,-1,25,20.5,-1,2,0,-1,-2,0,0,-1
"13245",2020-12-26,"Slate River Rd","w2021","Non.motorized",70,"Sat","weekend","no_sled","Slate River Rd",NA,NA,NA,4.1,NA,20,0,26,20.5,-1,-1,2,0,-1,-2,0,0
"13246",2020-12-26,"Slate River Rd","w2021","Mechanized",0,"Sat","weekend","no_sled","Slate River Rd",NA,NA,NA,4.1,NA,20,0,26,20.5,-1,-1,2,0,-1,-2,0,0
"13247",2020-12-26,"Slate River Rd","w2021","Motorized",0,"Sat","weekend","sled","Slate River Rd",NA,NA,NA,4.1,NA,20,0,26,20.5,-1,-1,2,0,-1,-2,0,0
"13248",2020-12-26,"Slate River Rd","w2021","Hybrid",9,"Sat","weekend","sled","Slate River Rd",NA,NA,NA,4.1,NA,20,0,26,20.5,-1,-1,2,0,-1,-2,0,0
"13249",2020-12-27,"Slate River Rd","w2021","Non.motorized",68,"Sun","weekend","no_sled","Slate River Rd",NA,NA,NA,4.2,NA,19,-1,19,22.1,0,-1,-1,2,-1,-2,-3,-1
"13250",2020-12-27,"Slate River Rd","w2021","Mechanized",1,"Sun","weekend","no_sled","Slate River Rd",NA,NA,NA,4.2,NA,19,-1,19,22.1,0,-1,-1,2,-1,-2,-3,-1
"13251",2020-12-27,"Slate River Rd","w2021","Motorized",2,"Sun","weekend","sled","Slate River Rd",NA,NA,NA,4.2,NA,19,-1,19,22.1,0,-1,-1,2,-1,-2,-3,-1
"13252",2020-12-27,"Slate River Rd","w2021","Hybrid",7,"Sun","weekend","sled","Slate River Rd",NA,NA,NA,4.2,NA,19,-1,19,22.1,0,-1,-1,2,-1,-2,-3,-1
"13253",2020-12-28,"Slate River Rd","w2021","Non.motorized",20,"Mon","weekday","no_sled","Slate River Rd",NA,NA,NA,4.2,NA,20,1,22,21,-1,0,-1,-1,0,0,-1,-2
"13254",2020-12-28,"Slate River Rd","w2021","Mechanized",0,"Mon","weekday","no_sled","Slate River Rd",NA,NA,NA,4.2,NA,20,1,22,21,-1,0,-1,-1,0,0,-1,-2
"13255",2020-12-28,"Slate River Rd","w2021","Motorized",0,"Mon","weekday","sled","Slate River Rd",NA,NA,NA,4.2,NA,20,1,22,21,-1,0,-1,-1,0,0,-1,-2
"13256",2020-12-28,"Slate River Rd","w2021","Hybrid",7,"Mon","weekday","sled","Slate River Rd",NA,NA,NA,4.2,NA,20,1,22,21,-1,0,-1,-1,0,0,-1,-2
"13257",2020-12-29,"Slate River Rd","w2021","Non.motorized",39,"Tue","weekday","no_sled","Slate River Rd",NA,NA,NA,4.9,NA,27,7,15,18.1,1,-1,0,-1,8,7,7,6
"13258",2020-12-29,"Slate River Rd","w2021","Mechanized",0,"Tue","weekday","no_sled","Slate River Rd",NA,NA,NA,4.9,NA,27,7,15,18.1,1,-1,0,-1,8,7,7,6
"13259",2020-12-29,"Slate River Rd","w2021","Motorized",0,"Tue","weekday","sled","Slate River Rd",NA,NA,NA,4.9,NA,27,7,15,18.1,1,-1,0,-1,8,7,7,6
"13260",2020-12-29,"Slate River Rd","w2021","Hybrid",5,"Tue","weekday","sled","Slate River Rd",NA,NA,NA,4.9,NA,27,7,15,18.1,1,-1,0,-1,8,7,7,6
"13261",2020-12-30,"Slate River Rd","w2021","Non.motorized",37,"Wed","weekday","no_sled","Slate River Rd",NA,NA,NA,4.9,NA,26,-1,10,18.8,7,1,-1,0,6,7,6,6
"13262",2020-12-30,"Slate River Rd","w2021","Mechanized",0,"Wed","weekday","no_sled","Slate River Rd",NA,NA,NA,4.9,NA,26,-1,10,18.8,7,1,-1,0,6,7,6,6
"13263",2020-12-30,"Slate River Rd","w2021","Motorized",0,"Wed","weekday","sled","Slate River Rd",NA,NA,NA,4.9,NA,26,-1,10,18.8,7,1,-1,0,6,7,6,6
"13264",2020-12-30,"Slate River Rd","w2021","Hybrid",3,"Wed","weekday","sled","Slate River Rd",NA,NA,NA,4.9,NA,26,-1,10,18.8,7,1,-1,0,6,7,6,6
"13265",2021-12-31,"Slate River Rd","w2021","Non.motorized",59,"Fri","weekday","no_sled","Slate River Rd",NA,NA,NA,NA,NA,NA,NA,NA,NA,NA,NA,NA,NA,NA,NA,NA,NA
"13266",2021-12-31,"Slate River Rd","w2021","Mechanized",0,"Fri","weekday","no_sled","Slate River Rd",NA,NA,NA,NA,NA,NA,NA,NA,NA,NA,NA,NA,NA,NA,NA,NA,NA
"13267",2021-12-31,"Slate River Rd","w2021","Motorized",1,"Fri","weekday","sled","Slate River Rd",NA,NA,NA,NA,NA,NA,NA,NA,NA,NA,NA,NA,NA,NA,NA,NA,NA
"13268",2021-12-31,"Slate River Rd","w2021","Hybrid",5,"Fri","weekday","sled","Slate River Rd",NA,NA,NA,NA,NA,NA,NA,NA,NA,NA,NA,NA,NA,NA,NA,NA,NA
"13269",2021-01-01,"Slate River Rd","w2021","Non.motorized",104,"Fri","weekday","no_sled","Slate River Rd",NA,NA,NA,4.9,NA,24,-1,21,20.4,-1,-1,7,1,-2,-3,4,5
"13270",2021-01-01,"Slate River Rd","w2021","Mechanized",0,"Fri","weekday","no_sled","Slate River Rd",NA,NA,NA,4.9,NA,24,-1,21,20.4,-1,-1,7,1,-2,-3,4,5
"13271",2021-01-01,"Slate River Rd","w2021","Motorized",0,"Fri","weekday","sled","Slate River Rd",NA,NA,NA,4.9,NA,24,-1,21,20.4,-1,-1,7,1,-2,-3,4,5
"13272",2021-01-01,"Slate River Rd","w2021","Hybrid",11,"Fri","weekday","sled","Slate River Rd",NA,NA,NA,4.9,NA,24,-1,21,20.4,-1,-1,7,1,-2,-3,4,5
"13273",2021-01-02,"Slate River Rd","w2021","Non.motorized",58,"Sat","weekend","no_sled","Slate River Rd",NA,NA,NA,4.9,NA,23,-1,19,21.3,-1,-1,-1,7,-2,-3,-4,3
"13274",2021-01-02,"Slate River Rd","w2021","Mechanized",0,"Sat","weekend","no_sled","Slate River Rd",NA,NA,NA,4.9,NA,23,-1,19,21.3,-1,-1,-1,7,-2,-3,-4,3
"13275",2021-01-02,"Slate River Rd","w2021","Motorized",5,"Sat","weekend","sled","Slate River Rd",NA,NA,NA,4.9,NA,23,-1,19,21.3,-1,-1,-1,7,-2,-3,-4,3
"13276",2021-01-02,"Slate River Rd","w2021","Hybrid",14,"Sat","weekend","sled","Slate River Rd",NA,NA,NA,4.9,NA,23,-1,19,21.3,-1,-1,-1,7,-2,-3,-4,3
"13277",2021-01-03,"Slate River Rd","w2021","Non.motorized",44,"Sun","weekend","no_sled","Slate River Rd",NA,NA,NA,4.9,NA,23,0,21,21.3,-1,-1,-1,-1,-1,-2,-3,-4
"13278",2021-01-03,"Slate River Rd","w2021","Mechanized",0,"Sun","weekend","no_sled","Slate River Rd",NA,NA,NA,4.9,NA,23,0,21,21.3,-1,-1,-1,-1,-1,-2,-3,-4
"13279",2021-01-03,"Slate River Rd","w2021","Motorized",0,"Sun","weekend","sled","Slate River Rd",NA,NA,NA,4.9,NA,23,0,21,21.3,-1,-1,-1,-1,-1,-2,-3,-4
"13280",2021-01-03,"Slate River Rd","w2021","Hybrid",7,"Sun","weekend","sled","Slate River Rd",NA,NA,NA,4.9,NA,23,0,21,21.3,-1,-1,-1,-1,-1,-2,-3,-4
"13281",2021-01-04,"Slate River Rd","w2021","Non.motorized",23,"Mon","weekday","no_sled","Slate River Rd",NA,NA,NA,4.9,NA,22,-1,25,22.3,0,-1,-1,-1,-1,-2,-3,-4
"13282",2021-01-04,"Slate River Rd","w2021","Mechanized",2,"Mon","weekday","no_sled","Slate River Rd",NA,NA,NA,4.9,NA,22,-1,25,22.3,0,-1,-1,-1,-1,-2,-3,-4
"13283",2021-01-04,"Slate River Rd","w2021","Motorized",0,"Mon","weekday","sled","Slate River Rd",NA,NA,NA,4.9,NA,22,-1,25,22.3,0,-1,-1,-1,-1,-2,-3,-4
"13284",2021-01-04,"Slate River Rd","w2021","Hybrid",5,"Mon","weekday","sled","Slate River Rd",NA,NA,NA,4.9,NA,22,-1,25,22.3,0,-1,-1,-1,-1,-2,-3,-4
"13285",2021-01-05,"Slate River Rd","w2021","Non.motorized",NA,"Tue","weekday","no_sled","Slate River Rd",NA,NA,NA,5,NA,22,0,23,22.7,-1,0,-1,-1,-1,-1,-2,-3
"13286",2021-01-05,"Slate River Rd","w2021","Mechanized",NA,"Tue","weekday","no_sled","Slate River Rd",NA,NA,NA,5,NA,22,0,23,22.7,-1,0,-1,-1,-1,-1,-2,-3
"13287",2021-01-05,"Slate River Rd","w2021","Motorized",NA,"Tue","weekday","sled","Slate River Rd",NA,NA,NA,5,NA,22,0,23,22.7,-1,0,-1,-1,-1,-1,-2,-3
"13288",2021-01-05,"Slate River Rd","w2021","Hybrid",NA,"Tue","weekday","sled","Slate River Rd",NA,NA,NA,5,NA,22,0,23,22.7,-1,0,-1,-1,-1,-1,-2,-3
"13289",2021-01-06,"Slate River Rd","w2021","Non.motorized",33,"Wed","weekday","no_sled","Slate River Rd",NA,NA,NA,5.1,NA,24,2,18,21.2,0,-1,0,-1,2,1,1,0
"13290",2021-01-06,"Slate River Rd","w2021","Mechanized",0,"Wed","weekday","no_sled","Slate River Rd",NA,NA,NA,5.1,NA,24,2,18,21.2,0,-1,0,-1,2,1,1,0
"13291",2021-01-06,"Slate River Rd","w2021","Motorized",2,"Wed","weekday","sled","Slate River Rd",NA,NA,NA,5.1,NA,24,2,18,21.2,0,-1,0,-1,2,1,1,0
"13292",2021-01-06,"Slate River Rd","w2021","Hybrid",6,"Wed","weekday","sled","Slate River Rd",NA,NA,NA,5.1,NA,24,2,18,21.2,0,-1,0,-1,2,1,1,0
"13293",2021-01-07,"Slate River Rd","w2021","Non.motorized",36,"Thu","weekday","no_sled","Slate River Rd",NA,NA,NA,5.1,NA,24,0,23,21.2,2,0,-1,0,2,2,1,1
"13294",2021-01-07,"Slate River Rd","w2021","Mechanized",0,"Thu","weekday","no_sled","Slate River Rd",NA,NA,NA,5.1,NA,24,0,23,21.2,2,0,-1,0,2,2,1,1
"13295",2021-01-07,"Slate River Rd","w2021","Motorized",0,"Thu","weekday","sled","Slate River Rd",NA,NA,NA,5.1,NA,24,0,23,21.2,2,0,-1,0,2,2,1,1
"13296",2021-01-07,"Slate River Rd","w2021","Hybrid",6,"Thu","weekday","sled","Slate River Rd",NA,NA,NA,5.1,NA,24,0,23,21.2,2,0,-1,0,2,2,1,1
"13297",2021-01-08,"Slate River Rd","w2021","Non.motorized",27,"Fri","weekday","no_sled","Slate River Rd",NA,NA,NA,5.1,NA,23,-1,20,22.2,0,2,0,-1,-1,1,1,0
"13298",2021-01-08,"Slate River Rd","w2021","Mechanized",0,"Fri","weekday","no_sled","Slate River Rd",NA,NA,NA,5.1,NA,23,-1,20,22.2,0,2,0,-1,-1,1,1,0
"13299",2021-01-08,"Slate River Rd","w2021","Motorized",0,"Fri","weekday","sled","Slate River Rd",NA,NA,NA,5.1,NA,23,-1,20,22.2,0,2,0,-1,-1,1,1,0
"13300",2021-01-08,"Slate River Rd","w2021","Hybrid",0,"Fri","weekday","sled","Slate River Rd",NA,NA,NA,5.1,NA,23,-1,20,22.2,0,2,0,-1,-1,1,1,0
"13301",2021-01-09,"Slate River Rd","w2021","Non.motorized",38,"Sat","weekend","no_sled","Slate River Rd",NA,NA,NA,5.1,NA,23,0,19,22.2,-1,0,2,0,-1,-1,1,1
"13302",2021-01-09,"Slate River Rd","w2021","Mechanized",0,"Sat","weekend","no_sled","Slate River Rd",NA,NA,NA,5.1,NA,23,0,19,22.2,-1,0,2,0,-1,-1,1,1
"13303",2021-01-09,"Slate River Rd","w2021","Motorized",0,"Sat","weekend","sled","Slate River Rd",NA,NA,NA,5.1,NA,23,0,19,22.2,-1,0,2,0,-1,-1,1,1
"13304",2021-01-09,"Slate River Rd","w2021","Hybrid",14,"Sat","weekend","sled","Slate River Rd",NA,NA,NA,5.1,NA,23,0,19,22.2,-1,0,2,0,-1,-1,1,1
"13305",2021-01-10,"Slate River Rd","w2021","Non.motorized",56,"Sun","weekend","no_sled","Slate River Rd",NA,NA,NA,5.1,NA,23,0,14,22.2,0,-1,0,2,0,-1,-1,1
"13306",2021-01-10,"Slate River Rd","w2021","Mechanized",0,"Sun","weekend","no_sled","Slate River Rd",NA,NA,NA,5.1,NA,23,0,14,22.2,0,-1,0,2,0,-1,-1,1
"13307",2021-01-10,"Slate River Rd","w2021","Motorized",0,"Sun","weekend","sled","Slate River Rd",NA,NA,NA,5.1,NA,23,0,14,22.2,0,-1,0,2,0,-1,-1,1
"13308",2021-01-10,"Slate River Rd","w2021","Hybrid",11,"Sun","weekend","sled","Slate River Rd",NA,NA,NA,5.1,NA,23,0,14,22.2,0,-1,0,2,0,-1,-1,1
"13309",2021-01-11,"Slate River Rd","w2021","Non.motorized",12,"Mon","weekday","no_sled","Slate River Rd",NA,NA,NA,5.1,NA,23,0,15,22.2,0,0,-1,0,0,0,-1,-1
"13310",2021-01-11,"Slate River Rd","w2021","Mechanized",0,"Mon","weekday","no_sled","Slate River Rd",NA,NA,NA,5.1,NA,23,0,15,22.2,0,0,-1,0,0,0,-1,-1
"13311",2021-01-11,"Slate River Rd","w2021","Motorized",0,"Mon","weekday","sled","Slate River Rd",NA,NA,NA,5.1,NA,23,0,15,22.2,0,0,-1,0,0,0,-1,-1
"13312",2021-01-11,"Slate River Rd","w2021","Hybrid",11,"Mon","weekday","sled","Slate River Rd",NA,NA,NA,5.1,NA,23,0,15,22.2,0,0,-1,0,0,0,-1,-1
"13313",2021-01-12,"Slate River Rd","w2021","Non.motorized",16,"Tue","weekday","no_sled","Slate River Rd",NA,NA,NA,5.1,NA,23,0,23,22.2,0,0,0,-1,0,0,0,-1
"13314",2021-01-12,"Slate River Rd","w2021","Mechanized",2,"Tue","weekday","no_sled","Slate River Rd",NA,NA,NA,5.1,NA,23,0,23,22.2,0,0,0,-1,0,0,0,-1
"13315",2021-01-12,"Slate River Rd","w2021","Motorized",0,"Tue","weekday","sled","Slate River Rd",NA,NA,NA,5.1,NA,23,0,23,22.2,0,0,0,-1,0,0,0,-1
"13316",2021-01-12,"Slate River Rd","w2021","Hybrid",10,"Tue","weekday","sled","Slate River Rd",NA,NA,NA,5.1,NA,23,0,23,22.2,0,0,0,-1,0,0,0,-1
"13317",2021-01-13,"Slate River Rd","w2021","Non.motorized",44,"Wed","weekday","no_sled","Slate River Rd",NA,NA,NA,5.1,NA,23,0,28,22.2,0,0,0,0,0,0,0,0
"13318",2021-01-13,"Slate River Rd","w2021","Mechanized",0,"Wed","weekday","no_sled","Slate River Rd",NA,NA,NA,5.1,NA,23,0,28,22.2,0,0,0,0,0,0,0,0
"13319",2021-01-13,"Slate River Rd","w2021","Motorized",4,"Wed","weekday","sled","Slate River Rd",NA,NA,NA,5.1,NA,23,0,28,22.2,0,0,0,0,0,0,0,0
"13320",2021-01-13,"Slate River Rd","w2021","Hybrid",7,"Wed","weekday","sled","Slate River Rd",NA,NA,NA,5.1,NA,23,0,28,22.2,0,0,0,0,0,0,0,0
"13321",2021-01-14,"Slate River Rd","w2021","Non.motorized",18,"Thu","weekday","no_sled","Slate River Rd",NA,NA,NA,5.1,NA,22,-1,20,23.2,0,0,0,0,-1,-1,-1,-1
"13322",2021-01-14,"Slate River Rd","w2021","Mechanized",0,"Thu","weekday","no_sled","Slate River Rd",NA,NA,NA,5.1,NA,22,-1,20,23.2,0,0,0,0,-1,-1,-1,-1
"13323",2021-01-14,"Slate River Rd","w2021","Motorized",0,"Thu","weekday","sled","Slate River Rd",NA,NA,NA,5.1,NA,22,-1,20,23.2,0,0,0,0,-1,-1,-1,-1
"13324",2021-01-14,"Slate River Rd","w2021","Hybrid",4,"Thu","weekday","sled","Slate River Rd",NA,NA,NA,5.1,NA,22,-1,20,23.2,0,0,0,0,-1,-1,-1,-1
"13325",2021-01-15,"Slate River Rd","w2021","Non.motorized",40,"Fri","weekday","no_sled","Slate River Rd",NA,NA,NA,5.1,NA,22,0,26,23.2,-1,0,0,0,-1,-1,-1,-1
"13326",2021-01-15,"Slate River Rd","w2021","Mechanized",0,"Fri","weekday","no_sled","Slate River Rd",NA,NA,NA,5.1,NA,22,0,26,23.2,-1,0,0,0,-1,-1,-1,-1
"13327",2021-01-15,"Slate River Rd","w2021","Motorized",0,"Fri","weekday","sled","Slate River Rd",NA,NA,NA,5.1,NA,22,0,26,23.2,-1,0,0,0,-1,-1,-1,-1
"13328",2021-01-15,"Slate River Rd","w2021","Hybrid",3,"Fri","weekday","sled","Slate River Rd",NA,NA,NA,5.1,NA,22,0,26,23.2,-1,0,0,0,-1,-1,-1,-1
"13329",2021-01-16,"Slate River Rd","w2021","Non.motorized",74,"Sat","weekend","no_sled","Slate River Rd",NA,NA,NA,5.1,NA,22,0,26,23.2,0,-1,0,0,0,-1,-1,-1
"13330",2021-01-16,"Slate River Rd","w2021","Mechanized",0,"Sat","weekend","no_sled","Slate River Rd",NA,NA,NA,5.1,NA,22,0,26,23.2,0,-1,0,0,0,-1,-1,-1
"13331",2021-01-16,"Slate River Rd","w2021","Motorized",7,"Sat","weekend","sled","Slate River Rd",NA,NA,NA,5.1,NA,22,0,26,23.2,0,-1,0,0,0,-1,-1,-1
"13332",2021-01-16,"Slate River Rd","w2021","Hybrid",9,"Sat","weekend","sled","Slate River Rd",NA,NA,NA,5.1,NA,22,0,26,23.2,0,-1,0,0,0,-1,-1,-1
"13333",2021-01-17,"Slate River Rd","w2021","Non.motorized",98,"Sun","weekend","no_sled","Slate River Rd",NA,NA,NA,5.1,NA,22,0,29,23.2,0,0,-1,0,0,0,-1,-1
"13334",2021-01-17,"Slate River Rd","w2021","Mechanized",7,"Sun","weekend","no_sled","Slate River Rd",NA,NA,NA,5.1,NA,22,0,29,23.2,0,0,-1,0,0,0,-1,-1
"13335",2021-01-17,"Slate River Rd","w2021","Motorized",0,"Sun","weekend","sled","Slate River Rd",NA,NA,NA,5.1,NA,22,0,29,23.2,0,0,-1,0,0,0,-1,-1
"13336",2021-01-17,"Slate River Rd","w2021","Hybrid",4,"Sun","weekend","sled","Slate River Rd",NA,NA,NA,5.1,NA,22,0,29,23.2,0,0,-1,0,0,0,-1,-1
"13337",2021-01-18,"Slate River Rd","w2021","Non.motorized",42,"Mon","weekday","no_sled","Slate River Rd",NA,NA,NA,5.1,NA,22,0,24,23.2,0,0,0,-1,0,0,0,-1
"13338",2021-01-18,"Slate River Rd","w2021","Mechanized",3,"Mon","weekday","no_sled","Slate River Rd",NA,NA,NA,5.1,NA,22,0,24,23.2,0,0,0,-1,0,0,0,-1
"13339",2021-01-18,"Slate River Rd","w2021","Motorized",1,"Mon","weekday","sled","Slate River Rd",NA,NA,NA,5.1,NA,22,0,24,23.2,0,0,0,-1,0,0,0,-1
"13340",2021-01-18,"Slate River Rd","w2021","Hybrid",11,"Mon","weekday","sled","Slate River Rd",NA,NA,NA,5.1,NA,22,0,24,23.2,0,0,0,-1,0,0,0,-1
"13341",2021-01-19,"Slate River Rd","w2021","Non.motorized",12,"Tue","weekday","no_sled","Slate River Rd",NA,NA,NA,5.1,NA,22,0,19,23.2,0,0,0,0,0,0,0,0
"13342",2021-01-19,"Slate River Rd","w2021","Mechanized",0,"Tue","weekday","no_sled","Slate River Rd",NA,NA,NA,5.1,NA,22,0,19,23.2,0,0,0,0,0,0,0,0
"13343",2021-01-19,"Slate River Rd","w2021","Motorized",0,"Tue","weekday","sled","Slate River Rd",NA,NA,NA,5.1,NA,22,0,19,23.2,0,0,0,0,0,0,0,0
"13344",2021-01-19,"Slate River Rd","w2021","Hybrid",4,"Tue","weekday","sled","Slate River Rd",NA,NA,NA,5.1,NA,22,0,19,23.2,0,0,0,0,0,0,0,0
"13345",2021-01-20,"Slate River Rd","w2021","Non.motorized",26,"Wed","weekday","no_sled","Slate River Rd",NA,NA,NA,5.2,NA,23,1,26,22.6,0,0,0,0,1,1,1,1
"13346",2021-01-20,"Slate River Rd","w2021","Mechanized",2,"Wed","weekday","no_sled","Slate River Rd",NA,NA,NA,5.2,NA,23,1,26,22.6,0,0,0,0,1,1,1,1
"13347",2021-01-20,"Slate River Rd","w2021","Motorized",1,"Wed","weekday","sled","Slate River Rd",NA,NA,NA,5.2,NA,23,1,26,22.6,0,0,0,0,1,1,1,1
"13348",2021-01-20,"Slate River Rd","w2021","Hybrid",9,"Wed","weekday","sled","Slate River Rd",NA,NA,NA,5.2,NA,23,1,26,22.6,0,0,0,0,1,1,1,1
"13349",2021-01-21,"Slate River Rd","w2021","Non.motorized",4,"Thu","weekday","no_sled","Slate River Rd",NA,NA,NA,5.2,NA,23,0,26,22.6,1,0,0,0,1,1,1,1
"13350",2021-01-21,"Slate River Rd","w2021","Mechanized",0,"Thu","weekday","no_sled","Slate River Rd",NA,NA,NA,5.2,NA,23,0,26,22.6,1,0,0,0,1,1,1,1
"13351",2021-01-21,"Slate River Rd","w2021","Motorized",0,"Thu","weekday","sled","Slate River Rd",NA,NA,NA,5.2,NA,23,0,26,22.6,1,0,0,0,1,1,1,1
"13352",2021-01-21,"Slate River Rd","w2021","Hybrid",0,"Thu","weekday","sled","Slate River Rd",NA,NA,NA,5.2,NA,23,0,26,22.6,1,0,0,0,1,1,1,1
"13353",2021-01-22,"Slate River Rd","w2021","Non.motorized",15,"Fri","weekday","no_sled","Slate River Rd",NA,NA,NA,5.3,NA,25,2,25,21.2,0,1,0,0,2,3,3,3
"13354",2021-01-22,"Slate River Rd","w2021","Mechanized",1,"Fri","weekday","no_sled","Slate River Rd",NA,NA,NA,5.3,NA,25,2,25,21.2,0,1,0,0,2,3,3,3
"13355",2021-01-22,"Slate River Rd","w2021","Motorized",2,"Fri","weekday","sled","Slate River Rd",NA,NA,NA,5.3,NA,25,2,25,21.2,0,1,0,0,2,3,3,3
"13356",2021-01-22,"Slate River Rd","w2021","Hybrid",1,"Fri","weekday","sled","Slate River Rd",NA,NA,NA,5.3,NA,25,2,25,21.2,0,1,0,0,2,3,3,3
"13357",2021-01-23,"Slate River Rd","w2021","Non.motorized",15,"Sat","weekend","no_sled","Slate River Rd",NA,NA,NA,5.4,NA,26,1,22,20.8,2,0,1,0,3,3,4,4
"13358",2021-01-23,"Slate River Rd","w2021","Mechanized",0,"Sat","weekend","no_sled","Slate River Rd",NA,NA,NA,5.4,NA,26,1,22,20.8,2,0,1,0,3,3,4,4
"13359",2021-01-23,"Slate River Rd","w2021","Motorized",0,"Sat","weekend","sled","Slate River Rd",NA,NA,NA,5.4,NA,26,1,22,20.8,2,0,1,0,3,3,4,4
"13360",2021-01-23,"Slate River Rd","w2021","Hybrid",3,"Sat","weekend","sled","Slate River Rd",NA,NA,NA,5.4,NA,26,1,22,20.8,2,0,1,0,3,3,4,4
"13361",2021-01-24,"Slate River Rd","w2021","Non.motorized",22,"Sun","weekend","no_sled","Slate River Rd",NA,NA,NA,5.6,NA,29,3,18,19.3,1,2,0,1,4,6,6,7
"13362",2021-01-24,"Slate River Rd","w2021","Mechanized",0,"Sun","weekend","no_sled","Slate River Rd",NA,NA,NA,5.6,NA,29,3,18,19.3,1,2,0,1,4,6,6,7
"13363",2021-01-24,"Slate River Rd","w2021","Motorized",2,"Sun","weekend","sled","Slate River Rd",NA,NA,NA,5.6,NA,29,3,18,19.3,1,2,0,1,4,6,6,7
"13364",2021-01-24,"Slate River Rd","w2021","Hybrid",14,"Sun","weekend","sled","Slate River Rd",NA,NA,NA,5.6,NA,29,3,18,19.3,1,2,0,1,4,6,6,7
"13365",2021-01-25,"Slate River Rd","w2021","Non.motorized",11,"Mon","weekday","no_sled","Slate River Rd",NA,NA,NA,5.8,NA,29,0,15,20,3,1,2,0,3,4,6,6
"13366",2021-01-25,"Slate River Rd","w2021","Mechanized",1,"Mon","weekday","no_sled","Slate River Rd",NA,NA,NA,5.8,NA,29,0,15,20,3,1,2,0,3,4,6,6
"13367",2021-01-25,"Slate River Rd","w2021","Motorized",0,"Mon","weekday","sled","Slate River Rd",NA,NA,NA,5.8,NA,29,0,15,20,3,1,2,0,3,4,6,6
"13368",2021-01-25,"Slate River Rd","w2021","Hybrid",5,"Mon","weekday","sled","Slate River Rd",NA,NA,NA,5.8,NA,29,0,15,20,3,1,2,0,3,4,6,6
"13369",2021-01-26,"Slate River Rd","w2021","Non.motorized",1,"Tue","weekday","no_sled","Slate River Rd",NA,NA,NA,5.9,NA,29,0,13,20.3,0,3,1,2,0,3,4,6
"13370",2021-01-26,"Slate River Rd","w2021","Mechanized",0,"Tue","weekday","no_sled","Slate River Rd",NA,NA,NA,5.9,NA,29,0,13,20.3,0,3,1,2,0,3,4,6
"13371",2021-01-26,"Slate River Rd","w2021","Motorized",0,"Tue","weekday","sled","Slate River Rd",NA,NA,NA,5.9,NA,29,0,13,20.3,0,3,1,2,0,3,4,6
"13372",2021-01-26,"Slate River Rd","w2021","Hybrid",6,"Tue","weekday","sled","Slate River Rd",NA,NA,NA,5.9,NA,29,0,13,20.3,0,3,1,2,0,3,4,6
"13373",2021-01-27,"Slate River Rd","w2021","Non.motorized",13,"Wed","weekday","no_sled","Slate River Rd",NA,NA,NA,6,NA,30,1,13,20,0,0,3,1,1,1,4,5
"13374",2021-01-27,"Slate River Rd","w2021","Mechanized",0,"Wed","weekday","no_sled","Slate River Rd",NA,NA,NA,6,NA,30,1,13,20,0,0,3,1,1,1,4,5
"13375",2021-01-27,"Slate River Rd","w2021","Motorized",0,"Wed","weekday","sled","Slate River Rd",NA,NA,NA,6,NA,30,1,13,20,0,0,3,1,1,1,4,5
"13376",2021-01-27,"Slate River Rd","w2021","Hybrid",5,"Wed","weekday","sled","Slate River Rd",NA,NA,NA,6,NA,30,1,13,20,0,0,3,1,1,1,4,5
"13377",2021-01-28,"Slate River Rd","w2021","Non.motorized",30,"Thu","weekday","no_sled","Slate River Rd",NA,NA,NA,6,NA,28,-2,27,21.4,1,0,0,3,-1,-1,-1,2
"13378",2021-01-28,"Slate River Rd","w2021","Mechanized",0,"Thu","weekday","no_sled","Slate River Rd",NA,NA,NA,6,NA,28,-2,27,21.4,1,0,0,3,-1,-1,-1,2
"13379",2021-01-28,"Slate River Rd","w2021","Motorized",0,"Thu","weekday","sled","Slate River Rd",NA,NA,NA,6,NA,28,-2,27,21.4,1,0,0,3,-1,-1,-1,2
"13380",2021-01-28,"Slate River Rd","w2021","Hybrid",3,"Thu","weekday","sled","Slate River Rd",NA,NA,NA,6,NA,28,-2,27,21.4,1,0,0,3,-1,-1,-1,2
"13381",2021-01-29,"Slate River Rd","w2021","Non.motorized",39,"Fri","weekday","no_sled","Slate River Rd",NA,NA,NA,6.1,NA,28,0,29,21.8,-2,1,0,0,-2,-1,-1,-1
"13382",2021-01-29,"Slate River Rd","w2021","Mechanized",0,"Fri","weekday","no_sled","Slate River Rd",NA,NA,NA,6.1,NA,28,0,29,21.8,-2,1,0,0,-2,-1,-1,-1
"13383",2021-01-29,"Slate River Rd","w2021","Motorized",2,"Fri","weekday","sled","Slate River Rd",NA,NA,NA,6.1,NA,28,0,29,21.8,-2,1,0,0,-2,-1,-1,-1
"13384",2021-01-29,"Slate River Rd","w2021","Hybrid",11,"Fri","weekday","sled","Slate River Rd",NA,NA,NA,6.1,NA,28,0,29,21.8,-2,1,0,0,-2,-1,-1,-1
"13385",2021-01-30,"Slate River Rd","w2021","Non.motorized",40,"Sat","weekend","no_sled","Slate River Rd",NA,NA,NA,6.2,NA,29,1,21,21.4,0,-2,1,0,1,-1,0,0
"13386",2021-01-30,"Slate River Rd","w2021","Mechanized",0,"Sat","weekend","no_sled","Slate River Rd",NA,NA,NA,6.2,NA,29,1,21,21.4,0,-2,1,0,1,-1,0,0
"13387",2021-01-30,"Slate River Rd","w2021","Motorized",1,"Sat","weekend","sled","Slate River Rd",NA,NA,NA,6.2,NA,29,1,21,21.4,0,-2,1,0,1,-1,0,0
"13388",2021-01-30,"Slate River Rd","w2021","Hybrid",4,"Sat","weekend","sled","Slate River Rd",NA,NA,NA,6.2,NA,29,1,21,21.4,0,-2,1,0,1,-1,0,0
"13389",2021-01-31,"Slate River Rd","w2021","Non.motorized",49,"Sun","weekend","no_sled","Slate River Rd",NA,NA,NA,6.3,NA,29,0,21,21.7,1,0,-2,1,1,1,-1,0
"13390",2021-01-31,"Slate River Rd","w2021","Mechanized",0,"Sun","weekend","no_sled","Slate River Rd",NA,NA,NA,6.3,NA,29,0,21,21.7,1,0,-2,1,1,1,-1,0
"13391",2021-01-31,"Slate River Rd","w2021","Motorized",2,"Sun","weekend","sled","Slate River Rd",NA,NA,NA,6.3,NA,29,0,21,21.7,1,0,-2,1,1,1,-1,0
"13392",2021-01-31,"Slate River Rd","w2021","Hybrid",22,"Sun","weekend","sled","Slate River Rd",NA,NA,NA,6.3,NA,29,0,21,21.7,1,0,-2,1,1,1,-1,0
"13393",2021-02-02,"Slate River Rd","w2021","Non.motorized",20,"Tue","weekday","no_sled","Slate River Rd",NA,NA,NA,6.3,NA,28,0,34,22.5,-1,0,1,0,-1,-1,0,0
"13394",2021-02-02,"Slate River Rd","w2021","Mechanized",0,"Tue","weekday","no_sled","Slate River Rd",NA,NA,NA,6.3,NA,28,0,34,22.5,-1,0,1,0,-1,-1,0,0
"13395",2021-02-02,"Slate River Rd","w2021","Motorized",0,"Tue","weekday","sled","Slate River Rd",NA,NA,NA,6.3,NA,28,0,34,22.5,-1,0,1,0,-1,-1,0,0
"13396",2021-02-02,"Slate River Rd","w2021","Hybrid",10,"Tue","weekday","sled","Slate River Rd",NA,NA,NA,6.3,NA,28,0,34,22.5,-1,0,1,0,-1,-1,0,0
"13397",2021-02-03,"Slate River Rd","w2021","Non.motorized",4,"Wed","weekday","no_sled","Slate River Rd",NA,NA,NA,6.3,NA,27,-1,30,23.3,0,-1,0,1,-1,-2,-2,-1
"13398",2021-02-03,"Slate River Rd","w2021","Mechanized",0,"Wed","weekday","no_sled","Slate River Rd",NA,NA,NA,6.3,NA,27,-1,30,23.3,0,-1,0,1,-1,-2,-2,-1
"13399",2021-02-03,"Slate River Rd","w2021","Motorized",0,"Wed","weekday","sled","Slate River Rd",NA,NA,NA,6.3,NA,27,-1,30,23.3,0,-1,0,1,-1,-2,-2,-1
"13400",2021-02-03,"Slate River Rd","w2021","Hybrid",7,"Wed","weekday","sled","Slate River Rd",NA,NA,NA,6.3,NA,27,-1,30,23.3,0,-1,0,1,-1,-2,-2,-1
"13401",2021-02-04,"Slate River Rd","w2021","Non.motorized",12,"Thu","weekday","no_sled","Slate River Rd",NA,NA,NA,7.2,NA,37,10,14,19.5,-1,0,-1,0,9,9,8,8
"13402",2021-02-04,"Slate River Rd","w2021","Mechanized",0,"Thu","weekday","no_sled","Slate River Rd",NA,NA,NA,7.2,NA,37,10,14,19.5,-1,0,-1,0,9,9,8,8
"13403",2021-02-04,"Slate River Rd","w2021","Motorized",0,"Thu","weekday","sled","Slate River Rd",NA,NA,NA,7.2,NA,37,10,14,19.5,-1,0,-1,0,9,9,8,8
"13404",2021-02-04,"Slate River Rd","w2021","Hybrid",0,"Thu","weekday","sled","Slate River Rd",NA,NA,NA,7.2,NA,37,10,14,19.5,-1,0,-1,0,9,9,8,8
"13405",2021-02-05,"Slate River Rd","w2021","Non.motorized",10,"Fri","weekday","no_sled","Slate River Rd",NA,NA,NA,7.2,NA,35,-2,16,20.6,10,-1,0,-1,8,7,7,6
"13406",2021-02-05,"Slate River Rd","w2021","Mechanized",0,"Fri","weekday","no_sled","Slate River Rd",NA,NA,NA,7.2,NA,35,-2,16,20.6,10,-1,0,-1,8,7,7,6
"13407",2021-02-05,"Slate River Rd","w2021","Motorized",0,"Fri","weekday","sled","Slate River Rd",NA,NA,NA,7.2,NA,35,-2,16,20.6,10,-1,0,-1,8,7,7,6
"13408",2021-02-05,"Slate River Rd","w2021","Hybrid",5,"Fri","weekday","sled","Slate River Rd",NA,NA,NA,7.2,NA,35,-2,16,20.6,10,-1,0,-1,8,7,7,6
"13409",2021-02-06,"Slate River Rd","w2021","Non.motorized",64,"Sat","weekend","no_sled","Slate River Rd",NA,NA,NA,7.5,NA,37,2,19,20.3,-2,10,-1,0,0,10,9,9
"13410",2021-02-06,"Slate River Rd","w2021","Mechanized",0,"Sat","weekend","no_sled","Slate River Rd",NA,NA,NA,7.5,NA,37,2,19,20.3,-2,10,-1,0,0,10,9,9
"13411",2021-02-06,"Slate River Rd","w2021","Motorized",0,"Sat","weekend","sled","Slate River Rd",NA,NA,NA,7.5,NA,37,2,19,20.3,-2,10,-1,0,0,10,9,9
"13412",2021-02-06,"Slate River Rd","w2021","Hybrid",9,"Sat","weekend","sled","Slate River Rd",NA,NA,NA,7.5,NA,37,2,19,20.3,-2,10,-1,0,0,10,9,9
"13413",2021-02-07,"Slate River Rd","w2021","Non.motorized",30,"Sun","weekend","no_sled","Slate River Rd",NA,NA,NA,7.5,NA,36,-1,24,20.8,2,-2,10,-1,1,-1,9,8
"13414",2021-02-07,"Slate River Rd","w2021","Mechanized",0,"Sun","weekend","no_sled","Slate River Rd",NA,NA,NA,7.5,NA,36,-1,24,20.8,2,-2,10,-1,1,-1,9,8
"13415",2021-02-07,"Slate River Rd","w2021","Motorized",0,"Sun","weekend","sled","Slate River Rd",NA,NA,NA,7.5,NA,36,-1,24,20.8,2,-2,10,-1,1,-1,9,8
"13416",2021-02-07,"Slate River Rd","w2021","Hybrid",3,"Sun","weekend","sled","Slate River Rd",NA,NA,NA,7.5,NA,36,-1,24,20.8,2,-2,10,-1,1,-1,9,8
"13417",2021-02-08,"Slate River Rd","w2021","Non.motorized",27,"Mon","weekday","no_sled","Slate River Rd",NA,NA,NA,7.6,NA,35,-1,28,21.7,-1,2,-2,10,-2,0,-2,8
"13418",2021-02-08,"Slate River Rd","w2021","Mechanized",0,"Mon","weekday","no_sled","Slate River Rd",NA,NA,NA,7.6,NA,35,-1,28,21.7,-1,2,-2,10,-2,0,-2,8
"13419",2021-02-08,"Slate River Rd","w2021","Motorized",0,"Mon","weekday","sled","Slate River Rd",NA,NA,NA,7.6,NA,35,-1,28,21.7,-1,2,-2,10,-2,0,-2,8
"13420",2021-02-08,"Slate River Rd","w2021","Hybrid",0,"Mon","weekday","sled","Slate River Rd",NA,NA,NA,7.6,NA,35,-1,28,21.7,-1,2,-2,10,-2,0,-2,8
"13421",2021-02-09,"Slate River Rd","w2021","Non.motorized",38,"Tue","weekday","no_sled","Slate River Rd",NA,NA,NA,7.6,NA,34,-1,28,22.4,-1,-1,2,-2,-2,-3,-1,-3
"13422",2021-02-09,"Slate River Rd","w2021","Mechanized",0,"Tue","weekday","no_sled","Slate River Rd",NA,NA,NA,7.6,NA,34,-1,28,22.4,-1,-1,2,-2,-2,-3,-1,-3
"13423",2021-02-09,"Slate River Rd","w2021","Motorized",0,"Tue","weekday","sled","Slate River Rd",NA,NA,NA,7.6,NA,34,-1,28,22.4,-1,-1,2,-2,-2,-3,-1,-3
"13424",2021-02-09,"Slate River Rd","w2021","Hybrid",14,"Tue","weekday","sled","Slate River Rd",NA,NA,NA,7.6,NA,34,-1,28,22.4,-1,-1,2,-2,-2,-3,-1,-3
"13425",2021-02-10,"Slate River Rd","w2021","Non.motorized",56,"Wed","weekday","no_sled","Slate River Rd",NA,NA,NA,7.7,NA,34,0,26,22.6,-1,-1,-1,2,-1,-2,-3,-1
"13426",2021-02-10,"Slate River Rd","w2021","Mechanized",0,"Wed","weekday","no_sled","Slate River Rd",NA,NA,NA,7.7,NA,34,0,26,22.6,-1,-1,-1,2,-1,-2,-3,-1
"13427",2021-02-10,"Slate River Rd","w2021","Motorized",0,"Wed","weekday","sled","Slate River Rd",NA,NA,NA,7.7,NA,34,0,26,22.6,-1,-1,-1,2,-1,-2,-3,-1
"13428",2021-02-10,"Slate River Rd","w2021","Hybrid",11,"Wed","weekday","sled","Slate River Rd",NA,NA,NA,7.7,NA,34,0,26,22.6,-1,-1,-1,2,-1,-2,-3,-1
"13429",2021-02-11,"Slate River Rd","w2021","Non.motorized",12,"Thu","weekday","no_sled","Slate River Rd",NA,NA,NA,8,NA,37,3,26,21.6,0,-1,-1,-1,3,2,1,0
"13430",2021-02-11,"Slate River Rd","w2021","Mechanized",0,"Thu","weekday","no_sled","Slate River Rd",NA,NA,NA,8,NA,37,3,26,21.6,0,-1,-1,-1,3,2,1,0
"13431",2021-02-11,"Slate River Rd","w2021","Motorized",0,"Thu","weekday","sled","Slate River Rd",NA,NA,NA,8,NA,37,3,26,21.6,0,-1,-1,-1,3,2,1,0
"13432",2021-02-11,"Slate River Rd","w2021","Hybrid",11,"Thu","weekday","sled","Slate River Rd",NA,NA,NA,8,NA,37,3,26,21.6,0,-1,-1,-1,3,2,1,0
"13433",2021-02-12,"Slate River Rd","w2021","Non.motorized",16,"Fri","weekday","no_sled","Slate River Rd",NA,NA,NA,8.1,NA,37,0,27,21.9,3,0,-1,-1,3,3,2,1
"13434",2021-02-12,"Slate River Rd","w2021","Mechanized",2,"Fri","weekday","no_sled","Slate River Rd",NA,NA,NA,8.1,NA,37,0,27,21.9,3,0,-1,-1,3,3,2,1
"13435",2021-02-12,"Slate River Rd","w2021","Motorized",0,"Fri","weekday","sled","Slate River Rd",NA,NA,NA,8.1,NA,37,0,27,21.9,3,0,-1,-1,3,3,2,1
"13436",2021-02-12,"Slate River Rd","w2021","Hybrid",10,"Fri","weekday","sled","Slate River Rd",NA,NA,NA,8.1,NA,37,0,27,21.9,3,0,-1,-1,3,3,2,1
"13437",2021-02-13,"Slate River Rd","w2021","Non.motorized",44,"Sat","weekend","no_sled","Slate River Rd",NA,NA,NA,8.4,NA,38,1,26,22.1,0,3,0,-1,1,4,4,3
"13438",2021-02-13,"Slate River Rd","w2021","Mechanized",0,"Sat","weekend","no_sled","Slate River Rd",NA,NA,NA,8.4,NA,38,1,26,22.1,0,3,0,-1,1,4,4,3
"13439",2021-02-13,"Slate River Rd","w2021","Motorized",4,"Sat","weekend","sled","Slate River Rd",NA,NA,NA,8.4,NA,38,1,26,22.1,0,3,0,-1,1,4,4,3
"13440",2021-02-13,"Slate River Rd","w2021","Hybrid",7,"Sat","weekend","sled","Slate River Rd",NA,NA,NA,8.4,NA,38,1,26,22.1,0,3,0,-1,1,4,4,3
"13441",2021-02-14,"Slate River Rd","w2021","Non.motorized",18,"Sun","weekend","no_sled","Slate River Rd",NA,NA,NA,8.9,NA,43,5,18,20.7,1,0,3,0,6,6,9,9
"13442",2021-02-14,"Slate River Rd","w2021","Mechanized",0,"Sun","weekend","no_sled","Slate River Rd",NA,NA,NA,8.9,NA,43,5,18,20.7,1,0,3,0,6,6,9,9
"13443",2021-02-14,"Slate River Rd","w2021","Motorized",0,"Sun","weekend","sled","Slate River Rd",NA,NA,NA,8.9,NA,43,5,18,20.7,1,0,3,0,6,6,9,9
"13444",2021-02-14,"Slate River Rd","w2021","Hybrid",4,"Sun","weekend","sled","Slate River Rd",NA,NA,NA,8.9,NA,43,5,18,20.7,1,0,3,0,6,6,9,9
"13445",2021-02-15,"Slate River Rd","w2021","Non.motorized",40,"Mon","weekday","no_sled","Slate River Rd",NA,NA,NA,8.9,NA,43,0,12,20.7,5,1,0,3,5,6,6,9
"13446",2021-02-15,"Slate River Rd","w2021","Mechanized",0,"Mon","weekday","no_sled","Slate River Rd",NA,NA,NA,8.9,NA,43,0,12,20.7,5,1,0,3,5,6,6,9
"13447",2021-02-15,"Slate River Rd","w2021","Motorized",0,"Mon","weekday","sled","Slate River Rd",NA,NA,NA,8.9,NA,43,0,12,20.7,5,1,0,3,5,6,6,9
"13448",2021-02-15,"Slate River Rd","w2021","Hybrid",3,"Mon","weekday","sled","Slate River Rd",NA,NA,NA,8.9,NA,43,0,12,20.7,5,1,0,3,5,6,6,9
"13449",2021-02-16,"Slate River Rd","w2021","Non.motorized",74,"Tue","weekday","no_sled","Slate River Rd",NA,NA,NA,9,NA,41,-2,17,22,0,5,1,0,-2,3,4,4
"13450",2021-02-16,"Slate River Rd","w2021","Mechanized",0,"Tue","weekday","no_sled","Slate River Rd",NA,NA,NA,9,NA,41,-2,17,22,0,5,1,0,-2,3,4,4
"13451",2021-02-16,"Slate River Rd","w2021","Motorized",7,"Tue","weekday","sled","Slate River Rd",NA,NA,NA,9,NA,41,-2,17,22,0,5,1,0,-2,3,4,4
"13452",2021-02-16,"Slate River Rd","w2021","Hybrid",9,"Tue","weekday","sled","Slate River Rd",NA,NA,NA,9,NA,41,-2,17,22,0,5,1,0,-2,3,4,4
"13453",2021-02-17,"Slate River Rd","w2021","Non.motorized",98,"Wed","weekday","no_sled","Slate River Rd",NA,NA,NA,9.1,NA,42,1,13,21.7,-2,0,5,1,-1,-1,4,5
"13454",2021-02-17,"Slate River Rd","w2021","Mechanized",7,"Wed","weekday","no_sled","Slate River Rd",NA,NA,NA,9.1,NA,42,1,13,21.7,-2,0,5,1,-1,-1,4,5
"13455",2021-02-17,"Slate River Rd","w2021","Motorized",0,"Wed","weekday","sled","Slate River Rd",NA,NA,NA,9.1,NA,42,1,13,21.7,-2,0,5,1,-1,-1,4,5
"13456",2021-02-17,"Slate River Rd","w2021","Hybrid",4,"Wed","weekday","sled","Slate River Rd",NA,NA,NA,9.1,NA,42,1,13,21.7,-2,0,5,1,-1,-1,4,5
"13457",2021-02-18,"Slate River Rd","w2021","Non.motorized",42,"Thu","weekday","no_sled","Slate River Rd",NA,NA,NA,9.1,NA,41,-1,11,22.2,1,-2,0,5,0,-2,-2,3
"13458",2021-02-18,"Slate River Rd","w2021","Mechanized",3,"Thu","weekday","no_sled","Slate River Rd",NA,NA,NA,9.1,NA,41,-1,11,22.2,1,-2,0,5,0,-2,-2,3
"13459",2021-02-18,"Slate River Rd","w2021","Motorized",1,"Thu","weekday","sled","Slate River Rd",NA,NA,NA,9.1,NA,41,-1,11,22.2,1,-2,0,5,0,-2,-2,3
"13460",2021-02-18,"Slate River Rd","w2021","Hybrid",11,"Thu","weekday","sled","Slate River Rd",NA,NA,NA,9.1,NA,41,-1,11,22.2,1,-2,0,5,0,-2,-2,3
"13461",2021-02-19,"Slate River Rd","w2021","Non.motorized",12,"Fri","weekday","no_sled","Slate River Rd",NA,NA,NA,9.1,NA,40,-1,18,22.8,-1,1,-2,0,-2,-1,-3,-3
"13462",2021-02-19,"Slate River Rd","w2021","Mechanized",0,"Fri","weekday","no_sled","Slate River Rd",NA,NA,NA,9.1,NA,40,-1,18,22.8,-1,1,-2,0,-2,-1,-3,-3
"13463",2021-02-19,"Slate River Rd","w2021","Motorized",0,"Fri","weekday","sled","Slate River Rd",NA,NA,NA,9.1,NA,40,-1,18,22.8,-1,1,-2,0,-2,-1,-3,-3
"13464",2021-02-19,"Slate River Rd","w2021","Hybrid",4,"Fri","weekday","sled","Slate River Rd",NA,NA,NA,9.1,NA,40,-1,18,22.8,-1,1,-2,0,-2,-1,-3,-3
"13465",2021-02-20,"Slate River Rd","w2021","Non.motorized",26,"Sat","weekend","no_sled","Slate River Rd",NA,NA,NA,9.2,NA,39,-1,23,23.6,-1,-1,1,-2,-2,-3,-2,-4
"13466",2021-02-20,"Slate River Rd","w2021","Mechanized",2,"Sat","weekend","no_sled","Slate River Rd",NA,NA,NA,9.2,NA,39,-1,23,23.6,-1,-1,1,-2,-2,-3,-2,-4
"13467",2021-02-20,"Slate River Rd","w2021","Motorized",1,"Sat","weekend","sled","Slate River Rd",NA,NA,NA,9.2,NA,39,-1,23,23.6,-1,-1,1,-2,-2,-3,-2,-4
"13468",2021-02-20,"Slate River Rd","w2021","Hybrid",9,"Sat","weekend","sled","Slate River Rd",NA,NA,NA,9.2,NA,39,-1,23,23.6,-1,-1,1,-2,-2,-3,-2,-4
"13469",2021-02-21,"Slate River Rd","w2021","Non.motorized",14,"Sun","weekend","no_sled","Slate River Rd",NA,NA,NA,9.2,NA,39,0,15,23.6,-1,-1,-1,1,-1,-2,-3,-2
"13470",2021-02-21,"Slate River Rd","w2021","Mechanized",0,"Sun","weekend","no_sled","Slate River Rd",NA,NA,NA,9.2,NA,39,0,15,23.6,-1,-1,-1,1,-1,-2,-3,-2
"13471",2021-02-21,"Slate River Rd","w2021","Motorized",0,"Sun","weekend","sled","Slate River Rd",NA,NA,NA,9.2,NA,39,0,15,23.6,-1,-1,-1,1,-1,-2,-3,-2
"13472",2021-02-21,"Slate River Rd","w2021","Hybrid",3,"Sun","weekend","sled","Slate River Rd",NA,NA,NA,9.2,NA,39,0,15,23.6,-1,-1,-1,1,-1,-2,-3,-2
"13473",2021-02-22,"Slate River Rd","w2021","Non.motorized",15,"Mon","weekday","no_sled","Slate River Rd",NA,NA,NA,9.2,NA,39,0,23,23.6,0,-1,-1,-1,0,-1,-2,-3
"13474",2021-02-22,"Slate River Rd","w2021","Mechanized",0,"Mon","weekday","no_sled","Slate River Rd",NA,NA,NA,9.2,NA,39,0,23,23.6,0,-1,-1,-1,0,-1,-2,-3
"13475",2021-02-22,"Slate River Rd","w2021","Motorized",0,"Mon","weekday","sled","Slate River Rd",NA,NA,NA,9.2,NA,39,0,23,23.6,0,-1,-1,-1,0,-1,-2,-3
"13476",2021-02-22,"Slate River Rd","w2021","Hybrid",7,"Mon","weekday","sled","Slate River Rd",NA,NA,NA,9.2,NA,39,0,23,23.6,0,-1,-1,-1,0,-1,-2,-3
"13477",2021-02-23,"Slate River Rd","w2021","Non.motorized",10,"Tue","weekday","no_sled","Slate River Rd",NA,NA,NA,9.2,NA,38,-1,28,24.2,0,0,-1,-1,-1,-1,-2,-3
"13478",2021-02-23,"Slate River Rd","w2021","Mechanized",0,"Tue","weekday","no_sled","Slate River Rd",NA,NA,NA,9.2,NA,38,-1,28,24.2,0,0,-1,-1,-1,-1,-2,-3
"13479",2021-02-23,"Slate River Rd","w2021","Motorized",3,"Tue","weekday","sled","Slate River Rd",NA,NA,NA,9.2,NA,38,-1,28,24.2,0,0,-1,-1,-1,-1,-2,-3
"13480",2021-02-23,"Slate River Rd","w2021","Hybrid",5,"Tue","weekday","sled","Slate River Rd",NA,NA,NA,9.2,NA,38,-1,28,24.2,0,0,-1,-1,-1,-1,-2,-3
"13481",2021-02-24,"Slate River Rd","w2021","Non.motorized",31,"Wed","weekday","no_sled","Slate River Rd",NA,NA,NA,9.2,NA,38,0,23,24.2,-1,0,0,-1,-1,-1,-1,-2
"13482",2021-02-24,"Slate River Rd","w2021","Mechanized",0,"Wed","weekday","no_sled","Slate River Rd",NA,NA,NA,9.2,NA,38,0,23,24.2,-1,0,0,-1,-1,-1,-1,-2
"13483",2021-02-24,"Slate River Rd","w2021","Motorized",1,"Wed","weekday","sled","Slate River Rd",NA,NA,NA,9.2,NA,38,0,23,24.2,-1,0,0,-1,-1,-1,-1,-2
"13484",2021-02-24,"Slate River Rd","w2021","Hybrid",3,"Wed","weekday","sled","Slate River Rd",NA,NA,NA,9.2,NA,38,0,23,24.2,-1,0,0,-1,-1,-1,-1,-2
"13485",2021-02-25,"Slate River Rd","w2021","Non.motorized",32,"Thu","weekday","no_sled","Slate River Rd",NA,NA,NA,9.2,NA,37,-1,20,24.9,0,-1,0,0,-1,-2,-2,-2
"13486",2021-02-25,"Slate River Rd","w2021","Mechanized",0,"Thu","weekday","no_sled","Slate River Rd",NA,NA,NA,9.2,NA,37,-1,20,24.9,0,-1,0,0,-1,-2,-2,-2
"13487",2021-02-25,"Slate River Rd","w2021","Motorized",0,"Thu","weekday","sled","Slate River Rd",NA,NA,NA,9.2,NA,37,-1,20,24.9,0,-1,0,0,-1,-2,-2,-2
"13488",2021-02-25,"Slate River Rd","w2021","Hybrid",10,"Thu","weekday","sled","Slate River Rd",NA,NA,NA,9.2,NA,37,-1,20,24.9,0,-1,0,0,-1,-2,-2,-2
"13489",2021-02-26,"Slate River Rd","w2021","Non.motorized",35,"Fri","weekday","no_sled","Slate River Rd",NA,NA,NA,9.2,NA,37,0,21,24.9,-1,0,-1,0,-1,-1,-2,-2
"13490",2021-02-26,"Slate River Rd","w2021","Mechanized",0,"Fri","weekday","no_sled","Slate River Rd",NA,NA,NA,9.2,NA,37,0,21,24.9,-1,0,-1,0,-1,-1,-2,-2
"13491",2021-02-26,"Slate River Rd","w2021","Motorized",0,"Fri","weekday","sled","Slate River Rd",NA,NA,NA,9.2,NA,37,0,21,24.9,-1,0,-1,0,-1,-1,-2,-2
"13492",2021-02-26,"Slate River Rd","w2021","Hybrid",5,"Fri","weekday","sled","Slate River Rd",NA,NA,NA,9.2,NA,37,0,21,24.9,-1,0,-1,0,-1,-1,-2,-2
"13493",2021-02-27,"Slate River Rd","w2021","Non.motorized",47,"Sat","weekend","no_sled","Slate River Rd",NA,NA,NA,9.2,NA,37,0,15,24.9,0,-1,0,-1,0,-1,-1,-2
"13494",2021-02-27,"Slate River Rd","w2021","Mechanized",0,"Sat","weekend","no_sled","Slate River Rd",NA,NA,NA,9.2,NA,37,0,15,24.9,0,-1,0,-1,0,-1,-1,-2
"13495",2021-02-27,"Slate River Rd","w2021","Motorized",3,"Sat","weekend","sled","Slate River Rd",NA,NA,NA,9.2,NA,37,0,15,24.9,0,-1,0,-1,0,-1,-1,-2
"13496",2021-02-27,"Slate River Rd","w2021","Hybrid",9,"Sat","weekend","sled","Slate River Rd",NA,NA,NA,9.2,NA,37,0,15,24.9,0,-1,0,-1,0,-1,-1,-2
"13497",2021-02-28,"Slate River Rd","w2021","Non.motorized",48,"Sun","weekend","no_sled","Slate River Rd",NA,NA,NA,9.2,NA,38,1,9,24.2,0,0,-1,0,1,1,0,0
"13498",2021-02-28,"Slate River Rd","w2021","Mechanized",1,"Sun","weekend","no_sled","Slate River Rd",NA,NA,NA,9.2,NA,38,1,9,24.2,0,0,-1,0,1,1,0,0
"13499",2021-02-28,"Slate River Rd","w2021","Motorized",3,"Sun","weekend","sled","Slate River Rd",NA,NA,NA,9.2,NA,38,1,9,24.2,0,0,-1,0,1,1,0,0
"13500",2021-02-28,"Slate River Rd","w2021","Hybrid",5,"Sun","weekend","sled","Slate River Rd",NA,NA,NA,9.2,NA,38,1,9,24.2,0,0,-1,0,1,1,0,0
"13501",2021-03-01,"Slate River Rd","w2021","Non.motorized",17,"Mon","weekday","no_sled","Slate River Rd",NA,NA,NA,9.2,NA,37,-1,20,24.9,1,0,0,-1,0,0,0,-1
"13502",2021-03-01,"Slate River Rd","w2021","Mechanized",0,"Mon","weekday","no_sled","Slate River Rd",NA,NA,NA,9.2,NA,37,-1,20,24.9,1,0,0,-1,0,0,0,-1
"13503",2021-03-01,"Slate River Rd","w2021","Motorized",1,"Mon","weekday","sled","Slate River Rd",NA,NA,NA,9.2,NA,37,-1,20,24.9,1,0,0,-1,0,0,0,-1
"13504",2021-03-01,"Slate River Rd","w2021","Hybrid",5,"Mon","weekday","sled","Slate River Rd",NA,NA,NA,9.2,NA,37,-1,20,24.9,1,0,0,-1,0,0,0,-1
"13505",2021-03-02,"Slate River Rd","w2021","Non.motorized",28,"Tue","weekday","no_sled","Slate River Rd",NA,NA,NA,9.2,NA,36,-1,27,25.6,-1,1,0,0,-2,-1,-1,-1
"13506",2021-03-02,"Slate River Rd","w2021","Mechanized",1,"Tue","weekday","no_sled","Slate River Rd",NA,NA,NA,9.2,NA,36,-1,27,25.6,-1,1,0,0,-2,-1,-1,-1
"13507",2021-03-02,"Slate River Rd","w2021","Motorized",1,"Tue","weekday","sled","Slate River Rd",NA,NA,NA,9.2,NA,36,-1,27,25.6,-1,1,0,0,-2,-1,-1,-1
"13508",2021-03-02,"Slate River Rd","w2021","Hybrid",4,"Tue","weekday","sled","Slate River Rd",NA,NA,NA,9.2,NA,36,-1,27,25.6,-1,1,0,0,-2,-1,-1,-1
"13509",2021-03-03,"Slate River Rd","w2021","Non.motorized",31,"Wed","weekday","no_sled","Slate River Rd",NA,NA,NA,9.2,NA,36,0,31,25.6,-1,-1,1,0,-1,-2,-1,-1
"13510",2021-03-03,"Slate River Rd","w2021","Mechanized",0,"Wed","weekday","no_sled","Slate River Rd",NA,NA,NA,9.2,NA,36,0,31,25.6,-1,-1,1,0,-1,-2,-1,-1
"13511",2021-03-03,"Slate River Rd","w2021","Motorized",1,"Wed","weekday","sled","Slate River Rd",NA,NA,NA,9.2,NA,36,0,31,25.6,-1,-1,1,0,-1,-2,-1,-1
"13512",2021-03-03,"Slate River Rd","w2021","Hybrid",1,"Wed","weekday","sled","Slate River Rd",NA,NA,NA,9.2,NA,36,0,31,25.6,-1,-1,1,0,-1,-2,-1,-1
"13513",2021-03-04,"Slate River Rd","w2021","Non.motorized",6,"Thu","weekday","no_sled","Slate River Rd",NA,NA,NA,9.2,NA,36,0,28,25.6,0,-1,-1,1,0,-1,-2,-1
"13514",2021-03-04,"Slate River Rd","w2021","Mechanized",1,"Thu","weekday","no_sled","Slate River Rd",NA,NA,NA,9.2,NA,36,0,28,25.6,0,-1,-1,1,0,-1,-2,-1
"13515",2021-03-04,"Slate River Rd","w2021","Motorized",0,"Thu","weekday","sled","Slate River Rd",NA,NA,NA,9.2,NA,36,0,28,25.6,0,-1,-1,1,0,-1,-2,-1
"13516",2021-03-04,"Slate River Rd","w2021","Hybrid",1,"Thu","weekday","sled","Slate River Rd",NA,NA,NA,9.2,NA,36,0,28,25.6,0,-1,-1,1,0,-1,-2,-1
"13517",2021-03-05,"Slate River Rd","w2021","Non.motorized",51,"Fri","weekday","no_sled","Slate River Rd",NA,NA,NA,9.4,NA,39,3,30,24.1,0,0,-1,-1,3,3,2,1
"13518",2021-03-05,"Slate River Rd","w2021","Mechanized",0,"Fri","weekday","no_sled","Slate River Rd",NA,NA,NA,9.4,NA,39,3,30,24.1,0,0,-1,-1,3,3,2,1
"13519",2021-03-05,"Slate River Rd","w2021","Motorized",3,"Fri","weekday","sled","Slate River Rd",NA,NA,NA,9.4,NA,39,3,30,24.1,0,0,-1,-1,3,3,2,1
"13520",2021-03-05,"Slate River Rd","w2021","Hybrid",6,"Fri","weekday","sled","Slate River Rd",NA,NA,NA,9.4,NA,39,3,30,24.1,0,0,-1,-1,3,3,2,1
"13521",2021-03-06,"Slate River Rd","w2021","Non.motorized",50,"Sat","weekend","no_sled","Slate River Rd",NA,NA,NA,9.4,NA,38,-1,32,24.7,3,0,0,-1,2,2,2,1
"13522",2021-03-06,"Slate River Rd","w2021","Mechanized",0,"Sat","weekend","no_sled","Slate River Rd",NA,NA,NA,9.4,NA,38,-1,32,24.7,3,0,0,-1,2,2,2,1
"13523",2021-03-06,"Slate River Rd","w2021","Motorized",2,"Sat","weekend","sled","Slate River Rd",NA,NA,NA,9.4,NA,38,-1,32,24.7,3,0,0,-1,2,2,2,1
"13524",2021-03-06,"Slate River Rd","w2021","Hybrid",5,"Sat","weekend","sled","Slate River Rd",NA,NA,NA,9.4,NA,38,-1,32,24.7,3,0,0,-1,2,2,2,1
"13525",2021-03-07,"Slate River Rd","w2021","Non.motorized",42,"Sun","weekend","no_sled","Slate River Rd",NA,NA,NA,9.4,NA,37,-1,35,25.4,-1,3,0,0,-2,1,1,1
"13526",2021-03-07,"Slate River Rd","w2021","Mechanized",2,"Sun","weekend","no_sled","Slate River Rd",NA,NA,NA,9.4,NA,37,-1,35,25.4,-1,3,0,0,-2,1,1,1
"13527",2021-03-07,"Slate River Rd","w2021","Motorized",4,"Sun","weekend","sled","Slate River Rd",NA,NA,NA,9.4,NA,37,-1,35,25.4,-1,3,0,0,-2,1,1,1
"13528",2021-03-07,"Slate River Rd","w2021","Hybrid",3,"Sun","weekend","sled","Slate River Rd",NA,NA,NA,9.4,NA,37,-1,35,25.4,-1,3,0,0,-2,1,1,1
"13529",2021-03-08,"Slate River Rd","w2021","Non.motorized",25,"Mon","weekday","no_sled","Slate River Rd",NA,NA,NA,9.5,NA,37,0,33,25.7,-1,-1,3,0,-1,-2,1,1
"13530",2021-03-08,"Slate River Rd","w2021","Mechanized",0,"Mon","weekday","no_sled","Slate River Rd",NA,NA,NA,9.5,NA,37,0,33,25.7,-1,-1,3,0,-1,-2,1,1
"13531",2021-03-08,"Slate River Rd","w2021","Motorized",0,"Mon","weekday","sled","Slate River Rd",NA,NA,NA,9.5,NA,37,0,33,25.7,-1,-1,3,0,-1,-2,1,1
"13532",2021-03-08,"Slate River Rd","w2021","Hybrid",2,"Mon","weekday","sled","Slate River Rd",NA,NA,NA,9.5,NA,37,0,33,25.7,-1,-1,3,0,-1,-2,1,1
"13533",2021-03-09,"Slate River Rd","w2021","Non.motorized",36,"Tue","weekday","no_sled","Slate River Rd",NA,NA,NA,9.5,NA,37,0,33,25.7,0,-1,-1,3,0,-1,-2,1
"13534",2021-03-09,"Slate River Rd","w2021","Mechanized",0,"Tue","weekday","no_sled","Slate River Rd",NA,NA,NA,9.5,NA,37,0,33,25.7,0,-1,-1,3,0,-1,-2,1
"13535",2021-03-09,"Slate River Rd","w2021","Motorized",2,"Tue","weekday","sled","Slate River Rd",NA,NA,NA,9.5,NA,37,0,33,25.7,0,-1,-1,3,0,-1,-2,1
"13536",2021-03-09,"Slate River Rd","w2021","Hybrid",3,"Tue","weekday","sled","Slate River Rd",NA,NA,NA,9.5,NA,37,0,33,25.7,0,-1,-1,3,0,-1,-2,1
"13537",2021-03-10,"Slate River Rd","w2021","Non.motorized",17,"Wed","weekday","no_sled","Slate River Rd",NA,NA,NA,9.7,NA,39,2,21,24.9,0,0,-1,-1,2,2,1,0
"13538",2021-03-10,"Slate River Rd","w2021","Mechanized",0,"Wed","weekday","no_sled","Slate River Rd",NA,NA,NA,9.7,NA,39,2,21,24.9,0,0,-1,-1,2,2,1,0
"13539",2021-03-10,"Slate River Rd","w2021","Motorized",1,"Wed","weekday","sled","Slate River Rd",NA,NA,NA,9.7,NA,39,2,21,24.9,0,0,-1,-1,2,2,1,0
"13540",2021-03-10,"Slate River Rd","w2021","Hybrid",1,"Wed","weekday","sled","Slate River Rd",NA,NA,NA,9.7,NA,39,2,21,24.9,0,0,-1,-1,2,2,1,0
"13541",2021-03-11,"Slate River Rd","w2021","Non.motorized",34,"Thu","weekday","no_sled","Slate River Rd",NA,NA,NA,9.8,NA,40,1,22,24.5,2,0,0,-1,3,3,3,2
"13542",2021-03-11,"Slate River Rd","w2021","Mechanized",0,"Thu","weekday","no_sled","Slate River Rd",NA,NA,NA,9.8,NA,40,1,22,24.5,2,0,0,-1,3,3,3,2
"13543",2021-03-11,"Slate River Rd","w2021","Motorized",2,"Thu","weekday","sled","Slate River Rd",NA,NA,NA,9.8,NA,40,1,22,24.5,2,0,0,-1,3,3,3,2
"13544",2021-03-11,"Slate River Rd","w2021","Hybrid",5,"Thu","weekday","sled","Slate River Rd",NA,NA,NA,9.8,NA,40,1,22,24.5,2,0,0,-1,3,3,3,2
"13545",2021-03-12,"Slate River Rd","w2021","Non.motorized",73,"Fri","weekday","no_sled","Slate River Rd",NA,NA,NA,9.8,NA,39,-1,29,25.1,1,2,0,0,0,2,2,2
"13546",2021-03-12,"Slate River Rd","w2021","Mechanized",1,"Fri","weekday","no_sled","Slate River Rd",NA,NA,NA,9.8,NA,39,-1,29,25.1,1,2,0,0,0,2,2,2
"13547",2021-03-12,"Slate River Rd","w2021","Motorized",1,"Fri","weekday","sled","Slate River Rd",NA,NA,NA,9.8,NA,39,-1,29,25.1,1,2,0,0,0,2,2,2
"13548",2021-03-12,"Slate River Rd","w2021","Hybrid",10,"Fri","weekday","sled","Slate River Rd",NA,NA,NA,9.8,NA,39,-1,29,25.1,1,2,0,0,0,2,2,2
"13549",2021-03-13,"Slate River Rd","w2021","Non.motorized",53,"Sat","weekend","no_sled","Slate River Rd",NA,NA,NA,9.8,NA,38,-1,27,25.8,-1,1,2,0,-2,-1,1,1
"13550",2021-03-13,"Slate River Rd","w2021","Mechanized",0,"Sat","weekend","no_sled","Slate River Rd",NA,NA,NA,9.8,NA,38,-1,27,25.8,-1,1,2,0,-2,-1,1,1
"13551",2021-03-13,"Slate River Rd","w2021","Motorized",0,"Sat","weekend","sled","Slate River Rd",NA,NA,NA,9.8,NA,38,-1,27,25.8,-1,1,2,0,-2,-1,1,1
"13552",2021-03-13,"Slate River Rd","w2021","Hybrid",18,"Sat","weekend","sled","Slate River Rd",NA,NA,NA,9.8,NA,38,-1,27,25.8,-1,1,2,0,-2,-1,1,1
"13553",2021-03-14,"Slate River Rd","w2021","Non.motorized",34,"Sun","weekend","no_sled","Slate River Rd",NA,NA,NA,10.2,NA,42,4,23,24.3,-1,-1,1,2,3,2,3,5
"13554",2021-03-14,"Slate River Rd","w2021","Mechanized",0,"Sun","weekend","no_sled","Slate River Rd",NA,NA,NA,10.2,NA,42,4,23,24.3,-1,-1,1,2,3,2,3,5
"13555",2021-03-14,"Slate River Rd","w2021","Motorized",0,"Sun","weekend","sled","Slate River Rd",NA,NA,NA,10.2,NA,42,4,23,24.3,-1,-1,1,2,3,2,3,5
"13556",2021-03-14,"Slate River Rd","w2021","Hybrid",3,"Sun","weekend","sled","Slate River Rd",NA,NA,NA,10.2,NA,42,4,23,24.3,-1,-1,1,2,3,2,3,5
"13557",2021-03-15,"Slate River Rd","w2021","Non.motorized",37,"Mon","weekday","no_sled","Slate River Rd",NA,NA,NA,10.2,NA,41,-1,26,24.9,4,-1,-1,1,3,2,1,2
"13558",2021-03-15,"Slate River Rd","w2021","Mechanized",0,"Mon","weekday","no_sled","Slate River Rd",NA,NA,NA,10.2,NA,41,-1,26,24.9,4,-1,-1,1,3,2,1,2
"13559",2021-03-15,"Slate River Rd","w2021","Motorized",0,"Mon","weekday","sled","Slate River Rd",NA,NA,NA,10.2,NA,41,-1,26,24.9,4,-1,-1,1,3,2,1,2
"13560",2021-03-15,"Slate River Rd","w2021","Hybrid",3,"Mon","weekday","sled","Slate River Rd",NA,NA,NA,10.2,NA,41,-1,26,24.9,4,-1,-1,1,3,2,1,2
"13561",2021-03-16,"Slate River Rd","w2021","Non.motorized",48,"Tue","weekday","no_sled","Slate River Rd",NA,NA,NA,10.3,NA,40,-1,26,25.8,-1,4,-1,-1,-2,2,1,0
"13562",2021-03-16,"Slate River Rd","w2021","Mechanized",1,"Tue","weekday","no_sled","Slate River Rd",NA,NA,NA,10.3,NA,40,-1,26,25.8,-1,4,-1,-1,-2,2,1,0
"13563",2021-03-16,"Slate River Rd","w2021","Motorized",0,"Tue","weekday","sled","Slate River Rd",NA,NA,NA,10.3,NA,40,-1,26,25.8,-1,4,-1,-1,-2,2,1,0
"13564",2021-03-16,"Slate River Rd","w2021","Hybrid",4,"Tue","weekday","sled","Slate River Rd",NA,NA,NA,10.3,NA,40,-1,26,25.8,-1,4,-1,-1,-2,2,1,0
"13565",2021-03-17,"Slate River Rd","w2021","Non.motorized",44,"Wed","weekday","no_sled","Slate River Rd",NA,NA,NA,10.3,NA,41,1,25,25.1,-1,-1,4,-1,0,-1,3,2
"13566",2021-03-17,"Slate River Rd","w2021","Mechanized",0,"Wed","weekday","no_sled","Slate River Rd",NA,NA,NA,10.3,NA,41,1,25,25.1,-1,-1,4,-1,0,-1,3,2
"13567",2021-03-17,"Slate River Rd","w2021","Motorized",0,"Wed","weekday","sled","Slate River Rd",NA,NA,NA,10.3,NA,41,1,25,25.1,-1,-1,4,-1,0,-1,3,2
"13568",2021-03-17,"Slate River Rd","w2021","Hybrid",4,"Wed","weekday","sled","Slate River Rd",NA,NA,NA,10.3,NA,41,1,25,25.1,-1,-1,4,-1,0,-1,3,2
"13569",2021-03-18,"Slate River Rd","w2021","Non.motorized",45,"Thu","weekday","no_sled","Slate River Rd",NA,NA,NA,10.3,NA,40,-1,29,25.8,1,-1,-1,4,0,-1,-2,2
"13570",2021-03-18,"Slate River Rd","w2021","Mechanized",0,"Thu","weekday","no_sled","Slate River Rd",NA,NA,NA,10.3,NA,40,-1,29,25.8,1,-1,-1,4,0,-1,-2,2
"13571",2021-03-18,"Slate River Rd","w2021","Motorized",0,"Thu","weekday","sled","Slate River Rd",NA,NA,NA,10.3,NA,40,-1,29,25.8,1,-1,-1,4,0,-1,-2,2
"13572",2021-03-18,"Slate River Rd","w2021","Hybrid",3,"Thu","weekday","sled","Slate River Rd",NA,NA,NA,10.3,NA,40,-1,29,25.8,1,-1,-1,4,0,-1,-2,2
"13573",2021-03-19,"Slate River Rd","w2021","Non.motorized",23,"Fri","weekday","no_sled","Slate River Rd",NA,NA,NA,10.3,NA,40,0,36,25.8,-1,1,-1,-1,-1,0,-1,-2
"13574",2021-03-19,"Slate River Rd","w2021","Mechanized",0,"Fri","weekday","no_sled","Slate River Rd",NA,NA,NA,10.3,NA,40,0,36,25.8,-1,1,-1,-1,-1,0,-1,-2
"13575",2021-03-19,"Slate River Rd","w2021","Motorized",0,"Fri","weekday","sled","Slate River Rd",NA,NA,NA,10.3,NA,40,0,36,25.8,-1,1,-1,-1,-1,0,-1,-2
"13576",2021-03-19,"Slate River Rd","w2021","Hybrid",1,"Fri","weekday","sled","Slate River Rd",NA,NA,NA,10.3,NA,40,0,36,25.8,-1,1,-1,-1,-1,0,-1,-2
"13577",2021-03-20,"Slate River Rd","w2021","Non.motorized",55,"Sat","weekend","no_sled","Slate River Rd",NA,NA,NA,10.4,NA,39,-1,37,26.7,0,-1,1,-1,-1,-2,-1,-2
"13578",2021-03-20,"Slate River Rd","w2021","Mechanized",0,"Sat","weekend","no_sled","Slate River Rd",NA,NA,NA,10.4,NA,39,-1,37,26.7,0,-1,1,-1,-1,-2,-1,-2
"13579",2021-03-20,"Slate River Rd","w2021","Motorized",1,"Sat","weekend","sled","Slate River Rd",NA,NA,NA,10.4,NA,39,-1,37,26.7,0,-1,1,-1,-1,-2,-1,-2
"13580",2021-03-20,"Slate River Rd","w2021","Hybrid",0,"Sat","weekend","sled","Slate River Rd",NA,NA,NA,10.4,NA,39,-1,37,26.7,0,-1,1,-1,-1,-2,-1,-2
"13581",2021-03-21,"Slate River Rd","w2021","Non.motorized",32,"Sun","weekend","no_sled","Slate River Rd",NA,NA,NA,10.4,NA,38,-1,28,27.4,-1,0,-1,1,-2,-2,-3,-2
"13582",2021-03-21,"Slate River Rd","w2021","Mechanized",0,"Sun","weekend","no_sled","Slate River Rd",NA,NA,NA,10.4,NA,38,-1,28,27.4,-1,0,-1,1,-2,-2,-3,-2
"13583",2021-03-21,"Slate River Rd","w2021","Motorized",0,"Sun","weekend","sled","Slate River Rd",NA,NA,NA,10.4,NA,38,-1,28,27.4,-1,0,-1,1,-2,-2,-3,-2
"13584",2021-03-21,"Slate River Rd","w2021","Hybrid",6,"Sun","weekend","sled","Slate River Rd",NA,NA,NA,10.4,NA,38,-1,28,27.4,-1,0,-1,1,-2,-2,-3,-2
"13585",2021-03-22,"Slate River Rd","w2021","Non.motorized",10,"Mon","weekday","no_sled","Slate River Rd",NA,NA,NA,10.5,NA,41,3,26,25.6,-1,-1,0,-1,2,1,1,0
"13586",2021-03-22,"Slate River Rd","w2021","Mechanized",0,"Mon","weekday","no_sled","Slate River Rd",NA,NA,NA,10.5,NA,41,3,26,25.6,-1,-1,0,-1,2,1,1,0
"13587",2021-03-22,"Slate River Rd","w2021","Motorized",0,"Mon","weekday","sled","Slate River Rd",NA,NA,NA,10.5,NA,41,3,26,25.6,-1,-1,0,-1,2,1,1,0
"13588",2021-03-22,"Slate River Rd","w2021","Hybrid",6,"Mon","weekday","sled","Slate River Rd",NA,NA,NA,10.5,NA,41,3,26,25.6,-1,-1,0,-1,2,1,1,0
"13589",2021-03-23,"Slate River Rd","w2021","Non.motorized",30,"Tue","weekday","no_sled","Slate River Rd",NA,NA,NA,10.6,NA,41,0,24,25.9,3,-1,-1,0,3,2,1,1
"13590",2021-03-23,"Slate River Rd","w2021","Mechanized",1,"Tue","weekday","no_sled","Slate River Rd",NA,NA,NA,10.6,NA,41,0,24,25.9,3,-1,-1,0,3,2,1,1
"13591",2021-03-23,"Slate River Rd","w2021","Motorized",1,"Tue","weekday","sled","Slate River Rd",NA,NA,NA,10.6,NA,41,0,24,25.9,3,-1,-1,0,3,2,1,1
"13592",2021-03-23,"Slate River Rd","w2021","Hybrid",5,"Tue","weekday","sled","Slate River Rd",NA,NA,NA,10.6,NA,41,0,24,25.9,3,-1,-1,0,3,2,1,1
"13593",2021-03-24,"Slate River Rd","w2021","Non.motorized",19,"Wed","weekday","no_sled","Slate River Rd",NA,NA,NA,10.8,NA,41,0,24,26.3,0,3,-1,-1,0,3,2,1
"13594",2021-03-24,"Slate River Rd","w2021","Mechanized",0,"Wed","weekday","no_sled","Slate River Rd",NA,NA,NA,10.8,NA,41,0,24,26.3,0,3,-1,-1,0,3,2,1
"13595",2021-03-24,"Slate River Rd","w2021","Motorized",2,"Wed","weekday","sled","Slate River Rd",NA,NA,NA,10.8,NA,41,0,24,26.3,0,3,-1,-1,0,3,2,1
"13596",2021-03-24,"Slate River Rd","w2021","Hybrid",3,"Wed","weekday","sled","Slate River Rd",NA,NA,NA,10.8,NA,41,0,24,26.3,0,3,-1,-1,0,3,2,1
"13597",2021-03-25,"Slate River Rd","w2021","Non.motorized",21,"Thu","weekday","no_sled","Slate River Rd",NA,NA,NA,10.9,NA,43,2,23,25.3,0,0,3,-1,2,2,5,4
"13598",2021-03-25,"Slate River Rd","w2021","Mechanized",0,"Thu","weekday","no_sled","Slate River Rd",NA,NA,NA,10.9,NA,43,2,23,25.3,0,0,3,-1,2,2,5,4
"13599",2021-03-25,"Slate River Rd","w2021","Motorized",1,"Thu","weekday","sled","Slate River Rd",NA,NA,NA,10.9,NA,43,2,23,25.3,0,0,3,-1,2,2,5,4
"13600",2021-03-25,"Slate River Rd","w2021","Hybrid",7,"Thu","weekday","sled","Slate River Rd",NA,NA,NA,10.9,NA,43,2,23,25.3,0,0,3,-1,2,2,5,4
"13601",2021-03-26,"Slate River Rd","w2021","Non.motorized",25,"Fri","weekday","no_sled","Slate River Rd",NA,NA,NA,11,NA,44,1,23,25,2,0,0,3,3,3,3,6
"13602",2021-03-26,"Slate River Rd","w2021","Mechanized",0,"Fri","weekday","no_sled","Slate River Rd",NA,NA,NA,11,NA,44,1,23,25,2,0,0,3,3,3,3,6
"13603",2021-03-26,"Slate River Rd","w2021","Motorized",2,"Fri","weekday","sled","Slate River Rd",NA,NA,NA,11,NA,44,1,23,25,2,0,0,3,3,3,3,6
"13604",2021-03-26,"Slate River Rd","w2021","Hybrid",2,"Fri","weekday","sled","Slate River Rd",NA,NA,NA,11,NA,44,1,23,25,2,0,0,3,3,3,3,6
"13605",2021-03-27,"Slate River Rd","w2021","Non.motorized",40,"Sat","weekend","no_sled","Slate River Rd",NA,NA,NA,11,NA,42,-2,25,26.2,1,2,0,0,-1,1,1,1
"13606",2021-03-27,"Slate River Rd","w2021","Mechanized",0,"Sat","weekend","no_sled","Slate River Rd",NA,NA,NA,11,NA,42,-2,25,26.2,1,2,0,0,-1,1,1,1
"13607",2021-03-27,"Slate River Rd","w2021","Motorized",2,"Sat","weekend","sled","Slate River Rd",NA,NA,NA,11,NA,42,-2,25,26.2,1,2,0,0,-1,1,1,1
"13608",2021-03-27,"Slate River Rd","w2021","Hybrid",9,"Sat","weekend","sled","Slate River Rd",NA,NA,NA,11,NA,42,-2,25,26.2,1,2,0,0,-1,1,1,1
"13609",2021-03-28,"Slate River Rd","w2021","Non.motorized",59,"Sun","weekend","no_sled","Slate River Rd",NA,NA,NA,11,NA,42,0,31,26.2,-2,1,2,0,-2,-1,1,1
"13610",2021-03-28,"Slate River Rd","w2021","Mechanized",0,"Sun","weekend","no_sled","Slate River Rd",NA,NA,NA,11,NA,42,0,31,26.2,-2,1,2,0,-2,-1,1,1
"13611",2021-03-28,"Slate River Rd","w2021","Motorized",0,"Sun","weekend","sled","Slate River Rd",NA,NA,NA,11,NA,42,0,31,26.2,-2,1,2,0,-2,-1,1,1
"13612",2021-03-28,"Slate River Rd","w2021","Hybrid",3,"Sun","weekend","sled","Slate River Rd",NA,NA,NA,11,NA,42,0,31,26.2,-2,1,2,0,-2,-1,1,1
"13613",2021-03-29,"Slate River Rd","w2021","Non.motorized",28,"Mon","weekday","no_sled","Slate River Rd",NA,NA,NA,11.1,NA,40,-2,37,27.8,0,-2,1,2,-2,-4,-3,-1
"13614",2021-03-29,"Slate River Rd","w2021","Mechanized",0,"Mon","weekday","no_sled","Slate River Rd",NA,NA,NA,11.1,NA,40,-2,37,27.8,0,-2,1,2,-2,-4,-3,-1
"13615",2021-03-29,"Slate River Rd","w2021","Motorized",0,"Mon","weekday","sled","Slate River Rd",NA,NA,NA,11.1,NA,40,-2,37,27.8,0,-2,1,2,-2,-4,-3,-1
"13616",2021-03-29,"Slate River Rd","w2021","Hybrid",1,"Mon","weekday","sled","Slate River Rd",NA,NA,NA,11.1,NA,40,-2,37,27.8,0,-2,1,2,-2,-4,-3,-1
"13617",2021-03-30,"Slate River Rd","w2021","Non.motorized",10,"Tue","weekday","no_sled","Slate River Rd",NA,NA,NA,11.1,NA,39,-1,23,28.5,-2,0,-2,1,-3,-3,-5,-4
"13618",2021-03-30,"Slate River Rd","w2021","Mechanized",0,"Tue","weekday","no_sled","Slate River Rd",NA,NA,NA,11.1,NA,39,-1,23,28.5,-2,0,-2,1,-3,-3,-5,-4
"13619",2021-03-30,"Slate River Rd","w2021","Motorized",0,"Tue","weekday","sled","Slate River Rd",NA,NA,NA,11.1,NA,39,-1,23,28.5,-2,0,-2,1,-3,-3,-5,-4
"13620",2021-03-30,"Slate River Rd","w2021","Hybrid",0,"Tue","weekday","sled","Slate River Rd",NA,NA,NA,11.1,NA,39,-1,23,28.5,-2,0,-2,1,-3,-3,-5,-4
"13621",2021-03-31,"Slate River Rd","w2021","Non.motorized",38,"Wed","weekday","no_sled","Slate River Rd",NA,NA,NA,11.1,NA,39,0,26,28.5,-1,-2,0,-2,-1,-3,-3,-5
"13622",2021-03-31,"Slate River Rd","w2021","Mechanized",0,"Wed","weekday","no_sled","Slate River Rd",NA,NA,NA,11.1,NA,39,0,26,28.5,-1,-2,0,-2,-1,-3,-3,-5
"13623",2021-03-31,"Slate River Rd","w2021","Motorized",0,"Wed","weekday","sled","Slate River Rd",NA,NA,NA,11.1,NA,39,0,26,28.5,-1,-2,0,-2,-1,-3,-3,-5
"13624",2021-03-31,"Slate River Rd","w2021","Hybrid",7,"Wed","weekday","sled","Slate River Rd",NA,NA,NA,11.1,NA,39,0,26,28.5,-1,-2,0,-2,-1,-3,-3,-5
"13625",2021-04-01,"Slate River Rd","w2021","Non.motorized",16,"Thu","weekday","no_sled","Slate River Rd",NA,NA,NA,11.1,NA,38,-1,36,29.2,0,-1,-2,0,-1,-2,-4,-4
"13626",2021-04-01,"Slate River Rd","w2021","Mechanized",0,"Thu","weekday","no_sled","Slate River Rd",NA,NA,NA,11.1,NA,38,-1,36,29.2,0,-1,-2,0,-1,-2,-4,-4
"13627",2021-04-01,"Slate River Rd","w2021","Motorized",1,"Thu","weekday","sled","Slate River Rd",NA,NA,NA,11.1,NA,38,-1,36,29.2,0,-1,-2,0,-1,-2,-4,-4
"13628",2021-04-01,"Slate River Rd","w2021","Hybrid",5,"Thu","weekday","sled","Slate River Rd",NA,NA,NA,11.1,NA,38,-1,36,29.2,0,-1,-2,0,-1,-2,-4,-4
"13629",2021-04-02,"Slate River Rd","w2021","Non.motorized",31,"Fri","weekday","no_sled","Slate River Rd",NA,NA,NA,11.1,NA,37,-1,42,30,-1,0,-1,-2,-2,-2,-3,-5
"13630",2021-04-02,"Slate River Rd","w2021","Mechanized",0,"Fri","weekday","no_sled","Slate River Rd",NA,NA,NA,11.1,NA,37,-1,42,30,-1,0,-1,-2,-2,-2,-3,-5
"13631",2021-04-02,"Slate River Rd","w2021","Motorized",1,"Fri","weekday","sled","Slate River Rd",NA,NA,NA,11.1,NA,37,-1,42,30,-1,0,-1,-2,-2,-2,-3,-5
"13632",2021-04-02,"Slate River Rd","w2021","Hybrid",2,"Fri","weekday","sled","Slate River Rd",NA,NA,NA,11.1,NA,37,-1,42,30,-1,0,-1,-2,-2,-2,-3,-5
"13633",2021-04-03,"Slate River Rd","w2021","Non.motorized",33,"Sat","weekend","no_sled","Slate River Rd",NA,NA,NA,10.8,NA,35,-2,45,30.9,-1,-1,0,-1,-3,-4,-4,-5
"13634",2021-04-03,"Slate River Rd","w2021","Mechanized",1,"Sat","weekend","no_sled","Slate River Rd",NA,NA,NA,10.8,NA,35,-2,45,30.9,-1,-1,0,-1,-3,-4,-4,-5
"13635",2021-04-03,"Slate River Rd","w2021","Motorized",0,"Sat","weekend","sled","Slate River Rd",NA,NA,NA,10.8,NA,35,-2,45,30.9,-1,-1,0,-1,-3,-4,-4,-5
"13636",2021-04-03,"Slate River Rd","w2021","Hybrid",4,"Sat","weekend","sled","Slate River Rd",NA,NA,NA,10.8,NA,35,-2,45,30.9,-1,-1,0,-1,-3,-4,-4,-5
"13637",2021-04-04,"Slate River Rd","w2021","Non.motorized",34,"Sun","weekend","no_sled","Slate River Rd",NA,NA,NA,10.7,NA,34,-1,44,31.5,-2,-1,-1,0,-3,-4,-5,-5
"13638",2021-04-04,"Slate River Rd","w2021","Mechanized",0,"Sun","weekend","no_sled","Slate River Rd",NA,NA,NA,10.7,NA,34,-1,44,31.5,-2,-1,-1,0,-3,-4,-5,-5
"13639",2021-04-04,"Slate River Rd","w2021","Motorized",0,"Sun","weekend","sled","Slate River Rd",NA,NA,NA,10.7,NA,34,-1,44,31.5,-2,-1,-1,0,-3,-4,-5,-5
"13640",2021-04-04,"Slate River Rd","w2021","Hybrid",2,"Sun","weekend","sled","Slate River Rd",NA,NA,NA,10.7,NA,34,-1,44,31.5,-2,-1,-1,0,-3,-4,-5,-5
"13641",2021-04-05,"Slate River Rd","w2021","Non.motorized",32,"Mon","weekday","no_sled","Slate River Rd",NA,NA,NA,10.6,NA,33,-1,44,32.1,-1,-2,-1,-1,-2,-4,-5,-6
"13642",2021-04-05,"Slate River Rd","w2021","Mechanized",0,"Mon","weekday","no_sled","Slate River Rd",NA,NA,NA,10.6,NA,33,-1,44,32.1,-1,-2,-1,-1,-2,-4,-5,-6
"13643",2021-04-05,"Slate River Rd","w2021","Motorized",0,"Mon","weekday","sled","Slate River Rd",NA,NA,NA,10.6,NA,33,-1,44,32.1,-1,-2,-1,-1,-2,-4,-5,-6
"13644",2021-04-05,"Slate River Rd","w2021","Hybrid",2,"Mon","weekday","sled","Slate River Rd",NA,NA,NA,10.6,NA,33,-1,44,32.1,-1,-2,-1,-1,-2,-4,-5,-6
"13645",2021-04-06,"Slate River Rd","w2021","Non.motorized",6,"Tue","weekday","no_sled","Slate River Rd",NA,NA,NA,10.3,NA,31,-2,32,33.2,-1,-1,-2,-1,-3,-4,-6,-7
"13646",2021-04-06,"Slate River Rd","w2021","Mechanized",0,"Tue","weekday","no_sled","Slate River Rd",NA,NA,NA,10.3,NA,31,-2,32,33.2,-1,-1,-2,-1,-3,-4,-6,-7
"13647",2021-04-06,"Slate River Rd","w2021","Motorized",0,"Tue","weekday","sled","Slate River Rd",NA,NA,NA,10.3,NA,31,-2,32,33.2,-1,-1,-2,-1,-3,-4,-6,-7
"13648",2021-04-06,"Slate River Rd","w2021","Hybrid",0,"Tue","weekday","sled","Slate River Rd",NA,NA,NA,10.3,NA,31,-2,32,33.2,-1,-1,-2,-1,-3,-4,-6,-7
"13649",2021-04-07,"Slate River Rd","w2021","Non.motorized",15,"Wed","weekday","no_sled","Slate River Rd",NA,NA,NA,10,NA,31,0,33,32.3,-2,-1,-1,-2,-2,-3,-4,-6
"13650",2021-04-07,"Slate River Rd","w2021","Mechanized",1,"Wed","weekday","no_sled","Slate River Rd",NA,NA,NA,10,NA,31,0,33,32.3,-2,-1,-1,-2,-2,-3,-4,-6
"13651",2021-04-07,"Slate River Rd","w2021","Motorized",0,"Wed","weekday","sled","Slate River Rd",NA,NA,NA,10,NA,31,0,33,32.3,-2,-1,-1,-2,-2,-3,-4,-6
"13652",2021-04-07,"Slate River Rd","w2021","Hybrid",2,"Wed","weekday","sled","Slate River Rd",NA,NA,NA,10,NA,31,0,33,32.3,-2,-1,-1,-2,-2,-3,-4,-6
"13653",2021-04-08,"Slate River Rd","w2021","Non.motorized",16,"Thu","weekday","no_sled","Slate River Rd",NA,NA,NA,9.9,NA,29,-2,39,34.1,0,-2,-1,-1,-2,-4,-5,-6
"13654",2021-04-08,"Slate River Rd","w2021","Mechanized",0,"Thu","weekday","no_sled","Slate River Rd",NA,NA,NA,9.9,NA,29,-2,39,34.1,0,-2,-1,-1,-2,-4,-5,-6
"13655",2021-04-08,"Slate River Rd","w2021","Motorized",0,"Thu","weekday","sled","Slate River Rd",NA,NA,NA,9.9,NA,29,-2,39,34.1,0,-2,-1,-1,-2,-4,-5,-6
"13656",2021-04-08,"Slate River Rd","w2021","Hybrid",3,"Thu","weekday","sled","Slate River Rd",NA,NA,NA,9.9,NA,29,-2,39,34.1,0,-2,-1,-1,-2,-4,-5,-6
"13657",2021-04-09,"Slate River Rd","w2021","Non.motorized",13,"Fri","weekday","no_sled","Slate River Rd",NA,NA,NA,9.6,NA,28,-1,33,34.3,-2,0,-2,-1,-3,-3,-5,-6
"13658",2021-04-09,"Slate River Rd","w2021","Mechanized",0,"Fri","weekday","no_sled","Slate River Rd",NA,NA,NA,9.6,NA,28,-1,33,34.3,-2,0,-2,-1,-3,-3,-5,-6
"13659",2021-04-09,"Slate River Rd","w2021","Motorized",0,"Fri","weekday","sled","Slate River Rd",NA,NA,NA,9.6,NA,28,-1,33,34.3,-2,0,-2,-1,-3,-3,-5,-6
"13660",2021-04-09,"Slate River Rd","w2021","Hybrid",2,"Fri","weekday","sled","Slate River Rd",NA,NA,NA,9.6,NA,28,-1,33,34.3,-2,0,-2,-1,-3,-3,-5,-6
"13661",2021-04-10,"Slate River Rd","w2021","Non.motorized",15,"Sat","weekend","no_sled","Slate River Rd",NA,NA,NA,9.5,NA,26,-2,37,36.5,-1,-2,0,-2,-3,-5,-5,-7
"13662",2021-04-10,"Slate River Rd","w2021","Mechanized",0,"Sat","weekend","no_sled","Slate River Rd",NA,NA,NA,9.5,NA,26,-2,37,36.5,-1,-2,0,-2,-3,-5,-5,-7
"13663",2021-04-10,"Slate River Rd","w2021","Motorized",5,"Sat","weekend","sled","Slate River Rd",NA,NA,NA,9.5,NA,26,-2,37,36.5,-1,-2,0,-2,-3,-5,-5,-7
"13664",2021-04-10,"Slate River Rd","w2021","Hybrid",5,"Sat","weekend","sled","Slate River Rd",NA,NA,NA,9.5,NA,26,-2,37,36.5,-1,-2,0,-2,-3,-5,-5,-7
"13665",2021-04-11,"Slate River Rd","w2021","Non.motorized",21,"Sun","weekend","no_sled","Slate River Rd",NA,NA,NA,9.2,NA,26,0,39,35.4,-2,-1,-2,0,-2,-3,-5,-5
"13666",2021-04-11,"Slate River Rd","w2021","Mechanized",0,"Sun","weekend","no_sled","Slate River Rd",NA,NA,NA,9.2,NA,26,0,39,35.4,-2,-1,-2,0,-2,-3,-5,-5
"13667",2021-04-11,"Slate River Rd","w2021","Motorized",0,"Sun","weekend","sled","Slate River Rd",NA,NA,NA,9.2,NA,26,0,39,35.4,-2,-1,-2,0,-2,-3,-5,-5
"13668",2021-04-11,"Slate River Rd","w2021","Hybrid",6,"Sun","weekend","sled","Slate River Rd",NA,NA,NA,9.2,NA,26,0,39,35.4,-2,-1,-2,0,-2,-3,-5,-5
"13669",2021-04-12,"Slate River Rd","w2021","Non.motorized",7,"Mon","weekday","no_sled","Slate River Rd",NA,NA,NA,8.8,NA,24,-2,38,36.7,0,-2,-1,-2,-2,-4,-5,-7
"13670",2021-04-12,"Slate River Rd","w2021","Mechanized",0,"Mon","weekday","no_sled","Slate River Rd",NA,NA,NA,8.8,NA,24,-2,38,36.7,0,-2,-1,-2,-2,-4,-5,-7
"13671",2021-04-12,"Slate River Rd","w2021","Motorized",0,"Mon","weekday","sled","Slate River Rd",NA,NA,NA,8.8,NA,24,-2,38,36.7,0,-2,-1,-2,-2,-4,-5,-7
"13672",2021-04-12,"Slate River Rd","w2021","Hybrid",0,"Mon","weekday","sled","Slate River Rd",NA,NA,NA,8.8,NA,24,-2,38,36.7,0,-2,-1,-2,-2,-4,-5,-7
"13673",2021-04-13,"Slate River Rd","w2021","Non.motorized",8,"Tue","weekday","no_sled","Slate River Rd",NA,NA,NA,8.4,NA,23,-1,35,36.5,-2,0,-2,-1,-3,-3,-5,-6
"13674",2021-04-13,"Slate River Rd","w2021","Mechanized",0,"Tue","weekday","no_sled","Slate River Rd",NA,NA,NA,8.4,NA,23,-1,35,36.5,-2,0,-2,-1,-3,-3,-5,-6
"13675",2021-04-13,"Slate River Rd","w2021","Motorized",0,"Tue","weekday","sled","Slate River Rd",NA,NA,NA,8.4,NA,23,-1,35,36.5,-2,0,-2,-1,-3,-3,-5,-6
"13676",2021-04-13,"Slate River Rd","w2021","Hybrid",3,"Tue","weekday","sled","Slate River Rd",NA,NA,NA,8.4,NA,23,-1,35,36.5,-2,0,-2,-1,-3,-3,-5,-6
"13677",2021-04-14,"Slate River Rd","w2021","Non.motorized",18,"Wed","weekday","no_sled","Slate River Rd",NA,NA,NA,8.4,NA,23,0,41,36.5,-1,-2,0,-2,-1,-3,-3,-5
"13678",2021-04-14,"Slate River Rd","w2021","Mechanized",0,"Wed","weekday","no_sled","Slate River Rd",NA,NA,NA,8.4,NA,23,0,41,36.5,-1,-2,0,-2,-1,-3,-3,-5
"13679",2021-04-14,"Slate River Rd","w2021","Motorized",0,"Wed","weekday","sled","Slate River Rd",NA,NA,NA,8.4,NA,23,0,41,36.5,-1,-2,0,-2,-1,-3,-3,-5
"13680",2021-04-14,"Slate River Rd","w2021","Hybrid",2,"Wed","weekday","sled","Slate River Rd",NA,NA,NA,8.4,NA,23,0,41,36.5,-1,-2,0,-2,-1,-3,-3,-5
"13681",2021-04-15,"Slate River Rd","w2021","Non.motorized",3,"Thu","weekday","no_sled","Slate River Rd",NA,NA,NA,8.1,NA,22,-1,33,36.8,0,-1,-2,0,-1,-2,-4,-4
"13682",2021-04-15,"Slate River Rd","w2021","Mechanized",0,"Thu","weekday","no_sled","Slate River Rd",NA,NA,NA,8.1,NA,22,-1,33,36.8,0,-1,-2,0,-1,-2,-4,-4
"13683",2021-04-15,"Slate River Rd","w2021","Motorized",0,"Thu","weekday","sled","Slate River Rd",NA,NA,NA,8.1,NA,22,-1,33,36.8,0,-1,-2,0,-1,-2,-4,-4
"13684",2021-04-15,"Slate River Rd","w2021","Hybrid",1,"Thu","weekday","sled","Slate River Rd",NA,NA,NA,8.1,NA,22,-1,33,36.8,0,-1,-2,0,-1,-2,-4,-4
"13685",2020-12-03,"Snodgrass","w2021","Non.motorized",23,"Thu","weekday","no_sled","East River",NA,NA,NA,NA,NA,NA,NA,NA,NA,NA,NA,NA,NA,NA,NA,NA,NA
"13686",2020-12-03,"Snodgrass","w2021","Mechanized",1,"Thu","weekday","no_sled","East River",NA,NA,NA,NA,NA,NA,NA,NA,NA,NA,NA,NA,NA,NA,NA,NA,NA
"13687",2020-12-03,"Snodgrass","w2021","Motorized",0,"Thu","weekday","sled","East River",NA,NA,NA,NA,NA,NA,NA,NA,NA,NA,NA,NA,NA,NA,NA,NA,NA
"13688",2020-12-03,"Snodgrass","w2021","Hybrid",0,"Thu","weekday","sled","East River",NA,NA,NA,NA,NA,NA,NA,NA,NA,NA,NA,NA,NA,NA,NA,NA,NA
"13689",2020-12-04,"Snodgrass","w2021","Non.motorized",58,"Fri","weekday","no_sled","East River",NA,NA,NA,2.4,NA,11,0,29,21.8,0,0,0,0,0,0,0,0
"13690",2020-12-04,"Snodgrass","w2021","Mechanized",0,"Fri","weekday","no_sled","East River",NA,NA,NA,2.4,NA,11,0,29,21.8,0,0,0,0,0,0,0,0
"13691",2020-12-04,"Snodgrass","w2021","Motorized",0,"Fri","weekday","sled","East River",NA,NA,NA,2.4,NA,11,0,29,21.8,0,0,0,0,0,0,0,0
"13692",2020-12-04,"Snodgrass","w2021","Hybrid",0,"Fri","weekday","sled","East River",NA,NA,NA,2.4,NA,11,0,29,21.8,0,0,0,0,0,0,0,0
"13693",2020-12-05,"Snodgrass","w2021","Non.motorized",103,"Sat","weekend","no_sled","East River",NA,NA,NA,2.5,NA,11,0,32,22.7,0,0,0,0,0,0,0,0
"13694",2020-12-05,"Snodgrass","w2021","Mechanized",1,"Sat","weekend","no_sled","East River",NA,NA,NA,2.5,NA,11,0,32,22.7,0,0,0,0,0,0,0,0
"13695",2020-12-05,"Snodgrass","w2021","Motorized",0,"Sat","weekend","sled","East River",NA,NA,NA,2.5,NA,11,0,32,22.7,0,0,0,0,0,0,0,0
"13696",2020-12-05,"Snodgrass","w2021","Hybrid",0,"Sat","weekend","sled","East River",NA,NA,NA,2.5,NA,11,0,32,22.7,0,0,0,0,0,0,0,0
"13697",2020-12-06,"Snodgrass","w2021","Non.motorized",90,"Sun","weekend","no_sled","East River",NA,NA,NA,2.5,NA,11,0,30,22.7,0,0,0,0,0,0,0,0
"13698",2020-12-06,"Snodgrass","w2021","Mechanized",3,"Sun","weekend","no_sled","East River",NA,NA,NA,2.5,NA,11,0,30,22.7,0,0,0,0,0,0,0,0
"13699",2020-12-06,"Snodgrass","w2021","Motorized",0,"Sun","weekend","sled","East River",NA,NA,NA,2.5,NA,11,0,30,22.7,0,0,0,0,0,0,0,0
"13700",2020-12-06,"Snodgrass","w2021","Hybrid",0,"Sun","weekend","sled","East River",NA,NA,NA,2.5,NA,11,0,30,22.7,0,0,0,0,0,0,0,0
"13701",2020-12-07,"Snodgrass","w2021","Non.motorized",43,"Mon","weekday","no_sled","East River",NA,NA,NA,2.5,NA,11,0,33,22.7,0,0,0,0,0,0,0,0
"13702",2020-12-07,"Snodgrass","w2021","Mechanized",1,"Mon","weekday","no_sled","East River",NA,NA,NA,2.5,NA,11,0,33,22.7,0,0,0,0,0,0,0,0
"13703",2020-12-07,"Snodgrass","w2021","Motorized",0,"Mon","weekday","sled","East River",NA,NA,NA,2.5,NA,11,0,33,22.7,0,0,0,0,0,0,0,0
"13704",2020-12-07,"Snodgrass","w2021","Hybrid",0,"Mon","weekday","sled","East River",NA,NA,NA,2.5,NA,11,0,33,22.7,0,0,0,0,0,0,0,0
"13705",2020-12-08,"Snodgrass","w2021","Non.motorized",40,"Tue","weekday","no_sled","East River",NA,NA,NA,2.5,NA,11,0,34,22.7,0,0,0,0,0,0,0,0
"13706",2020-12-08,"Snodgrass","w2021","Mechanized",1,"Tue","weekday","no_sled","East River",NA,NA,NA,2.5,NA,11,0,34,22.7,0,0,0,0,0,0,0,0
"13707",2020-12-08,"Snodgrass","w2021","Motorized",0,"Tue","weekday","sled","East River",NA,NA,NA,2.5,NA,11,0,34,22.7,0,0,0,0,0,0,0,0
"13708",2020-12-08,"Snodgrass","w2021","Hybrid",0,"Tue","weekday","sled","East River",NA,NA,NA,2.5,NA,11,0,34,22.7,0,0,0,0,0,0,0,0
"13709",2020-12-09,"Snodgrass","w2021","Non.motorized",34,"Wed","weekday","no_sled","East River",NA,NA,NA,2.5,NA,11,0,32,22.7,0,0,0,0,0,0,0,0
"13710",2020-12-09,"Snodgrass","w2021","Mechanized",0,"Wed","weekday","no_sled","East River",NA,NA,NA,2.5,NA,11,0,32,22.7,0,0,0,0,0,0,0,0
"13711",2020-12-09,"Snodgrass","w2021","Motorized",0,"Wed","weekday","sled","East River",NA,NA,NA,2.5,NA,11,0,32,22.7,0,0,0,0,0,0,0,0
"13712",2020-12-09,"Snodgrass","w2021","Hybrid",0,"Wed","weekday","sled","East River",NA,NA,NA,2.5,NA,11,0,32,22.7,0,0,0,0,0,0,0,0
"13713",2020-12-10,"Snodgrass","w2021","Non.motorized",39,"Thu","weekday","no_sled","East River",NA,NA,NA,2.5,NA,11,0,28,22.7,0,0,0,0,0,0,0,0
"13714",2020-12-10,"Snodgrass","w2021","Mechanized",1,"Thu","weekday","no_sled","East River",NA,NA,NA,2.5,NA,11,0,28,22.7,0,0,0,0,0,0,0,0
"13715",2020-12-10,"Snodgrass","w2021","Motorized",0,"Thu","weekday","sled","East River",NA,NA,NA,2.5,NA,11,0,28,22.7,0,0,0,0,0,0,0,0
"13716",2020-12-10,"Snodgrass","w2021","Hybrid",0,"Thu","weekday","sled","East River",NA,NA,NA,2.5,NA,11,0,28,22.7,0,0,0,0,0,0,0,0
"13717",2020-12-11,"Snodgrass","w2021","Non.motorized",NA,"Fri","weekday","no_sled","East River",NA,NA,NA,2.6,NA,12,1,20,21.7,0,0,0,0,1,1,1,1
"13718",2020-12-11,"Snodgrass","w2021","Mechanized",NA,"Fri","weekday","no_sled","East River",NA,NA,NA,2.6,NA,12,1,20,21.7,0,0,0,0,1,1,1,1
"13719",2020-12-11,"Snodgrass","w2021","Motorized",NA,"Fri","weekday","sled","East River",NA,NA,NA,2.6,NA,12,1,20,21.7,0,0,0,0,1,1,1,1
"13720",2020-12-11,"Snodgrass","w2021","Hybrid",NA,"Fri","weekday","sled","East River",NA,NA,NA,2.6,NA,12,1,20,21.7,0,0,0,0,1,1,1,1
"13721",2020-12-12,"Snodgrass","w2021","Non.motorized",NA,"Sat","weekend","no_sled","East River",NA,NA,NA,2.9,NA,17,5,12,17.1,1,0,0,0,6,6,6,6
"13722",2020-12-12,"Snodgrass","w2021","Mechanized",NA,"Sat","weekend","no_sled","East River",NA,NA,NA,2.9,NA,17,5,12,17.1,1,0,0,0,6,6,6,6
"13723",2020-12-12,"Snodgrass","w2021","Motorized",NA,"Sat","weekend","sled","East River",NA,NA,NA,2.9,NA,17,5,12,17.1,1,0,0,0,6,6,6,6
"13724",2020-12-12,"Snodgrass","w2021","Hybrid",NA,"Sat","weekend","sled","East River",NA,NA,NA,2.9,NA,17,5,12,17.1,1,0,0,0,6,6,6,6
"13725",2020-12-13,"Snodgrass","w2021","Non.motorized",152,"Sun","weekend","no_sled","East River",NA,NA,NA,3.3,NA,19,2,10,17.4,5,1,0,0,7,8,8,8
"13726",2020-12-13,"Snodgrass","w2021","Mechanized",0,"Sun","weekend","no_sled","East River",NA,NA,NA,3.3,NA,19,2,10,17.4,5,1,0,0,7,8,8,8
"13727",2020-12-13,"Snodgrass","w2021","Motorized",0,"Sun","weekend","sled","East River",NA,NA,NA,3.3,NA,19,2,10,17.4,5,1,0,0,7,8,8,8
"13728",2020-12-13,"Snodgrass","w2021","Hybrid",0,"Sun","weekend","sled","East River",NA,NA,NA,3.3,NA,19,2,10,17.4,5,1,0,0,7,8,8,8
"13729",2020-12-14,"Snodgrass","w2021","Non.motorized",58,"Mon","weekday","no_sled","East River",NA,NA,NA,3.3,NA,18,-1,18,18.3,2,5,1,0,1,6,7,7
"13730",2020-12-14,"Snodgrass","w2021","Mechanized",0,"Mon","weekday","no_sled","East River",NA,NA,NA,3.3,NA,18,-1,18,18.3,2,5,1,0,1,6,7,7
"13731",2020-12-14,"Snodgrass","w2021","Motorized",0,"Mon","weekday","sled","East River",NA,NA,NA,3.3,NA,18,-1,18,18.3,2,5,1,0,1,6,7,7
"13732",2020-12-14,"Snodgrass","w2021","Hybrid",0,"Mon","weekday","sled","East River",NA,NA,NA,3.3,NA,18,-1,18,18.3,2,5,1,0,1,6,7,7
"13733",2020-12-15,"Snodgrass","w2021","Non.motorized",74,"Tue","weekday","no_sled","East River",NA,NA,NA,3.5,NA,19,1,13,18.4,-1,2,5,1,0,2,7,8
"13734",2020-12-15,"Snodgrass","w2021","Mechanized",0,"Tue","weekday","no_sled","East River",NA,NA,NA,3.5,NA,19,1,13,18.4,-1,2,5,1,0,2,7,8
"13735",2020-12-15,"Snodgrass","w2021","Motorized",0,"Tue","weekday","sled","East River",NA,NA,NA,3.5,NA,19,1,13,18.4,-1,2,5,1,0,2,7,8
"13736",2020-12-15,"Snodgrass","w2021","Hybrid",0,"Tue","weekday","sled","East River",NA,NA,NA,3.5,NA,19,1,13,18.4,-1,2,5,1,0,2,7,8
"13737",2020-12-16,"Snodgrass","w2021","Non.motorized",58,"Wed","weekday","no_sled","East River",NA,NA,NA,3.5,NA,19,0,16,18.4,1,-1,2,5,1,0,2,7
"13738",2020-12-16,"Snodgrass","w2021","Mechanized",0,"Wed","weekday","no_sled","East River",NA,NA,NA,3.5,NA,19,0,16,18.4,1,-1,2,5,1,0,2,7
"13739",2020-12-16,"Snodgrass","w2021","Motorized",0,"Wed","weekday","sled","East River",NA,NA,NA,3.5,NA,19,0,16,18.4,1,-1,2,5,1,0,2,7
"13740",2020-12-16,"Snodgrass","w2021","Hybrid",0,"Wed","weekday","sled","East River",NA,NA,NA,3.5,NA,19,0,16,18.4,1,-1,2,5,1,0,2,7
"13741",2020-12-17,"Snodgrass","w2021","Non.motorized",71,"Thu","weekday","no_sled","East River",NA,NA,NA,3.5,NA,19,0,20,18.4,0,1,-1,2,0,1,0,2
"13742",2020-12-17,"Snodgrass","w2021","Mechanized",1,"Thu","weekday","no_sled","East River",NA,NA,NA,3.5,NA,19,0,20,18.4,0,1,-1,2,0,1,0,2
"13743",2020-12-17,"Snodgrass","w2021","Motorized",0,"Thu","weekday","sled","East River",NA,NA,NA,3.5,NA,19,0,20,18.4,0,1,-1,2,0,1,0,2
"13744",2020-12-17,"Snodgrass","w2021","Hybrid",0,"Thu","weekday","sled","East River",NA,NA,NA,3.5,NA,19,0,20,18.4,0,1,-1,2,0,1,0,2
"13745",2020-12-18,"Snodgrass","w2021","Non.motorized",69,"Fri","weekday","no_sled","East River",NA,NA,NA,3.8,NA,22,3,20,17.3,0,0,1,-1,3,3,4,3
"13746",2020-12-18,"Snodgrass","w2021","Mechanized",0,"Fri","weekday","no_sled","East River",NA,NA,NA,3.8,NA,22,3,20,17.3,0,0,1,-1,3,3,4,3
"13747",2020-12-18,"Snodgrass","w2021","Motorized",0,"Fri","weekday","sled","East River",NA,NA,NA,3.8,NA,22,3,20,17.3,0,0,1,-1,3,3,4,3
"13748",2020-12-18,"Snodgrass","w2021","Hybrid",0,"Fri","weekday","sled","East River",NA,NA,NA,3.8,NA,22,3,20,17.3,0,0,1,-1,3,3,4,3
"13749",2020-12-19,"Snodgrass","w2021","Non.motorized",133,"Sat","weekend","no_sled","East River",NA,NA,NA,3.9,NA,22,0,17,17.7,3,0,0,1,3,3,3,4
"13750",2020-12-19,"Snodgrass","w2021","Mechanized",2,"Sat","weekend","no_sled","East River",NA,NA,NA,3.9,NA,22,0,17,17.7,3,0,0,1,3,3,3,4
"13751",2020-12-19,"Snodgrass","w2021","Motorized",0,"Sat","weekend","sled","East River",NA,NA,NA,3.9,NA,22,0,17,17.7,3,0,0,1,3,3,3,4
"13752",2020-12-19,"Snodgrass","w2021","Hybrid",0,"Sat","weekend","sled","East River",NA,NA,NA,3.9,NA,22,0,17,17.7,3,0,0,1,3,3,3,4
"13753",2020-12-20,"Snodgrass","w2021","Non.motorized",127,"Sun","weekend","no_sled","East River",NA,NA,NA,3.9,NA,21,-1,26,18.6,0,3,0,0,-1,2,2,2
"13754",2020-12-20,"Snodgrass","w2021","Mechanized",0,"Sun","weekend","no_sled","East River",NA,NA,NA,3.9,NA,21,-1,26,18.6,0,3,0,0,-1,2,2,2
"13755",2020-12-20,"Snodgrass","w2021","Motorized",0,"Sun","weekend","sled","East River",NA,NA,NA,3.9,NA,21,-1,26,18.6,0,3,0,0,-1,2,2,2
"13756",2020-12-20,"Snodgrass","w2021","Hybrid",0,"Sun","weekend","sled","East River",NA,NA,NA,3.9,NA,21,-1,26,18.6,0,3,0,0,-1,2,2,2
"13757",2020-12-21,"Snodgrass","w2021","Non.motorized",68,"Mon","weekday","no_sled","East River",NA,NA,NA,3.9,NA,20,-1,28,19.5,-1,0,3,0,-2,-2,1,1
"13758",2020-12-21,"Snodgrass","w2021","Mechanized",1,"Mon","weekday","no_sled","East River",NA,NA,NA,3.9,NA,20,-1,28,19.5,-1,0,3,0,-2,-2,1,1
"13759",2020-12-21,"Snodgrass","w2021","Motorized",0,"Mon","weekday","sled","East River",NA,NA,NA,3.9,NA,20,-1,28,19.5,-1,0,3,0,-2,-2,1,1
"13760",2020-12-21,"Snodgrass","w2021","Hybrid",0,"Mon","weekday","sled","East River",NA,NA,NA,3.9,NA,20,-1,28,19.5,-1,0,3,0,-2,-2,1,1
"13761",2020-12-22,"Snodgrass","w2021","Non.motorized",62,"Tue","weekday","no_sled","East River",NA,NA,NA,4,NA,20,0,24,20,-1,-1,0,3,-1,-2,-2,1
"13762",2020-12-22,"Snodgrass","w2021","Mechanized",1,"Tue","weekday","no_sled","East River",NA,NA,NA,4,NA,20,0,24,20,-1,-1,0,3,-1,-2,-2,1
"13763",2020-12-22,"Snodgrass","w2021","Motorized",0,"Tue","weekday","sled","East River",NA,NA,NA,4,NA,20,0,24,20,-1,-1,0,3,-1,-2,-2,1
"13764",2020-12-22,"Snodgrass","w2021","Hybrid",0,"Tue","weekday","sled","East River",NA,NA,NA,4,NA,20,0,24,20,-1,-1,0,3,-1,-2,-2,1
"13765",2020-12-23,"Snodgrass","w2021","Non.motorized",NA,"Wed","weekday","no_sled","East River",NA,NA,NA,4.1,NA,22,2,6,18.6,0,-1,-1,0,2,1,0,0
"13766",2020-12-23,"Snodgrass","w2021","Mechanized",NA,"Wed","weekday","no_sled","East River",NA,NA,NA,4.1,NA,22,2,6,18.6,0,-1,-1,0,2,1,0,0
"13767",2020-12-23,"Snodgrass","w2021","Motorized",NA,"Wed","weekday","sled","East River",NA,NA,NA,4.1,NA,22,2,6,18.6,0,-1,-1,0,2,1,0,0
"13768",2020-12-23,"Snodgrass","w2021","Hybrid",NA,"Wed","weekday","sled","East River",NA,NA,NA,4.1,NA,22,2,6,18.6,0,-1,-1,0,2,1,0,0
"13769",2020-12-24,"Snodgrass","w2021","Non.motorized",NA,"Thu","weekday","no_sled","East River",NA,NA,NA,4.1,NA,21,-1,15,19.5,2,0,-1,-1,1,1,0,-1
"13770",2020-12-24,"Snodgrass","w2021","Mechanized",NA,"Thu","weekday","no_sled","East River",NA,NA,NA,4.1,NA,21,-1,15,19.5,2,0,-1,-1,1,1,0,-1
"13771",2020-12-24,"Snodgrass","w2021","Motorized",NA,"Thu","weekday","sled","East River",NA,NA,NA,4.1,NA,21,-1,15,19.5,2,0,-1,-1,1,1,0,-1
"13772",2020-12-24,"Snodgrass","w2021","Hybrid",NA,"Thu","weekday","sled","East River",NA,NA,NA,4.1,NA,21,-1,15,19.5,2,0,-1,-1,1,1,0,-1
"13773",2020-12-25,"Snodgrass","w2021","Non.motorized",157,"Fri","weekday","no_sled","East River",NA,NA,NA,4.1,NA,20,-1,25,20.5,-1,2,0,-1,-2,0,0,-1
"13774",2020-12-25,"Snodgrass","w2021","Mechanized",4,"Fri","weekday","no_sled","East River",NA,NA,NA,4.1,NA,20,-1,25,20.5,-1,2,0,-1,-2,0,0,-1
"13775",2020-12-25,"Snodgrass","w2021","Motorized",0,"Fri","weekday","sled","East River",NA,NA,NA,4.1,NA,20,-1,25,20.5,-1,2,0,-1,-2,0,0,-1
"13776",2020-12-25,"Snodgrass","w2021","Hybrid",0,"Fri","weekday","sled","East River",NA,NA,NA,4.1,NA,20,-1,25,20.5,-1,2,0,-1,-2,0,0,-1
"13777",2020-12-26,"Snodgrass","w2021","Non.motorized",158,"Sat","weekend","no_sled","East River",NA,NA,NA,4.1,NA,20,0,26,20.5,-1,-1,2,0,-1,-2,0,0
"13778",2020-12-26,"Snodgrass","w2021","Mechanized",3,"Sat","weekend","no_sled","East River",NA,NA,NA,4.1,NA,20,0,26,20.5,-1,-1,2,0,-1,-2,0,0
"13779",2020-12-26,"Snodgrass","w2021","Motorized",0,"Sat","weekend","sled","East River",NA,NA,NA,4.1,NA,20,0,26,20.5,-1,-1,2,0,-1,-2,0,0
"13780",2020-12-26,"Snodgrass","w2021","Hybrid",0,"Sat","weekend","sled","East River",NA,NA,NA,4.1,NA,20,0,26,20.5,-1,-1,2,0,-1,-2,0,0
"13781",2020-12-27,"Snodgrass","w2021","Non.motorized",145,"Sun","weekend","no_sled","East River",NA,NA,NA,4.2,NA,19,-1,19,22.1,0,-1,-1,2,-1,-2,-3,-1
"13782",2020-12-27,"Snodgrass","w2021","Mechanized",1,"Sun","weekend","no_sled","East River",NA,NA,NA,4.2,NA,19,-1,19,22.1,0,-1,-1,2,-1,-2,-3,-1
"13783",2020-12-27,"Snodgrass","w2021","Motorized",0,"Sun","weekend","sled","East River",NA,NA,NA,4.2,NA,19,-1,19,22.1,0,-1,-1,2,-1,-2,-3,-1
"13784",2020-12-27,"Snodgrass","w2021","Hybrid",0,"Sun","weekend","sled","East River",NA,NA,NA,4.2,NA,19,-1,19,22.1,0,-1,-1,2,-1,-2,-3,-1
"13785",2020-12-28,"Snodgrass","w2021","Non.motorized",98,"Mon","weekday","no_sled","East River",NA,NA,NA,4.2,NA,20,1,22,21,-1,0,-1,-1,0,0,-1,-2
"13786",2020-12-28,"Snodgrass","w2021","Mechanized",0,"Mon","weekday","no_sled","East River",NA,NA,NA,4.2,NA,20,1,22,21,-1,0,-1,-1,0,0,-1,-2
"13787",2020-12-28,"Snodgrass","w2021","Motorized",0,"Mon","weekday","sled","East River",NA,NA,NA,4.2,NA,20,1,22,21,-1,0,-1,-1,0,0,-1,-2
"13788",2020-12-28,"Snodgrass","w2021","Hybrid",0,"Mon","weekday","sled","East River",NA,NA,NA,4.2,NA,20,1,22,21,-1,0,-1,-1,0,0,-1,-2
"13789",2020-12-29,"Snodgrass","w2021","Non.motorized",107,"Tue","weekday","no_sled","East River",NA,NA,NA,4.9,NA,27,7,15,18.1,1,-1,0,-1,8,7,7,6
"13790",2020-12-29,"Snodgrass","w2021","Mechanized",0,"Tue","weekday","no_sled","East River",NA,NA,NA,4.9,NA,27,7,15,18.1,1,-1,0,-1,8,7,7,6
"13791",2020-12-29,"Snodgrass","w2021","Motorized",0,"Tue","weekday","sled","East River",NA,NA,NA,4.9,NA,27,7,15,18.1,1,-1,0,-1,8,7,7,6
"13792",2020-12-29,"Snodgrass","w2021","Hybrid",0,"Tue","weekday","sled","East River",NA,NA,NA,4.9,NA,27,7,15,18.1,1,-1,0,-1,8,7,7,6
"13793",2020-12-30,"Snodgrass","w2021","Non.motorized",147,"Wed","weekday","no_sled","East River",NA,NA,NA,4.9,NA,26,-1,10,18.8,7,1,-1,0,6,7,6,6
"13794",2020-12-30,"Snodgrass","w2021","Mechanized",2,"Wed","weekday","no_sled","East River",NA,NA,NA,4.9,NA,26,-1,10,18.8,7,1,-1,0,6,7,6,6
"13795",2020-12-30,"Snodgrass","w2021","Motorized",1,"Wed","weekday","sled","East River",NA,NA,NA,4.9,NA,26,-1,10,18.8,7,1,-1,0,6,7,6,6
"13796",2020-12-30,"Snodgrass","w2021","Hybrid",0,"Wed","weekday","sled","East River",NA,NA,NA,4.9,NA,26,-1,10,18.8,7,1,-1,0,6,7,6,6
"13797",2020-12-31,"Snodgrass","w2021","Non.motorized",235,"Thu","weekday","no_sled","East River",NA,NA,NA,4.9,NA,25,-1,19,19.6,-1,7,1,-1,-2,5,6,5
"13798",2020-12-31,"Snodgrass","w2021","Mechanized",2,"Thu","weekday","no_sled","East River",NA,NA,NA,4.9,NA,25,-1,19,19.6,-1,7,1,-1,-2,5,6,5
"13799",2020-12-31,"Snodgrass","w2021","Motorized",0,"Thu","weekday","sled","East River",NA,NA,NA,4.9,NA,25,-1,19,19.6,-1,7,1,-1,-2,5,6,5
"13800",2020-12-31,"Snodgrass","w2021","Hybrid",0,"Thu","weekday","sled","East River",NA,NA,NA,4.9,NA,25,-1,19,19.6,-1,7,1,-1,-2,5,6,5
"13801",2021-01-01,"Snodgrass","w2021","Non.motorized",209,"Fri","weekday","no_sled","East River",NA,NA,NA,4.9,NA,24,-1,21,20.4,-1,-1,7,1,-2,-3,4,5
"13802",2021-01-01,"Snodgrass","w2021","Mechanized",1,"Fri","weekday","no_sled","East River",NA,NA,NA,4.9,NA,24,-1,21,20.4,-1,-1,7,1,-2,-3,4,5
"13803",2021-01-01,"Snodgrass","w2021","Motorized",0,"Fri","weekday","sled","East River",NA,NA,NA,4.9,NA,24,-1,21,20.4,-1,-1,7,1,-2,-3,4,5
"13804",2021-01-01,"Snodgrass","w2021","Hybrid",0,"Fri","weekday","sled","East River",NA,NA,NA,4.9,NA,24,-1,21,20.4,-1,-1,7,1,-2,-3,4,5
"13805",2021-01-02,"Snodgrass","w2021","Non.motorized",167,"Sat","weekend","no_sled","East River",NA,NA,NA,4.9,NA,23,-1,19,21.3,-1,-1,-1,7,-2,-3,-4,3
"13806",2021-01-02,"Snodgrass","w2021","Mechanized",0,"Sat","weekend","no_sled","East River",NA,NA,NA,4.9,NA,23,-1,19,21.3,-1,-1,-1,7,-2,-3,-4,3
"13807",2021-01-02,"Snodgrass","w2021","Motorized",0,"Sat","weekend","sled","East River",NA,NA,NA,4.9,NA,23,-1,19,21.3,-1,-1,-1,7,-2,-3,-4,3
"13808",2021-01-02,"Snodgrass","w2021","Hybrid",0,"Sat","weekend","sled","East River",NA,NA,NA,4.9,NA,23,-1,19,21.3,-1,-1,-1,7,-2,-3,-4,3
"13809",2021-01-03,"Snodgrass","w2021","Non.motorized",149,"Sun","weekend","no_sled","East River",NA,NA,NA,4.9,NA,23,0,21,21.3,-1,-1,-1,-1,-1,-2,-3,-4
"13810",2021-01-03,"Snodgrass","w2021","Mechanized",0,"Sun","weekend","no_sled","East River",NA,NA,NA,4.9,NA,23,0,21,21.3,-1,-1,-1,-1,-1,-2,-3,-4
"13811",2021-01-03,"Snodgrass","w2021","Motorized",0,"Sun","weekend","sled","East River",NA,NA,NA,4.9,NA,23,0,21,21.3,-1,-1,-1,-1,-1,-2,-3,-4
"13812",2021-01-03,"Snodgrass","w2021","Hybrid",0,"Sun","weekend","sled","East River",NA,NA,NA,4.9,NA,23,0,21,21.3,-1,-1,-1,-1,-1,-2,-3,-4
"13813",2021-01-04,"Snodgrass","w2021","Non.motorized",71,"Mon","weekday","no_sled","East River",NA,NA,NA,4.9,NA,22,-1,25,22.3,0,-1,-1,-1,-1,-2,-3,-4
"13814",2021-01-04,"Snodgrass","w2021","Mechanized",1,"Mon","weekday","no_sled","East River",NA,NA,NA,4.9,NA,22,-1,25,22.3,0,-1,-1,-1,-1,-2,-3,-4
"13815",2021-01-04,"Snodgrass","w2021","Motorized",0,"Mon","weekday","sled","East River",NA,NA,NA,4.9,NA,22,-1,25,22.3,0,-1,-1,-1,-1,-2,-3,-4
"13816",2021-01-04,"Snodgrass","w2021","Hybrid",0,"Mon","weekday","sled","East River",NA,NA,NA,4.9,NA,22,-1,25,22.3,0,-1,-1,-1,-1,-2,-3,-4
"13817",2021-01-05,"Snodgrass","w2021","Non.motorized",NA,"Tue","weekday","no_sled","East River",NA,NA,NA,5,NA,22,0,23,22.7,-1,0,-1,-1,-1,-1,-2,-3
"13818",2021-01-05,"Snodgrass","w2021","Mechanized",NA,"Tue","weekday","no_sled","East River",NA,NA,NA,5,NA,22,0,23,22.7,-1,0,-1,-1,-1,-1,-2,-3
"13819",2021-01-05,"Snodgrass","w2021","Motorized",NA,"Tue","weekday","sled","East River",NA,NA,NA,5,NA,22,0,23,22.7,-1,0,-1,-1,-1,-1,-2,-3
"13820",2021-01-05,"Snodgrass","w2021","Hybrid",NA,"Tue","weekday","sled","East River",NA,NA,NA,5,NA,22,0,23,22.7,-1,0,-1,-1,-1,-1,-2,-3
"13821",2021-01-06,"Snodgrass","w2021","Non.motorized",57,"Wed","weekday","no_sled","East River",NA,NA,NA,5.1,NA,24,2,18,21.2,0,-1,0,-1,2,1,1,0
"13822",2021-01-06,"Snodgrass","w2021","Mechanized",0,"Wed","weekday","no_sled","East River",NA,NA,NA,5.1,NA,24,2,18,21.2,0,-1,0,-1,2,1,1,0
"13823",2021-01-06,"Snodgrass","w2021","Motorized",2,"Wed","weekday","sled","East River",NA,NA,NA,5.1,NA,24,2,18,21.2,0,-1,0,-1,2,1,1,0
"13824",2021-01-06,"Snodgrass","w2021","Hybrid",0,"Wed","weekday","sled","East River",NA,NA,NA,5.1,NA,24,2,18,21.2,0,-1,0,-1,2,1,1,0
"13825",2021-01-07,"Snodgrass","w2021","Non.motorized",93,"Thu","weekday","no_sled","East River",NA,NA,NA,5.1,NA,24,0,23,21.2,2,0,-1,0,2,2,1,1
"13826",2021-01-07,"Snodgrass","w2021","Mechanized",3,"Thu","weekday","no_sled","East River",NA,NA,NA,5.1,NA,24,0,23,21.2,2,0,-1,0,2,2,1,1
"13827",2021-01-07,"Snodgrass","w2021","Motorized",0,"Thu","weekday","sled","East River",NA,NA,NA,5.1,NA,24,0,23,21.2,2,0,-1,0,2,2,1,1
"13828",2021-01-07,"Snodgrass","w2021","Hybrid",0,"Thu","weekday","sled","East River",NA,NA,NA,5.1,NA,24,0,23,21.2,2,0,-1,0,2,2,1,1
"13829",2021-01-08,"Snodgrass","w2021","Non.motorized",52,"Fri","weekday","no_sled","East River",NA,NA,NA,5.1,NA,23,-1,20,22.2,0,2,0,-1,-1,1,1,0
"13830",2021-01-08,"Snodgrass","w2021","Mechanized",0,"Fri","weekday","no_sled","East River",NA,NA,NA,5.1,NA,23,-1,20,22.2,0,2,0,-1,-1,1,1,0
"13831",2021-01-08,"Snodgrass","w2021","Motorized",0,"Fri","weekday","sled","East River",NA,NA,NA,5.1,NA,23,-1,20,22.2,0,2,0,-1,-1,1,1,0
"13832",2021-01-08,"Snodgrass","w2021","Hybrid",0,"Fri","weekday","sled","East River",NA,NA,NA,5.1,NA,23,-1,20,22.2,0,2,0,-1,-1,1,1,0
"13833",2021-01-09,"Snodgrass","w2021","Non.motorized",141,"Sat","weekend","no_sled","East River",NA,NA,NA,5.1,NA,23,0,19,22.2,-1,0,2,0,-1,-1,1,1
"13834",2021-01-09,"Snodgrass","w2021","Mechanized",2,"Sat","weekend","no_sled","East River",NA,NA,NA,5.1,NA,23,0,19,22.2,-1,0,2,0,-1,-1,1,1
"13835",2021-01-09,"Snodgrass","w2021","Motorized",0,"Sat","weekend","sled","East River",NA,NA,NA,5.1,NA,23,0,19,22.2,-1,0,2,0,-1,-1,1,1
"13836",2021-01-09,"Snodgrass","w2021","Hybrid",0,"Sat","weekend","sled","East River",NA,NA,NA,5.1,NA,23,0,19,22.2,-1,0,2,0,-1,-1,1,1
"13837",2021-01-10,"Snodgrass","w2021","Non.motorized",156,"Sun","weekend","no_sled","East River",NA,NA,NA,5.1,NA,23,0,14,22.2,0,-1,0,2,0,-1,-1,1
"13838",2021-01-10,"Snodgrass","w2021","Mechanized",2,"Sun","weekend","no_sled","East River",NA,NA,NA,5.1,NA,23,0,14,22.2,0,-1,0,2,0,-1,-1,1
"13839",2021-01-10,"Snodgrass","w2021","Motorized",0,"Sun","weekend","sled","East River",NA,NA,NA,5.1,NA,23,0,14,22.2,0,-1,0,2,0,-1,-1,1
"13840",2021-01-10,"Snodgrass","w2021","Hybrid",0,"Sun","weekend","sled","East River",NA,NA,NA,5.1,NA,23,0,14,22.2,0,-1,0,2,0,-1,-1,1
"13841",2021-01-11,"Snodgrass","w2021","Non.motorized",87,"Mon","weekday","no_sled","East River",NA,NA,NA,5.1,NA,23,0,15,22.2,0,0,-1,0,0,0,-1,-1
"13842",2021-01-11,"Snodgrass","w2021","Mechanized",7,"Mon","weekday","no_sled","East River",NA,NA,NA,5.1,NA,23,0,15,22.2,0,0,-1,0,0,0,-1,-1
"13843",2021-01-11,"Snodgrass","w2021","Motorized",1,"Mon","weekday","sled","East River",NA,NA,NA,5.1,NA,23,0,15,22.2,0,0,-1,0,0,0,-1,-1
"13844",2021-01-11,"Snodgrass","w2021","Hybrid",0,"Mon","weekday","sled","East River",NA,NA,NA,5.1,NA,23,0,15,22.2,0,0,-1,0,0,0,-1,-1
"13845",2021-01-12,"Snodgrass","w2021","Non.motorized",62,"Tue","weekday","no_sled","East River",NA,NA,NA,5.1,NA,23,0,23,22.2,0,0,0,-1,0,0,0,-1
"13846",2021-01-12,"Snodgrass","w2021","Mechanized",1,"Tue","weekday","no_sled","East River",NA,NA,NA,5.1,NA,23,0,23,22.2,0,0,0,-1,0,0,0,-1
"13847",2021-01-12,"Snodgrass","w2021","Motorized",0,"Tue","weekday","sled","East River",NA,NA,NA,5.1,NA,23,0,23,22.2,0,0,0,-1,0,0,0,-1
"13848",2021-01-12,"Snodgrass","w2021","Hybrid",0,"Tue","weekday","sled","East River",NA,NA,NA,5.1,NA,23,0,23,22.2,0,0,0,-1,0,0,0,-1
"13849",2021-01-13,"Snodgrass","w2021","Non.motorized",57,"Wed","weekday","no_sled","East River",NA,NA,NA,5.1,NA,23,0,28,22.2,0,0,0,0,0,0,0,0
"13850",2021-01-13,"Snodgrass","w2021","Mechanized",4,"Wed","weekday","no_sled","East River",NA,NA,NA,5.1,NA,23,0,28,22.2,0,0,0,0,0,0,0,0
"13851",2021-01-13,"Snodgrass","w2021","Motorized",0,"Wed","weekday","sled","East River",NA,NA,NA,5.1,NA,23,0,28,22.2,0,0,0,0,0,0,0,0
"13852",2021-01-13,"Snodgrass","w2021","Hybrid",0,"Wed","weekday","sled","East River",NA,NA,NA,5.1,NA,23,0,28,22.2,0,0,0,0,0,0,0,0
"13853",2021-01-14,"Snodgrass","w2021","Non.motorized",80,"Thu","weekday","no_sled","East River",NA,NA,NA,5.1,NA,22,-1,20,23.2,0,0,0,0,-1,-1,-1,-1
"13854",2021-01-14,"Snodgrass","w2021","Mechanized",0,"Thu","weekday","no_sled","East River",NA,NA,NA,5.1,NA,22,-1,20,23.2,0,0,0,0,-1,-1,-1,-1
"13855",2021-01-14,"Snodgrass","w2021","Motorized",0,"Thu","weekday","sled","East River",NA,NA,NA,5.1,NA,22,-1,20,23.2,0,0,0,0,-1,-1,-1,-1
"13856",2021-01-14,"Snodgrass","w2021","Hybrid",0,"Thu","weekday","sled","East River",NA,NA,NA,5.1,NA,22,-1,20,23.2,0,0,0,0,-1,-1,-1,-1
"13857",2021-01-15,"Snodgrass","w2021","Non.motorized",103,"Fri","weekday","no_sled","East River",NA,NA,NA,5.1,NA,22,0,26,23.2,-1,0,0,0,-1,-1,-1,-1
"13858",2021-01-15,"Snodgrass","w2021","Mechanized",1,"Fri","weekday","no_sled","East River",NA,NA,NA,5.1,NA,22,0,26,23.2,-1,0,0,0,-1,-1,-1,-1
"13859",2021-01-15,"Snodgrass","w2021","Motorized",0,"Fri","weekday","sled","East River",NA,NA,NA,5.1,NA,22,0,26,23.2,-1,0,0,0,-1,-1,-1,-1
"13860",2021-01-15,"Snodgrass","w2021","Hybrid",0,"Fri","weekday","sled","East River",NA,NA,NA,5.1,NA,22,0,26,23.2,-1,0,0,0,-1,-1,-1,-1
"13861",2021-01-16,"Snodgrass","w2021","Non.motorized",150,"Sat","weekend","no_sled","East River",NA,NA,NA,5.1,NA,22,0,26,23.2,0,-1,0,0,0,-1,-1,-1
"13862",2021-01-16,"Snodgrass","w2021","Mechanized",4,"Sat","weekend","no_sled","East River",NA,NA,NA,5.1,NA,22,0,26,23.2,0,-1,0,0,0,-1,-1,-1
"13863",2021-01-16,"Snodgrass","w2021","Motorized",0,"Sat","weekend","sled","East River",NA,NA,NA,5.1,NA,22,0,26,23.2,0,-1,0,0,0,-1,-1,-1
"13864",2021-01-16,"Snodgrass","w2021","Hybrid",0,"Sat","weekend","sled","East River",NA,NA,NA,5.1,NA,22,0,26,23.2,0,-1,0,0,0,-1,-1,-1
"13865",2021-01-17,"Snodgrass","w2021","Non.motorized",156,"Sun","weekend","no_sled","East River",NA,NA,NA,5.1,NA,22,0,29,23.2,0,0,-1,0,0,0,-1,-1
"13866",2021-01-17,"Snodgrass","w2021","Mechanized",0,"Sun","weekend","no_sled","East River",NA,NA,NA,5.1,NA,22,0,29,23.2,0,0,-1,0,0,0,-1,-1
"13867",2021-01-17,"Snodgrass","w2021","Motorized",0,"Sun","weekend","sled","East River",NA,NA,NA,5.1,NA,22,0,29,23.2,0,0,-1,0,0,0,-1,-1
"13868",2021-01-17,"Snodgrass","w2021","Hybrid",0,"Sun","weekend","sled","East River",NA,NA,NA,5.1,NA,22,0,29,23.2,0,0,-1,0,0,0,-1,-1
"13869",2021-01-18,"Snodgrass","w2021","Non.motorized",102,"Mon","weekday","no_sled","East River",NA,NA,NA,5.1,NA,22,0,24,23.2,0,0,0,-1,0,0,0,-1
"13870",2021-01-18,"Snodgrass","w2021","Mechanized",1,"Mon","weekday","no_sled","East River",NA,NA,NA,5.1,NA,22,0,24,23.2,0,0,0,-1,0,0,0,-1
"13871",2021-01-18,"Snodgrass","w2021","Motorized",0,"Mon","weekday","sled","East River",NA,NA,NA,5.1,NA,22,0,24,23.2,0,0,0,-1,0,0,0,-1
"13872",2021-01-18,"Snodgrass","w2021","Hybrid",0,"Mon","weekday","sled","East River",NA,NA,NA,5.1,NA,22,0,24,23.2,0,0,0,-1,0,0,0,-1
"13873",2021-01-19,"Snodgrass","w2021","Non.motorized",58,"Tue","weekday","no_sled","East River",NA,NA,NA,5.1,NA,22,0,19,23.2,0,0,0,0,0,0,0,0
"13874",2021-01-19,"Snodgrass","w2021","Mechanized",0,"Tue","weekday","no_sled","East River",NA,NA,NA,5.1,NA,22,0,19,23.2,0,0,0,0,0,0,0,0
"13875",2021-01-19,"Snodgrass","w2021","Motorized",0,"Tue","weekday","sled","East River",NA,NA,NA,5.1,NA,22,0,19,23.2,0,0,0,0,0,0,0,0
"13876",2021-01-19,"Snodgrass","w2021","Hybrid",0,"Tue","weekday","sled","East River",NA,NA,NA,5.1,NA,22,0,19,23.2,0,0,0,0,0,0,0,0
"13877",2021-01-20,"Snodgrass","w2021","Non.motorized",59,"Wed","weekday","no_sled","East River",NA,NA,NA,5.2,NA,23,1,26,22.6,0,0,0,0,1,1,1,1
"13878",2021-01-20,"Snodgrass","w2021","Mechanized",0,"Wed","weekday","no_sled","East River",NA,NA,NA,5.2,NA,23,1,26,22.6,0,0,0,0,1,1,1,1
"13879",2021-01-20,"Snodgrass","w2021","Motorized",0,"Wed","weekday","sled","East River",NA,NA,NA,5.2,NA,23,1,26,22.6,0,0,0,0,1,1,1,1
"13880",2021-01-20,"Snodgrass","w2021","Hybrid",0,"Wed","weekday","sled","East River",NA,NA,NA,5.2,NA,23,1,26,22.6,0,0,0,0,1,1,1,1
"13881",2021-01-21,"Snodgrass","w2021","Non.motorized",67,"Thu","weekday","no_sled","East River",NA,NA,NA,5.2,NA,23,0,26,22.6,1,0,0,0,1,1,1,1
"13882",2021-01-21,"Snodgrass","w2021","Mechanized",2,"Thu","weekday","no_sled","East River",NA,NA,NA,5.2,NA,23,0,26,22.6,1,0,0,0,1,1,1,1
"13883",2021-01-21,"Snodgrass","w2021","Motorized",0,"Thu","weekday","sled","East River",NA,NA,NA,5.2,NA,23,0,26,22.6,1,0,0,0,1,1,1,1
"13884",2021-01-21,"Snodgrass","w2021","Hybrid",0,"Thu","weekday","sled","East River",NA,NA,NA,5.2,NA,23,0,26,22.6,1,0,0,0,1,1,1,1
"13885",2021-01-22,"Snodgrass","w2021","Non.motorized",84,"Fri","weekday","no_sled","East River",NA,NA,NA,5.3,NA,25,2,25,21.2,0,1,0,0,2,3,3,3
"13886",2021-01-22,"Snodgrass","w2021","Mechanized",1,"Fri","weekday","no_sled","East River",NA,NA,NA,5.3,NA,25,2,25,21.2,0,1,0,0,2,3,3,3
"13887",2021-01-22,"Snodgrass","w2021","Motorized",0,"Fri","weekday","sled","East River",NA,NA,NA,5.3,NA,25,2,25,21.2,0,1,0,0,2,3,3,3
"13888",2021-01-22,"Snodgrass","w2021","Hybrid",0,"Fri","weekday","sled","East River",NA,NA,NA,5.3,NA,25,2,25,21.2,0,1,0,0,2,3,3,3
"13889",2021-01-23,"Snodgrass","w2021","Non.motorized",116,"Sat","weekend","no_sled","East River",NA,NA,NA,5.4,NA,26,1,22,20.8,2,0,1,0,3,3,4,4
"13890",2021-01-23,"Snodgrass","w2021","Mechanized",0,"Sat","weekend","no_sled","East River",NA,NA,NA,5.4,NA,26,1,22,20.8,2,0,1,0,3,3,4,4
"13891",2021-01-23,"Snodgrass","w2021","Motorized",0,"Sat","weekend","sled","East River",NA,NA,NA,5.4,NA,26,1,22,20.8,2,0,1,0,3,3,4,4
"13892",2021-01-23,"Snodgrass","w2021","Hybrid",0,"Sat","weekend","sled","East River",NA,NA,NA,5.4,NA,26,1,22,20.8,2,0,1,0,3,3,4,4
"13893",2021-01-24,"Snodgrass","w2021","Non.motorized",100,"Sun","weekend","no_sled","East River",NA,NA,NA,5.6,NA,29,3,18,19.3,1,2,0,1,4,6,6,7
"13894",2021-01-24,"Snodgrass","w2021","Mechanized",0,"Sun","weekend","no_sled","East River",NA,NA,NA,5.6,NA,29,3,18,19.3,1,2,0,1,4,6,6,7
"13895",2021-01-24,"Snodgrass","w2021","Motorized",0,"Sun","weekend","sled","East River",NA,NA,NA,5.6,NA,29,3,18,19.3,1,2,0,1,4,6,6,7
"13896",2021-01-24,"Snodgrass","w2021","Hybrid",0,"Sun","weekend","sled","East River",NA,NA,NA,5.6,NA,29,3,18,19.3,1,2,0,1,4,6,6,7
"13897",2021-01-25,"Snodgrass","w2021","Non.motorized",60,"Mon","weekday","no_sled","East River",NA,NA,NA,5.8,NA,29,0,15,20,3,1,2,0,3,4,6,6
"13898",2021-01-25,"Snodgrass","w2021","Mechanized",0,"Mon","weekday","no_sled","East River",NA,NA,NA,5.8,NA,29,0,15,20,3,1,2,0,3,4,6,6
"13899",2021-01-25,"Snodgrass","w2021","Motorized",0,"Mon","weekday","sled","East River",NA,NA,NA,5.8,NA,29,0,15,20,3,1,2,0,3,4,6,6
"13900",2021-01-25,"Snodgrass","w2021","Hybrid",0,"Mon","weekday","sled","East River",NA,NA,NA,5.8,NA,29,0,15,20,3,1,2,0,3,4,6,6
"13901",2021-01-26,"Snodgrass","w2021","Non.motorized",50,"Tue","weekday","no_sled","East River",NA,NA,NA,5.9,NA,29,0,13,20.3,0,3,1,2,0,3,4,6
"13902",2021-01-26,"Snodgrass","w2021","Mechanized",0,"Tue","weekday","no_sled","East River",NA,NA,NA,5.9,NA,29,0,13,20.3,0,3,1,2,0,3,4,6
"13903",2021-01-26,"Snodgrass","w2021","Motorized",0,"Tue","weekday","sled","East River",NA,NA,NA,5.9,NA,29,0,13,20.3,0,3,1,2,0,3,4,6
"13904",2021-01-26,"Snodgrass","w2021","Hybrid",0,"Tue","weekday","sled","East River",NA,NA,NA,5.9,NA,29,0,13,20.3,0,3,1,2,0,3,4,6
"13905",2021-01-27,"Snodgrass","w2021","Non.motorized",42,"Wed","weekday","no_sled","East River",NA,NA,NA,6,NA,30,1,13,20,0,0,3,1,1,1,4,5
"13906",2021-01-27,"Snodgrass","w2021","Mechanized",0,"Wed","weekday","no_sled","East River",NA,NA,NA,6,NA,30,1,13,20,0,0,3,1,1,1,4,5
"13907",2021-01-27,"Snodgrass","w2021","Motorized",2,"Wed","weekday","sled","East River",NA,NA,NA,6,NA,30,1,13,20,0,0,3,1,1,1,4,5
"13908",2021-01-27,"Snodgrass","w2021","Hybrid",2,"Wed","weekday","sled","East River",NA,NA,NA,6,NA,30,1,13,20,0,0,3,1,1,1,4,5
"13909",2021-01-28,"Snodgrass","w2021","Non.motorized",75,"Thu","weekday","no_sled","East River",NA,NA,NA,6,NA,28,-2,27,21.4,1,0,0,3,-1,-1,-1,2
"13910",2021-01-28,"Snodgrass","w2021","Mechanized",2,"Thu","weekday","no_sled","East River",NA,NA,NA,6,NA,28,-2,27,21.4,1,0,0,3,-1,-1,-1,2
"13911",2021-01-28,"Snodgrass","w2021","Motorized",0,"Thu","weekday","sled","East River",NA,NA,NA,6,NA,28,-2,27,21.4,1,0,0,3,-1,-1,-1,2
"13912",2021-01-28,"Snodgrass","w2021","Hybrid",0,"Thu","weekday","sled","East River",NA,NA,NA,6,NA,28,-2,27,21.4,1,0,0,3,-1,-1,-1,2
"13913",2021-01-29,"Snodgrass","w2021","Non.motorized",100,"Fri","weekday","no_sled","East River",NA,NA,NA,6.1,NA,28,0,29,21.8,-2,1,0,0,-2,-1,-1,-1
"13914",2021-01-29,"Snodgrass","w2021","Mechanized",6,"Fri","weekday","no_sled","East River",NA,NA,NA,6.1,NA,28,0,29,21.8,-2,1,0,0,-2,-1,-1,-1
"13915",2021-01-29,"Snodgrass","w2021","Motorized",0,"Fri","weekday","sled","East River",NA,NA,NA,6.1,NA,28,0,29,21.8,-2,1,0,0,-2,-1,-1,-1
"13916",2021-01-29,"Snodgrass","w2021","Hybrid",0,"Fri","weekday","sled","East River",NA,NA,NA,6.1,NA,28,0,29,21.8,-2,1,0,0,-2,-1,-1,-1
"13917",2021-01-30,"Snodgrass","w2021","Non.motorized",78,"Sat","weekend","no_sled","East River",NA,NA,NA,6.2,NA,29,1,21,21.4,0,-2,1,0,1,-1,0,0
"13918",2021-01-30,"Snodgrass","w2021","Mechanized",0,"Sat","weekend","no_sled","East River",NA,NA,NA,6.2,NA,29,1,21,21.4,0,-2,1,0,1,-1,0,0
"13919",2021-01-30,"Snodgrass","w2021","Motorized",0,"Sat","weekend","sled","East River",NA,NA,NA,6.2,NA,29,1,21,21.4,0,-2,1,0,1,-1,0,0
"13920",2021-01-30,"Snodgrass","w2021","Hybrid",0,"Sat","weekend","sled","East River",NA,NA,NA,6.2,NA,29,1,21,21.4,0,-2,1,0,1,-1,0,0
"13921",2021-01-31,"Snodgrass","w2021","Non.motorized",86,"Sun","weekend","no_sled","East River",NA,NA,NA,6.3,NA,29,0,21,21.7,1,0,-2,1,1,1,-1,0
"13922",2021-01-31,"Snodgrass","w2021","Mechanized",2,"Sun","weekend","no_sled","East River",NA,NA,NA,6.3,NA,29,0,21,21.7,1,0,-2,1,1,1,-1,0
"13923",2021-01-31,"Snodgrass","w2021","Motorized",0,"Sun","weekend","sled","East River",NA,NA,NA,6.3,NA,29,0,21,21.7,1,0,-2,1,1,1,-1,0
"13924",2021-01-31,"Snodgrass","w2021","Hybrid",0,"Sun","weekend","sled","East River",NA,NA,NA,6.3,NA,29,0,21,21.7,1,0,-2,1,1,1,-1,0
"13925",2021-02-01,"Snodgrass","w2021","Non.motorized",63,"Mon","weekday","no_sled","East River",NA,NA,NA,6.3,NA,28,-1,30,22.5,0,1,0,-2,-1,0,0,-2
"13926",2021-02-01,"Snodgrass","w2021","Mechanized",2,"Mon","weekday","no_sled","East River",NA,NA,NA,6.3,NA,28,-1,30,22.5,0,1,0,-2,-1,0,0,-2
"13927",2021-02-01,"Snodgrass","w2021","Motorized",0,"Mon","weekday","sled","East River",NA,NA,NA,6.3,NA,28,-1,30,22.5,0,1,0,-2,-1,0,0,-2
"13928",2021-02-01,"Snodgrass","w2021","Hybrid",0,"Mon","weekday","sled","East River",NA,NA,NA,6.3,NA,28,-1,30,22.5,0,1,0,-2,-1,0,0,-2
"13929",2021-02-02,"Snodgrass","w2021","Non.motorized",65,"Tue","weekday","no_sled","East River",NA,NA,NA,6.3,NA,28,0,34,22.5,-1,0,1,0,-1,-1,0,0
"13930",2021-02-02,"Snodgrass","w2021","Mechanized",6,"Tue","weekday","no_sled","East River",NA,NA,NA,6.3,NA,28,0,34,22.5,-1,0,1,0,-1,-1,0,0
"13931",2021-02-02,"Snodgrass","w2021","Motorized",0,"Tue","weekday","sled","East River",NA,NA,NA,6.3,NA,28,0,34,22.5,-1,0,1,0,-1,-1,0,0
"13932",2021-02-02,"Snodgrass","w2021","Hybrid",0,"Tue","weekday","sled","East River",NA,NA,NA,6.3,NA,28,0,34,22.5,-1,0,1,0,-1,-1,0,0
"13933",2021-02-03,"Snodgrass","w2021","Non.motorized",42,"Wed","weekday","no_sled","East River",NA,NA,NA,6.3,NA,27,-1,30,23.3,0,-1,0,1,-1,-2,-2,-1
"13934",2021-02-03,"Snodgrass","w2021","Mechanized",0,"Wed","weekday","no_sled","East River",NA,NA,NA,6.3,NA,27,-1,30,23.3,0,-1,0,1,-1,-2,-2,-1
"13935",2021-02-03,"Snodgrass","w2021","Motorized",0,"Wed","weekday","sled","East River",NA,NA,NA,6.3,NA,27,-1,30,23.3,0,-1,0,1,-1,-2,-2,-1
"13936",2021-02-03,"Snodgrass","w2021","Hybrid",0,"Wed","weekday","sled","East River",NA,NA,NA,6.3,NA,27,-1,30,23.3,0,-1,0,1,-1,-2,-2,-1
"13937",2021-02-04,"Snodgrass","w2021","Non.motorized",64,"Thu","weekday","no_sled","East River",NA,NA,NA,7.2,NA,37,10,14,19.5,-1,0,-1,0,9,9,8,8
"13938",2021-02-04,"Snodgrass","w2021","Mechanized",0,"Thu","weekday","no_sled","East River",NA,NA,NA,7.2,NA,37,10,14,19.5,-1,0,-1,0,9,9,8,8
"13939",2021-02-04,"Snodgrass","w2021","Motorized",0,"Thu","weekday","sled","East River",NA,NA,NA,7.2,NA,37,10,14,19.5,-1,0,-1,0,9,9,8,8
"13940",2021-02-04,"Snodgrass","w2021","Hybrid",0,"Thu","weekday","sled","East River",NA,NA,NA,7.2,NA,37,10,14,19.5,-1,0,-1,0,9,9,8,8
"13941",2021-02-05,"Snodgrass","w2021","Non.motorized",59,"Fri","weekday","no_sled","East River",NA,NA,NA,7.2,NA,35,-2,16,20.6,10,-1,0,-1,8,7,7,6
"13942",2021-02-05,"Snodgrass","w2021","Mechanized",0,"Fri","weekday","no_sled","East River",NA,NA,NA,7.2,NA,35,-2,16,20.6,10,-1,0,-1,8,7,7,6
"13943",2021-02-05,"Snodgrass","w2021","Motorized",0,"Fri","weekday","sled","East River",NA,NA,NA,7.2,NA,35,-2,16,20.6,10,-1,0,-1,8,7,7,6
"13944",2021-02-05,"Snodgrass","w2021","Hybrid",0,"Fri","weekday","sled","East River",NA,NA,NA,7.2,NA,35,-2,16,20.6,10,-1,0,-1,8,7,7,6
"13945",2021-02-06,"Snodgrass","w2021","Non.motorized",89,"Sat","weekend","no_sled","East River",NA,NA,NA,7.5,NA,37,2,19,20.3,-2,10,-1,0,0,10,9,9
"13946",2021-02-06,"Snodgrass","w2021","Mechanized",2,"Sat","weekend","no_sled","East River",NA,NA,NA,7.5,NA,37,2,19,20.3,-2,10,-1,0,0,10,9,9
"13947",2021-02-06,"Snodgrass","w2021","Motorized",0,"Sat","weekend","sled","East River",NA,NA,NA,7.5,NA,37,2,19,20.3,-2,10,-1,0,0,10,9,9
"13948",2021-02-06,"Snodgrass","w2021","Hybrid",0,"Sat","weekend","sled","East River",NA,NA,NA,7.5,NA,37,2,19,20.3,-2,10,-1,0,0,10,9,9
"13949",2021-02-07,"Snodgrass","w2021","Non.motorized",122,"Sun","weekend","no_sled","East River",NA,NA,NA,7.5,NA,36,-1,24,20.8,2,-2,10,-1,1,-1,9,8
"13950",2021-02-07,"Snodgrass","w2021","Mechanized",0,"Sun","weekend","no_sled","East River",NA,NA,NA,7.5,NA,36,-1,24,20.8,2,-2,10,-1,1,-1,9,8
"13951",2021-02-07,"Snodgrass","w2021","Motorized",0,"Sun","weekend","sled","East River",NA,NA,NA,7.5,NA,36,-1,24,20.8,2,-2,10,-1,1,-1,9,8
"13952",2021-02-07,"Snodgrass","w2021","Hybrid",0,"Sun","weekend","sled","East River",NA,NA,NA,7.5,NA,36,-1,24,20.8,2,-2,10,-1,1,-1,9,8
"13953",2021-02-08,"Snodgrass","w2021","Non.motorized",63,"Mon","weekday","no_sled","East River",NA,NA,NA,7.6,NA,35,-1,28,21.7,-1,2,-2,10,-2,0,-2,8
"13954",2021-02-08,"Snodgrass","w2021","Mechanized",1,"Mon","weekday","no_sled","East River",NA,NA,NA,7.6,NA,35,-1,28,21.7,-1,2,-2,10,-2,0,-2,8
"13955",2021-02-08,"Snodgrass","w2021","Motorized",0,"Mon","weekday","sled","East River",NA,NA,NA,7.6,NA,35,-1,28,21.7,-1,2,-2,10,-2,0,-2,8
"13956",2021-02-08,"Snodgrass","w2021","Hybrid",0,"Mon","weekday","sled","East River",NA,NA,NA,7.6,NA,35,-1,28,21.7,-1,2,-2,10,-2,0,-2,8
"13957",2021-02-09,"Snodgrass","w2021","Non.motorized",67,"Tue","weekday","no_sled","East River",NA,NA,NA,7.6,NA,34,-1,28,22.4,-1,-1,2,-2,-2,-3,-1,-3
"13958",2021-02-09,"Snodgrass","w2021","Mechanized",0,"Tue","weekday","no_sled","East River",NA,NA,NA,7.6,NA,34,-1,28,22.4,-1,-1,2,-2,-2,-3,-1,-3
"13959",2021-02-09,"Snodgrass","w2021","Motorized",0,"Tue","weekday","sled","East River",NA,NA,NA,7.6,NA,34,-1,28,22.4,-1,-1,2,-2,-2,-3,-1,-3
"13960",2021-02-09,"Snodgrass","w2021","Hybrid",0,"Tue","weekday","sled","East River",NA,NA,NA,7.6,NA,34,-1,28,22.4,-1,-1,2,-2,-2,-3,-1,-3
"13961",2021-02-10,"Snodgrass","w2021","Non.motorized",59,"Wed","weekday","no_sled","East River",NA,NA,NA,7.7,NA,34,0,26,22.6,-1,-1,-1,2,-1,-2,-3,-1
"13962",2021-02-10,"Snodgrass","w2021","Mechanized",0,"Wed","weekday","no_sled","East River",NA,NA,NA,7.7,NA,34,0,26,22.6,-1,-1,-1,2,-1,-2,-3,-1
"13963",2021-02-10,"Snodgrass","w2021","Motorized",0,"Wed","weekday","sled","East River",NA,NA,NA,7.7,NA,34,0,26,22.6,-1,-1,-1,2,-1,-2,-3,-1
"13964",2021-02-10,"Snodgrass","w2021","Hybrid",0,"Wed","weekday","sled","East River",NA,NA,NA,7.7,NA,34,0,26,22.6,-1,-1,-1,2,-1,-2,-3,-1
"13965",2021-02-11,"Snodgrass","w2021","Non.motorized",73,"Thu","weekday","no_sled","East River",NA,NA,NA,8,NA,37,3,26,21.6,0,-1,-1,-1,3,2,1,0
"13966",2021-02-11,"Snodgrass","w2021","Mechanized",1,"Thu","weekday","no_sled","East River",NA,NA,NA,8,NA,37,3,26,21.6,0,-1,-1,-1,3,2,1,0
"13967",2021-02-11,"Snodgrass","w2021","Motorized",0,"Thu","weekday","sled","East River",NA,NA,NA,8,NA,37,3,26,21.6,0,-1,-1,-1,3,2,1,0
"13968",2021-02-11,"Snodgrass","w2021","Hybrid",0,"Thu","weekday","sled","East River",NA,NA,NA,8,NA,37,3,26,21.6,0,-1,-1,-1,3,2,1,0
"13969",2021-02-12,"Snodgrass","w2021","Non.motorized",58,"Fri","weekday","no_sled","East River",NA,NA,NA,8.1,NA,37,0,27,21.9,3,0,-1,-1,3,3,2,1
"13970",2021-02-12,"Snodgrass","w2021","Mechanized",1,"Fri","weekday","no_sled","East River",NA,NA,NA,8.1,NA,37,0,27,21.9,3,0,-1,-1,3,3,2,1
"13971",2021-02-12,"Snodgrass","w2021","Motorized",0,"Fri","weekday","sled","East River",NA,NA,NA,8.1,NA,37,0,27,21.9,3,0,-1,-1,3,3,2,1
"13972",2021-02-12,"Snodgrass","w2021","Hybrid",0,"Fri","weekday","sled","East River",NA,NA,NA,8.1,NA,37,0,27,21.9,3,0,-1,-1,3,3,2,1
"13973",2021-02-13,"Snodgrass","w2021","Non.motorized",170,"Sat","weekend","no_sled","East River",NA,NA,NA,8.4,NA,38,1,26,22.1,0,3,0,-1,1,4,4,3
"13974",2021-02-13,"Snodgrass","w2021","Mechanized",0,"Sat","weekend","no_sled","East River",NA,NA,NA,8.4,NA,38,1,26,22.1,0,3,0,-1,1,4,4,3
"13975",2021-02-13,"Snodgrass","w2021","Motorized",0,"Sat","weekend","sled","East River",NA,NA,NA,8.4,NA,38,1,26,22.1,0,3,0,-1,1,4,4,3
"13976",2021-02-13,"Snodgrass","w2021","Hybrid",0,"Sat","weekend","sled","East River",NA,NA,NA,8.4,NA,38,1,26,22.1,0,3,0,-1,1,4,4,3
"13977",2021-02-14,"Snodgrass","w2021","Non.motorized",203,"Sun","weekend","no_sled","East River",NA,NA,NA,8.9,NA,43,5,18,20.7,1,0,3,0,6,6,9,9
"13978",2021-02-14,"Snodgrass","w2021","Mechanized",1,"Sun","weekend","no_sled","East River",NA,NA,NA,8.9,NA,43,5,18,20.7,1,0,3,0,6,6,9,9
"13979",2021-02-14,"Snodgrass","w2021","Motorized",0,"Sun","weekend","sled","East River",NA,NA,NA,8.9,NA,43,5,18,20.7,1,0,3,0,6,6,9,9
"13980",2021-02-14,"Snodgrass","w2021","Hybrid",0,"Sun","weekend","sled","East River",NA,NA,NA,8.9,NA,43,5,18,20.7,1,0,3,0,6,6,9,9
"13981",2021-02-15,"Snodgrass","w2021","Non.motorized",105,"Mon","weekday","no_sled","East River",NA,NA,NA,8.9,NA,43,0,12,20.7,5,1,0,3,5,6,6,9
"13982",2021-02-15,"Snodgrass","w2021","Mechanized",1,"Mon","weekday","no_sled","East River",NA,NA,NA,8.9,NA,43,0,12,20.7,5,1,0,3,5,6,6,9
"13983",2021-02-15,"Snodgrass","w2021","Motorized",0,"Mon","weekday","sled","East River",NA,NA,NA,8.9,NA,43,0,12,20.7,5,1,0,3,5,6,6,9
"13984",2021-02-15,"Snodgrass","w2021","Hybrid",0,"Mon","weekday","sled","East River",NA,NA,NA,8.9,NA,43,0,12,20.7,5,1,0,3,5,6,6,9
"13985",2021-02-16,"Snodgrass","w2021","Non.motorized",70,"Tue","weekday","no_sled","East River",NA,NA,NA,9,NA,41,-2,17,22,0,5,1,0,-2,3,4,4
"13986",2021-02-16,"Snodgrass","w2021","Mechanized",0,"Tue","weekday","no_sled","East River",NA,NA,NA,9,NA,41,-2,17,22,0,5,1,0,-2,3,4,4
"13987",2021-02-16,"Snodgrass","w2021","Motorized",0,"Tue","weekday","sled","East River",NA,NA,NA,9,NA,41,-2,17,22,0,5,1,0,-2,3,4,4
"13988",2021-02-16,"Snodgrass","w2021","Hybrid",0,"Tue","weekday","sled","East River",NA,NA,NA,9,NA,41,-2,17,22,0,5,1,0,-2,3,4,4
"13989",2021-02-17,"Snodgrass","w2021","Non.motorized",37,"Wed","weekday","no_sled","East River",NA,NA,NA,9.1,NA,42,1,13,21.7,-2,0,5,1,-1,-1,4,5
"13990",2021-02-17,"Snodgrass","w2021","Mechanized",0,"Wed","weekday","no_sled","East River",NA,NA,NA,9.1,NA,42,1,13,21.7,-2,0,5,1,-1,-1,4,5
"13991",2021-02-17,"Snodgrass","w2021","Motorized",0,"Wed","weekday","sled","East River",NA,NA,NA,9.1,NA,42,1,13,21.7,-2,0,5,1,-1,-1,4,5
"13992",2021-02-17,"Snodgrass","w2021","Hybrid",0,"Wed","weekday","sled","East River",NA,NA,NA,9.1,NA,42,1,13,21.7,-2,0,5,1,-1,-1,4,5
"13993",2021-02-18,"Snodgrass","w2021","Non.motorized",69,"Thu","weekday","no_sled","East River",NA,NA,NA,9.1,NA,41,-1,11,22.2,1,-2,0,5,0,-2,-2,3
"13994",2021-02-18,"Snodgrass","w2021","Mechanized",3,"Thu","weekday","no_sled","East River",NA,NA,NA,9.1,NA,41,-1,11,22.2,1,-2,0,5,0,-2,-2,3
"13995",2021-02-18,"Snodgrass","w2021","Motorized",0,"Thu","weekday","sled","East River",NA,NA,NA,9.1,NA,41,-1,11,22.2,1,-2,0,5,0,-2,-2,3
"13996",2021-02-18,"Snodgrass","w2021","Hybrid",0,"Thu","weekday","sled","East River",NA,NA,NA,9.1,NA,41,-1,11,22.2,1,-2,0,5,0,-2,-2,3
"13997",2021-02-19,"Snodgrass","w2021","Non.motorized",104,"Fri","weekday","no_sled","East River",NA,NA,NA,9.1,NA,40,-1,18,22.8,-1,1,-2,0,-2,-1,-3,-3
"13998",2021-02-19,"Snodgrass","w2021","Mechanized",0,"Fri","weekday","no_sled","East River",NA,NA,NA,9.1,NA,40,-1,18,22.8,-1,1,-2,0,-2,-1,-3,-3
"13999",2021-02-19,"Snodgrass","w2021","Motorized",5,"Fri","weekday","sled","East River",NA,NA,NA,9.1,NA,40,-1,18,22.8,-1,1,-2,0,-2,-1,-3,-3
"14000",2021-02-19,"Snodgrass","w2021","Hybrid",0,"Fri","weekday","sled","East River",NA,NA,NA,9.1,NA,40,-1,18,22.8,-1,1,-2,0,-2,-1,-3,-3
"14001",2021-02-20,"Snodgrass","w2021","Non.motorized",161,"Sat","weekend","no_sled","East River",NA,NA,NA,9.2,NA,39,-1,23,23.6,-1,-1,1,-2,-2,-3,-2,-4
"14002",2021-02-20,"Snodgrass","w2021","Mechanized",3,"Sat","weekend","no_sled","East River",NA,NA,NA,9.2,NA,39,-1,23,23.6,-1,-1,1,-2,-2,-3,-2,-4
"14003",2021-02-20,"Snodgrass","w2021","Motorized",0,"Sat","weekend","sled","East River",NA,NA,NA,9.2,NA,39,-1,23,23.6,-1,-1,1,-2,-2,-3,-2,-4
"14004",2021-02-20,"Snodgrass","w2021","Hybrid",0,"Sat","weekend","sled","East River",NA,NA,NA,9.2,NA,39,-1,23,23.6,-1,-1,1,-2,-2,-3,-2,-4
"14005",2021-02-21,"Snodgrass","w2021","Non.motorized",94,"Sun","weekend","no_sled","East River",NA,NA,NA,9.2,NA,39,0,15,23.6,-1,-1,-1,1,-1,-2,-3,-2
"14006",2021-02-21,"Snodgrass","w2021","Mechanized",5,"Sun","weekend","no_sled","East River",NA,NA,NA,9.2,NA,39,0,15,23.6,-1,-1,-1,1,-1,-2,-3,-2
"14007",2021-02-21,"Snodgrass","w2021","Motorized",0,"Sun","weekend","sled","East River",NA,NA,NA,9.2,NA,39,0,15,23.6,-1,-1,-1,1,-1,-2,-3,-2
"14008",2021-02-21,"Snodgrass","w2021","Hybrid",0,"Sun","weekend","sled","East River",NA,NA,NA,9.2,NA,39,0,15,23.6,-1,-1,-1,1,-1,-2,-3,-2
"14009",2021-02-22,"Snodgrass","w2021","Non.motorized",40,"Mon","weekday","no_sled","East River",NA,NA,NA,9.2,NA,39,0,23,23.6,0,-1,-1,-1,0,-1,-2,-3
"14010",2021-02-22,"Snodgrass","w2021","Mechanized",2,"Mon","weekday","no_sled","East River",NA,NA,NA,9.2,NA,39,0,23,23.6,0,-1,-1,-1,0,-1,-2,-3
"14011",2021-02-22,"Snodgrass","w2021","Motorized",1,"Mon","weekday","sled","East River",NA,NA,NA,9.2,NA,39,0,23,23.6,0,-1,-1,-1,0,-1,-2,-3
"14012",2021-02-22,"Snodgrass","w2021","Hybrid",0,"Mon","weekday","sled","East River",NA,NA,NA,9.2,NA,39,0,23,23.6,0,-1,-1,-1,0,-1,-2,-3
"14013",2021-02-23,"Snodgrass","w2021","Non.motorized",64,"Tue","weekday","no_sled","East River",NA,NA,NA,9.2,NA,38,-1,28,24.2,0,0,-1,-1,-1,-1,-2,-3
"14014",2021-02-23,"Snodgrass","w2021","Mechanized",2,"Tue","weekday","no_sled","East River",NA,NA,NA,9.2,NA,38,-1,28,24.2,0,0,-1,-1,-1,-1,-2,-3
"14015",2021-02-23,"Snodgrass","w2021","Motorized",0,"Tue","weekday","sled","East River",NA,NA,NA,9.2,NA,38,-1,28,24.2,0,0,-1,-1,-1,-1,-2,-3
"14016",2021-02-23,"Snodgrass","w2021","Hybrid",0,"Tue","weekday","sled","East River",NA,NA,NA,9.2,NA,38,-1,28,24.2,0,0,-1,-1,-1,-1,-2,-3
"14017",2021-02-24,"Snodgrass","w2021","Non.motorized",101,"Wed","weekday","no_sled","East River",NA,NA,NA,9.2,NA,38,0,23,24.2,-1,0,0,-1,-1,-1,-1,-2
"14018",2021-02-24,"Snodgrass","w2021","Mechanized",0,"Wed","weekday","no_sled","East River",NA,NA,NA,9.2,NA,38,0,23,24.2,-1,0,0,-1,-1,-1,-1,-2
"14019",2021-02-24,"Snodgrass","w2021","Motorized",0,"Wed","weekday","sled","East River",NA,NA,NA,9.2,NA,38,0,23,24.2,-1,0,0,-1,-1,-1,-1,-2
"14020",2021-02-24,"Snodgrass","w2021","Hybrid",0,"Wed","weekday","sled","East River",NA,NA,NA,9.2,NA,38,0,23,24.2,-1,0,0,-1,-1,-1,-1,-2
"14021",2021-02-25,"Snodgrass","w2021","Non.motorized",93,"Thu","weekday","no_sled","East River",NA,NA,NA,9.2,NA,37,-1,20,24.9,0,-1,0,0,-1,-2,-2,-2
"14022",2021-02-25,"Snodgrass","w2021","Mechanized",4,"Thu","weekday","no_sled","East River",NA,NA,NA,9.2,NA,37,-1,20,24.9,0,-1,0,0,-1,-2,-2,-2
"14023",2021-02-25,"Snodgrass","w2021","Motorized",0,"Thu","weekday","sled","East River",NA,NA,NA,9.2,NA,37,-1,20,24.9,0,-1,0,0,-1,-2,-2,-2
"14024",2021-02-25,"Snodgrass","w2021","Hybrid",0,"Thu","weekday","sled","East River",NA,NA,NA,9.2,NA,37,-1,20,24.9,0,-1,0,0,-1,-2,-2,-2
"14025",2021-02-26,"Snodgrass","w2021","Non.motorized",89,"Fri","weekday","no_sled","East River",NA,NA,NA,9.2,NA,37,0,21,24.9,-1,0,-1,0,-1,-1,-2,-2
"14026",2021-02-26,"Snodgrass","w2021","Mechanized",0,"Fri","weekday","no_sled","East River",NA,NA,NA,9.2,NA,37,0,21,24.9,-1,0,-1,0,-1,-1,-2,-2
"14027",2021-02-26,"Snodgrass","w2021","Motorized",0,"Fri","weekday","sled","East River",NA,NA,NA,9.2,NA,37,0,21,24.9,-1,0,-1,0,-1,-1,-2,-2
"14028",2021-02-26,"Snodgrass","w2021","Hybrid",0,"Fri","weekday","sled","East River",NA,NA,NA,9.2,NA,37,0,21,24.9,-1,0,-1,0,-1,-1,-2,-2
"14029",2021-02-27,"Snodgrass","w2021","Non.motorized",104,"Sat","weekend","no_sled","East River",NA,NA,NA,9.2,NA,37,0,15,24.9,0,-1,0,-1,0,-1,-1,-2
"14030",2021-02-27,"Snodgrass","w2021","Mechanized",6,"Sat","weekend","no_sled","East River",NA,NA,NA,9.2,NA,37,0,15,24.9,0,-1,0,-1,0,-1,-1,-2
"14031",2021-02-27,"Snodgrass","w2021","Motorized",0,"Sat","weekend","sled","East River",NA,NA,NA,9.2,NA,37,0,15,24.9,0,-1,0,-1,0,-1,-1,-2
"14032",2021-02-27,"Snodgrass","w2021","Hybrid",1,"Sat","weekend","sled","East River",NA,NA,NA,9.2,NA,37,0,15,24.9,0,-1,0,-1,0,-1,-1,-2
"14033",2021-02-28,"Snodgrass","w2021","Non.motorized",NA,"Sun","weekend","no_sled","East River",NA,NA,NA,9.2,NA,38,1,9,24.2,0,0,-1,0,1,1,0,0
"14034",2021-02-28,"Snodgrass","w2021","Mechanized",NA,"Sun","weekend","no_sled","East River",NA,NA,NA,9.2,NA,38,1,9,24.2,0,0,-1,0,1,1,0,0
"14035",2021-02-28,"Snodgrass","w2021","Motorized",NA,"Sun","weekend","sled","East River",NA,NA,NA,9.2,NA,38,1,9,24.2,0,0,-1,0,1,1,0,0
"14036",2021-02-28,"Snodgrass","w2021","Hybrid",NA,"Sun","weekend","sled","East River",NA,NA,NA,9.2,NA,38,1,9,24.2,0,0,-1,0,1,1,0,0
"14037",2021-03-01,"Snodgrass","w2021","Non.motorized",NA,"Mon","weekday","no_sled","East River",NA,NA,NA,9.2,NA,37,-1,20,24.9,1,0,0,-1,0,0,0,-1
"14038",2021-03-01,"Snodgrass","w2021","Mechanized",NA,"Mon","weekday","no_sled","East River",NA,NA,NA,9.2,NA,37,-1,20,24.9,1,0,0,-1,0,0,0,-1
"14039",2021-03-01,"Snodgrass","w2021","Motorized",NA,"Mon","weekday","sled","East River",NA,NA,NA,9.2,NA,37,-1,20,24.9,1,0,0,-1,0,0,0,-1
"14040",2021-03-01,"Snodgrass","w2021","Hybrid",NA,"Mon","weekday","sled","East River",NA,NA,NA,9.2,NA,37,-1,20,24.9,1,0,0,-1,0,0,0,-1
"14041",2021-03-02,"Snodgrass","w2021","Non.motorized",41,"Tue","weekday","no_sled","East River",NA,NA,NA,9.2,NA,36,-1,27,25.6,-1,1,0,0,-2,-1,-1,-1
"14042",2021-03-02,"Snodgrass","w2021","Mechanized",0,"Tue","weekday","no_sled","East River",NA,NA,NA,9.2,NA,36,-1,27,25.6,-1,1,0,0,-2,-1,-1,-1
"14043",2021-03-02,"Snodgrass","w2021","Motorized",0,"Tue","weekday","sled","East River",NA,NA,NA,9.2,NA,36,-1,27,25.6,-1,1,0,0,-2,-1,-1,-1
"14044",2021-03-02,"Snodgrass","w2021","Hybrid",0,"Tue","weekday","sled","East River",NA,NA,NA,9.2,NA,36,-1,27,25.6,-1,1,0,0,-2,-1,-1,-1
"14045",2021-03-03,"Snodgrass","w2021","Non.motorized",45,"Wed","weekday","no_sled","East River",NA,NA,NA,9.2,NA,36,0,31,25.6,-1,-1,1,0,-1,-2,-1,-1
"14046",2021-03-03,"Snodgrass","w2021","Mechanized",1,"Wed","weekday","no_sled","East River",NA,NA,NA,9.2,NA,36,0,31,25.6,-1,-1,1,0,-1,-2,-1,-1
"14047",2021-03-03,"Snodgrass","w2021","Motorized",0,"Wed","weekday","sled","East River",NA,NA,NA,9.2,NA,36,0,31,25.6,-1,-1,1,0,-1,-2,-1,-1
"14048",2021-03-03,"Snodgrass","w2021","Hybrid",0,"Wed","weekday","sled","East River",NA,NA,NA,9.2,NA,36,0,31,25.6,-1,-1,1,0,-1,-2,-1,-1
"14049",2021-03-04,"Snodgrass","w2021","Non.motorized",NA,"Thu","weekday","no_sled","East River",NA,NA,NA,9.2,NA,36,0,28,25.6,0,-1,-1,1,0,-1,-2,-1
"14050",2021-03-04,"Snodgrass","w2021","Mechanized",NA,"Thu","weekday","no_sled","East River",NA,NA,NA,9.2,NA,36,0,28,25.6,0,-1,-1,1,0,-1,-2,-1
"14051",2021-03-04,"Snodgrass","w2021","Motorized",NA,"Thu","weekday","sled","East River",NA,NA,NA,9.2,NA,36,0,28,25.6,0,-1,-1,1,0,-1,-2,-1
"14052",2021-03-04,"Snodgrass","w2021","Hybrid",NA,"Thu","weekday","sled","East River",NA,NA,NA,9.2,NA,36,0,28,25.6,0,-1,-1,1,0,-1,-2,-1
"14053",2021-03-05,"Snodgrass","w2021","Non.motorized",25,"Fri","weekday","no_sled","East River",NA,NA,NA,9.4,NA,39,3,30,24.1,0,0,-1,-1,3,3,2,1
"14054",2021-03-05,"Snodgrass","w2021","Mechanized",1,"Fri","weekday","no_sled","East River",NA,NA,NA,9.4,NA,39,3,30,24.1,0,0,-1,-1,3,3,2,1
"14055",2021-03-05,"Snodgrass","w2021","Motorized",0,"Fri","weekday","sled","East River",NA,NA,NA,9.4,NA,39,3,30,24.1,0,0,-1,-1,3,3,2,1
"14056",2021-03-05,"Snodgrass","w2021","Hybrid",0,"Fri","weekday","sled","East River",NA,NA,NA,9.4,NA,39,3,30,24.1,0,0,-1,-1,3,3,2,1
"14057",2021-03-06,"Snodgrass","w2021","Non.motorized",55,"Sat","weekend","no_sled","East River",NA,NA,NA,9.4,NA,38,-1,32,24.7,3,0,0,-1,2,2,2,1
"14058",2021-03-06,"Snodgrass","w2021","Mechanized",1,"Sat","weekend","no_sled","East River",NA,NA,NA,9.4,NA,38,-1,32,24.7,3,0,0,-1,2,2,2,1
"14059",2021-03-06,"Snodgrass","w2021","Motorized",0,"Sat","weekend","sled","East River",NA,NA,NA,9.4,NA,38,-1,32,24.7,3,0,0,-1,2,2,2,1
"14060",2021-03-06,"Snodgrass","w2021","Hybrid",0,"Sat","weekend","sled","East River",NA,NA,NA,9.4,NA,38,-1,32,24.7,3,0,0,-1,2,2,2,1
"14061",2021-03-07,"Snodgrass","w2021","Non.motorized",30,"Sun","weekend","no_sled","East River",NA,NA,NA,9.4,NA,37,-1,35,25.4,-1,3,0,0,-2,1,1,1
"14062",2021-03-07,"Snodgrass","w2021","Mechanized",0,"Sun","weekend","no_sled","East River",NA,NA,NA,9.4,NA,37,-1,35,25.4,-1,3,0,0,-2,1,1,1
"14063",2021-03-07,"Snodgrass","w2021","Motorized",0,"Sun","weekend","sled","East River",NA,NA,NA,9.4,NA,37,-1,35,25.4,-1,3,0,0,-2,1,1,1
"14064",2021-03-07,"Snodgrass","w2021","Hybrid",0,"Sun","weekend","sled","East River",NA,NA,NA,9.4,NA,37,-1,35,25.4,-1,3,0,0,-2,1,1,1
"14065",2021-03-08,"Snodgrass","w2021","Non.motorized",54,"Mon","weekday","no_sled","East River",NA,NA,NA,9.5,NA,37,0,33,25.7,-1,-1,3,0,-1,-2,1,1
"14066",2021-03-08,"Snodgrass","w2021","Mechanized",3,"Mon","weekday","no_sled","East River",NA,NA,NA,9.5,NA,37,0,33,25.7,-1,-1,3,0,-1,-2,1,1
"14067",2021-03-08,"Snodgrass","w2021","Motorized",0,"Mon","weekday","sled","East River",NA,NA,NA,9.5,NA,37,0,33,25.7,-1,-1,3,0,-1,-2,1,1
"14068",2021-03-08,"Snodgrass","w2021","Hybrid",0,"Mon","weekday","sled","East River",NA,NA,NA,9.5,NA,37,0,33,25.7,-1,-1,3,0,-1,-2,1,1
"14069",2021-03-09,"Snodgrass","w2021","Non.motorized",50,"Tue","weekday","no_sled","East River",NA,NA,NA,9.5,NA,37,0,33,25.7,0,-1,-1,3,0,-1,-2,1
"14070",2021-03-09,"Snodgrass","w2021","Mechanized",1,"Tue","weekday","no_sled","East River",NA,NA,NA,9.5,NA,37,0,33,25.7,0,-1,-1,3,0,-1,-2,1
"14071",2021-03-09,"Snodgrass","w2021","Motorized",0,"Tue","weekday","sled","East River",NA,NA,NA,9.5,NA,37,0,33,25.7,0,-1,-1,3,0,-1,-2,1
"14072",2021-03-09,"Snodgrass","w2021","Hybrid",0,"Tue","weekday","sled","East River",NA,NA,NA,9.5,NA,37,0,33,25.7,0,-1,-1,3,0,-1,-2,1
"14073",2021-03-10,"Snodgrass","w2021","Non.motorized",50,"Wed","weekday","no_sled","East River",NA,NA,NA,9.7,NA,39,2,21,24.9,0,0,-1,-1,2,2,1,0
"14074",2021-03-10,"Snodgrass","w2021","Mechanized",0,"Wed","weekday","no_sled","East River",NA,NA,NA,9.7,NA,39,2,21,24.9,0,0,-1,-1,2,2,1,0
"14075",2021-03-10,"Snodgrass","w2021","Motorized",0,"Wed","weekday","sled","East River",NA,NA,NA,9.7,NA,39,2,21,24.9,0,0,-1,-1,2,2,1,0
"14076",2021-03-10,"Snodgrass","w2021","Hybrid",0,"Wed","weekday","sled","East River",NA,NA,NA,9.7,NA,39,2,21,24.9,0,0,-1,-1,2,2,1,0
"14077",2021-03-11,"Snodgrass","w2021","Non.motorized",68,"Thu","weekday","no_sled","East River",NA,NA,NA,9.8,NA,40,1,22,24.5,2,0,0,-1,3,3,3,2
"14078",2021-03-11,"Snodgrass","w2021","Mechanized",0,"Thu","weekday","no_sled","East River",NA,NA,NA,9.8,NA,40,1,22,24.5,2,0,0,-1,3,3,3,2
"14079",2021-03-11,"Snodgrass","w2021","Motorized",0,"Thu","weekday","sled","East River",NA,NA,NA,9.8,NA,40,1,22,24.5,2,0,0,-1,3,3,3,2
"14080",2021-03-11,"Snodgrass","w2021","Hybrid",0,"Thu","weekday","sled","East River",NA,NA,NA,9.8,NA,40,1,22,24.5,2,0,0,-1,3,3,3,2
"14081",2021-03-12,"Snodgrass","w2021","Non.motorized",69,"Fri","weekday","no_sled","East River",NA,NA,NA,9.8,NA,39,-1,29,25.1,1,2,0,0,0,2,2,2
"14082",2021-03-12,"Snodgrass","w2021","Mechanized",0,"Fri","weekday","no_sled","East River",NA,NA,NA,9.8,NA,39,-1,29,25.1,1,2,0,0,0,2,2,2
"14083",2021-03-12,"Snodgrass","w2021","Motorized",0,"Fri","weekday","sled","East River",NA,NA,NA,9.8,NA,39,-1,29,25.1,1,2,0,0,0,2,2,2
"14084",2021-03-12,"Snodgrass","w2021","Hybrid",0,"Fri","weekday","sled","East River",NA,NA,NA,9.8,NA,39,-1,29,25.1,1,2,0,0,0,2,2,2
"14085",2021-03-13,"Snodgrass","w2021","Non.motorized",113,"Sat","weekend","no_sled","East River",NA,NA,NA,9.8,NA,38,-1,27,25.8,-1,1,2,0,-2,-1,1,1
"14086",2021-03-13,"Snodgrass","w2021","Mechanized",2,"Sat","weekend","no_sled","East River",NA,NA,NA,9.8,NA,38,-1,27,25.8,-1,1,2,0,-2,-1,1,1
"14087",2021-03-13,"Snodgrass","w2021","Motorized",0,"Sat","weekend","sled","East River",NA,NA,NA,9.8,NA,38,-1,27,25.8,-1,1,2,0,-2,-1,1,1
"14088",2021-03-13,"Snodgrass","w2021","Hybrid",0,"Sat","weekend","sled","East River",NA,NA,NA,9.8,NA,38,-1,27,25.8,-1,1,2,0,-2,-1,1,1
"14089",2021-03-14,"Snodgrass","w2021","Non.motorized",114,"Sun","weekend","no_sled","East River",NA,NA,NA,10.2,NA,42,4,23,24.3,-1,-1,1,2,3,2,3,5
"14090",2021-03-14,"Snodgrass","w2021","Mechanized",0,"Sun","weekend","no_sled","East River",NA,NA,NA,10.2,NA,42,4,23,24.3,-1,-1,1,2,3,2,3,5
"14091",2021-03-14,"Snodgrass","w2021","Motorized",0,"Sun","weekend","sled","East River",NA,NA,NA,10.2,NA,42,4,23,24.3,-1,-1,1,2,3,2,3,5
"14092",2021-03-14,"Snodgrass","w2021","Hybrid",0,"Sun","weekend","sled","East River",NA,NA,NA,10.2,NA,42,4,23,24.3,-1,-1,1,2,3,2,3,5
"14093",2021-03-15,"Snodgrass","w2021","Non.motorized",60,"Mon","weekday","no_sled","East River",NA,NA,NA,10.2,NA,41,-1,26,24.9,4,-1,-1,1,3,2,1,2
"14094",2021-03-15,"Snodgrass","w2021","Mechanized",0,"Mon","weekday","no_sled","East River",NA,NA,NA,10.2,NA,41,-1,26,24.9,4,-1,-1,1,3,2,1,2
"14095",2021-03-15,"Snodgrass","w2021","Motorized",0,"Mon","weekday","sled","East River",NA,NA,NA,10.2,NA,41,-1,26,24.9,4,-1,-1,1,3,2,1,2
"14096",2021-03-15,"Snodgrass","w2021","Hybrid",0,"Mon","weekday","sled","East River",NA,NA,NA,10.2,NA,41,-1,26,24.9,4,-1,-1,1,3,2,1,2
"14097",2021-03-16,"Snodgrass","w2021","Non.motorized",86,"Tue","weekday","no_sled","East River",NA,NA,NA,10.3,NA,40,-1,26,25.8,-1,4,-1,-1,-2,2,1,0
"14098",2021-03-16,"Snodgrass","w2021","Mechanized",0,"Tue","weekday","no_sled","East River",NA,NA,NA,10.3,NA,40,-1,26,25.8,-1,4,-1,-1,-2,2,1,0
"14099",2021-03-16,"Snodgrass","w2021","Motorized",1,"Tue","weekday","sled","East River",NA,NA,NA,10.3,NA,40,-1,26,25.8,-1,4,-1,-1,-2,2,1,0
"14100",2021-03-16,"Snodgrass","w2021","Hybrid",0,"Tue","weekday","sled","East River",NA,NA,NA,10.3,NA,40,-1,26,25.8,-1,4,-1,-1,-2,2,1,0
"14101",2021-03-17,"Snodgrass","w2021","Non.motorized",77,"Wed","weekday","no_sled","East River",NA,NA,NA,10.3,NA,41,1,25,25.1,-1,-1,4,-1,0,-1,3,2
"14102",2021-03-17,"Snodgrass","w2021","Mechanized",0,"Wed","weekday","no_sled","East River",NA,NA,NA,10.3,NA,41,1,25,25.1,-1,-1,4,-1,0,-1,3,2
"14103",2021-03-17,"Snodgrass","w2021","Motorized",0,"Wed","weekday","sled","East River",NA,NA,NA,10.3,NA,41,1,25,25.1,-1,-1,4,-1,0,-1,3,2
"14104",2021-03-17,"Snodgrass","w2021","Hybrid",0,"Wed","weekday","sled","East River",NA,NA,NA,10.3,NA,41,1,25,25.1,-1,-1,4,-1,0,-1,3,2
"14105",2021-03-18,"Snodgrass","w2021","Non.motorized",104,"Thu","weekday","no_sled","East River",NA,NA,NA,10.3,NA,40,-1,29,25.8,1,-1,-1,4,0,-1,-2,2
"14106",2021-03-18,"Snodgrass","w2021","Mechanized",0,"Thu","weekday","no_sled","East River",NA,NA,NA,10.3,NA,40,-1,29,25.8,1,-1,-1,4,0,-1,-2,2
"14107",2021-03-18,"Snodgrass","w2021","Motorized",0,"Thu","weekday","sled","East River",NA,NA,NA,10.3,NA,40,-1,29,25.8,1,-1,-1,4,0,-1,-2,2
"14108",2021-03-18,"Snodgrass","w2021","Hybrid",0,"Thu","weekday","sled","East River",NA,NA,NA,10.3,NA,40,-1,29,25.8,1,-1,-1,4,0,-1,-2,2
"14109",2021-03-19,"Snodgrass","w2021","Non.motorized",70,"Fri","weekday","no_sled","East River",NA,NA,NA,10.3,NA,40,0,36,25.8,-1,1,-1,-1,-1,0,-1,-2
"14110",2021-03-19,"Snodgrass","w2021","Mechanized",0,"Fri","weekday","no_sled","East River",NA,NA,NA,10.3,NA,40,0,36,25.8,-1,1,-1,-1,-1,0,-1,-2
"14111",2021-03-19,"Snodgrass","w2021","Motorized",0,"Fri","weekday","sled","East River",NA,NA,NA,10.3,NA,40,0,36,25.8,-1,1,-1,-1,-1,0,-1,-2
"14112",2021-03-19,"Snodgrass","w2021","Hybrid",0,"Fri","weekday","sled","East River",NA,NA,NA,10.3,NA,40,0,36,25.8,-1,1,-1,-1,-1,0,-1,-2
"14113",2021-03-20,"Snodgrass","w2021","Non.motorized",95,"Sat","weekend","no_sled","East River",NA,NA,NA,10.4,NA,39,-1,37,26.7,0,-1,1,-1,-1,-2,-1,-2
"14114",2021-03-20,"Snodgrass","w2021","Mechanized",4,"Sat","weekend","no_sled","East River",NA,NA,NA,10.4,NA,39,-1,37,26.7,0,-1,1,-1,-1,-2,-1,-2
"14115",2021-03-20,"Snodgrass","w2021","Motorized",0,"Sat","weekend","sled","East River",NA,NA,NA,10.4,NA,39,-1,37,26.7,0,-1,1,-1,-1,-2,-1,-2
"14116",2021-03-20,"Snodgrass","w2021","Hybrid",0,"Sat","weekend","sled","East River",NA,NA,NA,10.4,NA,39,-1,37,26.7,0,-1,1,-1,-1,-2,-1,-2
"14117",2021-03-21,"Snodgrass","w2021","Non.motorized",115,"Sun","weekend","no_sled","East River",NA,NA,NA,10.4,NA,38,-1,28,27.4,-1,0,-1,1,-2,-2,-3,-2
"14118",2021-03-21,"Snodgrass","w2021","Mechanized",0,"Sun","weekend","no_sled","East River",NA,NA,NA,10.4,NA,38,-1,28,27.4,-1,0,-1,1,-2,-2,-3,-2
"14119",2021-03-21,"Snodgrass","w2021","Motorized",0,"Sun","weekend","sled","East River",NA,NA,NA,10.4,NA,38,-1,28,27.4,-1,0,-1,1,-2,-2,-3,-2
"14120",2021-03-21,"Snodgrass","w2021","Hybrid",0,"Sun","weekend","sled","East River",NA,NA,NA,10.4,NA,38,-1,28,27.4,-1,0,-1,1,-2,-2,-3,-2
"14121",2021-03-22,"Snodgrass","w2021","Non.motorized",92,"Mon","weekday","no_sled","East River",NA,NA,NA,10.5,NA,41,3,26,25.6,-1,-1,0,-1,2,1,1,0
"14122",2021-03-22,"Snodgrass","w2021","Mechanized",0,"Mon","weekday","no_sled","East River",NA,NA,NA,10.5,NA,41,3,26,25.6,-1,-1,0,-1,2,1,1,0
"14123",2021-03-22,"Snodgrass","w2021","Motorized",1,"Mon","weekday","sled","East River",NA,NA,NA,10.5,NA,41,3,26,25.6,-1,-1,0,-1,2,1,1,0
"14124",2021-03-22,"Snodgrass","w2021","Hybrid",0,"Mon","weekday","sled","East River",NA,NA,NA,10.5,NA,41,3,26,25.6,-1,-1,0,-1,2,1,1,0
"14125",2021-03-23,"Snodgrass","w2021","Non.motorized",87,"Tue","weekday","no_sled","East River",NA,NA,NA,10.6,NA,41,0,24,25.9,3,-1,-1,0,3,2,1,1
"14126",2021-03-23,"Snodgrass","w2021","Mechanized",4,"Tue","weekday","no_sled","East River",NA,NA,NA,10.6,NA,41,0,24,25.9,3,-1,-1,0,3,2,1,1
"14127",2021-03-23,"Snodgrass","w2021","Motorized",0,"Tue","weekday","sled","East River",NA,NA,NA,10.6,NA,41,0,24,25.9,3,-1,-1,0,3,2,1,1
"14128",2021-03-23,"Snodgrass","w2021","Hybrid",0,"Tue","weekday","sled","East River",NA,NA,NA,10.6,NA,41,0,24,25.9,3,-1,-1,0,3,2,1,1
"14129",2021-03-24,"Snodgrass","w2021","Non.motorized",81,"Wed","weekday","no_sled","East River",NA,NA,NA,10.8,NA,41,0,24,26.3,0,3,-1,-1,0,3,2,1
"14130",2021-03-24,"Snodgrass","w2021","Mechanized",0,"Wed","weekday","no_sled","East River",NA,NA,NA,10.8,NA,41,0,24,26.3,0,3,-1,-1,0,3,2,1
"14131",2021-03-24,"Snodgrass","w2021","Motorized",0,"Wed","weekday","sled","East River",NA,NA,NA,10.8,NA,41,0,24,26.3,0,3,-1,-1,0,3,2,1
"14132",2021-03-24,"Snodgrass","w2021","Hybrid",0,"Wed","weekday","sled","East River",NA,NA,NA,10.8,NA,41,0,24,26.3,0,3,-1,-1,0,3,2,1
"14133",2021-03-25,"Snodgrass","w2021","Non.motorized",36,"Thu","weekday","no_sled","East River",NA,NA,NA,10.9,NA,43,2,23,25.3,0,0,3,-1,2,2,5,4
"14134",2021-03-25,"Snodgrass","w2021","Mechanized",0,"Thu","weekday","no_sled","East River",NA,NA,NA,10.9,NA,43,2,23,25.3,0,0,3,-1,2,2,5,4
"14135",2021-03-25,"Snodgrass","w2021","Motorized",0,"Thu","weekday","sled","East River",NA,NA,NA,10.9,NA,43,2,23,25.3,0,0,3,-1,2,2,5,4
"14136",2021-03-25,"Snodgrass","w2021","Hybrid",0,"Thu","weekday","sled","East River",NA,NA,NA,10.9,NA,43,2,23,25.3,0,0,3,-1,2,2,5,4
"14137",2021-03-26,"Snodgrass","w2021","Non.motorized",92,"Fri","weekday","no_sled","East River",NA,NA,NA,11,NA,44,1,23,25,2,0,0,3,3,3,3,6
"14138",2021-03-26,"Snodgrass","w2021","Mechanized",0,"Fri","weekday","no_sled","East River",NA,NA,NA,11,NA,44,1,23,25,2,0,0,3,3,3,3,6
"14139",2021-03-26,"Snodgrass","w2021","Motorized",0,"Fri","weekday","sled","East River",NA,NA,NA,11,NA,44,1,23,25,2,0,0,3,3,3,3,6
"14140",2021-03-26,"Snodgrass","w2021","Hybrid",0,"Fri","weekday","sled","East River",NA,NA,NA,11,NA,44,1,23,25,2,0,0,3,3,3,3,6
"14141",2021-03-27,"Snodgrass","w2021","Non.motorized",117,"Sat","weekend","no_sled","East River",NA,NA,NA,11,NA,42,-2,25,26.2,1,2,0,0,-1,1,1,1
"14142",2021-03-27,"Snodgrass","w2021","Mechanized",4,"Sat","weekend","no_sled","East River",NA,NA,NA,11,NA,42,-2,25,26.2,1,2,0,0,-1,1,1,1
"14143",2021-03-27,"Snodgrass","w2021","Motorized",0,"Sat","weekend","sled","East River",NA,NA,NA,11,NA,42,-2,25,26.2,1,2,0,0,-1,1,1,1
"14144",2021-03-27,"Snodgrass","w2021","Hybrid",0,"Sat","weekend","sled","East River",NA,NA,NA,11,NA,42,-2,25,26.2,1,2,0,0,-1,1,1,1
"14145",2021-03-28,"Snodgrass","w2021","Non.motorized",107,"Sun","weekend","no_sled","East River",NA,NA,NA,11,NA,42,0,31,26.2,-2,1,2,0,-2,-1,1,1
"14146",2021-03-28,"Snodgrass","w2021","Mechanized",0,"Sun","weekend","no_sled","East River",NA,NA,NA,11,NA,42,0,31,26.2,-2,1,2,0,-2,-1,1,1
"14147",2021-03-28,"Snodgrass","w2021","Motorized",0,"Sun","weekend","sled","East River",NA,NA,NA,11,NA,42,0,31,26.2,-2,1,2,0,-2,-1,1,1
"14148",2021-03-28,"Snodgrass","w2021","Hybrid",0,"Sun","weekend","sled","East River",NA,NA,NA,11,NA,42,0,31,26.2,-2,1,2,0,-2,-1,1,1
"14149",2021-03-29,"Snodgrass","w2021","Non.motorized",23,"Mon","weekday","no_sled","East River",NA,NA,NA,11.1,NA,40,-2,37,27.8,0,-2,1,2,-2,-4,-3,-1
"14150",2021-03-29,"Snodgrass","w2021","Mechanized",0,"Mon","weekday","no_sled","East River",NA,NA,NA,11.1,NA,40,-2,37,27.8,0,-2,1,2,-2,-4,-3,-1
"14151",2021-03-29,"Snodgrass","w2021","Motorized",0,"Mon","weekday","sled","East River",NA,NA,NA,11.1,NA,40,-2,37,27.8,0,-2,1,2,-2,-4,-3,-1
"14152",2021-03-29,"Snodgrass","w2021","Hybrid",0,"Mon","weekday","sled","East River",NA,NA,NA,11.1,NA,40,-2,37,27.8,0,-2,1,2,-2,-4,-3,-1
"14153",2021-03-30,"Snodgrass","w2021","Non.motorized",42,"Tue","weekday","no_sled","East River",NA,NA,NA,11.1,NA,39,-1,23,28.5,-2,0,-2,1,-3,-3,-5,-4
"14154",2021-03-30,"Snodgrass","w2021","Mechanized",0,"Tue","weekday","no_sled","East River",NA,NA,NA,11.1,NA,39,-1,23,28.5,-2,0,-2,1,-3,-3,-5,-4
"14155",2021-03-30,"Snodgrass","w2021","Motorized",0,"Tue","weekday","sled","East River",NA,NA,NA,11.1,NA,39,-1,23,28.5,-2,0,-2,1,-3,-3,-5,-4
"14156",2021-03-30,"Snodgrass","w2021","Hybrid",0,"Tue","weekday","sled","East River",NA,NA,NA,11.1,NA,39,-1,23,28.5,-2,0,-2,1,-3,-3,-5,-4
"14157",2021-03-31,"Snodgrass","w2021","Non.motorized",58,"Wed","weekday","no_sled","East River",NA,NA,NA,11.1,NA,39,0,26,28.5,-1,-2,0,-2,-1,-3,-3,-5
"14158",2021-03-31,"Snodgrass","w2021","Mechanized",0,"Wed","weekday","no_sled","East River",NA,NA,NA,11.1,NA,39,0,26,28.5,-1,-2,0,-2,-1,-3,-3,-5
"14159",2021-03-31,"Snodgrass","w2021","Motorized",0,"Wed","weekday","sled","East River",NA,NA,NA,11.1,NA,39,0,26,28.5,-1,-2,0,-2,-1,-3,-3,-5
"14160",2021-03-31,"Snodgrass","w2021","Hybrid",0,"Wed","weekday","sled","East River",NA,NA,NA,11.1,NA,39,0,26,28.5,-1,-2,0,-2,-1,-3,-3,-5
"14161",2021-04-01,"Snodgrass","w2021","Non.motorized",48,"Thu","weekday","no_sled","East River",NA,NA,NA,11.1,NA,38,-1,36,29.2,0,-1,-2,0,-1,-2,-4,-4
"14162",2021-04-01,"Snodgrass","w2021","Mechanized",1,"Thu","weekday","no_sled","East River",NA,NA,NA,11.1,NA,38,-1,36,29.2,0,-1,-2,0,-1,-2,-4,-4
"14163",2021-04-01,"Snodgrass","w2021","Motorized",0,"Thu","weekday","sled","East River",NA,NA,NA,11.1,NA,38,-1,36,29.2,0,-1,-2,0,-1,-2,-4,-4
"14164",2021-04-01,"Snodgrass","w2021","Hybrid",0,"Thu","weekday","sled","East River",NA,NA,NA,11.1,NA,38,-1,36,29.2,0,-1,-2,0,-1,-2,-4,-4
"14165",2021-04-02,"Snodgrass","w2021","Non.motorized",55,"Fri","weekday","no_sled","East River",NA,NA,NA,11.1,NA,37,-1,42,30,-1,0,-1,-2,-2,-2,-3,-5
"14166",2021-04-02,"Snodgrass","w2021","Mechanized",1,"Fri","weekday","no_sled","East River",NA,NA,NA,11.1,NA,37,-1,42,30,-1,0,-1,-2,-2,-2,-3,-5
"14167",2021-04-02,"Snodgrass","w2021","Motorized",0,"Fri","weekday","sled","East River",NA,NA,NA,11.1,NA,37,-1,42,30,-1,0,-1,-2,-2,-2,-3,-5
"14168",2021-04-02,"Snodgrass","w2021","Hybrid",0,"Fri","weekday","sled","East River",NA,NA,NA,11.1,NA,37,-1,42,30,-1,0,-1,-2,-2,-2,-3,-5
"14169",2021-04-03,"Snodgrass","w2021","Non.motorized",46,"Sat","weekend","no_sled","East River",NA,NA,NA,10.8,NA,35,-2,45,30.9,-1,-1,0,-1,-3,-4,-4,-5
"14170",2021-04-03,"Snodgrass","w2021","Mechanized",1,"Sat","weekend","no_sled","East River",NA,NA,NA,10.8,NA,35,-2,45,30.9,-1,-1,0,-1,-3,-4,-4,-5
"14171",2021-04-03,"Snodgrass","w2021","Motorized",0,"Sat","weekend","sled","East River",NA,NA,NA,10.8,NA,35,-2,45,30.9,-1,-1,0,-1,-3,-4,-4,-5
"14172",2021-04-03,"Snodgrass","w2021","Hybrid",0,"Sat","weekend","sled","East River",NA,NA,NA,10.8,NA,35,-2,45,30.9,-1,-1,0,-1,-3,-4,-4,-5
"14173",2021-04-04,"Snodgrass","w2021","Non.motorized",75,"Sun","weekend","no_sled","East River",NA,NA,NA,10.7,NA,34,-1,44,31.5,-2,-1,-1,0,-3,-4,-5,-5
"14174",2021-04-04,"Snodgrass","w2021","Mechanized",0,"Sun","weekend","no_sled","East River",NA,NA,NA,10.7,NA,34,-1,44,31.5,-2,-1,-1,0,-3,-4,-5,-5
"14175",2021-04-04,"Snodgrass","w2021","Motorized",0,"Sun","weekend","sled","East River",NA,NA,NA,10.7,NA,34,-1,44,31.5,-2,-1,-1,0,-3,-4,-5,-5
"14176",2021-04-04,"Snodgrass","w2021","Hybrid",0,"Sun","weekend","sled","East River",NA,NA,NA,10.7,NA,34,-1,44,31.5,-2,-1,-1,0,-3,-4,-5,-5
"14177",2021-04-05,"Snodgrass","w2021","Non.motorized",24,"Mon","weekday","no_sled","East River",NA,NA,NA,10.6,NA,33,-1,44,32.1,-1,-2,-1,-1,-2,-4,-5,-6
"14178",2021-04-05,"Snodgrass","w2021","Mechanized",2,"Mon","weekday","no_sled","East River",NA,NA,NA,10.6,NA,33,-1,44,32.1,-1,-2,-1,-1,-2,-4,-5,-6
"14179",2021-04-05,"Snodgrass","w2021","Motorized",0,"Mon","weekday","sled","East River",NA,NA,NA,10.6,NA,33,-1,44,32.1,-1,-2,-1,-1,-2,-4,-5,-6
"14180",2021-04-05,"Snodgrass","w2021","Hybrid",0,"Mon","weekday","sled","East River",NA,NA,NA,10.6,NA,33,-1,44,32.1,-1,-2,-1,-1,-2,-4,-5,-6
"14181",2021-04-06,"Snodgrass","w2021","Non.motorized",18,"Tue","weekday","no_sled","East River",NA,NA,NA,10.3,NA,31,-2,32,33.2,-1,-1,-2,-1,-3,-4,-6,-7
"14182",2021-04-06,"Snodgrass","w2021","Mechanized",0,"Tue","weekday","no_sled","East River",NA,NA,NA,10.3,NA,31,-2,32,33.2,-1,-1,-2,-1,-3,-4,-6,-7
"14183",2021-04-06,"Snodgrass","w2021","Motorized",0,"Tue","weekday","sled","East River",NA,NA,NA,10.3,NA,31,-2,32,33.2,-1,-1,-2,-1,-3,-4,-6,-7
"14184",2021-04-06,"Snodgrass","w2021","Hybrid",0,"Tue","weekday","sled","East River",NA,NA,NA,10.3,NA,31,-2,32,33.2,-1,-1,-2,-1,-3,-4,-6,-7
"14185",2021-04-07,"Snodgrass","w2021","Non.motorized",8,"Wed","weekday","no_sled","East River",NA,NA,NA,10,NA,31,0,33,32.3,-2,-1,-1,-2,-2,-3,-4,-6
"14186",2021-04-07,"Snodgrass","w2021","Mechanized",0,"Wed","weekday","no_sled","East River",NA,NA,NA,10,NA,31,0,33,32.3,-2,-1,-1,-2,-2,-3,-4,-6
"14187",2021-04-07,"Snodgrass","w2021","Motorized",0,"Wed","weekday","sled","East River",NA,NA,NA,10,NA,31,0,33,32.3,-2,-1,-1,-2,-2,-3,-4,-6
"14188",2021-04-07,"Snodgrass","w2021","Hybrid",0,"Wed","weekday","sled","East River",NA,NA,NA,10,NA,31,0,33,32.3,-2,-1,-1,-2,-2,-3,-4,-6
"14189",2021-04-08,"Snodgrass","w2021","Non.motorized",8,"Thu","weekday","no_sled","East River",NA,NA,NA,9.9,NA,29,-2,39,34.1,0,-2,-1,-1,-2,-4,-5,-6
"14190",2021-04-08,"Snodgrass","w2021","Mechanized",2,"Thu","weekday","no_sled","East River",NA,NA,NA,9.9,NA,29,-2,39,34.1,0,-2,-1,-1,-2,-4,-5,-6
"14191",2021-04-08,"Snodgrass","w2021","Motorized",0,"Thu","weekday","sled","East River",NA,NA,NA,9.9,NA,29,-2,39,34.1,0,-2,-1,-1,-2,-4,-5,-6
"14192",2021-04-08,"Snodgrass","w2021","Hybrid",0,"Thu","weekday","sled","East River",NA,NA,NA,9.9,NA,29,-2,39,34.1,0,-2,-1,-1,-2,-4,-5,-6
"14193",2021-04-09,"Snodgrass","w2021","Non.motorized",21,"Fri","weekday","no_sled","East River",NA,NA,NA,9.6,NA,28,-1,33,34.3,-2,0,-2,-1,-3,-3,-5,-6
"14194",2021-04-09,"Snodgrass","w2021","Mechanized",1,"Fri","weekday","no_sled","East River",NA,NA,NA,9.6,NA,28,-1,33,34.3,-2,0,-2,-1,-3,-3,-5,-6
"14195",2021-04-09,"Snodgrass","w2021","Motorized",0,"Fri","weekday","sled","East River",NA,NA,NA,9.6,NA,28,-1,33,34.3,-2,0,-2,-1,-3,-3,-5,-6
"14196",2021-04-09,"Snodgrass","w2021","Hybrid",0,"Fri","weekday","sled","East River",NA,NA,NA,9.6,NA,28,-1,33,34.3,-2,0,-2,-1,-3,-3,-5,-6
"14197",2021-04-10,"Snodgrass","w2021","Non.motorized",24,"Sat","weekend","no_sled","East River",NA,NA,NA,9.5,NA,26,-2,37,36.5,-1,-2,0,-2,-3,-5,-5,-7
"14198",2021-04-10,"Snodgrass","w2021","Mechanized",1,"Sat","weekend","no_sled","East River",NA,NA,NA,9.5,NA,26,-2,37,36.5,-1,-2,0,-2,-3,-5,-5,-7
"14199",2021-04-10,"Snodgrass","w2021","Motorized",0,"Sat","weekend","sled","East River",NA,NA,NA,9.5,NA,26,-2,37,36.5,-1,-2,0,-2,-3,-5,-5,-7
"14200",2021-04-10,"Snodgrass","w2021","Hybrid",0,"Sat","weekend","sled","East River",NA,NA,NA,9.5,NA,26,-2,37,36.5,-1,-2,0,-2,-3,-5,-5,-7
"14201",2021-04-11,"Snodgrass","w2021","Non.motorized",17,"Sun","weekend","no_sled","East River",NA,NA,NA,9.2,NA,26,0,39,35.4,-2,-1,-2,0,-2,-3,-5,-5
"14202",2021-04-11,"Snodgrass","w2021","Mechanized",0,"Sun","weekend","no_sled","East River",NA,NA,NA,9.2,NA,26,0,39,35.4,-2,-1,-2,0,-2,-3,-5,-5
"14203",2021-04-11,"Snodgrass","w2021","Motorized",0,"Sun","weekend","sled","East River",NA,NA,NA,9.2,NA,26,0,39,35.4,-2,-1,-2,0,-2,-3,-5,-5
"14204",2021-04-11,"Snodgrass","w2021","Hybrid",0,"Sun","weekend","sled","East River",NA,NA,NA,9.2,NA,26,0,39,35.4,-2,-1,-2,0,-2,-3,-5,-5
"14205",2021-04-12,"Snodgrass","w2021","Non.motorized",11,"Mon","weekday","no_sled","East River",NA,NA,NA,8.8,NA,24,-2,38,36.7,0,-2,-1,-2,-2,-4,-5,-7
"14206",2021-04-12,"Snodgrass","w2021","Mechanized",1,"Mon","weekday","no_sled","East River",NA,NA,NA,8.8,NA,24,-2,38,36.7,0,-2,-1,-2,-2,-4,-5,-7
"14207",2021-04-12,"Snodgrass","w2021","Motorized",0,"Mon","weekday","sled","East River",NA,NA,NA,8.8,NA,24,-2,38,36.7,0,-2,-1,-2,-2,-4,-5,-7
"14208",2021-04-12,"Snodgrass","w2021","Hybrid",0,"Mon","weekday","sled","East River",NA,NA,NA,8.8,NA,24,-2,38,36.7,0,-2,-1,-2,-2,-4,-5,-7
"14209",2012-04-13,"Snodgrass","w2021","Non.motorized",7,"Fri","weekday","no_sled","East River",NA,NA,NA,NA,NA,NA,NA,NA,NA,NA,NA,NA,NA,NA,NA,NA,NA
"14210",2012-04-13,"Snodgrass","w2021","Mechanized",0,"Fri","weekday","no_sled","East River",NA,NA,NA,NA,NA,NA,NA,NA,NA,NA,NA,NA,NA,NA,NA,NA,NA
"14211",2012-04-13,"Snodgrass","w2021","Motorized",0,"Fri","weekday","sled","East River",NA,NA,NA,NA,NA,NA,NA,NA,NA,NA,NA,NA,NA,NA,NA,NA,NA
"14212",2012-04-13,"Snodgrass","w2021","Hybrid",0,"Fri","weekday","sled","East River",NA,NA,NA,NA,NA,NA,NA,NA,NA,NA,NA,NA,NA,NA,NA,NA,NA
"14213",2021-04-14,"Snodgrass","w2021","Non.motorized",4,"Wed","weekday","no_sled","East River",NA,NA,NA,8.4,NA,23,0,41,36.5,-1,-2,0,-2,-1,-3,-3,-5
"14214",2021-04-14,"Snodgrass","w2021","Mechanized",1,"Wed","weekday","no_sled","East River",NA,NA,NA,8.4,NA,23,0,41,36.5,-1,-2,0,-2,-1,-3,-3,-5
"14215",2021-04-14,"Snodgrass","w2021","Motorized",0,"Wed","weekday","sled","East River",NA,NA,NA,8.4,NA,23,0,41,36.5,-1,-2,0,-2,-1,-3,-3,-5
"14216",2021-04-14,"Snodgrass","w2021","Hybrid",0,"Wed","weekday","sled","East River",NA,NA,NA,8.4,NA,23,0,41,36.5,-1,-2,0,-2,-1,-3,-3,-5
"14217",2021-04-15,"Snodgrass","w2021","Non.motorized",2,"Thu","weekday","no_sled","East River",NA,NA,NA,8.1,NA,22,-1,33,36.8,0,-1,-2,0,-1,-2,-4,-4
"14218",2021-04-15,"Snodgrass","w2021","Mechanized",0,"Thu","weekday","no_sled","East River",NA,NA,NA,8.1,NA,22,-1,33,36.8,0,-1,-2,0,-1,-2,-4,-4
"14219",2021-04-15,"Snodgrass","w2021","Motorized",0,"Thu","weekday","sled","East River",NA,NA,NA,8.1,NA,22,-1,33,36.8,0,-1,-2,0,-1,-2,-4,-4
"14220",2021-04-15,"Snodgrass","w2021","Hybrid",0,"Thu","weekday","sled","East River",NA,NA,NA,8.1,NA,22,-1,33,36.8,0,-1,-2,0,-1,-2,-4,-4
"14221",2020-12-03,"Washington Gulch","w2021","Non.motorized",4,"Thu","weekday","no_sled","Washington Gulch",NA,NA,NA,NA,NA,NA,NA,NA,NA,NA,NA,NA,NA,NA,NA,NA,NA
"14222",2020-12-03,"Washington Gulch","w2021","Mechanized",0,"Thu","weekday","no_sled","Washington Gulch",NA,NA,NA,NA,NA,NA,NA,NA,NA,NA,NA,NA,NA,NA,NA,NA,NA
"14223",2020-12-03,"Washington Gulch","w2021","Motorized",1,"Thu","weekday","sled","Washington Gulch",NA,NA,NA,NA,NA,NA,NA,NA,NA,NA,NA,NA,NA,NA,NA,NA,NA
"14224",2020-12-03,"Washington Gulch","w2021","Hybrid",0,"Thu","weekday","sled","Washington Gulch",NA,NA,NA,NA,NA,NA,NA,NA,NA,NA,NA,NA,NA,NA,NA,NA,NA
"14225",2020-12-04,"Washington Gulch","w2021","Non.motorized",13,"Fri","weekday","no_sled","Washington Gulch",NA,NA,NA,2.4,NA,11,0,29,21.8,0,0,0,0,0,0,0,0
"14226",2020-12-04,"Washington Gulch","w2021","Mechanized",1,"Fri","weekday","no_sled","Washington Gulch",NA,NA,NA,2.4,NA,11,0,29,21.8,0,0,0,0,0,0,0,0
"14227",2020-12-04,"Washington Gulch","w2021","Motorized",1,"Fri","weekday","sled","Washington Gulch",NA,NA,NA,2.4,NA,11,0,29,21.8,0,0,0,0,0,0,0,0
"14228",2020-12-04,"Washington Gulch","w2021","Hybrid",0,"Fri","weekday","sled","Washington Gulch",NA,NA,NA,2.4,NA,11,0,29,21.8,0,0,0,0,0,0,0,0
"14229",2020-12-05,"Washington Gulch","w2021","Non.motorized",12,"Sat","weekend","no_sled","Washington Gulch",NA,NA,NA,2.5,NA,11,0,32,22.7,0,0,0,0,0,0,0,0
"14230",2020-12-05,"Washington Gulch","w2021","Mechanized",0,"Sat","weekend","no_sled","Washington Gulch",NA,NA,NA,2.5,NA,11,0,32,22.7,0,0,0,0,0,0,0,0
"14231",2020-12-05,"Washington Gulch","w2021","Motorized",6,"Sat","weekend","sled","Washington Gulch",NA,NA,NA,2.5,NA,11,0,32,22.7,0,0,0,0,0,0,0,0
"14232",2020-12-05,"Washington Gulch","w2021","Hybrid",0,"Sat","weekend","sled","Washington Gulch",NA,NA,NA,2.5,NA,11,0,32,22.7,0,0,0,0,0,0,0,0
"14233",2020-12-06,"Washington Gulch","w2021","Non.motorized",9,"Sun","weekend","no_sled","Washington Gulch",NA,NA,NA,2.5,NA,11,0,30,22.7,0,0,0,0,0,0,0,0
"14234",2020-12-06,"Washington Gulch","w2021","Mechanized",0,"Sun","weekend","no_sled","Washington Gulch",NA,NA,NA,2.5,NA,11,0,30,22.7,0,0,0,0,0,0,0,0
"14235",2020-12-06,"Washington Gulch","w2021","Motorized",0,"Sun","weekend","sled","Washington Gulch",NA,NA,NA,2.5,NA,11,0,30,22.7,0,0,0,0,0,0,0,0
"14236",2020-12-06,"Washington Gulch","w2021","Hybrid",0,"Sun","weekend","sled","Washington Gulch",NA,NA,NA,2.5,NA,11,0,30,22.7,0,0,0,0,0,0,0,0
"14237",2020-12-07,"Washington Gulch","w2021","Non.motorized",6,"Mon","weekday","no_sled","Washington Gulch",NA,NA,NA,2.5,NA,11,0,33,22.7,0,0,0,0,0,0,0,0
"14238",2020-12-07,"Washington Gulch","w2021","Mechanized",1,"Mon","weekday","no_sled","Washington Gulch",NA,NA,NA,2.5,NA,11,0,33,22.7,0,0,0,0,0,0,0,0
"14239",2020-12-07,"Washington Gulch","w2021","Motorized",0,"Mon","weekday","sled","Washington Gulch",NA,NA,NA,2.5,NA,11,0,33,22.7,0,0,0,0,0,0,0,0
"14240",2020-12-07,"Washington Gulch","w2021","Hybrid",0,"Mon","weekday","sled","Washington Gulch",NA,NA,NA,2.5,NA,11,0,33,22.7,0,0,0,0,0,0,0,0
"14241",2020-12-08,"Washington Gulch","w2021","Non.motorized",4,"Tue","weekday","no_sled","Washington Gulch",NA,NA,NA,2.5,NA,11,0,34,22.7,0,0,0,0,0,0,0,0
"14242",2020-12-08,"Washington Gulch","w2021","Mechanized",0,"Tue","weekday","no_sled","Washington Gulch",NA,NA,NA,2.5,NA,11,0,34,22.7,0,0,0,0,0,0,0,0
"14243",2020-12-08,"Washington Gulch","w2021","Motorized",0,"Tue","weekday","sled","Washington Gulch",NA,NA,NA,2.5,NA,11,0,34,22.7,0,0,0,0,0,0,0,0
"14244",2020-12-08,"Washington Gulch","w2021","Hybrid",0,"Tue","weekday","sled","Washington Gulch",NA,NA,NA,2.5,NA,11,0,34,22.7,0,0,0,0,0,0,0,0
"14245",2020-12-09,"Washington Gulch","w2021","Non.motorized",4,"Wed","weekday","no_sled","Washington Gulch",NA,NA,NA,2.5,NA,11,0,32,22.7,0,0,0,0,0,0,0,0
"14246",2020-12-09,"Washington Gulch","w2021","Mechanized",0,"Wed","weekday","no_sled","Washington Gulch",NA,NA,NA,2.5,NA,11,0,32,22.7,0,0,0,0,0,0,0,0
"14247",2020-12-09,"Washington Gulch","w2021","Motorized",0,"Wed","weekday","sled","Washington Gulch",NA,NA,NA,2.5,NA,11,0,32,22.7,0,0,0,0,0,0,0,0
"14248",2020-12-09,"Washington Gulch","w2021","Hybrid",0,"Wed","weekday","sled","Washington Gulch",NA,NA,NA,2.5,NA,11,0,32,22.7,0,0,0,0,0,0,0,0
"14249",2020-12-10,"Washington Gulch","w2021","Non.motorized",1,"Thu","weekday","no_sled","Washington Gulch",NA,NA,NA,2.5,NA,11,0,28,22.7,0,0,0,0,0,0,0,0
"14250",2020-12-10,"Washington Gulch","w2021","Mechanized",0,"Thu","weekday","no_sled","Washington Gulch",NA,NA,NA,2.5,NA,11,0,28,22.7,0,0,0,0,0,0,0,0
"14251",2020-12-10,"Washington Gulch","w2021","Motorized",0,"Thu","weekday","sled","Washington Gulch",NA,NA,NA,2.5,NA,11,0,28,22.7,0,0,0,0,0,0,0,0
"14252",2020-12-10,"Washington Gulch","w2021","Hybrid",0,"Thu","weekday","sled","Washington Gulch",NA,NA,NA,2.5,NA,11,0,28,22.7,0,0,0,0,0,0,0,0
"14253",2020-12-11,"Washington Gulch","w2021","Non.motorized",44,"Fri","weekday","no_sled","Washington Gulch",NA,NA,NA,2.6,NA,12,1,20,21.7,0,0,0,0,1,1,1,1
"14254",2020-12-11,"Washington Gulch","w2021","Mechanized",0,"Fri","weekday","no_sled","Washington Gulch",NA,NA,NA,2.6,NA,12,1,20,21.7,0,0,0,0,1,1,1,1
"14255",2020-12-11,"Washington Gulch","w2021","Motorized",0,"Fri","weekday","sled","Washington Gulch",NA,NA,NA,2.6,NA,12,1,20,21.7,0,0,0,0,1,1,1,1
"14256",2020-12-11,"Washington Gulch","w2021","Hybrid",6,"Fri","weekday","sled","Washington Gulch",NA,NA,NA,2.6,NA,12,1,20,21.7,0,0,0,0,1,1,1,1
"14257",2020-12-12,"Washington Gulch","w2021","Non.motorized",102,"Sat","weekend","no_sled","Washington Gulch",NA,NA,NA,2.9,NA,17,5,12,17.1,1,0,0,0,6,6,6,6
"14258",2020-12-12,"Washington Gulch","w2021","Mechanized",0,"Sat","weekend","no_sled","Washington Gulch",NA,NA,NA,2.9,NA,17,5,12,17.1,1,0,0,0,6,6,6,6
"14259",2020-12-12,"Washington Gulch","w2021","Motorized",10,"Sat","weekend","sled","Washington Gulch",NA,NA,NA,2.9,NA,17,5,12,17.1,1,0,0,0,6,6,6,6
"14260",2020-12-12,"Washington Gulch","w2021","Hybrid",3,"Sat","weekend","sled","Washington Gulch",NA,NA,NA,2.9,NA,17,5,12,17.1,1,0,0,0,6,6,6,6
"14261",2020-12-13,"Washington Gulch","w2021","Non.motorized",5,"Sun","weekend","no_sled","Washington Gulch",NA,NA,NA,3.3,NA,19,2,10,17.4,5,1,0,0,7,8,8,8
"14262",2020-12-13,"Washington Gulch","w2021","Mechanized",0,"Sun","weekend","no_sled","Washington Gulch",NA,NA,NA,3.3,NA,19,2,10,17.4,5,1,0,0,7,8,8,8
"14263",2020-12-13,"Washington Gulch","w2021","Motorized",3,"Sun","weekend","sled","Washington Gulch",NA,NA,NA,3.3,NA,19,2,10,17.4,5,1,0,0,7,8,8,8
"14264",2020-12-13,"Washington Gulch","w2021","Hybrid",1,"Sun","weekend","sled","Washington Gulch",NA,NA,NA,3.3,NA,19,2,10,17.4,5,1,0,0,7,8,8,8
"14265",2020-12-14,"Washington Gulch","w2021","Non.motorized",20,"Mon","weekday","no_sled","Washington Gulch",NA,NA,NA,3.3,NA,18,-1,18,18.3,2,5,1,0,1,6,7,7
"14266",2020-12-14,"Washington Gulch","w2021","Mechanized",0,"Mon","weekday","no_sled","Washington Gulch",NA,NA,NA,3.3,NA,18,-1,18,18.3,2,5,1,0,1,6,7,7
"14267",2020-12-14,"Washington Gulch","w2021","Motorized",1,"Mon","weekday","sled","Washington Gulch",NA,NA,NA,3.3,NA,18,-1,18,18.3,2,5,1,0,1,6,7,7
"14268",2020-12-14,"Washington Gulch","w2021","Hybrid",0,"Mon","weekday","sled","Washington Gulch",NA,NA,NA,3.3,NA,18,-1,18,18.3,2,5,1,0,1,6,7,7
"14269",2020-12-15,"Washington Gulch","w2021","Non.motorized",20,"Tue","weekday","no_sled","Washington Gulch",NA,NA,NA,3.5,NA,19,1,13,18.4,-1,2,5,1,0,2,7,8
"14270",2020-12-15,"Washington Gulch","w2021","Mechanized",0,"Tue","weekday","no_sled","Washington Gulch",NA,NA,NA,3.5,NA,19,1,13,18.4,-1,2,5,1,0,2,7,8
"14271",2020-12-15,"Washington Gulch","w2021","Motorized",1,"Tue","weekday","sled","Washington Gulch",NA,NA,NA,3.5,NA,19,1,13,18.4,-1,2,5,1,0,2,7,8
"14272",2020-12-15,"Washington Gulch","w2021","Hybrid",1,"Tue","weekday","sled","Washington Gulch",NA,NA,NA,3.5,NA,19,1,13,18.4,-1,2,5,1,0,2,7,8
"14273",2020-12-16,"Washington Gulch","w2021","Non.motorized",19,"Wed","weekday","no_sled","Washington Gulch",NA,NA,NA,3.5,NA,19,0,16,18.4,1,-1,2,5,1,0,2,7
"14274",2020-12-16,"Washington Gulch","w2021","Mechanized",0,"Wed","weekday","no_sled","Washington Gulch",NA,NA,NA,3.5,NA,19,0,16,18.4,1,-1,2,5,1,0,2,7
"14275",2020-12-16,"Washington Gulch","w2021","Motorized",0,"Wed","weekday","sled","Washington Gulch",NA,NA,NA,3.5,NA,19,0,16,18.4,1,-1,2,5,1,0,2,7
"14276",2020-12-16,"Washington Gulch","w2021","Hybrid",0,"Wed","weekday","sled","Washington Gulch",NA,NA,NA,3.5,NA,19,0,16,18.4,1,-1,2,5,1,0,2,7
"14277",2020-12-17,"Washington Gulch","w2021","Non.motorized",15,"Thu","weekday","no_sled","Washington Gulch",NA,NA,NA,3.5,NA,19,0,20,18.4,0,1,-1,2,0,1,0,2
"14278",2020-12-17,"Washington Gulch","w2021","Mechanized",0,"Thu","weekday","no_sled","Washington Gulch",NA,NA,NA,3.5,NA,19,0,20,18.4,0,1,-1,2,0,1,0,2
"14279",2020-12-17,"Washington Gulch","w2021","Motorized",7,"Thu","weekday","sled","Washington Gulch",NA,NA,NA,3.5,NA,19,0,20,18.4,0,1,-1,2,0,1,0,2
"14280",2020-12-17,"Washington Gulch","w2021","Hybrid",2,"Thu","weekday","sled","Washington Gulch",NA,NA,NA,3.5,NA,19,0,20,18.4,0,1,-1,2,0,1,0,2
"14281",2020-12-18,"Washington Gulch","w2021","Non.motorized",47,"Fri","weekday","no_sled","Washington Gulch",NA,NA,NA,3.8,NA,22,3,20,17.3,0,0,1,-1,3,3,4,3
"14282",2020-12-18,"Washington Gulch","w2021","Mechanized",0,"Fri","weekday","no_sled","Washington Gulch",NA,NA,NA,3.8,NA,22,3,20,17.3,0,0,1,-1,3,3,4,3
"14283",2020-12-18,"Washington Gulch","w2021","Motorized",8,"Fri","weekday","sled","Washington Gulch",NA,NA,NA,3.8,NA,22,3,20,17.3,0,0,1,-1,3,3,4,3
"14284",2020-12-18,"Washington Gulch","w2021","Hybrid",5,"Fri","weekday","sled","Washington Gulch",NA,NA,NA,3.8,NA,22,3,20,17.3,0,0,1,-1,3,3,4,3
"14285",2020-12-19,"Washington Gulch","w2021","Non.motorized",74,"Sat","weekend","no_sled","Washington Gulch",NA,NA,NA,3.9,NA,22,0,17,17.7,3,0,0,1,3,3,3,4
"14286",2020-12-19,"Washington Gulch","w2021","Mechanized",2,"Sat","weekend","no_sled","Washington Gulch",NA,NA,NA,3.9,NA,22,0,17,17.7,3,0,0,1,3,3,3,4
"14287",2020-12-19,"Washington Gulch","w2021","Motorized",6,"Sat","weekend","sled","Washington Gulch",NA,NA,NA,3.9,NA,22,0,17,17.7,3,0,0,1,3,3,3,4
"14288",2020-12-19,"Washington Gulch","w2021","Hybrid",4,"Sat","weekend","sled","Washington Gulch",NA,NA,NA,3.9,NA,22,0,17,17.7,3,0,0,1,3,3,3,4
"14289",2020-12-20,"Washington Gulch","w2021","Non.motorized",24,"Sun","weekend","no_sled","Washington Gulch",NA,NA,NA,3.9,NA,21,-1,26,18.6,0,3,0,0,-1,2,2,2
"14290",2020-12-20,"Washington Gulch","w2021","Mechanized",1,"Sun","weekend","no_sled","Washington Gulch",NA,NA,NA,3.9,NA,21,-1,26,18.6,0,3,0,0,-1,2,2,2
"14291",2020-12-20,"Washington Gulch","w2021","Motorized",2,"Sun","weekend","sled","Washington Gulch",NA,NA,NA,3.9,NA,21,-1,26,18.6,0,3,0,0,-1,2,2,2
"14292",2020-12-20,"Washington Gulch","w2021","Hybrid",2,"Sun","weekend","sled","Washington Gulch",NA,NA,NA,3.9,NA,21,-1,26,18.6,0,3,0,0,-1,2,2,2
"14293",2020-12-21,"Washington Gulch","w2021","Non.motorized",24,"Mon","weekday","no_sled","Washington Gulch",NA,NA,NA,3.9,NA,20,-1,28,19.5,-1,0,3,0,-2,-2,1,1
"14294",2020-12-21,"Washington Gulch","w2021","Mechanized",0,"Mon","weekday","no_sled","Washington Gulch",NA,NA,NA,3.9,NA,20,-1,28,19.5,-1,0,3,0,-2,-2,1,1
"14295",2020-12-21,"Washington Gulch","w2021","Motorized",2,"Mon","weekday","sled","Washington Gulch",NA,NA,NA,3.9,NA,20,-1,28,19.5,-1,0,3,0,-2,-2,1,1
"14296",2020-12-21,"Washington Gulch","w2021","Hybrid",1,"Mon","weekday","sled","Washington Gulch",NA,NA,NA,3.9,NA,20,-1,28,19.5,-1,0,3,0,-2,-2,1,1
"14297",2020-12-22,"Washington Gulch","w2021","Non.motorized",28,"Tue","weekday","no_sled","Washington Gulch",NA,NA,NA,4,NA,20,0,24,20,-1,-1,0,3,-1,-2,-2,1
"14298",2020-12-22,"Washington Gulch","w2021","Mechanized",0,"Tue","weekday","no_sled","Washington Gulch",NA,NA,NA,4,NA,20,0,24,20,-1,-1,0,3,-1,-2,-2,1
"14299",2020-12-22,"Washington Gulch","w2021","Motorized",2,"Tue","weekday","sled","Washington Gulch",NA,NA,NA,4,NA,20,0,24,20,-1,-1,0,3,-1,-2,-2,1
"14300",2020-12-22,"Washington Gulch","w2021","Hybrid",5,"Tue","weekday","sled","Washington Gulch",NA,NA,NA,4,NA,20,0,24,20,-1,-1,0,3,-1,-2,-2,1
"14301",2020-12-23,"Washington Gulch","w2021","Non.motorized",43,"Wed","weekday","no_sled","Washington Gulch",NA,NA,NA,4.1,NA,22,2,6,18.6,0,-1,-1,0,2,1,0,0
"14302",2020-12-23,"Washington Gulch","w2021","Mechanized",0,"Wed","weekday","no_sled","Washington Gulch",NA,NA,NA,4.1,NA,22,2,6,18.6,0,-1,-1,0,2,1,0,0
"14303",2020-12-23,"Washington Gulch","w2021","Motorized",6,"Wed","weekday","sled","Washington Gulch",NA,NA,NA,4.1,NA,22,2,6,18.6,0,-1,-1,0,2,1,0,0
"14304",2020-12-23,"Washington Gulch","w2021","Hybrid",5,"Wed","weekday","sled","Washington Gulch",NA,NA,NA,4.1,NA,22,2,6,18.6,0,-1,-1,0,2,1,0,0
"14305",2020-12-24,"Washington Gulch","w2021","Non.motorized",52,"Thu","weekday","no_sled","Washington Gulch",NA,NA,NA,4.1,NA,21,-1,15,19.5,2,0,-1,-1,1,1,0,-1
"14306",2020-12-24,"Washington Gulch","w2021","Mechanized",0,"Thu","weekday","no_sled","Washington Gulch",NA,NA,NA,4.1,NA,21,-1,15,19.5,2,0,-1,-1,1,1,0,-1
"14307",2020-12-24,"Washington Gulch","w2021","Motorized",1,"Thu","weekday","sled","Washington Gulch",NA,NA,NA,4.1,NA,21,-1,15,19.5,2,0,-1,-1,1,1,0,-1
"14308",2020-12-24,"Washington Gulch","w2021","Hybrid",7,"Thu","weekday","sled","Washington Gulch",NA,NA,NA,4.1,NA,21,-1,15,19.5,2,0,-1,-1,1,1,0,-1
"14309",2020-12-25,"Washington Gulch","w2021","Non.motorized",66,"Fri","weekday","no_sled","Washington Gulch",NA,NA,NA,4.1,NA,20,-1,25,20.5,-1,2,0,-1,-2,0,0,-1
"14310",2020-12-25,"Washington Gulch","w2021","Mechanized",2,"Fri","weekday","no_sled","Washington Gulch",NA,NA,NA,4.1,NA,20,-1,25,20.5,-1,2,0,-1,-2,0,0,-1
"14311",2020-12-25,"Washington Gulch","w2021","Motorized",4,"Fri","weekday","sled","Washington Gulch",NA,NA,NA,4.1,NA,20,-1,25,20.5,-1,2,0,-1,-2,0,0,-1
"14312",2020-12-25,"Washington Gulch","w2021","Hybrid",6,"Fri","weekday","sled","Washington Gulch",NA,NA,NA,4.1,NA,20,-1,25,20.5,-1,2,0,-1,-2,0,0,-1
"14313",2020-12-26,"Washington Gulch","w2021","Non.motorized",50,"Sat","weekend","no_sled","Washington Gulch",NA,NA,NA,4.1,NA,20,0,26,20.5,-1,-1,2,0,-1,-2,0,0
"14314",2020-12-26,"Washington Gulch","w2021","Mechanized",0,"Sat","weekend","no_sled","Washington Gulch",NA,NA,NA,4.1,NA,20,0,26,20.5,-1,-1,2,0,-1,-2,0,0
"14315",2020-12-26,"Washington Gulch","w2021","Motorized",9,"Sat","weekend","sled","Washington Gulch",NA,NA,NA,4.1,NA,20,0,26,20.5,-1,-1,2,0,-1,-2,0,0
"14316",2020-12-26,"Washington Gulch","w2021","Hybrid",3,"Sat","weekend","sled","Washington Gulch",NA,NA,NA,4.1,NA,20,0,26,20.5,-1,-1,2,0,-1,-2,0,0
"14317",2020-12-27,"Washington Gulch","w2021","Non.motorized",16,"Sun","weekend","no_sled","Washington Gulch",NA,NA,NA,4.2,NA,19,-1,19,22.1,0,-1,-1,2,-1,-2,-3,-1
"14318",2020-12-27,"Washington Gulch","w2021","Mechanized",0,"Sun","weekend","no_sled","Washington Gulch",NA,NA,NA,4.2,NA,19,-1,19,22.1,0,-1,-1,2,-1,-2,-3,-1
"14319",2020-12-27,"Washington Gulch","w2021","Motorized",0,"Sun","weekend","sled","Washington Gulch",NA,NA,NA,4.2,NA,19,-1,19,22.1,0,-1,-1,2,-1,-2,-3,-1
"14320",2020-12-27,"Washington Gulch","w2021","Hybrid",0,"Sun","weekend","sled","Washington Gulch",NA,NA,NA,4.2,NA,19,-1,19,22.1,0,-1,-1,2,-1,-2,-3,-1
"14321",2020-12-28,"Washington Gulch","w2021","Non.motorized",32,"Mon","weekday","no_sled","Washington Gulch",NA,NA,NA,4.2,NA,20,1,22,21,-1,0,-1,-1,0,0,-1,-2
"14322",2020-12-28,"Washington Gulch","w2021","Mechanized",0,"Mon","weekday","no_sled","Washington Gulch",NA,NA,NA,4.2,NA,20,1,22,21,-1,0,-1,-1,0,0,-1,-2
"14323",2020-12-28,"Washington Gulch","w2021","Motorized",1,"Mon","weekday","sled","Washington Gulch",NA,NA,NA,4.2,NA,20,1,22,21,-1,0,-1,-1,0,0,-1,-2
"14324",2020-12-28,"Washington Gulch","w2021","Hybrid",0,"Mon","weekday","sled","Washington Gulch",NA,NA,NA,4.2,NA,20,1,22,21,-1,0,-1,-1,0,0,-1,-2
"14325",2020-12-29,"Washington Gulch","w2021","Non.motorized",47,"Tue","weekday","no_sled","Washington Gulch",NA,NA,NA,4.9,NA,27,7,15,18.1,1,-1,0,-1,8,7,7,6
"14326",2020-12-29,"Washington Gulch","w2021","Mechanized",0,"Tue","weekday","no_sled","Washington Gulch",NA,NA,NA,4.9,NA,27,7,15,18.1,1,-1,0,-1,8,7,7,6
"14327",2020-12-29,"Washington Gulch","w2021","Motorized",2,"Tue","weekday","sled","Washington Gulch",NA,NA,NA,4.9,NA,27,7,15,18.1,1,-1,0,-1,8,7,7,6
"14328",2020-12-29,"Washington Gulch","w2021","Hybrid",0,"Tue","weekday","sled","Washington Gulch",NA,NA,NA,4.9,NA,27,7,15,18.1,1,-1,0,-1,8,7,7,6
"14329",2020-12-30,"Washington Gulch","w2021","Non.motorized",58,"Wed","weekday","no_sled","Washington Gulch",NA,NA,NA,4.9,NA,26,-1,10,18.8,7,1,-1,0,6,7,6,6
"14330",2020-12-30,"Washington Gulch","w2021","Mechanized",0,"Wed","weekday","no_sled","Washington Gulch",NA,NA,NA,4.9,NA,26,-1,10,18.8,7,1,-1,0,6,7,6,6
"14331",2020-12-30,"Washington Gulch","w2021","Motorized",9,"Wed","weekday","sled","Washington Gulch",NA,NA,NA,4.9,NA,26,-1,10,18.8,7,1,-1,0,6,7,6,6
"14332",2020-12-30,"Washington Gulch","w2021","Hybrid",11,"Wed","weekday","sled","Washington Gulch",NA,NA,NA,4.9,NA,26,-1,10,18.8,7,1,-1,0,6,7,6,6
"14333",2020-12-31,"Washington Gulch","w2021","Non.motorized",91,"Thu","weekday","no_sled","Washington Gulch",NA,NA,NA,4.9,NA,25,-1,19,19.6,-1,7,1,-1,-2,5,6,5
"14334",2020-12-31,"Washington Gulch","w2021","Mechanized",1,"Thu","weekday","no_sled","Washington Gulch",NA,NA,NA,4.9,NA,25,-1,19,19.6,-1,7,1,-1,-2,5,6,5
"14335",2020-12-31,"Washington Gulch","w2021","Motorized",7,"Thu","weekday","sled","Washington Gulch",NA,NA,NA,4.9,NA,25,-1,19,19.6,-1,7,1,-1,-2,5,6,5
"14336",2020-12-31,"Washington Gulch","w2021","Hybrid",6,"Thu","weekday","sled","Washington Gulch",NA,NA,NA,4.9,NA,25,-1,19,19.6,-1,7,1,-1,-2,5,6,5
"14337",2021-01-01,"Washington Gulch","w2021","Non.motorized",94,"Fri","weekday","no_sled","Washington Gulch",NA,NA,NA,4.9,NA,24,-1,21,20.4,-1,-1,7,1,-2,-3,4,5
"14338",2021-01-01,"Washington Gulch","w2021","Mechanized",1,"Fri","weekday","no_sled","Washington Gulch",NA,NA,NA,4.9,NA,24,-1,21,20.4,-1,-1,7,1,-2,-3,4,5
"14339",2021-01-01,"Washington Gulch","w2021","Motorized",7,"Fri","weekday","sled","Washington Gulch",NA,NA,NA,4.9,NA,24,-1,21,20.4,-1,-1,7,1,-2,-3,4,5
"14340",2021-01-01,"Washington Gulch","w2021","Hybrid",6,"Fri","weekday","sled","Washington Gulch",NA,NA,NA,4.9,NA,24,-1,21,20.4,-1,-1,7,1,-2,-3,4,5
"14341",2021-01-02,"Washington Gulch","w2021","Non.motorized",58,"Sat","weekend","no_sled","Washington Gulch",NA,NA,NA,4.9,NA,23,-1,19,21.3,-1,-1,-1,7,-2,-3,-4,3
"14342",2021-01-02,"Washington Gulch","w2021","Mechanized",0,"Sat","weekend","no_sled","Washington Gulch",NA,NA,NA,4.9,NA,23,-1,19,21.3,-1,-1,-1,7,-2,-3,-4,3
"14343",2021-01-02,"Washington Gulch","w2021","Motorized",5,"Sat","weekend","sled","Washington Gulch",NA,NA,NA,4.9,NA,23,-1,19,21.3,-1,-1,-1,7,-2,-3,-4,3
"14344",2021-01-02,"Washington Gulch","w2021","Hybrid",4,"Sat","weekend","sled","Washington Gulch",NA,NA,NA,4.9,NA,23,-1,19,21.3,-1,-1,-1,7,-2,-3,-4,3
"14345",2021-01-03,"Washington Gulch","w2021","Non.motorized",54,"Sun","weekend","no_sled","Washington Gulch",NA,NA,NA,4.9,NA,23,0,21,21.3,-1,-1,-1,-1,-1,-2,-3,-4
"14346",2021-01-03,"Washington Gulch","w2021","Mechanized",0,"Sun","weekend","no_sled","Washington Gulch",NA,NA,NA,4.9,NA,23,0,21,21.3,-1,-1,-1,-1,-1,-2,-3,-4
"14347",2021-01-03,"Washington Gulch","w2021","Motorized",0,"Sun","weekend","sled","Washington Gulch",NA,NA,NA,4.9,NA,23,0,21,21.3,-1,-1,-1,-1,-1,-2,-3,-4
"14348",2021-01-03,"Washington Gulch","w2021","Hybrid",11,"Sun","weekend","sled","Washington Gulch",NA,NA,NA,4.9,NA,23,0,21,21.3,-1,-1,-1,-1,-1,-2,-3,-4
"14349",2021-01-04,"Washington Gulch","w2021","Non.motorized",23,"Mon","weekday","no_sled","Washington Gulch",NA,NA,NA,4.9,NA,22,-1,25,22.3,0,-1,-1,-1,-1,-2,-3,-4
"14350",2021-01-04,"Washington Gulch","w2021","Mechanized",0,"Mon","weekday","no_sled","Washington Gulch",NA,NA,NA,4.9,NA,22,-1,25,22.3,0,-1,-1,-1,-1,-2,-3,-4
"14351",2021-01-04,"Washington Gulch","w2021","Motorized",2,"Mon","weekday","sled","Washington Gulch",NA,NA,NA,4.9,NA,22,-1,25,22.3,0,-1,-1,-1,-1,-2,-3,-4
"14352",2021-01-04,"Washington Gulch","w2021","Hybrid",0,"Mon","weekday","sled","Washington Gulch",NA,NA,NA,4.9,NA,22,-1,25,22.3,0,-1,-1,-1,-1,-2,-3,-4
"14353",2021-01-05,"Washington Gulch","w2021","Non.motorized",NA,"Tue","weekday","no_sled","Washington Gulch",NA,NA,NA,5,NA,22,0,23,22.7,-1,0,-1,-1,-1,-1,-2,-3
"14354",2021-01-05,"Washington Gulch","w2021","Mechanized",NA,"Tue","weekday","no_sled","Washington Gulch",NA,NA,NA,5,NA,22,0,23,22.7,-1,0,-1,-1,-1,-1,-2,-3
"14355",2021-01-05,"Washington Gulch","w2021","Motorized",NA,"Tue","weekday","sled","Washington Gulch",NA,NA,NA,5,NA,22,0,23,22.7,-1,0,-1,-1,-1,-1,-2,-3
"14356",2021-01-05,"Washington Gulch","w2021","Hybrid",NA,"Tue","weekday","sled","Washington Gulch",NA,NA,NA,5,NA,22,0,23,22.7,-1,0,-1,-1,-1,-1,-2,-3
"14357",2021-01-06,"Washington Gulch","w2021","Non.motorized",44,"Wed","weekday","no_sled","Washington Gulch",NA,NA,NA,5.1,NA,24,2,18,21.2,0,-1,0,-1,2,1,1,0
"14358",2021-01-06,"Washington Gulch","w2021","Mechanized",0,"Wed","weekday","no_sled","Washington Gulch",NA,NA,NA,5.1,NA,24,2,18,21.2,0,-1,0,-1,2,1,1,0
"14359",2021-01-06,"Washington Gulch","w2021","Motorized",2,"Wed","weekday","sled","Washington Gulch",NA,NA,NA,5.1,NA,24,2,18,21.2,0,-1,0,-1,2,1,1,0
"14360",2021-01-06,"Washington Gulch","w2021","Hybrid",4,"Wed","weekday","sled","Washington Gulch",NA,NA,NA,5.1,NA,24,2,18,21.2,0,-1,0,-1,2,1,1,0
"14361",2021-01-07,"Washington Gulch","w2021","Non.motorized",31,"Thu","weekday","no_sled","Washington Gulch",NA,NA,NA,5.1,NA,24,0,23,21.2,2,0,-1,0,2,2,1,1
"14362",2021-01-07,"Washington Gulch","w2021","Mechanized",1,"Thu","weekday","no_sled","Washington Gulch",NA,NA,NA,5.1,NA,24,0,23,21.2,2,0,-1,0,2,2,1,1
"14363",2021-01-07,"Washington Gulch","w2021","Motorized",1,"Thu","weekday","sled","Washington Gulch",NA,NA,NA,5.1,NA,24,0,23,21.2,2,0,-1,0,2,2,1,1
"14364",2021-01-07,"Washington Gulch","w2021","Hybrid",4,"Thu","weekday","sled","Washington Gulch",NA,NA,NA,5.1,NA,24,0,23,21.2,2,0,-1,0,2,2,1,1
"14365",2021-01-08,"Washington Gulch","w2021","Non.motorized",43,"Fri","weekday","no_sled","Washington Gulch",NA,NA,NA,5.1,NA,23,-1,20,22.2,0,2,0,-1,-1,1,1,0
"14366",2021-01-08,"Washington Gulch","w2021","Mechanized",0,"Fri","weekday","no_sled","Washington Gulch",NA,NA,NA,5.1,NA,23,-1,20,22.2,0,2,0,-1,-1,1,1,0
"14367",2021-01-08,"Washington Gulch","w2021","Motorized",0,"Fri","weekday","sled","Washington Gulch",NA,NA,NA,5.1,NA,23,-1,20,22.2,0,2,0,-1,-1,1,1,0
"14368",2021-01-08,"Washington Gulch","w2021","Hybrid",5,"Fri","weekday","sled","Washington Gulch",NA,NA,NA,5.1,NA,23,-1,20,22.2,0,2,0,-1,-1,1,1,0
"14369",2021-01-09,"Washington Gulch","w2021","Non.motorized",75,"Sat","weekend","no_sled","Washington Gulch",NA,NA,NA,5.1,NA,23,0,19,22.2,-1,0,2,0,-1,-1,1,1
"14370",2021-01-09,"Washington Gulch","w2021","Mechanized",4,"Sat","weekend","no_sled","Washington Gulch",NA,NA,NA,5.1,NA,23,0,19,22.2,-1,0,2,0,-1,-1,1,1
"14371",2021-01-09,"Washington Gulch","w2021","Motorized",9,"Sat","weekend","sled","Washington Gulch",NA,NA,NA,5.1,NA,23,0,19,22.2,-1,0,2,0,-1,-1,1,1
"14372",2021-01-09,"Washington Gulch","w2021","Hybrid",4,"Sat","weekend","sled","Washington Gulch",NA,NA,NA,5.1,NA,23,0,19,22.2,-1,0,2,0,-1,-1,1,1
"14373",2021-01-10,"Washington Gulch","w2021","Non.motorized",77,"Sun","weekend","no_sled","Washington Gulch",NA,NA,NA,5.1,NA,23,0,14,22.2,0,-1,0,2,0,-1,-1,1
"14374",2021-01-10,"Washington Gulch","w2021","Mechanized",0,"Sun","weekend","no_sled","Washington Gulch",NA,NA,NA,5.1,NA,23,0,14,22.2,0,-1,0,2,0,-1,-1,1
"14375",2021-01-10,"Washington Gulch","w2021","Motorized",7,"Sun","weekend","sled","Washington Gulch",NA,NA,NA,5.1,NA,23,0,14,22.2,0,-1,0,2,0,-1,-1,1
"14376",2021-01-10,"Washington Gulch","w2021","Hybrid",4,"Sun","weekend","sled","Washington Gulch",NA,NA,NA,5.1,NA,23,0,14,22.2,0,-1,0,2,0,-1,-1,1
"14377",2021-01-11,"Washington Gulch","w2021","Non.motorized",39,"Mon","weekday","no_sled","Washington Gulch",NA,NA,NA,5.1,NA,23,0,15,22.2,0,0,-1,0,0,0,-1,-1
"14378",2021-01-11,"Washington Gulch","w2021","Mechanized",0,"Mon","weekday","no_sled","Washington Gulch",NA,NA,NA,5.1,NA,23,0,15,22.2,0,0,-1,0,0,0,-1,-1
"14379",2021-01-11,"Washington Gulch","w2021","Motorized",2,"Mon","weekday","sled","Washington Gulch",NA,NA,NA,5.1,NA,23,0,15,22.2,0,0,-1,0,0,0,-1,-1
"14380",2021-01-11,"Washington Gulch","w2021","Hybrid",2,"Mon","weekday","sled","Washington Gulch",NA,NA,NA,5.1,NA,23,0,15,22.2,0,0,-1,0,0,0,-1,-1
"14381",2021-01-12,"Washington Gulch","w2021","Non.motorized",26,"Tue","weekday","no_sled","Washington Gulch",NA,NA,NA,5.1,NA,23,0,23,22.2,0,0,0,-1,0,0,0,-1
"14382",2021-01-12,"Washington Gulch","w2021","Mechanized",0,"Tue","weekday","no_sled","Washington Gulch",NA,NA,NA,5.1,NA,23,0,23,22.2,0,0,0,-1,0,0,0,-1
"14383",2021-01-12,"Washington Gulch","w2021","Motorized",6,"Tue","weekday","sled","Washington Gulch",NA,NA,NA,5.1,NA,23,0,23,22.2,0,0,0,-1,0,0,0,-1
"14384",2021-01-12,"Washington Gulch","w2021","Hybrid",0,"Tue","weekday","sled","Washington Gulch",NA,NA,NA,5.1,NA,23,0,23,22.2,0,0,0,-1,0,0,0,-1
"14385",2021-01-13,"Washington Gulch","w2021","Non.motorized",16,"Wed","weekday","no_sled","Washington Gulch",NA,NA,NA,5.1,NA,23,0,28,22.2,0,0,0,0,0,0,0,0
"14386",2021-01-13,"Washington Gulch","w2021","Mechanized",0,"Wed","weekday","no_sled","Washington Gulch",NA,NA,NA,5.1,NA,23,0,28,22.2,0,0,0,0,0,0,0,0
"14387",2021-01-13,"Washington Gulch","w2021","Motorized",2,"Wed","weekday","sled","Washington Gulch",NA,NA,NA,5.1,NA,23,0,28,22.2,0,0,0,0,0,0,0,0
"14388",2021-01-13,"Washington Gulch","w2021","Hybrid",0,"Wed","weekday","sled","Washington Gulch",NA,NA,NA,5.1,NA,23,0,28,22.2,0,0,0,0,0,0,0,0
"14389",2021-01-14,"Washington Gulch","w2021","Non.motorized",19,"Thu","weekday","no_sled","Washington Gulch",NA,NA,NA,5.1,NA,22,-1,20,23.2,0,0,0,0,-1,-1,-1,-1
"14390",2021-01-14,"Washington Gulch","w2021","Mechanized",0,"Thu","weekday","no_sled","Washington Gulch",NA,NA,NA,5.1,NA,22,-1,20,23.2,0,0,0,0,-1,-1,-1,-1
"14391",2021-01-14,"Washington Gulch","w2021","Motorized",3,"Thu","weekday","sled","Washington Gulch",NA,NA,NA,5.1,NA,22,-1,20,23.2,0,0,0,0,-1,-1,-1,-1
"14392",2021-01-14,"Washington Gulch","w2021","Hybrid",1,"Thu","weekday","sled","Washington Gulch",NA,NA,NA,5.1,NA,22,-1,20,23.2,0,0,0,0,-1,-1,-1,-1
"14393",2021-01-15,"Washington Gulch","w2021","Non.motorized",33,"Fri","weekday","no_sled","Washington Gulch",NA,NA,NA,5.1,NA,22,0,26,23.2,-1,0,0,0,-1,-1,-1,-1
"14394",2021-01-15,"Washington Gulch","w2021","Mechanized",0,"Fri","weekday","no_sled","Washington Gulch",NA,NA,NA,5.1,NA,22,0,26,23.2,-1,0,0,0,-1,-1,-1,-1
"14395",2021-01-15,"Washington Gulch","w2021","Motorized",2,"Fri","weekday","sled","Washington Gulch",NA,NA,NA,5.1,NA,22,0,26,23.2,-1,0,0,0,-1,-1,-1,-1
"14396",2021-01-15,"Washington Gulch","w2021","Hybrid",1,"Fri","weekday","sled","Washington Gulch",NA,NA,NA,5.1,NA,22,0,26,23.2,-1,0,0,0,-1,-1,-1,-1
"14397",2021-01-16,"Washington Gulch","w2021","Non.motorized",84,"Sat","weekend","no_sled","Washington Gulch",NA,NA,NA,5.1,NA,22,0,26,23.2,0,-1,0,0,0,-1,-1,-1
"14398",2021-01-16,"Washington Gulch","w2021","Mechanized",1,"Sat","weekend","no_sled","Washington Gulch",NA,NA,NA,5.1,NA,22,0,26,23.2,0,-1,0,0,0,-1,-1,-1
"14399",2021-01-16,"Washington Gulch","w2021","Motorized",16,"Sat","weekend","sled","Washington Gulch",NA,NA,NA,5.1,NA,22,0,26,23.2,0,-1,0,0,0,-1,-1,-1
"14400",2021-01-16,"Washington Gulch","w2021","Hybrid",0,"Sat","weekend","sled","Washington Gulch",NA,NA,NA,5.1,NA,22,0,26,23.2,0,-1,0,0,0,-1,-1,-1
"14401",2021-01-17,"Washington Gulch","w2021","Non.motorized",78,"Sun","weekend","no_sled","Washington Gulch",NA,NA,NA,5.1,NA,22,0,29,23.2,0,0,-1,0,0,0,-1,-1
"14402",2021-01-17,"Washington Gulch","w2021","Mechanized",1,"Sun","weekend","no_sled","Washington Gulch",NA,NA,NA,5.1,NA,22,0,29,23.2,0,0,-1,0,0,0,-1,-1
"14403",2021-01-17,"Washington Gulch","w2021","Motorized",6,"Sun","weekend","sled","Washington Gulch",NA,NA,NA,5.1,NA,22,0,29,23.2,0,0,-1,0,0,0,-1,-1
"14404",2021-01-17,"Washington Gulch","w2021","Hybrid",3,"Sun","weekend","sled","Washington Gulch",NA,NA,NA,5.1,NA,22,0,29,23.2,0,0,-1,0,0,0,-1,-1
"14405",2021-01-18,"Washington Gulch","w2021","Non.motorized",38,"Mon","weekday","no_sled","Washington Gulch",NA,NA,NA,5.1,NA,22,0,24,23.2,0,0,0,-1,0,0,0,-1
"14406",2021-01-18,"Washington Gulch","w2021","Mechanized",0,"Mon","weekday","no_sled","Washington Gulch",NA,NA,NA,5.1,NA,22,0,24,23.2,0,0,0,-1,0,0,0,-1
"14407",2021-01-18,"Washington Gulch","w2021","Motorized",3,"Mon","weekday","sled","Washington Gulch",NA,NA,NA,5.1,NA,22,0,24,23.2,0,0,0,-1,0,0,0,-1
"14408",2021-01-18,"Washington Gulch","w2021","Hybrid",0,"Mon","weekday","sled","Washington Gulch",NA,NA,NA,5.1,NA,22,0,24,23.2,0,0,0,-1,0,0,0,-1
"14409",2021-01-19,"Washington Gulch","w2021","Non.motorized",17,"Tue","weekday","no_sled","Washington Gulch",NA,NA,NA,5.1,NA,22,0,19,23.2,0,0,0,0,0,0,0,0
"14410",2021-01-19,"Washington Gulch","w2021","Mechanized",0,"Tue","weekday","no_sled","Washington Gulch",NA,NA,NA,5.1,NA,22,0,19,23.2,0,0,0,0,0,0,0,0
"14411",2021-01-19,"Washington Gulch","w2021","Motorized",5,"Tue","weekday","sled","Washington Gulch",NA,NA,NA,5.1,NA,22,0,19,23.2,0,0,0,0,0,0,0,0
"14412",2021-01-19,"Washington Gulch","w2021","Hybrid",0,"Tue","weekday","sled","Washington Gulch",NA,NA,NA,5.1,NA,22,0,19,23.2,0,0,0,0,0,0,0,0
"14413",2021-01-20,"Washington Gulch","w2021","Non.motorized",23,"Wed","weekday","no_sled","Washington Gulch",NA,NA,NA,5.2,NA,23,1,26,22.6,0,0,0,0,1,1,1,1
"14414",2021-01-20,"Washington Gulch","w2021","Mechanized",0,"Wed","weekday","no_sled","Washington Gulch",NA,NA,NA,5.2,NA,23,1,26,22.6,0,0,0,0,1,1,1,1
"14415",2021-01-20,"Washington Gulch","w2021","Motorized",7,"Wed","weekday","sled","Washington Gulch",NA,NA,NA,5.2,NA,23,1,26,22.6,0,0,0,0,1,1,1,1
"14416",2021-01-20,"Washington Gulch","w2021","Hybrid",0,"Wed","weekday","sled","Washington Gulch",NA,NA,NA,5.2,NA,23,1,26,22.6,0,0,0,0,1,1,1,1
"14417",2021-01-21,"Washington Gulch","w2021","Non.motorized",23,"Thu","weekday","no_sled","Washington Gulch",NA,NA,NA,5.2,NA,23,0,26,22.6,1,0,0,0,1,1,1,1
"14418",2021-01-21,"Washington Gulch","w2021","Mechanized",1,"Thu","weekday","no_sled","Washington Gulch",NA,NA,NA,5.2,NA,23,0,26,22.6,1,0,0,0,1,1,1,1
"14419",2021-01-21,"Washington Gulch","w2021","Motorized",4,"Thu","weekday","sled","Washington Gulch",NA,NA,NA,5.2,NA,23,0,26,22.6,1,0,0,0,1,1,1,1
"14420",2021-01-21,"Washington Gulch","w2021","Hybrid",1,"Thu","weekday","sled","Washington Gulch",NA,NA,NA,5.2,NA,23,0,26,22.6,1,0,0,0,1,1,1,1
"14421",2021-01-22,"Washington Gulch","w2021","Non.motorized",19,"Fri","weekday","no_sled","Washington Gulch",NA,NA,NA,5.3,NA,25,2,25,21.2,0,1,0,0,2,3,3,3
"14422",2021-01-22,"Washington Gulch","w2021","Mechanized",0,"Fri","weekday","no_sled","Washington Gulch",NA,NA,NA,5.3,NA,25,2,25,21.2,0,1,0,0,2,3,3,3
"14423",2021-01-22,"Washington Gulch","w2021","Motorized",2,"Fri","weekday","sled","Washington Gulch",NA,NA,NA,5.3,NA,25,2,25,21.2,0,1,0,0,2,3,3,3
"14424",2021-01-22,"Washington Gulch","w2021","Hybrid",0,"Fri","weekday","sled","Washington Gulch",NA,NA,NA,5.3,NA,25,2,25,21.2,0,1,0,0,2,3,3,3
"14425",2021-01-23,"Washington Gulch","w2021","Non.motorized",40,"Sat","weekend","no_sled","Washington Gulch",NA,NA,NA,5.4,NA,26,1,22,20.8,2,0,1,0,3,3,4,4
"14426",2021-01-23,"Washington Gulch","w2021","Mechanized",0,"Sat","weekend","no_sled","Washington Gulch",NA,NA,NA,5.4,NA,26,1,22,20.8,2,0,1,0,3,3,4,4
"14427",2021-01-23,"Washington Gulch","w2021","Motorized",3,"Sat","weekend","sled","Washington Gulch",NA,NA,NA,5.4,NA,26,1,22,20.8,2,0,1,0,3,3,4,4
"14428",2021-01-23,"Washington Gulch","w2021","Hybrid",0,"Sat","weekend","sled","Washington Gulch",NA,NA,NA,5.4,NA,26,1,22,20.8,2,0,1,0,3,3,4,4
"14429",2021-01-24,"Washington Gulch","w2021","Non.motorized",53,"Sun","weekend","no_sled","Washington Gulch",NA,NA,NA,5.6,NA,29,3,18,19.3,1,2,0,1,4,6,6,7
"14430",2021-01-24,"Washington Gulch","w2021","Mechanized",1,"Sun","weekend","no_sled","Washington Gulch",NA,NA,NA,5.6,NA,29,3,18,19.3,1,2,0,1,4,6,6,7
"14431",2021-01-24,"Washington Gulch","w2021","Motorized",4,"Sun","weekend","sled","Washington Gulch",NA,NA,NA,5.6,NA,29,3,18,19.3,1,2,0,1,4,6,6,7
"14432",2021-01-24,"Washington Gulch","w2021","Hybrid",0,"Sun","weekend","sled","Washington Gulch",NA,NA,NA,5.6,NA,29,3,18,19.3,1,2,0,1,4,6,6,7
"14433",2021-01-25,"Washington Gulch","w2021","Non.motorized",25,"Mon","weekday","no_sled","Washington Gulch",NA,NA,NA,5.8,NA,29,0,15,20,3,1,2,0,3,4,6,6
"14434",2021-01-25,"Washington Gulch","w2021","Mechanized",0,"Mon","weekday","no_sled","Washington Gulch",NA,NA,NA,5.8,NA,29,0,15,20,3,1,2,0,3,4,6,6
"14435",2021-01-25,"Washington Gulch","w2021","Motorized",2,"Mon","weekday","sled","Washington Gulch",NA,NA,NA,5.8,NA,29,0,15,20,3,1,2,0,3,4,6,6
"14436",2021-01-25,"Washington Gulch","w2021","Hybrid",0,"Mon","weekday","sled","Washington Gulch",NA,NA,NA,5.8,NA,29,0,15,20,3,1,2,0,3,4,6,6
"14437",2021-01-26,"Washington Gulch","w2021","Non.motorized",14,"Tue","weekday","no_sled","Washington Gulch",NA,NA,NA,5.9,NA,29,0,13,20.3,0,3,1,2,0,3,4,6
"14438",2021-01-26,"Washington Gulch","w2021","Mechanized",1,"Tue","weekday","no_sled","Washington Gulch",NA,NA,NA,5.9,NA,29,0,13,20.3,0,3,1,2,0,3,4,6
"14439",2021-01-26,"Washington Gulch","w2021","Motorized",5,"Tue","weekday","sled","Washington Gulch",NA,NA,NA,5.9,NA,29,0,13,20.3,0,3,1,2,0,3,4,6
"14440",2021-01-26,"Washington Gulch","w2021","Hybrid",0,"Tue","weekday","sled","Washington Gulch",NA,NA,NA,5.9,NA,29,0,13,20.3,0,3,1,2,0,3,4,6
"14441",2021-01-27,"Washington Gulch","w2021","Non.motorized",13,"Wed","weekday","no_sled","Washington Gulch",NA,NA,NA,6,NA,30,1,13,20,0,0,3,1,1,1,4,5
"14442",2021-01-27,"Washington Gulch","w2021","Mechanized",1,"Wed","weekday","no_sled","Washington Gulch",NA,NA,NA,6,NA,30,1,13,20,0,0,3,1,1,1,4,5
"14443",2021-01-27,"Washington Gulch","w2021","Motorized",1,"Wed","weekday","sled","Washington Gulch",NA,NA,NA,6,NA,30,1,13,20,0,0,3,1,1,1,4,5
"14444",2021-01-27,"Washington Gulch","w2021","Hybrid",0,"Wed","weekday","sled","Washington Gulch",NA,NA,NA,6,NA,30,1,13,20,0,0,3,1,1,1,4,5
"14445",2021-01-28,"Washington Gulch","w2021","Non.motorized",19,"Thu","weekday","no_sled","Washington Gulch",NA,NA,NA,6,NA,28,-2,27,21.4,1,0,0,3,-1,-1,-1,2
"14446",2021-01-28,"Washington Gulch","w2021","Mechanized",1,"Thu","weekday","no_sled","Washington Gulch",NA,NA,NA,6,NA,28,-2,27,21.4,1,0,0,3,-1,-1,-1,2
"14447",2021-01-28,"Washington Gulch","w2021","Motorized",6,"Thu","weekday","sled","Washington Gulch",NA,NA,NA,6,NA,28,-2,27,21.4,1,0,0,3,-1,-1,-1,2
"14448",2021-01-28,"Washington Gulch","w2021","Hybrid",0,"Thu","weekday","sled","Washington Gulch",NA,NA,NA,6,NA,28,-2,27,21.4,1,0,0,3,-1,-1,-1,2
"14449",2021-01-29,"Washington Gulch","w2021","Non.motorized",24,"Fri","weekday","no_sled","Washington Gulch",NA,NA,NA,6.1,NA,28,0,29,21.8,-2,1,0,0,-2,-1,-1,-1
"14450",2021-01-29,"Washington Gulch","w2021","Mechanized",0,"Fri","weekday","no_sled","Washington Gulch",NA,NA,NA,6.1,NA,28,0,29,21.8,-2,1,0,0,-2,-1,-1,-1
"14451",2021-01-29,"Washington Gulch","w2021","Motorized",3,"Fri","weekday","sled","Washington Gulch",NA,NA,NA,6.1,NA,28,0,29,21.8,-2,1,0,0,-2,-1,-1,-1
"14452",2021-01-29,"Washington Gulch","w2021","Hybrid",1,"Fri","weekday","sled","Washington Gulch",NA,NA,NA,6.1,NA,28,0,29,21.8,-2,1,0,0,-2,-1,-1,-1
"14453",2021-01-30,"Washington Gulch","w2021","Non.motorized",84,"Sat","weekend","no_sled","Washington Gulch",NA,NA,NA,6.2,NA,29,1,21,21.4,0,-2,1,0,1,-1,0,0
"14454",2021-01-30,"Washington Gulch","w2021","Mechanized",1,"Sat","weekend","no_sled","Washington Gulch",NA,NA,NA,6.2,NA,29,1,21,21.4,0,-2,1,0,1,-1,0,0
"14455",2021-01-30,"Washington Gulch","w2021","Motorized",11,"Sat","weekend","sled","Washington Gulch",NA,NA,NA,6.2,NA,29,1,21,21.4,0,-2,1,0,1,-1,0,0
"14456",2021-01-30,"Washington Gulch","w2021","Hybrid",0,"Sat","weekend","sled","Washington Gulch",NA,NA,NA,6.2,NA,29,1,21,21.4,0,-2,1,0,1,-1,0,0
"14457",2021-01-31,"Washington Gulch","w2021","Non.motorized",64,"Sun","weekend","no_sled","Washington Gulch",NA,NA,NA,6.3,NA,29,0,21,21.7,1,0,-2,1,1,1,-1,0
"14458",2021-01-31,"Washington Gulch","w2021","Mechanized",1,"Sun","weekend","no_sled","Washington Gulch",NA,NA,NA,6.3,NA,29,0,21,21.7,1,0,-2,1,1,1,-1,0
"14459",2021-01-31,"Washington Gulch","w2021","Motorized",6,"Sun","weekend","sled","Washington Gulch",NA,NA,NA,6.3,NA,29,0,21,21.7,1,0,-2,1,1,1,-1,0
"14460",2021-01-31,"Washington Gulch","w2021","Hybrid",0,"Sun","weekend","sled","Washington Gulch",NA,NA,NA,6.3,NA,29,0,21,21.7,1,0,-2,1,1,1,-1,0
"14461",2021-02-01,"Washington Gulch","w2021","Non.motorized",38,"Mon","weekday","no_sled","Washington Gulch",NA,NA,NA,6.3,NA,28,-1,30,22.5,0,1,0,-2,-1,0,0,-2
"14462",2021-02-01,"Washington Gulch","w2021","Mechanized",0,"Mon","weekday","no_sled","Washington Gulch",NA,NA,NA,6.3,NA,28,-1,30,22.5,0,1,0,-2,-1,0,0,-2
"14463",2021-02-01,"Washington Gulch","w2021","Motorized",3,"Mon","weekday","sled","Washington Gulch",NA,NA,NA,6.3,NA,28,-1,30,22.5,0,1,0,-2,-1,0,0,-2
"14464",2021-02-01,"Washington Gulch","w2021","Hybrid",1,"Mon","weekday","sled","Washington Gulch",NA,NA,NA,6.3,NA,28,-1,30,22.5,0,1,0,-2,-1,0,0,-2
"14465",2021-02-02,"Washington Gulch","w2021","Non.motorized",26,"Tue","weekday","no_sled","Washington Gulch",NA,NA,NA,6.3,NA,28,0,34,22.5,-1,0,1,0,-1,-1,0,0
"14466",2021-02-02,"Washington Gulch","w2021","Mechanized",0,"Tue","weekday","no_sled","Washington Gulch",NA,NA,NA,6.3,NA,28,0,34,22.5,-1,0,1,0,-1,-1,0,0
"14467",2021-02-02,"Washington Gulch","w2021","Motorized",0,"Tue","weekday","sled","Washington Gulch",NA,NA,NA,6.3,NA,28,0,34,22.5,-1,0,1,0,-1,-1,0,0
"14468",2021-02-02,"Washington Gulch","w2021","Hybrid",0,"Tue","weekday","sled","Washington Gulch",NA,NA,NA,6.3,NA,28,0,34,22.5,-1,0,1,0,-1,-1,0,0
"14469",2021-02-03,"Washington Gulch","w2021","Non.motorized",NA,"Wed","weekday","no_sled","Washington Gulch",NA,NA,NA,6.3,NA,27,-1,30,23.3,0,-1,0,1,-1,-2,-2,-1
"14470",2021-02-03,"Washington Gulch","w2021","Mechanized",NA,"Wed","weekday","no_sled","Washington Gulch",NA,NA,NA,6.3,NA,27,-1,30,23.3,0,-1,0,1,-1,-2,-2,-1
"14471",2021-02-03,"Washington Gulch","w2021","Motorized",NA,"Wed","weekday","sled","Washington Gulch",NA,NA,NA,6.3,NA,27,-1,30,23.3,0,-1,0,1,-1,-2,-2,-1
"14472",2021-02-03,"Washington Gulch","w2021","Hybrid",NA,"Wed","weekday","sled","Washington Gulch",NA,NA,NA,6.3,NA,27,-1,30,23.3,0,-1,0,1,-1,-2,-2,-1
"14473",2021-02-04,"Washington Gulch","w2021","Non.motorized",NA,"Thu","weekday","no_sled","Washington Gulch",NA,NA,NA,7.2,NA,37,10,14,19.5,-1,0,-1,0,9,9,8,8
"14474",2021-02-04,"Washington Gulch","w2021","Mechanized",NA,"Thu","weekday","no_sled","Washington Gulch",NA,NA,NA,7.2,NA,37,10,14,19.5,-1,0,-1,0,9,9,8,8
"14475",2021-02-04,"Washington Gulch","w2021","Motorized",NA,"Thu","weekday","sled","Washington Gulch",NA,NA,NA,7.2,NA,37,10,14,19.5,-1,0,-1,0,9,9,8,8
"14476",2021-02-04,"Washington Gulch","w2021","Hybrid",NA,"Thu","weekday","sled","Washington Gulch",NA,NA,NA,7.2,NA,37,10,14,19.5,-1,0,-1,0,9,9,8,8
"14477",2021-02-05,"Washington Gulch","w2021","Non.motorized",26,"Fri","weekday","no_sled","Washington Gulch",NA,NA,NA,7.2,NA,35,-2,16,20.6,10,-1,0,-1,8,7,7,6
"14478",2021-02-05,"Washington Gulch","w2021","Mechanized",0,"Fri","weekday","no_sled","Washington Gulch",NA,NA,NA,7.2,NA,35,-2,16,20.6,10,-1,0,-1,8,7,7,6
"14479",2021-02-05,"Washington Gulch","w2021","Motorized",3,"Fri","weekday","sled","Washington Gulch",NA,NA,NA,7.2,NA,35,-2,16,20.6,10,-1,0,-1,8,7,7,6
"14480",2021-02-05,"Washington Gulch","w2021","Hybrid",0,"Fri","weekday","sled","Washington Gulch",NA,NA,NA,7.2,NA,35,-2,16,20.6,10,-1,0,-1,8,7,7,6
"14481",2021-02-06,"Washington Gulch","w2021","Non.motorized",29,"Sat","weekend","no_sled","Washington Gulch",NA,NA,NA,7.5,NA,37,2,19,20.3,-2,10,-1,0,0,10,9,9
"14482",2021-02-06,"Washington Gulch","w2021","Mechanized",0,"Sat","weekend","no_sled","Washington Gulch",NA,NA,NA,7.5,NA,37,2,19,20.3,-2,10,-1,0,0,10,9,9
"14483",2021-02-06,"Washington Gulch","w2021","Motorized",0,"Sat","weekend","sled","Washington Gulch",NA,NA,NA,7.5,NA,37,2,19,20.3,-2,10,-1,0,0,10,9,9
"14484",2021-02-06,"Washington Gulch","w2021","Hybrid",1,"Sat","weekend","sled","Washington Gulch",NA,NA,NA,7.5,NA,37,2,19,20.3,-2,10,-1,0,0,10,9,9
"14485",2021-02-07,"Washington Gulch","w2021","Non.motorized",68,"Sun","weekend","no_sled","Washington Gulch",NA,NA,NA,7.5,NA,36,-1,24,20.8,2,-2,10,-1,1,-1,9,8
"14486",2021-02-07,"Washington Gulch","w2021","Mechanized",2,"Sun","weekend","no_sled","Washington Gulch",NA,NA,NA,7.5,NA,36,-1,24,20.8,2,-2,10,-1,1,-1,9,8
"14487",2021-02-07,"Washington Gulch","w2021","Motorized",2,"Sun","weekend","sled","Washington Gulch",NA,NA,NA,7.5,NA,36,-1,24,20.8,2,-2,10,-1,1,-1,9,8
"14488",2021-02-07,"Washington Gulch","w2021","Hybrid",2,"Sun","weekend","sled","Washington Gulch",NA,NA,NA,7.5,NA,36,-1,24,20.8,2,-2,10,-1,1,-1,9,8
"14489",2021-02-08,"Washington Gulch","w2021","Non.motorized",33,"Mon","weekday","no_sled","Washington Gulch",NA,NA,NA,7.6,NA,35,-1,28,21.7,-1,2,-2,10,-2,0,-2,8
"14490",2021-02-08,"Washington Gulch","w2021","Mechanized",0,"Mon","weekday","no_sled","Washington Gulch",NA,NA,NA,7.6,NA,35,-1,28,21.7,-1,2,-2,10,-2,0,-2,8
"14491",2021-02-08,"Washington Gulch","w2021","Motorized",0,"Mon","weekday","sled","Washington Gulch",NA,NA,NA,7.6,NA,35,-1,28,21.7,-1,2,-2,10,-2,0,-2,8
"14492",2021-02-08,"Washington Gulch","w2021","Hybrid",0,"Mon","weekday","sled","Washington Gulch",NA,NA,NA,7.6,NA,35,-1,28,21.7,-1,2,-2,10,-2,0,-2,8
"14493",2021-02-09,"Washington Gulch","w2021","Non.motorized",17,"Tue","weekday","no_sled","Washington Gulch",NA,NA,NA,7.6,NA,34,-1,28,22.4,-1,-1,2,-2,-2,-3,-1,-3
"14494",2021-02-09,"Washington Gulch","w2021","Mechanized",0,"Tue","weekday","no_sled","Washington Gulch",NA,NA,NA,7.6,NA,34,-1,28,22.4,-1,-1,2,-2,-2,-3,-1,-3
"14495",2021-02-09,"Washington Gulch","w2021","Motorized",0,"Tue","weekday","sled","Washington Gulch",NA,NA,NA,7.6,NA,34,-1,28,22.4,-1,-1,2,-2,-2,-3,-1,-3
"14496",2021-02-09,"Washington Gulch","w2021","Hybrid",0,"Tue","weekday","sled","Washington Gulch",NA,NA,NA,7.6,NA,34,-1,28,22.4,-1,-1,2,-2,-2,-3,-1,-3
"14497",2021-02-10,"Washington Gulch","w2021","Non.motorized",15,"Wed","weekday","no_sled","Washington Gulch",NA,NA,NA,7.7,NA,34,0,26,22.6,-1,-1,-1,2,-1,-2,-3,-1
"14498",2021-02-10,"Washington Gulch","w2021","Mechanized",0,"Wed","weekday","no_sled","Washington Gulch",NA,NA,NA,7.7,NA,34,0,26,22.6,-1,-1,-1,2,-1,-2,-3,-1
"14499",2021-02-10,"Washington Gulch","w2021","Motorized",1,"Wed","weekday","sled","Washington Gulch",NA,NA,NA,7.7,NA,34,0,26,22.6,-1,-1,-1,2,-1,-2,-3,-1
"14500",2021-02-10,"Washington Gulch","w2021","Hybrid",0,"Wed","weekday","sled","Washington Gulch",NA,NA,NA,7.7,NA,34,0,26,22.6,-1,-1,-1,2,-1,-2,-3,-1
"14501",2021-02-11,"Washington Gulch","w2021","Non.motorized",33,"Thu","weekday","no_sled","Washington Gulch",NA,NA,NA,8,NA,37,3,26,21.6,0,-1,-1,-1,3,2,1,0
"14502",2021-02-11,"Washington Gulch","w2021","Mechanized",0,"Thu","weekday","no_sled","Washington Gulch",NA,NA,NA,8,NA,37,3,26,21.6,0,-1,-1,-1,3,2,1,0
"14503",2021-02-11,"Washington Gulch","w2021","Motorized",0,"Thu","weekday","sled","Washington Gulch",NA,NA,NA,8,NA,37,3,26,21.6,0,-1,-1,-1,3,2,1,0
"14504",2021-02-11,"Washington Gulch","w2021","Hybrid",0,"Thu","weekday","sled","Washington Gulch",NA,NA,NA,8,NA,37,3,26,21.6,0,-1,-1,-1,3,2,1,0
"14505",2021-02-12,"Washington Gulch","w2021","Non.motorized",4,"Fri","weekday","no_sled","Washington Gulch",NA,NA,NA,8.1,NA,37,0,27,21.9,3,0,-1,-1,3,3,2,1
"14506",2021-02-12,"Washington Gulch","w2021","Mechanized",0,"Fri","weekday","no_sled","Washington Gulch",NA,NA,NA,8.1,NA,37,0,27,21.9,3,0,-1,-1,3,3,2,1
"14507",2021-02-12,"Washington Gulch","w2021","Motorized",1,"Fri","weekday","sled","Washington Gulch",NA,NA,NA,8.1,NA,37,0,27,21.9,3,0,-1,-1,3,3,2,1
"14508",2021-02-12,"Washington Gulch","w2021","Hybrid",0,"Fri","weekday","sled","Washington Gulch",NA,NA,NA,8.1,NA,37,0,27,21.9,3,0,-1,-1,3,3,2,1
"14509",2021-02-13,"Washington Gulch","w2021","Non.motorized",47,"Sat","weekend","no_sled","Washington Gulch",NA,NA,NA,8.4,NA,38,1,26,22.1,0,3,0,-1,1,4,4,3
"14510",2021-02-13,"Washington Gulch","w2021","Mechanized",1,"Sat","weekend","no_sled","Washington Gulch",NA,NA,NA,8.4,NA,38,1,26,22.1,0,3,0,-1,1,4,4,3
"14511",2021-02-13,"Washington Gulch","w2021","Motorized",2,"Sat","weekend","sled","Washington Gulch",NA,NA,NA,8.4,NA,38,1,26,22.1,0,3,0,-1,1,4,4,3
"14512",2021-02-13,"Washington Gulch","w2021","Hybrid",3,"Sat","weekend","sled","Washington Gulch",NA,NA,NA,8.4,NA,38,1,26,22.1,0,3,0,-1,1,4,4,3
"14513",2021-02-14,"Washington Gulch","w2021","Non.motorized",62,"Sun","weekend","no_sled","Washington Gulch",NA,NA,NA,8.9,NA,43,5,18,20.7,1,0,3,0,6,6,9,9
"14514",2021-02-14,"Washington Gulch","w2021","Mechanized",1,"Sun","weekend","no_sled","Washington Gulch",NA,NA,NA,8.9,NA,43,5,18,20.7,1,0,3,0,6,6,9,9
"14515",2021-02-14,"Washington Gulch","w2021","Motorized",5,"Sun","weekend","sled","Washington Gulch",NA,NA,NA,8.9,NA,43,5,18,20.7,1,0,3,0,6,6,9,9
"14516",2021-02-14,"Washington Gulch","w2021","Hybrid",3,"Sun","weekend","sled","Washington Gulch",NA,NA,NA,8.9,NA,43,5,18,20.7,1,0,3,0,6,6,9,9
"14517",2021-02-15,"Washington Gulch","w2021","Non.motorized",24,"Mon","weekday","no_sled","Washington Gulch",NA,NA,NA,8.9,NA,43,0,12,20.7,5,1,0,3,5,6,6,9
"14518",2021-02-15,"Washington Gulch","w2021","Mechanized",0,"Mon","weekday","no_sled","Washington Gulch",NA,NA,NA,8.9,NA,43,0,12,20.7,5,1,0,3,5,6,6,9
"14519",2021-02-15,"Washington Gulch","w2021","Motorized",2,"Mon","weekday","sled","Washington Gulch",NA,NA,NA,8.9,NA,43,0,12,20.7,5,1,0,3,5,6,6,9
"14520",2021-02-15,"Washington Gulch","w2021","Hybrid",1,"Mon","weekday","sled","Washington Gulch",NA,NA,NA,8.9,NA,43,0,12,20.7,5,1,0,3,5,6,6,9
"14521",2021-02-16,"Washington Gulch","w2021","Non.motorized",19,"Tue","weekday","no_sled","Washington Gulch",NA,NA,NA,9,NA,41,-2,17,22,0,5,1,0,-2,3,4,4
"14522",2021-02-16,"Washington Gulch","w2021","Mechanized",0,"Tue","weekday","no_sled","Washington Gulch",NA,NA,NA,9,NA,41,-2,17,22,0,5,1,0,-2,3,4,4
"14523",2021-02-16,"Washington Gulch","w2021","Motorized",6,"Tue","weekday","sled","Washington Gulch",NA,NA,NA,9,NA,41,-2,17,22,0,5,1,0,-2,3,4,4
"14524",2021-02-16,"Washington Gulch","w2021","Hybrid",0,"Tue","weekday","sled","Washington Gulch",NA,NA,NA,9,NA,41,-2,17,22,0,5,1,0,-2,3,4,4
"14525",2021-02-17,"Washington Gulch","w2021","Non.motorized",30,"Wed","weekday","no_sled","Washington Gulch",NA,NA,NA,9.1,NA,42,1,13,21.7,-2,0,5,1,-1,-1,4,5
"14526",2021-02-17,"Washington Gulch","w2021","Mechanized",1,"Wed","weekday","no_sled","Washington Gulch",NA,NA,NA,9.1,NA,42,1,13,21.7,-2,0,5,1,-1,-1,4,5
"14527",2021-02-17,"Washington Gulch","w2021","Motorized",1,"Wed","weekday","sled","Washington Gulch",NA,NA,NA,9.1,NA,42,1,13,21.7,-2,0,5,1,-1,-1,4,5
"14528",2021-02-17,"Washington Gulch","w2021","Hybrid",0,"Wed","weekday","sled","Washington Gulch",NA,NA,NA,9.1,NA,42,1,13,21.7,-2,0,5,1,-1,-1,4,5
"14529",2021-02-18,"Washington Gulch","w2021","Non.motorized",28,"Thu","weekday","no_sled","Washington Gulch",NA,NA,NA,9.1,NA,41,-1,11,22.2,1,-2,0,5,0,-2,-2,3
"14530",2021-02-18,"Washington Gulch","w2021","Mechanized",0,"Thu","weekday","no_sled","Washington Gulch",NA,NA,NA,9.1,NA,41,-1,11,22.2,1,-2,0,5,0,-2,-2,3
"14531",2021-02-18,"Washington Gulch","w2021","Motorized",0,"Thu","weekday","sled","Washington Gulch",NA,NA,NA,9.1,NA,41,-1,11,22.2,1,-2,0,5,0,-2,-2,3
"14532",2021-02-18,"Washington Gulch","w2021","Hybrid",4,"Thu","weekday","sled","Washington Gulch",NA,NA,NA,9.1,NA,41,-1,11,22.2,1,-2,0,5,0,-2,-2,3
"14533",2021-02-19,"Washington Gulch","w2021","Non.motorized",15,"Fri","weekday","no_sled","Washington Gulch",NA,NA,NA,9.1,NA,40,-1,18,22.8,-1,1,-2,0,-2,-1,-3,-3
"14534",2021-02-19,"Washington Gulch","w2021","Mechanized",2,"Fri","weekday","no_sled","Washington Gulch",NA,NA,NA,9.1,NA,40,-1,18,22.8,-1,1,-2,0,-2,-1,-3,-3
"14535",2021-02-19,"Washington Gulch","w2021","Motorized",0,"Fri","weekday","sled","Washington Gulch",NA,NA,NA,9.1,NA,40,-1,18,22.8,-1,1,-2,0,-2,-1,-3,-3
"14536",2021-02-19,"Washington Gulch","w2021","Hybrid",2,"Fri","weekday","sled","Washington Gulch",NA,NA,NA,9.1,NA,40,-1,18,22.8,-1,1,-2,0,-2,-1,-3,-3
"14537",2021-02-20,"Washington Gulch","w2021","Non.motorized",53,"Sat","weekend","no_sled","Washington Gulch",NA,NA,NA,9.2,NA,39,-1,23,23.6,-1,-1,1,-2,-2,-3,-2,-4
"14538",2021-02-20,"Washington Gulch","w2021","Mechanized",0,"Sat","weekend","no_sled","Washington Gulch",NA,NA,NA,9.2,NA,39,-1,23,23.6,-1,-1,1,-2,-2,-3,-2,-4
"14539",2021-02-20,"Washington Gulch","w2021","Motorized",1,"Sat","weekend","sled","Washington Gulch",NA,NA,NA,9.2,NA,39,-1,23,23.6,-1,-1,1,-2,-2,-3,-2,-4
"14540",2021-02-20,"Washington Gulch","w2021","Hybrid",0,"Sat","weekend","sled","Washington Gulch",NA,NA,NA,9.2,NA,39,-1,23,23.6,-1,-1,1,-2,-2,-3,-2,-4
"14541",2021-02-21,"Washington Gulch","w2021","Non.motorized",66,"Sun","weekend","no_sled","Washington Gulch",NA,NA,NA,9.2,NA,39,0,15,23.6,-1,-1,-1,1,-1,-2,-3,-2
"14542",2021-02-21,"Washington Gulch","w2021","Mechanized",0,"Sun","weekend","no_sled","Washington Gulch",NA,NA,NA,9.2,NA,39,0,15,23.6,-1,-1,-1,1,-1,-2,-3,-2
"14543",2021-02-21,"Washington Gulch","w2021","Motorized",3,"Sun","weekend","sled","Washington Gulch",NA,NA,NA,9.2,NA,39,0,15,23.6,-1,-1,-1,1,-1,-2,-3,-2
"14544",2021-02-21,"Washington Gulch","w2021","Hybrid",5,"Sun","weekend","sled","Washington Gulch",NA,NA,NA,9.2,NA,39,0,15,23.6,-1,-1,-1,1,-1,-2,-3,-2
"14545",2021-02-22,"Washington Gulch","w2021","Non.motorized",23,"Mon","weekday","no_sled","Washington Gulch",NA,NA,NA,9.2,NA,39,0,23,23.6,0,-1,-1,-1,0,-1,-2,-3
"14546",2021-02-22,"Washington Gulch","w2021","Mechanized",2,"Mon","weekday","no_sled","Washington Gulch",NA,NA,NA,9.2,NA,39,0,23,23.6,0,-1,-1,-1,0,-1,-2,-3
"14547",2021-02-22,"Washington Gulch","w2021","Motorized",2,"Mon","weekday","sled","Washington Gulch",NA,NA,NA,9.2,NA,39,0,23,23.6,0,-1,-1,-1,0,-1,-2,-3
"14548",2021-02-22,"Washington Gulch","w2021","Hybrid",3,"Mon","weekday","sled","Washington Gulch",NA,NA,NA,9.2,NA,39,0,23,23.6,0,-1,-1,-1,0,-1,-2,-3
"14549",2021-02-23,"Washington Gulch","w2021","Non.motorized",28,"Tue","weekday","no_sled","Washington Gulch",NA,NA,NA,9.2,NA,38,-1,28,24.2,0,0,-1,-1,-1,-1,-2,-3
"14550",2021-02-23,"Washington Gulch","w2021","Mechanized",0,"Tue","weekday","no_sled","Washington Gulch",NA,NA,NA,9.2,NA,38,-1,28,24.2,0,0,-1,-1,-1,-1,-2,-3
"14551",2021-02-23,"Washington Gulch","w2021","Motorized",0,"Tue","weekday","sled","Washington Gulch",NA,NA,NA,9.2,NA,38,-1,28,24.2,0,0,-1,-1,-1,-1,-2,-3
"14552",2021-02-23,"Washington Gulch","w2021","Hybrid",1,"Tue","weekday","sled","Washington Gulch",NA,NA,NA,9.2,NA,38,-1,28,24.2,0,0,-1,-1,-1,-1,-2,-3
"14553",2021-02-24,"Washington Gulch","w2021","Non.motorized",31,"Wed","weekday","no_sled","Washington Gulch",NA,NA,NA,9.2,NA,38,0,23,24.2,-1,0,0,-1,-1,-1,-1,-2
"14554",2021-02-24,"Washington Gulch","w2021","Mechanized",0,"Wed","weekday","no_sled","Washington Gulch",NA,NA,NA,9.2,NA,38,0,23,24.2,-1,0,0,-1,-1,-1,-1,-2
"14555",2021-02-24,"Washington Gulch","w2021","Motorized",2,"Wed","weekday","sled","Washington Gulch",NA,NA,NA,9.2,NA,38,0,23,24.2,-1,0,0,-1,-1,-1,-1,-2
"14556",2021-02-24,"Washington Gulch","w2021","Hybrid",1,"Wed","weekday","sled","Washington Gulch",NA,NA,NA,9.2,NA,38,0,23,24.2,-1,0,0,-1,-1,-1,-1,-2
"14557",2021-02-25,"Washington Gulch","w2021","Non.motorized",23,"Thu","weekday","no_sled","Washington Gulch",NA,NA,NA,9.2,NA,37,-1,20,24.9,0,-1,0,0,-1,-2,-2,-2
"14558",2021-02-25,"Washington Gulch","w2021","Mechanized",0,"Thu","weekday","no_sled","Washington Gulch",NA,NA,NA,9.2,NA,37,-1,20,24.9,0,-1,0,0,-1,-2,-2,-2
"14559",2021-02-25,"Washington Gulch","w2021","Motorized",3,"Thu","weekday","sled","Washington Gulch",NA,NA,NA,9.2,NA,37,-1,20,24.9,0,-1,0,0,-1,-2,-2,-2
"14560",2021-02-25,"Washington Gulch","w2021","Hybrid",1,"Thu","weekday","sled","Washington Gulch",NA,NA,NA,9.2,NA,37,-1,20,24.9,0,-1,0,0,-1,-2,-2,-2
"14561",2021-02-26,"Washington Gulch","w2021","Non.motorized",26,"Fri","weekday","no_sled","Washington Gulch",NA,NA,NA,9.2,NA,37,0,21,24.9,-1,0,-1,0,-1,-1,-2,-2
"14562",2021-02-26,"Washington Gulch","w2021","Mechanized",0,"Fri","weekday","no_sled","Washington Gulch",NA,NA,NA,9.2,NA,37,0,21,24.9,-1,0,-1,0,-1,-1,-2,-2
"14563",2021-02-26,"Washington Gulch","w2021","Motorized",4,"Fri","weekday","sled","Washington Gulch",NA,NA,NA,9.2,NA,37,0,21,24.9,-1,0,-1,0,-1,-1,-2,-2
"14564",2021-02-26,"Washington Gulch","w2021","Hybrid",5,"Fri","weekday","sled","Washington Gulch",NA,NA,NA,9.2,NA,37,0,21,24.9,-1,0,-1,0,-1,-1,-2,-2
"14565",2021-02-27,"Washington Gulch","w2021","Non.motorized",21,"Sat","weekend","no_sled","Washington Gulch",NA,NA,NA,9.2,NA,37,0,15,24.9,0,-1,0,-1,0,-1,-1,-2
"14566",2021-02-27,"Washington Gulch","w2021","Mechanized",0,"Sat","weekend","no_sled","Washington Gulch",NA,NA,NA,9.2,NA,37,0,15,24.9,0,-1,0,-1,0,-1,-1,-2
"14567",2021-02-27,"Washington Gulch","w2021","Motorized",3,"Sat","weekend","sled","Washington Gulch",NA,NA,NA,9.2,NA,37,0,15,24.9,0,-1,0,-1,0,-1,-1,-2
"14568",2021-02-27,"Washington Gulch","w2021","Hybrid",0,"Sat","weekend","sled","Washington Gulch",NA,NA,NA,9.2,NA,37,0,15,24.9,0,-1,0,-1,0,-1,-1,-2
"14569",2021-02-28,"Washington Gulch","w2021","Non.motorized",69,"Sun","weekend","no_sled","Washington Gulch",NA,NA,NA,9.2,NA,38,1,9,24.2,0,0,-1,0,1,1,0,0
"14570",2021-02-28,"Washington Gulch","w2021","Mechanized",0,"Sun","weekend","no_sled","Washington Gulch",NA,NA,NA,9.2,NA,38,1,9,24.2,0,0,-1,0,1,1,0,0
"14571",2021-02-28,"Washington Gulch","w2021","Motorized",3,"Sun","weekend","sled","Washington Gulch",NA,NA,NA,9.2,NA,38,1,9,24.2,0,0,-1,0,1,1,0,0
"14572",2021-02-28,"Washington Gulch","w2021","Hybrid",10,"Sun","weekend","sled","Washington Gulch",NA,NA,NA,9.2,NA,38,1,9,24.2,0,0,-1,0,1,1,0,0
"14573",2021-03-01,"Washington Gulch","w2021","Non.motorized",29,"Mon","weekday","no_sled","Washington Gulch",NA,NA,NA,9.2,NA,37,-1,20,24.9,1,0,0,-1,0,0,0,-1
"14574",2021-03-01,"Washington Gulch","w2021","Mechanized",0,"Mon","weekday","no_sled","Washington Gulch",NA,NA,NA,9.2,NA,37,-1,20,24.9,1,0,0,-1,0,0,0,-1
"14575",2021-03-01,"Washington Gulch","w2021","Motorized",1,"Mon","weekday","sled","Washington Gulch",NA,NA,NA,9.2,NA,37,-1,20,24.9,1,0,0,-1,0,0,0,-1
"14576",2021-03-01,"Washington Gulch","w2021","Hybrid",1,"Mon","weekday","sled","Washington Gulch",NA,NA,NA,9.2,NA,37,-1,20,24.9,1,0,0,-1,0,0,0,-1
"14577",2021-03-02,"Washington Gulch","w2021","Non.motorized",33,"Tue","weekday","no_sled","Washington Gulch",NA,NA,NA,9.2,NA,36,-1,27,25.6,-1,1,0,0,-2,-1,-1,-1
"14578",2021-03-02,"Washington Gulch","w2021","Mechanized",0,"Tue","weekday","no_sled","Washington Gulch",NA,NA,NA,9.2,NA,36,-1,27,25.6,-1,1,0,0,-2,-1,-1,-1
"14579",2021-03-02,"Washington Gulch","w2021","Motorized",2,"Tue","weekday","sled","Washington Gulch",NA,NA,NA,9.2,NA,36,-1,27,25.6,-1,1,0,0,-2,-1,-1,-1
"14580",2021-03-02,"Washington Gulch","w2021","Hybrid",0,"Tue","weekday","sled","Washington Gulch",NA,NA,NA,9.2,NA,36,-1,27,25.6,-1,1,0,0,-2,-1,-1,-1
"14581",2021-03-03,"Washington Gulch","w2021","Non.motorized",36,"Wed","weekday","no_sled","Washington Gulch",NA,NA,NA,9.2,NA,36,0,31,25.6,-1,-1,1,0,-1,-2,-1,-1
"14582",2021-03-03,"Washington Gulch","w2021","Mechanized",0,"Wed","weekday","no_sled","Washington Gulch",NA,NA,NA,9.2,NA,36,0,31,25.6,-1,-1,1,0,-1,-2,-1,-1
"14583",2021-03-03,"Washington Gulch","w2021","Motorized",5,"Wed","weekday","sled","Washington Gulch",NA,NA,NA,9.2,NA,36,0,31,25.6,-1,-1,1,0,-1,-2,-1,-1
"14584",2021-03-03,"Washington Gulch","w2021","Hybrid",3,"Wed","weekday","sled","Washington Gulch",NA,NA,NA,9.2,NA,36,0,31,25.6,-1,-1,1,0,-1,-2,-1,-1
"14585",2021-03-04,"Washington Gulch","w2021","Non.motorized",17,"Thu","weekday","no_sled","Washington Gulch",NA,NA,NA,9.2,NA,36,0,28,25.6,0,-1,-1,1,0,-1,-2,-1
"14586",2021-03-04,"Washington Gulch","w2021","Mechanized",0,"Thu","weekday","no_sled","Washington Gulch",NA,NA,NA,9.2,NA,36,0,28,25.6,0,-1,-1,1,0,-1,-2,-1
"14587",2021-03-04,"Washington Gulch","w2021","Motorized",1,"Thu","weekday","sled","Washington Gulch",NA,NA,NA,9.2,NA,36,0,28,25.6,0,-1,-1,1,0,-1,-2,-1
"14588",2021-03-04,"Washington Gulch","w2021","Hybrid",0,"Thu","weekday","sled","Washington Gulch",NA,NA,NA,9.2,NA,36,0,28,25.6,0,-1,-1,1,0,-1,-2,-1
"14589",2021-03-05,"Washington Gulch","w2021","Non.motorized",41,"Fri","weekday","no_sled","Washington Gulch",NA,NA,NA,9.4,NA,39,3,30,24.1,0,0,-1,-1,3,3,2,1
"14590",2021-03-05,"Washington Gulch","w2021","Mechanized",0,"Fri","weekday","no_sled","Washington Gulch",NA,NA,NA,9.4,NA,39,3,30,24.1,0,0,-1,-1,3,3,2,1
"14591",2021-03-05,"Washington Gulch","w2021","Motorized",0,"Fri","weekday","sled","Washington Gulch",NA,NA,NA,9.4,NA,39,3,30,24.1,0,0,-1,-1,3,3,2,1
"14592",2021-03-05,"Washington Gulch","w2021","Hybrid",0,"Fri","weekday","sled","Washington Gulch",NA,NA,NA,9.4,NA,39,3,30,24.1,0,0,-1,-1,3,3,2,1
"14593",2021-03-06,"Washington Gulch","w2021","Non.motorized",53,"Sat","weekend","no_sled","Washington Gulch",NA,NA,NA,9.4,NA,38,-1,32,24.7,3,0,0,-1,2,2,2,1
"14594",2021-03-06,"Washington Gulch","w2021","Mechanized",0,"Sat","weekend","no_sled","Washington Gulch",NA,NA,NA,9.4,NA,38,-1,32,24.7,3,0,0,-1,2,2,2,1
"14595",2021-03-06,"Washington Gulch","w2021","Motorized",5,"Sat","weekend","sled","Washington Gulch",NA,NA,NA,9.4,NA,38,-1,32,24.7,3,0,0,-1,2,2,2,1
"14596",2021-03-06,"Washington Gulch","w2021","Hybrid",8,"Sat","weekend","sled","Washington Gulch",NA,NA,NA,9.4,NA,38,-1,32,24.7,3,0,0,-1,2,2,2,1
"14597",2021-03-07,"Washington Gulch","w2021","Non.motorized",52,"Sun","weekend","no_sled","Washington Gulch",NA,NA,NA,9.4,NA,37,-1,35,25.4,-1,3,0,0,-2,1,1,1
"14598",2021-03-07,"Washington Gulch","w2021","Mechanized",0,"Sun","weekend","no_sled","Washington Gulch",NA,NA,NA,9.4,NA,37,-1,35,25.4,-1,3,0,0,-2,1,1,1
"14599",2021-03-07,"Washington Gulch","w2021","Motorized",11,"Sun","weekend","sled","Washington Gulch",NA,NA,NA,9.4,NA,37,-1,35,25.4,-1,3,0,0,-2,1,1,1
"14600",2021-03-07,"Washington Gulch","w2021","Hybrid",2,"Sun","weekend","sled","Washington Gulch",NA,NA,NA,9.4,NA,37,-1,35,25.4,-1,3,0,0,-2,1,1,1
"14601",2021-03-08,"Washington Gulch","w2021","Non.motorized",15,"Mon","weekday","no_sled","Washington Gulch",NA,NA,NA,9.5,NA,37,0,33,25.7,-1,-1,3,0,-1,-2,1,1
"14602",2021-03-08,"Washington Gulch","w2021","Mechanized",0,"Mon","weekday","no_sled","Washington Gulch",NA,NA,NA,9.5,NA,37,0,33,25.7,-1,-1,3,0,-1,-2,1,1
"14603",2021-03-08,"Washington Gulch","w2021","Motorized",0,"Mon","weekday","sled","Washington Gulch",NA,NA,NA,9.5,NA,37,0,33,25.7,-1,-1,3,0,-1,-2,1,1
"14604",2021-03-08,"Washington Gulch","w2021","Hybrid",0,"Mon","weekday","sled","Washington Gulch",NA,NA,NA,9.5,NA,37,0,33,25.7,-1,-1,3,0,-1,-2,1,1
"14605",2021-03-09,"Washington Gulch","w2021","Non.motorized",25,"Tue","weekday","no_sled","Washington Gulch",NA,NA,NA,9.5,NA,37,0,33,25.7,0,-1,-1,3,0,-1,-2,1
"14606",2021-03-09,"Washington Gulch","w2021","Mechanized",0,"Tue","weekday","no_sled","Washington Gulch",NA,NA,NA,9.5,NA,37,0,33,25.7,0,-1,-1,3,0,-1,-2,1
"14607",2021-03-09,"Washington Gulch","w2021","Motorized",1,"Tue","weekday","sled","Washington Gulch",NA,NA,NA,9.5,NA,37,0,33,25.7,0,-1,-1,3,0,-1,-2,1
"14608",2021-03-09,"Washington Gulch","w2021","Hybrid",3,"Tue","weekday","sled","Washington Gulch",NA,NA,NA,9.5,NA,37,0,33,25.7,0,-1,-1,3,0,-1,-2,1
"14609",2021-03-10,"Washington Gulch","w2021","Non.motorized",15,"Wed","weekday","no_sled","Washington Gulch",NA,NA,NA,9.7,NA,39,2,21,24.9,0,0,-1,-1,2,2,1,0
"14610",2021-03-10,"Washington Gulch","w2021","Mechanized",0,"Wed","weekday","no_sled","Washington Gulch",NA,NA,NA,9.7,NA,39,2,21,24.9,0,0,-1,-1,2,2,1,0
"14611",2021-03-10,"Washington Gulch","w2021","Motorized",0,"Wed","weekday","sled","Washington Gulch",NA,NA,NA,9.7,NA,39,2,21,24.9,0,0,-1,-1,2,2,1,0
"14612",2021-03-10,"Washington Gulch","w2021","Hybrid",0,"Wed","weekday","sled","Washington Gulch",NA,NA,NA,9.7,NA,39,2,21,24.9,0,0,-1,-1,2,2,1,0
"14613",2021-03-11,"Washington Gulch","w2021","Non.motorized",19,"Thu","weekday","no_sled","Washington Gulch",NA,NA,NA,9.8,NA,40,1,22,24.5,2,0,0,-1,3,3,3,2
"14614",2021-03-11,"Washington Gulch","w2021","Mechanized",0,"Thu","weekday","no_sled","Washington Gulch",NA,NA,NA,9.8,NA,40,1,22,24.5,2,0,0,-1,3,3,3,2
"14615",2021-03-11,"Washington Gulch","w2021","Motorized",3,"Thu","weekday","sled","Washington Gulch",NA,NA,NA,9.8,NA,40,1,22,24.5,2,0,0,-1,3,3,3,2
"14616",2021-03-11,"Washington Gulch","w2021","Hybrid",0,"Thu","weekday","sled","Washington Gulch",NA,NA,NA,9.8,NA,40,1,22,24.5,2,0,0,-1,3,3,3,2
"14617",2021-03-12,"Washington Gulch","w2021","Non.motorized",37,"Fri","weekday","no_sled","Washington Gulch",NA,NA,NA,9.8,NA,39,-1,29,25.1,1,2,0,0,0,2,2,2
"14618",2021-03-12,"Washington Gulch","w2021","Mechanized",0,"Fri","weekday","no_sled","Washington Gulch",NA,NA,NA,9.8,NA,39,-1,29,25.1,1,2,0,0,0,2,2,2
"14619",2021-03-12,"Washington Gulch","w2021","Motorized",1,"Fri","weekday","sled","Washington Gulch",NA,NA,NA,9.8,NA,39,-1,29,25.1,1,2,0,0,0,2,2,2
"14620",2021-03-12,"Washington Gulch","w2021","Hybrid",1,"Fri","weekday","sled","Washington Gulch",NA,NA,NA,9.8,NA,39,-1,29,25.1,1,2,0,0,0,2,2,2
"14621",2021-03-13,"Washington Gulch","w2021","Non.motorized",41,"Sat","weekend","no_sled","Washington Gulch",NA,NA,NA,9.8,NA,38,-1,27,25.8,-1,1,2,0,-2,-1,1,1
"14622",2021-03-13,"Washington Gulch","w2021","Mechanized",0,"Sat","weekend","no_sled","Washington Gulch",NA,NA,NA,9.8,NA,38,-1,27,25.8,-1,1,2,0,-2,-1,1,1
"14623",2021-03-13,"Washington Gulch","w2021","Motorized",5,"Sat","weekend","sled","Washington Gulch",NA,NA,NA,9.8,NA,38,-1,27,25.8,-1,1,2,0,-2,-1,1,1
"14624",2021-03-13,"Washington Gulch","w2021","Hybrid",0,"Sat","weekend","sled","Washington Gulch",NA,NA,NA,9.8,NA,38,-1,27,25.8,-1,1,2,0,-2,-1,1,1
"14625",2021-03-14,"Washington Gulch","w2021","Non.motorized",55,"Sun","weekend","no_sled","Washington Gulch",NA,NA,NA,10.2,NA,42,4,23,24.3,-1,-1,1,2,3,2,3,5
"14626",2021-03-14,"Washington Gulch","w2021","Mechanized",0,"Sun","weekend","no_sled","Washington Gulch",NA,NA,NA,10.2,NA,42,4,23,24.3,-1,-1,1,2,3,2,3,5
"14627",2021-03-14,"Washington Gulch","w2021","Motorized",0,"Sun","weekend","sled","Washington Gulch",NA,NA,NA,10.2,NA,42,4,23,24.3,-1,-1,1,2,3,2,3,5
"14628",2021-03-14,"Washington Gulch","w2021","Hybrid",2,"Sun","weekend","sled","Washington Gulch",NA,NA,NA,10.2,NA,42,4,23,24.3,-1,-1,1,2,3,2,3,5
"14629",2021-03-15,"Washington Gulch","w2021","Non.motorized",11,"Mon","weekday","no_sled","Washington Gulch",NA,NA,NA,10.2,NA,41,-1,26,24.9,4,-1,-1,1,3,2,1,2
"14630",2021-03-15,"Washington Gulch","w2021","Mechanized",0,"Mon","weekday","no_sled","Washington Gulch",NA,NA,NA,10.2,NA,41,-1,26,24.9,4,-1,-1,1,3,2,1,2
"14631",2021-03-15,"Washington Gulch","w2021","Motorized",10,"Mon","weekday","sled","Washington Gulch",NA,NA,NA,10.2,NA,41,-1,26,24.9,4,-1,-1,1,3,2,1,2
"14632",2021-03-15,"Washington Gulch","w2021","Hybrid",1,"Mon","weekday","sled","Washington Gulch",NA,NA,NA,10.2,NA,41,-1,26,24.9,4,-1,-1,1,3,2,1,2
"14633",2021-03-16,"Washington Gulch","w2021","Non.motorized",22,"Tue","weekday","no_sled","Washington Gulch",NA,NA,NA,10.3,NA,40,-1,26,25.8,-1,4,-1,-1,-2,2,1,0
"14634",2021-03-16,"Washington Gulch","w2021","Mechanized",0,"Tue","weekday","no_sled","Washington Gulch",NA,NA,NA,10.3,NA,40,-1,26,25.8,-1,4,-1,-1,-2,2,1,0
"14635",2021-03-16,"Washington Gulch","w2021","Motorized",5,"Tue","weekday","sled","Washington Gulch",NA,NA,NA,10.3,NA,40,-1,26,25.8,-1,4,-1,-1,-2,2,1,0
"14636",2021-03-16,"Washington Gulch","w2021","Hybrid",4,"Tue","weekday","sled","Washington Gulch",NA,NA,NA,10.3,NA,40,-1,26,25.8,-1,4,-1,-1,-2,2,1,0
"14637",2021-03-17,"Washington Gulch","w2021","Non.motorized",26,"Wed","weekday","no_sled","Washington Gulch",NA,NA,NA,10.3,NA,41,1,25,25.1,-1,-1,4,-1,0,-1,3,2
"14638",2021-03-17,"Washington Gulch","w2021","Mechanized",0,"Wed","weekday","no_sled","Washington Gulch",NA,NA,NA,10.3,NA,41,1,25,25.1,-1,-1,4,-1,0,-1,3,2
"14639",2021-03-17,"Washington Gulch","w2021","Motorized",5,"Wed","weekday","sled","Washington Gulch",NA,NA,NA,10.3,NA,41,1,25,25.1,-1,-1,4,-1,0,-1,3,2
"14640",2021-03-17,"Washington Gulch","w2021","Hybrid",2,"Wed","weekday","sled","Washington Gulch",NA,NA,NA,10.3,NA,41,1,25,25.1,-1,-1,4,-1,0,-1,3,2
"14641",2021-03-18,"Washington Gulch","w2021","Non.motorized",24,"Thu","weekday","no_sled","Washington Gulch",NA,NA,NA,10.3,NA,40,-1,29,25.8,1,-1,-1,4,0,-1,-2,2
"14642",2021-03-18,"Washington Gulch","w2021","Mechanized",0,"Thu","weekday","no_sled","Washington Gulch",NA,NA,NA,10.3,NA,40,-1,29,25.8,1,-1,-1,4,0,-1,-2,2
"14643",2021-03-18,"Washington Gulch","w2021","Motorized",7,"Thu","weekday","sled","Washington Gulch",NA,NA,NA,10.3,NA,40,-1,29,25.8,1,-1,-1,4,0,-1,-2,2
"14644",2021-03-18,"Washington Gulch","w2021","Hybrid",0,"Thu","weekday","sled","Washington Gulch",NA,NA,NA,10.3,NA,40,-1,29,25.8,1,-1,-1,4,0,-1,-2,2
"14645",2021-03-19,"Washington Gulch","w2021","Non.motorized",40,"Fri","weekday","no_sled","Washington Gulch",NA,NA,NA,10.3,NA,40,0,36,25.8,-1,1,-1,-1,-1,0,-1,-2
"14646",2021-03-19,"Washington Gulch","w2021","Mechanized",0,"Fri","weekday","no_sled","Washington Gulch",NA,NA,NA,10.3,NA,40,0,36,25.8,-1,1,-1,-1,-1,0,-1,-2
"14647",2021-03-19,"Washington Gulch","w2021","Motorized",1,"Fri","weekday","sled","Washington Gulch",NA,NA,NA,10.3,NA,40,0,36,25.8,-1,1,-1,-1,-1,0,-1,-2
"14648",2021-03-19,"Washington Gulch","w2021","Hybrid",2,"Fri","weekday","sled","Washington Gulch",NA,NA,NA,10.3,NA,40,0,36,25.8,-1,1,-1,-1,-1,0,-1,-2
"14649",2021-03-20,"Washington Gulch","w2021","Non.motorized",33,"Sat","weekend","no_sled","Washington Gulch",NA,NA,NA,10.4,NA,39,-1,37,26.7,0,-1,1,-1,-1,-2,-1,-2
"14650",2021-03-20,"Washington Gulch","w2021","Mechanized",1,"Sat","weekend","no_sled","Washington Gulch",NA,NA,NA,10.4,NA,39,-1,37,26.7,0,-1,1,-1,-1,-2,-1,-2
"14651",2021-03-20,"Washington Gulch","w2021","Motorized",0,"Sat","weekend","sled","Washington Gulch",NA,NA,NA,10.4,NA,39,-1,37,26.7,0,-1,1,-1,-1,-2,-1,-2
"14652",2021-03-20,"Washington Gulch","w2021","Hybrid",0,"Sat","weekend","sled","Washington Gulch",NA,NA,NA,10.4,NA,39,-1,37,26.7,0,-1,1,-1,-1,-2,-1,-2
"14653",2021-03-21,"Washington Gulch","w2021","Non.motorized",18,"Sun","weekend","no_sled","Washington Gulch",NA,NA,NA,10.4,NA,38,-1,28,27.4,-1,0,-1,1,-2,-2,-3,-2
"14654",2021-03-21,"Washington Gulch","w2021","Mechanized",0,"Sun","weekend","no_sled","Washington Gulch",NA,NA,NA,10.4,NA,38,-1,28,27.4,-1,0,-1,1,-2,-2,-3,-2
"14655",2021-03-21,"Washington Gulch","w2021","Motorized",0,"Sun","weekend","sled","Washington Gulch",NA,NA,NA,10.4,NA,38,-1,28,27.4,-1,0,-1,1,-2,-2,-3,-2
"14656",2021-03-21,"Washington Gulch","w2021","Hybrid",4,"Sun","weekend","sled","Washington Gulch",NA,NA,NA,10.4,NA,38,-1,28,27.4,-1,0,-1,1,-2,-2,-3,-2
"14657",2021-03-22,"Washington Gulch","w2021","Non.motorized",26,"Mon","weekday","no_sled","Washington Gulch",NA,NA,NA,10.5,NA,41,3,26,25.6,-1,-1,0,-1,2,1,1,0
"14658",2021-03-22,"Washington Gulch","w2021","Mechanized",0,"Mon","weekday","no_sled","Washington Gulch",NA,NA,NA,10.5,NA,41,3,26,25.6,-1,-1,0,-1,2,1,1,0
"14659",2021-03-22,"Washington Gulch","w2021","Motorized",1,"Mon","weekday","sled","Washington Gulch",NA,NA,NA,10.5,NA,41,3,26,25.6,-1,-1,0,-1,2,1,1,0
"14660",2021-03-22,"Washington Gulch","w2021","Hybrid",0,"Mon","weekday","sled","Washington Gulch",NA,NA,NA,10.5,NA,41,3,26,25.6,-1,-1,0,-1,2,1,1,0
"14661",2021-03-23,"Washington Gulch","w2021","Non.motorized",29,"Tue","weekday","no_sled","Washington Gulch",NA,NA,NA,10.6,NA,41,0,24,25.9,3,-1,-1,0,3,2,1,1
"14662",2021-03-23,"Washington Gulch","w2021","Mechanized",0,"Tue","weekday","no_sled","Washington Gulch",NA,NA,NA,10.6,NA,41,0,24,25.9,3,-1,-1,0,3,2,1,1
"14663",2021-03-23,"Washington Gulch","w2021","Motorized",2,"Tue","weekday","sled","Washington Gulch",NA,NA,NA,10.6,NA,41,0,24,25.9,3,-1,-1,0,3,2,1,1
"14664",2021-03-23,"Washington Gulch","w2021","Hybrid",0,"Tue","weekday","sled","Washington Gulch",NA,NA,NA,10.6,NA,41,0,24,25.9,3,-1,-1,0,3,2,1,1
"14665",2021-03-24,"Washington Gulch","w2021","Non.motorized",14,"Wed","weekday","no_sled","Washington Gulch",NA,NA,NA,10.8,NA,41,0,24,26.3,0,3,-1,-1,0,3,2,1
"14666",2021-03-24,"Washington Gulch","w2021","Mechanized",0,"Wed","weekday","no_sled","Washington Gulch",NA,NA,NA,10.8,NA,41,0,24,26.3,0,3,-1,-1,0,3,2,1
"14667",2021-03-24,"Washington Gulch","w2021","Motorized",8,"Wed","weekday","sled","Washington Gulch",NA,NA,NA,10.8,NA,41,0,24,26.3,0,3,-1,-1,0,3,2,1
"14668",2021-03-24,"Washington Gulch","w2021","Hybrid",1,"Wed","weekday","sled","Washington Gulch",NA,NA,NA,10.8,NA,41,0,24,26.3,0,3,-1,-1,0,3,2,1
"14669",2021-03-25,"Washington Gulch","w2021","Non.motorized",17,"Thu","weekday","no_sled","Washington Gulch",NA,NA,NA,10.9,NA,43,2,23,25.3,0,0,3,-1,2,2,5,4
"14670",2021-03-25,"Washington Gulch","w2021","Mechanized",0,"Thu","weekday","no_sled","Washington Gulch",NA,NA,NA,10.9,NA,43,2,23,25.3,0,0,3,-1,2,2,5,4
"14671",2021-03-25,"Washington Gulch","w2021","Motorized",0,"Thu","weekday","sled","Washington Gulch",NA,NA,NA,10.9,NA,43,2,23,25.3,0,0,3,-1,2,2,5,4
"14672",2021-03-25,"Washington Gulch","w2021","Hybrid",1,"Thu","weekday","sled","Washington Gulch",NA,NA,NA,10.9,NA,43,2,23,25.3,0,0,3,-1,2,2,5,4
"14673",2021-03-26,"Washington Gulch","w2021","Non.motorized",20,"Fri","weekday","no_sled","Washington Gulch",NA,NA,NA,11,NA,44,1,23,25,2,0,0,3,3,3,3,6
"14674",2021-03-26,"Washington Gulch","w2021","Mechanized",0,"Fri","weekday","no_sled","Washington Gulch",NA,NA,NA,11,NA,44,1,23,25,2,0,0,3,3,3,3,6
"14675",2021-03-26,"Washington Gulch","w2021","Motorized",1,"Fri","weekday","sled","Washington Gulch",NA,NA,NA,11,NA,44,1,23,25,2,0,0,3,3,3,3,6
"14676",2021-03-26,"Washington Gulch","w2021","Hybrid",1,"Fri","weekday","sled","Washington Gulch",NA,NA,NA,11,NA,44,1,23,25,2,0,0,3,3,3,3,6
"14677",2021-03-27,"Washington Gulch","w2021","Non.motorized",63,"Sat","weekend","no_sled","Washington Gulch",NA,NA,NA,11,NA,42,-2,25,26.2,1,2,0,0,-1,1,1,1
"14678",2021-03-27,"Washington Gulch","w2021","Mechanized",1,"Sat","weekend","no_sled","Washington Gulch",NA,NA,NA,11,NA,42,-2,25,26.2,1,2,0,0,-1,1,1,1
"14679",2021-03-27,"Washington Gulch","w2021","Motorized",2,"Sat","weekend","sled","Washington Gulch",NA,NA,NA,11,NA,42,-2,25,26.2,1,2,0,0,-1,1,1,1
"14680",2021-03-27,"Washington Gulch","w2021","Hybrid",0,"Sat","weekend","sled","Washington Gulch",NA,NA,NA,11,NA,42,-2,25,26.2,1,2,0,0,-1,1,1,1
"14681",2021-03-28,"Washington Gulch","w2021","Non.motorized",28,"Sun","weekend","no_sled","Washington Gulch",NA,NA,NA,11,NA,42,0,31,26.2,-2,1,2,0,-2,-1,1,1
"14682",2021-03-28,"Washington Gulch","w2021","Mechanized",0,"Sun","weekend","no_sled","Washington Gulch",NA,NA,NA,11,NA,42,0,31,26.2,-2,1,2,0,-2,-1,1,1
"14683",2021-03-28,"Washington Gulch","w2021","Motorized",3,"Sun","weekend","sled","Washington Gulch",NA,NA,NA,11,NA,42,0,31,26.2,-2,1,2,0,-2,-1,1,1
"14684",2021-03-28,"Washington Gulch","w2021","Hybrid",3,"Sun","weekend","sled","Washington Gulch",NA,NA,NA,11,NA,42,0,31,26.2,-2,1,2,0,-2,-1,1,1
"14685",2021-03-29,"Washington Gulch","w2021","Non.motorized",17,"Mon","weekday","no_sled","Washington Gulch",NA,NA,NA,11.1,NA,40,-2,37,27.8,0,-2,1,2,-2,-4,-3,-1
"14686",2021-03-29,"Washington Gulch","w2021","Mechanized",0,"Mon","weekday","no_sled","Washington Gulch",NA,NA,NA,11.1,NA,40,-2,37,27.8,0,-2,1,2,-2,-4,-3,-1
"14687",2021-03-29,"Washington Gulch","w2021","Motorized",8,"Mon","weekday","sled","Washington Gulch",NA,NA,NA,11.1,NA,40,-2,37,27.8,0,-2,1,2,-2,-4,-3,-1
"14688",2021-03-29,"Washington Gulch","w2021","Hybrid",0,"Mon","weekday","sled","Washington Gulch",NA,NA,NA,11.1,NA,40,-2,37,27.8,0,-2,1,2,-2,-4,-3,-1
"14689",2021-03-30,"Washington Gulch","w2021","Non.motorized",19,"Tue","weekday","no_sled","Washington Gulch",NA,NA,NA,11.1,NA,39,-1,23,28.5,-2,0,-2,1,-3,-3,-5,-4
"14690",2021-03-30,"Washington Gulch","w2021","Mechanized",0,"Tue","weekday","no_sled","Washington Gulch",NA,NA,NA,11.1,NA,39,-1,23,28.5,-2,0,-2,1,-3,-3,-5,-4
"14691",2021-03-30,"Washington Gulch","w2021","Motorized",1,"Tue","weekday","sled","Washington Gulch",NA,NA,NA,11.1,NA,39,-1,23,28.5,-2,0,-2,1,-3,-3,-5,-4
"14692",2021-03-30,"Washington Gulch","w2021","Hybrid",2,"Tue","weekday","sled","Washington Gulch",NA,NA,NA,11.1,NA,39,-1,23,28.5,-2,0,-2,1,-3,-3,-5,-4
"14693",2021-03-31,"Washington Gulch","w2021","Non.motorized",27,"Wed","weekday","no_sled","Washington Gulch",NA,NA,NA,11.1,NA,39,0,26,28.5,-1,-2,0,-2,-1,-3,-3,-5
"14694",2021-03-31,"Washington Gulch","w2021","Mechanized",0,"Wed","weekday","no_sled","Washington Gulch",NA,NA,NA,11.1,NA,39,0,26,28.5,-1,-2,0,-2,-1,-3,-3,-5
"14695",2021-03-31,"Washington Gulch","w2021","Motorized",9,"Wed","weekday","sled","Washington Gulch",NA,NA,NA,11.1,NA,39,0,26,28.5,-1,-2,0,-2,-1,-3,-3,-5
"14696",2021-03-31,"Washington Gulch","w2021","Hybrid",0,"Wed","weekday","sled","Washington Gulch",NA,NA,NA,11.1,NA,39,0,26,28.5,-1,-2,0,-2,-1,-3,-3,-5
"14697",2021-04-01,"Washington Gulch","w2021","Non.motorized",25,"Thu","weekday","no_sled","Washington Gulch",NA,NA,NA,11.1,NA,38,-1,36,29.2,0,-1,-2,0,-1,-2,-4,-4
"14698",2021-04-01,"Washington Gulch","w2021","Mechanized",0,"Thu","weekday","no_sled","Washington Gulch",NA,NA,NA,11.1,NA,38,-1,36,29.2,0,-1,-2,0,-1,-2,-4,-4
"14699",2021-04-01,"Washington Gulch","w2021","Motorized",4,"Thu","weekday","sled","Washington Gulch",NA,NA,NA,11.1,NA,38,-1,36,29.2,0,-1,-2,0,-1,-2,-4,-4
"14700",2021-04-01,"Washington Gulch","w2021","Hybrid",4,"Thu","weekday","sled","Washington Gulch",NA,NA,NA,11.1,NA,38,-1,36,29.2,0,-1,-2,0,-1,-2,-4,-4
"14701",2021-04-02,"Washington Gulch","w2021","Non.motorized",29,"Fri","weekday","no_sled","Washington Gulch",NA,NA,NA,11.1,NA,37,-1,42,30,-1,0,-1,-2,-2,-2,-3,-5
"14702",2021-04-02,"Washington Gulch","w2021","Mechanized",0,"Fri","weekday","no_sled","Washington Gulch",NA,NA,NA,11.1,NA,37,-1,42,30,-1,0,-1,-2,-2,-2,-3,-5
"14703",2021-04-02,"Washington Gulch","w2021","Motorized",2,"Fri","weekday","sled","Washington Gulch",NA,NA,NA,11.1,NA,37,-1,42,30,-1,0,-1,-2,-2,-2,-3,-5
"14704",2021-04-02,"Washington Gulch","w2021","Hybrid",1,"Fri","weekday","sled","Washington Gulch",NA,NA,NA,11.1,NA,37,-1,42,30,-1,0,-1,-2,-2,-2,-3,-5
"14705",2021-04-03,"Washington Gulch","w2021","Non.motorized",30,"Sat","weekend","no_sled","Washington Gulch",NA,NA,NA,10.8,NA,35,-2,45,30.9,-1,-1,0,-1,-3,-4,-4,-5
"14706",2021-04-03,"Washington Gulch","w2021","Mechanized",2,"Sat","weekend","no_sled","Washington Gulch",NA,NA,NA,10.8,NA,35,-2,45,30.9,-1,-1,0,-1,-3,-4,-4,-5
"14707",2021-04-03,"Washington Gulch","w2021","Motorized",3,"Sat","weekend","sled","Washington Gulch",NA,NA,NA,10.8,NA,35,-2,45,30.9,-1,-1,0,-1,-3,-4,-4,-5
"14708",2021-04-03,"Washington Gulch","w2021","Hybrid",10,"Sat","weekend","sled","Washington Gulch",NA,NA,NA,10.8,NA,35,-2,45,30.9,-1,-1,0,-1,-3,-4,-4,-5
"14709",2021-04-04,"Washington Gulch","w2021","Non.motorized",13,"Sun","weekend","no_sled","Washington Gulch",NA,NA,NA,10.7,NA,34,-1,44,31.5,-2,-1,-1,0,-3,-4,-5,-5
"14710",2021-04-04,"Washington Gulch","w2021","Mechanized",0,"Sun","weekend","no_sled","Washington Gulch",NA,NA,NA,10.7,NA,34,-1,44,31.5,-2,-1,-1,0,-3,-4,-5,-5
"14711",2021-04-04,"Washington Gulch","w2021","Motorized",0,"Sun","weekend","sled","Washington Gulch",NA,NA,NA,10.7,NA,34,-1,44,31.5,-2,-1,-1,0,-3,-4,-5,-5
"14712",2021-04-04,"Washington Gulch","w2021","Hybrid",0,"Sun","weekend","sled","Washington Gulch",NA,NA,NA,10.7,NA,34,-1,44,31.5,-2,-1,-1,0,-3,-4,-5,-5
"14713",2021-04-05,"Washington Gulch","w2021","Non.motorized",3,"Mon","weekday","no_sled","Washington Gulch",NA,NA,NA,10.6,NA,33,-1,44,32.1,-1,-2,-1,-1,-2,-4,-5,-6
"14714",2021-04-05,"Washington Gulch","w2021","Mechanized",0,"Mon","weekday","no_sled","Washington Gulch",NA,NA,NA,10.6,NA,33,-1,44,32.1,-1,-2,-1,-1,-2,-4,-5,-6
"14715",2021-04-05,"Washington Gulch","w2021","Motorized",0,"Mon","weekday","sled","Washington Gulch",NA,NA,NA,10.6,NA,33,-1,44,32.1,-1,-2,-1,-1,-2,-4,-5,-6
"14716",2021-04-05,"Washington Gulch","w2021","Hybrid",0,"Mon","weekday","sled","Washington Gulch",NA,NA,NA,10.6,NA,33,-1,44,32.1,-1,-2,-1,-1,-2,-4,-5,-6
"14717",2021-04-06,"Washington Gulch","w2021","Non.motorized",3,"Tue","weekday","no_sled","Washington Gulch",NA,NA,NA,10.3,NA,31,-2,32,33.2,-1,-1,-2,-1,-3,-4,-6,-7
"14718",2021-04-06,"Washington Gulch","w2021","Mechanized",0,"Tue","weekday","no_sled","Washington Gulch",NA,NA,NA,10.3,NA,31,-2,32,33.2,-1,-1,-2,-1,-3,-4,-6,-7
"14719",2021-04-06,"Washington Gulch","w2021","Motorized",0,"Tue","weekday","sled","Washington Gulch",NA,NA,NA,10.3,NA,31,-2,32,33.2,-1,-1,-2,-1,-3,-4,-6,-7
"14720",2021-04-06,"Washington Gulch","w2021","Hybrid",0,"Tue","weekday","sled","Washington Gulch",NA,NA,NA,10.3,NA,31,-2,32,33.2,-1,-1,-2,-1,-3,-4,-6,-7
"14721",2021-04-07,"Washington Gulch","w2021","Non.motorized",8,"Wed","weekday","no_sled","Washington Gulch",NA,NA,NA,10,NA,31,0,33,32.3,-2,-1,-1,-2,-2,-3,-4,-6
"14722",2021-04-07,"Washington Gulch","w2021","Mechanized",0,"Wed","weekday","no_sled","Washington Gulch",NA,NA,NA,10,NA,31,0,33,32.3,-2,-1,-1,-2,-2,-3,-4,-6
"14723",2021-04-07,"Washington Gulch","w2021","Motorized",0,"Wed","weekday","sled","Washington Gulch",NA,NA,NA,10,NA,31,0,33,32.3,-2,-1,-1,-2,-2,-3,-4,-6
"14724",2021-04-07,"Washington Gulch","w2021","Hybrid",3,"Wed","weekday","sled","Washington Gulch",NA,NA,NA,10,NA,31,0,33,32.3,-2,-1,-1,-2,-2,-3,-4,-6
"14725",2021-04-08,"Washington Gulch","w2021","Non.motorized",7,"Thu","weekday","no_sled","Washington Gulch",NA,NA,NA,9.9,NA,29,-2,39,34.1,0,-2,-1,-1,-2,-4,-5,-6
"14726",2021-04-08,"Washington Gulch","w2021","Mechanized",0,"Thu","weekday","no_sled","Washington Gulch",NA,NA,NA,9.9,NA,29,-2,39,34.1,0,-2,-1,-1,-2,-4,-5,-6
"14727",2021-04-08,"Washington Gulch","w2021","Motorized",0,"Thu","weekday","sled","Washington Gulch",NA,NA,NA,9.9,NA,29,-2,39,34.1,0,-2,-1,-1,-2,-4,-5,-6
"14728",2021-04-08,"Washington Gulch","w2021","Hybrid",1,"Thu","weekday","sled","Washington Gulch",NA,NA,NA,9.9,NA,29,-2,39,34.1,0,-2,-1,-1,-2,-4,-5,-6
"14729",2021-04-09,"Washington Gulch","w2021","Non.motorized",13,"Fri","weekday","no_sled","Washington Gulch",NA,NA,NA,9.6,NA,28,-1,33,34.3,-2,0,-2,-1,-3,-3,-5,-6
"14730",2021-04-09,"Washington Gulch","w2021","Mechanized",0,"Fri","weekday","no_sled","Washington Gulch",NA,NA,NA,9.6,NA,28,-1,33,34.3,-2,0,-2,-1,-3,-3,-5,-6
"14731",2021-04-09,"Washington Gulch","w2021","Motorized",2,"Fri","weekday","sled","Washington Gulch",NA,NA,NA,9.6,NA,28,-1,33,34.3,-2,0,-2,-1,-3,-3,-5,-6
"14732",2021-04-09,"Washington Gulch","w2021","Hybrid",9,"Fri","weekday","sled","Washington Gulch",NA,NA,NA,9.6,NA,28,-1,33,34.3,-2,0,-2,-1,-3,-3,-5,-6
"14733",2021-04-10,"Washington Gulch","w2021","Non.motorized",12,"Sat","weekend","no_sled","Washington Gulch",NA,NA,NA,9.5,NA,26,-2,37,36.5,-1,-2,0,-2,-3,-5,-5,-7
"14734",2021-04-10,"Washington Gulch","w2021","Mechanized",0,"Sat","weekend","no_sled","Washington Gulch",NA,NA,NA,9.5,NA,26,-2,37,36.5,-1,-2,0,-2,-3,-5,-5,-7
"14735",2021-04-10,"Washington Gulch","w2021","Motorized",2,"Sat","weekend","sled","Washington Gulch",NA,NA,NA,9.5,NA,26,-2,37,36.5,-1,-2,0,-2,-3,-5,-5,-7
"14736",2021-04-10,"Washington Gulch","w2021","Hybrid",2,"Sat","weekend","sled","Washington Gulch",NA,NA,NA,9.5,NA,26,-2,37,36.5,-1,-2,0,-2,-3,-5,-5,-7
"14737",2021-04-11,"Washington Gulch","w2021","Non.motorized",23,"Sun","weekend","no_sled","Washington Gulch",NA,NA,NA,9.2,NA,26,0,39,35.4,-2,-1,-2,0,-2,-3,-5,-5
"14738",2021-04-11,"Washington Gulch","w2021","Mechanized",0,"Sun","weekend","no_sled","Washington Gulch",NA,NA,NA,9.2,NA,26,0,39,35.4,-2,-1,-2,0,-2,-3,-5,-5
"14739",2021-04-11,"Washington Gulch","w2021","Motorized",0,"Sun","weekend","sled","Washington Gulch",NA,NA,NA,9.2,NA,26,0,39,35.4,-2,-1,-2,0,-2,-3,-5,-5
"14740",2021-04-11,"Washington Gulch","w2021","Hybrid",2,"Sun","weekend","sled","Washington Gulch",NA,NA,NA,9.2,NA,26,0,39,35.4,-2,-1,-2,0,-2,-3,-5,-5
"14741",2021-04-12,"Washington Gulch","w2021","Non.motorized",8,"Mon","weekday","no_sled","Washington Gulch",NA,NA,NA,8.8,NA,24,-2,38,36.7,0,-2,-1,-2,-2,-4,-5,-7
"14742",2021-04-12,"Washington Gulch","w2021","Mechanized",0,"Mon","weekday","no_sled","Washington Gulch",NA,NA,NA,8.8,NA,24,-2,38,36.7,0,-2,-1,-2,-2,-4,-5,-7
"14743",2021-04-12,"Washington Gulch","w2021","Motorized",0,"Mon","weekday","sled","Washington Gulch",NA,NA,NA,8.8,NA,24,-2,38,36.7,0,-2,-1,-2,-2,-4,-5,-7
"14744",2021-04-12,"Washington Gulch","w2021","Hybrid",4,"Mon","weekday","sled","Washington Gulch",NA,NA,NA,8.8,NA,24,-2,38,36.7,0,-2,-1,-2,-2,-4,-5,-7
"14745",2021-04-13,"Washington Gulch","w2021","Non.motorized",1,"Tue","weekday","no_sled","Washington Gulch",NA,NA,NA,8.4,NA,23,-1,35,36.5,-2,0,-2,-1,-3,-3,-5,-6
"14746",2021-04-13,"Washington Gulch","w2021","Mechanized",0,"Tue","weekday","no_sled","Washington Gulch",NA,NA,NA,8.4,NA,23,-1,35,36.5,-2,0,-2,-1,-3,-3,-5,-6
"14747",2021-04-13,"Washington Gulch","w2021","Motorized",0,"Tue","weekday","sled","Washington Gulch",NA,NA,NA,8.4,NA,23,-1,35,36.5,-2,0,-2,-1,-3,-3,-5,-6
"14748",2021-04-13,"Washington Gulch","w2021","Hybrid",1,"Tue","weekday","sled","Washington Gulch",NA,NA,NA,8.4,NA,23,-1,35,36.5,-2,0,-2,-1,-3,-3,-5,-6
"14749",2021-04-14,"Washington Gulch","w2021","Non.motorized",6,"Wed","weekday","no_sled","Washington Gulch",NA,NA,NA,8.4,NA,23,0,41,36.5,-1,-2,0,-2,-1,-3,-3,-5
"14750",2021-04-14,"Washington Gulch","w2021","Mechanized",0,"Wed","weekday","no_sled","Washington Gulch",NA,NA,NA,8.4,NA,23,0,41,36.5,-1,-2,0,-2,-1,-3,-3,-5
"14751",2021-04-14,"Washington Gulch","w2021","Motorized",3,"Wed","weekday","sled","Washington Gulch",NA,NA,NA,8.4,NA,23,0,41,36.5,-1,-2,0,-2,-1,-3,-3,-5
"14752",2021-04-14,"Washington Gulch","w2021","Hybrid",2,"Wed","weekday","sled","Washington Gulch",NA,NA,NA,8.4,NA,23,0,41,36.5,-1,-2,0,-2,-1,-3,-3,-5
"14753",2021-04-15,"Washington Gulch","w2021","Non.motorized",3,"Thu","weekday","no_sled","Washington Gulch",NA,NA,NA,8.1,NA,22,-1,33,36.8,0,-1,-2,0,-1,-2,-4,-4
"14754",2021-04-15,"Washington Gulch","w2021","Mechanized",0,"Thu","weekday","no_sled","Washington Gulch",NA,NA,NA,8.1,NA,22,-1,33,36.8,0,-1,-2,0,-1,-2,-4,-4
"14755",2021-04-15,"Washington Gulch","w2021","Motorized",1,"Thu","weekday","sled","Washington Gulch",NA,NA,NA,8.1,NA,22,-1,33,36.8,0,-1,-2,0,-1,-2,-4,-4
"14756",2021-04-15,"Washington Gulch","w2021","Hybrid",0,"Thu","weekday","sled","Washington Gulch",NA,NA,NA,8.1,NA,22,-1,33,36.8,0,-1,-2,0,-1,-2,-4,-4
