"","date","Trailhead","rating_above","rating_near","rating_below","swe","change_swe","snow_depth","change_depth","air_temp","snow_density","lag1snow","lag2snow","lag3snow","lag4snow","past2snow","past3snow","past4snow","past5snow","year","modality","user.count","week","weekend"
"1",2017-12-22,"Brush Creek Trailhead","2","2","1",2,0,11,3,17,18.2,0,0,0,0,3,3,3,3,"w1718","Non.motorized",14,"Fri","weekday"
"2",2017-12-22,"Brush Creek Trailhead","2","2","1",2,0,11,3,17,18.2,0,0,0,0,3,3,3,3,"w1718","Mechanized",1,"Fri","weekday"
"3",2017-12-22,"Brush Creek Trailhead","2","2","1",2,0,11,3,17,18.2,0,0,0,0,3,3,3,3,"w1718","Motorized",0,"Fri","weekday"
"4",2017-12-22,"Brush Creek Trailhead","2","2","1",2,0,11,3,17,18.2,0,0,0,0,3,3,3,3,"w1718","Hybrid",NA,"Fri","weekday"
"5",2017-12-23,"Brush Creek Trailhead","2","1","1",2.1,0.1,10,-1,21,21,3,0,0,0,2,2,2,2,"w1718","Non.motorized",11,"Sat","weekend"
"6",2017-12-23,"Brush Creek Trailhead","2","1","1",2.1,0.1,10,-1,21,21,3,0,0,0,2,2,2,2,"w1718","Mechanized",0,"Sat","weekend"
"7",2017-12-23,"Brush Creek Trailhead","2","1","1",2.1,0.1,10,-1,21,21,3,0,0,0,2,2,2,2,"w1718","Motorized",0,"Sat","weekend"
"8",2017-12-23,"Brush Creek Trailhead","2","1","1",2.1,0.1,10,-1,21,21,3,0,0,0,2,2,2,2,"w1718","Hybrid",NA,"Sat","weekend"
"9",2017-12-24,"Brush Creek Trailhead","1","1","1",2.4,0.3,14,4,19,17.1,-1,3,0,0,3,6,6,6,"w1718","Non.motorized",28,"Sun","weekend"
"10",2017-12-24,"Brush Creek Trailhead","1","1","1",2.4,0.3,14,4,19,17.1,-1,3,0,0,3,6,6,6,"w1718","Mechanized",0,"Sun","weekend"
"11",2017-12-24,"Brush Creek Trailhead","1","1","1",2.4,0.3,14,4,19,17.1,-1,3,0,0,3,6,6,6,"w1718","Motorized",0,"Sun","weekend"
"12",2017-12-24,"Brush Creek Trailhead","1","1","1",2.4,0.3,14,4,19,17.1,-1,3,0,0,3,6,6,6,"w1718","Hybrid",NA,"Sun","weekend"
"13",2017-12-25,"Brush Creek Trailhead","2","1","1",2.6,0.2,14,0,25,18.6,4,-1,3,0,4,3,6,6,"w1718","Non.motorized",14,"Mon","weekday"
"14",2017-12-25,"Brush Creek Trailhead","2","1","1",2.6,0.2,14,0,25,18.6,4,-1,3,0,4,3,6,6,"w1718","Mechanized",0,"Mon","weekday"
"15",2017-12-25,"Brush Creek Trailhead","2","1","1",2.6,0.2,14,0,25,18.6,4,-1,3,0,4,3,6,6,"w1718","Motorized",0,"Mon","weekday"
"16",2017-12-25,"Brush Creek Trailhead","2","1","1",2.6,0.2,14,0,25,18.6,4,-1,3,0,4,3,6,6,"w1718","Hybrid",NA,"Mon","weekday"
"17",2017-12-26,"Brush Creek Trailhead","1","1","1",3.1,0.5,20,6,25,15.5,0,4,-1,3,6,10,9,12,"w1718","Non.motorized",27,"Tue","weekday"
"18",2017-12-26,"Brush Creek Trailhead","1","1","1",3.1,0.5,20,6,25,15.5,0,4,-1,3,6,10,9,12,"w1718","Mechanized",0,"Tue","weekday"
"19",2017-12-26,"Brush Creek Trailhead","1","1","1",3.1,0.5,20,6,25,15.5,0,4,-1,3,6,10,9,12,"w1718","Motorized",0,"Tue","weekday"
"20",2017-12-26,"Brush Creek Trailhead","1","1","1",3.1,0.5,20,6,25,15.5,0,4,-1,3,6,10,9,12,"w1718","Hybrid",NA,"Tue","weekday"
"21",2017-12-27,"Brush Creek Trailhead","1","1","1",3.1,0,18,-2,27,17.2,6,0,4,-1,4,4,8,7,"w1718","Non.motorized",24,"Wed","weekday"
"22",2017-12-27,"Brush Creek Trailhead","1","1","1",3.1,0,18,-2,27,17.2,6,0,4,-1,4,4,8,7,"w1718","Mechanized",0,"Wed","weekday"
"23",2017-12-27,"Brush Creek Trailhead","1","1","1",3.1,0,18,-2,27,17.2,6,0,4,-1,4,4,8,7,"w1718","Motorized",0,"Wed","weekday"
"24",2017-12-27,"Brush Creek Trailhead","1","1","1",3.1,0,18,-2,27,17.2,6,0,4,-1,4,4,8,7,"w1718","Hybrid",NA,"Wed","weekday"
"25",2017-12-28,"Brush Creek Trailhead","1","1","1",3.2,0.1,17,-1,31,18.8,-2,6,0,4,-3,3,3,7,"w1718","Non.motorized",37,"Thu","weekday"
"26",2017-12-28,"Brush Creek Trailhead","1","1","1",3.2,0.1,17,-1,31,18.8,-2,6,0,4,-3,3,3,7,"w1718","Mechanized",0,"Thu","weekday"
"27",2017-12-28,"Brush Creek Trailhead","1","1","1",3.2,0.1,17,-1,31,18.8,-2,6,0,4,-3,3,3,7,"w1718","Motorized",0,"Thu","weekday"
"28",2017-12-28,"Brush Creek Trailhead","1","1","1",3.2,0.1,17,-1,31,18.8,-2,6,0,4,-3,3,3,7,"w1718","Hybrid",NA,"Thu","weekday"
"29",2017-12-29,"Brush Creek Trailhead","1","1","1",3.2,0,17,0,36,18.8,-1,-2,6,0,-1,-3,3,3,"w1718","Non.motorized",27,"Fri","weekday"
"30",2017-12-29,"Brush Creek Trailhead","1","1","1",3.2,0,17,0,36,18.8,-1,-2,6,0,-1,-3,3,3,"w1718","Mechanized",0,"Fri","weekday"
"31",2017-12-29,"Brush Creek Trailhead","1","1","1",3.2,0,17,0,36,18.8,-1,-2,6,0,-1,-3,3,3,"w1718","Motorized",0,"Fri","weekday"
"32",2017-12-29,"Brush Creek Trailhead","1","1","1",3.2,0,17,0,36,18.8,-1,-2,6,0,-1,-3,3,3,"w1718","Hybrid",NA,"Fri","weekday"
"33",2017-12-30,"Brush Creek Trailhead","1","1","1",3.2,0,15,-2,37,21.3,0,-1,-2,6,-2,-3,-5,1,"w1718","Non.motorized",44,"Sat","weekend"
"34",2017-12-30,"Brush Creek Trailhead","1","1","1",3.2,0,15,-2,37,21.3,0,-1,-2,6,-2,-3,-5,1,"w1718","Mechanized",0,"Sat","weekend"
"35",2017-12-30,"Brush Creek Trailhead","1","1","1",3.2,0,15,-2,37,21.3,0,-1,-2,6,-2,-3,-5,1,"w1718","Motorized",0,"Sat","weekend"
"36",2017-12-30,"Brush Creek Trailhead","1","1","1",3.2,0,15,-2,37,21.3,0,-1,-2,6,-2,-3,-5,1,"w1718","Hybrid",NA,"Sat","weekend"
"37",2017-12-31,"Brush Creek Trailhead","1","1","1",3.2,0,15,0,31,21.3,-2,0,-1,-2,-2,-2,-3,-5,"w1718","Non.motorized",33,"Sun","weekend"
"38",2017-12-31,"Brush Creek Trailhead","1","1","1",3.2,0,15,0,31,21.3,-2,0,-1,-2,-2,-2,-3,-5,"w1718","Mechanized",1,"Sun","weekend"
"39",2017-12-31,"Brush Creek Trailhead","1","1","1",3.2,0,15,0,31,21.3,-2,0,-1,-2,-2,-2,-3,-5,"w1718","Motorized",0,"Sun","weekend"
"40",2017-12-31,"Brush Creek Trailhead","1","1","1",3.2,0,15,0,31,21.3,-2,0,-1,-2,-2,-2,-3,-5,"w1718","Hybrid",NA,"Sun","weekend"
"41",2018-01-01,"Brush Creek Trailhead","1","1","1",3.2,0,15,0,27,21.3,0,-2,0,-1,0,-2,-2,-3,"w1718","Non.motorized",44,"Mon","weekday"
"42",2018-01-01,"Brush Creek Trailhead","1","1","1",3.2,0,15,0,27,21.3,0,-2,0,-1,0,-2,-2,-3,"w1718","Mechanized",1,"Mon","weekday"
"43",2018-01-01,"Brush Creek Trailhead","1","1","1",3.2,0,15,0,27,21.3,0,-2,0,-1,0,-2,-2,-3,"w1718","Motorized",0,"Mon","weekday"
"44",2018-01-01,"Brush Creek Trailhead","1","1","1",3.2,0,15,0,27,21.3,0,-2,0,-1,0,-2,-2,-3,"w1718","Hybrid",NA,"Mon","weekday"
"45",2018-01-02,"Brush Creek Trailhead","1","1","1",3.2,0,15,0,22,21.3,0,0,-2,0,0,0,-2,-2,"w1718","Non.motorized",13,"Tue","weekday"
"46",2018-01-02,"Brush Creek Trailhead","1","1","1",3.2,0,15,0,22,21.3,0,0,-2,0,0,0,-2,-2,"w1718","Mechanized",1,"Tue","weekday"
"47",2018-01-02,"Brush Creek Trailhead","1","1","1",3.2,0,15,0,22,21.3,0,0,-2,0,0,0,-2,-2,"w1718","Motorized",0,"Tue","weekday"
"48",2018-01-02,"Brush Creek Trailhead","1","1","1",3.2,0,15,0,22,21.3,0,0,-2,0,0,0,-2,-2,"w1718","Hybrid",NA,"Tue","weekday"
"49",2018-01-03,"Brush Creek Trailhead","1","1","1",3.2,0,15,0,27,21.3,0,0,0,-2,0,0,0,-2,"w1718","Non.motorized",24,"Wed","weekday"
"50",2018-01-03,"Brush Creek Trailhead","1","1","1",3.2,0,15,0,27,21.3,0,0,0,-2,0,0,0,-2,"w1718","Mechanized",0,"Wed","weekday"
"51",2018-01-03,"Brush Creek Trailhead","1","1","1",3.2,0,15,0,27,21.3,0,0,0,-2,0,0,0,-2,"w1718","Motorized",0,"Wed","weekday"
"52",2018-01-03,"Brush Creek Trailhead","1","1","1",3.2,0,15,0,27,21.3,0,0,0,-2,0,0,0,-2,"w1718","Hybrid",NA,"Wed","weekday"
"53",2018-01-04,"Brush Creek Trailhead","1","1","1",3.2,0,15,0,29,21.3,0,0,0,0,0,0,0,0,"w1718","Non.motorized",15,"Thu","weekday"
"54",2018-01-04,"Brush Creek Trailhead","1","1","1",3.2,0,15,0,29,21.3,0,0,0,0,0,0,0,0,"w1718","Mechanized",0,"Thu","weekday"
"55",2018-01-04,"Brush Creek Trailhead","1","1","1",3.2,0,15,0,29,21.3,0,0,0,0,0,0,0,0,"w1718","Motorized",0,"Thu","weekday"
"56",2018-01-04,"Brush Creek Trailhead","1","1","1",3.2,0,15,0,29,21.3,0,0,0,0,0,0,0,0,"w1718","Hybrid",NA,"Thu","weekday"
"57",2018-01-05,"Brush Creek Trailhead","1","1","1",3.2,0,14,-1,32,22.9,0,0,0,0,-1,-1,-1,-1,"w1718","Non.motorized",14,"Fri","weekday"
"58",2018-01-05,"Brush Creek Trailhead","1","1","1",3.2,0,14,-1,32,22.9,0,0,0,0,-1,-1,-1,-1,"w1718","Mechanized",0,"Fri","weekday"
"59",2018-01-05,"Brush Creek Trailhead","1","1","1",3.2,0,14,-1,32,22.9,0,0,0,0,-1,-1,-1,-1,"w1718","Motorized",0,"Fri","weekday"
"60",2018-01-05,"Brush Creek Trailhead","1","1","1",3.2,0,14,-1,32,22.9,0,0,0,0,-1,-1,-1,-1,"w1718","Hybrid",NA,"Fri","weekday"
"61",2018-01-06,"Brush Creek Trailhead","1","1","1",3.2,0,14,0,30,22.9,-1,0,0,0,-1,-1,-1,-1,"w1718","Non.motorized",16,"Sat","weekend"
"62",2018-01-06,"Brush Creek Trailhead","1","1","1",3.2,0,14,0,30,22.9,-1,0,0,0,-1,-1,-1,-1,"w1718","Mechanized",0,"Sat","weekend"
"63",2018-01-06,"Brush Creek Trailhead","1","1","1",3.2,0,14,0,30,22.9,-1,0,0,0,-1,-1,-1,-1,"w1718","Motorized",0,"Sat","weekend"
"64",2018-01-06,"Brush Creek Trailhead","1","1","1",3.2,0,14,0,30,22.9,-1,0,0,0,-1,-1,-1,-1,"w1718","Hybrid",NA,"Sat","weekend"
"65",2018-01-07,"Brush Creek Trailhead","2","2","2",3.5,0.3,18,4,25,19.4,0,-1,0,0,4,3,3,3,"w1718","Non.motorized",24,"Sun","weekend"
"66",2018-01-07,"Brush Creek Trailhead","2","2","2",3.5,0.3,18,4,25,19.4,0,-1,0,0,4,3,3,3,"w1718","Mechanized",0,"Sun","weekend"
"67",2018-01-07,"Brush Creek Trailhead","2","2","2",3.5,0.3,18,4,25,19.4,0,-1,0,0,4,3,3,3,"w1718","Motorized",0,"Sun","weekend"
"68",2018-01-07,"Brush Creek Trailhead","2","2","2",3.5,0.3,18,4,25,19.4,0,-1,0,0,4,3,3,3,"w1718","Hybrid",NA,"Sun","weekend"
"69",2018-01-08,"Brush Creek Trailhead","2","2","1",3.7,0.2,20,2,29,18.5,4,0,-1,0,6,6,5,5,"w1718","Non.motorized",9,"Mon","weekday"
"70",2018-01-08,"Brush Creek Trailhead","2","2","1",3.7,0.2,20,2,29,18.5,4,0,-1,0,6,6,5,5,"w1718","Mechanized",0,"Mon","weekday"
"71",2018-01-08,"Brush Creek Trailhead","2","2","1",3.7,0.2,20,2,29,18.5,4,0,-1,0,6,6,5,5,"w1718","Motorized",0,"Mon","weekday"
"72",2018-01-08,"Brush Creek Trailhead","2","2","1",3.7,0.2,20,2,29,18.5,4,0,-1,0,6,6,5,5,"w1718","Hybrid",NA,"Mon","weekday"
"73",2018-01-09,"Brush Creek Trailhead","2","2","1",3.8,0.1,21,1,34,18.1,2,4,0,-1,3,7,7,6,"w1718","Non.motorized",14,"Tue","weekday"
"74",2018-01-09,"Brush Creek Trailhead","2","2","1",3.8,0.1,21,1,34,18.1,2,4,0,-1,3,7,7,6,"w1718","Mechanized",0,"Tue","weekday"
"75",2018-01-09,"Brush Creek Trailhead","2","2","1",3.8,0.1,21,1,34,18.1,2,4,0,-1,3,7,7,6,"w1718","Motorized",0,"Tue","weekday"
"76",2018-01-09,"Brush Creek Trailhead","2","2","1",3.8,0.1,21,1,34,18.1,2,4,0,-1,3,7,7,6,"w1718","Hybrid",NA,"Tue","weekday"
"77",2018-01-10,"Brush Creek Trailhead","3","3","3",4,0.2,21,0,28,19,1,2,4,0,1,3,7,7,"w1718","Non.motorized",1,"Wed","weekday"
"78",2018-01-10,"Brush Creek Trailhead","3","3","3",4,0.2,21,0,28,19,1,2,4,0,1,3,7,7,"w1718","Mechanized",0,"Wed","weekday"
"79",2018-01-10,"Brush Creek Trailhead","3","3","3",4,0.2,21,0,28,19,1,2,4,0,1,3,7,7,"w1718","Motorized",0,"Wed","weekday"
"80",2018-01-10,"Brush Creek Trailhead","3","3","3",4,0.2,21,0,28,19,1,2,4,0,1,3,7,7,"w1718","Hybrid",NA,"Wed","weekday"
"81",2018-01-11,"Brush Creek Trailhead","3","3","3",4.1,0.1,26,5,17,15.8,0,1,2,4,5,6,8,12,"w1718","Non.motorized",9,"Thu","weekday"
"82",2018-01-11,"Brush Creek Trailhead","3","3","3",4.1,0.1,26,5,17,15.8,0,1,2,4,5,6,8,12,"w1718","Mechanized",0,"Thu","weekday"
"83",2018-01-11,"Brush Creek Trailhead","3","3","3",4.1,0.1,26,5,17,15.8,0,1,2,4,5,6,8,12,"w1718","Motorized",0,"Thu","weekday"
"84",2018-01-11,"Brush Creek Trailhead","3","3","3",4.1,0.1,26,5,17,15.8,0,1,2,4,5,6,8,12,"w1718","Hybrid",NA,"Thu","weekday"
"85",2018-01-12,"Brush Creek Trailhead","3","3","3",4.3,0.2,24,-2,22,17.9,5,0,1,2,3,3,4,6,"w1718","Non.motorized",1,"Fri","weekday"
"86",2018-01-12,"Brush Creek Trailhead","3","3","3",4.3,0.2,24,-2,22,17.9,5,0,1,2,3,3,4,6,"w1718","Mechanized",0,"Fri","weekday"
"87",2018-01-12,"Brush Creek Trailhead","3","3","3",4.3,0.2,24,-2,22,17.9,5,0,1,2,3,3,4,6,"w1718","Motorized",0,"Fri","weekday"
"88",2018-01-12,"Brush Creek Trailhead","3","3","3",4.3,0.2,24,-2,22,17.9,5,0,1,2,3,3,4,6,"w1718","Hybrid",NA,"Fri","weekday"
"89",2018-01-13,"Brush Creek Trailhead","3","3","3",4.4,0.1,24,0,24,18.3,-2,5,0,1,-2,3,3,4,"w1718","Non.motorized",8,"Sat","weekend"
"90",2018-01-13,"Brush Creek Trailhead","3","3","3",4.4,0.1,24,0,24,18.3,-2,5,0,1,-2,3,3,4,"w1718","Mechanized",0,"Sat","weekend"
"91",2018-01-13,"Brush Creek Trailhead","3","3","3",4.4,0.1,24,0,24,18.3,-2,5,0,1,-2,3,3,4,"w1718","Motorized",0,"Sat","weekend"
"92",2018-01-13,"Brush Creek Trailhead","3","3","3",4.4,0.1,24,0,24,18.3,-2,5,0,1,-2,3,3,4,"w1718","Hybrid",NA,"Sat","weekend"
"93",2018-01-14,"Brush Creek Trailhead","3","3","2",4.4,0,24,0,27,18.3,0,-2,5,0,0,-2,3,3,"w1718","Non.motorized",19,"Sun","weekend"
"94",2018-01-14,"Brush Creek Trailhead","3","3","2",4.4,0,24,0,27,18.3,0,-2,5,0,0,-2,3,3,"w1718","Mechanized",0,"Sun","weekend"
"95",2018-01-14,"Brush Creek Trailhead","3","3","2",4.4,0,24,0,27,18.3,0,-2,5,0,0,-2,3,3,"w1718","Motorized",0,"Sun","weekend"
"96",2018-01-14,"Brush Creek Trailhead","3","3","2",4.4,0,24,0,27,18.3,0,-2,5,0,0,-2,3,3,"w1718","Hybrid",NA,"Sun","weekend"
"97",2018-01-15,"Brush Creek Trailhead","3","3","2",4.4,0,23,-1,27,19.1,0,0,-2,5,-1,-1,-3,2,"w1718","Non.motorized",23,"Mon","weekday"
"98",2018-01-15,"Brush Creek Trailhead","3","3","2",4.4,0,23,-1,27,19.1,0,0,-2,5,-1,-1,-3,2,"w1718","Mechanized",0,"Mon","weekday"
"99",2018-01-15,"Brush Creek Trailhead","3","3","2",4.4,0,23,-1,27,19.1,0,0,-2,5,-1,-1,-3,2,"w1718","Motorized",0,"Mon","weekday"
"100",2018-01-15,"Brush Creek Trailhead","3","3","2",4.4,0,23,-1,27,19.1,0,0,-2,5,-1,-1,-3,2,"w1718","Hybrid",NA,"Mon","weekday"
"101",2018-01-16,"Brush Creek Trailhead","3","3","2",4.4,0,22,-1,20,20,-1,0,0,-2,-2,-2,-2,-4,"w1718","Non.motorized",6,"Tue","weekday"
"102",2018-01-16,"Brush Creek Trailhead","3","3","2",4.4,0,22,-1,20,20,-1,0,0,-2,-2,-2,-2,-4,"w1718","Mechanized",0,"Tue","weekday"
"103",2018-01-16,"Brush Creek Trailhead","3","3","2",4.4,0,22,-1,20,20,-1,0,0,-2,-2,-2,-2,-4,"w1718","Motorized",0,"Tue","weekday"
"104",2018-01-16,"Brush Creek Trailhead","3","3","2",4.4,0,22,-1,20,20,-1,0,0,-2,-2,-2,-2,-4,"w1718","Hybrid",NA,"Tue","weekday"
"105",2018-01-17,"Brush Creek Trailhead","2","2","2",4.4,0,22,0,24,20,-1,-1,0,0,-1,-2,-2,-2,"w1718","Non.motorized",6,"Wed","weekday"
"106",2018-01-17,"Brush Creek Trailhead","2","2","2",4.4,0,22,0,24,20,-1,-1,0,0,-1,-2,-2,-2,"w1718","Mechanized",0,"Wed","weekday"
"107",2018-01-17,"Brush Creek Trailhead","2","2","2",4.4,0,22,0,24,20,-1,-1,0,0,-1,-2,-2,-2,"w1718","Motorized",0,"Wed","weekday"
"108",2018-01-17,"Brush Creek Trailhead","2","2","2",4.4,0,22,0,24,20,-1,-1,0,0,-1,-2,-2,-2,"w1718","Hybrid",NA,"Wed","weekday"
"109",2018-01-18,"Brush Creek Trailhead","2","2","2",4.4,0,21,-1,29,21,0,-1,-1,0,-1,-2,-3,-3,"w1718","Non.motorized",4,"Thu","weekday"
"110",2018-01-18,"Brush Creek Trailhead","2","2","2",4.4,0,21,-1,29,21,0,-1,-1,0,-1,-2,-3,-3,"w1718","Mechanized",0,"Thu","weekday"
"111",2018-01-18,"Brush Creek Trailhead","2","2","2",4.4,0,21,-1,29,21,0,-1,-1,0,-1,-2,-3,-3,"w1718","Motorized",0,"Thu","weekday"
"112",2018-01-18,"Brush Creek Trailhead","2","2","2",4.4,0,21,-1,29,21,0,-1,-1,0,-1,-2,-3,-3,"w1718","Hybrid",NA,"Thu","weekday"
"113",2018-01-19,"Brush Creek Trailhead","2","2","2",4.5,0.1,21,0,34,21.4,-1,0,-1,-1,-1,-1,-2,-3,"w1718","Non.motorized",7,"Fri","weekday"
"114",2018-01-19,"Brush Creek Trailhead","2","2","2",4.5,0.1,21,0,34,21.4,-1,0,-1,-1,-1,-1,-2,-3,"w1718","Mechanized",1,"Fri","weekday"
"115",2018-01-19,"Brush Creek Trailhead","2","2","2",4.5,0.1,21,0,34,21.4,-1,0,-1,-1,-1,-1,-2,-3,"w1718","Motorized",0,"Fri","weekday"
"116",2018-01-19,"Brush Creek Trailhead","2","2","2",4.5,0.1,21,0,34,21.4,-1,0,-1,-1,-1,-1,-2,-3,"w1718","Hybrid",NA,"Fri","weekday"
"117",2018-01-20,"Brush Creek Trailhead","2","2","2",4.5,0,21,0,32,21.4,0,-1,0,-1,0,-1,-1,-2,"w1718","Non.motorized",16,"Sat","weekend"
"118",2018-01-20,"Brush Creek Trailhead","2","2","2",4.5,0,21,0,32,21.4,0,-1,0,-1,0,-1,-1,-2,"w1718","Mechanized",1,"Sat","weekend"
"119",2018-01-20,"Brush Creek Trailhead","2","2","2",4.5,0,21,0,32,21.4,0,-1,0,-1,0,-1,-1,-2,"w1718","Motorized",0,"Sat","weekend"
"120",2018-01-20,"Brush Creek Trailhead","2","2","2",4.5,0,21,0,32,21.4,0,-1,0,-1,0,-1,-1,-2,"w1718","Hybrid",NA,"Sat","weekend"
"121",2018-01-21,"Brush Creek Trailhead","3","3","3",4.6,0.1,23,2,15,20,0,0,-1,0,2,2,1,1,"w1718","Non.motorized",12,"Sun","weekend"
"122",2018-01-21,"Brush Creek Trailhead","3","3","3",4.6,0.1,23,2,15,20,0,0,-1,0,2,2,1,1,"w1718","Mechanized",0,"Sun","weekend"
"123",2018-01-21,"Brush Creek Trailhead","3","3","3",4.6,0.1,23,2,15,20,0,0,-1,0,2,2,1,1,"w1718","Motorized",0,"Sun","weekend"
"124",2018-01-21,"Brush Creek Trailhead","3","3","3",4.6,0.1,23,2,15,20,0,0,-1,0,2,2,1,1,"w1718","Hybrid",NA,"Sun","weekend"
"125",2018-01-22,"Brush Creek Trailhead","3","3","3",4.6,0,21,-2,12,21.9,2,0,0,-1,0,0,0,-1,"w1718","Non.motorized",10,"Mon","weekday"
"126",2018-01-22,"Brush Creek Trailhead","3","3","3",4.6,0,21,-2,12,21.9,2,0,0,-1,0,0,0,-1,"w1718","Mechanized",0,"Mon","weekday"
"127",2018-01-22,"Brush Creek Trailhead","3","3","3",4.6,0,21,-2,12,21.9,2,0,0,-1,0,0,0,-1,"w1718","Motorized",0,"Mon","weekday"
"128",2018-01-22,"Brush Creek Trailhead","3","3","3",4.6,0,21,-2,12,21.9,2,0,0,-1,0,0,0,-1,"w1718","Hybrid",NA,"Mon","weekday"
"129",2018-01-23,"Brush Creek Trailhead","3","3","3",4.6,0,22,1,16,20.9,-2,2,0,0,-1,1,1,1,"w1718","Non.motorized",8,"Tue","weekday"
"130",2018-01-23,"Brush Creek Trailhead","3","3","3",4.6,0,22,1,16,20.9,-2,2,0,0,-1,1,1,1,"w1718","Mechanized",0,"Tue","weekday"
"131",2018-01-23,"Brush Creek Trailhead","3","3","3",4.6,0,22,1,16,20.9,-2,2,0,0,-1,1,1,1,"w1718","Motorized",0,"Tue","weekday"
"132",2018-01-23,"Brush Creek Trailhead","3","3","3",4.6,0,22,1,16,20.9,-2,2,0,0,-1,1,1,1,"w1718","Hybrid",NA,"Tue","weekday"
"133",2018-01-24,"Brush Creek Trailhead","2","2","2",4.6,0,22,0,22,20.9,1,-2,2,0,1,-1,1,1,"w1718","Non.motorized",16,"Wed","weekday"
"134",2018-01-24,"Brush Creek Trailhead","2","2","2",4.6,0,22,0,22,20.9,1,-2,2,0,1,-1,1,1,"w1718","Mechanized",0,"Wed","weekday"
"135",2018-01-24,"Brush Creek Trailhead","2","2","2",4.6,0,22,0,22,20.9,1,-2,2,0,1,-1,1,1,"w1718","Motorized",0,"Wed","weekday"
"136",2018-01-24,"Brush Creek Trailhead","2","2","2",4.6,0,22,0,22,20.9,1,-2,2,0,1,-1,1,1,"w1718","Hybrid",NA,"Wed","weekday"
"137",2018-01-25,"Brush Creek Trailhead","2","2","2",4.6,0,22,0,28,20.9,0,1,-2,2,0,1,-1,1,"w1718","Non.motorized",19,"Thu","weekday"
"138",2018-01-25,"Brush Creek Trailhead","2","2","2",4.6,0,22,0,28,20.9,0,1,-2,2,0,1,-1,1,"w1718","Mechanized",0,"Thu","weekday"
"139",2018-01-25,"Brush Creek Trailhead","2","2","2",4.6,0,22,0,28,20.9,0,1,-2,2,0,1,-1,1,"w1718","Motorized",0,"Thu","weekday"
"140",2018-01-25,"Brush Creek Trailhead","2","2","2",4.6,0,22,0,28,20.9,0,1,-2,2,0,1,-1,1,"w1718","Hybrid",NA,"Thu","weekday"
"141",2018-01-26,"Brush Creek Trailhead","2","2","2",4.7,0.1,22,0,15,21.4,0,0,1,-2,0,0,1,-1,"w1718","Non.motorized",11,"Fri","weekday"
"142",2018-01-26,"Brush Creek Trailhead","2","2","2",4.7,0.1,22,0,15,21.4,0,0,1,-2,0,0,1,-1,"w1718","Mechanized",3,"Fri","weekday"
"143",2018-01-26,"Brush Creek Trailhead","2","2","2",4.7,0.1,22,0,15,21.4,0,0,1,-2,0,0,1,-1,"w1718","Motorized",0,"Fri","weekday"
"144",2018-01-26,"Brush Creek Trailhead","2","2","2",4.7,0.1,22,0,15,21.4,0,0,1,-2,0,0,1,-1,"w1718","Hybrid",NA,"Fri","weekday"
"145",2018-01-27,"Brush Creek Trailhead","2","2","2",4.7,0,23,1,16,20.4,0,0,0,1,1,1,1,2,"w1718","Non.motorized",21,"Sat","weekend"
"146",2018-01-27,"Brush Creek Trailhead","2","2","2",4.7,0,23,1,16,20.4,0,0,0,1,1,1,1,2,"w1718","Mechanized",0,"Sat","weekend"
"147",2018-01-27,"Brush Creek Trailhead","2","2","2",4.7,0,23,1,16,20.4,0,0,0,1,1,1,1,2,"w1718","Motorized",0,"Sat","weekend"
"148",2018-01-27,"Brush Creek Trailhead","2","2","2",4.7,0,23,1,16,20.4,0,0,0,1,1,1,1,2,"w1718","Hybrid",NA,"Sat","weekend"
"149",2018-01-28,"Brush Creek Trailhead","2","2","2",4.7,0,23,0,25,20.4,1,0,0,0,1,1,1,1,"w1718","Non.motorized",18,"Sun","weekend"
"150",2018-01-28,"Brush Creek Trailhead","2","2","2",4.7,0,23,0,25,20.4,1,0,0,0,1,1,1,1,"w1718","Mechanized",0,"Sun","weekend"
"151",2018-01-28,"Brush Creek Trailhead","2","2","2",4.7,0,23,0,25,20.4,1,0,0,0,1,1,1,1,"w1718","Motorized",0,"Sun","weekend"
"152",2018-01-28,"Brush Creek Trailhead","2","2","2",4.7,0,23,0,25,20.4,1,0,0,0,1,1,1,1,"w1718","Hybrid",NA,"Sun","weekend"
"153",2018-01-29,"Brush Creek Trailhead","2","2","2",4.8,0.1,22,-1,30,21.8,0,1,0,0,-1,0,0,0,"w1718","Non.motorized",22,"Mon","weekday"
"154",2018-01-29,"Brush Creek Trailhead","2","2","2",4.8,0.1,22,-1,30,21.8,0,1,0,0,-1,0,0,0,"w1718","Mechanized",0,"Mon","weekday"
"155",2018-01-29,"Brush Creek Trailhead","2","2","2",4.8,0.1,22,-1,30,21.8,0,1,0,0,-1,0,0,0,"w1718","Motorized",0,"Mon","weekday"
"156",2018-01-29,"Brush Creek Trailhead","2","2","2",4.8,0.1,22,-1,30,21.8,0,1,0,0,-1,0,0,0,"w1718","Hybrid",NA,"Mon","weekday"
"157",2018-01-30,"Brush Creek Trailhead","2","2","2",4.8,0,22,0,34,21.8,-1,0,1,0,-1,-1,0,0,"w1718","Non.motorized",17,"Tue","weekday"
"158",2018-01-30,"Brush Creek Trailhead","2","2","2",4.8,0,22,0,34,21.8,-1,0,1,0,-1,-1,0,0,"w1718","Mechanized",0,"Tue","weekday"
"159",2018-01-30,"Brush Creek Trailhead","2","2","2",4.8,0,22,0,34,21.8,-1,0,1,0,-1,-1,0,0,"w1718","Motorized",0,"Tue","weekday"
"160",2018-01-30,"Brush Creek Trailhead","2","2","2",4.8,0,22,0,34,21.8,-1,0,1,0,-1,-1,0,0,"w1718","Hybrid",NA,"Tue","weekday"
"161",2018-01-31,"Brush Creek Trailhead","2","2","2",4.8,0,22,0,34,21.8,0,-1,0,1,0,-1,-1,0,"w1718","Non.motorized",25,"Wed","weekday"
"162",2018-01-31,"Brush Creek Trailhead","2","2","2",4.8,0,22,0,34,21.8,0,-1,0,1,0,-1,-1,0,"w1718","Mechanized",0,"Wed","weekday"
"163",2018-01-31,"Brush Creek Trailhead","2","2","2",4.8,0,22,0,34,21.8,0,-1,0,1,0,-1,-1,0,"w1718","Motorized",0,"Wed","weekday"
"164",2018-01-31,"Brush Creek Trailhead","2","2","2",4.8,0,22,0,34,21.8,0,-1,0,1,0,-1,-1,0,"w1718","Hybrid",NA,"Wed","weekday"
"165",2018-02-01,"Brush Creek Trailhead","2","2","2",4.9,0.1,21,-1,32,23.3,0,0,-1,0,-1,-1,-2,-2,"w1718","Non.motorized",11,"Thu","weekday"
"166",2018-02-01,"Brush Creek Trailhead","2","2","2",4.9,0.1,21,-1,32,23.3,0,0,-1,0,-1,-1,-2,-2,"w1718","Mechanized",0,"Thu","weekday"
"167",2018-02-01,"Brush Creek Trailhead","2","2","2",4.9,0.1,21,-1,32,23.3,0,0,-1,0,-1,-1,-2,-2,"w1718","Motorized",0,"Thu","weekday"
"168",2018-02-01,"Brush Creek Trailhead","2","2","2",4.9,0.1,21,-1,32,23.3,0,0,-1,0,-1,-1,-2,-2,"w1718","Hybrid",NA,"Thu","weekday"
"169",2018-02-02,"Brush Creek Trailhead","2","2","2",4.9,0,20,-1,33,24.5,-1,0,0,-1,-2,-2,-2,-3,"w1718","Non.motorized",18,"Fri","weekday"
"170",2018-02-02,"Brush Creek Trailhead","2","2","2",4.9,0,20,-1,33,24.5,-1,0,0,-1,-2,-2,-2,-3,"w1718","Mechanized",0,"Fri","weekday"
"171",2018-02-02,"Brush Creek Trailhead","2","2","2",4.9,0,20,-1,33,24.5,-1,0,0,-1,-2,-2,-2,-3,"w1718","Motorized",0,"Fri","weekday"
"172",2018-02-02,"Brush Creek Trailhead","2","2","2",4.9,0,20,-1,33,24.5,-1,0,0,-1,-2,-2,-2,-3,"w1718","Hybrid",NA,"Fri","weekday"
"173",2018-02-03,"Brush Creek Trailhead","2","2","2",4.9,0,21,1,32,23.3,-1,-1,0,0,0,-1,-1,-1,"w1718","Non.motorized",19,"Sat","weekend"
"174",2018-02-03,"Brush Creek Trailhead","2","2","2",4.9,0,21,1,32,23.3,-1,-1,0,0,0,-1,-1,-1,"w1718","Mechanized",0,"Sat","weekend"
"175",2018-02-03,"Brush Creek Trailhead","2","2","2",4.9,0,21,1,32,23.3,-1,-1,0,0,0,-1,-1,-1,"w1718","Motorized",0,"Sat","weekend"
"176",2018-02-03,"Brush Creek Trailhead","2","2","2",4.9,0,21,1,32,23.3,-1,-1,0,0,0,-1,-1,-1,"w1718","Hybrid",NA,"Sat","weekend"
"177",2018-02-04,"Brush Creek Trailhead","2","2","2",4.9,0,19,-2,32,25.8,1,-1,-1,0,-1,-2,-3,-3,"w1718","Non.motorized",18,"Sun","weekend"
"178",2018-02-04,"Brush Creek Trailhead","2","2","2",4.9,0,19,-2,32,25.8,1,-1,-1,0,-1,-2,-3,-3,"w1718","Mechanized",1,"Sun","weekend"
"179",2018-02-04,"Brush Creek Trailhead","2","2","2",4.9,0,19,-2,32,25.8,1,-1,-1,0,-1,-2,-3,-3,"w1718","Motorized",0,"Sun","weekend"
"180",2018-02-04,"Brush Creek Trailhead","2","2","2",4.9,0,19,-2,32,25.8,1,-1,-1,0,-1,-2,-3,-3,"w1718","Hybrid",NA,"Sun","weekend"
"181",2018-02-05,"Brush Creek Trailhead","2","2","2",5,0.1,18,-1,29,27.8,-2,1,-1,-1,-3,-2,-3,-4,"w1718","Non.motorized",0,"Mon","weekday"
"182",2018-02-05,"Brush Creek Trailhead","2","2","2",5,0.1,18,-1,29,27.8,-2,1,-1,-1,-3,-2,-3,-4,"w1718","Mechanized",0,"Mon","weekday"
"183",2018-02-05,"Brush Creek Trailhead","2","2","2",5,0.1,18,-1,29,27.8,-2,1,-1,-1,-3,-2,-3,-4,"w1718","Motorized",0,"Mon","weekday"
"184",2018-02-05,"Brush Creek Trailhead","2","2","2",5,0.1,18,-1,29,27.8,-2,1,-1,-1,-3,-2,-3,-4,"w1718","Hybrid",NA,"Mon","weekday"
"185",2018-02-06,"Brush Creek Trailhead","2","2","2",5.2,0.2,23,5,22,22.6,-1,-2,1,-1,4,2,3,2,"w1718","Non.motorized",11,"Tue","weekday"
"186",2018-02-06,"Brush Creek Trailhead","2","2","2",5.2,0.2,23,5,22,22.6,-1,-2,1,-1,4,2,3,2,"w1718","Mechanized",0,"Tue","weekday"
"187",2018-02-06,"Brush Creek Trailhead","2","2","2",5.2,0.2,23,5,22,22.6,-1,-2,1,-1,4,2,3,2,"w1718","Motorized",0,"Tue","weekday"
"188",2018-02-06,"Brush Creek Trailhead","2","2","2",5.2,0.2,23,5,22,22.6,-1,-2,1,-1,4,2,3,2,"w1718","Hybrid",NA,"Tue","weekday"
"189",2018-02-07,"Brush Creek Trailhead","2","2","2",5.2,0,23,0,24,22.6,5,-1,-2,1,5,4,2,3,"w1718","Non.motorized",19,"Wed","weekday"
"190",2018-02-07,"Brush Creek Trailhead","2","2","2",5.2,0,23,0,24,22.6,5,-1,-2,1,5,4,2,3,"w1718","Mechanized",0,"Wed","weekday"
"191",2018-02-07,"Brush Creek Trailhead","2","2","2",5.2,0,23,0,24,22.6,5,-1,-2,1,5,4,2,3,"w1718","Motorized",0,"Wed","weekday"
"192",2018-02-07,"Brush Creek Trailhead","2","2","2",5.2,0,23,0,24,22.6,5,-1,-2,1,5,4,2,3,"w1718","Hybrid",NA,"Wed","weekday"
"193",2018-02-08,"Brush Creek Trailhead","2","2","1",5.3,0.1,25,2,28,21.2,0,5,-1,-2,2,7,6,4,"w1718","Non.motorized",16,"Thu","weekday"
"194",2018-02-08,"Brush Creek Trailhead","2","2","1",5.3,0.1,25,2,28,21.2,0,5,-1,-2,2,7,6,4,"w1718","Mechanized",0,"Thu","weekday"
"195",2018-02-08,"Brush Creek Trailhead","2","2","1",5.3,0.1,25,2,28,21.2,0,5,-1,-2,2,7,6,4,"w1718","Motorized",0,"Thu","weekday"
"196",2018-02-08,"Brush Creek Trailhead","2","2","1",5.3,0.1,25,2,28,21.2,0,5,-1,-2,2,7,6,4,"w1718","Hybrid",NA,"Thu","weekday"
"197",2018-02-09,"Brush Creek Trailhead","2","2","1",5.3,0,24,-1,33,22.1,2,0,5,-1,1,1,6,5,"w1718","Non.motorized",19,"Fri","weekday"
"198",2018-02-09,"Brush Creek Trailhead","2","2","1",5.3,0,24,-1,33,22.1,2,0,5,-1,1,1,6,5,"w1718","Mechanized",3,"Fri","weekday"
"199",2018-02-09,"Brush Creek Trailhead","2","2","1",5.3,0,24,-1,33,22.1,2,0,5,-1,1,1,6,5,"w1718","Motorized",0,"Fri","weekday"
"200",2018-02-09,"Brush Creek Trailhead","2","2","1",5.3,0,24,-1,33,22.1,2,0,5,-1,1,1,6,5,"w1718","Hybrid",NA,"Fri","weekday"
"201",2018-02-10,"Brush Creek Trailhead","3","3","2",5.3,0,24,0,24,22.1,-1,2,0,5,-1,1,1,6,"w1718","Non.motorized",4,"Sat","weekend"
"202",2018-02-10,"Brush Creek Trailhead","3","3","2",5.3,0,24,0,24,22.1,-1,2,0,5,-1,1,1,6,"w1718","Mechanized",0,"Sat","weekend"
"203",2018-02-10,"Brush Creek Trailhead","3","3","2",5.3,0,24,0,24,22.1,-1,2,0,5,-1,1,1,6,"w1718","Motorized",0,"Sat","weekend"
"204",2018-02-10,"Brush Creek Trailhead","3","3","2",5.3,0,24,0,24,22.1,-1,2,0,5,-1,1,1,6,"w1718","Hybrid",NA,"Sat","weekend"
"205",2018-02-11,"Brush Creek Trailhead","3","3","2",5.6,0.3,27,3,13,20.7,0,-1,2,0,3,2,4,4,"w1718","Non.motorized",14,"Sun","weekend"
"206",2018-02-11,"Brush Creek Trailhead","3","3","2",5.6,0.3,27,3,13,20.7,0,-1,2,0,3,2,4,4,"w1718","Mechanized",0,"Sun","weekend"
"207",2018-02-11,"Brush Creek Trailhead","3","3","2",5.6,0.3,27,3,13,20.7,0,-1,2,0,3,2,4,4,"w1718","Motorized",0,"Sun","weekend"
"208",2018-02-11,"Brush Creek Trailhead","3","3","2",5.6,0.3,27,3,13,20.7,0,-1,2,0,3,2,4,4,"w1718","Hybrid",NA,"Sun","weekend"
"209",2018-02-12,"Brush Creek Trailhead","3","3","3",5.7,0.1,27,0,23,21.1,3,0,-1,2,3,3,2,4,"w1718","Non.motorized",8,"Mon","weekday"
"210",2018-02-12,"Brush Creek Trailhead","3","3","3",5.7,0.1,27,0,23,21.1,3,0,-1,2,3,3,2,4,"w1718","Mechanized",0,"Mon","weekday"
"211",2018-02-12,"Brush Creek Trailhead","3","3","3",5.7,0.1,27,0,23,21.1,3,0,-1,2,3,3,2,4,"w1718","Motorized",0,"Mon","weekday"
"212",2018-02-12,"Brush Creek Trailhead","3","3","3",5.7,0.1,27,0,23,21.1,3,0,-1,2,3,3,2,4,"w1718","Hybrid",NA,"Mon","weekday"
"213",2018-02-13,"Brush Creek Trailhead","3","3","3",6.1,0.4,29,2,28,21,0,3,0,-1,2,5,5,4,"w1718","Non.motorized",4,"Tue","weekday"
"214",2018-02-13,"Brush Creek Trailhead","3","3","3",6.1,0.4,29,2,28,21,0,3,0,-1,2,5,5,4,"w1718","Mechanized",0,"Tue","weekday"
"215",2018-02-13,"Brush Creek Trailhead","3","3","3",6.1,0.4,29,2,28,21,0,3,0,-1,2,5,5,4,"w1718","Motorized",0,"Tue","weekday"
"216",2018-02-13,"Brush Creek Trailhead","3","3","3",6.1,0.4,29,2,28,21,0,3,0,-1,2,5,5,4,"w1718","Hybrid",NA,"Tue","weekday"
"217",2018-02-14,"Brush Creek Trailhead","3","3","3",6.2,0.1,30,1,30,20.7,2,0,3,0,3,3,6,6,"w1718","Non.motorized",1,"Wed","weekday"
"218",2018-02-14,"Brush Creek Trailhead","3","3","3",6.2,0.1,30,1,30,20.7,2,0,3,0,3,3,6,6,"w1718","Mechanized",0,"Wed","weekday"
"219",2018-02-14,"Brush Creek Trailhead","3","3","3",6.2,0.1,30,1,30,20.7,2,0,3,0,3,3,6,6,"w1718","Motorized",0,"Wed","weekday"
"220",2018-02-14,"Brush Creek Trailhead","3","3","3",6.2,0.1,30,1,30,20.7,2,0,3,0,3,3,6,6,"w1718","Hybrid",NA,"Wed","weekday"
"221",2018-02-15,"Brush Creek Trailhead","3","3","3",6.3,0.1,28,-2,24,22.5,1,2,0,3,-1,1,1,4,"w1718","Non.motorized",9,"Thu","weekday"
"222",2018-02-15,"Brush Creek Trailhead","3","3","3",6.3,0.1,28,-2,24,22.5,1,2,0,3,-1,1,1,4,"w1718","Mechanized",0,"Thu","weekday"
"223",2018-02-15,"Brush Creek Trailhead","3","3","3",6.3,0.1,28,-2,24,22.5,1,2,0,3,-1,1,1,4,"w1718","Motorized",0,"Thu","weekday"
"224",2018-02-15,"Brush Creek Trailhead","3","3","3",6.3,0.1,28,-2,24,22.5,1,2,0,3,-1,1,1,4,"w1718","Hybrid",NA,"Thu","weekday"
"225",2018-02-16,"Brush Creek Trailhead","3","3","3",6.7,0.4,32,4,18,20.9,-2,1,2,0,2,3,5,5,"w1718","Non.motorized",7,"Fri","weekday"
"226",2018-02-16,"Brush Creek Trailhead","3","3","3",6.7,0.4,32,4,18,20.9,-2,1,2,0,2,3,5,5,"w1718","Mechanized",0,"Fri","weekday"
"227",2018-02-16,"Brush Creek Trailhead","3","3","3",6.7,0.4,32,4,18,20.9,-2,1,2,0,2,3,5,5,"w1718","Motorized",0,"Fri","weekday"
"228",2018-02-16,"Brush Creek Trailhead","3","3","3",6.7,0.4,32,4,18,20.9,-2,1,2,0,2,3,5,5,"w1718","Hybrid",NA,"Fri","weekday"
"229",2018-02-17,"Brush Creek Trailhead","3","3","2",6.7,0,32,0,25,20.9,4,-2,1,2,4,2,3,5,"w1718","Non.motorized",32,"Sat","weekend"
"230",2018-02-17,"Brush Creek Trailhead","3","3","2",6.7,0,32,0,25,20.9,4,-2,1,2,4,2,3,5,"w1718","Mechanized",2,"Sat","weekend"
"231",2018-02-17,"Brush Creek Trailhead","3","3","2",6.7,0,32,0,25,20.9,4,-2,1,2,4,2,3,5,"w1718","Motorized",2,"Sat","weekend"
"232",2018-02-17,"Brush Creek Trailhead","3","3","2",6.7,0,32,0,25,20.9,4,-2,1,2,4,2,3,5,"w1718","Hybrid",NA,"Sat","weekend"
"233",2018-02-18,"Brush Creek Trailhead","2","2","2",6.7,0,31,-1,32,21.6,0,4,-2,1,-1,3,1,2,"w1718","Non.motorized",38,"Sun","weekend"
"234",2018-02-18,"Brush Creek Trailhead","2","2","2",6.7,0,31,-1,32,21.6,0,4,-2,1,-1,3,1,2,"w1718","Mechanized",0,"Sun","weekend"
"235",2018-02-18,"Brush Creek Trailhead","2","2","2",6.7,0,31,-1,32,21.6,0,4,-2,1,-1,3,1,2,"w1718","Motorized",0,"Sun","weekend"
"236",2018-02-18,"Brush Creek Trailhead","2","2","2",6.7,0,31,-1,32,21.6,0,4,-2,1,-1,3,1,2,"w1718","Hybrid",NA,"Sun","weekend"
"237",2018-02-19,"Brush Creek Trailhead","2","2","2",6.8,0.1,29,-2,24,23.4,-1,0,4,-2,-3,-3,1,-1,"w1718","Non.motorized",6,"Mon","weekday"
"238",2018-02-19,"Brush Creek Trailhead","2","2","2",6.8,0.1,29,-2,24,23.4,-1,0,4,-2,-3,-3,1,-1,"w1718","Mechanized",0,"Mon","weekday"
"239",2018-02-19,"Brush Creek Trailhead","2","2","2",6.8,0.1,29,-2,24,23.4,-1,0,4,-2,-3,-3,1,-1,"w1718","Motorized",0,"Mon","weekday"
"240",2018-02-19,"Brush Creek Trailhead","2","2","2",6.8,0.1,29,-2,24,23.4,-1,0,4,-2,-3,-3,1,-1,"w1718","Hybrid",NA,"Mon","weekday"
"241",2018-02-19,"Brush Creek Trailhead","3","3","3",6.8,0.1,29,-2,24,23.4,-1,0,4,-2,-3,-3,1,-1,"w1718","Non.motorized",6,"Mon","weekday"
"242",2018-02-19,"Brush Creek Trailhead","3","3","3",6.8,0.1,29,-2,24,23.4,-1,0,4,-2,-3,-3,1,-1,"w1718","Mechanized",0,"Mon","weekday"
"243",2018-02-19,"Brush Creek Trailhead","3","3","3",6.8,0.1,29,-2,24,23.4,-1,0,4,-2,-3,-3,1,-1,"w1718","Motorized",0,"Mon","weekday"
"244",2018-02-19,"Brush Creek Trailhead","3","3","3",6.8,0.1,29,-2,24,23.4,-1,0,4,-2,-3,-3,1,-1,"w1718","Hybrid",NA,"Mon","weekday"
"245",2018-02-20,"Brush Creek Trailhead","3","3","3",6.8,0,31,2,8,21.9,-2,-1,0,4,0,-1,-1,3,"w1718","Non.motorized",9,"Tue","weekday"
"246",2018-02-20,"Brush Creek Trailhead","3","3","3",6.8,0,31,2,8,21.9,-2,-1,0,4,0,-1,-1,3,"w1718","Mechanized",0,"Tue","weekday"
"247",2018-02-20,"Brush Creek Trailhead","3","3","3",6.8,0,31,2,8,21.9,-2,-1,0,4,0,-1,-1,3,"w1718","Motorized",0,"Tue","weekday"
"248",2018-02-20,"Brush Creek Trailhead","3","3","3",6.8,0,31,2,8,21.9,-2,-1,0,4,0,-1,-1,3,"w1718","Hybrid",NA,"Tue","weekday"
"249",2018-02-21,"Brush Creek Trailhead","3","3","3",6.8,0,31,0,11,21.9,2,-2,-1,0,2,0,-1,-1,"w1718","Non.motorized",4,"Wed","weekday"
"250",2018-02-21,"Brush Creek Trailhead","3","3","3",6.8,0,31,0,11,21.9,2,-2,-1,0,2,0,-1,-1,"w1718","Mechanized",0,"Wed","weekday"
"251",2018-02-21,"Brush Creek Trailhead","3","3","3",6.8,0,31,0,11,21.9,2,-2,-1,0,2,0,-1,-1,"w1718","Motorized",0,"Wed","weekday"
"252",2018-02-21,"Brush Creek Trailhead","3","3","3",6.8,0,31,0,11,21.9,2,-2,-1,0,2,0,-1,-1,"w1718","Hybrid",NA,"Wed","weekday"
"253",2018-02-22,"Brush Creek Trailhead","3","3","2",6.8,0,30,-1,16,22.7,0,2,-2,-1,-1,1,-1,-2,"w1718","Non.motorized",18,"Thu","weekday"
"254",2018-02-22,"Brush Creek Trailhead","3","3","2",6.8,0,30,-1,16,22.7,0,2,-2,-1,-1,1,-1,-2,"w1718","Mechanized",0,"Thu","weekday"
"255",2018-02-22,"Brush Creek Trailhead","3","3","2",6.8,0,30,-1,16,22.7,0,2,-2,-1,-1,1,-1,-2,"w1718","Motorized",0,"Thu","weekday"
"256",2018-02-22,"Brush Creek Trailhead","3","3","2",6.8,0,30,-1,16,22.7,0,2,-2,-1,-1,1,-1,-2,"w1718","Hybrid",NA,"Thu","weekday"
"257",2018-02-23,"Brush Creek Trailhead","3","3","2",6.9,0.1,30,0,15,23,-1,0,2,-2,-1,-1,1,-1,"w1718","Non.motorized",19,"Fri","weekday"
"258",2018-02-23,"Brush Creek Trailhead","3","3","2",6.9,0.1,30,0,15,23,-1,0,2,-2,-1,-1,1,-1,"w1718","Mechanized",0,"Fri","weekday"
"259",2018-02-23,"Brush Creek Trailhead","3","3","2",6.9,0.1,30,0,15,23,-1,0,2,-2,-1,-1,1,-1,"w1718","Motorized",0,"Fri","weekday"
"260",2018-02-23,"Brush Creek Trailhead","3","3","2",6.9,0.1,30,0,15,23,-1,0,2,-2,-1,-1,1,-1,"w1718","Hybrid",NA,"Fri","weekday"
"261",2018-02-24,"Brush Creek Trailhead","3","3","2",6.9,0,31,1,10,22.3,0,-1,0,2,1,0,0,2,"w1718","Non.motorized",8,"Sat","weekend"
"262",2018-02-24,"Brush Creek Trailhead","3","3","2",6.9,0,31,1,10,22.3,0,-1,0,2,1,0,0,2,"w1718","Mechanized",0,"Sat","weekend"
"263",2018-02-24,"Brush Creek Trailhead","3","3","2",6.9,0,31,1,10,22.3,0,-1,0,2,1,0,0,2,"w1718","Motorized",0,"Sat","weekend"
"264",2018-02-24,"Brush Creek Trailhead","3","3","2",6.9,0,31,1,10,22.3,0,-1,0,2,1,0,0,2,"w1718","Hybrid",NA,"Sat","weekend"
"265",2018-02-25,"Brush Creek Trailhead","3","3","2",7.1,0.2,32,1,11,22.2,1,0,-1,0,2,2,1,1,"w1718","Non.motorized",25,"Sun","weekend"
"266",2018-02-25,"Brush Creek Trailhead","3","3","2",7.1,0.2,32,1,11,22.2,1,0,-1,0,2,2,1,1,"w1718","Mechanized",0,"Sun","weekend"
"267",2018-02-25,"Brush Creek Trailhead","3","3","2",7.1,0.2,32,1,11,22.2,1,0,-1,0,2,2,1,1,"w1718","Motorized",0,"Sun","weekend"
"268",2018-02-25,"Brush Creek Trailhead","3","3","2",7.1,0.2,32,1,11,22.2,1,0,-1,0,2,2,1,1,"w1718","Hybrid",NA,"Sun","weekend"
"269",2018-02-26,"Brush Creek Trailhead","2","2","2",7.1,0,32,0,20,22.2,1,1,0,-1,1,2,2,1,"w1718","Non.motorized",13,"Mon","weekday"
"270",2018-02-26,"Brush Creek Trailhead","2","2","2",7.1,0,32,0,20,22.2,1,1,0,-1,1,2,2,1,"w1718","Mechanized",1,"Mon","weekday"
"271",2018-02-26,"Brush Creek Trailhead","2","2","2",7.1,0,32,0,20,22.2,1,1,0,-1,1,2,2,1,"w1718","Motorized",0,"Mon","weekday"
"272",2018-02-26,"Brush Creek Trailhead","2","2","2",7.1,0,32,0,20,22.2,1,1,0,-1,1,2,2,1,"w1718","Hybrid",NA,"Mon","weekday"
"273",2018-02-27,"Brush Creek Trailhead","2","2","2",7.2,0.1,32,0,26,22.5,0,1,1,0,0,1,2,2,"w1718","Non.motorized",8,"Tue","weekday"
"274",2018-02-27,"Brush Creek Trailhead","2","2","2",7.2,0.1,32,0,26,22.5,0,1,1,0,0,1,2,2,"w1718","Mechanized",1,"Tue","weekday"
"275",2018-02-27,"Brush Creek Trailhead","2","2","2",7.2,0.1,32,0,26,22.5,0,1,1,0,0,1,2,2,"w1718","Motorized",0,"Tue","weekday"
"276",2018-02-27,"Brush Creek Trailhead","2","2","2",7.2,0.1,32,0,26,22.5,0,1,1,0,0,1,2,2,"w1718","Hybrid",NA,"Tue","weekday"
"277",2018-02-28,"Brush Creek Trailhead","2","2","2",7.2,0,31,-1,23,23.2,0,0,1,1,-1,-1,0,1,"w1718","Non.motorized",13,"Wed","weekday"
"278",2018-02-28,"Brush Creek Trailhead","2","2","2",7.2,0,31,-1,23,23.2,0,0,1,1,-1,-1,0,1,"w1718","Mechanized",0,"Wed","weekday"
"279",2018-02-28,"Brush Creek Trailhead","2","2","2",7.2,0,31,-1,23,23.2,0,0,1,1,-1,-1,0,1,"w1718","Motorized",0,"Wed","weekday"
"280",2018-02-28,"Brush Creek Trailhead","2","2","2",7.2,0,31,-1,23,23.2,0,0,1,1,-1,-1,0,1,"w1718","Hybrid",NA,"Wed","weekday"
"281",2018-03-01,"Brush Creek Trailhead","2","2","2",7.2,0,31,0,24,23.2,-1,0,0,1,-1,-1,-1,0,"w1718","Non.motorized",7,"Thu","weekday"
"282",2018-03-01,"Brush Creek Trailhead","2","2","2",7.2,0,31,0,24,23.2,-1,0,0,1,-1,-1,-1,0,"w1718","Mechanized",1,"Thu","weekday"
"283",2018-03-01,"Brush Creek Trailhead","2","2","2",7.2,0,31,0,24,23.2,-1,0,0,1,-1,-1,-1,0,"w1718","Motorized",0,"Thu","weekday"
"284",2018-03-01,"Brush Creek Trailhead","2","2","2",7.2,0,31,0,24,23.2,-1,0,0,1,-1,-1,-1,0,"w1718","Hybrid",NA,"Thu","weekday"
"285",2018-03-02,"Brush Creek Trailhead","2","2","1",7.2,0,31,0,30,23.2,0,-1,0,0,0,-1,-1,-1,"w1718","Non.motorized",14,"Fri","weekday"
"286",2018-03-02,"Brush Creek Trailhead","2","2","1",7.2,0,31,0,30,23.2,0,-1,0,0,0,-1,-1,-1,"w1718","Mechanized",0,"Fri","weekday"
"287",2018-03-02,"Brush Creek Trailhead","2","2","1",7.2,0,31,0,30,23.2,0,-1,0,0,0,-1,-1,-1,"w1718","Motorized",0,"Fri","weekday"
"288",2018-03-02,"Brush Creek Trailhead","2","2","1",7.2,0,31,0,30,23.2,0,-1,0,0,0,-1,-1,-1,"w1718","Hybrid",NA,"Fri","weekday"
"289",2018-03-03,"Brush Creek Trailhead","2","2","1",7.3,0.1,30,-1,34,24.3,0,0,-1,0,-1,-1,-2,-2,"w1718","Non.motorized",36,"Sat","weekend"
"290",2018-03-03,"Brush Creek Trailhead","2","2","1",7.3,0.1,30,-1,34,24.3,0,0,-1,0,-1,-1,-2,-2,"w1718","Mechanized",0,"Sat","weekend"
"291",2018-03-03,"Brush Creek Trailhead","2","2","1",7.3,0.1,30,-1,34,24.3,0,0,-1,0,-1,-1,-2,-2,"w1718","Motorized",0,"Sat","weekend"
"292",2018-03-03,"Brush Creek Trailhead","2","2","1",7.3,0.1,30,-1,34,24.3,0,0,-1,0,-1,-1,-2,-2,"w1718","Hybrid",NA,"Sat","weekend"
"293",2018-03-04,"Brush Creek Trailhead","2","2","1",7.3,0,29,-1,24,25.2,-1,0,0,-1,-2,-2,-2,-3,"w1718","Non.motorized",34,"Sun","weekend"
"294",2018-03-04,"Brush Creek Trailhead","2","2","1",7.3,0,29,-1,24,25.2,-1,0,0,-1,-2,-2,-2,-3,"w1718","Mechanized",0,"Sun","weekend"
"295",2018-03-04,"Brush Creek Trailhead","2","2","1",7.3,0,29,-1,24,25.2,-1,0,0,-1,-2,-2,-2,-3,"w1718","Motorized",0,"Sun","weekend"
"296",2018-03-04,"Brush Creek Trailhead","2","2","1",7.3,0,29,-1,24,25.2,-1,0,0,-1,-2,-2,-2,-3,"w1718","Hybrid",NA,"Sun","weekend"
"297",2018-03-05,"Brush Creek Trailhead","2","2","1",7.3,0,31,2,13,23.5,-1,-1,0,0,1,0,0,0,"w1718","Non.motorized",6,"Mon","weekday"
"298",2018-03-05,"Brush Creek Trailhead","2","2","1",7.3,0,31,2,13,23.5,-1,-1,0,0,1,0,0,0,"w1718","Mechanized",0,"Mon","weekday"
"299",2018-03-05,"Brush Creek Trailhead","2","2","1",7.3,0,31,2,13,23.5,-1,-1,0,0,1,0,0,0,"w1718","Motorized",0,"Mon","weekday"
"300",2018-03-05,"Brush Creek Trailhead","2","2","1",7.3,0,31,2,13,23.5,-1,-1,0,0,1,0,0,0,"w1718","Hybrid",NA,"Mon","weekday"
"301",2018-03-06,"Brush Creek Trailhead","2","2","1",7.3,0,31,0,19,23.5,2,-1,-1,0,2,1,0,0,"w1718","Non.motorized",17,"Tue","weekday"
"302",2018-03-06,"Brush Creek Trailhead","2","2","1",7.3,0,31,0,19,23.5,2,-1,-1,0,2,1,0,0,"w1718","Mechanized",0,"Tue","weekday"
"303",2018-03-06,"Brush Creek Trailhead","2","2","1",7.3,0,31,0,19,23.5,2,-1,-1,0,2,1,0,0,"w1718","Motorized",0,"Tue","weekday"
"304",2018-03-06,"Brush Creek Trailhead","2","2","1",7.3,0,31,0,19,23.5,2,-1,-1,0,2,1,0,0,"w1718","Hybrid",NA,"Tue","weekday"
"305",2018-03-07,"Brush Creek Trailhead","2","2","1",7.4,0.1,31,0,27,23.9,0,2,-1,-1,0,2,1,0,"w1718","Non.motorized",17,"Wed","weekday"
"306",2018-03-07,"Brush Creek Trailhead","2","2","1",7.4,0.1,31,0,27,23.9,0,2,-1,-1,0,2,1,0,"w1718","Mechanized",0,"Wed","weekday"
"307",2018-03-07,"Brush Creek Trailhead","2","2","1",7.4,0.1,31,0,27,23.9,0,2,-1,-1,0,2,1,0,"w1718","Motorized",0,"Wed","weekday"
"308",2018-03-07,"Brush Creek Trailhead","2","2","1",7.4,0.1,31,0,27,23.9,0,2,-1,-1,0,2,1,0,"w1718","Hybrid",NA,"Wed","weekday"
"309",2018-03-08,"Brush Creek Trailhead","2","2","1",7.4,0,30,-1,33,24.7,0,0,2,-1,-1,-1,1,0,"w1718","Non.motorized",7,"Thu","weekday"
"310",2018-03-08,"Brush Creek Trailhead","2","2","1",7.4,0,30,-1,33,24.7,0,0,2,-1,-1,-1,1,0,"w1718","Mechanized",0,"Thu","weekday"
"311",2018-03-08,"Brush Creek Trailhead","2","2","1",7.4,0,30,-1,33,24.7,0,0,2,-1,-1,-1,1,0,"w1718","Motorized",0,"Thu","weekday"
"312",2018-03-08,"Brush Creek Trailhead","2","2","1",7.4,0,30,-1,33,24.7,0,0,2,-1,-1,-1,1,0,"w1718","Hybrid",NA,"Thu","weekday"
"313",2018-03-09,"Brush Creek Trailhead","2","2","1",7.4,0,30,0,34,24.7,-1,0,0,2,-1,-1,-1,1,"w1718","Non.motorized",19,"Fri","weekday"
"314",2018-03-09,"Brush Creek Trailhead","2","2","1",7.4,0,30,0,34,24.7,-1,0,0,2,-1,-1,-1,1,"w1718","Mechanized",0,"Fri","weekday"
"315",2018-03-09,"Brush Creek Trailhead","2","2","1",7.4,0,30,0,34,24.7,-1,0,0,2,-1,-1,-1,1,"w1718","Motorized",0,"Fri","weekday"
"316",2018-03-09,"Brush Creek Trailhead","2","2","1",7.4,0,30,0,34,24.7,-1,0,0,2,-1,-1,-1,1,"w1718","Hybrid",NA,"Fri","weekday"
"317",2018-03-10,"Brush Creek Trailhead","1","1","1",7.4,0,30,0,31,24.7,0,-1,0,0,0,-1,-1,-1,"w1718","Non.motorized",12,"Sat","weekend"
"318",2018-03-10,"Brush Creek Trailhead","1","1","1",7.4,0,30,0,31,24.7,0,-1,0,0,0,-1,-1,-1,"w1718","Mechanized",0,"Sat","weekend"
"319",2018-03-10,"Brush Creek Trailhead","1","1","1",7.4,0,30,0,31,24.7,0,-1,0,0,0,-1,-1,-1,"w1718","Motorized",0,"Sat","weekend"
"320",2018-03-10,"Brush Creek Trailhead","1","1","1",7.4,0,30,0,31,24.7,0,-1,0,0,0,-1,-1,-1,"w1718","Hybrid",NA,"Sat","weekend"
"321",2018-03-11,"Brush Creek Trailhead","1","1","1",7.4,0,29,-1,31,25.5,0,0,-1,0,-1,-1,-2,-2,"w1718","Non.motorized",19,"Sun","weekend"
"322",2018-03-11,"Brush Creek Trailhead","1","1","1",7.4,0,29,-1,31,25.5,0,0,-1,0,-1,-1,-2,-2,"w1718","Mechanized",0,"Sun","weekend"
"323",2018-03-11,"Brush Creek Trailhead","1","1","1",7.4,0,29,-1,31,25.5,0,0,-1,0,-1,-1,-2,-2,"w1718","Motorized",0,"Sun","weekend"
"324",2018-03-11,"Brush Creek Trailhead","1","1","1",7.4,0,29,-1,31,25.5,0,0,-1,0,-1,-1,-2,-2,"w1718","Hybrid",NA,"Sun","weekend"
"325",2018-03-12,"Brush Creek Trailhead","1","1","1",7.4,0,29,0,33,25.5,-1,0,0,-1,-1,-1,-1,-2,"w1718","Non.motorized",16,"Mon","weekday"
"326",2018-03-12,"Brush Creek Trailhead","1","1","1",7.4,0,29,0,33,25.5,-1,0,0,-1,-1,-1,-1,-2,"w1718","Mechanized",0,"Mon","weekday"
"327",2018-03-12,"Brush Creek Trailhead","1","1","1",7.4,0,29,0,33,25.5,-1,0,0,-1,-1,-1,-1,-2,"w1718","Motorized",0,"Mon","weekday"
"328",2018-03-12,"Brush Creek Trailhead","1","1","1",7.4,0,29,0,33,25.5,-1,0,0,-1,-1,-1,-1,-2,"w1718","Hybrid",NA,"Mon","weekday"
"329",2018-03-13,"Brush Creek Trailhead","1","1","1",7.4,0,29,0,34,25.5,0,-1,0,0,0,-1,-1,-1,"w1718","Non.motorized",7,"Tue","weekday"
"330",2018-03-13,"Brush Creek Trailhead","1","1","1",7.4,0,29,0,34,25.5,0,-1,0,0,0,-1,-1,-1,"w1718","Mechanized",0,"Tue","weekday"
"331",2018-03-13,"Brush Creek Trailhead","1","1","1",7.4,0,29,0,34,25.5,0,-1,0,0,0,-1,-1,-1,"w1718","Motorized",0,"Tue","weekday"
"332",2018-03-13,"Brush Creek Trailhead","1","1","1",7.4,0,29,0,34,25.5,0,-1,0,0,0,-1,-1,-1,"w1718","Hybrid",NA,"Tue","weekday"
"333",2018-03-14,"Brush Creek Trailhead","1","2","2",7.4,0,29,0,39,25.5,0,0,-1,0,0,0,-1,-1,"w1718","Non.motorized",8,"Wed","weekday"
"334",2018-03-14,"Brush Creek Trailhead","1","2","2",7.4,0,29,0,39,25.5,0,0,-1,0,0,0,-1,-1,"w1718","Mechanized",0,"Wed","weekday"
"335",2018-03-14,"Brush Creek Trailhead","1","2","2",7.4,0,29,0,39,25.5,0,0,-1,0,0,0,-1,-1,"w1718","Motorized",0,"Wed","weekday"
"336",2018-03-14,"Brush Creek Trailhead","1","2","2",7.4,0,29,0,39,25.5,0,0,-1,0,0,0,-1,-1,"w1718","Hybrid",NA,"Wed","weekday"
"337",2018-03-15,"Brush Creek Trailhead","2","2","2",7.5,0.1,28,-1,31,26.8,0,0,0,-1,-1,-1,-1,-2,"w1718","Non.motorized",10,"Thu","weekday"
"338",2018-03-15,"Brush Creek Trailhead","2","2","2",7.5,0.1,28,-1,31,26.8,0,0,0,-1,-1,-1,-1,-2,"w1718","Mechanized",0,"Thu","weekday"
"339",2018-03-15,"Brush Creek Trailhead","2","2","2",7.5,0.1,28,-1,31,26.8,0,0,0,-1,-1,-1,-1,-2,"w1718","Motorized",0,"Thu","weekday"
"340",2018-03-15,"Brush Creek Trailhead","2","2","2",7.5,0.1,28,-1,31,26.8,0,0,0,-1,-1,-1,-1,-2,"w1718","Hybrid",NA,"Thu","weekday"
"341",2018-03-16,"Brush Creek Trailhead","2","2","2",7.7,0.2,29,1,25,26.6,-1,0,0,0,0,0,0,0,"w1718","Non.motorized",10,"Fri","weekday"
"342",2018-03-16,"Brush Creek Trailhead","2","2","2",7.7,0.2,29,1,25,26.6,-1,0,0,0,0,0,0,0,"w1718","Mechanized",0,"Fri","weekday"
"343",2018-03-16,"Brush Creek Trailhead","2","2","2",7.7,0.2,29,1,25,26.6,-1,0,0,0,0,0,0,0,"w1718","Motorized",0,"Fri","weekday"
"344",2018-03-16,"Brush Creek Trailhead","2","2","2",7.7,0.2,29,1,25,26.6,-1,0,0,0,0,0,0,0,"w1718","Hybrid",NA,"Fri","weekday"
"345",2018-03-17,"Brush Creek Trailhead","2","2","2",7.8,0.1,32,3,29,24.4,1,-1,0,0,4,3,3,3,"w1718","Non.motorized",17,"Sat","weekend"
"346",2018-03-17,"Brush Creek Trailhead","2","2","2",7.8,0.1,32,3,29,24.4,1,-1,0,0,4,3,3,3,"w1718","Mechanized",0,"Sat","weekend"
"347",2018-03-17,"Brush Creek Trailhead","2","2","2",7.8,0.1,32,3,29,24.4,1,-1,0,0,4,3,3,3,"w1718","Motorized",0,"Sat","weekend"
"348",2018-03-17,"Brush Creek Trailhead","2","2","2",7.8,0.1,32,3,29,24.4,1,-1,0,0,4,3,3,3,"w1718","Hybrid",NA,"Sat","weekend"
"349",2018-03-18,"Brush Creek Trailhead","2","2","2",7.9,0.1,31,-1,24,25.5,3,1,-1,0,2,3,2,2,"w1718","Non.motorized",17,"Sun","weekend"
"350",2018-03-18,"Brush Creek Trailhead","2","2","2",7.9,0.1,31,-1,24,25.5,3,1,-1,0,2,3,2,2,"w1718","Mechanized",0,"Sun","weekend"
"351",2018-03-18,"Brush Creek Trailhead","2","2","2",7.9,0.1,31,-1,24,25.5,3,1,-1,0,2,3,2,2,"w1718","Motorized",0,"Sun","weekend"
"352",2018-03-18,"Brush Creek Trailhead","2","2","2",7.9,0.1,31,-1,24,25.5,3,1,-1,0,2,3,2,2,"w1718","Hybrid",NA,"Sun","weekend"
"353",2018-03-19,"Brush Creek Trailhead","2","2","1",8,0.1,32,1,19,25,-1,3,1,-1,0,3,4,3,"w1718","Non.motorized",8,"Mon","weekday"
"354",2018-03-19,"Brush Creek Trailhead","2","2","1",8,0.1,32,1,19,25,-1,3,1,-1,0,3,4,3,"w1718","Mechanized",0,"Mon","weekday"
"355",2018-03-19,"Brush Creek Trailhead","2","2","1",8,0.1,32,1,19,25,-1,3,1,-1,0,3,4,3,"w1718","Motorized",0,"Mon","weekday"
"356",2018-03-19,"Brush Creek Trailhead","2","2","1",8,0.1,32,1,19,25,-1,3,1,-1,0,3,4,3,"w1718","Hybrid",NA,"Mon","weekday"
"357",2018-03-20,"Brush Creek Trailhead","2","2","1",8,0,30,-2,24,26.7,1,-1,3,1,-1,-2,1,2,"w1718","Non.motorized",NA,"Tue","weekday"
"358",2018-03-20,"Brush Creek Trailhead","2","2","1",8,0,30,-2,24,26.7,1,-1,3,1,-1,-2,1,2,"w1718","Mechanized",NA,"Tue","weekday"
"359",2018-03-20,"Brush Creek Trailhead","2","2","1",8,0,30,-2,24,26.7,1,-1,3,1,-1,-2,1,2,"w1718","Motorized",NA,"Tue","weekday"
"360",2018-03-20,"Brush Creek Trailhead","2","2","1",8,0,30,-2,24,26.7,1,-1,3,1,-1,-2,1,2,"w1718","Hybrid",NA,"Tue","weekday"
"361",2018-03-21,"Brush Creek Trailhead","1","1","1",8.1,0.1,32,2,30,25.3,-2,1,-1,3,0,1,0,3,"w1718","Non.motorized",NA,"Wed","weekday"
"362",2018-03-21,"Brush Creek Trailhead","1","1","1",8.1,0.1,32,2,30,25.3,-2,1,-1,3,0,1,0,3,"w1718","Mechanized",NA,"Wed","weekday"
"363",2018-03-21,"Brush Creek Trailhead","1","1","1",8.1,0.1,32,2,30,25.3,-2,1,-1,3,0,1,0,3,"w1718","Motorized",NA,"Wed","weekday"
"364",2018-03-21,"Brush Creek Trailhead","1","1","1",8.1,0.1,32,2,30,25.3,-2,1,-1,3,0,1,0,3,"w1718","Hybrid",NA,"Wed","weekday"
"365",2018-03-22,"Brush Creek Trailhead","1","1","1",8.1,0,30,-2,36,27,2,-2,1,-1,0,-2,-1,-2,"w1718","Non.motorized",NA,"Thu","weekday"
"366",2018-03-22,"Brush Creek Trailhead","1","1","1",8.1,0,30,-2,36,27,2,-2,1,-1,0,-2,-1,-2,"w1718","Mechanized",NA,"Thu","weekday"
"367",2018-03-22,"Brush Creek Trailhead","1","1","1",8.1,0,30,-2,36,27,2,-2,1,-1,0,-2,-1,-2,"w1718","Motorized",NA,"Thu","weekday"
"368",2018-03-22,"Brush Creek Trailhead","1","1","1",8.1,0,30,-2,36,27,2,-2,1,-1,0,-2,-1,-2,"w1718","Hybrid",NA,"Thu","weekday"
"369",2018-03-23,"Brush Creek Trailhead","2","2","3",8.2,0.1,29,-1,34,28.3,-2,2,-2,1,-3,-1,-3,-2,"w1718","Non.motorized",1,"Fri","weekday"
"370",2018-03-23,"Brush Creek Trailhead","2","2","3",8.2,0.1,29,-1,34,28.3,-2,2,-2,1,-3,-1,-3,-2,"w1718","Mechanized",0,"Fri","weekday"
"371",2018-03-23,"Brush Creek Trailhead","2","2","3",8.2,0.1,29,-1,34,28.3,-2,2,-2,1,-3,-1,-3,-2,"w1718","Motorized",0,"Fri","weekday"
"372",2018-03-23,"Brush Creek Trailhead","2","2","3",8.2,0.1,29,-1,34,28.3,-2,2,-2,1,-3,-1,-3,-2,"w1718","Hybrid",NA,"Fri","weekday"
"373",2018-03-24,"Brush Creek Trailhead","2","2","1",8.9,0.7,34,5,32,26.2,-1,-2,2,-2,4,2,4,2,"w1718","Non.motorized",4,"Sat","weekend"
"374",2018-03-24,"Brush Creek Trailhead","2","2","1",8.9,0.7,34,5,32,26.2,-1,-2,2,-2,4,2,4,2,"w1718","Mechanized",0,"Sat","weekend"
"375",2018-03-24,"Brush Creek Trailhead","2","2","1",8.9,0.7,34,5,32,26.2,-1,-2,2,-2,4,2,4,2,"w1718","Motorized",0,"Sat","weekend"
"376",2018-03-24,"Brush Creek Trailhead","2","2","1",8.9,0.7,34,5,32,26.2,-1,-2,2,-2,4,2,4,2,"w1718","Hybrid",NA,"Sat","weekend"
"377",2018-02-06,"Brush Creek Rd","2","2","2",5.2,0.2,23,5,22,22.6,-1,-2,1,-1,4,2,3,2,"w1718","Non.motorized",5,"Tue","weekday"
"378",2018-02-06,"Brush Creek Rd","2","2","2",5.2,0.2,23,5,22,22.6,-1,-2,1,-1,4,2,3,2,"w1718","Mechanized",0,"Tue","weekday"
"379",2018-02-06,"Brush Creek Rd","2","2","2",5.2,0.2,23,5,22,22.6,-1,-2,1,-1,4,2,3,2,"w1718","Motorized",0,"Tue","weekday"
"380",2018-02-06,"Brush Creek Rd","2","2","2",5.2,0.2,23,5,22,22.6,-1,-2,1,-1,4,2,3,2,"w1718","Hybrid",0,"Tue","weekday"
"381",2018-02-07,"Brush Creek Rd","2","2","2",5.2,0,23,0,24,22.6,5,-1,-2,1,5,4,2,3,"w1718","Non.motorized",6,"Wed","weekday"
"382",2018-02-07,"Brush Creek Rd","2","2","2",5.2,0,23,0,24,22.6,5,-1,-2,1,5,4,2,3,"w1718","Mechanized",0,"Wed","weekday"
"383",2018-02-07,"Brush Creek Rd","2","2","2",5.2,0,23,0,24,22.6,5,-1,-2,1,5,4,2,3,"w1718","Motorized",0,"Wed","weekday"
"384",2018-02-07,"Brush Creek Rd","2","2","2",5.2,0,23,0,24,22.6,5,-1,-2,1,5,4,2,3,"w1718","Hybrid",0,"Wed","weekday"
"385",2018-02-08,"Brush Creek Rd","2","2","1",5.3,0.1,25,2,28,21.2,0,5,-1,-2,2,7,6,4,"w1718","Non.motorized",6,"Thu","weekday"
"386",2018-02-08,"Brush Creek Rd","2","2","1",5.3,0.1,25,2,28,21.2,0,5,-1,-2,2,7,6,4,"w1718","Mechanized",0,"Thu","weekday"
"387",2018-02-08,"Brush Creek Rd","2","2","1",5.3,0.1,25,2,28,21.2,0,5,-1,-2,2,7,6,4,"w1718","Motorized",0,"Thu","weekday"
"388",2018-02-08,"Brush Creek Rd","2","2","1",5.3,0.1,25,2,28,21.2,0,5,-1,-2,2,7,6,4,"w1718","Hybrid",0,"Thu","weekday"
"389",2018-02-09,"Brush Creek Rd","2","2","1",5.3,0,24,-1,33,22.1,2,0,5,-1,1,1,6,5,"w1718","Non.motorized",9,"Fri","weekday"
"390",2018-02-09,"Brush Creek Rd","2","2","1",5.3,0,24,-1,33,22.1,2,0,5,-1,1,1,6,5,"w1718","Mechanized",0,"Fri","weekday"
"391",2018-02-09,"Brush Creek Rd","2","2","1",5.3,0,24,-1,33,22.1,2,0,5,-1,1,1,6,5,"w1718","Motorized",1,"Fri","weekday"
"392",2018-02-09,"Brush Creek Rd","2","2","1",5.3,0,24,-1,33,22.1,2,0,5,-1,1,1,6,5,"w1718","Hybrid",0,"Fri","weekday"
"393",2018-02-10,"Brush Creek Rd","3","3","2",5.3,0,24,0,24,22.1,-1,2,0,5,-1,1,1,6,"w1718","Non.motorized",5,"Sat","weekend"
"394",2018-02-10,"Brush Creek Rd","3","3","2",5.3,0,24,0,24,22.1,-1,2,0,5,-1,1,1,6,"w1718","Mechanized",0,"Sat","weekend"
"395",2018-02-10,"Brush Creek Rd","3","3","2",5.3,0,24,0,24,22.1,-1,2,0,5,-1,1,1,6,"w1718","Motorized",0,"Sat","weekend"
"396",2018-02-10,"Brush Creek Rd","3","3","2",5.3,0,24,0,24,22.1,-1,2,0,5,-1,1,1,6,"w1718","Hybrid",0,"Sat","weekend"
"397",2018-02-11,"Brush Creek Rd","3","3","2",5.6,0.3,27,3,13,20.7,0,-1,2,0,3,2,4,4,"w1718","Non.motorized",11,"Sun","weekend"
"398",2018-02-11,"Brush Creek Rd","3","3","2",5.6,0.3,27,3,13,20.7,0,-1,2,0,3,2,4,4,"w1718","Mechanized",0,"Sun","weekend"
"399",2018-02-11,"Brush Creek Rd","3","3","2",5.6,0.3,27,3,13,20.7,0,-1,2,0,3,2,4,4,"w1718","Motorized",0,"Sun","weekend"
"400",2018-02-11,"Brush Creek Rd","3","3","2",5.6,0.3,27,3,13,20.7,0,-1,2,0,3,2,4,4,"w1718","Hybrid",0,"Sun","weekend"
"401",2018-02-12,"Brush Creek Rd","3","3","3",5.7,0.1,27,0,23,21.1,3,0,-1,2,3,3,2,4,"w1718","Non.motorized",1,"Mon","weekday"
"402",2018-02-12,"Brush Creek Rd","3","3","3",5.7,0.1,27,0,23,21.1,3,0,-1,2,3,3,2,4,"w1718","Mechanized",0,"Mon","weekday"
"403",2018-02-12,"Brush Creek Rd","3","3","3",5.7,0.1,27,0,23,21.1,3,0,-1,2,3,3,2,4,"w1718","Motorized",0,"Mon","weekday"
"404",2018-02-12,"Brush Creek Rd","3","3","3",5.7,0.1,27,0,23,21.1,3,0,-1,2,3,3,2,4,"w1718","Hybrid",0,"Mon","weekday"
"405",2018-02-13,"Brush Creek Rd","3","3","3",6.1,0.4,29,2,28,21,0,3,0,-1,2,5,5,4,"w1718","Non.motorized",0,"Tue","weekday"
"406",2018-02-13,"Brush Creek Rd","3","3","3",6.1,0.4,29,2,28,21,0,3,0,-1,2,5,5,4,"w1718","Mechanized",0,"Tue","weekday"
"407",2018-02-13,"Brush Creek Rd","3","3","3",6.1,0.4,29,2,28,21,0,3,0,-1,2,5,5,4,"w1718","Motorized",0,"Tue","weekday"
"408",2018-02-13,"Brush Creek Rd","3","3","3",6.1,0.4,29,2,28,21,0,3,0,-1,2,5,5,4,"w1718","Hybrid",0,"Tue","weekday"
"409",2018-02-14,"Brush Creek Rd","3","3","3",6.2,0.1,30,1,30,20.7,2,0,3,0,3,3,6,6,"w1718","Non.motorized",3,"Wed","weekday"
"410",2018-02-14,"Brush Creek Rd","3","3","3",6.2,0.1,30,1,30,20.7,2,0,3,0,3,3,6,6,"w1718","Mechanized",0,"Wed","weekday"
"411",2018-02-14,"Brush Creek Rd","3","3","3",6.2,0.1,30,1,30,20.7,2,0,3,0,3,3,6,6,"w1718","Motorized",1,"Wed","weekday"
"412",2018-02-14,"Brush Creek Rd","3","3","3",6.2,0.1,30,1,30,20.7,2,0,3,0,3,3,6,6,"w1718","Hybrid",0,"Wed","weekday"
"413",2018-02-15,"Brush Creek Rd","3","3","3",6.3,0.1,28,-2,24,22.5,1,2,0,3,-1,1,1,4,"w1718","Non.motorized",5,"Thu","weekday"
"414",2018-02-15,"Brush Creek Rd","3","3","3",6.3,0.1,28,-2,24,22.5,1,2,0,3,-1,1,1,4,"w1718","Mechanized",0,"Thu","weekday"
"415",2018-02-15,"Brush Creek Rd","3","3","3",6.3,0.1,28,-2,24,22.5,1,2,0,3,-1,1,1,4,"w1718","Motorized",0,"Thu","weekday"
"416",2018-02-15,"Brush Creek Rd","3","3","3",6.3,0.1,28,-2,24,22.5,1,2,0,3,-1,1,1,4,"w1718","Hybrid",0,"Thu","weekday"
"417",2018-02-16,"Brush Creek Rd","3","3","3",6.7,0.4,32,4,18,20.9,-2,1,2,0,2,3,5,5,"w1718","Non.motorized",6,"Fri","weekday"
"418",2018-02-16,"Brush Creek Rd","3","3","3",6.7,0.4,32,4,18,20.9,-2,1,2,0,2,3,5,5,"w1718","Mechanized",0,"Fri","weekday"
"419",2018-02-16,"Brush Creek Rd","3","3","3",6.7,0.4,32,4,18,20.9,-2,1,2,0,2,3,5,5,"w1718","Motorized",0,"Fri","weekday"
"420",2018-02-16,"Brush Creek Rd","3","3","3",6.7,0.4,32,4,18,20.9,-2,1,2,0,2,3,5,5,"w1718","Hybrid",0,"Fri","weekday"
"421",2018-02-17,"Brush Creek Rd","3","3","2",6.7,0,32,0,25,20.9,4,-2,1,2,4,2,3,5,"w1718","Non.motorized",24,"Sat","weekend"
"422",2018-02-17,"Brush Creek Rd","3","3","2",6.7,0,32,0,25,20.9,4,-2,1,2,4,2,3,5,"w1718","Mechanized",3,"Sat","weekend"
"423",2018-02-17,"Brush Creek Rd","3","3","2",6.7,0,32,0,25,20.9,4,-2,1,2,4,2,3,5,"w1718","Motorized",1,"Sat","weekend"
"424",2018-02-17,"Brush Creek Rd","3","3","2",6.7,0,32,0,25,20.9,4,-2,1,2,4,2,3,5,"w1718","Hybrid",1,"Sat","weekend"
"425",2018-02-18,"Brush Creek Rd","2","2","2",6.7,0,31,-1,32,21.6,0,4,-2,1,-1,3,1,2,"w1718","Non.motorized",21,"Sun","weekend"
"426",2018-02-18,"Brush Creek Rd","2","2","2",6.7,0,31,-1,32,21.6,0,4,-2,1,-1,3,1,2,"w1718","Mechanized",3,"Sun","weekend"
"427",2018-02-18,"Brush Creek Rd","2","2","2",6.7,0,31,-1,32,21.6,0,4,-2,1,-1,3,1,2,"w1718","Motorized",2,"Sun","weekend"
"428",2018-02-18,"Brush Creek Rd","2","2","2",6.7,0,31,-1,32,21.6,0,4,-2,1,-1,3,1,2,"w1718","Hybrid",0,"Sun","weekend"
"429",2018-02-19,"Brush Creek Rd","2","2","2",6.8,0.1,29,-2,24,23.4,-1,0,4,-2,-3,-3,1,-1,"w1718","Non.motorized",1,"Mon","weekday"
"430",2018-02-19,"Brush Creek Rd","2","2","2",6.8,0.1,29,-2,24,23.4,-1,0,4,-2,-3,-3,1,-1,"w1718","Mechanized",0,"Mon","weekday"
"431",2018-02-19,"Brush Creek Rd","2","2","2",6.8,0.1,29,-2,24,23.4,-1,0,4,-2,-3,-3,1,-1,"w1718","Motorized",0,"Mon","weekday"
"432",2018-02-19,"Brush Creek Rd","2","2","2",6.8,0.1,29,-2,24,23.4,-1,0,4,-2,-3,-3,1,-1,"w1718","Hybrid",0,"Mon","weekday"
"433",2018-02-19,"Brush Creek Rd","3","3","3",6.8,0.1,29,-2,24,23.4,-1,0,4,-2,-3,-3,1,-1,"w1718","Non.motorized",1,"Mon","weekday"
"434",2018-02-19,"Brush Creek Rd","3","3","3",6.8,0.1,29,-2,24,23.4,-1,0,4,-2,-3,-3,1,-1,"w1718","Mechanized",0,"Mon","weekday"
"435",2018-02-19,"Brush Creek Rd","3","3","3",6.8,0.1,29,-2,24,23.4,-1,0,4,-2,-3,-3,1,-1,"w1718","Motorized",0,"Mon","weekday"
"436",2018-02-19,"Brush Creek Rd","3","3","3",6.8,0.1,29,-2,24,23.4,-1,0,4,-2,-3,-3,1,-1,"w1718","Hybrid",0,"Mon","weekday"
"437",2018-02-20,"Brush Creek Rd","3","3","3",6.8,0,31,2,8,21.9,-2,-1,0,4,0,-1,-1,3,"w1718","Non.motorized",0,"Tue","weekday"
"438",2018-02-20,"Brush Creek Rd","3","3","3",6.8,0,31,2,8,21.9,-2,-1,0,4,0,-1,-1,3,"w1718","Mechanized",0,"Tue","weekday"
"439",2018-02-20,"Brush Creek Rd","3","3","3",6.8,0,31,2,8,21.9,-2,-1,0,4,0,-1,-1,3,"w1718","Motorized",0,"Tue","weekday"
"440",2018-02-20,"Brush Creek Rd","3","3","3",6.8,0,31,2,8,21.9,-2,-1,0,4,0,-1,-1,3,"w1718","Hybrid",0,"Tue","weekday"
"441",2018-02-21,"Brush Creek Rd","3","3","3",6.8,0,31,0,11,21.9,2,-2,-1,0,2,0,-1,-1,"w1718","Non.motorized",9,"Wed","weekday"
"442",2018-02-21,"Brush Creek Rd","3","3","3",6.8,0,31,0,11,21.9,2,-2,-1,0,2,0,-1,-1,"w1718","Mechanized",0,"Wed","weekday"
"443",2018-02-21,"Brush Creek Rd","3","3","3",6.8,0,31,0,11,21.9,2,-2,-1,0,2,0,-1,-1,"w1718","Motorized",0,"Wed","weekday"
"444",2018-02-21,"Brush Creek Rd","3","3","3",6.8,0,31,0,11,21.9,2,-2,-1,0,2,0,-1,-1,"w1718","Hybrid",0,"Wed","weekday"
"445",2018-02-22,"Brush Creek Rd","3","3","2",6.8,0,30,-1,16,22.7,0,2,-2,-1,-1,1,-1,-2,"w1718","Non.motorized",2,"Thu","weekday"
"446",2018-02-22,"Brush Creek Rd","3","3","2",6.8,0,30,-1,16,22.7,0,2,-2,-1,-1,1,-1,-2,"w1718","Mechanized",0,"Thu","weekday"
"447",2018-02-22,"Brush Creek Rd","3","3","2",6.8,0,30,-1,16,22.7,0,2,-2,-1,-1,1,-1,-2,"w1718","Motorized",0,"Thu","weekday"
"448",2018-02-22,"Brush Creek Rd","3","3","2",6.8,0,30,-1,16,22.7,0,2,-2,-1,-1,1,-1,-2,"w1718","Hybrid",0,"Thu","weekday"
"449",2018-02-23,"Brush Creek Rd","3","3","2",6.9,0.1,30,0,15,23,-1,0,2,-2,-1,-1,1,-1,"w1718","Non.motorized",12,"Fri","weekday"
"450",2018-02-23,"Brush Creek Rd","3","3","2",6.9,0.1,30,0,15,23,-1,0,2,-2,-1,-1,1,-1,"w1718","Mechanized",0,"Fri","weekday"
"451",2018-02-23,"Brush Creek Rd","3","3","2",6.9,0.1,30,0,15,23,-1,0,2,-2,-1,-1,1,-1,"w1718","Motorized",0,"Fri","weekday"
"452",2018-02-23,"Brush Creek Rd","3","3","2",6.9,0.1,30,0,15,23,-1,0,2,-2,-1,-1,1,-1,"w1718","Hybrid",0,"Fri","weekday"
"453",2018-02-24,"Brush Creek Rd","3","3","2",6.9,0,31,1,10,22.3,0,-1,0,2,1,0,0,2,"w1718","Non.motorized",18,"Sat","weekend"
"454",2018-02-24,"Brush Creek Rd","3","3","2",6.9,0,31,1,10,22.3,0,-1,0,2,1,0,0,2,"w1718","Mechanized",2,"Sat","weekend"
"455",2018-02-24,"Brush Creek Rd","3","3","2",6.9,0,31,1,10,22.3,0,-1,0,2,1,0,0,2,"w1718","Motorized",0,"Sat","weekend"
"456",2018-02-24,"Brush Creek Rd","3","3","2",6.9,0,31,1,10,22.3,0,-1,0,2,1,0,0,2,"w1718","Hybrid",0,"Sat","weekend"
"457",2018-02-25,"Brush Creek Rd","3","3","2",7.1,0.2,32,1,11,22.2,1,0,-1,0,2,2,1,1,"w1718","Non.motorized",8,"Sun","weekend"
"458",2018-02-25,"Brush Creek Rd","3","3","2",7.1,0.2,32,1,11,22.2,1,0,-1,0,2,2,1,1,"w1718","Mechanized",1,"Sun","weekend"
"459",2018-02-25,"Brush Creek Rd","3","3","2",7.1,0.2,32,1,11,22.2,1,0,-1,0,2,2,1,1,"w1718","Motorized",4,"Sun","weekend"
"460",2018-02-25,"Brush Creek Rd","3","3","2",7.1,0.2,32,1,11,22.2,1,0,-1,0,2,2,1,1,"w1718","Hybrid",0,"Sun","weekend"
"461",2018-02-26,"Brush Creek Rd","2","2","2",7.1,0,32,0,20,22.2,1,1,0,-1,1,2,2,1,"w1718","Non.motorized",2,"Mon","weekday"
"462",2018-02-26,"Brush Creek Rd","2","2","2",7.1,0,32,0,20,22.2,1,1,0,-1,1,2,2,1,"w1718","Mechanized",3,"Mon","weekday"
"463",2018-02-26,"Brush Creek Rd","2","2","2",7.1,0,32,0,20,22.2,1,1,0,-1,1,2,2,1,"w1718","Motorized",0,"Mon","weekday"
"464",2018-02-26,"Brush Creek Rd","2","2","2",7.1,0,32,0,20,22.2,1,1,0,-1,1,2,2,1,"w1718","Hybrid",0,"Mon","weekday"
"465",2018-02-27,"Brush Creek Rd","2","2","2",7.2,0.1,32,0,26,22.5,0,1,1,0,0,1,2,2,"w1718","Non.motorized",NA,"Tue","weekday"
"466",2018-02-27,"Brush Creek Rd","2","2","2",7.2,0.1,32,0,26,22.5,0,1,1,0,0,1,2,2,"w1718","Mechanized",NA,"Tue","weekday"
"467",2018-02-27,"Brush Creek Rd","2","2","2",7.2,0.1,32,0,26,22.5,0,1,1,0,0,1,2,2,"w1718","Motorized",NA,"Tue","weekday"
"468",2018-02-27,"Brush Creek Rd","2","2","2",7.2,0.1,32,0,26,22.5,0,1,1,0,0,1,2,2,"w1718","Hybrid",NA,"Tue","weekday"
"469",2018-02-28,"Brush Creek Rd","2","2","2",7.2,0,31,-1,23,23.2,0,0,1,1,-1,-1,0,1,"w1718","Non.motorized",NA,"Wed","weekday"
"470",2018-02-28,"Brush Creek Rd","2","2","2",7.2,0,31,-1,23,23.2,0,0,1,1,-1,-1,0,1,"w1718","Mechanized",NA,"Wed","weekday"
"471",2018-02-28,"Brush Creek Rd","2","2","2",7.2,0,31,-1,23,23.2,0,0,1,1,-1,-1,0,1,"w1718","Motorized",NA,"Wed","weekday"
"472",2018-02-28,"Brush Creek Rd","2","2","2",7.2,0,31,-1,23,23.2,0,0,1,1,-1,-1,0,1,"w1718","Hybrid",NA,"Wed","weekday"
"473",2018-03-01,"Brush Creek Rd","2","2","2",7.2,0,31,0,24,23.2,-1,0,0,1,-1,-1,-1,0,"w1718","Non.motorized",NA,"Thu","weekday"
"474",2018-03-01,"Brush Creek Rd","2","2","2",7.2,0,31,0,24,23.2,-1,0,0,1,-1,-1,-1,0,"w1718","Mechanized",NA,"Thu","weekday"
"475",2018-03-01,"Brush Creek Rd","2","2","2",7.2,0,31,0,24,23.2,-1,0,0,1,-1,-1,-1,0,"w1718","Motorized",NA,"Thu","weekday"
"476",2018-03-01,"Brush Creek Rd","2","2","2",7.2,0,31,0,24,23.2,-1,0,0,1,-1,-1,-1,0,"w1718","Hybrid",NA,"Thu","weekday"
"477",2018-03-02,"Brush Creek Rd","2","2","1",7.2,0,31,0,30,23.2,0,-1,0,0,0,-1,-1,-1,"w1718","Non.motorized",NA,"Fri","weekday"
"478",2018-03-02,"Brush Creek Rd","2","2","1",7.2,0,31,0,30,23.2,0,-1,0,0,0,-1,-1,-1,"w1718","Mechanized",NA,"Fri","weekday"
"479",2018-03-02,"Brush Creek Rd","2","2","1",7.2,0,31,0,30,23.2,0,-1,0,0,0,-1,-1,-1,"w1718","Motorized",NA,"Fri","weekday"
"480",2018-03-02,"Brush Creek Rd","2","2","1",7.2,0,31,0,30,23.2,0,-1,0,0,0,-1,-1,-1,"w1718","Hybrid",NA,"Fri","weekday"
"481",2018-03-03,"Brush Creek Rd","2","2","1",7.3,0.1,30,-1,34,24.3,0,0,-1,0,-1,-1,-2,-2,"w1718","Non.motorized",NA,"Sat","weekend"
"482",2018-03-03,"Brush Creek Rd","2","2","1",7.3,0.1,30,-1,34,24.3,0,0,-1,0,-1,-1,-2,-2,"w1718","Mechanized",NA,"Sat","weekend"
"483",2018-03-03,"Brush Creek Rd","2","2","1",7.3,0.1,30,-1,34,24.3,0,0,-1,0,-1,-1,-2,-2,"w1718","Motorized",NA,"Sat","weekend"
"484",2018-03-03,"Brush Creek Rd","2","2","1",7.3,0.1,30,-1,34,24.3,0,0,-1,0,-1,-1,-2,-2,"w1718","Hybrid",NA,"Sat","weekend"
"485",2018-03-04,"Brush Creek Rd","2","2","1",7.3,0,29,-1,24,25.2,-1,0,0,-1,-2,-2,-2,-3,"w1718","Non.motorized",NA,"Sun","weekend"
"486",2018-03-04,"Brush Creek Rd","2","2","1",7.3,0,29,-1,24,25.2,-1,0,0,-1,-2,-2,-2,-3,"w1718","Mechanized",NA,"Sun","weekend"
"487",2018-03-04,"Brush Creek Rd","2","2","1",7.3,0,29,-1,24,25.2,-1,0,0,-1,-2,-2,-2,-3,"w1718","Motorized",NA,"Sun","weekend"
"488",2018-03-04,"Brush Creek Rd","2","2","1",7.3,0,29,-1,24,25.2,-1,0,0,-1,-2,-2,-2,-3,"w1718","Hybrid",NA,"Sun","weekend"
"489",2018-03-05,"Brush Creek Rd","2","2","1",7.3,0,31,2,13,23.5,-1,-1,0,0,1,0,0,0,"w1718","Non.motorized",NA,"Mon","weekday"
"490",2018-03-05,"Brush Creek Rd","2","2","1",7.3,0,31,2,13,23.5,-1,-1,0,0,1,0,0,0,"w1718","Mechanized",NA,"Mon","weekday"
"491",2018-03-05,"Brush Creek Rd","2","2","1",7.3,0,31,2,13,23.5,-1,-1,0,0,1,0,0,0,"w1718","Motorized",NA,"Mon","weekday"
"492",2018-03-05,"Brush Creek Rd","2","2","1",7.3,0,31,2,13,23.5,-1,-1,0,0,1,0,0,0,"w1718","Hybrid",NA,"Mon","weekday"
"493",2018-03-06,"Brush Creek Rd","2","2","1",7.3,0,31,0,19,23.5,2,-1,-1,0,2,1,0,0,"w1718","Non.motorized",0,"Tue","weekday"
"494",2018-03-06,"Brush Creek Rd","2","2","1",7.3,0,31,0,19,23.5,2,-1,-1,0,2,1,0,0,"w1718","Mechanized",0,"Tue","weekday"
"495",2018-03-06,"Brush Creek Rd","2","2","1",7.3,0,31,0,19,23.5,2,-1,-1,0,2,1,0,0,"w1718","Motorized",1,"Tue","weekday"
"496",2018-03-06,"Brush Creek Rd","2","2","1",7.3,0,31,0,19,23.5,2,-1,-1,0,2,1,0,0,"w1718","Hybrid",0,"Tue","weekday"
"497",2018-03-07,"Brush Creek Rd","2","2","1",7.4,0.1,31,0,27,23.9,0,2,-1,-1,0,2,1,0,"w1718","Non.motorized",6,"Wed","weekday"
"498",2018-03-07,"Brush Creek Rd","2","2","1",7.4,0.1,31,0,27,23.9,0,2,-1,-1,0,2,1,0,"w1718","Mechanized",0,"Wed","weekday"
"499",2018-03-07,"Brush Creek Rd","2","2","1",7.4,0.1,31,0,27,23.9,0,2,-1,-1,0,2,1,0,"w1718","Motorized",2,"Wed","weekday"
"500",2018-03-07,"Brush Creek Rd","2","2","1",7.4,0.1,31,0,27,23.9,0,2,-1,-1,0,2,1,0,"w1718","Hybrid",0,"Wed","weekday"
"501",2018-03-08,"Brush Creek Rd","2","2","1",7.4,0,30,-1,33,24.7,0,0,2,-1,-1,-1,1,0,"w1718","Non.motorized",4,"Thu","weekday"
"502",2018-03-08,"Brush Creek Rd","2","2","1",7.4,0,30,-1,33,24.7,0,0,2,-1,-1,-1,1,0,"w1718","Mechanized",0,"Thu","weekday"
"503",2018-03-08,"Brush Creek Rd","2","2","1",7.4,0,30,-1,33,24.7,0,0,2,-1,-1,-1,1,0,"w1718","Motorized",0,"Thu","weekday"
"504",2018-03-08,"Brush Creek Rd","2","2","1",7.4,0,30,-1,33,24.7,0,0,2,-1,-1,-1,1,0,"w1718","Hybrid",0,"Thu","weekday"
"505",2018-03-09,"Brush Creek Rd","2","2","1",7.4,0,30,0,34,24.7,-1,0,0,2,-1,-1,-1,1,"w1718","Non.motorized",NA,"Fri","weekday"
"506",2018-03-09,"Brush Creek Rd","2","2","1",7.4,0,30,0,34,24.7,-1,0,0,2,-1,-1,-1,1,"w1718","Mechanized",NA,"Fri","weekday"
"507",2018-03-09,"Brush Creek Rd","2","2","1",7.4,0,30,0,34,24.7,-1,0,0,2,-1,-1,-1,1,"w1718","Motorized",NA,"Fri","weekday"
"508",2018-03-09,"Brush Creek Rd","2","2","1",7.4,0,30,0,34,24.7,-1,0,0,2,-1,-1,-1,1,"w1718","Hybrid",NA,"Fri","weekday"
"509",2018-03-10,"Brush Creek Rd","1","1","1",7.4,0,30,0,31,24.7,0,-1,0,0,0,-1,-1,-1,"w1718","Non.motorized",NA,"Sat","weekend"
"510",2018-03-10,"Brush Creek Rd","1","1","1",7.4,0,30,0,31,24.7,0,-1,0,0,0,-1,-1,-1,"w1718","Mechanized",NA,"Sat","weekend"
"511",2018-03-10,"Brush Creek Rd","1","1","1",7.4,0,30,0,31,24.7,0,-1,0,0,0,-1,-1,-1,"w1718","Motorized",NA,"Sat","weekend"
"512",2018-03-10,"Brush Creek Rd","1","1","1",7.4,0,30,0,31,24.7,0,-1,0,0,0,-1,-1,-1,"w1718","Hybrid",NA,"Sat","weekend"
"513",2018-03-11,"Brush Creek Rd","1","1","1",7.4,0,29,-1,31,25.5,0,0,-1,0,-1,-1,-2,-2,"w1718","Non.motorized",NA,"Sun","weekend"
"514",2018-03-11,"Brush Creek Rd","1","1","1",7.4,0,29,-1,31,25.5,0,0,-1,0,-1,-1,-2,-2,"w1718","Mechanized",NA,"Sun","weekend"
"515",2018-03-11,"Brush Creek Rd","1","1","1",7.4,0,29,-1,31,25.5,0,0,-1,0,-1,-1,-2,-2,"w1718","Motorized",NA,"Sun","weekend"
"516",2018-03-11,"Brush Creek Rd","1","1","1",7.4,0,29,-1,31,25.5,0,0,-1,0,-1,-1,-2,-2,"w1718","Hybrid",NA,"Sun","weekend"
"517",2018-03-12,"Brush Creek Rd","1","1","1",7.4,0,29,0,33,25.5,-1,0,0,-1,-1,-1,-1,-2,"w1718","Non.motorized",NA,"Mon","weekday"
"518",2018-03-12,"Brush Creek Rd","1","1","1",7.4,0,29,0,33,25.5,-1,0,0,-1,-1,-1,-1,-2,"w1718","Mechanized",NA,"Mon","weekday"
"519",2018-03-12,"Brush Creek Rd","1","1","1",7.4,0,29,0,33,25.5,-1,0,0,-1,-1,-1,-1,-2,"w1718","Motorized",NA,"Mon","weekday"
"520",2018-03-12,"Brush Creek Rd","1","1","1",7.4,0,29,0,33,25.5,-1,0,0,-1,-1,-1,-1,-2,"w1718","Hybrid",NA,"Mon","weekday"
"521",2018-03-13,"Brush Creek Rd","1","1","1",7.4,0,29,0,34,25.5,0,-1,0,0,0,-1,-1,-1,"w1718","Non.motorized",NA,"Tue","weekday"
"522",2018-03-13,"Brush Creek Rd","1","1","1",7.4,0,29,0,34,25.5,0,-1,0,0,0,-1,-1,-1,"w1718","Mechanized",NA,"Tue","weekday"
"523",2018-03-13,"Brush Creek Rd","1","1","1",7.4,0,29,0,34,25.5,0,-1,0,0,0,-1,-1,-1,"w1718","Motorized",NA,"Tue","weekday"
"524",2018-03-13,"Brush Creek Rd","1","1","1",7.4,0,29,0,34,25.5,0,-1,0,0,0,-1,-1,-1,"w1718","Hybrid",NA,"Tue","weekday"
"525",2018-03-14,"Brush Creek Rd","1","2","2",7.4,0,29,0,39,25.5,0,0,-1,0,0,0,-1,-1,"w1718","Non.motorized",NA,"Wed","weekday"
"526",2018-03-14,"Brush Creek Rd","1","2","2",7.4,0,29,0,39,25.5,0,0,-1,0,0,0,-1,-1,"w1718","Mechanized",NA,"Wed","weekday"
"527",2018-03-14,"Brush Creek Rd","1","2","2",7.4,0,29,0,39,25.5,0,0,-1,0,0,0,-1,-1,"w1718","Motorized",NA,"Wed","weekday"
"528",2018-03-14,"Brush Creek Rd","1","2","2",7.4,0,29,0,39,25.5,0,0,-1,0,0,0,-1,-1,"w1718","Hybrid",NA,"Wed","weekday"
"529",2018-03-15,"Brush Creek Rd","2","2","2",7.5,0.1,28,-1,31,26.8,0,0,0,-1,-1,-1,-1,-2,"w1718","Non.motorized",NA,"Thu","weekday"
"530",2018-03-15,"Brush Creek Rd","2","2","2",7.5,0.1,28,-1,31,26.8,0,0,0,-1,-1,-1,-1,-2,"w1718","Mechanized",NA,"Thu","weekday"
"531",2018-03-15,"Brush Creek Rd","2","2","2",7.5,0.1,28,-1,31,26.8,0,0,0,-1,-1,-1,-1,-2,"w1718","Motorized",NA,"Thu","weekday"
"532",2018-03-15,"Brush Creek Rd","2","2","2",7.5,0.1,28,-1,31,26.8,0,0,0,-1,-1,-1,-1,-2,"w1718","Hybrid",NA,"Thu","weekday"
"533",2018-03-16,"Brush Creek Rd","2","2","2",7.7,0.2,29,1,25,26.6,-1,0,0,0,0,0,0,0,"w1718","Non.motorized",NA,"Fri","weekday"
"534",2018-03-16,"Brush Creek Rd","2","2","2",7.7,0.2,29,1,25,26.6,-1,0,0,0,0,0,0,0,"w1718","Mechanized",NA,"Fri","weekday"
"535",2018-03-16,"Brush Creek Rd","2","2","2",7.7,0.2,29,1,25,26.6,-1,0,0,0,0,0,0,0,"w1718","Motorized",NA,"Fri","weekday"
"536",2018-03-16,"Brush Creek Rd","2","2","2",7.7,0.2,29,1,25,26.6,-1,0,0,0,0,0,0,0,"w1718","Hybrid",NA,"Fri","weekday"
"537",2018-03-17,"Brush Creek Rd","2","2","2",7.8,0.1,32,3,29,24.4,1,-1,0,0,4,3,3,3,"w1718","Non.motorized",NA,"Sat","weekend"
"538",2018-03-17,"Brush Creek Rd","2","2","2",7.8,0.1,32,3,29,24.4,1,-1,0,0,4,3,3,3,"w1718","Mechanized",NA,"Sat","weekend"
"539",2018-03-17,"Brush Creek Rd","2","2","2",7.8,0.1,32,3,29,24.4,1,-1,0,0,4,3,3,3,"w1718","Motorized",NA,"Sat","weekend"
"540",2018-03-17,"Brush Creek Rd","2","2","2",7.8,0.1,32,3,29,24.4,1,-1,0,0,4,3,3,3,"w1718","Hybrid",NA,"Sat","weekend"
"541",2018-03-18,"Brush Creek Rd","2","2","2",7.9,0.1,31,-1,24,25.5,3,1,-1,0,2,3,2,2,"w1718","Non.motorized",NA,"Sun","weekend"
"542",2018-03-18,"Brush Creek Rd","2","2","2",7.9,0.1,31,-1,24,25.5,3,1,-1,0,2,3,2,2,"w1718","Mechanized",NA,"Sun","weekend"
"543",2018-03-18,"Brush Creek Rd","2","2","2",7.9,0.1,31,-1,24,25.5,3,1,-1,0,2,3,2,2,"w1718","Motorized",NA,"Sun","weekend"
"544",2018-03-18,"Brush Creek Rd","2","2","2",7.9,0.1,31,-1,24,25.5,3,1,-1,0,2,3,2,2,"w1718","Hybrid",NA,"Sun","weekend"
"545",2018-03-19,"Brush Creek Rd","2","2","1",8,0.1,32,1,19,25,-1,3,1,-1,0,3,4,3,"w1718","Non.motorized",NA,"Mon","weekday"
"546",2018-03-19,"Brush Creek Rd","2","2","1",8,0.1,32,1,19,25,-1,3,1,-1,0,3,4,3,"w1718","Mechanized",NA,"Mon","weekday"
"547",2018-03-19,"Brush Creek Rd","2","2","1",8,0.1,32,1,19,25,-1,3,1,-1,0,3,4,3,"w1718","Motorized",NA,"Mon","weekday"
"548",2018-03-19,"Brush Creek Rd","2","2","1",8,0.1,32,1,19,25,-1,3,1,-1,0,3,4,3,"w1718","Hybrid",NA,"Mon","weekday"
"549",2018-03-20,"Brush Creek Rd","2","2","1",8,0,30,-2,24,26.7,1,-1,3,1,-1,-2,1,2,"w1718","Non.motorized",9,"Tue","weekday"
"550",2018-03-20,"Brush Creek Rd","2","2","1",8,0,30,-2,24,26.7,1,-1,3,1,-1,-2,1,2,"w1718","Mechanized",0,"Tue","weekday"
"551",2018-03-20,"Brush Creek Rd","2","2","1",8,0,30,-2,24,26.7,1,-1,3,1,-1,-2,1,2,"w1718","Motorized",0,"Tue","weekday"
"552",2018-03-20,"Brush Creek Rd","2","2","1",8,0,30,-2,24,26.7,1,-1,3,1,-1,-2,1,2,"w1718","Hybrid",0,"Tue","weekday"
"553",2018-03-21,"Brush Creek Rd","1","1","1",8.1,0.1,32,2,30,25.3,-2,1,-1,3,0,1,0,3,"w1718","Non.motorized",274,"Wed","weekday"
"554",2018-03-21,"Brush Creek Rd","1","1","1",8.1,0.1,32,2,30,25.3,-2,1,-1,3,0,1,0,3,"w1718","Mechanized",2,"Wed","weekday"
"555",2018-03-21,"Brush Creek Rd","1","1","1",8.1,0.1,32,2,30,25.3,-2,1,-1,3,0,1,0,3,"w1718","Motorized",8,"Wed","weekday"
"556",2018-03-21,"Brush Creek Rd","1","1","1",8.1,0.1,32,2,30,25.3,-2,1,-1,3,0,1,0,3,"w1718","Hybrid",0,"Wed","weekday"
"557",2018-03-22,"Brush Creek Rd","1","1","1",8.1,0,30,-2,36,27,2,-2,1,-1,0,-2,-1,-2,"w1718","Non.motorized",10,"Thu","weekday"
"558",2018-03-22,"Brush Creek Rd","1","1","1",8.1,0,30,-2,36,27,2,-2,1,-1,0,-2,-1,-2,"w1718","Mechanized",1,"Thu","weekday"
"559",2018-03-22,"Brush Creek Rd","1","1","1",8.1,0,30,-2,36,27,2,-2,1,-1,0,-2,-1,-2,"w1718","Motorized",1,"Thu","weekday"
"560",2018-03-22,"Brush Creek Rd","1","1","1",8.1,0,30,-2,36,27,2,-2,1,-1,0,-2,-1,-2,"w1718","Hybrid",0,"Thu","weekday"
"561",2018-03-23,"Brush Creek Rd","2","2","3",8.2,0.1,29,-1,34,28.3,-2,2,-2,1,-3,-1,-3,-2,"w1718","Non.motorized",6,"Fri","weekday"
"562",2018-03-23,"Brush Creek Rd","2","2","3",8.2,0.1,29,-1,34,28.3,-2,2,-2,1,-3,-1,-3,-2,"w1718","Mechanized",0,"Fri","weekday"
"563",2018-03-23,"Brush Creek Rd","2","2","3",8.2,0.1,29,-1,34,28.3,-2,2,-2,1,-3,-1,-3,-2,"w1718","Motorized",0,"Fri","weekday"
"564",2018-03-23,"Brush Creek Rd","2","2","3",8.2,0.1,29,-1,34,28.3,-2,2,-2,1,-3,-1,-3,-2,"w1718","Hybrid",0,"Fri","weekday"
"565",2018-03-24,"Brush Creek Rd","2","2","1",8.9,0.7,34,5,32,26.2,-1,-2,2,-2,4,2,4,2,"w1718","Non.motorized",3,"Sat","weekend"
"566",2018-03-24,"Brush Creek Rd","2","2","1",8.9,0.7,34,5,32,26.2,-1,-2,2,-2,4,2,4,2,"w1718","Mechanized",0,"Sat","weekend"
"567",2018-03-24,"Brush Creek Rd","2","2","1",8.9,0.7,34,5,32,26.2,-1,-2,2,-2,4,2,4,2,"w1718","Motorized",2,"Sat","weekend"
"568",2018-03-24,"Brush Creek Rd","2","2","1",8.9,0.7,34,5,32,26.2,-1,-2,2,-2,4,2,4,2,"w1718","Hybrid",1,"Sat","weekend"
"569",2018-03-25,"Brush Creek Rd","2","2","1",8.9,0,35,1,35,25.4,5,-1,-2,2,6,5,3,5,"w1718","Non.motorized",2,"Sun","weekend"
"570",2018-03-25,"Brush Creek Rd","2","2","1",8.9,0,35,1,35,25.4,5,-1,-2,2,6,5,3,5,"w1718","Mechanized",0,"Sun","weekend"
"571",2018-03-25,"Brush Creek Rd","2","2","1",8.9,0,35,1,35,25.4,5,-1,-2,2,6,5,3,5,"w1718","Motorized",0,"Sun","weekend"
"572",2018-03-25,"Brush Creek Rd","2","2","1",8.9,0,35,1,35,25.4,5,-1,-2,2,6,5,3,5,"w1718","Hybrid",0,"Sun","weekend"
"573",2018-03-26,"Brush Creek Rd","1","1","1",8.9,0,34,-1,31,26.2,1,5,-1,-2,0,5,4,2,"w1718","Non.motorized",2,"Mon","weekday"
"574",2018-03-26,"Brush Creek Rd","1","1","1",8.9,0,34,-1,31,26.2,1,5,-1,-2,0,5,4,2,"w1718","Mechanized",0,"Mon","weekday"
"575",2018-03-26,"Brush Creek Rd","1","1","1",8.9,0,34,-1,31,26.2,1,5,-1,-2,0,5,4,2,"w1718","Motorized",4,"Mon","weekday"
"576",2018-03-26,"Brush Creek Rd","1","1","1",8.9,0,34,-1,31,26.2,1,5,-1,-2,0,5,4,2,"w1718","Hybrid",2,"Mon","weekday"
"577",2018-03-26,"Brush Creek Rd","2","1","1",8.9,0,34,-1,31,26.2,1,5,-1,-2,0,5,4,2,"w1718","Non.motorized",2,"Mon","weekday"
"578",2018-03-26,"Brush Creek Rd","2","1","1",8.9,0,34,-1,31,26.2,1,5,-1,-2,0,5,4,2,"w1718","Mechanized",0,"Mon","weekday"
"579",2018-03-26,"Brush Creek Rd","2","1","1",8.9,0,34,-1,31,26.2,1,5,-1,-2,0,5,4,2,"w1718","Motorized",4,"Mon","weekday"
"580",2018-03-26,"Brush Creek Rd","2","1","1",8.9,0,34,-1,31,26.2,1,5,-1,-2,0,5,4,2,"w1718","Hybrid",2,"Mon","weekday"
"581",2018-03-27,"Brush Creek Rd","1","1","1",8.9,0,33,-1,29,27,-1,1,5,-1,-2,-1,4,3,"w1718","Non.motorized",2,"Tue","weekday"
"582",2018-03-27,"Brush Creek Rd","1","1","1",8.9,0,33,-1,29,27,-1,1,5,-1,-2,-1,4,3,"w1718","Mechanized",0,"Tue","weekday"
"583",2018-03-27,"Brush Creek Rd","1","1","1",8.9,0,33,-1,29,27,-1,1,5,-1,-2,-1,4,3,"w1718","Motorized",0,"Tue","weekday"
"584",2018-03-27,"Brush Creek Rd","1","1","1",8.9,0,33,-1,29,27,-1,1,5,-1,-2,-1,4,3,"w1718","Hybrid",0,"Tue","weekday"
"585",2018-03-28,"Brush Creek Rd","1","1","1",8.9,0,33,0,27,27,-1,-1,1,5,-1,-2,-1,4,"w1718","Non.motorized",7,"Wed","weekday"
"586",2018-03-28,"Brush Creek Rd","1","1","1",8.9,0,33,0,27,27,-1,-1,1,5,-1,-2,-1,4,"w1718","Mechanized",0,"Wed","weekday"
"587",2018-03-28,"Brush Creek Rd","1","1","1",8.9,0,33,0,27,27,-1,-1,1,5,-1,-2,-1,4,"w1718","Motorized",0,"Wed","weekday"
"588",2018-03-28,"Brush Creek Rd","1","1","1",8.9,0,33,0,27,27,-1,-1,1,5,-1,-2,-1,4,"w1718","Hybrid",0,"Wed","weekday"
"589",2018-03-29,"Brush Creek Rd","1","1","1",8.9,0,33,0,27,27,0,-1,-1,1,0,-1,-2,-1,"w1718","Non.motorized",6,"Thu","weekday"
"590",2018-03-29,"Brush Creek Rd","1","1","1",8.9,0,33,0,27,27,0,-1,-1,1,0,-1,-2,-1,"w1718","Mechanized",3,"Thu","weekday"
"591",2018-03-29,"Brush Creek Rd","1","1","1",8.9,0,33,0,27,27,0,-1,-1,1,0,-1,-2,-1,"w1718","Motorized",0,"Thu","weekday"
"592",2018-03-29,"Brush Creek Rd","1","1","1",8.9,0,33,0,27,27,0,-1,-1,1,0,-1,-2,-1,"w1718","Hybrid",0,"Thu","weekday"
"593",2018-03-30,"Brush Creek Rd","1","1","1",8.9,0,32,-1,33,27.8,0,0,-1,-1,-1,-1,-2,-3,"w1718","Non.motorized",0,"Fri","weekday"
"594",2018-03-30,"Brush Creek Rd","1","1","1",8.9,0,32,-1,33,27.8,0,0,-1,-1,-1,-1,-2,-3,"w1718","Mechanized",0,"Fri","weekday"
"595",2018-03-30,"Brush Creek Rd","1","1","1",8.9,0,32,-1,33,27.8,0,0,-1,-1,-1,-1,-2,-3,"w1718","Motorized",1,"Fri","weekday"
"596",2018-03-30,"Brush Creek Rd","1","1","1",8.9,0,32,-1,33,27.8,0,0,-1,-1,-1,-1,-2,-3,"w1718","Hybrid",0,"Fri","weekday"
"597",2018-03-31,"Brush Creek Rd","1","1","1",8.9,0,32,0,39,27.8,-1,0,0,-1,-1,-1,-1,-2,"w1718","Non.motorized",0,"Sat","weekend"
"598",2018-03-31,"Brush Creek Rd","1","1","1",8.9,0,32,0,39,27.8,-1,0,0,-1,-1,-1,-1,-2,"w1718","Mechanized",0,"Sat","weekend"
"599",2018-03-31,"Brush Creek Rd","1","1","1",8.9,0,32,0,39,27.8,-1,0,0,-1,-1,-1,-1,-2,"w1718","Motorized",0,"Sat","weekend"
"600",2018-03-31,"Brush Creek Rd","1","1","1",8.9,0,32,0,39,27.8,-1,0,0,-1,-1,-1,-1,-2,"w1718","Hybrid",0,"Sat","weekend"
"601",2018-04-01,"Brush Creek Rd","1","1","1",8.8,-0.1,30,-2,41,29.3,0,-1,0,0,-2,-3,-3,-3,"w1718","Non.motorized",3,"Sun","weekend"
"602",2018-04-01,"Brush Creek Rd","1","1","1",8.8,-0.1,30,-2,41,29.3,0,-1,0,0,-2,-3,-3,-3,"w1718","Mechanized",0,"Sun","weekend"
"603",2018-04-01,"Brush Creek Rd","1","1","1",8.8,-0.1,30,-2,41,29.3,0,-1,0,0,-2,-3,-3,-3,"w1718","Motorized",0,"Sun","weekend"
"604",2018-04-01,"Brush Creek Rd","1","1","1",8.8,-0.1,30,-2,41,29.3,0,-1,0,0,-2,-3,-3,-3,"w1718","Hybrid",0,"Sun","weekend"
"605",2018-04-02,"Brush Creek Rd","1","1","1",8.7,-0.1,29,-1,39,30,-2,0,-1,0,-3,-3,-4,-4,"w1718","Non.motorized",0,"Mon","weekday"
"606",2018-04-02,"Brush Creek Rd","1","1","1",8.7,-0.1,29,-1,39,30,-2,0,-1,0,-3,-3,-4,-4,"w1718","Mechanized",0,"Mon","weekday"
"607",2018-04-02,"Brush Creek Rd","1","1","1",8.7,-0.1,29,-1,39,30,-2,0,-1,0,-3,-3,-4,-4,"w1718","Motorized",0,"Mon","weekday"
"608",2018-04-02,"Brush Creek Rd","1","1","1",8.7,-0.1,29,-1,39,30,-2,0,-1,0,-3,-3,-4,-4,"w1718","Hybrid",0,"Mon","weekday"
"609",2018-04-03,"Brush Creek Rd","1","1","1",8.8,0.1,30,1,27,29.3,-1,-2,0,-1,0,-2,-2,-3,"w1718","Non.motorized",0,"Tue","weekday"
"610",2018-04-03,"Brush Creek Rd","1","1","1",8.8,0.1,30,1,27,29.3,-1,-2,0,-1,0,-2,-2,-3,"w1718","Mechanized",0,"Tue","weekday"
"611",2018-04-03,"Brush Creek Rd","1","1","1",8.8,0.1,30,1,27,29.3,-1,-2,0,-1,0,-2,-2,-3,"w1718","Motorized",0,"Tue","weekday"
"612",2018-04-03,"Brush Creek Rd","1","1","1",8.8,0.1,30,1,27,29.3,-1,-2,0,-1,0,-2,-2,-3,"w1718","Hybrid",0,"Tue","weekday"
"613",2018-04-04,"Brush Creek Rd","1","2","2",8.9,0.1,28,-2,33,31.8,1,-1,-2,0,-1,-2,-4,-4,"w1718","Non.motorized",0,"Wed","weekday"
"614",2018-04-04,"Brush Creek Rd","1","2","2",8.9,0.1,28,-2,33,31.8,1,-1,-2,0,-1,-2,-4,-4,"w1718","Mechanized",0,"Wed","weekday"
"615",2018-04-04,"Brush Creek Rd","1","2","2",8.9,0.1,28,-2,33,31.8,1,-1,-2,0,-1,-2,-4,-4,"w1718","Motorized",0,"Wed","weekday"
"616",2018-04-04,"Brush Creek Rd","1","2","2",8.9,0.1,28,-2,33,31.8,1,-1,-2,0,-1,-2,-4,-4,"w1718","Hybrid",0,"Wed","weekday"
"617",2018-04-05,"Brush Creek Rd","1","2","2",8.9,0,27,-1,35,33,-2,1,-1,-2,-3,-2,-3,-5,"w1718","Non.motorized",0,"Thu","weekday"
"618",2018-04-05,"Brush Creek Rd","1","2","2",8.9,0,27,-1,35,33,-2,1,-1,-2,-3,-2,-3,-5,"w1718","Mechanized",0,"Thu","weekday"
"619",2018-04-05,"Brush Creek Rd","1","2","2",8.9,0,27,-1,35,33,-2,1,-1,-2,-3,-2,-3,-5,"w1718","Motorized",0,"Thu","weekday"
"620",2018-04-05,"Brush Creek Rd","1","2","2",8.9,0,27,-1,35,33,-2,1,-1,-2,-3,-2,-3,-5,"w1718","Hybrid",0,"Thu","weekday"
"621",2018-02-15,"Cement Creek","3","3","3",6.3,0.1,28,-2,24,22.5,1,2,0,3,-1,1,1,4,"w1718","Non.motorized",2,"Thu","weekday"
"622",2018-02-15,"Cement Creek","3","3","3",6.3,0.1,28,-2,24,22.5,1,2,0,3,-1,1,1,4,"w1718","Mechanized",0,"Thu","weekday"
"623",2018-02-15,"Cement Creek","3","3","3",6.3,0.1,28,-2,24,22.5,1,2,0,3,-1,1,1,4,"w1718","Motorized",0,"Thu","weekday"
"624",2018-02-15,"Cement Creek","3","3","3",6.3,0.1,28,-2,24,22.5,1,2,0,3,-1,1,1,4,"w1718","Hybrid",0,"Thu","weekday"
"625",2018-02-16,"Cement Creek","3","3","3",6.7,0.4,32,4,18,20.9,-2,1,2,0,2,3,5,5,"w1718","Non.motorized",1,"Fri","weekday"
"626",2018-02-16,"Cement Creek","3","3","3",6.7,0.4,32,4,18,20.9,-2,1,2,0,2,3,5,5,"w1718","Mechanized",0,"Fri","weekday"
"627",2018-02-16,"Cement Creek","3","3","3",6.7,0.4,32,4,18,20.9,-2,1,2,0,2,3,5,5,"w1718","Motorized",0,"Fri","weekday"
"628",2018-02-16,"Cement Creek","3","3","3",6.7,0.4,32,4,18,20.9,-2,1,2,0,2,3,5,5,"w1718","Hybrid",0,"Fri","weekday"
"629",2018-02-17,"Cement Creek","3","3","2",6.7,0,32,0,25,20.9,4,-2,1,2,4,2,3,5,"w1718","Non.motorized",26,"Sat","weekend"
"630",2018-02-17,"Cement Creek","3","3","2",6.7,0,32,0,25,20.9,4,-2,1,2,4,2,3,5,"w1718","Mechanized",0,"Sat","weekend"
"631",2018-02-17,"Cement Creek","3","3","2",6.7,0,32,0,25,20.9,4,-2,1,2,4,2,3,5,"w1718","Motorized",0,"Sat","weekend"
"632",2018-02-17,"Cement Creek","3","3","2",6.7,0,32,0,25,20.9,4,-2,1,2,4,2,3,5,"w1718","Hybrid",0,"Sat","weekend"
"633",2018-02-18,"Cement Creek","2","2","2",6.7,0,31,-1,32,21.6,0,4,-2,1,-1,3,1,2,"w1718","Non.motorized",19,"Sun","weekend"
"634",2018-02-18,"Cement Creek","2","2","2",6.7,0,31,-1,32,21.6,0,4,-2,1,-1,3,1,2,"w1718","Mechanized",0,"Sun","weekend"
"635",2018-02-18,"Cement Creek","2","2","2",6.7,0,31,-1,32,21.6,0,4,-2,1,-1,3,1,2,"w1718","Motorized",0,"Sun","weekend"
"636",2018-02-18,"Cement Creek","2","2","2",6.7,0,31,-1,32,21.6,0,4,-2,1,-1,3,1,2,"w1718","Hybrid",0,"Sun","weekend"
"637",2018-02-19,"Cement Creek","2","2","2",6.8,0.1,29,-2,24,23.4,-1,0,4,-2,-3,-3,1,-1,"w1718","Non.motorized",1,"Mon","weekday"
"638",2018-02-19,"Cement Creek","2","2","2",6.8,0.1,29,-2,24,23.4,-1,0,4,-2,-3,-3,1,-1,"w1718","Mechanized",0,"Mon","weekday"
"639",2018-02-19,"Cement Creek","2","2","2",6.8,0.1,29,-2,24,23.4,-1,0,4,-2,-3,-3,1,-1,"w1718","Motorized",0,"Mon","weekday"
"640",2018-02-19,"Cement Creek","2","2","2",6.8,0.1,29,-2,24,23.4,-1,0,4,-2,-3,-3,1,-1,"w1718","Hybrid",0,"Mon","weekday"
"641",2018-02-19,"Cement Creek","3","3","3",6.8,0.1,29,-2,24,23.4,-1,0,4,-2,-3,-3,1,-1,"w1718","Non.motorized",1,"Mon","weekday"
"642",2018-02-19,"Cement Creek","3","3","3",6.8,0.1,29,-2,24,23.4,-1,0,4,-2,-3,-3,1,-1,"w1718","Mechanized",0,"Mon","weekday"
"643",2018-02-19,"Cement Creek","3","3","3",6.8,0.1,29,-2,24,23.4,-1,0,4,-2,-3,-3,1,-1,"w1718","Motorized",0,"Mon","weekday"
"644",2018-02-19,"Cement Creek","3","3","3",6.8,0.1,29,-2,24,23.4,-1,0,4,-2,-3,-3,1,-1,"w1718","Hybrid",0,"Mon","weekday"
"645",2018-02-20,"Cement Creek","3","3","3",6.8,0,31,2,8,21.9,-2,-1,0,4,0,-1,-1,3,"w1718","Non.motorized",0,"Tue","weekday"
"646",2018-02-20,"Cement Creek","3","3","3",6.8,0,31,2,8,21.9,-2,-1,0,4,0,-1,-1,3,"w1718","Mechanized",0,"Tue","weekday"
"647",2018-02-20,"Cement Creek","3","3","3",6.8,0,31,2,8,21.9,-2,-1,0,4,0,-1,-1,3,"w1718","Motorized",0,"Tue","weekday"
"648",2018-02-20,"Cement Creek","3","3","3",6.8,0,31,2,8,21.9,-2,-1,0,4,0,-1,-1,3,"w1718","Hybrid",0,"Tue","weekday"
"649",2018-02-21,"Cement Creek","3","3","3",6.8,0,31,0,11,21.9,2,-2,-1,0,2,0,-1,-1,"w1718","Non.motorized",1,"Wed","weekday"
"650",2018-02-21,"Cement Creek","3","3","3",6.8,0,31,0,11,21.9,2,-2,-1,0,2,0,-1,-1,"w1718","Mechanized",0,"Wed","weekday"
"651",2018-02-21,"Cement Creek","3","3","3",6.8,0,31,0,11,21.9,2,-2,-1,0,2,0,-1,-1,"w1718","Motorized",1,"Wed","weekday"
"652",2018-02-21,"Cement Creek","3","3","3",6.8,0,31,0,11,21.9,2,-2,-1,0,2,0,-1,-1,"w1718","Hybrid",0,"Wed","weekday"
"653",2018-02-22,"Cement Creek","3","3","2",6.8,0,30,-1,16,22.7,0,2,-2,-1,-1,1,-1,-2,"w1718","Non.motorized",0,"Thu","weekday"
"654",2018-02-22,"Cement Creek","3","3","2",6.8,0,30,-1,16,22.7,0,2,-2,-1,-1,1,-1,-2,"w1718","Mechanized",0,"Thu","weekday"
"655",2018-02-22,"Cement Creek","3","3","2",6.8,0,30,-1,16,22.7,0,2,-2,-1,-1,1,-1,-2,"w1718","Motorized",0,"Thu","weekday"
"656",2018-02-22,"Cement Creek","3","3","2",6.8,0,30,-1,16,22.7,0,2,-2,-1,-1,1,-1,-2,"w1718","Hybrid",0,"Thu","weekday"
"657",2018-02-23,"Cement Creek","3","3","2",6.9,0.1,30,0,15,23,-1,0,2,-2,-1,-1,1,-1,"w1718","Non.motorized",0,"Fri","weekday"
"658",2018-02-23,"Cement Creek","3","3","2",6.9,0.1,30,0,15,23,-1,0,2,-2,-1,-1,1,-1,"w1718","Mechanized",0,"Fri","weekday"
"659",2018-02-23,"Cement Creek","3","3","2",6.9,0.1,30,0,15,23,-1,0,2,-2,-1,-1,1,-1,"w1718","Motorized",0,"Fri","weekday"
"660",2018-02-23,"Cement Creek","3","3","2",6.9,0.1,30,0,15,23,-1,0,2,-2,-1,-1,1,-1,"w1718","Hybrid",0,"Fri","weekday"
"661",2018-02-24,"Cement Creek","3","3","2",6.9,0,31,1,10,22.3,0,-1,0,2,1,0,0,2,"w1718","Non.motorized",1,"Sat","weekend"
"662",2018-02-24,"Cement Creek","3","3","2",6.9,0,31,1,10,22.3,0,-1,0,2,1,0,0,2,"w1718","Mechanized",0,"Sat","weekend"
"663",2018-02-24,"Cement Creek","3","3","2",6.9,0,31,1,10,22.3,0,-1,0,2,1,0,0,2,"w1718","Motorized",0,"Sat","weekend"
"664",2018-02-24,"Cement Creek","3","3","2",6.9,0,31,1,10,22.3,0,-1,0,2,1,0,0,2,"w1718","Hybrid",0,"Sat","weekend"
"665",2018-02-25,"Cement Creek","3","3","2",7.1,0.2,32,1,11,22.2,1,0,-1,0,2,2,1,1,"w1718","Non.motorized",3,"Sun","weekend"
"666",2018-02-25,"Cement Creek","3","3","2",7.1,0.2,32,1,11,22.2,1,0,-1,0,2,2,1,1,"w1718","Mechanized",0,"Sun","weekend"
"667",2018-02-25,"Cement Creek","3","3","2",7.1,0.2,32,1,11,22.2,1,0,-1,0,2,2,1,1,"w1718","Motorized",0,"Sun","weekend"
"668",2018-02-25,"Cement Creek","3","3","2",7.1,0.2,32,1,11,22.2,1,0,-1,0,2,2,1,1,"w1718","Hybrid",0,"Sun","weekend"
"669",2018-02-26,"Cement Creek","2","2","2",7.1,0,32,0,20,22.2,1,1,0,-1,1,2,2,1,"w1718","Non.motorized",3,"Mon","weekday"
"670",2018-02-26,"Cement Creek","2","2","2",7.1,0,32,0,20,22.2,1,1,0,-1,1,2,2,1,"w1718","Mechanized",0,"Mon","weekday"
"671",2018-02-26,"Cement Creek","2","2","2",7.1,0,32,0,20,22.2,1,1,0,-1,1,2,2,1,"w1718","Motorized",0,"Mon","weekday"
"672",2018-02-26,"Cement Creek","2","2","2",7.1,0,32,0,20,22.2,1,1,0,-1,1,2,2,1,"w1718","Hybrid",0,"Mon","weekday"
"673",2018-02-27,"Cement Creek","2","2","2",7.2,0.1,32,0,26,22.5,0,1,1,0,0,1,2,2,"w1718","Non.motorized",16,"Tue","weekday"
"674",2018-02-27,"Cement Creek","2","2","2",7.2,0.1,32,0,26,22.5,0,1,1,0,0,1,2,2,"w1718","Mechanized",2,"Tue","weekday"
"675",2018-02-27,"Cement Creek","2","2","2",7.2,0.1,32,0,26,22.5,0,1,1,0,0,1,2,2,"w1718","Motorized",9,"Tue","weekday"
"676",2018-02-27,"Cement Creek","2","2","2",7.2,0.1,32,0,26,22.5,0,1,1,0,0,1,2,2,"w1718","Hybrid",0,"Tue","weekday"
"677",2018-02-28,"Cement Creek","2","2","2",7.2,0,31,-1,23,23.2,0,0,1,1,-1,-1,0,1,"w1718","Non.motorized",12,"Wed","weekday"
"678",2018-02-28,"Cement Creek","2","2","2",7.2,0,31,-1,23,23.2,0,0,1,1,-1,-1,0,1,"w1718","Mechanized",1,"Wed","weekday"
"679",2018-02-28,"Cement Creek","2","2","2",7.2,0,31,-1,23,23.2,0,0,1,1,-1,-1,0,1,"w1718","Motorized",5,"Wed","weekday"
"680",2018-02-28,"Cement Creek","2","2","2",7.2,0,31,-1,23,23.2,0,0,1,1,-1,-1,0,1,"w1718","Hybrid",0,"Wed","weekday"
"681",2018-03-01,"Cement Creek","2","2","2",7.2,0,31,0,24,23.2,-1,0,0,1,-1,-1,-1,0,"w1718","Non.motorized",10,"Thu","weekday"
"682",2018-03-01,"Cement Creek","2","2","2",7.2,0,31,0,24,23.2,-1,0,0,1,-1,-1,-1,0,"w1718","Mechanized",5,"Thu","weekday"
"683",2018-03-01,"Cement Creek","2","2","2",7.2,0,31,0,24,23.2,-1,0,0,1,-1,-1,-1,0,"w1718","Motorized",7,"Thu","weekday"
"684",2018-03-01,"Cement Creek","2","2","2",7.2,0,31,0,24,23.2,-1,0,0,1,-1,-1,-1,0,"w1718","Hybrid",0,"Thu","weekday"
"685",2018-03-02,"Cement Creek","2","2","1",7.2,0,31,0,30,23.2,0,-1,0,0,0,-1,-1,-1,"w1718","Non.motorized",19,"Fri","weekday"
"686",2018-03-02,"Cement Creek","2","2","1",7.2,0,31,0,30,23.2,0,-1,0,0,0,-1,-1,-1,"w1718","Mechanized",2,"Fri","weekday"
"687",2018-03-02,"Cement Creek","2","2","1",7.2,0,31,0,30,23.2,0,-1,0,0,0,-1,-1,-1,"w1718","Motorized",12,"Fri","weekday"
"688",2018-03-02,"Cement Creek","2","2","1",7.2,0,31,0,30,23.2,0,-1,0,0,0,-1,-1,-1,"w1718","Hybrid",0,"Fri","weekday"
"689",2018-03-03,"Cement Creek","2","2","1",7.3,0.1,30,-1,34,24.3,0,0,-1,0,-1,-1,-2,-2,"w1718","Non.motorized",49,"Sat","weekend"
"690",2018-03-03,"Cement Creek","2","2","1",7.3,0.1,30,-1,34,24.3,0,0,-1,0,-1,-1,-2,-2,"w1718","Mechanized",1,"Sat","weekend"
"691",2018-03-03,"Cement Creek","2","2","1",7.3,0.1,30,-1,34,24.3,0,0,-1,0,-1,-1,-2,-2,"w1718","Motorized",7,"Sat","weekend"
"692",2018-03-03,"Cement Creek","2","2","1",7.3,0.1,30,-1,34,24.3,0,0,-1,0,-1,-1,-2,-2,"w1718","Hybrid",0,"Sat","weekend"
"693",2018-03-04,"Cement Creek","2","2","1",7.3,0,29,-1,24,25.2,-1,0,0,-1,-2,-2,-2,-3,"w1718","Non.motorized",39,"Sun","weekend"
"694",2018-03-04,"Cement Creek","2","2","1",7.3,0,29,-1,24,25.2,-1,0,0,-1,-2,-2,-2,-3,"w1718","Mechanized",2,"Sun","weekend"
"695",2018-03-04,"Cement Creek","2","2","1",7.3,0,29,-1,24,25.2,-1,0,0,-1,-2,-2,-2,-3,"w1718","Motorized",5,"Sun","weekend"
"696",2018-03-04,"Cement Creek","2","2","1",7.3,0,29,-1,24,25.2,-1,0,0,-1,-2,-2,-2,-3,"w1718","Hybrid",0,"Sun","weekend"
"697",2018-03-05,"Cement Creek","2","2","1",7.3,0,31,2,13,23.5,-1,-1,0,0,1,0,0,0,"w1718","Non.motorized",17,"Mon","weekday"
"698",2018-03-05,"Cement Creek","2","2","1",7.3,0,31,2,13,23.5,-1,-1,0,0,1,0,0,0,"w1718","Mechanized",0,"Mon","weekday"
"699",2018-03-05,"Cement Creek","2","2","1",7.3,0,31,2,13,23.5,-1,-1,0,0,1,0,0,0,"w1718","Motorized",9,"Mon","weekday"
"700",2018-03-05,"Cement Creek","2","2","1",7.3,0,31,2,13,23.5,-1,-1,0,0,1,0,0,0,"w1718","Hybrid",0,"Mon","weekday"
"701",2018-03-06,"Cement Creek","2","2","1",7.3,0,31,0,19,23.5,2,-1,-1,0,2,1,0,0,"w1718","Non.motorized",12,"Tue","weekday"
"702",2018-03-06,"Cement Creek","2","2","1",7.3,0,31,0,19,23.5,2,-1,-1,0,2,1,0,0,"w1718","Mechanized",1,"Tue","weekday"
"703",2018-03-06,"Cement Creek","2","2","1",7.3,0,31,0,19,23.5,2,-1,-1,0,2,1,0,0,"w1718","Motorized",6,"Tue","weekday"
"704",2018-03-06,"Cement Creek","2","2","1",7.3,0,31,0,19,23.5,2,-1,-1,0,2,1,0,0,"w1718","Hybrid",0,"Tue","weekday"
"705",2018-03-07,"Cement Creek","2","2","1",7.4,0.1,31,0,27,23.9,0,2,-1,-1,0,2,1,0,"w1718","Non.motorized",22,"Wed","weekday"
"706",2018-03-07,"Cement Creek","2","2","1",7.4,0.1,31,0,27,23.9,0,2,-1,-1,0,2,1,0,"w1718","Mechanized",3,"Wed","weekday"
"707",2018-03-07,"Cement Creek","2","2","1",7.4,0.1,31,0,27,23.9,0,2,-1,-1,0,2,1,0,"w1718","Motorized",7,"Wed","weekday"
"708",2018-03-07,"Cement Creek","2","2","1",7.4,0.1,31,0,27,23.9,0,2,-1,-1,0,2,1,0,"w1718","Hybrid",2,"Wed","weekday"
"709",2018-03-08,"Cement Creek","2","2","1",7.4,0,30,-1,33,24.7,0,0,2,-1,-1,-1,1,0,"w1718","Non.motorized",13,"Thu","weekday"
"710",2018-03-08,"Cement Creek","2","2","1",7.4,0,30,-1,33,24.7,0,0,2,-1,-1,-1,1,0,"w1718","Mechanized",1,"Thu","weekday"
"711",2018-03-08,"Cement Creek","2","2","1",7.4,0,30,-1,33,24.7,0,0,2,-1,-1,-1,1,0,"w1718","Motorized",2,"Thu","weekday"
"712",2018-03-08,"Cement Creek","2","2","1",7.4,0,30,-1,33,24.7,0,0,2,-1,-1,-1,1,0,"w1718","Hybrid",0,"Thu","weekday"
"713",2018-03-09,"Cement Creek","2","2","1",7.4,0,30,0,34,24.7,-1,0,0,2,-1,-1,-1,1,"w1718","Non.motorized",5,"Fri","weekday"
"714",2018-03-09,"Cement Creek","2","2","1",7.4,0,30,0,34,24.7,-1,0,0,2,-1,-1,-1,1,"w1718","Mechanized",2,"Fri","weekday"
"715",2018-03-09,"Cement Creek","2","2","1",7.4,0,30,0,34,24.7,-1,0,0,2,-1,-1,-1,1,"w1718","Motorized",7,"Fri","weekday"
"716",2018-03-09,"Cement Creek","2","2","1",7.4,0,30,0,34,24.7,-1,0,0,2,-1,-1,-1,1,"w1718","Hybrid",0,"Fri","weekday"
"717",2018-03-10,"Cement Creek","1","1","1",7.4,0,30,0,31,24.7,0,-1,0,0,0,-1,-1,-1,"w1718","Non.motorized",11,"Sat","weekend"
"718",2018-03-10,"Cement Creek","1","1","1",7.4,0,30,0,31,24.7,0,-1,0,0,0,-1,-1,-1,"w1718","Mechanized",2,"Sat","weekend"
"719",2018-03-10,"Cement Creek","1","1","1",7.4,0,30,0,31,24.7,0,-1,0,0,0,-1,-1,-1,"w1718","Motorized",5,"Sat","weekend"
"720",2018-03-10,"Cement Creek","1","1","1",7.4,0,30,0,31,24.7,0,-1,0,0,0,-1,-1,-1,"w1718","Hybrid",0,"Sat","weekend"
"721",2018-03-11,"Cement Creek","1","1","1",7.4,0,29,-1,31,25.5,0,0,-1,0,-1,-1,-2,-2,"w1718","Non.motorized",30,"Sun","weekend"
"722",2018-03-11,"Cement Creek","1","1","1",7.4,0,29,-1,31,25.5,0,0,-1,0,-1,-1,-2,-2,"w1718","Mechanized",0,"Sun","weekend"
"723",2018-03-11,"Cement Creek","1","1","1",7.4,0,29,-1,31,25.5,0,0,-1,0,-1,-1,-2,-2,"w1718","Motorized",6,"Sun","weekend"
"724",2018-03-11,"Cement Creek","1","1","1",7.4,0,29,-1,31,25.5,0,0,-1,0,-1,-1,-2,-2,"w1718","Hybrid",2,"Sun","weekend"
"725",2018-03-12,"Cement Creek","1","1","1",7.4,0,29,0,33,25.5,-1,0,0,-1,-1,-1,-1,-2,"w1718","Non.motorized",15,"Mon","weekday"
"726",2018-03-12,"Cement Creek","1","1","1",7.4,0,29,0,33,25.5,-1,0,0,-1,-1,-1,-1,-2,"w1718","Mechanized",0,"Mon","weekday"
"727",2018-03-12,"Cement Creek","1","1","1",7.4,0,29,0,33,25.5,-1,0,0,-1,-1,-1,-1,-2,"w1718","Motorized",4,"Mon","weekday"
"728",2018-03-12,"Cement Creek","1","1","1",7.4,0,29,0,33,25.5,-1,0,0,-1,-1,-1,-1,-2,"w1718","Hybrid",2,"Mon","weekday"
"729",2018-03-13,"Cement Creek","1","1","1",7.4,0,29,0,34,25.5,0,-1,0,0,0,-1,-1,-1,"w1718","Non.motorized",4,"Tue","weekday"
"730",2018-03-13,"Cement Creek","1","1","1",7.4,0,29,0,34,25.5,0,-1,0,0,0,-1,-1,-1,"w1718","Mechanized",0,"Tue","weekday"
"731",2018-03-13,"Cement Creek","1","1","1",7.4,0,29,0,34,25.5,0,-1,0,0,0,-1,-1,-1,"w1718","Motorized",10,"Tue","weekday"
"732",2018-03-13,"Cement Creek","1","1","1",7.4,0,29,0,34,25.5,0,-1,0,0,0,-1,-1,-1,"w1718","Hybrid",3,"Tue","weekday"
"733",2018-03-14,"Cement Creek","1","2","2",7.4,0,29,0,39,25.5,0,0,-1,0,0,0,-1,-1,"w1718","Non.motorized",13,"Wed","weekday"
"734",2018-03-14,"Cement Creek","1","2","2",7.4,0,29,0,39,25.5,0,0,-1,0,0,0,-1,-1,"w1718","Mechanized",2,"Wed","weekday"
"735",2018-03-14,"Cement Creek","1","2","2",7.4,0,29,0,39,25.5,0,0,-1,0,0,0,-1,-1,"w1718","Motorized",3,"Wed","weekday"
"736",2018-03-14,"Cement Creek","1","2","2",7.4,0,29,0,39,25.5,0,0,-1,0,0,0,-1,-1,"w1718","Hybrid",0,"Wed","weekday"
"737",2018-03-15,"Cement Creek","2","2","2",7.5,0.1,28,-1,31,26.8,0,0,0,-1,-1,-1,-1,-2,"w1718","Non.motorized",11,"Thu","weekday"
"738",2018-03-15,"Cement Creek","2","2","2",7.5,0.1,28,-1,31,26.8,0,0,0,-1,-1,-1,-1,-2,"w1718","Mechanized",0,"Thu","weekday"
"739",2018-03-15,"Cement Creek","2","2","2",7.5,0.1,28,-1,31,26.8,0,0,0,-1,-1,-1,-1,-2,"w1718","Motorized",0,"Thu","weekday"
"740",2018-03-15,"Cement Creek","2","2","2",7.5,0.1,28,-1,31,26.8,0,0,0,-1,-1,-1,-1,-2,"w1718","Hybrid",0,"Thu","weekday"
"741",2018-03-16,"Cement Creek","2","2","2",7.7,0.2,29,1,25,26.6,-1,0,0,0,0,0,0,0,"w1718","Non.motorized",21,"Fri","weekday"
"742",2018-03-16,"Cement Creek","2","2","2",7.7,0.2,29,1,25,26.6,-1,0,0,0,0,0,0,0,"w1718","Mechanized",0,"Fri","weekday"
"743",2018-03-16,"Cement Creek","2","2","2",7.7,0.2,29,1,25,26.6,-1,0,0,0,0,0,0,0,"w1718","Motorized",6,"Fri","weekday"
"744",2018-03-16,"Cement Creek","2","2","2",7.7,0.2,29,1,25,26.6,-1,0,0,0,0,0,0,0,"w1718","Hybrid",0,"Fri","weekday"
"745",2018-03-17,"Cement Creek","2","2","2",7.8,0.1,32,3,29,24.4,1,-1,0,0,4,3,3,3,"w1718","Non.motorized",40,"Sat","weekend"
"746",2018-03-17,"Cement Creek","2","2","2",7.8,0.1,32,3,29,24.4,1,-1,0,0,4,3,3,3,"w1718","Mechanized",1,"Sat","weekend"
"747",2018-03-17,"Cement Creek","2","2","2",7.8,0.1,32,3,29,24.4,1,-1,0,0,4,3,3,3,"w1718","Motorized",8,"Sat","weekend"
"748",2018-03-17,"Cement Creek","2","2","2",7.8,0.1,32,3,29,24.4,1,-1,0,0,4,3,3,3,"w1718","Hybrid",0,"Sat","weekend"
"749",2018-03-18,"Cement Creek","2","2","2",7.9,0.1,31,-1,24,25.5,3,1,-1,0,2,3,2,2,"w1718","Non.motorized",13,"Sun","weekend"
"750",2018-03-18,"Cement Creek","2","2","2",7.9,0.1,31,-1,24,25.5,3,1,-1,0,2,3,2,2,"w1718","Mechanized",1,"Sun","weekend"
"751",2018-03-18,"Cement Creek","2","2","2",7.9,0.1,31,-1,24,25.5,3,1,-1,0,2,3,2,2,"w1718","Motorized",8,"Sun","weekend"
"752",2018-03-18,"Cement Creek","2","2","2",7.9,0.1,31,-1,24,25.5,3,1,-1,0,2,3,2,2,"w1718","Hybrid",0,"Sun","weekend"
"753",2018-03-19,"Cement Creek","2","2","1",8,0.1,32,1,19,25,-1,3,1,-1,0,3,4,3,"w1718","Non.motorized",9,"Mon","weekday"
"754",2018-03-19,"Cement Creek","2","2","1",8,0.1,32,1,19,25,-1,3,1,-1,0,3,4,3,"w1718","Mechanized",1,"Mon","weekday"
"755",2018-03-19,"Cement Creek","2","2","1",8,0.1,32,1,19,25,-1,3,1,-1,0,3,4,3,"w1718","Motorized",7,"Mon","weekday"
"756",2018-03-19,"Cement Creek","2","2","1",8,0.1,32,1,19,25,-1,3,1,-1,0,3,4,3,"w1718","Hybrid",0,"Mon","weekday"
"757",2018-03-20,"Cement Creek","2","2","1",8,0,30,-2,24,26.7,1,-1,3,1,-1,-2,1,2,"w1718","Non.motorized",13,"Tue","weekday"
"758",2018-03-20,"Cement Creek","2","2","1",8,0,30,-2,24,26.7,1,-1,3,1,-1,-2,1,2,"w1718","Mechanized",2,"Tue","weekday"
"759",2018-03-20,"Cement Creek","2","2","1",8,0,30,-2,24,26.7,1,-1,3,1,-1,-2,1,2,"w1718","Motorized",10,"Tue","weekday"
"760",2018-03-20,"Cement Creek","2","2","1",8,0,30,-2,24,26.7,1,-1,3,1,-1,-2,1,2,"w1718","Hybrid",0,"Tue","weekday"
"761",2018-03-21,"Cement Creek","1","1","1",8.1,0.1,32,2,30,25.3,-2,1,-1,3,0,1,0,3,"w1718","Non.motorized",8,"Wed","weekday"
"762",2018-03-21,"Cement Creek","1","1","1",8.1,0.1,32,2,30,25.3,-2,1,-1,3,0,1,0,3,"w1718","Mechanized",0,"Wed","weekday"
"763",2018-03-21,"Cement Creek","1","1","1",8.1,0.1,32,2,30,25.3,-2,1,-1,3,0,1,0,3,"w1718","Motorized",6,"Wed","weekday"
"764",2018-03-21,"Cement Creek","1","1","1",8.1,0.1,32,2,30,25.3,-2,1,-1,3,0,1,0,3,"w1718","Hybrid",1,"Wed","weekday"
"765",2018-03-22,"Cement Creek","1","1","1",8.1,0,30,-2,36,27,2,-2,1,-1,0,-2,-1,-2,"w1718","Non.motorized",21,"Thu","weekday"
"766",2018-03-22,"Cement Creek","1","1","1",8.1,0,30,-2,36,27,2,-2,1,-1,0,-2,-1,-2,"w1718","Mechanized",0,"Thu","weekday"
"767",2018-03-22,"Cement Creek","1","1","1",8.1,0,30,-2,36,27,2,-2,1,-1,0,-2,-1,-2,"w1718","Motorized",3,"Thu","weekday"
"768",2018-03-22,"Cement Creek","1","1","1",8.1,0,30,-2,36,27,2,-2,1,-1,0,-2,-1,-2,"w1718","Hybrid",0,"Thu","weekday"
"769",2018-03-23,"Cement Creek","2","2","3",8.2,0.1,29,-1,34,28.3,-2,2,-2,1,-3,-1,-3,-2,"w1718","Non.motorized",2,"Fri","weekday"
"770",2018-03-23,"Cement Creek","2","2","3",8.2,0.1,29,-1,34,28.3,-2,2,-2,1,-3,-1,-3,-2,"w1718","Mechanized",0,"Fri","weekday"
"771",2018-03-23,"Cement Creek","2","2","3",8.2,0.1,29,-1,34,28.3,-2,2,-2,1,-3,-1,-3,-2,"w1718","Motorized",4,"Fri","weekday"
"772",2018-03-23,"Cement Creek","2","2","3",8.2,0.1,29,-1,34,28.3,-2,2,-2,1,-3,-1,-3,-2,"w1718","Hybrid",0,"Fri","weekday"
"773",2018-03-24,"Cement Creek","2","2","1",8.9,0.7,34,5,32,26.2,-1,-2,2,-2,4,2,4,2,"w1718","Non.motorized",6,"Sat","weekend"
"774",2018-03-24,"Cement Creek","2","2","1",8.9,0.7,34,5,32,26.2,-1,-2,2,-2,4,2,4,2,"w1718","Mechanized",0,"Sat","weekend"
"775",2018-03-24,"Cement Creek","2","2","1",8.9,0.7,34,5,32,26.2,-1,-2,2,-2,4,2,4,2,"w1718","Motorized",5,"Sat","weekend"
"776",2018-03-24,"Cement Creek","2","2","1",8.9,0.7,34,5,32,26.2,-1,-2,2,-2,4,2,4,2,"w1718","Hybrid",0,"Sat","weekend"
"777",2018-03-25,"Cement Creek","2","2","1",8.9,0,35,1,35,25.4,5,-1,-2,2,6,5,3,5,"w1718","Non.motorized",20,"Sun","weekend"
"778",2018-03-25,"Cement Creek","2","2","1",8.9,0,35,1,35,25.4,5,-1,-2,2,6,5,3,5,"w1718","Mechanized",0,"Sun","weekend"
"779",2018-03-25,"Cement Creek","2","2","1",8.9,0,35,1,35,25.4,5,-1,-2,2,6,5,3,5,"w1718","Motorized",6,"Sun","weekend"
"780",2018-03-25,"Cement Creek","2","2","1",8.9,0,35,1,35,25.4,5,-1,-2,2,6,5,3,5,"w1718","Hybrid",2,"Sun","weekend"
"781",2018-03-26,"Cement Creek","1","1","1",8.9,0,34,-1,31,26.2,1,5,-1,-2,0,5,4,2,"w1718","Non.motorized",10,"Mon","weekday"
"782",2018-03-26,"Cement Creek","1","1","1",8.9,0,34,-1,31,26.2,1,5,-1,-2,0,5,4,2,"w1718","Mechanized",1,"Mon","weekday"
"783",2018-03-26,"Cement Creek","1","1","1",8.9,0,34,-1,31,26.2,1,5,-1,-2,0,5,4,2,"w1718","Motorized",2,"Mon","weekday"
"784",2018-03-26,"Cement Creek","1","1","1",8.9,0,34,-1,31,26.2,1,5,-1,-2,0,5,4,2,"w1718","Hybrid",0,"Mon","weekday"
"785",2018-03-26,"Cement Creek","2","1","1",8.9,0,34,-1,31,26.2,1,5,-1,-2,0,5,4,2,"w1718","Non.motorized",10,"Mon","weekday"
"786",2018-03-26,"Cement Creek","2","1","1",8.9,0,34,-1,31,26.2,1,5,-1,-2,0,5,4,2,"w1718","Mechanized",1,"Mon","weekday"
"787",2018-03-26,"Cement Creek","2","1","1",8.9,0,34,-1,31,26.2,1,5,-1,-2,0,5,4,2,"w1718","Motorized",2,"Mon","weekday"
"788",2018-03-26,"Cement Creek","2","1","1",8.9,0,34,-1,31,26.2,1,5,-1,-2,0,5,4,2,"w1718","Hybrid",0,"Mon","weekday"
"789",2018-03-27,"Cement Creek","1","1","1",8.9,0,33,-1,29,27,-1,1,5,-1,-2,-1,4,3,"w1718","Non.motorized",2,"Tue","weekday"
"790",2018-03-27,"Cement Creek","1","1","1",8.9,0,33,-1,29,27,-1,1,5,-1,-2,-1,4,3,"w1718","Mechanized",0,"Tue","weekday"
"791",2018-03-27,"Cement Creek","1","1","1",8.9,0,33,-1,29,27,-1,1,5,-1,-2,-1,4,3,"w1718","Motorized",4,"Tue","weekday"
"792",2018-03-27,"Cement Creek","1","1","1",8.9,0,33,-1,29,27,-1,1,5,-1,-2,-1,4,3,"w1718","Hybrid",0,"Tue","weekday"
"793",2018-03-28,"Cement Creek","1","1","1",8.9,0,33,0,27,27,-1,-1,1,5,-1,-2,-1,4,"w1718","Non.motorized",10,"Wed","weekday"
"794",2018-03-28,"Cement Creek","1","1","1",8.9,0,33,0,27,27,-1,-1,1,5,-1,-2,-1,4,"w1718","Mechanized",0,"Wed","weekday"
"795",2018-03-28,"Cement Creek","1","1","1",8.9,0,33,0,27,27,-1,-1,1,5,-1,-2,-1,4,"w1718","Motorized",1,"Wed","weekday"
"796",2018-03-28,"Cement Creek","1","1","1",8.9,0,33,0,27,27,-1,-1,1,5,-1,-2,-1,4,"w1718","Hybrid",0,"Wed","weekday"
"797",2018-03-29,"Cement Creek","1","1","1",8.9,0,33,0,27,27,0,-1,-1,1,0,-1,-2,-1,"w1718","Non.motorized",10,"Thu","weekday"
"798",2018-03-29,"Cement Creek","1","1","1",8.9,0,33,0,27,27,0,-1,-1,1,0,-1,-2,-1,"w1718","Mechanized",0,"Thu","weekday"
"799",2018-03-29,"Cement Creek","1","1","1",8.9,0,33,0,27,27,0,-1,-1,1,0,-1,-2,-1,"w1718","Motorized",4,"Thu","weekday"
"800",2018-03-29,"Cement Creek","1","1","1",8.9,0,33,0,27,27,0,-1,-1,1,0,-1,-2,-1,"w1718","Hybrid",0,"Thu","weekday"
"801",2018-03-30,"Cement Creek","1","1","1",8.9,0,32,-1,33,27.8,0,0,-1,-1,-1,-1,-2,-3,"w1718","Non.motorized",11,"Fri","weekday"
"802",2018-03-30,"Cement Creek","1","1","1",8.9,0,32,-1,33,27.8,0,0,-1,-1,-1,-1,-2,-3,"w1718","Mechanized",0,"Fri","weekday"
"803",2018-03-30,"Cement Creek","1","1","1",8.9,0,32,-1,33,27.8,0,0,-1,-1,-1,-1,-2,-3,"w1718","Motorized",8,"Fri","weekday"
"804",2018-03-30,"Cement Creek","1","1","1",8.9,0,32,-1,33,27.8,0,0,-1,-1,-1,-1,-2,-3,"w1718","Hybrid",0,"Fri","weekday"
"805",2017-12-22,"Gothic Rd","2","2","1",2,0,11,3,17,18.2,0,0,0,0,3,3,3,3,"w1718","Non.motorized",0,"Fri","weekday"
"806",2017-12-22,"Gothic Rd","2","2","1",2,0,11,3,17,18.2,0,0,0,0,3,3,3,3,"w1718","Mechanized",0,"Fri","weekday"
"807",2017-12-22,"Gothic Rd","2","2","1",2,0,11,3,17,18.2,0,0,0,0,3,3,3,3,"w1718","Motorized",0,"Fri","weekday"
"808",2017-12-22,"Gothic Rd","2","2","1",2,0,11,3,17,18.2,0,0,0,0,3,3,3,3,"w1718","Hybrid",0,"Fri","weekday"
"809",2017-12-23,"Gothic Rd","2","1","1",2.1,0.1,10,-1,21,21,3,0,0,0,2,2,2,2,"w1718","Non.motorized",0,"Sat","weekend"
"810",2017-12-23,"Gothic Rd","2","1","1",2.1,0.1,10,-1,21,21,3,0,0,0,2,2,2,2,"w1718","Mechanized",0,"Sat","weekend"
"811",2017-12-23,"Gothic Rd","2","1","1",2.1,0.1,10,-1,21,21,3,0,0,0,2,2,2,2,"w1718","Motorized",0,"Sat","weekend"
"812",2017-12-23,"Gothic Rd","2","1","1",2.1,0.1,10,-1,21,21,3,0,0,0,2,2,2,2,"w1718","Hybrid",0,"Sat","weekend"
"813",2017-12-24,"Gothic Rd","1","1","1",2.4,0.3,14,4,19,17.1,-1,3,0,0,3,6,6,6,"w1718","Non.motorized",0,"Sun","weekend"
"814",2017-12-24,"Gothic Rd","1","1","1",2.4,0.3,14,4,19,17.1,-1,3,0,0,3,6,6,6,"w1718","Mechanized",0,"Sun","weekend"
"815",2017-12-24,"Gothic Rd","1","1","1",2.4,0.3,14,4,19,17.1,-1,3,0,0,3,6,6,6,"w1718","Motorized",0,"Sun","weekend"
"816",2017-12-24,"Gothic Rd","1","1","1",2.4,0.3,14,4,19,17.1,-1,3,0,0,3,6,6,6,"w1718","Hybrid",0,"Sun","weekend"
"817",2017-12-25,"Gothic Rd","2","1","1",2.6,0.2,14,0,25,18.6,4,-1,3,0,4,3,6,6,"w1718","Non.motorized",42,"Mon","weekday"
"818",2017-12-25,"Gothic Rd","2","1","1",2.6,0.2,14,0,25,18.6,4,-1,3,0,4,3,6,6,"w1718","Mechanized",0,"Mon","weekday"
"819",2017-12-25,"Gothic Rd","2","1","1",2.6,0.2,14,0,25,18.6,4,-1,3,0,4,3,6,6,"w1718","Motorized",2,"Mon","weekday"
"820",2017-12-25,"Gothic Rd","2","1","1",2.6,0.2,14,0,25,18.6,4,-1,3,0,4,3,6,6,"w1718","Hybrid",0,"Mon","weekday"
"821",2017-12-26,"Gothic Rd","1","1","1",3.1,0.5,20,6,25,15.5,0,4,-1,3,6,10,9,12,"w1718","Non.motorized",55,"Tue","weekday"
"822",2017-12-26,"Gothic Rd","1","1","1",3.1,0.5,20,6,25,15.5,0,4,-1,3,6,10,9,12,"w1718","Mechanized",0,"Tue","weekday"
"823",2017-12-26,"Gothic Rd","1","1","1",3.1,0.5,20,6,25,15.5,0,4,-1,3,6,10,9,12,"w1718","Motorized",4,"Tue","weekday"
"824",2017-12-26,"Gothic Rd","1","1","1",3.1,0.5,20,6,25,15.5,0,4,-1,3,6,10,9,12,"w1718","Hybrid",0,"Tue","weekday"
"825",2017-12-27,"Gothic Rd","1","1","1",3.1,0,18,-2,27,17.2,6,0,4,-1,4,4,8,7,"w1718","Non.motorized",6,"Wed","weekday"
"826",2017-12-27,"Gothic Rd","1","1","1",3.1,0,18,-2,27,17.2,6,0,4,-1,4,4,8,7,"w1718","Mechanized",1,"Wed","weekday"
"827",2017-12-27,"Gothic Rd","1","1","1",3.1,0,18,-2,27,17.2,6,0,4,-1,4,4,8,7,"w1718","Motorized",0,"Wed","weekday"
"828",2017-12-27,"Gothic Rd","1","1","1",3.1,0,18,-2,27,17.2,6,0,4,-1,4,4,8,7,"w1718","Hybrid",0,"Wed","weekday"
"829",2017-12-28,"Gothic Rd","1","1","1",3.2,0.1,17,-1,31,18.8,-2,6,0,4,-3,3,3,7,"w1718","Non.motorized",77,"Thu","weekday"
"830",2017-12-28,"Gothic Rd","1","1","1",3.2,0.1,17,-1,31,18.8,-2,6,0,4,-3,3,3,7,"w1718","Mechanized",16,"Thu","weekday"
"831",2017-12-28,"Gothic Rd","1","1","1",3.2,0.1,17,-1,31,18.8,-2,6,0,4,-3,3,3,7,"w1718","Motorized",1,"Thu","weekday"
"832",2017-12-28,"Gothic Rd","1","1","1",3.2,0.1,17,-1,31,18.8,-2,6,0,4,-3,3,3,7,"w1718","Hybrid",0,"Thu","weekday"
"833",2017-12-29,"Gothic Rd","1","1","1",3.2,0,17,0,36,18.8,-1,-2,6,0,-1,-3,3,3,"w1718","Non.motorized",117,"Fri","weekday"
"834",2017-12-29,"Gothic Rd","1","1","1",3.2,0,17,0,36,18.8,-1,-2,6,0,-1,-3,3,3,"w1718","Mechanized",9,"Fri","weekday"
"835",2017-12-29,"Gothic Rd","1","1","1",3.2,0,17,0,36,18.8,-1,-2,6,0,-1,-3,3,3,"w1718","Motorized",0,"Fri","weekday"
"836",2017-12-29,"Gothic Rd","1","1","1",3.2,0,17,0,36,18.8,-1,-2,6,0,-1,-3,3,3,"w1718","Hybrid",0,"Fri","weekday"
"837",2017-12-30,"Gothic Rd","1","1","1",3.2,0,15,-2,37,21.3,0,-1,-2,6,-2,-3,-5,1,"w1718","Non.motorized",147,"Sat","weekend"
"838",2017-12-30,"Gothic Rd","1","1","1",3.2,0,15,-2,37,21.3,0,-1,-2,6,-2,-3,-5,1,"w1718","Mechanized",10,"Sat","weekend"
"839",2017-12-30,"Gothic Rd","1","1","1",3.2,0,15,-2,37,21.3,0,-1,-2,6,-2,-3,-5,1,"w1718","Motorized",2,"Sat","weekend"
"840",2017-12-30,"Gothic Rd","1","1","1",3.2,0,15,-2,37,21.3,0,-1,-2,6,-2,-3,-5,1,"w1718","Hybrid",0,"Sat","weekend"
"841",2017-12-31,"Gothic Rd","1","1","1",3.2,0,15,0,31,21.3,-2,0,-1,-2,-2,-2,-3,-5,"w1718","Non.motorized",106,"Sun","weekend"
"842",2017-12-31,"Gothic Rd","1","1","1",3.2,0,15,0,31,21.3,-2,0,-1,-2,-2,-2,-3,-5,"w1718","Mechanized",6,"Sun","weekend"
"843",2017-12-31,"Gothic Rd","1","1","1",3.2,0,15,0,31,21.3,-2,0,-1,-2,-2,-2,-3,-5,"w1718","Motorized",4,"Sun","weekend"
"844",2017-12-31,"Gothic Rd","1","1","1",3.2,0,15,0,31,21.3,-2,0,-1,-2,-2,-2,-3,-5,"w1718","Hybrid",0,"Sun","weekend"
"845",2018-01-01,"Gothic Rd","1","1","1",3.2,0,15,0,27,21.3,0,-2,0,-1,0,-2,-2,-3,"w1718","Non.motorized",93,"Mon","weekday"
"846",2018-01-01,"Gothic Rd","1","1","1",3.2,0,15,0,27,21.3,0,-2,0,-1,0,-2,-2,-3,"w1718","Mechanized",2,"Mon","weekday"
"847",2018-01-01,"Gothic Rd","1","1","1",3.2,0,15,0,27,21.3,0,-2,0,-1,0,-2,-2,-3,"w1718","Motorized",0,"Mon","weekday"
"848",2018-01-01,"Gothic Rd","1","1","1",3.2,0,15,0,27,21.3,0,-2,0,-1,0,-2,-2,-3,"w1718","Hybrid",0,"Mon","weekday"
"849",2018-01-02,"Gothic Rd","1","1","1",3.2,0,15,0,22,21.3,0,0,-2,0,0,0,-2,-2,"w1718","Non.motorized",NA,"Tue","weekday"
"850",2018-01-02,"Gothic Rd","1","1","1",3.2,0,15,0,22,21.3,0,0,-2,0,0,0,-2,-2,"w1718","Mechanized",NA,"Tue","weekday"
"851",2018-01-02,"Gothic Rd","1","1","1",3.2,0,15,0,22,21.3,0,0,-2,0,0,0,-2,-2,"w1718","Motorized",NA,"Tue","weekday"
"852",2018-01-02,"Gothic Rd","1","1","1",3.2,0,15,0,22,21.3,0,0,-2,0,0,0,-2,-2,"w1718","Hybrid",NA,"Tue","weekday"
"853",2018-01-03,"Gothic Rd","1","1","1",3.2,0,15,0,27,21.3,0,0,0,-2,0,0,0,-2,"w1718","Non.motorized",NA,"Wed","weekday"
"854",2018-01-03,"Gothic Rd","1","1","1",3.2,0,15,0,27,21.3,0,0,0,-2,0,0,0,-2,"w1718","Mechanized",NA,"Wed","weekday"
"855",2018-01-03,"Gothic Rd","1","1","1",3.2,0,15,0,27,21.3,0,0,0,-2,0,0,0,-2,"w1718","Motorized",NA,"Wed","weekday"
"856",2018-01-03,"Gothic Rd","1","1","1",3.2,0,15,0,27,21.3,0,0,0,-2,0,0,0,-2,"w1718","Hybrid",NA,"Wed","weekday"
"857",2018-01-04,"Gothic Rd","1","1","1",3.2,0,15,0,29,21.3,0,0,0,0,0,0,0,0,"w1718","Non.motorized",NA,"Thu","weekday"
"858",2018-01-04,"Gothic Rd","1","1","1",3.2,0,15,0,29,21.3,0,0,0,0,0,0,0,0,"w1718","Mechanized",NA,"Thu","weekday"
"859",2018-01-04,"Gothic Rd","1","1","1",3.2,0,15,0,29,21.3,0,0,0,0,0,0,0,0,"w1718","Motorized",NA,"Thu","weekday"
"860",2018-01-04,"Gothic Rd","1","1","1",3.2,0,15,0,29,21.3,0,0,0,0,0,0,0,0,"w1718","Hybrid",NA,"Thu","weekday"
"861",2018-01-05,"Gothic Rd","1","1","1",3.2,0,14,-1,32,22.9,0,0,0,0,-1,-1,-1,-1,"w1718","Non.motorized",NA,"Fri","weekday"
"862",2018-01-05,"Gothic Rd","1","1","1",3.2,0,14,-1,32,22.9,0,0,0,0,-1,-1,-1,-1,"w1718","Mechanized",NA,"Fri","weekday"
"863",2018-01-05,"Gothic Rd","1","1","1",3.2,0,14,-1,32,22.9,0,0,0,0,-1,-1,-1,-1,"w1718","Motorized",NA,"Fri","weekday"
"864",2018-01-05,"Gothic Rd","1","1","1",3.2,0,14,-1,32,22.9,0,0,0,0,-1,-1,-1,-1,"w1718","Hybrid",NA,"Fri","weekday"
"865",2018-01-06,"Gothic Rd","1","1","1",3.2,0,14,0,30,22.9,-1,0,0,0,-1,-1,-1,-1,"w1718","Non.motorized",NA,"Sat","weekend"
"866",2018-01-06,"Gothic Rd","1","1","1",3.2,0,14,0,30,22.9,-1,0,0,0,-1,-1,-1,-1,"w1718","Mechanized",NA,"Sat","weekend"
"867",2018-01-06,"Gothic Rd","1","1","1",3.2,0,14,0,30,22.9,-1,0,0,0,-1,-1,-1,-1,"w1718","Motorized",NA,"Sat","weekend"
"868",2018-01-06,"Gothic Rd","1","1","1",3.2,0,14,0,30,22.9,-1,0,0,0,-1,-1,-1,-1,"w1718","Hybrid",NA,"Sat","weekend"
"869",2018-01-07,"Gothic Rd","2","2","2",3.5,0.3,18,4,25,19.4,0,-1,0,0,4,3,3,3,"w1718","Non.motorized",16,"Sun","weekend"
"870",2018-01-07,"Gothic Rd","2","2","2",3.5,0.3,18,4,25,19.4,0,-1,0,0,4,3,3,3,"w1718","Mechanized",0,"Sun","weekend"
"871",2018-01-07,"Gothic Rd","2","2","2",3.5,0.3,18,4,25,19.4,0,-1,0,0,4,3,3,3,"w1718","Motorized",0,"Sun","weekend"
"872",2018-01-07,"Gothic Rd","2","2","2",3.5,0.3,18,4,25,19.4,0,-1,0,0,4,3,3,3,"w1718","Hybrid",0,"Sun","weekend"
"873",2018-01-08,"Gothic Rd","2","2","1",3.7,0.2,20,2,29,18.5,4,0,-1,0,6,6,5,5,"w1718","Non.motorized",24,"Mon","weekday"
"874",2018-01-08,"Gothic Rd","2","2","1",3.7,0.2,20,2,29,18.5,4,0,-1,0,6,6,5,5,"w1718","Mechanized",1,"Mon","weekday"
"875",2018-01-08,"Gothic Rd","2","2","1",3.7,0.2,20,2,29,18.5,4,0,-1,0,6,6,5,5,"w1718","Motorized",0,"Mon","weekday"
"876",2018-01-08,"Gothic Rd","2","2","1",3.7,0.2,20,2,29,18.5,4,0,-1,0,6,6,5,5,"w1718","Hybrid",0,"Mon","weekday"
"877",2018-01-09,"Gothic Rd","2","2","1",3.8,0.1,21,1,34,18.1,2,4,0,-1,3,7,7,6,"w1718","Non.motorized",26,"Tue","weekday"
"878",2018-01-09,"Gothic Rd","2","2","1",3.8,0.1,21,1,34,18.1,2,4,0,-1,3,7,7,6,"w1718","Mechanized",0,"Tue","weekday"
"879",2018-01-09,"Gothic Rd","2","2","1",3.8,0.1,21,1,34,18.1,2,4,0,-1,3,7,7,6,"w1718","Motorized",1,"Tue","weekday"
"880",2018-01-09,"Gothic Rd","2","2","1",3.8,0.1,21,1,34,18.1,2,4,0,-1,3,7,7,6,"w1718","Hybrid",0,"Tue","weekday"
"881",2018-01-10,"Gothic Rd","3","3","3",4,0.2,21,0,28,19,1,2,4,0,1,3,7,7,"w1718","Non.motorized",NA,"Wed","weekday"
"882",2018-01-10,"Gothic Rd","3","3","3",4,0.2,21,0,28,19,1,2,4,0,1,3,7,7,"w1718","Mechanized",NA,"Wed","weekday"
"883",2018-01-10,"Gothic Rd","3","3","3",4,0.2,21,0,28,19,1,2,4,0,1,3,7,7,"w1718","Motorized",NA,"Wed","weekday"
"884",2018-01-10,"Gothic Rd","3","3","3",4,0.2,21,0,28,19,1,2,4,0,1,3,7,7,"w1718","Hybrid",NA,"Wed","weekday"
"885",2018-01-11,"Gothic Rd","3","3","3",4.1,0.1,26,5,17,15.8,0,1,2,4,5,6,8,12,"w1718","Non.motorized",NA,"Thu","weekday"
"886",2018-01-11,"Gothic Rd","3","3","3",4.1,0.1,26,5,17,15.8,0,1,2,4,5,6,8,12,"w1718","Mechanized",NA,"Thu","weekday"
"887",2018-01-11,"Gothic Rd","3","3","3",4.1,0.1,26,5,17,15.8,0,1,2,4,5,6,8,12,"w1718","Motorized",NA,"Thu","weekday"
"888",2018-01-11,"Gothic Rd","3","3","3",4.1,0.1,26,5,17,15.8,0,1,2,4,5,6,8,12,"w1718","Hybrid",NA,"Thu","weekday"
"889",2018-01-12,"Gothic Rd","3","3","3",4.3,0.2,24,-2,22,17.9,5,0,1,2,3,3,4,6,"w1718","Non.motorized",NA,"Fri","weekday"
"890",2018-01-12,"Gothic Rd","3","3","3",4.3,0.2,24,-2,22,17.9,5,0,1,2,3,3,4,6,"w1718","Mechanized",NA,"Fri","weekday"
"891",2018-01-12,"Gothic Rd","3","3","3",4.3,0.2,24,-2,22,17.9,5,0,1,2,3,3,4,6,"w1718","Motorized",NA,"Fri","weekday"
"892",2018-01-12,"Gothic Rd","3","3","3",4.3,0.2,24,-2,22,17.9,5,0,1,2,3,3,4,6,"w1718","Hybrid",NA,"Fri","weekday"
"893",2018-01-13,"Gothic Rd","3","3","3",4.4,0.1,24,0,24,18.3,-2,5,0,1,-2,3,3,4,"w1718","Non.motorized",NA,"Sat","weekend"
"894",2018-01-13,"Gothic Rd","3","3","3",4.4,0.1,24,0,24,18.3,-2,5,0,1,-2,3,3,4,"w1718","Mechanized",NA,"Sat","weekend"
"895",2018-01-13,"Gothic Rd","3","3","3",4.4,0.1,24,0,24,18.3,-2,5,0,1,-2,3,3,4,"w1718","Motorized",NA,"Sat","weekend"
"896",2018-01-13,"Gothic Rd","3","3","3",4.4,0.1,24,0,24,18.3,-2,5,0,1,-2,3,3,4,"w1718","Hybrid",NA,"Sat","weekend"
"897",2018-01-14,"Gothic Rd","3","3","2",4.4,0,24,0,27,18.3,0,-2,5,0,0,-2,3,3,"w1718","Non.motorized",NA,"Sun","weekend"
"898",2018-01-14,"Gothic Rd","3","3","2",4.4,0,24,0,27,18.3,0,-2,5,0,0,-2,3,3,"w1718","Mechanized",NA,"Sun","weekend"
"899",2018-01-14,"Gothic Rd","3","3","2",4.4,0,24,0,27,18.3,0,-2,5,0,0,-2,3,3,"w1718","Motorized",NA,"Sun","weekend"
"900",2018-01-14,"Gothic Rd","3","3","2",4.4,0,24,0,27,18.3,0,-2,5,0,0,-2,3,3,"w1718","Hybrid",NA,"Sun","weekend"
"901",2018-01-15,"Gothic Rd","3","3","2",4.4,0,23,-1,27,19.1,0,0,-2,5,-1,-1,-3,2,"w1718","Non.motorized",NA,"Mon","weekday"
"902",2018-01-15,"Gothic Rd","3","3","2",4.4,0,23,-1,27,19.1,0,0,-2,5,-1,-1,-3,2,"w1718","Mechanized",NA,"Mon","weekday"
"903",2018-01-15,"Gothic Rd","3","3","2",4.4,0,23,-1,27,19.1,0,0,-2,5,-1,-1,-3,2,"w1718","Motorized",NA,"Mon","weekday"
"904",2018-01-15,"Gothic Rd","3","3","2",4.4,0,23,-1,27,19.1,0,0,-2,5,-1,-1,-3,2,"w1718","Hybrid",NA,"Mon","weekday"
"905",2018-01-16,"Gothic Rd","3","3","2",4.4,0,22,-1,20,20,-1,0,0,-2,-2,-2,-2,-4,"w1718","Non.motorized",NA,"Tue","weekday"
"906",2018-01-16,"Gothic Rd","3","3","2",4.4,0,22,-1,20,20,-1,0,0,-2,-2,-2,-2,-4,"w1718","Mechanized",NA,"Tue","weekday"
"907",2018-01-16,"Gothic Rd","3","3","2",4.4,0,22,-1,20,20,-1,0,0,-2,-2,-2,-2,-4,"w1718","Motorized",NA,"Tue","weekday"
"908",2018-01-16,"Gothic Rd","3","3","2",4.4,0,22,-1,20,20,-1,0,0,-2,-2,-2,-2,-4,"w1718","Hybrid",NA,"Tue","weekday"
"909",2018-01-17,"Gothic Rd","2","2","2",4.4,0,22,0,24,20,-1,-1,0,0,-1,-2,-2,-2,"w1718","Non.motorized",NA,"Wed","weekday"
"910",2018-01-17,"Gothic Rd","2","2","2",4.4,0,22,0,24,20,-1,-1,0,0,-1,-2,-2,-2,"w1718","Mechanized",NA,"Wed","weekday"
"911",2018-01-17,"Gothic Rd","2","2","2",4.4,0,22,0,24,20,-1,-1,0,0,-1,-2,-2,-2,"w1718","Motorized",NA,"Wed","weekday"
"912",2018-01-17,"Gothic Rd","2","2","2",4.4,0,22,0,24,20,-1,-1,0,0,-1,-2,-2,-2,"w1718","Hybrid",NA,"Wed","weekday"
"913",2018-01-18,"Gothic Rd","2","2","2",4.4,0,21,-1,29,21,0,-1,-1,0,-1,-2,-3,-3,"w1718","Non.motorized",NA,"Thu","weekday"
"914",2018-01-18,"Gothic Rd","2","2","2",4.4,0,21,-1,29,21,0,-1,-1,0,-1,-2,-3,-3,"w1718","Mechanized",NA,"Thu","weekday"
"915",2018-01-18,"Gothic Rd","2","2","2",4.4,0,21,-1,29,21,0,-1,-1,0,-1,-2,-3,-3,"w1718","Motorized",NA,"Thu","weekday"
"916",2018-01-18,"Gothic Rd","2","2","2",4.4,0,21,-1,29,21,0,-1,-1,0,-1,-2,-3,-3,"w1718","Hybrid",NA,"Thu","weekday"
"917",2018-01-19,"Gothic Rd","2","2","2",4.5,0.1,21,0,34,21.4,-1,0,-1,-1,-1,-1,-2,-3,"w1718","Non.motorized",NA,"Fri","weekday"
"918",2018-01-19,"Gothic Rd","2","2","2",4.5,0.1,21,0,34,21.4,-1,0,-1,-1,-1,-1,-2,-3,"w1718","Mechanized",NA,"Fri","weekday"
"919",2018-01-19,"Gothic Rd","2","2","2",4.5,0.1,21,0,34,21.4,-1,0,-1,-1,-1,-1,-2,-3,"w1718","Motorized",NA,"Fri","weekday"
"920",2018-01-19,"Gothic Rd","2","2","2",4.5,0.1,21,0,34,21.4,-1,0,-1,-1,-1,-1,-2,-3,"w1718","Hybrid",NA,"Fri","weekday"
"921",2018-01-20,"Gothic Rd","2","2","2",4.5,0,21,0,32,21.4,0,-1,0,-1,0,-1,-1,-2,"w1718","Non.motorized",NA,"Sat","weekend"
"922",2018-01-20,"Gothic Rd","2","2","2",4.5,0,21,0,32,21.4,0,-1,0,-1,0,-1,-1,-2,"w1718","Mechanized",NA,"Sat","weekend"
"923",2018-01-20,"Gothic Rd","2","2","2",4.5,0,21,0,32,21.4,0,-1,0,-1,0,-1,-1,-2,"w1718","Motorized",NA,"Sat","weekend"
"924",2018-01-20,"Gothic Rd","2","2","2",4.5,0,21,0,32,21.4,0,-1,0,-1,0,-1,-1,-2,"w1718","Hybrid",NA,"Sat","weekend"
"925",2018-01-21,"Gothic Rd","3","3","3",4.6,0.1,23,2,15,20,0,0,-1,0,2,2,1,1,"w1718","Non.motorized",NA,"Sun","weekend"
"926",2018-01-21,"Gothic Rd","3","3","3",4.6,0.1,23,2,15,20,0,0,-1,0,2,2,1,1,"w1718","Mechanized",NA,"Sun","weekend"
"927",2018-01-21,"Gothic Rd","3","3","3",4.6,0.1,23,2,15,20,0,0,-1,0,2,2,1,1,"w1718","Motorized",NA,"Sun","weekend"
"928",2018-01-21,"Gothic Rd","3","3","3",4.6,0.1,23,2,15,20,0,0,-1,0,2,2,1,1,"w1718","Hybrid",NA,"Sun","weekend"
"929",2018-01-22,"Gothic Rd","3","3","3",4.6,0,21,-2,12,21.9,2,0,0,-1,0,0,0,-1,"w1718","Non.motorized",NA,"Mon","weekday"
"930",2018-01-22,"Gothic Rd","3","3","3",4.6,0,21,-2,12,21.9,2,0,0,-1,0,0,0,-1,"w1718","Mechanized",NA,"Mon","weekday"
"931",2018-01-22,"Gothic Rd","3","3","3",4.6,0,21,-2,12,21.9,2,0,0,-1,0,0,0,-1,"w1718","Motorized",NA,"Mon","weekday"
"932",2018-01-22,"Gothic Rd","3","3","3",4.6,0,21,-2,12,21.9,2,0,0,-1,0,0,0,-1,"w1718","Hybrid",NA,"Mon","weekday"
"933",2018-01-23,"Gothic Rd","3","3","3",4.6,0,22,1,16,20.9,-2,2,0,0,-1,1,1,1,"w1718","Non.motorized",NA,"Tue","weekday"
"934",2018-01-23,"Gothic Rd","3","3","3",4.6,0,22,1,16,20.9,-2,2,0,0,-1,1,1,1,"w1718","Mechanized",NA,"Tue","weekday"
"935",2018-01-23,"Gothic Rd","3","3","3",4.6,0,22,1,16,20.9,-2,2,0,0,-1,1,1,1,"w1718","Motorized",NA,"Tue","weekday"
"936",2018-01-23,"Gothic Rd","3","3","3",4.6,0,22,1,16,20.9,-2,2,0,0,-1,1,1,1,"w1718","Hybrid",NA,"Tue","weekday"
"937",2018-01-24,"Gothic Rd","2","2","2",4.6,0,22,0,22,20.9,1,-2,2,0,1,-1,1,1,"w1718","Non.motorized",NA,"Wed","weekday"
"938",2018-01-24,"Gothic Rd","2","2","2",4.6,0,22,0,22,20.9,1,-2,2,0,1,-1,1,1,"w1718","Mechanized",NA,"Wed","weekday"
"939",2018-01-24,"Gothic Rd","2","2","2",4.6,0,22,0,22,20.9,1,-2,2,0,1,-1,1,1,"w1718","Motorized",NA,"Wed","weekday"
"940",2018-01-24,"Gothic Rd","2","2","2",4.6,0,22,0,22,20.9,1,-2,2,0,1,-1,1,1,"w1718","Hybrid",NA,"Wed","weekday"
"941",2018-01-25,"Gothic Rd","2","2","2",4.6,0,22,0,28,20.9,0,1,-2,2,0,1,-1,1,"w1718","Non.motorized",NA,"Thu","weekday"
"942",2018-01-25,"Gothic Rd","2","2","2",4.6,0,22,0,28,20.9,0,1,-2,2,0,1,-1,1,"w1718","Mechanized",NA,"Thu","weekday"
"943",2018-01-25,"Gothic Rd","2","2","2",4.6,0,22,0,28,20.9,0,1,-2,2,0,1,-1,1,"w1718","Motorized",NA,"Thu","weekday"
"944",2018-01-25,"Gothic Rd","2","2","2",4.6,0,22,0,28,20.9,0,1,-2,2,0,1,-1,1,"w1718","Hybrid",NA,"Thu","weekday"
"945",2018-01-26,"Gothic Rd","2","2","2",4.7,0.1,22,0,15,21.4,0,0,1,-2,0,0,1,-1,"w1718","Non.motorized",NA,"Fri","weekday"
"946",2018-01-26,"Gothic Rd","2","2","2",4.7,0.1,22,0,15,21.4,0,0,1,-2,0,0,1,-1,"w1718","Mechanized",NA,"Fri","weekday"
"947",2018-01-26,"Gothic Rd","2","2","2",4.7,0.1,22,0,15,21.4,0,0,1,-2,0,0,1,-1,"w1718","Motorized",NA,"Fri","weekday"
"948",2018-01-26,"Gothic Rd","2","2","2",4.7,0.1,22,0,15,21.4,0,0,1,-2,0,0,1,-1,"w1718","Hybrid",NA,"Fri","weekday"
"949",2018-01-27,"Gothic Rd","2","2","2",4.7,0,23,1,16,20.4,0,0,0,1,1,1,1,2,"w1718","Non.motorized",NA,"Sat","weekend"
"950",2018-01-27,"Gothic Rd","2","2","2",4.7,0,23,1,16,20.4,0,0,0,1,1,1,1,2,"w1718","Mechanized",NA,"Sat","weekend"
"951",2018-01-27,"Gothic Rd","2","2","2",4.7,0,23,1,16,20.4,0,0,0,1,1,1,1,2,"w1718","Motorized",NA,"Sat","weekend"
"952",2018-01-27,"Gothic Rd","2","2","2",4.7,0,23,1,16,20.4,0,0,0,1,1,1,1,2,"w1718","Hybrid",NA,"Sat","weekend"
"953",2018-01-28,"Gothic Rd","2","2","2",4.7,0,23,0,25,20.4,1,0,0,0,1,1,1,1,"w1718","Non.motorized",NA,"Sun","weekend"
"954",2018-01-28,"Gothic Rd","2","2","2",4.7,0,23,0,25,20.4,1,0,0,0,1,1,1,1,"w1718","Mechanized",NA,"Sun","weekend"
"955",2018-01-28,"Gothic Rd","2","2","2",4.7,0,23,0,25,20.4,1,0,0,0,1,1,1,1,"w1718","Motorized",NA,"Sun","weekend"
"956",2018-01-28,"Gothic Rd","2","2","2",4.7,0,23,0,25,20.4,1,0,0,0,1,1,1,1,"w1718","Hybrid",NA,"Sun","weekend"
"957",2018-01-29,"Gothic Rd","2","2","2",4.8,0.1,22,-1,30,21.8,0,1,0,0,-1,0,0,0,"w1718","Non.motorized",NA,"Mon","weekday"
"958",2018-01-29,"Gothic Rd","2","2","2",4.8,0.1,22,-1,30,21.8,0,1,0,0,-1,0,0,0,"w1718","Mechanized",NA,"Mon","weekday"
"959",2018-01-29,"Gothic Rd","2","2","2",4.8,0.1,22,-1,30,21.8,0,1,0,0,-1,0,0,0,"w1718","Motorized",NA,"Mon","weekday"
"960",2018-01-29,"Gothic Rd","2","2","2",4.8,0.1,22,-1,30,21.8,0,1,0,0,-1,0,0,0,"w1718","Hybrid",NA,"Mon","weekday"
"961",2018-01-30,"Gothic Rd","2","2","2",4.8,0,22,0,34,21.8,-1,0,1,0,-1,-1,0,0,"w1718","Non.motorized",NA,"Tue","weekday"
"962",2018-01-30,"Gothic Rd","2","2","2",4.8,0,22,0,34,21.8,-1,0,1,0,-1,-1,0,0,"w1718","Mechanized",NA,"Tue","weekday"
"963",2018-01-30,"Gothic Rd","2","2","2",4.8,0,22,0,34,21.8,-1,0,1,0,-1,-1,0,0,"w1718","Motorized",NA,"Tue","weekday"
"964",2018-01-30,"Gothic Rd","2","2","2",4.8,0,22,0,34,21.8,-1,0,1,0,-1,-1,0,0,"w1718","Hybrid",NA,"Tue","weekday"
"965",2018-01-31,"Gothic Rd","2","2","2",4.8,0,22,0,34,21.8,0,-1,0,1,0,-1,-1,0,"w1718","Non.motorized",7,"Wed","weekday"
"966",2018-01-31,"Gothic Rd","2","2","2",4.8,0,22,0,34,21.8,0,-1,0,1,0,-1,-1,0,"w1718","Mechanized",0,"Wed","weekday"
"967",2018-01-31,"Gothic Rd","2","2","2",4.8,0,22,0,34,21.8,0,-1,0,1,0,-1,-1,0,"w1718","Motorized",1,"Wed","weekday"
"968",2018-01-31,"Gothic Rd","2","2","2",4.8,0,22,0,34,21.8,0,-1,0,1,0,-1,-1,0,"w1718","Hybrid",0,"Wed","weekday"
"969",2018-02-01,"Gothic Rd","2","2","2",4.9,0.1,21,-1,32,23.3,0,0,-1,0,-1,-1,-2,-2,"w1718","Non.motorized",25,"Thu","weekday"
"970",2018-02-01,"Gothic Rd","2","2","2",4.9,0.1,21,-1,32,23.3,0,0,-1,0,-1,-1,-2,-2,"w1718","Mechanized",2,"Thu","weekday"
"971",2018-02-01,"Gothic Rd","2","2","2",4.9,0.1,21,-1,32,23.3,0,0,-1,0,-1,-1,-2,-2,"w1718","Motorized",0,"Thu","weekday"
"972",2018-02-01,"Gothic Rd","2","2","2",4.9,0.1,21,-1,32,23.3,0,0,-1,0,-1,-1,-2,-2,"w1718","Hybrid",0,"Thu","weekday"
"973",2018-02-02,"Gothic Rd","2","2","2",4.9,0,20,-1,33,24.5,-1,0,0,-1,-2,-2,-2,-3,"w1718","Non.motorized",55,"Fri","weekday"
"974",2018-02-02,"Gothic Rd","2","2","2",4.9,0,20,-1,33,24.5,-1,0,0,-1,-2,-2,-2,-3,"w1718","Mechanized",7,"Fri","weekday"
"975",2018-02-02,"Gothic Rd","2","2","2",4.9,0,20,-1,33,24.5,-1,0,0,-1,-2,-2,-2,-3,"w1718","Motorized",0,"Fri","weekday"
"976",2018-02-02,"Gothic Rd","2","2","2",4.9,0,20,-1,33,24.5,-1,0,0,-1,-2,-2,-2,-3,"w1718","Hybrid",0,"Fri","weekday"
"977",2018-02-03,"Gothic Rd","2","2","2",4.9,0,21,1,32,23.3,-1,-1,0,0,0,-1,-1,-1,"w1718","Non.motorized",106,"Sat","weekend"
"978",2018-02-03,"Gothic Rd","2","2","2",4.9,0,21,1,32,23.3,-1,-1,0,0,0,-1,-1,-1,"w1718","Mechanized",3,"Sat","weekend"
"979",2018-02-03,"Gothic Rd","2","2","2",4.9,0,21,1,32,23.3,-1,-1,0,0,0,-1,-1,-1,"w1718","Motorized",7,"Sat","weekend"
"980",2018-02-03,"Gothic Rd","2","2","2",4.9,0,21,1,32,23.3,-1,-1,0,0,0,-1,-1,-1,"w1718","Hybrid",0,"Sat","weekend"
"981",2018-02-04,"Gothic Rd","2","2","2",4.9,0,19,-2,32,25.8,1,-1,-1,0,-1,-2,-3,-3,"w1718","Non.motorized",89,"Sun","weekend"
"982",2018-02-04,"Gothic Rd","2","2","2",4.9,0,19,-2,32,25.8,1,-1,-1,0,-1,-2,-3,-3,"w1718","Mechanized",7,"Sun","weekend"
"983",2018-02-04,"Gothic Rd","2","2","2",4.9,0,19,-2,32,25.8,1,-1,-1,0,-1,-2,-3,-3,"w1718","Motorized",3,"Sun","weekend"
"984",2018-02-04,"Gothic Rd","2","2","2",4.9,0,19,-2,32,25.8,1,-1,-1,0,-1,-2,-3,-3,"w1718","Hybrid",2,"Sun","weekend"
"985",2018-02-05,"Gothic Rd","2","2","2",5,0.1,18,-1,29,27.8,-2,1,-1,-1,-3,-2,-3,-4,"w1718","Non.motorized",29,"Mon","weekday"
"986",2018-02-05,"Gothic Rd","2","2","2",5,0.1,18,-1,29,27.8,-2,1,-1,-1,-3,-2,-3,-4,"w1718","Mechanized",1,"Mon","weekday"
"987",2018-02-05,"Gothic Rd","2","2","2",5,0.1,18,-1,29,27.8,-2,1,-1,-1,-3,-2,-3,-4,"w1718","Motorized",0,"Mon","weekday"
"988",2018-02-05,"Gothic Rd","2","2","2",5,0.1,18,-1,29,27.8,-2,1,-1,-1,-3,-2,-3,-4,"w1718","Hybrid",0,"Mon","weekday"
"989",2018-02-06,"Gothic Rd","2","2","2",5.2,0.2,23,5,22,22.6,-1,-2,1,-1,4,2,3,2,"w1718","Non.motorized",15,"Tue","weekday"
"990",2018-02-06,"Gothic Rd","2","2","2",5.2,0.2,23,5,22,22.6,-1,-2,1,-1,4,2,3,2,"w1718","Mechanized",0,"Tue","weekday"
"991",2018-02-06,"Gothic Rd","2","2","2",5.2,0.2,23,5,22,22.6,-1,-2,1,-1,4,2,3,2,"w1718","Motorized",0,"Tue","weekday"
"992",2018-02-06,"Gothic Rd","2","2","2",5.2,0.2,23,5,22,22.6,-1,-2,1,-1,4,2,3,2,"w1718","Hybrid",0,"Tue","weekday"
"993",2018-02-07,"Gothic Rd","2","2","2",5.2,0,23,0,24,22.6,5,-1,-2,1,5,4,2,3,"w1718","Non.motorized",51,"Wed","weekday"
"994",2018-02-07,"Gothic Rd","2","2","2",5.2,0,23,0,24,22.6,5,-1,-2,1,5,4,2,3,"w1718","Mechanized",8,"Wed","weekday"
"995",2018-02-07,"Gothic Rd","2","2","2",5.2,0,23,0,24,22.6,5,-1,-2,1,5,4,2,3,"w1718","Motorized",1,"Wed","weekday"
"996",2018-02-07,"Gothic Rd","2","2","2",5.2,0,23,0,24,22.6,5,-1,-2,1,5,4,2,3,"w1718","Hybrid",0,"Wed","weekday"
"997",2018-02-08,"Gothic Rd","2","2","1",5.3,0.1,25,2,28,21.2,0,5,-1,-2,2,7,6,4,"w1718","Non.motorized",60,"Thu","weekday"
"998",2018-02-08,"Gothic Rd","2","2","1",5.3,0.1,25,2,28,21.2,0,5,-1,-2,2,7,6,4,"w1718","Mechanized",7,"Thu","weekday"
"999",2018-02-08,"Gothic Rd","2","2","1",5.3,0.1,25,2,28,21.2,0,5,-1,-2,2,7,6,4,"w1718","Motorized",0,"Thu","weekday"
"1000",2018-02-08,"Gothic Rd","2","2","1",5.3,0.1,25,2,28,21.2,0,5,-1,-2,2,7,6,4,"w1718","Hybrid",0,"Thu","weekday"
"1001",2018-02-09,"Gothic Rd","2","2","1",5.3,0,24,-1,33,22.1,2,0,5,-1,1,1,6,5,"w1718","Non.motorized",72,"Fri","weekday"
"1002",2018-02-09,"Gothic Rd","2","2","1",5.3,0,24,-1,33,22.1,2,0,5,-1,1,1,6,5,"w1718","Mechanized",8,"Fri","weekday"
"1003",2018-02-09,"Gothic Rd","2","2","1",5.3,0,24,-1,33,22.1,2,0,5,-1,1,1,6,5,"w1718","Motorized",0,"Fri","weekday"
"1004",2018-02-09,"Gothic Rd","2","2","1",5.3,0,24,-1,33,22.1,2,0,5,-1,1,1,6,5,"w1718","Hybrid",0,"Fri","weekday"
"1005",2018-02-10,"Gothic Rd","3","3","2",5.3,0,24,0,24,22.1,-1,2,0,5,-1,1,1,6,"w1718","Non.motorized",42,"Sat","weekend"
"1006",2018-02-10,"Gothic Rd","3","3","2",5.3,0,24,0,24,22.1,-1,2,0,5,-1,1,1,6,"w1718","Mechanized",7,"Sat","weekend"
"1007",2018-02-10,"Gothic Rd","3","3","2",5.3,0,24,0,24,22.1,-1,2,0,5,-1,1,1,6,"w1718","Motorized",0,"Sat","weekend"
"1008",2018-02-10,"Gothic Rd","3","3","2",5.3,0,24,0,24,22.1,-1,2,0,5,-1,1,1,6,"w1718","Hybrid",0,"Sat","weekend"
"1009",2018-02-11,"Gothic Rd","3","3","2",5.6,0.3,27,3,13,20.7,0,-1,2,0,3,2,4,4,"w1718","Non.motorized",39,"Sun","weekend"
"1010",2018-02-11,"Gothic Rd","3","3","2",5.6,0.3,27,3,13,20.7,0,-1,2,0,3,2,4,4,"w1718","Mechanized",1,"Sun","weekend"
"1011",2018-02-11,"Gothic Rd","3","3","2",5.6,0.3,27,3,13,20.7,0,-1,2,0,3,2,4,4,"w1718","Motorized",0,"Sun","weekend"
"1012",2018-02-11,"Gothic Rd","3","3","2",5.6,0.3,27,3,13,20.7,0,-1,2,0,3,2,4,4,"w1718","Hybrid",0,"Sun","weekend"
"1013",2018-02-12,"Gothic Rd","3","3","3",5.7,0.1,27,0,23,21.1,3,0,-1,2,3,3,2,4,"w1718","Non.motorized",25,"Mon","weekday"
"1014",2018-02-12,"Gothic Rd","3","3","3",5.7,0.1,27,0,23,21.1,3,0,-1,2,3,3,2,4,"w1718","Mechanized",0,"Mon","weekday"
"1015",2018-02-12,"Gothic Rd","3","3","3",5.7,0.1,27,0,23,21.1,3,0,-1,2,3,3,2,4,"w1718","Motorized",0,"Mon","weekday"
"1016",2018-02-12,"Gothic Rd","3","3","3",5.7,0.1,27,0,23,21.1,3,0,-1,2,3,3,2,4,"w1718","Hybrid",0,"Mon","weekday"
"1017",2018-02-13,"Gothic Rd","3","3","3",6.1,0.4,29,2,28,21,0,3,0,-1,2,5,5,4,"w1718","Non.motorized",20,"Tue","weekday"
"1018",2018-02-13,"Gothic Rd","3","3","3",6.1,0.4,29,2,28,21,0,3,0,-1,2,5,5,4,"w1718","Mechanized",2,"Tue","weekday"
"1019",2018-02-13,"Gothic Rd","3","3","3",6.1,0.4,29,2,28,21,0,3,0,-1,2,5,5,4,"w1718","Motorized",0,"Tue","weekday"
"1020",2018-02-13,"Gothic Rd","3","3","3",6.1,0.4,29,2,28,21,0,3,0,-1,2,5,5,4,"w1718","Hybrid",0,"Tue","weekday"
"1021",2018-02-14,"Gothic Rd","3","3","3",6.2,0.1,30,1,30,20.7,2,0,3,0,3,3,6,6,"w1718","Non.motorized",32,"Wed","weekday"
"1022",2018-02-14,"Gothic Rd","3","3","3",6.2,0.1,30,1,30,20.7,2,0,3,0,3,3,6,6,"w1718","Mechanized",4,"Wed","weekday"
"1023",2018-02-14,"Gothic Rd","3","3","3",6.2,0.1,30,1,30,20.7,2,0,3,0,3,3,6,6,"w1718","Motorized",0,"Wed","weekday"
"1024",2018-02-14,"Gothic Rd","3","3","3",6.2,0.1,30,1,30,20.7,2,0,3,0,3,3,6,6,"w1718","Hybrid",0,"Wed","weekday"
"1025",2018-02-15,"Gothic Rd","3","3","3",6.3,0.1,28,-2,24,22.5,1,2,0,3,-1,1,1,4,"w1718","Non.motorized",10,"Thu","weekday"
"1026",2018-02-15,"Gothic Rd","3","3","3",6.3,0.1,28,-2,24,22.5,1,2,0,3,-1,1,1,4,"w1718","Mechanized",0,"Thu","weekday"
"1027",2018-02-15,"Gothic Rd","3","3","3",6.3,0.1,28,-2,24,22.5,1,2,0,3,-1,1,1,4,"w1718","Motorized",0,"Thu","weekday"
"1028",2018-02-15,"Gothic Rd","3","3","3",6.3,0.1,28,-2,24,22.5,1,2,0,3,-1,1,1,4,"w1718","Hybrid",0,"Thu","weekday"
"1029",2018-02-16,"Gothic Rd","3","3","3",6.7,0.4,32,4,18,20.9,-2,1,2,0,2,3,5,5,"w1718","Non.motorized",23,"Fri","weekday"
"1030",2018-02-16,"Gothic Rd","3","3","3",6.7,0.4,32,4,18,20.9,-2,1,2,0,2,3,5,5,"w1718","Mechanized",0,"Fri","weekday"
"1031",2018-02-16,"Gothic Rd","3","3","3",6.7,0.4,32,4,18,20.9,-2,1,2,0,2,3,5,5,"w1718","Motorized",1,"Fri","weekday"
"1032",2018-02-16,"Gothic Rd","3","3","3",6.7,0.4,32,4,18,20.9,-2,1,2,0,2,3,5,5,"w1718","Hybrid",0,"Fri","weekday"
"1033",2018-02-17,"Gothic Rd","3","3","2",6.7,0,32,0,25,20.9,4,-2,1,2,4,2,3,5,"w1718","Non.motorized",107,"Sat","weekend"
"1034",2018-02-17,"Gothic Rd","3","3","2",6.7,0,32,0,25,20.9,4,-2,1,2,4,2,3,5,"w1718","Mechanized",8,"Sat","weekend"
"1035",2018-02-17,"Gothic Rd","3","3","2",6.7,0,32,0,25,20.9,4,-2,1,2,4,2,3,5,"w1718","Motorized",1,"Sat","weekend"
"1036",2018-02-17,"Gothic Rd","3","3","2",6.7,0,32,0,25,20.9,4,-2,1,2,4,2,3,5,"w1718","Hybrid",0,"Sat","weekend"
"1037",2018-02-18,"Gothic Rd","2","2","2",6.7,0,31,-1,32,21.6,0,4,-2,1,-1,3,1,2,"w1718","Non.motorized",122,"Sun","weekend"
"1038",2018-02-18,"Gothic Rd","2","2","2",6.7,0,31,-1,32,21.6,0,4,-2,1,-1,3,1,2,"w1718","Mechanized",9,"Sun","weekend"
"1039",2018-02-18,"Gothic Rd","2","2","2",6.7,0,31,-1,32,21.6,0,4,-2,1,-1,3,1,2,"w1718","Motorized",4,"Sun","weekend"
"1040",2018-02-18,"Gothic Rd","2","2","2",6.7,0,31,-1,32,21.6,0,4,-2,1,-1,3,1,2,"w1718","Hybrid",0,"Sun","weekend"
"1041",2018-02-19,"Gothic Rd","2","2","2",6.8,0.1,29,-2,24,23.4,-1,0,4,-2,-3,-3,1,-1,"w1718","Non.motorized",36,"Mon","weekday"
"1042",2018-02-19,"Gothic Rd","2","2","2",6.8,0.1,29,-2,24,23.4,-1,0,4,-2,-3,-3,1,-1,"w1718","Mechanized",0,"Mon","weekday"
"1043",2018-02-19,"Gothic Rd","2","2","2",6.8,0.1,29,-2,24,23.4,-1,0,4,-2,-3,-3,1,-1,"w1718","Motorized",0,"Mon","weekday"
"1044",2018-02-19,"Gothic Rd","2","2","2",6.8,0.1,29,-2,24,23.4,-1,0,4,-2,-3,-3,1,-1,"w1718","Hybrid",0,"Mon","weekday"
"1045",2018-02-19,"Gothic Rd","3","3","3",6.8,0.1,29,-2,24,23.4,-1,0,4,-2,-3,-3,1,-1,"w1718","Non.motorized",36,"Mon","weekday"
"1046",2018-02-19,"Gothic Rd","3","3","3",6.8,0.1,29,-2,24,23.4,-1,0,4,-2,-3,-3,1,-1,"w1718","Mechanized",0,"Mon","weekday"
"1047",2018-02-19,"Gothic Rd","3","3","3",6.8,0.1,29,-2,24,23.4,-1,0,4,-2,-3,-3,1,-1,"w1718","Motorized",0,"Mon","weekday"
"1048",2018-02-19,"Gothic Rd","3","3","3",6.8,0.1,29,-2,24,23.4,-1,0,4,-2,-3,-3,1,-1,"w1718","Hybrid",0,"Mon","weekday"
"1049",2018-02-20,"Gothic Rd","3","3","3",6.8,0,31,2,8,21.9,-2,-1,0,4,0,-1,-1,3,"w1718","Non.motorized",21,"Tue","weekday"
"1050",2018-02-20,"Gothic Rd","3","3","3",6.8,0,31,2,8,21.9,-2,-1,0,4,0,-1,-1,3,"w1718","Mechanized",0,"Tue","weekday"
"1051",2018-02-20,"Gothic Rd","3","3","3",6.8,0,31,2,8,21.9,-2,-1,0,4,0,-1,-1,3,"w1718","Motorized",1,"Tue","weekday"
"1052",2018-02-20,"Gothic Rd","3","3","3",6.8,0,31,2,8,21.9,-2,-1,0,4,0,-1,-1,3,"w1718","Hybrid",0,"Tue","weekday"
"1053",2018-02-21,"Gothic Rd","3","3","3",6.8,0,31,0,11,21.9,2,-2,-1,0,2,0,-1,-1,"w1718","Non.motorized",27,"Wed","weekday"
"1054",2018-02-21,"Gothic Rd","3","3","3",6.8,0,31,0,11,21.9,2,-2,-1,0,2,0,-1,-1,"w1718","Mechanized",1,"Wed","weekday"
"1055",2018-02-21,"Gothic Rd","3","3","3",6.8,0,31,0,11,21.9,2,-2,-1,0,2,0,-1,-1,"w1718","Motorized",0,"Wed","weekday"
"1056",2018-02-21,"Gothic Rd","3","3","3",6.8,0,31,0,11,21.9,2,-2,-1,0,2,0,-1,-1,"w1718","Hybrid",0,"Wed","weekday"
"1057",2018-02-22,"Gothic Rd","3","3","2",6.8,0,30,-1,16,22.7,0,2,-2,-1,-1,1,-1,-2,"w1718","Non.motorized",17,"Thu","weekday"
"1058",2018-02-22,"Gothic Rd","3","3","2",6.8,0,30,-1,16,22.7,0,2,-2,-1,-1,1,-1,-2,"w1718","Mechanized",0,"Thu","weekday"
"1059",2018-02-22,"Gothic Rd","3","3","2",6.8,0,30,-1,16,22.7,0,2,-2,-1,-1,1,-1,-2,"w1718","Motorized",0,"Thu","weekday"
"1060",2018-02-22,"Gothic Rd","3","3","2",6.8,0,30,-1,16,22.7,0,2,-2,-1,-1,1,-1,-2,"w1718","Hybrid",0,"Thu","weekday"
"1061",2018-02-23,"Gothic Rd","3","3","2",6.9,0.1,30,0,15,23,-1,0,2,-2,-1,-1,1,-1,"w1718","Non.motorized",25,"Fri","weekday"
"1062",2018-02-23,"Gothic Rd","3","3","2",6.9,0.1,30,0,15,23,-1,0,2,-2,-1,-1,1,-1,"w1718","Mechanized",1,"Fri","weekday"
"1063",2018-02-23,"Gothic Rd","3","3","2",6.9,0.1,30,0,15,23,-1,0,2,-2,-1,-1,1,-1,"w1718","Motorized",0,"Fri","weekday"
"1064",2018-02-23,"Gothic Rd","3","3","2",6.9,0.1,30,0,15,23,-1,0,2,-2,-1,-1,1,-1,"w1718","Hybrid",0,"Fri","weekday"
"1065",2018-02-24,"Gothic Rd","3","3","2",6.9,0,31,1,10,22.3,0,-1,0,2,1,0,0,2,"w1718","Non.motorized",46,"Sat","weekend"
"1066",2018-02-24,"Gothic Rd","3","3","2",6.9,0,31,1,10,22.3,0,-1,0,2,1,0,0,2,"w1718","Mechanized",3,"Sat","weekend"
"1067",2018-02-24,"Gothic Rd","3","3","2",6.9,0,31,1,10,22.3,0,-1,0,2,1,0,0,2,"w1718","Motorized",0,"Sat","weekend"
"1068",2018-02-24,"Gothic Rd","3","3","2",6.9,0,31,1,10,22.3,0,-1,0,2,1,0,0,2,"w1718","Hybrid",0,"Sat","weekend"
"1069",2018-02-25,"Gothic Rd","3","3","2",7.1,0.2,32,1,11,22.2,1,0,-1,0,2,2,1,1,"w1718","Non.motorized",30,"Sun","weekend"
"1070",2018-02-25,"Gothic Rd","3","3","2",7.1,0.2,32,1,11,22.2,1,0,-1,0,2,2,1,1,"w1718","Mechanized",9,"Sun","weekend"
"1071",2018-02-25,"Gothic Rd","3","3","2",7.1,0.2,32,1,11,22.2,1,0,-1,0,2,2,1,1,"w1718","Motorized",0,"Sun","weekend"
"1072",2018-02-25,"Gothic Rd","3","3","2",7.1,0.2,32,1,11,22.2,1,0,-1,0,2,2,1,1,"w1718","Hybrid",0,"Sun","weekend"
"1073",2018-02-26,"Gothic Rd","2","2","2",7.1,0,32,0,20,22.2,1,1,0,-1,1,2,2,1,"w1718","Non.motorized",25,"Mon","weekday"
"1074",2018-02-26,"Gothic Rd","2","2","2",7.1,0,32,0,20,22.2,1,1,0,-1,1,2,2,1,"w1718","Mechanized",5,"Mon","weekday"
"1075",2018-02-26,"Gothic Rd","2","2","2",7.1,0,32,0,20,22.2,1,1,0,-1,1,2,2,1,"w1718","Motorized",0,"Mon","weekday"
"1076",2018-02-26,"Gothic Rd","2","2","2",7.1,0,32,0,20,22.2,1,1,0,-1,1,2,2,1,"w1718","Hybrid",0,"Mon","weekday"
"1077",2018-02-27,"Gothic Rd","2","2","2",7.2,0.1,32,0,26,22.5,0,1,1,0,0,1,2,2,"w1718","Non.motorized",38,"Tue","weekday"
"1078",2018-02-27,"Gothic Rd","2","2","2",7.2,0.1,32,0,26,22.5,0,1,1,0,0,1,2,2,"w1718","Mechanized",2,"Tue","weekday"
"1079",2018-02-27,"Gothic Rd","2","2","2",7.2,0.1,32,0,26,22.5,0,1,1,0,0,1,2,2,"w1718","Motorized",1,"Tue","weekday"
"1080",2018-02-27,"Gothic Rd","2","2","2",7.2,0.1,32,0,26,22.5,0,1,1,0,0,1,2,2,"w1718","Hybrid",0,"Tue","weekday"
"1081",2018-02-28,"Gothic Rd","2","2","2",7.2,0,31,-1,23,23.2,0,0,1,1,-1,-1,0,1,"w1718","Non.motorized",33,"Wed","weekday"
"1082",2018-02-28,"Gothic Rd","2","2","2",7.2,0,31,-1,23,23.2,0,0,1,1,-1,-1,0,1,"w1718","Mechanized",2,"Wed","weekday"
"1083",2018-02-28,"Gothic Rd","2","2","2",7.2,0,31,-1,23,23.2,0,0,1,1,-1,-1,0,1,"w1718","Motorized",0,"Wed","weekday"
"1084",2018-02-28,"Gothic Rd","2","2","2",7.2,0,31,-1,23,23.2,0,0,1,1,-1,-1,0,1,"w1718","Hybrid",0,"Wed","weekday"
"1085",2018-03-01,"Gothic Rd","2","2","2",7.2,0,31,0,24,23.2,-1,0,0,1,-1,-1,-1,0,"w1718","Non.motorized",28,"Thu","weekday"
"1086",2018-03-01,"Gothic Rd","2","2","2",7.2,0,31,0,24,23.2,-1,0,0,1,-1,-1,-1,0,"w1718","Mechanized",1,"Thu","weekday"
"1087",2018-03-01,"Gothic Rd","2","2","2",7.2,0,31,0,24,23.2,-1,0,0,1,-1,-1,-1,0,"w1718","Motorized",1,"Thu","weekday"
"1088",2018-03-01,"Gothic Rd","2","2","2",7.2,0,31,0,24,23.2,-1,0,0,1,-1,-1,-1,0,"w1718","Hybrid",0,"Thu","weekday"
"1089",2018-03-02,"Gothic Rd","2","2","1",7.2,0,31,0,30,23.2,0,-1,0,0,0,-1,-1,-1,"w1718","Non.motorized",62,"Fri","weekday"
"1090",2018-03-02,"Gothic Rd","2","2","1",7.2,0,31,0,30,23.2,0,-1,0,0,0,-1,-1,-1,"w1718","Mechanized",4,"Fri","weekday"
"1091",2018-03-02,"Gothic Rd","2","2","1",7.2,0,31,0,30,23.2,0,-1,0,0,0,-1,-1,-1,"w1718","Motorized",2,"Fri","weekday"
"1092",2018-03-02,"Gothic Rd","2","2","1",7.2,0,31,0,30,23.2,0,-1,0,0,0,-1,-1,-1,"w1718","Hybrid",0,"Fri","weekday"
"1093",2018-03-03,"Gothic Rd","2","2","1",7.3,0.1,30,-1,34,24.3,0,0,-1,0,-1,-1,-2,-2,"w1718","Non.motorized",68,"Sat","weekend"
"1094",2018-03-03,"Gothic Rd","2","2","1",7.3,0.1,30,-1,34,24.3,0,0,-1,0,-1,-1,-2,-2,"w1718","Mechanized",5,"Sat","weekend"
"1095",2018-03-03,"Gothic Rd","2","2","1",7.3,0.1,30,-1,34,24.3,0,0,-1,0,-1,-1,-2,-2,"w1718","Motorized",1,"Sat","weekend"
"1096",2018-03-03,"Gothic Rd","2","2","1",7.3,0.1,30,-1,34,24.3,0,0,-1,0,-1,-1,-2,-2,"w1718","Hybrid",0,"Sat","weekend"
"1097",2018-03-04,"Gothic Rd","2","2","1",7.3,0,29,-1,24,25.2,-1,0,0,-1,-2,-2,-2,-3,"w1718","Non.motorized",NA,"Sun","weekend"
"1098",2018-03-04,"Gothic Rd","2","2","1",7.3,0,29,-1,24,25.2,-1,0,0,-1,-2,-2,-2,-3,"w1718","Mechanized",NA,"Sun","weekend"
"1099",2018-03-04,"Gothic Rd","2","2","1",7.3,0,29,-1,24,25.2,-1,0,0,-1,-2,-2,-2,-3,"w1718","Motorized",NA,"Sun","weekend"
"1100",2018-03-04,"Gothic Rd","2","2","1",7.3,0,29,-1,24,25.2,-1,0,0,-1,-2,-2,-2,-3,"w1718","Hybrid",NA,"Sun","weekend"
"1101",2018-03-05,"Gothic Rd","2","2","1",7.3,0,31,2,13,23.5,-1,-1,0,0,1,0,0,0,"w1718","Non.motorized",NA,"Mon","weekday"
"1102",2018-03-05,"Gothic Rd","2","2","1",7.3,0,31,2,13,23.5,-1,-1,0,0,1,0,0,0,"w1718","Mechanized",NA,"Mon","weekday"
"1103",2018-03-05,"Gothic Rd","2","2","1",7.3,0,31,2,13,23.5,-1,-1,0,0,1,0,0,0,"w1718","Motorized",NA,"Mon","weekday"
"1104",2018-03-05,"Gothic Rd","2","2","1",7.3,0,31,2,13,23.5,-1,-1,0,0,1,0,0,0,"w1718","Hybrid",NA,"Mon","weekday"
"1105",2018-03-06,"Gothic Rd","2","2","1",7.3,0,31,0,19,23.5,2,-1,-1,0,2,1,0,0,"w1718","Non.motorized",NA,"Tue","weekday"
"1106",2018-03-06,"Gothic Rd","2","2","1",7.3,0,31,0,19,23.5,2,-1,-1,0,2,1,0,0,"w1718","Mechanized",NA,"Tue","weekday"
"1107",2018-03-06,"Gothic Rd","2","2","1",7.3,0,31,0,19,23.5,2,-1,-1,0,2,1,0,0,"w1718","Motorized",NA,"Tue","weekday"
"1108",2018-03-06,"Gothic Rd","2","2","1",7.3,0,31,0,19,23.5,2,-1,-1,0,2,1,0,0,"w1718","Hybrid",NA,"Tue","weekday"
"1109",2018-03-07,"Gothic Rd","2","2","1",7.4,0.1,31,0,27,23.9,0,2,-1,-1,0,2,1,0,"w1718","Non.motorized",NA,"Wed","weekday"
"1110",2018-03-07,"Gothic Rd","2","2","1",7.4,0.1,31,0,27,23.9,0,2,-1,-1,0,2,1,0,"w1718","Mechanized",NA,"Wed","weekday"
"1111",2018-03-07,"Gothic Rd","2","2","1",7.4,0.1,31,0,27,23.9,0,2,-1,-1,0,2,1,0,"w1718","Motorized",NA,"Wed","weekday"
"1112",2018-03-07,"Gothic Rd","2","2","1",7.4,0.1,31,0,27,23.9,0,2,-1,-1,0,2,1,0,"w1718","Hybrid",NA,"Wed","weekday"
"1113",2018-03-08,"Gothic Rd","2","2","1",7.4,0,30,-1,33,24.7,0,0,2,-1,-1,-1,1,0,"w1718","Non.motorized",NA,"Thu","weekday"
"1114",2018-03-08,"Gothic Rd","2","2","1",7.4,0,30,-1,33,24.7,0,0,2,-1,-1,-1,1,0,"w1718","Mechanized",NA,"Thu","weekday"
"1115",2018-03-08,"Gothic Rd","2","2","1",7.4,0,30,-1,33,24.7,0,0,2,-1,-1,-1,1,0,"w1718","Motorized",NA,"Thu","weekday"
"1116",2018-03-08,"Gothic Rd","2","2","1",7.4,0,30,-1,33,24.7,0,0,2,-1,-1,-1,1,0,"w1718","Hybrid",NA,"Thu","weekday"
"1117",2018-03-09,"Gothic Rd","2","2","1",7.4,0,30,0,34,24.7,-1,0,0,2,-1,-1,-1,1,"w1718","Non.motorized",10,"Fri","weekday"
"1118",2018-03-09,"Gothic Rd","2","2","1",7.4,0,30,0,34,24.7,-1,0,0,2,-1,-1,-1,1,"w1718","Mechanized",0,"Fri","weekday"
"1119",2018-03-09,"Gothic Rd","2","2","1",7.4,0,30,0,34,24.7,-1,0,0,2,-1,-1,-1,1,"w1718","Motorized",0,"Fri","weekday"
"1120",2018-03-09,"Gothic Rd","2","2","1",7.4,0,30,0,34,24.7,-1,0,0,2,-1,-1,-1,1,"w1718","Hybrid",0,"Fri","weekday"
"1121",2018-03-10,"Gothic Rd","1","1","1",7.4,0,30,0,31,24.7,0,-1,0,0,0,-1,-1,-1,"w1718","Non.motorized",80,"Sat","weekend"
"1122",2018-03-10,"Gothic Rd","1","1","1",7.4,0,30,0,31,24.7,0,-1,0,0,0,-1,-1,-1,"w1718","Mechanized",4,"Sat","weekend"
"1123",2018-03-10,"Gothic Rd","1","1","1",7.4,0,30,0,31,24.7,0,-1,0,0,0,-1,-1,-1,"w1718","Motorized",3,"Sat","weekend"
"1124",2018-03-10,"Gothic Rd","1","1","1",7.4,0,30,0,31,24.7,0,-1,0,0,0,-1,-1,-1,"w1718","Hybrid",0,"Sat","weekend"
"1125",2018-03-11,"Gothic Rd","1","1","1",7.4,0,29,-1,31,25.5,0,0,-1,0,-1,-1,-2,-2,"w1718","Non.motorized",77,"Sun","weekend"
"1126",2018-03-11,"Gothic Rd","1","1","1",7.4,0,29,-1,31,25.5,0,0,-1,0,-1,-1,-2,-2,"w1718","Mechanized",7,"Sun","weekend"
"1127",2018-03-11,"Gothic Rd","1","1","1",7.4,0,29,-1,31,25.5,0,0,-1,0,-1,-1,-2,-2,"w1718","Motorized",1,"Sun","weekend"
"1128",2018-03-11,"Gothic Rd","1","1","1",7.4,0,29,-1,31,25.5,0,0,-1,0,-1,-1,-2,-2,"w1718","Hybrid",0,"Sun","weekend"
"1129",2018-03-12,"Gothic Rd","1","1","1",7.4,0,29,0,33,25.5,-1,0,0,-1,-1,-1,-1,-2,"w1718","Non.motorized",28,"Mon","weekday"
"1130",2018-03-12,"Gothic Rd","1","1","1",7.4,0,29,0,33,25.5,-1,0,0,-1,-1,-1,-1,-2,"w1718","Mechanized",3,"Mon","weekday"
"1131",2018-03-12,"Gothic Rd","1","1","1",7.4,0,29,0,33,25.5,-1,0,0,-1,-1,-1,-1,-2,"w1718","Motorized",2,"Mon","weekday"
"1132",2018-03-12,"Gothic Rd","1","1","1",7.4,0,29,0,33,25.5,-1,0,0,-1,-1,-1,-1,-2,"w1718","Hybrid",2,"Mon","weekday"
"1133",2018-03-13,"Gothic Rd","1","1","1",7.4,0,29,0,34,25.5,0,-1,0,0,0,-1,-1,-1,"w1718","Non.motorized",50,"Tue","weekday"
"1134",2018-03-13,"Gothic Rd","1","1","1",7.4,0,29,0,34,25.5,0,-1,0,0,0,-1,-1,-1,"w1718","Mechanized",6,"Tue","weekday"
"1135",2018-03-13,"Gothic Rd","1","1","1",7.4,0,29,0,34,25.5,0,-1,0,0,0,-1,-1,-1,"w1718","Motorized",1,"Tue","weekday"
"1136",2018-03-13,"Gothic Rd","1","1","1",7.4,0,29,0,34,25.5,0,-1,0,0,0,-1,-1,-1,"w1718","Hybrid",0,"Tue","weekday"
"1137",2018-03-14,"Gothic Rd","1","2","2",7.4,0,29,0,39,25.5,0,0,-1,0,0,0,-1,-1,"w1718","Non.motorized",31,"Wed","weekday"
"1138",2018-03-14,"Gothic Rd","1","2","2",7.4,0,29,0,39,25.5,0,0,-1,0,0,0,-1,-1,"w1718","Mechanized",3,"Wed","weekday"
"1139",2018-03-14,"Gothic Rd","1","2","2",7.4,0,29,0,39,25.5,0,0,-1,0,0,0,-1,-1,"w1718","Motorized",0,"Wed","weekday"
"1140",2018-03-14,"Gothic Rd","1","2","2",7.4,0,29,0,39,25.5,0,0,-1,0,0,0,-1,-1,"w1718","Hybrid",0,"Wed","weekday"
"1141",2018-03-15,"Gothic Rd","2","2","2",7.5,0.1,28,-1,31,26.8,0,0,0,-1,-1,-1,-1,-2,"w1718","Non.motorized",14,"Thu","weekday"
"1142",2018-03-15,"Gothic Rd","2","2","2",7.5,0.1,28,-1,31,26.8,0,0,0,-1,-1,-1,-1,-2,"w1718","Mechanized",2,"Thu","weekday"
"1143",2018-03-15,"Gothic Rd","2","2","2",7.5,0.1,28,-1,31,26.8,0,0,0,-1,-1,-1,-1,-2,"w1718","Motorized",0,"Thu","weekday"
"1144",2018-03-15,"Gothic Rd","2","2","2",7.5,0.1,28,-1,31,26.8,0,0,0,-1,-1,-1,-1,-2,"w1718","Hybrid",0,"Thu","weekday"
"1145",2018-03-16,"Gothic Rd","2","2","2",7.7,0.2,29,1,25,26.6,-1,0,0,0,0,0,0,0,"w1718","Non.motorized",37,"Fri","weekday"
"1146",2018-03-16,"Gothic Rd","2","2","2",7.7,0.2,29,1,25,26.6,-1,0,0,0,0,0,0,0,"w1718","Mechanized",3,"Fri","weekday"
"1147",2018-03-16,"Gothic Rd","2","2","2",7.7,0.2,29,1,25,26.6,-1,0,0,0,0,0,0,0,"w1718","Motorized",0,"Fri","weekday"
"1148",2018-03-16,"Gothic Rd","2","2","2",7.7,0.2,29,1,25,26.6,-1,0,0,0,0,0,0,0,"w1718","Hybrid",0,"Fri","weekday"
"1149",2018-03-17,"Gothic Rd","2","2","2",7.8,0.1,32,3,29,24.4,1,-1,0,0,4,3,3,3,"w1718","Non.motorized",54,"Sat","weekend"
"1150",2018-03-17,"Gothic Rd","2","2","2",7.8,0.1,32,3,29,24.4,1,-1,0,0,4,3,3,3,"w1718","Mechanized",5,"Sat","weekend"
"1151",2018-03-17,"Gothic Rd","2","2","2",7.8,0.1,32,3,29,24.4,1,-1,0,0,4,3,3,3,"w1718","Motorized",0,"Sat","weekend"
"1152",2018-03-17,"Gothic Rd","2","2","2",7.8,0.1,32,3,29,24.4,1,-1,0,0,4,3,3,3,"w1718","Hybrid",0,"Sat","weekend"
"1153",2018-03-18,"Gothic Rd","2","2","2",7.9,0.1,31,-1,24,25.5,3,1,-1,0,2,3,2,2,"w1718","Non.motorized",27,"Sun","weekend"
"1154",2018-03-18,"Gothic Rd","2","2","2",7.9,0.1,31,-1,24,25.5,3,1,-1,0,2,3,2,2,"w1718","Mechanized",4,"Sun","weekend"
"1155",2018-03-18,"Gothic Rd","2","2","2",7.9,0.1,31,-1,24,25.5,3,1,-1,0,2,3,2,2,"w1718","Motorized",0,"Sun","weekend"
"1156",2018-03-18,"Gothic Rd","2","2","2",7.9,0.1,31,-1,24,25.5,3,1,-1,0,2,3,2,2,"w1718","Hybrid",0,"Sun","weekend"
"1157",2018-03-19,"Gothic Rd","2","2","1",8,0.1,32,1,19,25,-1,3,1,-1,0,3,4,3,"w1718","Non.motorized",51,"Mon","weekday"
"1158",2018-03-19,"Gothic Rd","2","2","1",8,0.1,32,1,19,25,-1,3,1,-1,0,3,4,3,"w1718","Mechanized",0,"Mon","weekday"
"1159",2018-03-19,"Gothic Rd","2","2","1",8,0.1,32,1,19,25,-1,3,1,-1,0,3,4,3,"w1718","Motorized",1,"Mon","weekday"
"1160",2018-03-19,"Gothic Rd","2","2","1",8,0.1,32,1,19,25,-1,3,1,-1,0,3,4,3,"w1718","Hybrid",0,"Mon","weekday"
"1161",2018-03-20,"Gothic Rd","2","2","1",8,0,30,-2,24,26.7,1,-1,3,1,-1,-2,1,2,"w1718","Non.motorized",19,"Tue","weekday"
"1162",2018-03-20,"Gothic Rd","2","2","1",8,0,30,-2,24,26.7,1,-1,3,1,-1,-2,1,2,"w1718","Mechanized",0,"Tue","weekday"
"1163",2018-03-20,"Gothic Rd","2","2","1",8,0,30,-2,24,26.7,1,-1,3,1,-1,-2,1,2,"w1718","Motorized",0,"Tue","weekday"
"1164",2018-03-20,"Gothic Rd","2","2","1",8,0,30,-2,24,26.7,1,-1,3,1,-1,-2,1,2,"w1718","Hybrid",0,"Tue","weekday"
"1165",2018-03-21,"Gothic Rd","1","1","1",8.1,0.1,32,2,30,25.3,-2,1,-1,3,0,1,0,3,"w1718","Non.motorized",29,"Wed","weekday"
"1166",2018-03-21,"Gothic Rd","1","1","1",8.1,0.1,32,2,30,25.3,-2,1,-1,3,0,1,0,3,"w1718","Mechanized",2,"Wed","weekday"
"1167",2018-03-21,"Gothic Rd","1","1","1",8.1,0.1,32,2,30,25.3,-2,1,-1,3,0,1,0,3,"w1718","Motorized",0,"Wed","weekday"
"1168",2018-03-21,"Gothic Rd","1","1","1",8.1,0.1,32,2,30,25.3,-2,1,-1,3,0,1,0,3,"w1718","Hybrid",0,"Wed","weekday"
"1169",2018-03-22,"Gothic Rd","1","1","1",8.1,0,30,-2,36,27,2,-2,1,-1,0,-2,-1,-2,"w1718","Non.motorized",30,"Thu","weekday"
"1170",2018-03-22,"Gothic Rd","1","1","1",8.1,0,30,-2,36,27,2,-2,1,-1,0,-2,-1,-2,"w1718","Mechanized",0,"Thu","weekday"
"1171",2018-03-22,"Gothic Rd","1","1","1",8.1,0,30,-2,36,27,2,-2,1,-1,0,-2,-1,-2,"w1718","Motorized",0,"Thu","weekday"
"1172",2018-03-22,"Gothic Rd","1","1","1",8.1,0,30,-2,36,27,2,-2,1,-1,0,-2,-1,-2,"w1718","Hybrid",0,"Thu","weekday"
"1173",2018-03-23,"Gothic Rd","2","2","3",8.2,0.1,29,-1,34,28.3,-2,2,-2,1,-3,-1,-3,-2,"w1718","Non.motorized",18,"Fri","weekday"
"1174",2018-03-23,"Gothic Rd","2","2","3",8.2,0.1,29,-1,34,28.3,-2,2,-2,1,-3,-1,-3,-2,"w1718","Mechanized",0,"Fri","weekday"
"1175",2018-03-23,"Gothic Rd","2","2","3",8.2,0.1,29,-1,34,28.3,-2,2,-2,1,-3,-1,-3,-2,"w1718","Motorized",0,"Fri","weekday"
"1176",2018-03-23,"Gothic Rd","2","2","3",8.2,0.1,29,-1,34,28.3,-2,2,-2,1,-3,-1,-3,-2,"w1718","Hybrid",0,"Fri","weekday"
"1177",2018-03-24,"Gothic Rd","2","2","1",8.9,0.7,34,5,32,26.2,-1,-2,2,-2,4,2,4,2,"w1718","Non.motorized",25,"Sat","weekend"
"1178",2018-03-24,"Gothic Rd","2","2","1",8.9,0.7,34,5,32,26.2,-1,-2,2,-2,4,2,4,2,"w1718","Mechanized",7,"Sat","weekend"
"1179",2018-03-24,"Gothic Rd","2","2","1",8.9,0.7,34,5,32,26.2,-1,-2,2,-2,4,2,4,2,"w1718","Motorized",1,"Sat","weekend"
"1180",2018-03-24,"Gothic Rd","2","2","1",8.9,0.7,34,5,32,26.2,-1,-2,2,-2,4,2,4,2,"w1718","Hybrid",0,"Sat","weekend"
"1181",2018-03-25,"Gothic Rd","2","2","1",8.9,0,35,1,35,25.4,5,-1,-2,2,6,5,3,5,"w1718","Non.motorized",65,"Sun","weekend"
"1182",2018-03-25,"Gothic Rd","2","2","1",8.9,0,35,1,35,25.4,5,-1,-2,2,6,5,3,5,"w1718","Mechanized",3,"Sun","weekend"
"1183",2018-03-25,"Gothic Rd","2","2","1",8.9,0,35,1,35,25.4,5,-1,-2,2,6,5,3,5,"w1718","Motorized",0,"Sun","weekend"
"1184",2018-03-25,"Gothic Rd","2","2","1",8.9,0,35,1,35,25.4,5,-1,-2,2,6,5,3,5,"w1718","Hybrid",0,"Sun","weekend"
"1185",2018-03-26,"Gothic Rd","1","1","1",8.9,0,34,-1,31,26.2,1,5,-1,-2,0,5,4,2,"w1718","Non.motorized",52,"Mon","weekday"
"1186",2018-03-26,"Gothic Rd","1","1","1",8.9,0,34,-1,31,26.2,1,5,-1,-2,0,5,4,2,"w1718","Mechanized",4,"Mon","weekday"
"1187",2018-03-26,"Gothic Rd","1","1","1",8.9,0,34,-1,31,26.2,1,5,-1,-2,0,5,4,2,"w1718","Motorized",0,"Mon","weekday"
"1188",2018-03-26,"Gothic Rd","1","1","1",8.9,0,34,-1,31,26.2,1,5,-1,-2,0,5,4,2,"w1718","Hybrid",0,"Mon","weekday"
"1189",2018-03-26,"Gothic Rd","2","1","1",8.9,0,34,-1,31,26.2,1,5,-1,-2,0,5,4,2,"w1718","Non.motorized",52,"Mon","weekday"
"1190",2018-03-26,"Gothic Rd","2","1","1",8.9,0,34,-1,31,26.2,1,5,-1,-2,0,5,4,2,"w1718","Mechanized",4,"Mon","weekday"
"1191",2018-03-26,"Gothic Rd","2","1","1",8.9,0,34,-1,31,26.2,1,5,-1,-2,0,5,4,2,"w1718","Motorized",0,"Mon","weekday"
"1192",2018-03-26,"Gothic Rd","2","1","1",8.9,0,34,-1,31,26.2,1,5,-1,-2,0,5,4,2,"w1718","Hybrid",0,"Mon","weekday"
"1193",2018-03-27,"Gothic Rd","1","1","1",8.9,0,33,-1,29,27,-1,1,5,-1,-2,-1,4,3,"w1718","Non.motorized",34,"Tue","weekday"
"1194",2018-03-27,"Gothic Rd","1","1","1",8.9,0,33,-1,29,27,-1,1,5,-1,-2,-1,4,3,"w1718","Mechanized",3,"Tue","weekday"
"1195",2018-03-27,"Gothic Rd","1","1","1",8.9,0,33,-1,29,27,-1,1,5,-1,-2,-1,4,3,"w1718","Motorized",0,"Tue","weekday"
"1196",2018-03-27,"Gothic Rd","1","1","1",8.9,0,33,-1,29,27,-1,1,5,-1,-2,-1,4,3,"w1718","Hybrid",0,"Tue","weekday"
"1197",2018-03-28,"Gothic Rd","1","1","1",8.9,0,33,0,27,27,-1,-1,1,5,-1,-2,-1,4,"w1718","Non.motorized",25,"Wed","weekday"
"1198",2018-03-28,"Gothic Rd","1","1","1",8.9,0,33,0,27,27,-1,-1,1,5,-1,-2,-1,4,"w1718","Mechanized",0,"Wed","weekday"
"1199",2018-03-28,"Gothic Rd","1","1","1",8.9,0,33,0,27,27,-1,-1,1,5,-1,-2,-1,4,"w1718","Motorized",0,"Wed","weekday"
"1200",2018-03-28,"Gothic Rd","1","1","1",8.9,0,33,0,27,27,-1,-1,1,5,-1,-2,-1,4,"w1718","Hybrid",0,"Wed","weekday"
"1201",2018-03-29,"Gothic Rd","1","1","1",8.9,0,33,0,27,27,0,-1,-1,1,0,-1,-2,-1,"w1718","Non.motorized",36,"Thu","weekday"
"1202",2018-03-29,"Gothic Rd","1","1","1",8.9,0,33,0,27,27,0,-1,-1,1,0,-1,-2,-1,"w1718","Mechanized",3,"Thu","weekday"
"1203",2018-03-29,"Gothic Rd","1","1","1",8.9,0,33,0,27,27,0,-1,-1,1,0,-1,-2,-1,"w1718","Motorized",0,"Thu","weekday"
"1204",2018-03-29,"Gothic Rd","1","1","1",8.9,0,33,0,27,27,0,-1,-1,1,0,-1,-2,-1,"w1718","Hybrid",0,"Thu","weekday"
"1205",2018-03-30,"Gothic Rd","1","1","1",8.9,0,32,-1,33,27.8,0,0,-1,-1,-1,-1,-2,-3,"w1718","Non.motorized",61,"Fri","weekday"
"1206",2018-03-30,"Gothic Rd","1","1","1",8.9,0,32,-1,33,27.8,0,0,-1,-1,-1,-1,-2,-3,"w1718","Mechanized",3,"Fri","weekday"
"1207",2018-03-30,"Gothic Rd","1","1","1",8.9,0,32,-1,33,27.8,0,0,-1,-1,-1,-1,-2,-3,"w1718","Motorized",2,"Fri","weekday"
"1208",2018-03-30,"Gothic Rd","1","1","1",8.9,0,32,-1,33,27.8,0,0,-1,-1,-1,-1,-2,-3,"w1718","Hybrid",0,"Fri","weekday"
"1209",2018-03-31,"Gothic Rd","1","1","1",8.9,0,32,0,39,27.8,-1,0,0,-1,-1,-1,-1,-2,"w1718","Non.motorized",58,"Sat","weekend"
"1210",2018-03-31,"Gothic Rd","1","1","1",8.9,0,32,0,39,27.8,-1,0,0,-1,-1,-1,-1,-2,"w1718","Mechanized",1,"Sat","weekend"
"1211",2018-03-31,"Gothic Rd","1","1","1",8.9,0,32,0,39,27.8,-1,0,0,-1,-1,-1,-1,-2,"w1718","Motorized",0,"Sat","weekend"
"1212",2018-03-31,"Gothic Rd","1","1","1",8.9,0,32,0,39,27.8,-1,0,0,-1,-1,-1,-1,-2,"w1718","Hybrid",0,"Sat","weekend"
"1213",2018-04-01,"Gothic Rd","1","1","1",8.8,-0.1,30,-2,41,29.3,0,-1,0,0,-2,-3,-3,-3,"w1718","Non.motorized",27,"Sun","weekend"
"1214",2018-04-01,"Gothic Rd","1","1","1",8.8,-0.1,30,-2,41,29.3,0,-1,0,0,-2,-3,-3,-3,"w1718","Mechanized",0,"Sun","weekend"
"1215",2018-04-01,"Gothic Rd","1","1","1",8.8,-0.1,30,-2,41,29.3,0,-1,0,0,-2,-3,-3,-3,"w1718","Motorized",0,"Sun","weekend"
"1216",2018-04-01,"Gothic Rd","1","1","1",8.8,-0.1,30,-2,41,29.3,0,-1,0,0,-2,-3,-3,-3,"w1718","Hybrid",0,"Sun","weekend"
"1217",2018-04-02,"Gothic Rd","1","1","1",8.7,-0.1,29,-1,39,30,-2,0,-1,0,-3,-3,-4,-4,"w1718","Non.motorized",21,"Mon","weekday"
"1218",2018-04-02,"Gothic Rd","1","1","1",8.7,-0.1,29,-1,39,30,-2,0,-1,0,-3,-3,-4,-4,"w1718","Mechanized",0,"Mon","weekday"
"1219",2018-04-02,"Gothic Rd","1","1","1",8.7,-0.1,29,-1,39,30,-2,0,-1,0,-3,-3,-4,-4,"w1718","Motorized",0,"Mon","weekday"
"1220",2018-04-02,"Gothic Rd","1","1","1",8.7,-0.1,29,-1,39,30,-2,0,-1,0,-3,-3,-4,-4,"w1718","Hybrid",0,"Mon","weekday"
"1221",2018-04-03,"Gothic Rd","1","1","1",8.8,0.1,30,1,27,29.3,-1,-2,0,-1,0,-2,-2,-3,"w1718","Non.motorized",11,"Tue","weekday"
"1222",2018-04-03,"Gothic Rd","1","1","1",8.8,0.1,30,1,27,29.3,-1,-2,0,-1,0,-2,-2,-3,"w1718","Mechanized",0,"Tue","weekday"
"1223",2018-04-03,"Gothic Rd","1","1","1",8.8,0.1,30,1,27,29.3,-1,-2,0,-1,0,-2,-2,-3,"w1718","Motorized",0,"Tue","weekday"
"1224",2018-04-03,"Gothic Rd","1","1","1",8.8,0.1,30,1,27,29.3,-1,-2,0,-1,0,-2,-2,-3,"w1718","Hybrid",0,"Tue","weekday"
"1225",2018-04-04,"Gothic Rd","1","2","2",8.9,0.1,28,-2,33,31.8,1,-1,-2,0,-1,-2,-4,-4,"w1718","Non.motorized",16,"Wed","weekday"
"1226",2018-04-04,"Gothic Rd","1","2","2",8.9,0.1,28,-2,33,31.8,1,-1,-2,0,-1,-2,-4,-4,"w1718","Mechanized",0,"Wed","weekday"
"1227",2018-04-04,"Gothic Rd","1","2","2",8.9,0.1,28,-2,33,31.8,1,-1,-2,0,-1,-2,-4,-4,"w1718","Motorized",0,"Wed","weekday"
"1228",2018-04-04,"Gothic Rd","1","2","2",8.9,0.1,28,-2,33,31.8,1,-1,-2,0,-1,-2,-4,-4,"w1718","Hybrid",0,"Wed","weekday"
"1229",2018-04-05,"Gothic Rd","1","2","2",8.9,0,27,-1,35,33,-2,1,-1,-2,-3,-2,-3,-5,"w1718","Non.motorized",17,"Thu","weekday"
"1230",2018-04-05,"Gothic Rd","1","2","2",8.9,0,27,-1,35,33,-2,1,-1,-2,-3,-2,-3,-5,"w1718","Mechanized",0,"Thu","weekday"
"1231",2018-04-05,"Gothic Rd","1","2","2",8.9,0,27,-1,35,33,-2,1,-1,-2,-3,-2,-3,-5,"w1718","Motorized",1,"Thu","weekday"
"1232",2018-04-05,"Gothic Rd","1","2","2",8.9,0,27,-1,35,33,-2,1,-1,-2,-3,-2,-3,-5,"w1718","Hybrid",0,"Thu","weekday"
"1233",2018-04-06,"Gothic Rd","1","2","2",8.9,0,25,-2,35,35.6,-1,-2,1,-1,-3,-5,-4,-5,"w1718","Non.motorized",4,"Fri","weekday"
"1234",2018-04-06,"Gothic Rd","1","2","2",8.9,0,25,-2,35,35.6,-1,-2,1,-1,-3,-5,-4,-5,"w1718","Mechanized",0,"Fri","weekday"
"1235",2018-04-06,"Gothic Rd","1","2","2",8.9,0,25,-2,35,35.6,-1,-2,1,-1,-3,-5,-4,-5,"w1718","Motorized",0,"Fri","weekday"
"1236",2018-04-06,"Gothic Rd","1","2","2",8.9,0,25,-2,35,35.6,-1,-2,1,-1,-3,-5,-4,-5,"w1718","Hybrid",0,"Fri","weekday"
"1237",2018-04-07,"Gothic Rd","2","2","2",9.2,0.3,31,6,37,29.7,-2,-1,-2,1,4,3,1,2,"w1718","Non.motorized",18,"Sat","weekend"
"1238",2018-04-07,"Gothic Rd","2","2","2",9.2,0.3,31,6,37,29.7,-2,-1,-2,1,4,3,1,2,"w1718","Mechanized",0,"Sat","weekend"
"1239",2018-04-07,"Gothic Rd","2","2","2",9.2,0.3,31,6,37,29.7,-2,-1,-2,1,4,3,1,2,"w1718","Motorized",0,"Sat","weekend"
"1240",2018-04-07,"Gothic Rd","2","2","2",9.2,0.3,31,6,37,29.7,-2,-1,-2,1,4,3,1,2,"w1718","Hybrid",0,"Sat","weekend"
"1241",2018-04-08,"Gothic Rd","3","3","3",10,0.8,33,2,33,30.3,6,-2,-1,-2,8,6,5,3,"w1718","Non.motorized",6,"Sun","weekend"
"1242",2018-04-08,"Gothic Rd","3","3","3",10,0.8,33,2,33,30.3,6,-2,-1,-2,8,6,5,3,"w1718","Mechanized",0,"Sun","weekend"
"1243",2018-04-08,"Gothic Rd","3","3","3",10,0.8,33,2,33,30.3,6,-2,-1,-2,8,6,5,3,"w1718","Motorized",0,"Sun","weekend"
"1244",2018-04-08,"Gothic Rd","3","3","3",10,0.8,33,2,33,30.3,6,-2,-1,-2,8,6,5,3,"w1718","Hybrid",0,"Sun","weekend"
"1245",2018-04-09,"Gothic Rd","1","1","1",10.1,0.1,33,0,31,30.6,2,6,-2,-1,2,8,6,5,"w1718","Non.motorized",7,"Mon","weekday"
"1246",2018-04-09,"Gothic Rd","1","1","1",10.1,0.1,33,0,31,30.6,2,6,-2,-1,2,8,6,5,"w1718","Mechanized",0,"Mon","weekday"
"1247",2018-04-09,"Gothic Rd","1","1","1",10.1,0.1,33,0,31,30.6,2,6,-2,-1,2,8,6,5,"w1718","Motorized",0,"Mon","weekday"
"1248",2018-04-09,"Gothic Rd","1","1","1",10.1,0.1,33,0,31,30.6,2,6,-2,-1,2,8,6,5,"w1718","Hybrid",0,"Mon","weekday"
"1249",2018-04-10,"Gothic Rd","1","1","1",10.1,0,31,-2,38,32.6,0,2,6,-2,-2,0,6,4,"w1718","Non.motorized",12,"Tue","weekday"
"1250",2018-04-10,"Gothic Rd","1","1","1",10.1,0,31,-2,38,32.6,0,2,6,-2,-2,0,6,4,"w1718","Mechanized",0,"Tue","weekday"
"1251",2018-04-10,"Gothic Rd","1","1","1",10.1,0,31,-2,38,32.6,0,2,6,-2,-2,0,6,4,"w1718","Motorized",0,"Tue","weekday"
"1252",2018-04-10,"Gothic Rd","1","1","1",10.1,0,31,-2,38,32.6,0,2,6,-2,-2,0,6,4,"w1718","Hybrid",0,"Tue","weekday"
"1253",2018-04-11,"Gothic Rd","2","2","2",9.9,-0.2,29,-2,45,34.1,-2,0,2,6,-4,-4,-2,4,"w1718","Non.motorized",11,"Wed","weekday"
"1254",2018-04-11,"Gothic Rd","2","2","2",9.9,-0.2,29,-2,45,34.1,-2,0,2,6,-4,-4,-2,4,"w1718","Mechanized",0,"Wed","weekday"
"1255",2018-04-11,"Gothic Rd","2","2","2",9.9,-0.2,29,-2,45,34.1,-2,0,2,6,-4,-4,-2,4,"w1718","Motorized",0,"Wed","weekday"
"1256",2018-04-11,"Gothic Rd","2","2","2",9.9,-0.2,29,-2,45,34.1,-2,0,2,6,-4,-4,-2,4,"w1718","Hybrid",0,"Wed","weekday"
"1257",2018-04-12,"Gothic Rd","1","2","2",9.5,-0.4,28,-1,40,33.9,-2,-2,0,2,-3,-5,-5,-3,"w1718","Non.motorized",6,"Thu","weekday"
"1258",2018-04-12,"Gothic Rd","1","2","2",9.5,-0.4,28,-1,40,33.9,-2,-2,0,2,-3,-5,-5,-3,"w1718","Mechanized",0,"Thu","weekday"
"1259",2018-04-12,"Gothic Rd","1","2","2",9.5,-0.4,28,-1,40,33.9,-2,-2,0,2,-3,-5,-5,-3,"w1718","Motorized",0,"Thu","weekday"
"1260",2018-04-12,"Gothic Rd","1","2","2",9.5,-0.4,28,-1,40,33.9,-2,-2,0,2,-3,-5,-5,-3,"w1718","Hybrid",0,"Thu","weekday"
"1261",2018-04-13,"Gothic Rd","2","2","1",9.4,-0.1,26,-2,23,36.2,-1,-2,-2,0,-3,-5,-7,-7,"w1718","Non.motorized",6,"Fri","weekday"
"1262",2018-04-13,"Gothic Rd","2","2","1",9.4,-0.1,26,-2,23,36.2,-1,-2,-2,0,-3,-5,-7,-7,"w1718","Mechanized",1,"Fri","weekday"
"1263",2018-04-13,"Gothic Rd","2","2","1",9.4,-0.1,26,-2,23,36.2,-1,-2,-2,0,-3,-5,-7,-7,"w1718","Motorized",0,"Fri","weekday"
"1264",2018-04-13,"Gothic Rd","2","2","1",9.4,-0.1,26,-2,23,36.2,-1,-2,-2,0,-3,-5,-7,-7,"w1718","Hybrid",0,"Fri","weekday"
"1265",2018-04-14,"Gothic Rd","2","2","1",9.4,0,28,2,28,33.6,-2,-1,-2,-2,0,-1,-3,-5,"w1718","Non.motorized",9,"Sat","weekend"
"1266",2018-04-14,"Gothic Rd","2","2","1",9.4,0,28,2,28,33.6,-2,-1,-2,-2,0,-1,-3,-5,"w1718","Mechanized",0,"Sat","weekend"
"1267",2018-04-14,"Gothic Rd","2","2","1",9.4,0,28,2,28,33.6,-2,-1,-2,-2,0,-1,-3,-5,"w1718","Motorized",0,"Sat","weekend"
"1268",2018-04-14,"Gothic Rd","2","2","1",9.4,0,28,2,28,33.6,-2,-1,-2,-2,0,-1,-3,-5,"w1718","Hybrid",0,"Sat","weekend"
"1269",2018-04-15,"Gothic Rd","2","2","1",9.2,-0.2,27,-1,37,34.1,2,-2,-1,-2,1,-1,-2,-4,"w1718","Non.motorized",11,"Sun","weekend"
"1270",2018-04-15,"Gothic Rd","2","2","1",9.2,-0.2,27,-1,37,34.1,2,-2,-1,-2,1,-1,-2,-4,"w1718","Mechanized",0,"Sun","weekend"
"1271",2018-04-15,"Gothic Rd","2","2","1",9.2,-0.2,27,-1,37,34.1,2,-2,-1,-2,1,-1,-2,-4,"w1718","Motorized",0,"Sun","weekend"
"1272",2018-04-15,"Gothic Rd","2","2","1",9.2,-0.2,27,-1,37,34.1,2,-2,-1,-2,1,-1,-2,-4,"w1718","Hybrid",0,"Sun","weekend"
"1273",2018-02-09,"Kebler","2","2","1",5.3,0,24,-1,33,22.1,2,0,5,-1,1,1,6,5,"w1718","Non.motorized",1,"Fri","weekday"
"1274",2018-02-09,"Kebler","2","2","1",5.3,0,24,-1,33,22.1,2,0,5,-1,1,1,6,5,"w1718","Mechanized",1,"Fri","weekday"
"1275",2018-02-09,"Kebler","2","2","1",5.3,0,24,-1,33,22.1,2,0,5,-1,1,1,6,5,"w1718","Motorized",29,"Fri","weekday"
"1276",2018-02-09,"Kebler","2","2","1",5.3,0,24,-1,33,22.1,2,0,5,-1,1,1,6,5,"w1718","Hybrid",0,"Fri","weekday"
"1277",2018-02-10,"Kebler","3","3","2",5.3,0,24,0,24,22.1,-1,2,0,5,-1,1,1,6,"w1718","Non.motorized",3,"Sat","weekend"
"1278",2018-02-10,"Kebler","3","3","2",5.3,0,24,0,24,22.1,-1,2,0,5,-1,1,1,6,"w1718","Mechanized",1,"Sat","weekend"
"1279",2018-02-10,"Kebler","3","3","2",5.3,0,24,0,24,22.1,-1,2,0,5,-1,1,1,6,"w1718","Motorized",20,"Sat","weekend"
"1280",2018-02-10,"Kebler","3","3","2",5.3,0,24,0,24,22.1,-1,2,0,5,-1,1,1,6,"w1718","Hybrid",4,"Sat","weekend"
"1281",2018-02-11,"Kebler","3","3","2",5.6,0.3,27,3,13,20.7,0,-1,2,0,3,2,4,4,"w1718","Non.motorized",10,"Sun","weekend"
"1282",2018-02-11,"Kebler","3","3","2",5.6,0.3,27,3,13,20.7,0,-1,2,0,3,2,4,4,"w1718","Mechanized",0,"Sun","weekend"
"1283",2018-02-11,"Kebler","3","3","2",5.6,0.3,27,3,13,20.7,0,-1,2,0,3,2,4,4,"w1718","Motorized",129,"Sun","weekend"
"1284",2018-02-11,"Kebler","3","3","2",5.6,0.3,27,3,13,20.7,0,-1,2,0,3,2,4,4,"w1718","Hybrid",21,"Sun","weekend"
"1285",2018-02-12,"Kebler","3","3","3",5.7,0.1,27,0,23,21.1,3,0,-1,2,3,3,2,4,"w1718","Non.motorized",0,"Mon","weekday"
"1286",2018-02-12,"Kebler","3","3","3",5.7,0.1,27,0,23,21.1,3,0,-1,2,3,3,2,4,"w1718","Mechanized",0,"Mon","weekday"
"1287",2018-02-12,"Kebler","3","3","3",5.7,0.1,27,0,23,21.1,3,0,-1,2,3,3,2,4,"w1718","Motorized",32,"Mon","weekday"
"1288",2018-02-12,"Kebler","3","3","3",5.7,0.1,27,0,23,21.1,3,0,-1,2,3,3,2,4,"w1718","Hybrid",9,"Mon","weekday"
"1289",2018-02-13,"Kebler","3","3","3",6.1,0.4,29,2,28,21,0,3,0,-1,2,5,5,4,"w1718","Non.motorized",16,"Tue","weekday"
"1290",2018-02-13,"Kebler","3","3","3",6.1,0.4,29,2,28,21,0,3,0,-1,2,5,5,4,"w1718","Mechanized",1,"Tue","weekday"
"1291",2018-02-13,"Kebler","3","3","3",6.1,0.4,29,2,28,21,0,3,0,-1,2,5,5,4,"w1718","Motorized",38,"Tue","weekday"
"1292",2018-02-13,"Kebler","3","3","3",6.1,0.4,29,2,28,21,0,3,0,-1,2,5,5,4,"w1718","Hybrid",2,"Tue","weekday"
"1293",2018-02-14,"Kebler","3","3","3",6.2,0.1,30,1,30,20.7,2,0,3,0,3,3,6,6,"w1718","Non.motorized",9,"Wed","weekday"
"1294",2018-02-14,"Kebler","3","3","3",6.2,0.1,30,1,30,20.7,2,0,3,0,3,3,6,6,"w1718","Mechanized",0,"Wed","weekday"
"1295",2018-02-14,"Kebler","3","3","3",6.2,0.1,30,1,30,20.7,2,0,3,0,3,3,6,6,"w1718","Motorized",80,"Wed","weekday"
"1296",2018-02-14,"Kebler","3","3","3",6.2,0.1,30,1,30,20.7,2,0,3,0,3,3,6,6,"w1718","Hybrid",0,"Wed","weekday"
"1297",2018-02-15,"Kebler","3","3","3",6.3,0.1,28,-2,24,22.5,1,2,0,3,-1,1,1,4,"w1718","Non.motorized",10,"Thu","weekday"
"1298",2018-02-15,"Kebler","3","3","3",6.3,0.1,28,-2,24,22.5,1,2,0,3,-1,1,1,4,"w1718","Mechanized",0,"Thu","weekday"
"1299",2018-02-15,"Kebler","3","3","3",6.3,0.1,28,-2,24,22.5,1,2,0,3,-1,1,1,4,"w1718","Motorized",43,"Thu","weekday"
"1300",2018-02-15,"Kebler","3","3","3",6.3,0.1,28,-2,24,22.5,1,2,0,3,-1,1,1,4,"w1718","Hybrid",0,"Thu","weekday"
"1301",2018-02-16,"Kebler","3","3","3",6.7,0.4,32,4,18,20.9,-2,1,2,0,2,3,5,5,"w1718","Non.motorized",12,"Fri","weekday"
"1302",2018-02-16,"Kebler","3","3","3",6.7,0.4,32,4,18,20.9,-2,1,2,0,2,3,5,5,"w1718","Mechanized",0,"Fri","weekday"
"1303",2018-02-16,"Kebler","3","3","3",6.7,0.4,32,4,18,20.9,-2,1,2,0,2,3,5,5,"w1718","Motorized",114,"Fri","weekday"
"1304",2018-02-16,"Kebler","3","3","3",6.7,0.4,32,4,18,20.9,-2,1,2,0,2,3,5,5,"w1718","Hybrid",6,"Fri","weekday"
"1305",2018-02-17,"Kebler","3","3","2",6.7,0,32,0,25,20.9,4,-2,1,2,4,2,3,5,"w1718","Non.motorized",39,"Sat","weekend"
"1306",2018-02-17,"Kebler","3","3","2",6.7,0,32,0,25,20.9,4,-2,1,2,4,2,3,5,"w1718","Mechanized",0,"Sat","weekend"
"1307",2018-02-17,"Kebler","3","3","2",6.7,0,32,0,25,20.9,4,-2,1,2,4,2,3,5,"w1718","Motorized",184,"Sat","weekend"
"1308",2018-02-17,"Kebler","3","3","2",6.7,0,32,0,25,20.9,4,-2,1,2,4,2,3,5,"w1718","Hybrid",2,"Sat","weekend"
"1309",2018-02-18,"Kebler","2","2","2",6.7,0,31,-1,32,21.6,0,4,-2,1,-1,3,1,2,"w1718","Non.motorized",19,"Sun","weekend"
"1310",2018-02-18,"Kebler","2","2","2",6.7,0,31,-1,32,21.6,0,4,-2,1,-1,3,1,2,"w1718","Mechanized",0,"Sun","weekend"
"1311",2018-02-18,"Kebler","2","2","2",6.7,0,31,-1,32,21.6,0,4,-2,1,-1,3,1,2,"w1718","Motorized",156,"Sun","weekend"
"1312",2018-02-18,"Kebler","2","2","2",6.7,0,31,-1,32,21.6,0,4,-2,1,-1,3,1,2,"w1718","Hybrid",17,"Sun","weekend"
"1313",2018-02-19,"Kebler","2","2","2",6.8,0.1,29,-2,24,23.4,-1,0,4,-2,-3,-3,1,-1,"w1718","Non.motorized",0,"Mon","weekday"
"1314",2018-02-19,"Kebler","2","2","2",6.8,0.1,29,-2,24,23.4,-1,0,4,-2,-3,-3,1,-1,"w1718","Mechanized",0,"Mon","weekday"
"1315",2018-02-19,"Kebler","2","2","2",6.8,0.1,29,-2,24,23.4,-1,0,4,-2,-3,-3,1,-1,"w1718","Motorized",49,"Mon","weekday"
"1316",2018-02-19,"Kebler","2","2","2",6.8,0.1,29,-2,24,23.4,-1,0,4,-2,-3,-3,1,-1,"w1718","Hybrid",2,"Mon","weekday"
"1317",2018-02-19,"Kebler","3","3","3",6.8,0.1,29,-2,24,23.4,-1,0,4,-2,-3,-3,1,-1,"w1718","Non.motorized",0,"Mon","weekday"
"1318",2018-02-19,"Kebler","3","3","3",6.8,0.1,29,-2,24,23.4,-1,0,4,-2,-3,-3,1,-1,"w1718","Mechanized",0,"Mon","weekday"
"1319",2018-02-19,"Kebler","3","3","3",6.8,0.1,29,-2,24,23.4,-1,0,4,-2,-3,-3,1,-1,"w1718","Motorized",49,"Mon","weekday"
"1320",2018-02-19,"Kebler","3","3","3",6.8,0.1,29,-2,24,23.4,-1,0,4,-2,-3,-3,1,-1,"w1718","Hybrid",2,"Mon","weekday"
"1321",2018-02-20,"Kebler","3","3","3",6.8,0,31,2,8,21.9,-2,-1,0,4,0,-1,-1,3,"w1718","Non.motorized",8,"Tue","weekday"
"1322",2018-02-20,"Kebler","3","3","3",6.8,0,31,2,8,21.9,-2,-1,0,4,0,-1,-1,3,"w1718","Mechanized",0,"Tue","weekday"
"1323",2018-02-20,"Kebler","3","3","3",6.8,0,31,2,8,21.9,-2,-1,0,4,0,-1,-1,3,"w1718","Motorized",35,"Tue","weekday"
"1324",2018-02-20,"Kebler","3","3","3",6.8,0,31,2,8,21.9,-2,-1,0,4,0,-1,-1,3,"w1718","Hybrid",1,"Tue","weekday"
"1325",2018-02-21,"Kebler","3","3","3",6.8,0,31,0,11,21.9,2,-2,-1,0,2,0,-1,-1,"w1718","Non.motorized",18,"Wed","weekday"
"1326",2018-02-21,"Kebler","3","3","3",6.8,0,31,0,11,21.9,2,-2,-1,0,2,0,-1,-1,"w1718","Mechanized",0,"Wed","weekday"
"1327",2018-02-21,"Kebler","3","3","3",6.8,0,31,0,11,21.9,2,-2,-1,0,2,0,-1,-1,"w1718","Motorized",63,"Wed","weekday"
"1328",2018-02-21,"Kebler","3","3","3",6.8,0,31,0,11,21.9,2,-2,-1,0,2,0,-1,-1,"w1718","Hybrid",3,"Wed","weekday"
"1329",2018-02-22,"Kebler","3","3","2",6.8,0,30,-1,16,22.7,0,2,-2,-1,-1,1,-1,-2,"w1718","Non.motorized",1,"Thu","weekday"
"1330",2018-02-22,"Kebler","3","3","2",6.8,0,30,-1,16,22.7,0,2,-2,-1,-1,1,-1,-2,"w1718","Mechanized",0,"Thu","weekday"
"1331",2018-02-22,"Kebler","3","3","2",6.8,0,30,-1,16,22.7,0,2,-2,-1,-1,1,-1,-2,"w1718","Motorized",49,"Thu","weekday"
"1332",2018-02-22,"Kebler","3","3","2",6.8,0,30,-1,16,22.7,0,2,-2,-1,-1,1,-1,-2,"w1718","Hybrid",0,"Thu","weekday"
"1333",2018-02-23,"Kebler","3","3","2",6.9,0.1,30,0,15,23,-1,0,2,-2,-1,-1,1,-1,"w1718","Non.motorized",16,"Fri","weekday"
"1334",2018-02-23,"Kebler","3","3","2",6.9,0.1,30,0,15,23,-1,0,2,-2,-1,-1,1,-1,"w1718","Mechanized",0,"Fri","weekday"
"1335",2018-02-23,"Kebler","3","3","2",6.9,0.1,30,0,15,23,-1,0,2,-2,-1,-1,1,-1,"w1718","Motorized",66,"Fri","weekday"
"1336",2018-02-23,"Kebler","3","3","2",6.9,0.1,30,0,15,23,-1,0,2,-2,-1,-1,1,-1,"w1718","Hybrid",2,"Fri","weekday"
"1337",2018-02-24,"Kebler","3","3","2",6.9,0,31,1,10,22.3,0,-1,0,2,1,0,0,2,"w1718","Non.motorized",7,"Sat","weekend"
"1338",2018-02-24,"Kebler","3","3","2",6.9,0,31,1,10,22.3,0,-1,0,2,1,0,0,2,"w1718","Mechanized",0,"Sat","weekend"
"1339",2018-02-24,"Kebler","3","3","2",6.9,0,31,1,10,22.3,0,-1,0,2,1,0,0,2,"w1718","Motorized",86,"Sat","weekend"
"1340",2018-02-24,"Kebler","3","3","2",6.9,0,31,1,10,22.3,0,-1,0,2,1,0,0,2,"w1718","Hybrid",5,"Sat","weekend"
"1341",2018-02-25,"Kebler","3","3","2",7.1,0.2,32,1,11,22.2,1,0,-1,0,2,2,1,1,"w1718","Non.motorized",9,"Sun","weekend"
"1342",2018-02-25,"Kebler","3","3","2",7.1,0.2,32,1,11,22.2,1,0,-1,0,2,2,1,1,"w1718","Mechanized",0,"Sun","weekend"
"1343",2018-02-25,"Kebler","3","3","2",7.1,0.2,32,1,11,22.2,1,0,-1,0,2,2,1,1,"w1718","Motorized",57,"Sun","weekend"
"1344",2018-02-25,"Kebler","3","3","2",7.1,0.2,32,1,11,22.2,1,0,-1,0,2,2,1,1,"w1718","Hybrid",7,"Sun","weekend"
"1345",2018-02-26,"Kebler","2","2","2",7.1,0,32,0,20,22.2,1,1,0,-1,1,2,2,1,"w1718","Non.motorized",23,"Mon","weekday"
"1346",2018-02-26,"Kebler","2","2","2",7.1,0,32,0,20,22.2,1,1,0,-1,1,2,2,1,"w1718","Mechanized",0,"Mon","weekday"
"1347",2018-02-26,"Kebler","2","2","2",7.1,0,32,0,20,22.2,1,1,0,-1,1,2,2,1,"w1718","Motorized",103,"Mon","weekday"
"1348",2018-02-26,"Kebler","2","2","2",7.1,0,32,0,20,22.2,1,1,0,-1,1,2,2,1,"w1718","Hybrid",5,"Mon","weekday"
"1349",2018-02-27,"Kebler","2","2","2",7.2,0.1,32,0,26,22.5,0,1,1,0,0,1,2,2,"w1718","Non.motorized",3,"Tue","weekday"
"1350",2018-02-27,"Kebler","2","2","2",7.2,0.1,32,0,26,22.5,0,1,1,0,0,1,2,2,"w1718","Mechanized",0,"Tue","weekday"
"1351",2018-02-27,"Kebler","2","2","2",7.2,0.1,32,0,26,22.5,0,1,1,0,0,1,2,2,"w1718","Motorized",76,"Tue","weekday"
"1352",2018-02-27,"Kebler","2","2","2",7.2,0.1,32,0,26,22.5,0,1,1,0,0,1,2,2,"w1718","Hybrid",2,"Tue","weekday"
"1353",2018-02-28,"Kebler","2","2","2",7.2,0,31,-1,23,23.2,0,0,1,1,-1,-1,0,1,"w1718","Non.motorized",6,"Wed","weekday"
"1354",2018-02-28,"Kebler","2","2","2",7.2,0,31,-1,23,23.2,0,0,1,1,-1,-1,0,1,"w1718","Mechanized",0,"Wed","weekday"
"1355",2018-02-28,"Kebler","2","2","2",7.2,0,31,-1,23,23.2,0,0,1,1,-1,-1,0,1,"w1718","Motorized",81,"Wed","weekday"
"1356",2018-02-28,"Kebler","2","2","2",7.2,0,31,-1,23,23.2,0,0,1,1,-1,-1,0,1,"w1718","Hybrid",2,"Wed","weekday"
"1357",2018-03-01,"Kebler","2","2","2",7.2,0,31,0,24,23.2,-1,0,0,1,-1,-1,-1,0,"w1718","Non.motorized",1,"Thu","weekday"
"1358",2018-03-01,"Kebler","2","2","2",7.2,0,31,0,24,23.2,-1,0,0,1,-1,-1,-1,0,"w1718","Mechanized",0,"Thu","weekday"
"1359",2018-03-01,"Kebler","2","2","2",7.2,0,31,0,24,23.2,-1,0,0,1,-1,-1,-1,0,"w1718","Motorized",29,"Thu","weekday"
"1360",2018-03-01,"Kebler","2","2","2",7.2,0,31,0,24,23.2,-1,0,0,1,-1,-1,-1,0,"w1718","Hybrid",0,"Thu","weekday"
"1361",2018-03-02,"Kebler","2","2","1",7.2,0,31,0,30,23.2,0,-1,0,0,0,-1,-1,-1,"w1718","Non.motorized",0,"Fri","weekday"
"1362",2018-03-02,"Kebler","2","2","1",7.2,0,31,0,30,23.2,0,-1,0,0,0,-1,-1,-1,"w1718","Mechanized",0,"Fri","weekday"
"1363",2018-03-02,"Kebler","2","2","1",7.2,0,31,0,30,23.2,0,-1,0,0,0,-1,-1,-1,"w1718","Motorized",62,"Fri","weekday"
"1364",2018-03-02,"Kebler","2","2","1",7.2,0,31,0,30,23.2,0,-1,0,0,0,-1,-1,-1,"w1718","Hybrid",5,"Fri","weekday"
"1365",2018-03-03,"Kebler","2","2","1",7.3,0.1,30,-1,34,24.3,0,0,-1,0,-1,-1,-2,-2,"w1718","Non.motorized",12,"Sat","weekend"
"1366",2018-03-03,"Kebler","2","2","1",7.3,0.1,30,-1,34,24.3,0,0,-1,0,-1,-1,-2,-2,"w1718","Mechanized",0,"Sat","weekend"
"1367",2018-03-03,"Kebler","2","2","1",7.3,0.1,30,-1,34,24.3,0,0,-1,0,-1,-1,-2,-2,"w1718","Motorized",102,"Sat","weekend"
"1368",2018-03-03,"Kebler","2","2","1",7.3,0.1,30,-1,34,24.3,0,0,-1,0,-1,-1,-2,-2,"w1718","Hybrid",23,"Sat","weekend"
"1369",2018-03-04,"Kebler","2","2","1",7.3,0,29,-1,24,25.2,-1,0,0,-1,-2,-2,-2,-3,"w1718","Non.motorized",0,"Sun","weekend"
"1370",2018-03-04,"Kebler","2","2","1",7.3,0,29,-1,24,25.2,-1,0,0,-1,-2,-2,-2,-3,"w1718","Mechanized",1,"Sun","weekend"
"1371",2018-03-04,"Kebler","2","2","1",7.3,0,29,-1,24,25.2,-1,0,0,-1,-2,-2,-2,-3,"w1718","Motorized",55,"Sun","weekend"
"1372",2018-03-04,"Kebler","2","2","1",7.3,0,29,-1,24,25.2,-1,0,0,-1,-2,-2,-2,-3,"w1718","Hybrid",9,"Sun","weekend"
"1373",2018-03-05,"Kebler","2","2","1",7.3,0,31,2,13,23.5,-1,-1,0,0,1,0,0,0,"w1718","Non.motorized",5,"Mon","weekday"
"1374",2018-03-05,"Kebler","2","2","1",7.3,0,31,2,13,23.5,-1,-1,0,0,1,0,0,0,"w1718","Mechanized",0,"Mon","weekday"
"1375",2018-03-05,"Kebler","2","2","1",7.3,0,31,2,13,23.5,-1,-1,0,0,1,0,0,0,"w1718","Motorized",60,"Mon","weekday"
"1376",2018-03-05,"Kebler","2","2","1",7.3,0,31,2,13,23.5,-1,-1,0,0,1,0,0,0,"w1718","Hybrid",3,"Mon","weekday"
"1377",2018-03-06,"Kebler","2","2","1",7.3,0,31,0,19,23.5,2,-1,-1,0,2,1,0,0,"w1718","Non.motorized",0,"Tue","weekday"
"1378",2018-03-06,"Kebler","2","2","1",7.3,0,31,0,19,23.5,2,-1,-1,0,2,1,0,0,"w1718","Mechanized",0,"Tue","weekday"
"1379",2018-03-06,"Kebler","2","2","1",7.3,0,31,0,19,23.5,2,-1,-1,0,2,1,0,0,"w1718","Motorized",68,"Tue","weekday"
"1380",2018-03-06,"Kebler","2","2","1",7.3,0,31,0,19,23.5,2,-1,-1,0,2,1,0,0,"w1718","Hybrid",6,"Tue","weekday"
"1381",2018-03-07,"Kebler","2","2","1",7.4,0.1,31,0,27,23.9,0,2,-1,-1,0,2,1,0,"w1718","Non.motorized",6,"Wed","weekday"
"1382",2018-03-07,"Kebler","2","2","1",7.4,0.1,31,0,27,23.9,0,2,-1,-1,0,2,1,0,"w1718","Mechanized",0,"Wed","weekday"
"1383",2018-03-07,"Kebler","2","2","1",7.4,0.1,31,0,27,23.9,0,2,-1,-1,0,2,1,0,"w1718","Motorized",43,"Wed","weekday"
"1384",2018-03-07,"Kebler","2","2","1",7.4,0.1,31,0,27,23.9,0,2,-1,-1,0,2,1,0,"w1718","Hybrid",4,"Wed","weekday"
"1385",2018-03-08,"Kebler","2","2","1",7.4,0,30,-1,33,24.7,0,0,2,-1,-1,-1,1,0,"w1718","Non.motorized",0,"Thu","weekday"
"1386",2018-03-08,"Kebler","2","2","1",7.4,0,30,-1,33,24.7,0,0,2,-1,-1,-1,1,0,"w1718","Mechanized",0,"Thu","weekday"
"1387",2018-03-08,"Kebler","2","2","1",7.4,0,30,-1,33,24.7,0,0,2,-1,-1,-1,1,0,"w1718","Motorized",77,"Thu","weekday"
"1388",2018-03-08,"Kebler","2","2","1",7.4,0,30,-1,33,24.7,0,0,2,-1,-1,-1,1,0,"w1718","Hybrid",8,"Thu","weekday"
"1389",2018-03-09,"Kebler","2","2","1",7.4,0,30,0,34,24.7,-1,0,0,2,-1,-1,-1,1,"w1718","Non.motorized",6,"Fri","weekday"
"1390",2018-03-09,"Kebler","2","2","1",7.4,0,30,0,34,24.7,-1,0,0,2,-1,-1,-1,1,"w1718","Mechanized",0,"Fri","weekday"
"1391",2018-03-09,"Kebler","2","2","1",7.4,0,30,0,34,24.7,-1,0,0,2,-1,-1,-1,1,"w1718","Motorized",105,"Fri","weekday"
"1392",2018-03-09,"Kebler","2","2","1",7.4,0,30,0,34,24.7,-1,0,0,2,-1,-1,-1,1,"w1718","Hybrid",0,"Fri","weekday"
"1393",2018-03-10,"Kebler","1","1","1",7.4,0,30,0,31,24.7,0,-1,0,0,0,-1,-1,-1,"w1718","Non.motorized",8,"Sat","weekend"
"1394",2018-03-10,"Kebler","1","1","1",7.4,0,30,0,31,24.7,0,-1,0,0,0,-1,-1,-1,"w1718","Mechanized",0,"Sat","weekend"
"1395",2018-03-10,"Kebler","1","1","1",7.4,0,30,0,31,24.7,0,-1,0,0,0,-1,-1,-1,"w1718","Motorized",138,"Sat","weekend"
"1396",2018-03-10,"Kebler","1","1","1",7.4,0,30,0,31,24.7,0,-1,0,0,0,-1,-1,-1,"w1718","Hybrid",11,"Sat","weekend"
"1397",2018-03-11,"Kebler","1","1","1",7.4,0,29,-1,31,25.5,0,0,-1,0,-1,-1,-2,-2,"w1718","Non.motorized",16,"Sun","weekend"
"1398",2018-03-11,"Kebler","1","1","1",7.4,0,29,-1,31,25.5,0,0,-1,0,-1,-1,-2,-2,"w1718","Mechanized",0,"Sun","weekend"
"1399",2018-03-11,"Kebler","1","1","1",7.4,0,29,-1,31,25.5,0,0,-1,0,-1,-1,-2,-2,"w1718","Motorized",170,"Sun","weekend"
"1400",2018-03-11,"Kebler","1","1","1",7.4,0,29,-1,31,25.5,0,0,-1,0,-1,-1,-2,-2,"w1718","Hybrid",14,"Sun","weekend"
"1401",2018-03-12,"Kebler","1","1","1",7.4,0,29,0,33,25.5,-1,0,0,-1,-1,-1,-1,-2,"w1718","Non.motorized",2,"Mon","weekday"
"1402",2018-03-12,"Kebler","1","1","1",7.4,0,29,0,33,25.5,-1,0,0,-1,-1,-1,-1,-2,"w1718","Mechanized",0,"Mon","weekday"
"1403",2018-03-12,"Kebler","1","1","1",7.4,0,29,0,33,25.5,-1,0,0,-1,-1,-1,-1,-2,"w1718","Motorized",99,"Mon","weekday"
"1404",2018-03-12,"Kebler","1","1","1",7.4,0,29,0,33,25.5,-1,0,0,-1,-1,-1,-1,-2,"w1718","Hybrid",0,"Mon","weekday"
"1405",2018-03-13,"Kebler","1","1","1",7.4,0,29,0,34,25.5,0,-1,0,0,0,-1,-1,-1,"w1718","Non.motorized",7,"Tue","weekday"
"1406",2018-03-13,"Kebler","1","1","1",7.4,0,29,0,34,25.5,0,-1,0,0,0,-1,-1,-1,"w1718","Mechanized",2,"Tue","weekday"
"1407",2018-03-13,"Kebler","1","1","1",7.4,0,29,0,34,25.5,0,-1,0,0,0,-1,-1,-1,"w1718","Motorized",163,"Tue","weekday"
"1408",2018-03-13,"Kebler","1","1","1",7.4,0,29,0,34,25.5,0,-1,0,0,0,-1,-1,-1,"w1718","Hybrid",3,"Tue","weekday"
"1409",2018-03-14,"Kebler","1","2","2",7.4,0,29,0,39,25.5,0,0,-1,0,0,0,-1,-1,"w1718","Non.motorized",10,"Wed","weekday"
"1410",2018-03-14,"Kebler","1","2","2",7.4,0,29,0,39,25.5,0,0,-1,0,0,0,-1,-1,"w1718","Mechanized",0,"Wed","weekday"
"1411",2018-03-14,"Kebler","1","2","2",7.4,0,29,0,39,25.5,0,0,-1,0,0,0,-1,-1,"w1718","Motorized",137,"Wed","weekday"
"1412",2018-03-14,"Kebler","1","2","2",7.4,0,29,0,39,25.5,0,0,-1,0,0,0,-1,-1,"w1718","Hybrid",6,"Wed","weekday"
"1413",2018-03-15,"Kebler","2","2","2",7.5,0.1,28,-1,31,26.8,0,0,0,-1,-1,-1,-1,-2,"w1718","Non.motorized",3,"Thu","weekday"
"1414",2018-03-15,"Kebler","2","2","2",7.5,0.1,28,-1,31,26.8,0,0,0,-1,-1,-1,-1,-2,"w1718","Mechanized",0,"Thu","weekday"
"1415",2018-03-15,"Kebler","2","2","2",7.5,0.1,28,-1,31,26.8,0,0,0,-1,-1,-1,-1,-2,"w1718","Motorized",157,"Thu","weekday"
"1416",2018-03-15,"Kebler","2","2","2",7.5,0.1,28,-1,31,26.8,0,0,0,-1,-1,-1,-1,-2,"w1718","Hybrid",3,"Thu","weekday"
"1417",2018-03-16,"Kebler","2","2","2",7.7,0.2,29,1,25,26.6,-1,0,0,0,0,0,0,0,"w1718","Non.motorized",10,"Fri","weekday"
"1418",2018-03-16,"Kebler","2","2","2",7.7,0.2,29,1,25,26.6,-1,0,0,0,0,0,0,0,"w1718","Mechanized",0,"Fri","weekday"
"1419",2018-03-16,"Kebler","2","2","2",7.7,0.2,29,1,25,26.6,-1,0,0,0,0,0,0,0,"w1718","Motorized",99,"Fri","weekday"
"1420",2018-03-16,"Kebler","2","2","2",7.7,0.2,29,1,25,26.6,-1,0,0,0,0,0,0,0,"w1718","Hybrid",12,"Fri","weekday"
"1421",2018-03-17,"Kebler","2","2","2",7.8,0.1,32,3,29,24.4,1,-1,0,0,4,3,3,3,"w1718","Non.motorized",3,"Sat","weekend"
"1422",2018-03-17,"Kebler","2","2","2",7.8,0.1,32,3,29,24.4,1,-1,0,0,4,3,3,3,"w1718","Mechanized",1,"Sat","weekend"
"1423",2018-03-17,"Kebler","2","2","2",7.8,0.1,32,3,29,24.4,1,-1,0,0,4,3,3,3,"w1718","Motorized",130,"Sat","weekend"
"1424",2018-03-17,"Kebler","2","2","2",7.8,0.1,32,3,29,24.4,1,-1,0,0,4,3,3,3,"w1718","Hybrid",17,"Sat","weekend"
"1425",2018-03-18,"Kebler","2","2","2",7.9,0.1,31,-1,24,25.5,3,1,-1,0,2,3,2,2,"w1718","Non.motorized",4,"Sun","weekend"
"1426",2018-03-18,"Kebler","2","2","2",7.9,0.1,31,-1,24,25.5,3,1,-1,0,2,3,2,2,"w1718","Mechanized",0,"Sun","weekend"
"1427",2018-03-18,"Kebler","2","2","2",7.9,0.1,31,-1,24,25.5,3,1,-1,0,2,3,2,2,"w1718","Motorized",92,"Sun","weekend"
"1428",2018-03-18,"Kebler","2","2","2",7.9,0.1,31,-1,24,25.5,3,1,-1,0,2,3,2,2,"w1718","Hybrid",14,"Sun","weekend"
"1429",2018-03-19,"Kebler","2","2","1",8,0.1,32,1,19,25,-1,3,1,-1,0,3,4,3,"w1718","Non.motorized",2,"Mon","weekday"
"1430",2018-03-19,"Kebler","2","2","1",8,0.1,32,1,19,25,-1,3,1,-1,0,3,4,3,"w1718","Mechanized",0,"Mon","weekday"
"1431",2018-03-19,"Kebler","2","2","1",8,0.1,32,1,19,25,-1,3,1,-1,0,3,4,3,"w1718","Motorized",61,"Mon","weekday"
"1432",2018-03-19,"Kebler","2","2","1",8,0.1,32,1,19,25,-1,3,1,-1,0,3,4,3,"w1718","Hybrid",7,"Mon","weekday"
"1433",2018-03-20,"Kebler","2","2","1",8,0,30,-2,24,26.7,1,-1,3,1,-1,-2,1,2,"w1718","Non.motorized",3,"Tue","weekday"
"1434",2018-03-20,"Kebler","2","2","1",8,0,30,-2,24,26.7,1,-1,3,1,-1,-2,1,2,"w1718","Mechanized",0,"Tue","weekday"
"1435",2018-03-20,"Kebler","2","2","1",8,0,30,-2,24,26.7,1,-1,3,1,-1,-2,1,2,"w1718","Motorized",87,"Tue","weekday"
"1436",2018-03-20,"Kebler","2","2","1",8,0,30,-2,24,26.7,1,-1,3,1,-1,-2,1,2,"w1718","Hybrid",7,"Tue","weekday"
"1437",2018-03-21,"Kebler","1","1","1",8.1,0.1,32,2,30,25.3,-2,1,-1,3,0,1,0,3,"w1718","Non.motorized",0,"Wed","weekday"
"1438",2018-03-21,"Kebler","1","1","1",8.1,0.1,32,2,30,25.3,-2,1,-1,3,0,1,0,3,"w1718","Mechanized",0,"Wed","weekday"
"1439",2018-03-21,"Kebler","1","1","1",8.1,0.1,32,2,30,25.3,-2,1,-1,3,0,1,0,3,"w1718","Motorized",86,"Wed","weekday"
"1440",2018-03-21,"Kebler","1","1","1",8.1,0.1,32,2,30,25.3,-2,1,-1,3,0,1,0,3,"w1718","Hybrid",7,"Wed","weekday"
"1441",2018-03-22,"Kebler","1","1","1",8.1,0,30,-2,36,27,2,-2,1,-1,0,-2,-1,-2,"w1718","Non.motorized",3,"Thu","weekday"
"1442",2018-03-22,"Kebler","1","1","1",8.1,0,30,-2,36,27,2,-2,1,-1,0,-2,-1,-2,"w1718","Mechanized",0,"Thu","weekday"
"1443",2018-03-22,"Kebler","1","1","1",8.1,0,30,-2,36,27,2,-2,1,-1,0,-2,-1,-2,"w1718","Motorized",67,"Thu","weekday"
"1444",2018-03-22,"Kebler","1","1","1",8.1,0,30,-2,36,27,2,-2,1,-1,0,-2,-1,-2,"w1718","Hybrid",4,"Thu","weekday"
"1445",2018-03-23,"Kebler","2","2","3",8.2,0.1,29,-1,34,28.3,-2,2,-2,1,-3,-1,-3,-2,"w1718","Non.motorized",1,"Fri","weekday"
"1446",2018-03-23,"Kebler","2","2","3",8.2,0.1,29,-1,34,28.3,-2,2,-2,1,-3,-1,-3,-2,"w1718","Mechanized",0,"Fri","weekday"
"1447",2018-03-23,"Kebler","2","2","3",8.2,0.1,29,-1,34,28.3,-2,2,-2,1,-3,-1,-3,-2,"w1718","Motorized",30,"Fri","weekday"
"1448",2018-03-23,"Kebler","2","2","3",8.2,0.1,29,-1,34,28.3,-2,2,-2,1,-3,-1,-3,-2,"w1718","Hybrid",1,"Fri","weekday"
"1449",2018-03-24,"Kebler","2","2","1",8.9,0.7,34,5,32,26.2,-1,-2,2,-2,4,2,4,2,"w1718","Non.motorized",5,"Sat","weekend"
"1450",2018-03-24,"Kebler","2","2","1",8.9,0.7,34,5,32,26.2,-1,-2,2,-2,4,2,4,2,"w1718","Mechanized",0,"Sat","weekend"
"1451",2018-03-24,"Kebler","2","2","1",8.9,0.7,34,5,32,26.2,-1,-2,2,-2,4,2,4,2,"w1718","Motorized",74,"Sat","weekend"
"1452",2018-03-24,"Kebler","2","2","1",8.9,0.7,34,5,32,26.2,-1,-2,2,-2,4,2,4,2,"w1718","Hybrid",4,"Sat","weekend"
"1453",2018-03-25,"Kebler","2","2","1",8.9,0,35,1,35,25.4,5,-1,-2,2,6,5,3,5,"w1718","Non.motorized",5,"Sun","weekend"
"1454",2018-03-25,"Kebler","2","2","1",8.9,0,35,1,35,25.4,5,-1,-2,2,6,5,3,5,"w1718","Mechanized",0,"Sun","weekend"
"1455",2018-03-25,"Kebler","2","2","1",8.9,0,35,1,35,25.4,5,-1,-2,2,6,5,3,5,"w1718","Motorized",90,"Sun","weekend"
"1456",2018-03-25,"Kebler","2","2","1",8.9,0,35,1,35,25.4,5,-1,-2,2,6,5,3,5,"w1718","Hybrid",11,"Sun","weekend"
"1457",2018-03-26,"Kebler","1","1","1",8.9,0,34,-1,31,26.2,1,5,-1,-2,0,5,4,2,"w1718","Non.motorized",12,"Mon","weekday"
"1458",2018-03-26,"Kebler","1","1","1",8.9,0,34,-1,31,26.2,1,5,-1,-2,0,5,4,2,"w1718","Mechanized",0,"Mon","weekday"
"1459",2018-03-26,"Kebler","1","1","1",8.9,0,34,-1,31,26.2,1,5,-1,-2,0,5,4,2,"w1718","Motorized",76,"Mon","weekday"
"1460",2018-03-26,"Kebler","1","1","1",8.9,0,34,-1,31,26.2,1,5,-1,-2,0,5,4,2,"w1718","Hybrid",9,"Mon","weekday"
"1461",2018-03-26,"Kebler","2","1","1",8.9,0,34,-1,31,26.2,1,5,-1,-2,0,5,4,2,"w1718","Non.motorized",12,"Mon","weekday"
"1462",2018-03-26,"Kebler","2","1","1",8.9,0,34,-1,31,26.2,1,5,-1,-2,0,5,4,2,"w1718","Mechanized",0,"Mon","weekday"
"1463",2018-03-26,"Kebler","2","1","1",8.9,0,34,-1,31,26.2,1,5,-1,-2,0,5,4,2,"w1718","Motorized",76,"Mon","weekday"
"1464",2018-03-26,"Kebler","2","1","1",8.9,0,34,-1,31,26.2,1,5,-1,-2,0,5,4,2,"w1718","Hybrid",9,"Mon","weekday"
"1465",2018-03-27,"Kebler","1","1","1",8.9,0,33,-1,29,27,-1,1,5,-1,-2,-1,4,3,"w1718","Non.motorized",4,"Tue","weekday"
"1466",2018-03-27,"Kebler","1","1","1",8.9,0,33,-1,29,27,-1,1,5,-1,-2,-1,4,3,"w1718","Mechanized",1,"Tue","weekday"
"1467",2018-03-27,"Kebler","1","1","1",8.9,0,33,-1,29,27,-1,1,5,-1,-2,-1,4,3,"w1718","Motorized",54,"Tue","weekday"
"1468",2018-03-27,"Kebler","1","1","1",8.9,0,33,-1,29,27,-1,1,5,-1,-2,-1,4,3,"w1718","Hybrid",8,"Tue","weekday"
"1469",2018-03-28,"Kebler","1","1","1",8.9,0,33,0,27,27,-1,-1,1,5,-1,-2,-1,4,"w1718","Non.motorized",2,"Wed","weekday"
"1470",2018-03-28,"Kebler","1","1","1",8.9,0,33,0,27,27,-1,-1,1,5,-1,-2,-1,4,"w1718","Mechanized",0,"Wed","weekday"
"1471",2018-03-28,"Kebler","1","1","1",8.9,0,33,0,27,27,-1,-1,1,5,-1,-2,-1,4,"w1718","Motorized",58,"Wed","weekday"
"1472",2018-03-28,"Kebler","1","1","1",8.9,0,33,0,27,27,-1,-1,1,5,-1,-2,-1,4,"w1718","Hybrid",4,"Wed","weekday"
"1473",2018-03-29,"Kebler","1","1","1",8.9,0,33,0,27,27,0,-1,-1,1,0,-1,-2,-1,"w1718","Non.motorized",1,"Thu","weekday"
"1474",2018-03-29,"Kebler","1","1","1",8.9,0,33,0,27,27,0,-1,-1,1,0,-1,-2,-1,"w1718","Mechanized",4,"Thu","weekday"
"1475",2018-03-29,"Kebler","1","1","1",8.9,0,33,0,27,27,0,-1,-1,1,0,-1,-2,-1,"w1718","Motorized",69,"Thu","weekday"
"1476",2018-03-29,"Kebler","1","1","1",8.9,0,33,0,27,27,0,-1,-1,1,0,-1,-2,-1,"w1718","Hybrid",10,"Thu","weekday"
"1477",2018-03-30,"Kebler","1","1","1",8.9,0,32,-1,33,27.8,0,0,-1,-1,-1,-1,-2,-3,"w1718","Non.motorized",12,"Fri","weekday"
"1478",2018-03-30,"Kebler","1","1","1",8.9,0,32,-1,33,27.8,0,0,-1,-1,-1,-1,-2,-3,"w1718","Mechanized",0,"Fri","weekday"
"1479",2018-03-30,"Kebler","1","1","1",8.9,0,32,-1,33,27.8,0,0,-1,-1,-1,-1,-2,-3,"w1718","Motorized",83,"Fri","weekday"
"1480",2018-03-30,"Kebler","1","1","1",8.9,0,32,-1,33,27.8,0,0,-1,-1,-1,-1,-2,-3,"w1718","Hybrid",14,"Fri","weekday"
"1481",2018-03-31,"Kebler","1","1","1",8.9,0,32,0,39,27.8,-1,0,0,-1,-1,-1,-1,-2,"w1718","Non.motorized",4,"Sat","weekend"
"1482",2018-03-31,"Kebler","1","1","1",8.9,0,32,0,39,27.8,-1,0,0,-1,-1,-1,-1,-2,"w1718","Mechanized",0,"Sat","weekend"
"1483",2018-03-31,"Kebler","1","1","1",8.9,0,32,0,39,27.8,-1,0,0,-1,-1,-1,-1,-2,"w1718","Motorized",78,"Sat","weekend"
"1484",2018-03-31,"Kebler","1","1","1",8.9,0,32,0,39,27.8,-1,0,0,-1,-1,-1,-1,-2,"w1718","Hybrid",14,"Sat","weekend"
"1485",2018-04-01,"Kebler","1","1","1",8.8,-0.1,30,-2,41,29.3,0,-1,0,0,-2,-3,-3,-3,"w1718","Non.motorized",4,"Sun","weekend"
"1486",2018-04-01,"Kebler","1","1","1",8.8,-0.1,30,-2,41,29.3,0,-1,0,0,-2,-3,-3,-3,"w1718","Mechanized",0,"Sun","weekend"
"1487",2018-04-01,"Kebler","1","1","1",8.8,-0.1,30,-2,41,29.3,0,-1,0,0,-2,-3,-3,-3,"w1718","Motorized",37,"Sun","weekend"
"1488",2018-04-01,"Kebler","1","1","1",8.8,-0.1,30,-2,41,29.3,0,-1,0,0,-2,-3,-3,-3,"w1718","Hybrid",4,"Sun","weekend"
"1489",2018-04-02,"Kebler","1","1","1",8.7,-0.1,29,-1,39,30,-2,0,-1,0,-3,-3,-4,-4,"w1718","Non.motorized",2,"Mon","weekday"
"1490",2018-04-02,"Kebler","1","1","1",8.7,-0.1,29,-1,39,30,-2,0,-1,0,-3,-3,-4,-4,"w1718","Mechanized",0,"Mon","weekday"
"1491",2018-04-02,"Kebler","1","1","1",8.7,-0.1,29,-1,39,30,-2,0,-1,0,-3,-3,-4,-4,"w1718","Motorized",47,"Mon","weekday"
"1492",2018-04-02,"Kebler","1","1","1",8.7,-0.1,29,-1,39,30,-2,0,-1,0,-3,-3,-4,-4,"w1718","Hybrid",7,"Mon","weekday"
"1493",2018-04-03,"Kebler","1","1","1",8.8,0.1,30,1,27,29.3,-1,-2,0,-1,0,-2,-2,-3,"w1718","Non.motorized",0,"Tue","weekday"
"1494",2018-04-03,"Kebler","1","1","1",8.8,0.1,30,1,27,29.3,-1,-2,0,-1,0,-2,-2,-3,"w1718","Mechanized",0,"Tue","weekday"
"1495",2018-04-03,"Kebler","1","1","1",8.8,0.1,30,1,27,29.3,-1,-2,0,-1,0,-2,-2,-3,"w1718","Motorized",54,"Tue","weekday"
"1496",2018-04-03,"Kebler","1","1","1",8.8,0.1,30,1,27,29.3,-1,-2,0,-1,0,-2,-2,-3,"w1718","Hybrid",4,"Tue","weekday"
"1497",2018-04-04,"Kebler","1","2","2",8.9,0.1,28,-2,33,31.8,1,-1,-2,0,-1,-2,-4,-4,"w1718","Non.motorized",6,"Wed","weekday"
"1498",2018-04-04,"Kebler","1","2","2",8.9,0.1,28,-2,33,31.8,1,-1,-2,0,-1,-2,-4,-4,"w1718","Mechanized",0,"Wed","weekday"
"1499",2018-04-04,"Kebler","1","2","2",8.9,0.1,28,-2,33,31.8,1,-1,-2,0,-1,-2,-4,-4,"w1718","Motorized",65,"Wed","weekday"
"1500",2018-04-04,"Kebler","1","2","2",8.9,0.1,28,-2,33,31.8,1,-1,-2,0,-1,-2,-4,-4,"w1718","Hybrid",5,"Wed","weekday"
"1501",2018-04-05,"Kebler","1","2","2",8.9,0,27,-1,35,33,-2,1,-1,-2,-3,-2,-3,-5,"w1718","Non.motorized",3,"Thu","weekday"
"1502",2018-04-05,"Kebler","1","2","2",8.9,0,27,-1,35,33,-2,1,-1,-2,-3,-2,-3,-5,"w1718","Mechanized",1,"Thu","weekday"
"1503",2018-04-05,"Kebler","1","2","2",8.9,0,27,-1,35,33,-2,1,-1,-2,-3,-2,-3,-5,"w1718","Motorized",57,"Thu","weekday"
"1504",2018-04-05,"Kebler","1","2","2",8.9,0,27,-1,35,33,-2,1,-1,-2,-3,-2,-3,-5,"w1718","Hybrid",4,"Thu","weekday"
"1505",2018-04-06,"Kebler","1","2","2",8.9,0,25,-2,35,35.6,-1,-2,1,-1,-3,-5,-4,-5,"w1718","Non.motorized",0,"Fri","weekday"
"1506",2018-04-06,"Kebler","1","2","2",8.9,0,25,-2,35,35.6,-1,-2,1,-1,-3,-5,-4,-5,"w1718","Mechanized",0,"Fri","weekday"
"1507",2018-04-06,"Kebler","1","2","2",8.9,0,25,-2,35,35.6,-1,-2,1,-1,-3,-5,-4,-5,"w1718","Motorized",86,"Fri","weekday"
"1508",2018-04-06,"Kebler","1","2","2",8.9,0,25,-2,35,35.6,-1,-2,1,-1,-3,-5,-4,-5,"w1718","Hybrid",3,"Fri","weekday"
"1509",2018-04-07,"Kebler","2","2","2",9.2,0.3,31,6,37,29.7,-2,-1,-2,1,4,3,1,2,"w1718","Non.motorized",0,"Sat","weekend"
"1510",2018-04-07,"Kebler","2","2","2",9.2,0.3,31,6,37,29.7,-2,-1,-2,1,4,3,1,2,"w1718","Mechanized",0,"Sat","weekend"
"1511",2018-04-07,"Kebler","2","2","2",9.2,0.3,31,6,37,29.7,-2,-1,-2,1,4,3,1,2,"w1718","Motorized",50,"Sat","weekend"
"1512",2018-04-07,"Kebler","2","2","2",9.2,0.3,31,6,37,29.7,-2,-1,-2,1,4,3,1,2,"w1718","Hybrid",8,"Sat","weekend"
"1513",2018-04-08,"Kebler","3","3","3",10,0.8,33,2,33,30.3,6,-2,-1,-2,8,6,5,3,"w1718","Non.motorized",0,"Sun","weekend"
"1514",2018-04-08,"Kebler","3","3","3",10,0.8,33,2,33,30.3,6,-2,-1,-2,8,6,5,3,"w1718","Mechanized",1,"Sun","weekend"
"1515",2018-04-08,"Kebler","3","3","3",10,0.8,33,2,33,30.3,6,-2,-1,-2,8,6,5,3,"w1718","Motorized",40,"Sun","weekend"
"1516",2018-04-08,"Kebler","3","3","3",10,0.8,33,2,33,30.3,6,-2,-1,-2,8,6,5,3,"w1718","Hybrid",0,"Sun","weekend"
"1517",2018-04-09,"Kebler","1","1","1",10.1,0.1,33,0,31,30.6,2,6,-2,-1,2,8,6,5,"w1718","Non.motorized",0,"Mon","weekday"
"1518",2018-04-09,"Kebler","1","1","1",10.1,0.1,33,0,31,30.6,2,6,-2,-1,2,8,6,5,"w1718","Mechanized",0,"Mon","weekday"
"1519",2018-04-09,"Kebler","1","1","1",10.1,0.1,33,0,31,30.6,2,6,-2,-1,2,8,6,5,"w1718","Motorized",11,"Mon","weekday"
"1520",2018-04-09,"Kebler","1","1","1",10.1,0.1,33,0,31,30.6,2,6,-2,-1,2,8,6,5,"w1718","Hybrid",3,"Mon","weekday"
"1521",2017-12-22,"Slate River Rd","2","2","1",2,0,11,3,17,18.2,0,0,0,0,3,3,3,3,"w1718","Non.motorized",14,"Fri","weekday"
"1522",2017-12-22,"Slate River Rd","2","2","1",2,0,11,3,17,18.2,0,0,0,0,3,3,3,3,"w1718","Mechanized",1,"Fri","weekday"
"1523",2017-12-22,"Slate River Rd","2","2","1",2,0,11,3,17,18.2,0,0,0,0,3,3,3,3,"w1718","Motorized",0,"Fri","weekday"
"1524",2017-12-22,"Slate River Rd","2","2","1",2,0,11,3,17,18.2,0,0,0,0,3,3,3,3,"w1718","Hybrid",0,"Fri","weekday"
"1525",2017-12-23,"Slate River Rd","2","1","1",2.1,0.1,10,-1,21,21,3,0,0,0,2,2,2,2,"w1718","Non.motorized",5,"Sat","weekend"
"1526",2017-12-23,"Slate River Rd","2","1","1",2.1,0.1,10,-1,21,21,3,0,0,0,2,2,2,2,"w1718","Mechanized",2,"Sat","weekend"
"1527",2017-12-23,"Slate River Rd","2","1","1",2.1,0.1,10,-1,21,21,3,0,0,0,2,2,2,2,"w1718","Motorized",4,"Sat","weekend"
"1528",2017-12-23,"Slate River Rd","2","1","1",2.1,0.1,10,-1,21,21,3,0,0,0,2,2,2,2,"w1718","Hybrid",0,"Sat","weekend"
"1529",2017-12-24,"Slate River Rd","1","1","1",2.4,0.3,14,4,19,17.1,-1,3,0,0,3,6,6,6,"w1718","Non.motorized",7,"Sun","weekend"
"1530",2017-12-24,"Slate River Rd","1","1","1",2.4,0.3,14,4,19,17.1,-1,3,0,0,3,6,6,6,"w1718","Mechanized",2,"Sun","weekend"
"1531",2017-12-24,"Slate River Rd","1","1","1",2.4,0.3,14,4,19,17.1,-1,3,0,0,3,6,6,6,"w1718","Motorized",5,"Sun","weekend"
"1532",2017-12-24,"Slate River Rd","1","1","1",2.4,0.3,14,4,19,17.1,-1,3,0,0,3,6,6,6,"w1718","Hybrid",2,"Sun","weekend"
"1533",2017-12-25,"Slate River Rd","2","1","1",2.6,0.2,14,0,25,18.6,4,-1,3,0,4,3,6,6,"w1718","Non.motorized",18,"Mon","weekday"
"1534",2017-12-25,"Slate River Rd","2","1","1",2.6,0.2,14,0,25,18.6,4,-1,3,0,4,3,6,6,"w1718","Mechanized",3,"Mon","weekday"
"1535",2017-12-25,"Slate River Rd","2","1","1",2.6,0.2,14,0,25,18.6,4,-1,3,0,4,3,6,6,"w1718","Motorized",5,"Mon","weekday"
"1536",2017-12-25,"Slate River Rd","2","1","1",2.6,0.2,14,0,25,18.6,4,-1,3,0,4,3,6,6,"w1718","Hybrid",3,"Mon","weekday"
"1537",2017-12-26,"Slate River Rd","1","1","1",3.1,0.5,20,6,25,15.5,0,4,-1,3,6,10,9,12,"w1718","Non.motorized",30,"Tue","weekday"
"1538",2017-12-26,"Slate River Rd","1","1","1",3.1,0.5,20,6,25,15.5,0,4,-1,3,6,10,9,12,"w1718","Mechanized",4,"Tue","weekday"
"1539",2017-12-26,"Slate River Rd","1","1","1",3.1,0.5,20,6,25,15.5,0,4,-1,3,6,10,9,12,"w1718","Motorized",6,"Tue","weekday"
"1540",2017-12-26,"Slate River Rd","1","1","1",3.1,0.5,20,6,25,15.5,0,4,-1,3,6,10,9,12,"w1718","Hybrid",5,"Tue","weekday"
"1541",2017-12-27,"Slate River Rd","1","1","1",3.1,0,18,-2,27,17.2,6,0,4,-1,4,4,8,7,"w1718","Non.motorized",71,"Wed","weekday"
"1542",2017-12-27,"Slate River Rd","1","1","1",3.1,0,18,-2,27,17.2,6,0,4,-1,4,4,8,7,"w1718","Mechanized",0,"Wed","weekday"
"1543",2017-12-27,"Slate River Rd","1","1","1",3.1,0,18,-2,27,17.2,6,0,4,-1,4,4,8,7,"w1718","Motorized",92,"Wed","weekday"
"1544",2017-12-27,"Slate River Rd","1","1","1",3.1,0,18,-2,27,17.2,6,0,4,-1,4,4,8,7,"w1718","Hybrid",88,"Wed","weekday"
"1545",2017-12-28,"Slate River Rd","1","1","1",3.2,0.1,17,-1,31,18.8,-2,6,0,4,-3,3,3,7,"w1718","Non.motorized",66,"Thu","weekday"
"1546",2017-12-28,"Slate River Rd","1","1","1",3.2,0.1,17,-1,31,18.8,-2,6,0,4,-3,3,3,7,"w1718","Mechanized",4,"Thu","weekday"
"1547",2017-12-28,"Slate River Rd","1","1","1",3.2,0.1,17,-1,31,18.8,-2,6,0,4,-3,3,3,7,"w1718","Motorized",4,"Thu","weekday"
"1548",2017-12-28,"Slate River Rd","1","1","1",3.2,0.1,17,-1,31,18.8,-2,6,0,4,-3,3,3,7,"w1718","Hybrid",1,"Thu","weekday"
"1549",2017-12-29,"Slate River Rd","1","1","1",3.2,0,17,0,36,18.8,-1,-2,6,0,-1,-3,3,3,"w1718","Non.motorized",50,"Fri","weekday"
"1550",2017-12-29,"Slate River Rd","1","1","1",3.2,0,17,0,36,18.8,-1,-2,6,0,-1,-3,3,3,"w1718","Mechanized",0,"Fri","weekday"
"1551",2017-12-29,"Slate River Rd","1","1","1",3.2,0,17,0,36,18.8,-1,-2,6,0,-1,-3,3,3,"w1718","Motorized",3,"Fri","weekday"
"1552",2017-12-29,"Slate River Rd","1","1","1",3.2,0,17,0,36,18.8,-1,-2,6,0,-1,-3,3,3,"w1718","Hybrid",2,"Fri","weekday"
"1553",2017-12-30,"Slate River Rd","1","1","1",3.2,0,15,-2,37,21.3,0,-1,-2,6,-2,-3,-5,1,"w1718","Non.motorized",65,"Sat","weekend"
"1554",2017-12-30,"Slate River Rd","1","1","1",3.2,0,15,-2,37,21.3,0,-1,-2,6,-2,-3,-5,1,"w1718","Mechanized",8,"Sat","weekend"
"1555",2017-12-30,"Slate River Rd","1","1","1",3.2,0,15,-2,37,21.3,0,-1,-2,6,-2,-3,-5,1,"w1718","Motorized",13,"Sat","weekend"
"1556",2017-12-30,"Slate River Rd","1","1","1",3.2,0,15,-2,37,21.3,0,-1,-2,6,-2,-3,-5,1,"w1718","Hybrid",9,"Sat","weekend"
"1557",2017-12-31,"Slate River Rd","1","1","1",3.2,0,15,0,31,21.3,-2,0,-1,-2,-2,-2,-3,-5,"w1718","Non.motorized",78,"Sun","weekend"
"1558",2017-12-31,"Slate River Rd","1","1","1",3.2,0,15,0,31,21.3,-2,0,-1,-2,-2,-2,-3,-5,"w1718","Mechanized",2,"Sun","weekend"
"1559",2017-12-31,"Slate River Rd","1","1","1",3.2,0,15,0,31,21.3,-2,0,-1,-2,-2,-2,-3,-5,"w1718","Motorized",20,"Sun","weekend"
"1560",2017-12-31,"Slate River Rd","1","1","1",3.2,0,15,0,31,21.3,-2,0,-1,-2,-2,-2,-3,-5,"w1718","Hybrid",4,"Sun","weekend"
"1561",2018-01-01,"Slate River Rd","1","1","1",3.2,0,15,0,27,21.3,0,-2,0,-1,0,-2,-2,-3,"w1718","Non.motorized",63,"Mon","weekday"
"1562",2018-01-01,"Slate River Rd","1","1","1",3.2,0,15,0,27,21.3,0,-2,0,-1,0,-2,-2,-3,"w1718","Mechanized",7,"Mon","weekday"
"1563",2018-01-01,"Slate River Rd","1","1","1",3.2,0,15,0,27,21.3,0,-2,0,-1,0,-2,-2,-3,"w1718","Motorized",26,"Mon","weekday"
"1564",2018-01-01,"Slate River Rd","1","1","1",3.2,0,15,0,27,21.3,0,-2,0,-1,0,-2,-2,-3,"w1718","Hybrid",14,"Mon","weekday"
"1565",2018-01-02,"Slate River Rd","1","1","1",3.2,0,15,0,22,21.3,0,0,-2,0,0,0,-2,-2,"w1718","Non.motorized",29,"Tue","weekday"
"1566",2018-01-02,"Slate River Rd","1","1","1",3.2,0,15,0,22,21.3,0,0,-2,0,0,0,-2,-2,"w1718","Mechanized",3,"Tue","weekday"
"1567",2018-01-02,"Slate River Rd","1","1","1",3.2,0,15,0,22,21.3,0,0,-2,0,0,0,-2,-2,"w1718","Motorized",17,"Tue","weekday"
"1568",2018-01-02,"Slate River Rd","1","1","1",3.2,0,15,0,22,21.3,0,0,-2,0,0,0,-2,-2,"w1718","Hybrid",11,"Tue","weekday"
"1569",2018-01-03,"Slate River Rd","1","1","1",3.2,0,15,0,27,21.3,0,0,0,-2,0,0,0,-2,"w1718","Non.motorized",26,"Wed","weekday"
"1570",2018-01-03,"Slate River Rd","1","1","1",3.2,0,15,0,27,21.3,0,0,0,-2,0,0,0,-2,"w1718","Mechanized",4,"Wed","weekday"
"1571",2018-01-03,"Slate River Rd","1","1","1",3.2,0,15,0,27,21.3,0,0,0,-2,0,0,0,-2,"w1718","Motorized",14,"Wed","weekday"
"1572",2018-01-03,"Slate River Rd","1","1","1",3.2,0,15,0,27,21.3,0,0,0,-2,0,0,0,-2,"w1718","Hybrid",4,"Wed","weekday"
"1573",2018-01-04,"Slate River Rd","1","1","1",3.2,0,15,0,29,21.3,0,0,0,0,0,0,0,0,"w1718","Non.motorized",19,"Thu","weekday"
"1574",2018-01-04,"Slate River Rd","1","1","1",3.2,0,15,0,29,21.3,0,0,0,0,0,0,0,0,"w1718","Mechanized",5,"Thu","weekday"
"1575",2018-01-04,"Slate River Rd","1","1","1",3.2,0,15,0,29,21.3,0,0,0,0,0,0,0,0,"w1718","Motorized",17,"Thu","weekday"
"1576",2018-01-04,"Slate River Rd","1","1","1",3.2,0,15,0,29,21.3,0,0,0,0,0,0,0,0,"w1718","Hybrid",4,"Thu","weekday"
"1577",2018-01-05,"Slate River Rd","1","1","1",3.2,0,14,-1,32,22.9,0,0,0,0,-1,-1,-1,-1,"w1718","Non.motorized",25,"Fri","weekday"
"1578",2018-01-05,"Slate River Rd","1","1","1",3.2,0,14,-1,32,22.9,0,0,0,0,-1,-1,-1,-1,"w1718","Mechanized",3,"Fri","weekday"
"1579",2018-01-05,"Slate River Rd","1","1","1",3.2,0,14,-1,32,22.9,0,0,0,0,-1,-1,-1,-1,"w1718","Motorized",18,"Fri","weekday"
"1580",2018-01-05,"Slate River Rd","1","1","1",3.2,0,14,-1,32,22.9,0,0,0,0,-1,-1,-1,-1,"w1718","Hybrid",2,"Fri","weekday"
"1581",2018-01-06,"Slate River Rd","1","1","1",3.2,0,14,0,30,22.9,-1,0,0,0,-1,-1,-1,-1,"w1718","Non.motorized",20,"Sat","weekend"
"1582",2018-01-06,"Slate River Rd","1","1","1",3.2,0,14,0,30,22.9,-1,0,0,0,-1,-1,-1,-1,"w1718","Mechanized",6,"Sat","weekend"
"1583",2018-01-06,"Slate River Rd","1","1","1",3.2,0,14,0,30,22.9,-1,0,0,0,-1,-1,-1,-1,"w1718","Motorized",24,"Sat","weekend"
"1584",2018-01-06,"Slate River Rd","1","1","1",3.2,0,14,0,30,22.9,-1,0,0,0,-1,-1,-1,-1,"w1718","Hybrid",6,"Sat","weekend"
"1585",2018-01-07,"Slate River Rd","2","2","2",3.5,0.3,18,4,25,19.4,0,-1,0,0,4,3,3,3,"w1718","Non.motorized",NA,"Sun","weekend"
"1586",2018-01-07,"Slate River Rd","2","2","2",3.5,0.3,18,4,25,19.4,0,-1,0,0,4,3,3,3,"w1718","Mechanized",NA,"Sun","weekend"
"1587",2018-01-07,"Slate River Rd","2","2","2",3.5,0.3,18,4,25,19.4,0,-1,0,0,4,3,3,3,"w1718","Motorized",NA,"Sun","weekend"
"1588",2018-01-07,"Slate River Rd","2","2","2",3.5,0.3,18,4,25,19.4,0,-1,0,0,4,3,3,3,"w1718","Hybrid",NA,"Sun","weekend"
"1589",2018-01-08,"Slate River Rd","2","2","1",3.7,0.2,20,2,29,18.5,4,0,-1,0,6,6,5,5,"w1718","Non.motorized",NA,"Mon","weekday"
"1590",2018-01-08,"Slate River Rd","2","2","1",3.7,0.2,20,2,29,18.5,4,0,-1,0,6,6,5,5,"w1718","Mechanized",NA,"Mon","weekday"
"1591",2018-01-08,"Slate River Rd","2","2","1",3.7,0.2,20,2,29,18.5,4,0,-1,0,6,6,5,5,"w1718","Motorized",NA,"Mon","weekday"
"1592",2018-01-08,"Slate River Rd","2","2","1",3.7,0.2,20,2,29,18.5,4,0,-1,0,6,6,5,5,"w1718","Hybrid",NA,"Mon","weekday"
"1593",2018-01-09,"Slate River Rd","2","2","1",3.8,0.1,21,1,34,18.1,2,4,0,-1,3,7,7,6,"w1718","Non.motorized",NA,"Tue","weekday"
"1594",2018-01-09,"Slate River Rd","2","2","1",3.8,0.1,21,1,34,18.1,2,4,0,-1,3,7,7,6,"w1718","Mechanized",NA,"Tue","weekday"
"1595",2018-01-09,"Slate River Rd","2","2","1",3.8,0.1,21,1,34,18.1,2,4,0,-1,3,7,7,6,"w1718","Motorized",NA,"Tue","weekday"
"1596",2018-01-09,"Slate River Rd","2","2","1",3.8,0.1,21,1,34,18.1,2,4,0,-1,3,7,7,6,"w1718","Hybrid",NA,"Tue","weekday"
"1597",2018-01-10,"Slate River Rd","3","3","3",4,0.2,21,0,28,19,1,2,4,0,1,3,7,7,"w1718","Non.motorized",NA,"Wed","weekday"
"1598",2018-01-10,"Slate River Rd","3","3","3",4,0.2,21,0,28,19,1,2,4,0,1,3,7,7,"w1718","Mechanized",NA,"Wed","weekday"
"1599",2018-01-10,"Slate River Rd","3","3","3",4,0.2,21,0,28,19,1,2,4,0,1,3,7,7,"w1718","Motorized",NA,"Wed","weekday"
"1600",2018-01-10,"Slate River Rd","3","3","3",4,0.2,21,0,28,19,1,2,4,0,1,3,7,7,"w1718","Hybrid",NA,"Wed","weekday"
"1601",2018-01-11,"Slate River Rd","3","3","3",4.1,0.1,26,5,17,15.8,0,1,2,4,5,6,8,12,"w1718","Non.motorized",3,"Thu","weekday"
"1602",2018-01-11,"Slate River Rd","3","3","3",4.1,0.1,26,5,17,15.8,0,1,2,4,5,6,8,12,"w1718","Mechanized",0,"Thu","weekday"
"1603",2018-01-11,"Slate River Rd","3","3","3",4.1,0.1,26,5,17,15.8,0,1,2,4,5,6,8,12,"w1718","Motorized",2,"Thu","weekday"
"1604",2018-01-11,"Slate River Rd","3","3","3",4.1,0.1,26,5,17,15.8,0,1,2,4,5,6,8,12,"w1718","Hybrid",1,"Thu","weekday"
"1605",2018-01-12,"Slate River Rd","3","3","3",4.3,0.2,24,-2,22,17.9,5,0,1,2,3,3,4,6,"w1718","Non.motorized",3,"Fri","weekday"
"1606",2018-01-12,"Slate River Rd","3","3","3",4.3,0.2,24,-2,22,17.9,5,0,1,2,3,3,4,6,"w1718","Mechanized",0,"Fri","weekday"
"1607",2018-01-12,"Slate River Rd","3","3","3",4.3,0.2,24,-2,22,17.9,5,0,1,2,3,3,4,6,"w1718","Motorized",4,"Fri","weekday"
"1608",2018-01-12,"Slate River Rd","3","3","3",4.3,0.2,24,-2,22,17.9,5,0,1,2,3,3,4,6,"w1718","Hybrid",3,"Fri","weekday"
"1609",2018-01-13,"Slate River Rd","3","3","3",4.4,0.1,24,0,24,18.3,-2,5,0,1,-2,3,3,4,"w1718","Non.motorized",34,"Sat","weekend"
"1610",2018-01-13,"Slate River Rd","3","3","3",4.4,0.1,24,0,24,18.3,-2,5,0,1,-2,3,3,4,"w1718","Mechanized",2,"Sat","weekend"
"1611",2018-01-13,"Slate River Rd","3","3","3",4.4,0.1,24,0,24,18.3,-2,5,0,1,-2,3,3,4,"w1718","Motorized",18,"Sat","weekend"
"1612",2018-01-13,"Slate River Rd","3","3","3",4.4,0.1,24,0,24,18.3,-2,5,0,1,-2,3,3,4,"w1718","Hybrid",15,"Sat","weekend"
"1613",2018-01-14,"Slate River Rd","3","3","2",4.4,0,24,0,27,18.3,0,-2,5,0,0,-2,3,3,"w1718","Non.motorized",39,"Sun","weekend"
"1614",2018-01-14,"Slate River Rd","3","3","2",4.4,0,24,0,27,18.3,0,-2,5,0,0,-2,3,3,"w1718","Mechanized",0,"Sun","weekend"
"1615",2018-01-14,"Slate River Rd","3","3","2",4.4,0,24,0,27,18.3,0,-2,5,0,0,-2,3,3,"w1718","Motorized",18,"Sun","weekend"
"1616",2018-01-14,"Slate River Rd","3","3","2",4.4,0,24,0,27,18.3,0,-2,5,0,0,-2,3,3,"w1718","Hybrid",13,"Sun","weekend"
"1617",2018-01-15,"Slate River Rd","3","3","2",4.4,0,23,-1,27,19.1,0,0,-2,5,-1,-1,-3,2,"w1718","Non.motorized",12,"Mon","weekday"
"1618",2018-01-15,"Slate River Rd","3","3","2",4.4,0,23,-1,27,19.1,0,0,-2,5,-1,-1,-3,2,"w1718","Mechanized",0,"Mon","weekday"
"1619",2018-01-15,"Slate River Rd","3","3","2",4.4,0,23,-1,27,19.1,0,0,-2,5,-1,-1,-3,2,"w1718","Motorized",8,"Mon","weekday"
"1620",2018-01-15,"Slate River Rd","3","3","2",4.4,0,23,-1,27,19.1,0,0,-2,5,-1,-1,-3,2,"w1718","Hybrid",7,"Mon","weekday"
"1621",2018-01-16,"Slate River Rd","3","3","2",4.4,0,22,-1,20,20,-1,0,0,-2,-2,-2,-2,-4,"w1718","Non.motorized",11,"Tue","weekday"
"1622",2018-01-16,"Slate River Rd","3","3","2",4.4,0,22,-1,20,20,-1,0,0,-2,-2,-2,-2,-4,"w1718","Mechanized",0,"Tue","weekday"
"1623",2018-01-16,"Slate River Rd","3","3","2",4.4,0,22,-1,20,20,-1,0,0,-2,-2,-2,-2,-4,"w1718","Motorized",10,"Tue","weekday"
"1624",2018-01-16,"Slate River Rd","3","3","2",4.4,0,22,-1,20,20,-1,0,0,-2,-2,-2,-2,-4,"w1718","Hybrid",9,"Tue","weekday"
"1625",2018-01-17,"Slate River Rd","2","2","2",4.4,0,22,0,24,20,-1,-1,0,0,-1,-2,-2,-2,"w1718","Non.motorized",10,"Wed","weekday"
"1626",2018-01-17,"Slate River Rd","2","2","2",4.4,0,22,0,24,20,-1,-1,0,0,-1,-2,-2,-2,"w1718","Mechanized",0,"Wed","weekday"
"1627",2018-01-17,"Slate River Rd","2","2","2",4.4,0,22,0,24,20,-1,-1,0,0,-1,-2,-2,-2,"w1718","Motorized",0,"Wed","weekday"
"1628",2018-01-17,"Slate River Rd","2","2","2",4.4,0,22,0,24,20,-1,-1,0,0,-1,-2,-2,-2,"w1718","Hybrid",0,"Wed","weekday"
"1629",2018-01-18,"Slate River Rd","2","2","2",4.4,0,21,-1,29,21,0,-1,-1,0,-1,-2,-3,-3,"w1718","Non.motorized",13,"Thu","weekday"
"1630",2018-01-18,"Slate River Rd","2","2","2",4.4,0,21,-1,29,21,0,-1,-1,0,-1,-2,-3,-3,"w1718","Mechanized",0,"Thu","weekday"
"1631",2018-01-18,"Slate River Rd","2","2","2",4.4,0,21,-1,29,21,0,-1,-1,0,-1,-2,-3,-3,"w1718","Motorized",2,"Thu","weekday"
"1632",2018-01-18,"Slate River Rd","2","2","2",4.4,0,21,-1,29,21,0,-1,-1,0,-1,-2,-3,-3,"w1718","Hybrid",2,"Thu","weekday"
"1633",2018-01-19,"Slate River Rd","2","2","2",4.5,0.1,21,0,34,21.4,-1,0,-1,-1,-1,-1,-2,-3,"w1718","Non.motorized",30,"Fri","weekday"
"1634",2018-01-19,"Slate River Rd","2","2","2",4.5,0.1,21,0,34,21.4,-1,0,-1,-1,-1,-1,-2,-3,"w1718","Mechanized",0,"Fri","weekday"
"1635",2018-01-19,"Slate River Rd","2","2","2",4.5,0.1,21,0,34,21.4,-1,0,-1,-1,-1,-1,-2,-3,"w1718","Motorized",2,"Fri","weekday"
"1636",2018-01-19,"Slate River Rd","2","2","2",4.5,0.1,21,0,34,21.4,-1,0,-1,-1,-1,-1,-2,-3,"w1718","Hybrid",2,"Fri","weekday"
"1637",2018-01-20,"Slate River Rd","2","2","2",4.5,0,21,0,32,21.4,0,-1,0,-1,0,-1,-1,-2,"w1718","Non.motorized",34,"Sat","weekend"
"1638",2018-01-20,"Slate River Rd","2","2","2",4.5,0,21,0,32,21.4,0,-1,0,-1,0,-1,-1,-2,"w1718","Mechanized",0,"Sat","weekend"
"1639",2018-01-20,"Slate River Rd","2","2","2",4.5,0,21,0,32,21.4,0,-1,0,-1,0,-1,-1,-2,"w1718","Motorized",17,"Sat","weekend"
"1640",2018-01-20,"Slate River Rd","2","2","2",4.5,0,21,0,32,21.4,0,-1,0,-1,0,-1,-1,-2,"w1718","Hybrid",17,"Sat","weekend"
"1641",2018-01-21,"Slate River Rd","3","3","3",4.6,0.1,23,2,15,20,0,0,-1,0,2,2,1,1,"w1718","Non.motorized",5,"Sun","weekend"
"1642",2018-01-21,"Slate River Rd","3","3","3",4.6,0.1,23,2,15,20,0,0,-1,0,2,2,1,1,"w1718","Mechanized",0,"Sun","weekend"
"1643",2018-01-21,"Slate River Rd","3","3","3",4.6,0.1,23,2,15,20,0,0,-1,0,2,2,1,1,"w1718","Motorized",0,"Sun","weekend"
"1644",2018-01-21,"Slate River Rd","3","3","3",4.6,0.1,23,2,15,20,0,0,-1,0,2,2,1,1,"w1718","Hybrid",0,"Sun","weekend"
"1645",2018-01-22,"Slate River Rd","3","3","3",4.6,0,21,-2,12,21.9,2,0,0,-1,0,0,0,-1,"w1718","Non.motorized",19,"Mon","weekday"
"1646",2018-01-22,"Slate River Rd","3","3","3",4.6,0,21,-2,12,21.9,2,0,0,-1,0,0,0,-1,"w1718","Mechanized",0,"Mon","weekday"
"1647",2018-01-22,"Slate River Rd","3","3","3",4.6,0,21,-2,12,21.9,2,0,0,-1,0,0,0,-1,"w1718","Motorized",6,"Mon","weekday"
"1648",2018-01-22,"Slate River Rd","3","3","3",4.6,0,21,-2,12,21.9,2,0,0,-1,0,0,0,-1,"w1718","Hybrid",6,"Mon","weekday"
"1649",2018-01-23,"Slate River Rd","3","3","3",4.6,0,22,1,16,20.9,-2,2,0,0,-1,1,1,1,"w1718","Non.motorized",9,"Tue","weekday"
"1650",2018-01-23,"Slate River Rd","3","3","3",4.6,0,22,1,16,20.9,-2,2,0,0,-1,1,1,1,"w1718","Mechanized",0,"Tue","weekday"
"1651",2018-01-23,"Slate River Rd","3","3","3",4.6,0,22,1,16,20.9,-2,2,0,0,-1,1,1,1,"w1718","Motorized",7,"Tue","weekday"
"1652",2018-01-23,"Slate River Rd","3","3","3",4.6,0,22,1,16,20.9,-2,2,0,0,-1,1,1,1,"w1718","Hybrid",7,"Tue","weekday"
"1653",2018-01-24,"Slate River Rd","2","2","2",4.6,0,22,0,22,20.9,1,-2,2,0,1,-1,1,1,"w1718","Non.motorized",12,"Wed","weekday"
"1654",2018-01-24,"Slate River Rd","2","2","2",4.6,0,22,0,22,20.9,1,-2,2,0,1,-1,1,1,"w1718","Mechanized",0,"Wed","weekday"
"1655",2018-01-24,"Slate River Rd","2","2","2",4.6,0,22,0,22,20.9,1,-2,2,0,1,-1,1,1,"w1718","Motorized",0,"Wed","weekday"
"1656",2018-01-24,"Slate River Rd","2","2","2",4.6,0,22,0,22,20.9,1,-2,2,0,1,-1,1,1,"w1718","Hybrid",0,"Wed","weekday"
"1657",2018-01-25,"Slate River Rd","2","2","2",4.6,0,22,0,28,20.9,0,1,-2,2,0,1,-1,1,"w1718","Non.motorized",21,"Thu","weekday"
"1658",2018-01-25,"Slate River Rd","2","2","2",4.6,0,22,0,28,20.9,0,1,-2,2,0,1,-1,1,"w1718","Mechanized",0,"Thu","weekday"
"1659",2018-01-25,"Slate River Rd","2","2","2",4.6,0,22,0,28,20.9,0,1,-2,2,0,1,-1,1,"w1718","Motorized",9,"Thu","weekday"
"1660",2018-01-25,"Slate River Rd","2","2","2",4.6,0,22,0,28,20.9,0,1,-2,2,0,1,-1,1,"w1718","Hybrid",9,"Thu","weekday"
"1661",2018-01-26,"Slate River Rd","2","2","2",4.7,0.1,22,0,15,21.4,0,0,1,-2,0,0,1,-1,"w1718","Non.motorized",4,"Fri","weekday"
"1662",2018-01-26,"Slate River Rd","2","2","2",4.7,0.1,22,0,15,21.4,0,0,1,-2,0,0,1,-1,"w1718","Mechanized",0,"Fri","weekday"
"1663",2018-01-26,"Slate River Rd","2","2","2",4.7,0.1,22,0,15,21.4,0,0,1,-2,0,0,1,-1,"w1718","Motorized",1,"Fri","weekday"
"1664",2018-01-26,"Slate River Rd","2","2","2",4.7,0.1,22,0,15,21.4,0,0,1,-2,0,0,1,-1,"w1718","Hybrid",1,"Fri","weekday"
"1665",2018-01-27,"Slate River Rd","2","2","2",4.7,0,23,1,16,20.4,0,0,0,1,1,1,1,2,"w1718","Non.motorized",34,"Sat","weekend"
"1666",2018-01-27,"Slate River Rd","2","2","2",4.7,0,23,1,16,20.4,0,0,0,1,1,1,1,2,"w1718","Mechanized",1,"Sat","weekend"
"1667",2018-01-27,"Slate River Rd","2","2","2",4.7,0,23,1,16,20.4,0,0,0,1,1,1,1,2,"w1718","Motorized",19,"Sat","weekend"
"1668",2018-01-27,"Slate River Rd","2","2","2",4.7,0,23,1,16,20.4,0,0,0,1,1,1,1,2,"w1718","Hybrid",17,"Sat","weekend"
"1669",2018-01-28,"Slate River Rd","2","2","2",4.7,0,23,0,25,20.4,1,0,0,0,1,1,1,1,"w1718","Non.motorized",41,"Sun","weekend"
"1670",2018-01-28,"Slate River Rd","2","2","2",4.7,0,23,0,25,20.4,1,0,0,0,1,1,1,1,"w1718","Mechanized",2,"Sun","weekend"
"1671",2018-01-28,"Slate River Rd","2","2","2",4.7,0,23,0,25,20.4,1,0,0,0,1,1,1,1,"w1718","Motorized",17,"Sun","weekend"
"1672",2018-01-28,"Slate River Rd","2","2","2",4.7,0,23,0,25,20.4,1,0,0,0,1,1,1,1,"w1718","Hybrid",17,"Sun","weekend"
"1673",2018-01-29,"Slate River Rd","2","2","2",4.8,0.1,22,-1,30,21.8,0,1,0,0,-1,0,0,0,"w1718","Non.motorized",21,"Mon","weekday"
"1674",2018-01-29,"Slate River Rd","2","2","2",4.8,0.1,22,-1,30,21.8,0,1,0,0,-1,0,0,0,"w1718","Mechanized",0,"Mon","weekday"
"1675",2018-01-29,"Slate River Rd","2","2","2",4.8,0.1,22,-1,30,21.8,0,1,0,0,-1,0,0,0,"w1718","Motorized",8,"Mon","weekday"
"1676",2018-01-29,"Slate River Rd","2","2","2",4.8,0.1,22,-1,30,21.8,0,1,0,0,-1,0,0,0,"w1718","Hybrid",7,"Mon","weekday"
"1677",2018-01-30,"Slate River Rd","2","2","2",4.8,0,22,0,34,21.8,-1,0,1,0,-1,-1,0,0,"w1718","Non.motorized",19,"Tue","weekday"
"1678",2018-01-30,"Slate River Rd","2","2","2",4.8,0,22,0,34,21.8,-1,0,1,0,-1,-1,0,0,"w1718","Mechanized",0,"Tue","weekday"
"1679",2018-01-30,"Slate River Rd","2","2","2",4.8,0,22,0,34,21.8,-1,0,1,0,-1,-1,0,0,"w1718","Motorized",7,"Tue","weekday"
"1680",2018-01-30,"Slate River Rd","2","2","2",4.8,0,22,0,34,21.8,-1,0,1,0,-1,-1,0,0,"w1718","Hybrid",7,"Tue","weekday"
"1681",2018-01-31,"Slate River Rd","2","2","2",4.8,0,22,0,34,21.8,0,-1,0,1,0,-1,-1,0,"w1718","Non.motorized",13,"Wed","weekday"
"1682",2018-01-31,"Slate River Rd","2","2","2",4.8,0,22,0,34,21.8,0,-1,0,1,0,-1,-1,0,"w1718","Mechanized",0,"Wed","weekday"
"1683",2018-01-31,"Slate River Rd","2","2","2",4.8,0,22,0,34,21.8,0,-1,0,1,0,-1,-1,0,"w1718","Motorized",2,"Wed","weekday"
"1684",2018-01-31,"Slate River Rd","2","2","2",4.8,0,22,0,34,21.8,0,-1,0,1,0,-1,-1,0,"w1718","Hybrid",2,"Wed","weekday"
"1685",2018-02-01,"Slate River Rd","2","2","2",4.9,0.1,21,-1,32,23.3,0,0,-1,0,-1,-1,-2,-2,"w1718","Non.motorized",16,"Thu","weekday"
"1686",2018-02-01,"Slate River Rd","2","2","2",4.9,0.1,21,-1,32,23.3,0,0,-1,0,-1,-1,-2,-2,"w1718","Mechanized",0,"Thu","weekday"
"1687",2018-02-01,"Slate River Rd","2","2","2",4.9,0.1,21,-1,32,23.3,0,0,-1,0,-1,-1,-2,-2,"w1718","Motorized",7,"Thu","weekday"
"1688",2018-02-01,"Slate River Rd","2","2","2",4.9,0.1,21,-1,32,23.3,0,0,-1,0,-1,-1,-2,-2,"w1718","Hybrid",6,"Thu","weekday"
"1689",2018-02-02,"Slate River Rd","2","2","2",4.9,0,20,-1,33,24.5,-1,0,0,-1,-2,-2,-2,-3,"w1718","Non.motorized",11,"Fri","weekday"
"1690",2018-02-02,"Slate River Rd","2","2","2",4.9,0,20,-1,33,24.5,-1,0,0,-1,-2,-2,-2,-3,"w1718","Mechanized",2,"Fri","weekday"
"1691",2018-02-02,"Slate River Rd","2","2","2",4.9,0,20,-1,33,24.5,-1,0,0,-1,-2,-2,-2,-3,"w1718","Motorized",8,"Fri","weekday"
"1692",2018-02-02,"Slate River Rd","2","2","2",4.9,0,20,-1,33,24.5,-1,0,0,-1,-2,-2,-2,-3,"w1718","Hybrid",8,"Fri","weekday"
"1693",2018-02-03,"Slate River Rd","2","2","2",4.9,0,21,1,32,23.3,-1,-1,0,0,0,-1,-1,-1,"w1718","Non.motorized",42,"Sat","weekend"
"1694",2018-02-03,"Slate River Rd","2","2","2",4.9,0,21,1,32,23.3,-1,-1,0,0,0,-1,-1,-1,"w1718","Mechanized",2,"Sat","weekend"
"1695",2018-02-03,"Slate River Rd","2","2","2",4.9,0,21,1,32,23.3,-1,-1,0,0,0,-1,-1,-1,"w1718","Motorized",7,"Sat","weekend"
"1696",2018-02-03,"Slate River Rd","2","2","2",4.9,0,21,1,32,23.3,-1,-1,0,0,0,-1,-1,-1,"w1718","Hybrid",3,"Sat","weekend"
"1697",2018-02-04,"Slate River Rd","2","2","2",4.9,0,19,-2,32,25.8,1,-1,-1,0,-1,-2,-3,-3,"w1718","Non.motorized",54,"Sun","weekend"
"1698",2018-02-04,"Slate River Rd","2","2","2",4.9,0,19,-2,32,25.8,1,-1,-1,0,-1,-2,-3,-3,"w1718","Mechanized",4,"Sun","weekend"
"1699",2018-02-04,"Slate River Rd","2","2","2",4.9,0,19,-2,32,25.8,1,-1,-1,0,-1,-2,-3,-3,"w1718","Motorized",10,"Sun","weekend"
"1700",2018-02-04,"Slate River Rd","2","2","2",4.9,0,19,-2,32,25.8,1,-1,-1,0,-1,-2,-3,-3,"w1718","Hybrid",9,"Sun","weekend"
"1701",2018-02-05,"Slate River Rd","2","2","2",5,0.1,18,-1,29,27.8,-2,1,-1,-1,-3,-2,-3,-4,"w1718","Non.motorized",37,"Mon","weekday"
"1702",2018-02-05,"Slate River Rd","2","2","2",5,0.1,18,-1,29,27.8,-2,1,-1,-1,-3,-2,-3,-4,"w1718","Mechanized",0,"Mon","weekday"
"1703",2018-02-05,"Slate River Rd","2","2","2",5,0.1,18,-1,29,27.8,-2,1,-1,-1,-3,-2,-3,-4,"w1718","Motorized",5,"Mon","weekday"
"1704",2018-02-05,"Slate River Rd","2","2","2",5,0.1,18,-1,29,27.8,-2,1,-1,-1,-3,-2,-3,-4,"w1718","Hybrid",4,"Mon","weekday"
"1705",2018-02-06,"Slate River Rd","2","2","2",5.2,0.2,23,5,22,22.6,-1,-2,1,-1,4,2,3,2,"w1718","Non.motorized",16,"Tue","weekday"
"1706",2018-02-06,"Slate River Rd","2","2","2",5.2,0.2,23,5,22,22.6,-1,-2,1,-1,4,2,3,2,"w1718","Mechanized",0,"Tue","weekday"
"1707",2018-02-06,"Slate River Rd","2","2","2",5.2,0.2,23,5,22,22.6,-1,-2,1,-1,4,2,3,2,"w1718","Motorized",7,"Tue","weekday"
"1708",2018-02-06,"Slate River Rd","2","2","2",5.2,0.2,23,5,22,22.6,-1,-2,1,-1,4,2,3,2,"w1718","Hybrid",6,"Tue","weekday"
"1709",2018-02-07,"Slate River Rd","2","2","2",5.2,0,23,0,24,22.6,5,-1,-2,1,5,4,2,3,"w1718","Non.motorized",18,"Wed","weekday"
"1710",2018-02-07,"Slate River Rd","2","2","2",5.2,0,23,0,24,22.6,5,-1,-2,1,5,4,2,3,"w1718","Mechanized",0,"Wed","weekday"
"1711",2018-02-07,"Slate River Rd","2","2","2",5.2,0,23,0,24,22.6,5,-1,-2,1,5,4,2,3,"w1718","Motorized",11,"Wed","weekday"
"1712",2018-02-07,"Slate River Rd","2","2","2",5.2,0,23,0,24,22.6,5,-1,-2,1,5,4,2,3,"w1718","Hybrid",10,"Wed","weekday"
"1713",2018-02-08,"Slate River Rd","2","2","1",5.3,0.1,25,2,28,21.2,0,5,-1,-2,2,7,6,4,"w1718","Non.motorized",23,"Thu","weekday"
"1714",2018-02-08,"Slate River Rd","2","2","1",5.3,0.1,25,2,28,21.2,0,5,-1,-2,2,7,6,4,"w1718","Mechanized",0,"Thu","weekday"
"1715",2018-02-08,"Slate River Rd","2","2","1",5.3,0.1,25,2,28,21.2,0,5,-1,-2,2,7,6,4,"w1718","Motorized",4,"Thu","weekday"
"1716",2018-02-08,"Slate River Rd","2","2","1",5.3,0.1,25,2,28,21.2,0,5,-1,-2,2,7,6,4,"w1718","Hybrid",3,"Thu","weekday"
"1717",2018-02-09,"Slate River Rd","2","2","1",5.3,0,24,-1,33,22.1,2,0,5,-1,1,1,6,5,"w1718","Non.motorized",16,"Fri","weekday"
"1718",2018-02-09,"Slate River Rd","2","2","1",5.3,0,24,-1,33,22.1,2,0,5,-1,1,1,6,5,"w1718","Mechanized",0,"Fri","weekday"
"1719",2018-02-09,"Slate River Rd","2","2","1",5.3,0,24,-1,33,22.1,2,0,5,-1,1,1,6,5,"w1718","Motorized",4,"Fri","weekday"
"1720",2018-02-09,"Slate River Rd","2","2","1",5.3,0,24,-1,33,22.1,2,0,5,-1,1,1,6,5,"w1718","Hybrid",4,"Fri","weekday"
"1721",2018-02-10,"Slate River Rd","3","3","2",5.3,0,24,0,24,22.1,-1,2,0,5,-1,1,1,6,"w1718","Non.motorized",3,"Sat","weekend"
"1722",2018-02-10,"Slate River Rd","3","3","2",5.3,0,24,0,24,22.1,-1,2,0,5,-1,1,1,6,"w1718","Mechanized",0,"Sat","weekend"
"1723",2018-02-10,"Slate River Rd","3","3","2",5.3,0,24,0,24,22.1,-1,2,0,5,-1,1,1,6,"w1718","Motorized",0,"Sat","weekend"
"1724",2018-02-10,"Slate River Rd","3","3","2",5.3,0,24,0,24,22.1,-1,2,0,5,-1,1,1,6,"w1718","Hybrid",0,"Sat","weekend"
"1725",2018-02-11,"Slate River Rd","3","3","2",5.6,0.3,27,3,13,20.7,0,-1,2,0,3,2,4,4,"w1718","Non.motorized",20,"Sun","weekend"
"1726",2018-02-11,"Slate River Rd","3","3","2",5.6,0.3,27,3,13,20.7,0,-1,2,0,3,2,4,4,"w1718","Mechanized",1,"Sun","weekend"
"1727",2018-02-11,"Slate River Rd","3","3","2",5.6,0.3,27,3,13,20.7,0,-1,2,0,3,2,4,4,"w1718","Motorized",4,"Sun","weekend"
"1728",2018-02-11,"Slate River Rd","3","3","2",5.6,0.3,27,3,13,20.7,0,-1,2,0,3,2,4,4,"w1718","Hybrid",3,"Sun","weekend"
"1729",2018-02-12,"Slate River Rd","3","3","3",5.7,0.1,27,0,23,21.1,3,0,-1,2,3,3,2,4,"w1718","Non.motorized",11,"Mon","weekday"
"1730",2018-02-12,"Slate River Rd","3","3","3",5.7,0.1,27,0,23,21.1,3,0,-1,2,3,3,2,4,"w1718","Mechanized",0,"Mon","weekday"
"1731",2018-02-12,"Slate River Rd","3","3","3",5.7,0.1,27,0,23,21.1,3,0,-1,2,3,3,2,4,"w1718","Motorized",4,"Mon","weekday"
"1732",2018-02-12,"Slate River Rd","3","3","3",5.7,0.1,27,0,23,21.1,3,0,-1,2,3,3,2,4,"w1718","Hybrid",4,"Mon","weekday"
"1733",2018-02-13,"Slate River Rd","3","3","3",6.1,0.4,29,2,28,21,0,3,0,-1,2,5,5,4,"w1718","Non.motorized",7,"Tue","weekday"
"1734",2018-02-13,"Slate River Rd","3","3","3",6.1,0.4,29,2,28,21,0,3,0,-1,2,5,5,4,"w1718","Mechanized",2,"Tue","weekday"
"1735",2018-02-13,"Slate River Rd","3","3","3",6.1,0.4,29,2,28,21,0,3,0,-1,2,5,5,4,"w1718","Motorized",6,"Tue","weekday"
"1736",2018-02-13,"Slate River Rd","3","3","3",6.1,0.4,29,2,28,21,0,3,0,-1,2,5,5,4,"w1718","Hybrid",6,"Tue","weekday"
"1737",2018-02-14,"Slate River Rd","3","3","3",6.2,0.1,30,1,30,20.7,2,0,3,0,3,3,6,6,"w1718","Non.motorized",14,"Wed","weekday"
"1738",2018-02-14,"Slate River Rd","3","3","3",6.2,0.1,30,1,30,20.7,2,0,3,0,3,3,6,6,"w1718","Mechanized",0,"Wed","weekday"
"1739",2018-02-14,"Slate River Rd","3","3","3",6.2,0.1,30,1,30,20.7,2,0,3,0,3,3,6,6,"w1718","Motorized",4,"Wed","weekday"
"1740",2018-02-14,"Slate River Rd","3","3","3",6.2,0.1,30,1,30,20.7,2,0,3,0,3,3,6,6,"w1718","Hybrid",4,"Wed","weekday"
"1741",2018-02-15,"Slate River Rd","3","3","3",6.3,0.1,28,-2,24,22.5,1,2,0,3,-1,1,1,4,"w1718","Non.motorized",7,"Thu","weekday"
"1742",2018-02-15,"Slate River Rd","3","3","3",6.3,0.1,28,-2,24,22.5,1,2,0,3,-1,1,1,4,"w1718","Mechanized",0,"Thu","weekday"
"1743",2018-02-15,"Slate River Rd","3","3","3",6.3,0.1,28,-2,24,22.5,1,2,0,3,-1,1,1,4,"w1718","Motorized",10,"Thu","weekday"
"1744",2018-02-15,"Slate River Rd","3","3","3",6.3,0.1,28,-2,24,22.5,1,2,0,3,-1,1,1,4,"w1718","Hybrid",10,"Thu","weekday"
"1745",2018-02-16,"Slate River Rd","3","3","3",6.7,0.4,32,4,18,20.9,-2,1,2,0,2,3,5,5,"w1718","Non.motorized",14,"Fri","weekday"
"1746",2018-02-16,"Slate River Rd","3","3","3",6.7,0.4,32,4,18,20.9,-2,1,2,0,2,3,5,5,"w1718","Mechanized",1,"Fri","weekday"
"1747",2018-02-16,"Slate River Rd","3","3","3",6.7,0.4,32,4,18,20.9,-2,1,2,0,2,3,5,5,"w1718","Motorized",8,"Fri","weekday"
"1748",2018-02-16,"Slate River Rd","3","3","3",6.7,0.4,32,4,18,20.9,-2,1,2,0,2,3,5,5,"w1718","Hybrid",6,"Fri","weekday"
"1749",2018-02-17,"Slate River Rd","3","3","2",6.7,0,32,0,25,20.9,4,-2,1,2,4,2,3,5,"w1718","Non.motorized",65,"Sat","weekend"
"1750",2018-02-17,"Slate River Rd","3","3","2",6.7,0,32,0,25,20.9,4,-2,1,2,4,2,3,5,"w1718","Mechanized",4,"Sat","weekend"
"1751",2018-02-17,"Slate River Rd","3","3","2",6.7,0,32,0,25,20.9,4,-2,1,2,4,2,3,5,"w1718","Motorized",10,"Sat","weekend"
"1752",2018-02-17,"Slate River Rd","3","3","2",6.7,0,32,0,25,20.9,4,-2,1,2,4,2,3,5,"w1718","Hybrid",9,"Sat","weekend"
"1753",2018-02-18,"Slate River Rd","2","2","2",6.7,0,31,-1,32,21.6,0,4,-2,1,-1,3,1,2,"w1718","Non.motorized",51,"Sun","weekend"
"1754",2018-02-18,"Slate River Rd","2","2","2",6.7,0,31,-1,32,21.6,0,4,-2,1,-1,3,1,2,"w1718","Mechanized",6,"Sun","weekend"
"1755",2018-02-18,"Slate River Rd","2","2","2",6.7,0,31,-1,32,21.6,0,4,-2,1,-1,3,1,2,"w1718","Motorized",6,"Sun","weekend"
"1756",2018-02-18,"Slate River Rd","2","2","2",6.7,0,31,-1,32,21.6,0,4,-2,1,-1,3,1,2,"w1718","Hybrid",6,"Sun","weekend"
"1757",2018-02-19,"Slate River Rd","2","2","2",6.8,0.1,29,-2,24,23.4,-1,0,4,-2,-3,-3,1,-1,"w1718","Non.motorized",6,"Mon","weekday"
"1758",2018-02-19,"Slate River Rd","2","2","2",6.8,0.1,29,-2,24,23.4,-1,0,4,-2,-3,-3,1,-1,"w1718","Mechanized",0,"Mon","weekday"
"1759",2018-02-19,"Slate River Rd","2","2","2",6.8,0.1,29,-2,24,23.4,-1,0,4,-2,-3,-3,1,-1,"w1718","Motorized",17,"Mon","weekday"
"1760",2018-02-19,"Slate River Rd","2","2","2",6.8,0.1,29,-2,24,23.4,-1,0,4,-2,-3,-3,1,-1,"w1718","Hybrid",16,"Mon","weekday"
"1761",2018-02-19,"Slate River Rd","3","3","3",6.8,0.1,29,-2,24,23.4,-1,0,4,-2,-3,-3,1,-1,"w1718","Non.motorized",6,"Mon","weekday"
"1762",2018-02-19,"Slate River Rd","3","3","3",6.8,0.1,29,-2,24,23.4,-1,0,4,-2,-3,-3,1,-1,"w1718","Mechanized",0,"Mon","weekday"
"1763",2018-02-19,"Slate River Rd","3","3","3",6.8,0.1,29,-2,24,23.4,-1,0,4,-2,-3,-3,1,-1,"w1718","Motorized",17,"Mon","weekday"
"1764",2018-02-19,"Slate River Rd","3","3","3",6.8,0.1,29,-2,24,23.4,-1,0,4,-2,-3,-3,1,-1,"w1718","Hybrid",16,"Mon","weekday"
"1765",2018-02-20,"Slate River Rd","3","3","3",6.8,0,31,2,8,21.9,-2,-1,0,4,0,-1,-1,3,"w1718","Non.motorized",0,"Tue","weekday"
"1766",2018-02-20,"Slate River Rd","3","3","3",6.8,0,31,2,8,21.9,-2,-1,0,4,0,-1,-1,3,"w1718","Mechanized",0,"Tue","weekday"
"1767",2018-02-20,"Slate River Rd","3","3","3",6.8,0,31,2,8,21.9,-2,-1,0,4,0,-1,-1,3,"w1718","Motorized",1,"Tue","weekday"
"1768",2018-02-20,"Slate River Rd","3","3","3",6.8,0,31,2,8,21.9,-2,-1,0,4,0,-1,-1,3,"w1718","Hybrid",1,"Tue","weekday"
"1769",2018-02-21,"Slate River Rd","3","3","3",6.8,0,31,0,11,21.9,2,-2,-1,0,2,0,-1,-1,"w1718","Non.motorized",19,"Wed","weekday"
"1770",2018-02-21,"Slate River Rd","3","3","3",6.8,0,31,0,11,21.9,2,-2,-1,0,2,0,-1,-1,"w1718","Mechanized",0,"Wed","weekday"
"1771",2018-02-21,"Slate River Rd","3","3","3",6.8,0,31,0,11,21.9,2,-2,-1,0,2,0,-1,-1,"w1718","Motorized",2,"Wed","weekday"
"1772",2018-02-21,"Slate River Rd","3","3","3",6.8,0,31,0,11,21.9,2,-2,-1,0,2,0,-1,-1,"w1718","Hybrid",2,"Wed","weekday"
"1773",2018-02-22,"Slate River Rd","3","3","2",6.8,0,30,-1,16,22.7,0,2,-2,-1,-1,1,-1,-2,"w1718","Non.motorized",14,"Thu","weekday"
"1774",2018-02-22,"Slate River Rd","3","3","2",6.8,0,30,-1,16,22.7,0,2,-2,-1,-1,1,-1,-2,"w1718","Mechanized",0,"Thu","weekday"
"1775",2018-02-22,"Slate River Rd","3","3","2",6.8,0,30,-1,16,22.7,0,2,-2,-1,-1,1,-1,-2,"w1718","Motorized",3,"Thu","weekday"
"1776",2018-02-22,"Slate River Rd","3","3","2",6.8,0,30,-1,16,22.7,0,2,-2,-1,-1,1,-1,-2,"w1718","Hybrid",3,"Thu","weekday"
"1777",2018-02-23,"Slate River Rd","3","3","2",6.9,0.1,30,0,15,23,-1,0,2,-2,-1,-1,1,-1,"w1718","Non.motorized",10,"Fri","weekday"
"1778",2018-02-23,"Slate River Rd","3","3","2",6.9,0.1,30,0,15,23,-1,0,2,-2,-1,-1,1,-1,"w1718","Mechanized",1,"Fri","weekday"
"1779",2018-02-23,"Slate River Rd","3","3","2",6.9,0.1,30,0,15,23,-1,0,2,-2,-1,-1,1,-1,"w1718","Motorized",8,"Fri","weekday"
"1780",2018-02-23,"Slate River Rd","3","3","2",6.9,0.1,30,0,15,23,-1,0,2,-2,-1,-1,1,-1,"w1718","Hybrid",7,"Fri","weekday"
"1781",2018-02-24,"Slate River Rd","3","3","2",6.9,0,31,1,10,22.3,0,-1,0,2,1,0,0,2,"w1718","Non.motorized",8,"Sat","weekend"
"1782",2018-02-24,"Slate River Rd","3","3","2",6.9,0,31,1,10,22.3,0,-1,0,2,1,0,0,2,"w1718","Mechanized",1,"Sat","weekend"
"1783",2018-02-24,"Slate River Rd","3","3","2",6.9,0,31,1,10,22.3,0,-1,0,2,1,0,0,2,"w1718","Motorized",2,"Sat","weekend"
"1784",2018-02-24,"Slate River Rd","3","3","2",6.9,0,31,1,10,22.3,0,-1,0,2,1,0,0,2,"w1718","Hybrid",0,"Sat","weekend"
"1785",2018-02-25,"Slate River Rd","3","3","2",7.1,0.2,32,1,11,22.2,1,0,-1,0,2,2,1,1,"w1718","Non.motorized",4,"Sun","weekend"
"1786",2018-02-25,"Slate River Rd","3","3","2",7.1,0.2,32,1,11,22.2,1,0,-1,0,2,2,1,1,"w1718","Mechanized",1,"Sun","weekend"
"1787",2018-02-25,"Slate River Rd","3","3","2",7.1,0.2,32,1,11,22.2,1,0,-1,0,2,2,1,1,"w1718","Motorized",5,"Sun","weekend"
"1788",2018-02-25,"Slate River Rd","3","3","2",7.1,0.2,32,1,11,22.2,1,0,-1,0,2,2,1,1,"w1718","Hybrid",5,"Sun","weekend"
"1789",2018-02-26,"Slate River Rd","2","2","2",7.1,0,32,0,20,22.2,1,1,0,-1,1,2,2,1,"w1718","Non.motorized",20,"Mon","weekday"
"1790",2018-02-26,"Slate River Rd","2","2","2",7.1,0,32,0,20,22.2,1,1,0,-1,1,2,2,1,"w1718","Mechanized",0,"Mon","weekday"
"1791",2018-02-26,"Slate River Rd","2","2","2",7.1,0,32,0,20,22.2,1,1,0,-1,1,2,2,1,"w1718","Motorized",0,"Mon","weekday"
"1792",2018-02-26,"Slate River Rd","2","2","2",7.1,0,32,0,20,22.2,1,1,0,-1,1,2,2,1,"w1718","Hybrid",0,"Mon","weekday"
"1793",2018-02-27,"Slate River Rd","2","2","2",7.2,0.1,32,0,26,22.5,0,1,1,0,0,1,2,2,"w1718","Non.motorized",19,"Tue","weekday"
"1794",2018-02-27,"Slate River Rd","2","2","2",7.2,0.1,32,0,26,22.5,0,1,1,0,0,1,2,2,"w1718","Mechanized",0,"Tue","weekday"
"1795",2018-02-27,"Slate River Rd","2","2","2",7.2,0.1,32,0,26,22.5,0,1,1,0,0,1,2,2,"w1718","Motorized",1,"Tue","weekday"
"1796",2018-02-27,"Slate River Rd","2","2","2",7.2,0.1,32,0,26,22.5,0,1,1,0,0,1,2,2,"w1718","Hybrid",0,"Tue","weekday"
"1797",2018-02-28,"Slate River Rd","2","2","2",7.2,0,31,-1,23,23.2,0,0,1,1,-1,-1,0,1,"w1718","Non.motorized",7,"Wed","weekday"
"1798",2018-02-28,"Slate River Rd","2","2","2",7.2,0,31,-1,23,23.2,0,0,1,1,-1,-1,0,1,"w1718","Mechanized",0,"Wed","weekday"
"1799",2018-02-28,"Slate River Rd","2","2","2",7.2,0,31,-1,23,23.2,0,0,1,1,-1,-1,0,1,"w1718","Motorized",1,"Wed","weekday"
"1800",2018-02-28,"Slate River Rd","2","2","2",7.2,0,31,-1,23,23.2,0,0,1,1,-1,-1,0,1,"w1718","Hybrid",0,"Wed","weekday"
"1801",2018-03-01,"Slate River Rd","2","2","2",7.2,0,31,0,24,23.2,-1,0,0,1,-1,-1,-1,0,"w1718","Non.motorized",15,"Thu","weekday"
"1802",2018-03-01,"Slate River Rd","2","2","2",7.2,0,31,0,24,23.2,-1,0,0,1,-1,-1,-1,0,"w1718","Mechanized",15,"Thu","weekday"
"1803",2018-03-01,"Slate River Rd","2","2","2",7.2,0,31,0,24,23.2,-1,0,0,1,-1,-1,-1,0,"w1718","Motorized",12,"Thu","weekday"
"1804",2018-03-01,"Slate River Rd","2","2","2",7.2,0,31,0,24,23.2,-1,0,0,1,-1,-1,-1,0,"w1718","Hybrid",8,"Thu","weekday"
"1805",2018-03-02,"Slate River Rd","2","2","1",7.2,0,31,0,30,23.2,0,-1,0,0,0,-1,-1,-1,"w1718","Non.motorized",11,"Fri","weekday"
"1806",2018-03-02,"Slate River Rd","2","2","1",7.2,0,31,0,30,23.2,0,-1,0,0,0,-1,-1,-1,"w1718","Mechanized",0,"Fri","weekday"
"1807",2018-03-02,"Slate River Rd","2","2","1",7.2,0,31,0,30,23.2,0,-1,0,0,0,-1,-1,-1,"w1718","Motorized",5,"Fri","weekday"
"1808",2018-03-02,"Slate River Rd","2","2","1",7.2,0,31,0,30,23.2,0,-1,0,0,0,-1,-1,-1,"w1718","Hybrid",5,"Fri","weekday"
"1809",2018-03-03,"Slate River Rd","2","2","1",7.3,0.1,30,-1,34,24.3,0,0,-1,0,-1,-1,-2,-2,"w1718","Non.motorized",44,"Sat","weekend"
"1810",2018-03-03,"Slate River Rd","2","2","1",7.3,0.1,30,-1,34,24.3,0,0,-1,0,-1,-1,-2,-2,"w1718","Mechanized",1,"Sat","weekend"
"1811",2018-03-03,"Slate River Rd","2","2","1",7.3,0.1,30,-1,34,24.3,0,0,-1,0,-1,-1,-2,-2,"w1718","Motorized",11,"Sat","weekend"
"1812",2018-03-03,"Slate River Rd","2","2","1",7.3,0.1,30,-1,34,24.3,0,0,-1,0,-1,-1,-2,-2,"w1718","Hybrid",11,"Sat","weekend"
"1813",2018-03-04,"Slate River Rd","2","2","1",7.3,0,29,-1,24,25.2,-1,0,0,-1,-2,-2,-2,-3,"w1718","Non.motorized",35,"Sun","weekend"
"1814",2018-03-04,"Slate River Rd","2","2","1",7.3,0,29,-1,24,25.2,-1,0,0,-1,-2,-2,-2,-3,"w1718","Mechanized",1,"Sun","weekend"
"1815",2018-03-04,"Slate River Rd","2","2","1",7.3,0,29,-1,24,25.2,-1,0,0,-1,-2,-2,-2,-3,"w1718","Motorized",13,"Sun","weekend"
"1816",2018-03-04,"Slate River Rd","2","2","1",7.3,0,29,-1,24,25.2,-1,0,0,-1,-2,-2,-2,-3,"w1718","Hybrid",13,"Sun","weekend"
"1817",2018-03-05,"Slate River Rd","2","2","1",7.3,0,31,2,13,23.5,-1,-1,0,0,1,0,0,0,"w1718","Non.motorized",14,"Mon","weekday"
"1818",2018-03-05,"Slate River Rd","2","2","1",7.3,0,31,2,13,23.5,-1,-1,0,0,1,0,0,0,"w1718","Mechanized",3,"Mon","weekday"
"1819",2018-03-05,"Slate River Rd","2","2","1",7.3,0,31,2,13,23.5,-1,-1,0,0,1,0,0,0,"w1718","Motorized",2,"Mon","weekday"
"1820",2018-03-05,"Slate River Rd","2","2","1",7.3,0,31,2,13,23.5,-1,-1,0,0,1,0,0,0,"w1718","Hybrid",0,"Mon","weekday"
"1821",2018-03-06,"Slate River Rd","2","2","1",7.3,0,31,0,19,23.5,2,-1,-1,0,2,1,0,0,"w1718","Non.motorized",9,"Tue","weekday"
"1822",2018-03-06,"Slate River Rd","2","2","1",7.3,0,31,0,19,23.5,2,-1,-1,0,2,1,0,0,"w1718","Mechanized",0,"Tue","weekday"
"1823",2018-03-06,"Slate River Rd","2","2","1",7.3,0,31,0,19,23.5,2,-1,-1,0,2,1,0,0,"w1718","Motorized",6,"Tue","weekday"
"1824",2018-03-06,"Slate River Rd","2","2","1",7.3,0,31,0,19,23.5,2,-1,-1,0,2,1,0,0,"w1718","Hybrid",4,"Tue","weekday"
"1825",2018-03-07,"Slate River Rd","2","2","1",7.4,0.1,31,0,27,23.9,0,2,-1,-1,0,2,1,0,"w1718","Non.motorized",16,"Wed","weekday"
"1826",2018-03-07,"Slate River Rd","2","2","1",7.4,0.1,31,0,27,23.9,0,2,-1,-1,0,2,1,0,"w1718","Mechanized",0,"Wed","weekday"
"1827",2018-03-07,"Slate River Rd","2","2","1",7.4,0.1,31,0,27,23.9,0,2,-1,-1,0,2,1,0,"w1718","Motorized",9,"Wed","weekday"
"1828",2018-03-07,"Slate River Rd","2","2","1",7.4,0.1,31,0,27,23.9,0,2,-1,-1,0,2,1,0,"w1718","Hybrid",9,"Wed","weekday"
"1829",2018-03-08,"Slate River Rd","2","2","1",7.4,0,30,-1,33,24.7,0,0,2,-1,-1,-1,1,0,"w1718","Non.motorized",17,"Thu","weekday"
"1830",2018-03-08,"Slate River Rd","2","2","1",7.4,0,30,-1,33,24.7,0,0,2,-1,-1,-1,1,0,"w1718","Mechanized",0,"Thu","weekday"
"1831",2018-03-08,"Slate River Rd","2","2","1",7.4,0,30,-1,33,24.7,0,0,2,-1,-1,-1,1,0,"w1718","Motorized",10,"Thu","weekday"
"1832",2018-03-08,"Slate River Rd","2","2","1",7.4,0,30,-1,33,24.7,0,0,2,-1,-1,-1,1,0,"w1718","Hybrid",8,"Thu","weekday"
"1833",2018-03-09,"Slate River Rd","2","2","1",7.4,0,30,0,34,24.7,-1,0,0,2,-1,-1,-1,1,"w1718","Non.motorized",41,"Fri","weekday"
"1834",2018-03-09,"Slate River Rd","2","2","1",7.4,0,30,0,34,24.7,-1,0,0,2,-1,-1,-1,1,"w1718","Mechanized",0,"Fri","weekday"
"1835",2018-03-09,"Slate River Rd","2","2","1",7.4,0,30,0,34,24.7,-1,0,0,2,-1,-1,-1,1,"w1718","Motorized",10,"Fri","weekday"
"1836",2018-03-09,"Slate River Rd","2","2","1",7.4,0,30,0,34,24.7,-1,0,0,2,-1,-1,-1,1,"w1718","Hybrid",10,"Fri","weekday"
"1837",2018-03-10,"Slate River Rd","1","1","1",7.4,0,30,0,31,24.7,0,-1,0,0,0,-1,-1,-1,"w1718","Non.motorized",37,"Sat","weekend"
"1838",2018-03-10,"Slate River Rd","1","1","1",7.4,0,30,0,31,24.7,0,-1,0,0,0,-1,-1,-1,"w1718","Mechanized",0,"Sat","weekend"
"1839",2018-03-10,"Slate River Rd","1","1","1",7.4,0,30,0,31,24.7,0,-1,0,0,0,-1,-1,-1,"w1718","Motorized",6,"Sat","weekend"
"1840",2018-03-10,"Slate River Rd","1","1","1",7.4,0,30,0,31,24.7,0,-1,0,0,0,-1,-1,-1,"w1718","Hybrid",5,"Sat","weekend"
"1841",2018-03-11,"Slate River Rd","1","1","1",7.4,0,29,-1,31,25.5,0,0,-1,0,-1,-1,-2,-2,"w1718","Non.motorized",54,"Sun","weekend"
"1842",2018-03-11,"Slate River Rd","1","1","1",7.4,0,29,-1,31,25.5,0,0,-1,0,-1,-1,-2,-2,"w1718","Mechanized",0,"Sun","weekend"
"1843",2018-03-11,"Slate River Rd","1","1","1",7.4,0,29,-1,31,25.5,0,0,-1,0,-1,-1,-2,-2,"w1718","Motorized",4,"Sun","weekend"
"1844",2018-03-11,"Slate River Rd","1","1","1",7.4,0,29,-1,31,25.5,0,0,-1,0,-1,-1,-2,-2,"w1718","Hybrid",4,"Sun","weekend"
"1845",2018-03-12,"Slate River Rd","1","1","1",7.4,0,29,0,33,25.5,-1,0,0,-1,-1,-1,-1,-2,"w1718","Non.motorized",26,"Mon","weekday"
"1846",2018-03-12,"Slate River Rd","1","1","1",7.4,0,29,0,33,25.5,-1,0,0,-1,-1,-1,-1,-2,"w1718","Mechanized",0,"Mon","weekday"
"1847",2018-03-12,"Slate River Rd","1","1","1",7.4,0,29,0,33,25.5,-1,0,0,-1,-1,-1,-1,-2,"w1718","Motorized",4,"Mon","weekday"
"1848",2018-03-12,"Slate River Rd","1","1","1",7.4,0,29,0,33,25.5,-1,0,0,-1,-1,-1,-1,-2,"w1718","Hybrid",2,"Mon","weekday"
"1849",2018-03-13,"Slate River Rd","1","1","1",7.4,0,29,0,34,25.5,0,-1,0,0,0,-1,-1,-1,"w1718","Non.motorized",49,"Tue","weekday"
"1850",2018-03-13,"Slate River Rd","1","1","1",7.4,0,29,0,34,25.5,0,-1,0,0,0,-1,-1,-1,"w1718","Mechanized",1,"Tue","weekday"
"1851",2018-03-13,"Slate River Rd","1","1","1",7.4,0,29,0,34,25.5,0,-1,0,0,0,-1,-1,-1,"w1718","Motorized",3,"Tue","weekday"
"1852",2018-03-13,"Slate River Rd","1","1","1",7.4,0,29,0,34,25.5,0,-1,0,0,0,-1,-1,-1,"w1718","Hybrid",2,"Tue","weekday"
"1853",2018-03-14,"Slate River Rd","1","2","2",7.4,0,29,0,39,25.5,0,0,-1,0,0,0,-1,-1,"w1718","Non.motorized",27,"Wed","weekday"
"1854",2018-03-14,"Slate River Rd","1","2","2",7.4,0,29,0,39,25.5,0,0,-1,0,0,0,-1,-1,"w1718","Mechanized",0,"Wed","weekday"
"1855",2018-03-14,"Slate River Rd","1","2","2",7.4,0,29,0,39,25.5,0,0,-1,0,0,0,-1,-1,"w1718","Motorized",7,"Wed","weekday"
"1856",2018-03-14,"Slate River Rd","1","2","2",7.4,0,29,0,39,25.5,0,0,-1,0,0,0,-1,-1,"w1718","Hybrid",2,"Wed","weekday"
"1857",2018-03-15,"Slate River Rd","2","2","2",7.5,0.1,28,-1,31,26.8,0,0,0,-1,-1,-1,-1,-2,"w1718","Non.motorized",12,"Thu","weekday"
"1858",2018-03-15,"Slate River Rd","2","2","2",7.5,0.1,28,-1,31,26.8,0,0,0,-1,-1,-1,-1,-2,"w1718","Mechanized",0,"Thu","weekday"
"1859",2018-03-15,"Slate River Rd","2","2","2",7.5,0.1,28,-1,31,26.8,0,0,0,-1,-1,-1,-1,-2,"w1718","Motorized",2,"Thu","weekday"
"1860",2018-03-15,"Slate River Rd","2","2","2",7.5,0.1,28,-1,31,26.8,0,0,0,-1,-1,-1,-1,-2,"w1718","Hybrid",2,"Thu","weekday"
"1861",2018-03-16,"Slate River Rd","2","2","2",7.7,0.2,29,1,25,26.6,-1,0,0,0,0,0,0,0,"w1718","Non.motorized",20,"Fri","weekday"
"1862",2018-03-16,"Slate River Rd","2","2","2",7.7,0.2,29,1,25,26.6,-1,0,0,0,0,0,0,0,"w1718","Mechanized",0,"Fri","weekday"
"1863",2018-03-16,"Slate River Rd","2","2","2",7.7,0.2,29,1,25,26.6,-1,0,0,0,0,0,0,0,"w1718","Motorized",10,"Fri","weekday"
"1864",2018-03-16,"Slate River Rd","2","2","2",7.7,0.2,29,1,25,26.6,-1,0,0,0,0,0,0,0,"w1718","Hybrid",10,"Fri","weekday"
"1865",2018-03-17,"Slate River Rd","2","2","2",7.8,0.1,32,3,29,24.4,1,-1,0,0,4,3,3,3,"w1718","Non.motorized",22,"Sat","weekend"
"1866",2018-03-17,"Slate River Rd","2","2","2",7.8,0.1,32,3,29,24.4,1,-1,0,0,4,3,3,3,"w1718","Mechanized",0,"Sat","weekend"
"1867",2018-03-17,"Slate River Rd","2","2","2",7.8,0.1,32,3,29,24.4,1,-1,0,0,4,3,3,3,"w1718","Motorized",11,"Sat","weekend"
"1868",2018-03-17,"Slate River Rd","2","2","2",7.8,0.1,32,3,29,24.4,1,-1,0,0,4,3,3,3,"w1718","Hybrid",11,"Sat","weekend"
"1869",2018-03-18,"Slate River Rd","2","2","2",7.9,0.1,31,-1,24,25.5,3,1,-1,0,2,3,2,2,"w1718","Non.motorized",11,"Sun","weekend"
"1870",2018-03-18,"Slate River Rd","2","2","2",7.9,0.1,31,-1,24,25.5,3,1,-1,0,2,3,2,2,"w1718","Mechanized",1,"Sun","weekend"
"1871",2018-03-18,"Slate River Rd","2","2","2",7.9,0.1,31,-1,24,25.5,3,1,-1,0,2,3,2,2,"w1718","Motorized",14,"Sun","weekend"
"1872",2018-03-18,"Slate River Rd","2","2","2",7.9,0.1,31,-1,24,25.5,3,1,-1,0,2,3,2,2,"w1718","Hybrid",10,"Sun","weekend"
"1873",2018-03-19,"Slate River Rd","2","2","1",8,0.1,32,1,19,25,-1,3,1,-1,0,3,4,3,"w1718","Non.motorized",15,"Mon","weekday"
"1874",2018-03-19,"Slate River Rd","2","2","1",8,0.1,32,1,19,25,-1,3,1,-1,0,3,4,3,"w1718","Mechanized",0,"Mon","weekday"
"1875",2018-03-19,"Slate River Rd","2","2","1",8,0.1,32,1,19,25,-1,3,1,-1,0,3,4,3,"w1718","Motorized",14,"Mon","weekday"
"1876",2018-03-19,"Slate River Rd","2","2","1",8,0.1,32,1,19,25,-1,3,1,-1,0,3,4,3,"w1718","Hybrid",14,"Mon","weekday"
"1877",2018-03-20,"Slate River Rd","2","2","1",8,0,30,-2,24,26.7,1,-1,3,1,-1,-2,1,2,"w1718","Non.motorized",40,"Tue","weekday"
"1878",2018-03-20,"Slate River Rd","2","2","1",8,0,30,-2,24,26.7,1,-1,3,1,-1,-2,1,2,"w1718","Mechanized",0,"Tue","weekday"
"1879",2018-03-20,"Slate River Rd","2","2","1",8,0,30,-2,24,26.7,1,-1,3,1,-1,-2,1,2,"w1718","Motorized",10,"Tue","weekday"
"1880",2018-03-20,"Slate River Rd","2","2","1",8,0,30,-2,24,26.7,1,-1,3,1,-1,-2,1,2,"w1718","Hybrid",10,"Tue","weekday"
"1881",2018-03-21,"Slate River Rd","1","1","1",8.1,0.1,32,2,30,25.3,-2,1,-1,3,0,1,0,3,"w1718","Non.motorized",16,"Wed","weekday"
"1882",2018-03-21,"Slate River Rd","1","1","1",8.1,0.1,32,2,30,25.3,-2,1,-1,3,0,1,0,3,"w1718","Mechanized",1,"Wed","weekday"
"1883",2018-03-21,"Slate River Rd","1","1","1",8.1,0.1,32,2,30,25.3,-2,1,-1,3,0,1,0,3,"w1718","Motorized",7,"Wed","weekday"
"1884",2018-03-21,"Slate River Rd","1","1","1",8.1,0.1,32,2,30,25.3,-2,1,-1,3,0,1,0,3,"w1718","Hybrid",6,"Wed","weekday"
"1885",2018-03-22,"Slate River Rd","1","1","1",8.1,0,30,-2,36,27,2,-2,1,-1,0,-2,-1,-2,"w1718","Non.motorized",43,"Thu","weekday"
"1886",2018-03-22,"Slate River Rd","1","1","1",8.1,0,30,-2,36,27,2,-2,1,-1,0,-2,-1,-2,"w1718","Mechanized",0,"Thu","weekday"
"1887",2018-03-22,"Slate River Rd","1","1","1",8.1,0,30,-2,36,27,2,-2,1,-1,0,-2,-1,-2,"w1718","Motorized",11,"Thu","weekday"
"1888",2018-03-22,"Slate River Rd","1","1","1",8.1,0,30,-2,36,27,2,-2,1,-1,0,-2,-1,-2,"w1718","Hybrid",10,"Thu","weekday"
"1889",2018-03-23,"Slate River Rd","2","2","3",8.2,0.1,29,-1,34,28.3,-2,2,-2,1,-3,-1,-3,-2,"w1718","Non.motorized",9,"Fri","weekday"
"1890",2018-03-23,"Slate River Rd","2","2","3",8.2,0.1,29,-1,34,28.3,-2,2,-2,1,-3,-1,-3,-2,"w1718","Mechanized",0,"Fri","weekday"
"1891",2018-03-23,"Slate River Rd","2","2","3",8.2,0.1,29,-1,34,28.3,-2,2,-2,1,-3,-1,-3,-2,"w1718","Motorized",2,"Fri","weekday"
"1892",2018-03-23,"Slate River Rd","2","2","3",8.2,0.1,29,-1,34,28.3,-2,2,-2,1,-3,-1,-3,-2,"w1718","Hybrid",2,"Fri","weekday"
"1893",2018-03-24,"Slate River Rd","2","2","1",8.9,0.7,34,5,32,26.2,-1,-2,2,-2,4,2,4,2,"w1718","Non.motorized",43,"Sat","weekend"
"1894",2018-03-24,"Slate River Rd","2","2","1",8.9,0.7,34,5,32,26.2,-1,-2,2,-2,4,2,4,2,"w1718","Mechanized",1,"Sat","weekend"
"1895",2018-03-24,"Slate River Rd","2","2","1",8.9,0.7,34,5,32,26.2,-1,-2,2,-2,4,2,4,2,"w1718","Motorized",3,"Sat","weekend"
"1896",2018-03-24,"Slate River Rd","2","2","1",8.9,0.7,34,5,32,26.2,-1,-2,2,-2,4,2,4,2,"w1718","Hybrid",3,"Sat","weekend"
"1897",2018-03-25,"Slate River Rd","2","2","1",8.9,0,35,1,35,25.4,5,-1,-2,2,6,5,3,5,"w1718","Non.motorized",44,"Sun","weekend"
"1898",2018-03-25,"Slate River Rd","2","2","1",8.9,0,35,1,35,25.4,5,-1,-2,2,6,5,3,5,"w1718","Mechanized",0,"Sun","weekend"
"1899",2018-03-25,"Slate River Rd","2","2","1",8.9,0,35,1,35,25.4,5,-1,-2,2,6,5,3,5,"w1718","Motorized",12,"Sun","weekend"
"1900",2018-03-25,"Slate River Rd","2","2","1",8.9,0,35,1,35,25.4,5,-1,-2,2,6,5,3,5,"w1718","Hybrid",9,"Sun","weekend"
"1901",2018-03-26,"Slate River Rd","1","1","1",8.9,0,34,-1,31,26.2,1,5,-1,-2,0,5,4,2,"w1718","Non.motorized",29,"Mon","weekday"
"1902",2018-03-26,"Slate River Rd","1","1","1",8.9,0,34,-1,31,26.2,1,5,-1,-2,0,5,4,2,"w1718","Mechanized",0,"Mon","weekday"
"1903",2018-03-26,"Slate River Rd","1","1","1",8.9,0,34,-1,31,26.2,1,5,-1,-2,0,5,4,2,"w1718","Motorized",1,"Mon","weekday"
"1904",2018-03-26,"Slate River Rd","1","1","1",8.9,0,34,-1,31,26.2,1,5,-1,-2,0,5,4,2,"w1718","Hybrid",1,"Mon","weekday"
"1905",2018-03-26,"Slate River Rd","2","1","1",8.9,0,34,-1,31,26.2,1,5,-1,-2,0,5,4,2,"w1718","Non.motorized",29,"Mon","weekday"
"1906",2018-03-26,"Slate River Rd","2","1","1",8.9,0,34,-1,31,26.2,1,5,-1,-2,0,5,4,2,"w1718","Mechanized",0,"Mon","weekday"
"1907",2018-03-26,"Slate River Rd","2","1","1",8.9,0,34,-1,31,26.2,1,5,-1,-2,0,5,4,2,"w1718","Motorized",1,"Mon","weekday"
"1908",2018-03-26,"Slate River Rd","2","1","1",8.9,0,34,-1,31,26.2,1,5,-1,-2,0,5,4,2,"w1718","Hybrid",1,"Mon","weekday"
"1909",2018-03-27,"Slate River Rd","1","1","1",8.9,0,33,-1,29,27,-1,1,5,-1,-2,-1,4,3,"w1718","Non.motorized",30,"Tue","weekday"
"1910",2018-03-27,"Slate River Rd","1","1","1",8.9,0,33,-1,29,27,-1,1,5,-1,-2,-1,4,3,"w1718","Mechanized",0,"Tue","weekday"
"1911",2018-03-27,"Slate River Rd","1","1","1",8.9,0,33,-1,29,27,-1,1,5,-1,-2,-1,4,3,"w1718","Motorized",3,"Tue","weekday"
"1912",2018-03-27,"Slate River Rd","1","1","1",8.9,0,33,-1,29,27,-1,1,5,-1,-2,-1,4,3,"w1718","Hybrid",1,"Tue","weekday"
"1913",2018-03-28,"Slate River Rd","1","1","1",8.9,0,33,0,27,27,-1,-1,1,5,-1,-2,-1,4,"w1718","Non.motorized",21,"Wed","weekday"
"1914",2018-03-28,"Slate River Rd","1","1","1",8.9,0,33,0,27,27,-1,-1,1,5,-1,-2,-1,4,"w1718","Mechanized",0,"Wed","weekday"
"1915",2018-03-28,"Slate River Rd","1","1","1",8.9,0,33,0,27,27,-1,-1,1,5,-1,-2,-1,4,"w1718","Motorized",5,"Wed","weekday"
"1916",2018-03-28,"Slate River Rd","1","1","1",8.9,0,33,0,27,27,-1,-1,1,5,-1,-2,-1,4,"w1718","Hybrid",5,"Wed","weekday"
"1917",2018-03-29,"Slate River Rd","1","1","1",8.9,0,33,0,27,27,0,-1,-1,1,0,-1,-2,-1,"w1718","Non.motorized",33,"Thu","weekday"
"1918",2018-03-29,"Slate River Rd","1","1","1",8.9,0,33,0,27,27,0,-1,-1,1,0,-1,-2,-1,"w1718","Mechanized",0,"Thu","weekday"
"1919",2018-03-29,"Slate River Rd","1","1","1",8.9,0,33,0,27,27,0,-1,-1,1,0,-1,-2,-1,"w1718","Motorized",5,"Thu","weekday"
"1920",2018-03-29,"Slate River Rd","1","1","1",8.9,0,33,0,27,27,0,-1,-1,1,0,-1,-2,-1,"w1718","Hybrid",5,"Thu","weekday"
"1921",2018-03-30,"Slate River Rd","1","1","1",8.9,0,32,-1,33,27.8,0,0,-1,-1,-1,-1,-2,-3,"w1718","Non.motorized",22,"Fri","weekday"
"1922",2018-03-30,"Slate River Rd","1","1","1",8.9,0,32,-1,33,27.8,0,0,-1,-1,-1,-1,-2,-3,"w1718","Mechanized",0,"Fri","weekday"
"1923",2018-03-30,"Slate River Rd","1","1","1",8.9,0,32,-1,33,27.8,0,0,-1,-1,-1,-1,-2,-3,"w1718","Motorized",7,"Fri","weekday"
"1924",2018-03-30,"Slate River Rd","1","1","1",8.9,0,32,-1,33,27.8,0,0,-1,-1,-1,-1,-2,-3,"w1718","Hybrid",7,"Fri","weekday"
"1925",2018-03-31,"Slate River Rd","1","1","1",8.9,0,32,0,39,27.8,-1,0,0,-1,-1,-1,-1,-2,"w1718","Non.motorized",34,"Sat","weekend"
"1926",2018-03-31,"Slate River Rd","1","1","1",8.9,0,32,0,39,27.8,-1,0,0,-1,-1,-1,-1,-2,"w1718","Mechanized",0,"Sat","weekend"
"1927",2018-03-31,"Slate River Rd","1","1","1",8.9,0,32,0,39,27.8,-1,0,0,-1,-1,-1,-1,-2,"w1718","Motorized",4,"Sat","weekend"
"1928",2018-03-31,"Slate River Rd","1","1","1",8.9,0,32,0,39,27.8,-1,0,0,-1,-1,-1,-1,-2,"w1718","Hybrid",4,"Sat","weekend"
"1929",2018-04-01,"Slate River Rd","1","1","1",8.8,-0.1,30,-2,41,29.3,0,-1,0,0,-2,-3,-3,-3,"w1718","Non.motorized",12,"Sun","weekend"
"1930",2018-04-01,"Slate River Rd","1","1","1",8.8,-0.1,30,-2,41,29.3,0,-1,0,0,-2,-3,-3,-3,"w1718","Mechanized",0,"Sun","weekend"
"1931",2018-04-01,"Slate River Rd","1","1","1",8.8,-0.1,30,-2,41,29.3,0,-1,0,0,-2,-3,-3,-3,"w1718","Motorized",7,"Sun","weekend"
"1932",2018-04-01,"Slate River Rd","1","1","1",8.8,-0.1,30,-2,41,29.3,0,-1,0,0,-2,-3,-3,-3,"w1718","Hybrid",7,"Sun","weekend"
"1933",2018-04-02,"Slate River Rd","1","1","1",8.7,-0.1,29,-1,39,30,-2,0,-1,0,-3,-3,-4,-4,"w1718","Non.motorized",9,"Mon","weekday"
"1934",2018-04-02,"Slate River Rd","1","1","1",8.7,-0.1,29,-1,39,30,-2,0,-1,0,-3,-3,-4,-4,"w1718","Mechanized",0,"Mon","weekday"
"1935",2018-04-02,"Slate River Rd","1","1","1",8.7,-0.1,29,-1,39,30,-2,0,-1,0,-3,-3,-4,-4,"w1718","Motorized",3,"Mon","weekday"
"1936",2018-04-02,"Slate River Rd","1","1","1",8.7,-0.1,29,-1,39,30,-2,0,-1,0,-3,-3,-4,-4,"w1718","Hybrid",2,"Mon","weekday"
"1937",2018-04-03,"Slate River Rd","1","1","1",8.8,0.1,30,1,27,29.3,-1,-2,0,-1,0,-2,-2,-3,"w1718","Non.motorized",7,"Tue","weekday"
"1938",2018-04-03,"Slate River Rd","1","1","1",8.8,0.1,30,1,27,29.3,-1,-2,0,-1,0,-2,-2,-3,"w1718","Mechanized",0,"Tue","weekday"
"1939",2018-04-03,"Slate River Rd","1","1","1",8.8,0.1,30,1,27,29.3,-1,-2,0,-1,0,-2,-2,-3,"w1718","Motorized",7,"Tue","weekday"
"1940",2018-04-03,"Slate River Rd","1","1","1",8.8,0.1,30,1,27,29.3,-1,-2,0,-1,0,-2,-2,-3,"w1718","Hybrid",5,"Tue","weekday"
"1941",2018-04-04,"Slate River Rd","1","2","2",8.9,0.1,28,-2,33,31.8,1,-1,-2,0,-1,-2,-4,-4,"w1718","Non.motorized",6,"Wed","weekday"
"1942",2018-04-04,"Slate River Rd","1","2","2",8.9,0.1,28,-2,33,31.8,1,-1,-2,0,-1,-2,-4,-4,"w1718","Mechanized",1,"Wed","weekday"
"1943",2018-04-04,"Slate River Rd","1","2","2",8.9,0.1,28,-2,33,31.8,1,-1,-2,0,-1,-2,-4,-4,"w1718","Motorized",3,"Wed","weekday"
"1944",2018-04-04,"Slate River Rd","1","2","2",8.9,0.1,28,-2,33,31.8,1,-1,-2,0,-1,-2,-4,-4,"w1718","Hybrid",2,"Wed","weekday"
"1945",2018-04-05,"Slate River Rd","1","2","2",8.9,0,27,-1,35,33,-2,1,-1,-2,-3,-2,-3,-5,"w1718","Non.motorized",11,"Thu","weekday"
"1946",2018-04-05,"Slate River Rd","1","2","2",8.9,0,27,-1,35,33,-2,1,-1,-2,-3,-2,-3,-5,"w1718","Mechanized",0,"Thu","weekday"
"1947",2018-04-05,"Slate River Rd","1","2","2",8.9,0,27,-1,35,33,-2,1,-1,-2,-3,-2,-3,-5,"w1718","Motorized",2,"Thu","weekday"
"1948",2018-04-05,"Slate River Rd","1","2","2",8.9,0,27,-1,35,33,-2,1,-1,-2,-3,-2,-3,-5,"w1718","Hybrid",2,"Thu","weekday"
"1949",2018-04-06,"Slate River Rd","1","2","2",8.9,0,25,-2,35,35.6,-1,-2,1,-1,-3,-5,-4,-5,"w1718","Non.motorized",7,"Fri","weekday"
"1950",2018-04-06,"Slate River Rd","1","2","2",8.9,0,25,-2,35,35.6,-1,-2,1,-1,-3,-5,-4,-5,"w1718","Mechanized",0,"Fri","weekday"
"1951",2018-04-06,"Slate River Rd","1","2","2",8.9,0,25,-2,35,35.6,-1,-2,1,-1,-3,-5,-4,-5,"w1718","Motorized",5,"Fri","weekday"
"1952",2018-04-06,"Slate River Rd","1","2","2",8.9,0,25,-2,35,35.6,-1,-2,1,-1,-3,-5,-4,-5,"w1718","Hybrid",5,"Fri","weekday"
"1953",2018-04-07,"Slate River Rd","2","2","2",9.2,0.3,31,6,37,29.7,-2,-1,-2,1,4,3,1,2,"w1718","Non.motorized",10,"Sat","weekend"
"1954",2018-04-07,"Slate River Rd","2","2","2",9.2,0.3,31,6,37,29.7,-2,-1,-2,1,4,3,1,2,"w1718","Mechanized",0,"Sat","weekend"
"1955",2018-04-07,"Slate River Rd","2","2","2",9.2,0.3,31,6,37,29.7,-2,-1,-2,1,4,3,1,2,"w1718","Motorized",2,"Sat","weekend"
"1956",2018-04-07,"Slate River Rd","2","2","2",9.2,0.3,31,6,37,29.7,-2,-1,-2,1,4,3,1,2,"w1718","Hybrid",2,"Sat","weekend"
"1957",2018-04-08,"Slate River Rd","3","3","3",10,0.8,33,2,33,30.3,6,-2,-1,-2,8,6,5,3,"w1718","Non.motorized",7,"Sun","weekend"
"1958",2018-04-08,"Slate River Rd","3","3","3",10,0.8,33,2,33,30.3,6,-2,-1,-2,8,6,5,3,"w1718","Mechanized",0,"Sun","weekend"
"1959",2018-04-08,"Slate River Rd","3","3","3",10,0.8,33,2,33,30.3,6,-2,-1,-2,8,6,5,3,"w1718","Motorized",1,"Sun","weekend"
"1960",2018-04-08,"Slate River Rd","3","3","3",10,0.8,33,2,33,30.3,6,-2,-1,-2,8,6,5,3,"w1718","Hybrid",1,"Sun","weekend"
"1961",2018-04-09,"Slate River Rd","1","1","1",10.1,0.1,33,0,31,30.6,2,6,-2,-1,2,8,6,5,"w1718","Non.motorized",7,"Mon","weekday"
"1962",2018-04-09,"Slate River Rd","1","1","1",10.1,0.1,33,0,31,30.6,2,6,-2,-1,2,8,6,5,"w1718","Mechanized",0,"Mon","weekday"
"1963",2018-04-09,"Slate River Rd","1","1","1",10.1,0.1,33,0,31,30.6,2,6,-2,-1,2,8,6,5,"w1718","Motorized",0,"Mon","weekday"
"1964",2018-04-09,"Slate River Rd","1","1","1",10.1,0.1,33,0,31,30.6,2,6,-2,-1,2,8,6,5,"w1718","Hybrid",0,"Mon","weekday"
"1965",2018-04-10,"Slate River Rd","1","1","1",10.1,0,31,-2,38,32.6,0,2,6,-2,-2,0,6,4,"w1718","Non.motorized",10,"Tue","weekday"
"1966",2018-04-10,"Slate River Rd","1","1","1",10.1,0,31,-2,38,32.6,0,2,6,-2,-2,0,6,4,"w1718","Mechanized",0,"Tue","weekday"
"1967",2018-04-10,"Slate River Rd","1","1","1",10.1,0,31,-2,38,32.6,0,2,6,-2,-2,0,6,4,"w1718","Motorized",5,"Tue","weekday"
"1968",2018-04-10,"Slate River Rd","1","1","1",10.1,0,31,-2,38,32.6,0,2,6,-2,-2,0,6,4,"w1718","Hybrid",3,"Tue","weekday"
"1969",2018-04-11,"Slate River Rd","2","2","2",9.9,-0.2,29,-2,45,34.1,-2,0,2,6,-4,-4,-2,4,"w1718","Non.motorized",11,"Wed","weekday"
"1970",2018-04-11,"Slate River Rd","2","2","2",9.9,-0.2,29,-2,45,34.1,-2,0,2,6,-4,-4,-2,4,"w1718","Mechanized",0,"Wed","weekday"
"1971",2018-04-11,"Slate River Rd","2","2","2",9.9,-0.2,29,-2,45,34.1,-2,0,2,6,-4,-4,-2,4,"w1718","Motorized",3,"Wed","weekday"
"1972",2018-04-11,"Slate River Rd","2","2","2",9.9,-0.2,29,-2,45,34.1,-2,0,2,6,-4,-4,-2,4,"w1718","Hybrid",2,"Wed","weekday"
"1973",2018-04-12,"Slate River Rd","1","2","2",9.5,-0.4,28,-1,40,33.9,-2,-2,0,2,-3,-5,-5,-3,"w1718","Non.motorized",1,"Thu","weekday"
"1974",2018-04-12,"Slate River Rd","1","2","2",9.5,-0.4,28,-1,40,33.9,-2,-2,0,2,-3,-5,-5,-3,"w1718","Mechanized",0,"Thu","weekday"
"1975",2018-04-12,"Slate River Rd","1","2","2",9.5,-0.4,28,-1,40,33.9,-2,-2,0,2,-3,-5,-5,-3,"w1718","Motorized",0,"Thu","weekday"
"1976",2018-04-12,"Slate River Rd","1","2","2",9.5,-0.4,28,-1,40,33.9,-2,-2,0,2,-3,-5,-5,-3,"w1718","Hybrid",0,"Thu","weekday"
"1977",2018-04-13,"Slate River Rd","2","2","1",9.4,-0.1,26,-2,23,36.2,-1,-2,-2,0,-3,-5,-7,-7,"w1718","Non.motorized",9,"Fri","weekday"
"1978",2018-04-13,"Slate River Rd","2","2","1",9.4,-0.1,26,-2,23,36.2,-1,-2,-2,0,-3,-5,-7,-7,"w1718","Mechanized",0,"Fri","weekday"
"1979",2018-04-13,"Slate River Rd","2","2","1",9.4,-0.1,26,-2,23,36.2,-1,-2,-2,0,-3,-5,-7,-7,"w1718","Motorized",8,"Fri","weekday"
"1980",2018-04-13,"Slate River Rd","2","2","1",9.4,-0.1,26,-2,23,36.2,-1,-2,-2,0,-3,-5,-7,-7,"w1718","Hybrid",0,"Fri","weekday"
"1981",2018-04-14,"Slate River Rd","2","2","1",9.4,0,28,2,28,33.6,-2,-1,-2,-2,0,-1,-3,-5,"w1718","Non.motorized",20,"Sat","weekend"
"1982",2018-04-14,"Slate River Rd","2","2","1",9.4,0,28,2,28,33.6,-2,-1,-2,-2,0,-1,-3,-5,"w1718","Mechanized",0,"Sat","weekend"
"1983",2018-04-14,"Slate River Rd","2","2","1",9.4,0,28,2,28,33.6,-2,-1,-2,-2,0,-1,-3,-5,"w1718","Motorized",9,"Sat","weekend"
"1984",2018-04-14,"Slate River Rd","2","2","1",9.4,0,28,2,28,33.6,-2,-1,-2,-2,0,-1,-3,-5,"w1718","Hybrid",5,"Sat","weekend"
"1985",2018-04-15,"Slate River Rd","2","2","1",9.2,-0.2,27,-1,37,34.1,2,-2,-1,-2,1,-1,-2,-4,"w1718","Non.motorized",10,"Sun","weekend"
"1986",2018-04-15,"Slate River Rd","2","2","1",9.2,-0.2,27,-1,37,34.1,2,-2,-1,-2,1,-1,-2,-4,"w1718","Mechanized",2,"Sun","weekend"
"1987",2018-04-15,"Slate River Rd","2","2","1",9.2,-0.2,27,-1,37,34.1,2,-2,-1,-2,1,-1,-2,-4,"w1718","Motorized",7,"Sun","weekend"
"1988",2018-04-15,"Slate River Rd","2","2","1",9.2,-0.2,27,-1,37,34.1,2,-2,-1,-2,1,-1,-2,-4,"w1718","Hybrid",2,"Sun","weekend"
"1989",2018-04-16,"Slate River Rd",NA,NA,NA,8.9,-0.3,24,-3,43,37.1,-1,2,-2,-1,-4,-2,-4,-5,"w1718","Non.motorized",5,"Mon","weekday"
"1990",2018-04-16,"Slate River Rd",NA,NA,NA,8.9,-0.3,24,-3,43,37.1,-1,2,-2,-1,-4,-2,-4,-5,"w1718","Mechanized",0,"Mon","weekday"
"1991",2018-04-16,"Slate River Rd",NA,NA,NA,8.9,-0.3,24,-3,43,37.1,-1,2,-2,-1,-4,-2,-4,-5,"w1718","Motorized",3,"Mon","weekday"
"1992",2018-04-16,"Slate River Rd",NA,NA,NA,8.9,-0.3,24,-3,43,37.1,-1,2,-2,-1,-4,-2,-4,-5,"w1718","Hybrid",2,"Mon","weekday"
"1993",2017-12-22,"Snodgrass","2","2","1",2,0,11,3,17,18.2,0,0,0,0,3,3,3,3,"w1718","Non.motorized",0,"Fri","weekday"
"1994",2017-12-22,"Snodgrass","2","2","1",2,0,11,3,17,18.2,0,0,0,0,3,3,3,3,"w1718","Mechanized",0,"Fri","weekday"
"1995",2017-12-22,"Snodgrass","2","2","1",2,0,11,3,17,18.2,0,0,0,0,3,3,3,3,"w1718","Motorized",0,"Fri","weekday"
"1996",2017-12-22,"Snodgrass","2","2","1",2,0,11,3,17,18.2,0,0,0,0,3,3,3,3,"w1718","Hybrid",NA,"Fri","weekday"
"1997",2017-12-23,"Snodgrass","2","1","1",2.1,0.1,10,-1,21,21,3,0,0,0,2,2,2,2,"w1718","Non.motorized",0,"Sat","weekend"
"1998",2017-12-23,"Snodgrass","2","1","1",2.1,0.1,10,-1,21,21,3,0,0,0,2,2,2,2,"w1718","Mechanized",0,"Sat","weekend"
"1999",2017-12-23,"Snodgrass","2","1","1",2.1,0.1,10,-1,21,21,3,0,0,0,2,2,2,2,"w1718","Motorized",0,"Sat","weekend"
"2000",2017-12-23,"Snodgrass","2","1","1",2.1,0.1,10,-1,21,21,3,0,0,0,2,2,2,2,"w1718","Hybrid",NA,"Sat","weekend"
"2001",2017-12-24,"Snodgrass","1","1","1",2.4,0.3,14,4,19,17.1,-1,3,0,0,3,6,6,6,"w1718","Non.motorized",0,"Sun","weekend"
"2002",2017-12-24,"Snodgrass","1","1","1",2.4,0.3,14,4,19,17.1,-1,3,0,0,3,6,6,6,"w1718","Mechanized",0,"Sun","weekend"
"2003",2017-12-24,"Snodgrass","1","1","1",2.4,0.3,14,4,19,17.1,-1,3,0,0,3,6,6,6,"w1718","Motorized",0,"Sun","weekend"
"2004",2017-12-24,"Snodgrass","1","1","1",2.4,0.3,14,4,19,17.1,-1,3,0,0,3,6,6,6,"w1718","Hybrid",NA,"Sun","weekend"
"2005",2017-12-25,"Snodgrass","2","1","1",2.6,0.2,14,0,25,18.6,4,-1,3,0,4,3,6,6,"w1718","Non.motorized",40,"Mon","weekday"
"2006",2017-12-25,"Snodgrass","2","1","1",2.6,0.2,14,0,25,18.6,4,-1,3,0,4,3,6,6,"w1718","Mechanized",0,"Mon","weekday"
"2007",2017-12-25,"Snodgrass","2","1","1",2.6,0.2,14,0,25,18.6,4,-1,3,0,4,3,6,6,"w1718","Motorized",2,"Mon","weekday"
"2008",2017-12-25,"Snodgrass","2","1","1",2.6,0.2,14,0,25,18.6,4,-1,3,0,4,3,6,6,"w1718","Hybrid",NA,"Mon","weekday"
"2009",2017-12-26,"Snodgrass","1","1","1",3.1,0.5,20,6,25,15.5,0,4,-1,3,6,10,9,12,"w1718","Non.motorized",51,"Tue","weekday"
"2010",2017-12-26,"Snodgrass","1","1","1",3.1,0.5,20,6,25,15.5,0,4,-1,3,6,10,9,12,"w1718","Mechanized",0,"Tue","weekday"
"2011",2017-12-26,"Snodgrass","1","1","1",3.1,0.5,20,6,25,15.5,0,4,-1,3,6,10,9,12,"w1718","Motorized",4,"Tue","weekday"
"2012",2017-12-26,"Snodgrass","1","1","1",3.1,0.5,20,6,25,15.5,0,4,-1,3,6,10,9,12,"w1718","Hybrid",NA,"Tue","weekday"
"2013",2017-12-27,"Snodgrass","1","1","1",3.1,0,18,-2,27,17.2,6,0,4,-1,4,4,8,7,"w1718","Non.motorized",97,"Wed","weekday"
"2014",2017-12-27,"Snodgrass","1","1","1",3.1,0,18,-2,27,17.2,6,0,4,-1,4,4,8,7,"w1718","Mechanized",1,"Wed","weekday"
"2015",2017-12-27,"Snodgrass","1","1","1",3.1,0,18,-2,27,17.2,6,0,4,-1,4,4,8,7,"w1718","Motorized",2,"Wed","weekday"
"2016",2017-12-27,"Snodgrass","1","1","1",3.1,0,18,-2,27,17.2,6,0,4,-1,4,4,8,7,"w1718","Hybrid",NA,"Wed","weekday"
"2017",2017-12-28,"Snodgrass","1","1","1",3.2,0.1,17,-1,31,18.8,-2,6,0,4,-3,3,3,7,"w1718","Non.motorized",NA,"Thu","weekday"
"2018",2017-12-28,"Snodgrass","1","1","1",3.2,0.1,17,-1,31,18.8,-2,6,0,4,-3,3,3,7,"w1718","Mechanized",NA,"Thu","weekday"
"2019",2017-12-28,"Snodgrass","1","1","1",3.2,0.1,17,-1,31,18.8,-2,6,0,4,-3,3,3,7,"w1718","Motorized",NA,"Thu","weekday"
"2020",2017-12-28,"Snodgrass","1","1","1",3.2,0.1,17,-1,31,18.8,-2,6,0,4,-3,3,3,7,"w1718","Hybrid",NA,"Thu","weekday"
"2021",2017-12-29,"Snodgrass","1","1","1",3.2,0,17,0,36,18.8,-1,-2,6,0,-1,-3,3,3,"w1718","Non.motorized",NA,"Fri","weekday"
"2022",2017-12-29,"Snodgrass","1","1","1",3.2,0,17,0,36,18.8,-1,-2,6,0,-1,-3,3,3,"w1718","Mechanized",NA,"Fri","weekday"
"2023",2017-12-29,"Snodgrass","1","1","1",3.2,0,17,0,36,18.8,-1,-2,6,0,-1,-3,3,3,"w1718","Motorized",NA,"Fri","weekday"
"2024",2017-12-29,"Snodgrass","1","1","1",3.2,0,17,0,36,18.8,-1,-2,6,0,-1,-3,3,3,"w1718","Hybrid",NA,"Fri","weekday"
"2025",2017-12-30,"Snodgrass","1","1","1",3.2,0,15,-2,37,21.3,0,-1,-2,6,-2,-3,-5,1,"w1718","Non.motorized",NA,"Sat","weekend"
"2026",2017-12-30,"Snodgrass","1","1","1",3.2,0,15,-2,37,21.3,0,-1,-2,6,-2,-3,-5,1,"w1718","Mechanized",NA,"Sat","weekend"
"2027",2017-12-30,"Snodgrass","1","1","1",3.2,0,15,-2,37,21.3,0,-1,-2,6,-2,-3,-5,1,"w1718","Motorized",NA,"Sat","weekend"
"2028",2017-12-30,"Snodgrass","1","1","1",3.2,0,15,-2,37,21.3,0,-1,-2,6,-2,-3,-5,1,"w1718","Hybrid",NA,"Sat","weekend"
"2029",2017-12-31,"Snodgrass","1","1","1",3.2,0,15,0,31,21.3,-2,0,-1,-2,-2,-2,-3,-5,"w1718","Non.motorized",NA,"Sun","weekend"
"2030",2017-12-31,"Snodgrass","1","1","1",3.2,0,15,0,31,21.3,-2,0,-1,-2,-2,-2,-3,-5,"w1718","Mechanized",NA,"Sun","weekend"
"2031",2017-12-31,"Snodgrass","1","1","1",3.2,0,15,0,31,21.3,-2,0,-1,-2,-2,-2,-3,-5,"w1718","Motorized",NA,"Sun","weekend"
"2032",2017-12-31,"Snodgrass","1","1","1",3.2,0,15,0,31,21.3,-2,0,-1,-2,-2,-2,-3,-5,"w1718","Hybrid",NA,"Sun","weekend"
"2033",2018-01-01,"Snodgrass","1","1","1",3.2,0,15,0,27,21.3,0,-2,0,-1,0,-2,-2,-3,"w1718","Non.motorized",NA,"Mon","weekday"
"2034",2018-01-01,"Snodgrass","1","1","1",3.2,0,15,0,27,21.3,0,-2,0,-1,0,-2,-2,-3,"w1718","Mechanized",NA,"Mon","weekday"
"2035",2018-01-01,"Snodgrass","1","1","1",3.2,0,15,0,27,21.3,0,-2,0,-1,0,-2,-2,-3,"w1718","Motorized",NA,"Mon","weekday"
"2036",2018-01-01,"Snodgrass","1","1","1",3.2,0,15,0,27,21.3,0,-2,0,-1,0,-2,-2,-3,"w1718","Hybrid",NA,"Mon","weekday"
"2037",2018-01-02,"Snodgrass","1","1","1",3.2,0,15,0,22,21.3,0,0,-2,0,0,0,-2,-2,"w1718","Non.motorized",NA,"Tue","weekday"
"2038",2018-01-02,"Snodgrass","1","1","1",3.2,0,15,0,22,21.3,0,0,-2,0,0,0,-2,-2,"w1718","Mechanized",NA,"Tue","weekday"
"2039",2018-01-02,"Snodgrass","1","1","1",3.2,0,15,0,22,21.3,0,0,-2,0,0,0,-2,-2,"w1718","Motorized",NA,"Tue","weekday"
"2040",2018-01-02,"Snodgrass","1","1","1",3.2,0,15,0,22,21.3,0,0,-2,0,0,0,-2,-2,"w1718","Hybrid",NA,"Tue","weekday"
"2041",2018-01-03,"Snodgrass","1","1","1",3.2,0,15,0,27,21.3,0,0,0,-2,0,0,0,-2,"w1718","Non.motorized",NA,"Wed","weekday"
"2042",2018-01-03,"Snodgrass","1","1","1",3.2,0,15,0,27,21.3,0,0,0,-2,0,0,0,-2,"w1718","Mechanized",NA,"Wed","weekday"
"2043",2018-01-03,"Snodgrass","1","1","1",3.2,0,15,0,27,21.3,0,0,0,-2,0,0,0,-2,"w1718","Motorized",NA,"Wed","weekday"
"2044",2018-01-03,"Snodgrass","1","1","1",3.2,0,15,0,27,21.3,0,0,0,-2,0,0,0,-2,"w1718","Hybrid",NA,"Wed","weekday"
"2045",2018-01-04,"Snodgrass","1","1","1",3.2,0,15,0,29,21.3,0,0,0,0,0,0,0,0,"w1718","Non.motorized",NA,"Thu","weekday"
"2046",2018-01-04,"Snodgrass","1","1","1",3.2,0,15,0,29,21.3,0,0,0,0,0,0,0,0,"w1718","Mechanized",NA,"Thu","weekday"
"2047",2018-01-04,"Snodgrass","1","1","1",3.2,0,15,0,29,21.3,0,0,0,0,0,0,0,0,"w1718","Motorized",NA,"Thu","weekday"
"2048",2018-01-04,"Snodgrass","1","1","1",3.2,0,15,0,29,21.3,0,0,0,0,0,0,0,0,"w1718","Hybrid",NA,"Thu","weekday"
"2049",2018-01-05,"Snodgrass","1","1","1",3.2,0,14,-1,32,22.9,0,0,0,0,-1,-1,-1,-1,"w1718","Non.motorized",NA,"Fri","weekday"
"2050",2018-01-05,"Snodgrass","1","1","1",3.2,0,14,-1,32,22.9,0,0,0,0,-1,-1,-1,-1,"w1718","Mechanized",NA,"Fri","weekday"
"2051",2018-01-05,"Snodgrass","1","1","1",3.2,0,14,-1,32,22.9,0,0,0,0,-1,-1,-1,-1,"w1718","Motorized",NA,"Fri","weekday"
"2052",2018-01-05,"Snodgrass","1","1","1",3.2,0,14,-1,32,22.9,0,0,0,0,-1,-1,-1,-1,"w1718","Hybrid",NA,"Fri","weekday"
"2053",2018-01-06,"Snodgrass","1","1","1",3.2,0,14,0,30,22.9,-1,0,0,0,-1,-1,-1,-1,"w1718","Non.motorized",NA,"Sat","weekend"
"2054",2018-01-06,"Snodgrass","1","1","1",3.2,0,14,0,30,22.9,-1,0,0,0,-1,-1,-1,-1,"w1718","Mechanized",NA,"Sat","weekend"
"2055",2018-01-06,"Snodgrass","1","1","1",3.2,0,14,0,30,22.9,-1,0,0,0,-1,-1,-1,-1,"w1718","Motorized",NA,"Sat","weekend"
"2056",2018-01-06,"Snodgrass","1","1","1",3.2,0,14,0,30,22.9,-1,0,0,0,-1,-1,-1,-1,"w1718","Hybrid",NA,"Sat","weekend"
"2057",2018-01-07,"Snodgrass","2","2","2",3.5,0.3,18,4,25,19.4,0,-1,0,0,4,3,3,3,"w1718","Non.motorized",NA,"Sun","weekend"
"2058",2018-01-07,"Snodgrass","2","2","2",3.5,0.3,18,4,25,19.4,0,-1,0,0,4,3,3,3,"w1718","Mechanized",NA,"Sun","weekend"
"2059",2018-01-07,"Snodgrass","2","2","2",3.5,0.3,18,4,25,19.4,0,-1,0,0,4,3,3,3,"w1718","Motorized",NA,"Sun","weekend"
"2060",2018-01-07,"Snodgrass","2","2","2",3.5,0.3,18,4,25,19.4,0,-1,0,0,4,3,3,3,"w1718","Hybrid",NA,"Sun","weekend"
"2061",2018-01-08,"Snodgrass","2","2","1",3.7,0.2,20,2,29,18.5,4,0,-1,0,6,6,5,5,"w1718","Non.motorized",NA,"Mon","weekday"
"2062",2018-01-08,"Snodgrass","2","2","1",3.7,0.2,20,2,29,18.5,4,0,-1,0,6,6,5,5,"w1718","Mechanized",NA,"Mon","weekday"
"2063",2018-01-08,"Snodgrass","2","2","1",3.7,0.2,20,2,29,18.5,4,0,-1,0,6,6,5,5,"w1718","Motorized",NA,"Mon","weekday"
"2064",2018-01-08,"Snodgrass","2","2","1",3.7,0.2,20,2,29,18.5,4,0,-1,0,6,6,5,5,"w1718","Hybrid",NA,"Mon","weekday"
"2065",2018-01-09,"Snodgrass","2","2","1",3.8,0.1,21,1,34,18.1,2,4,0,-1,3,7,7,6,"w1718","Non.motorized",7,"Tue","weekday"
"2066",2018-01-09,"Snodgrass","2","2","1",3.8,0.1,21,1,34,18.1,2,4,0,-1,3,7,7,6,"w1718","Mechanized",0,"Tue","weekday"
"2067",2018-01-09,"Snodgrass","2","2","1",3.8,0.1,21,1,34,18.1,2,4,0,-1,3,7,7,6,"w1718","Motorized",0,"Tue","weekday"
"2068",2018-01-09,"Snodgrass","2","2","1",3.8,0.1,21,1,34,18.1,2,4,0,-1,3,7,7,6,"w1718","Hybrid",NA,"Tue","weekday"
"2069",2018-01-10,"Snodgrass","3","3","3",4,0.2,21,0,28,19,1,2,4,0,1,3,7,7,"w1718","Non.motorized",73,"Wed","weekday"
"2070",2018-01-10,"Snodgrass","3","3","3",4,0.2,21,0,28,19,1,2,4,0,1,3,7,7,"w1718","Mechanized",0,"Wed","weekday"
"2071",2018-01-10,"Snodgrass","3","3","3",4,0.2,21,0,28,19,1,2,4,0,1,3,7,7,"w1718","Motorized",0,"Wed","weekday"
"2072",2018-01-10,"Snodgrass","3","3","3",4,0.2,21,0,28,19,1,2,4,0,1,3,7,7,"w1718","Hybrid",NA,"Wed","weekday"
"2073",2018-01-11,"Snodgrass","3","3","3",4.1,0.1,26,5,17,15.8,0,1,2,4,5,6,8,12,"w1718","Non.motorized",55,"Thu","weekday"
"2074",2018-01-11,"Snodgrass","3","3","3",4.1,0.1,26,5,17,15.8,0,1,2,4,5,6,8,12,"w1718","Mechanized",1,"Thu","weekday"
"2075",2018-01-11,"Snodgrass","3","3","3",4.1,0.1,26,5,17,15.8,0,1,2,4,5,6,8,12,"w1718","Motorized",0,"Thu","weekday"
"2076",2018-01-11,"Snodgrass","3","3","3",4.1,0.1,26,5,17,15.8,0,1,2,4,5,6,8,12,"w1718","Hybrid",NA,"Thu","weekday"
"2077",2018-01-12,"Snodgrass","3","3","3",4.3,0.2,24,-2,22,17.9,5,0,1,2,3,3,4,6,"w1718","Non.motorized",29,"Fri","weekday"
"2078",2018-01-12,"Snodgrass","3","3","3",4.3,0.2,24,-2,22,17.9,5,0,1,2,3,3,4,6,"w1718","Mechanized",0,"Fri","weekday"
"2079",2018-01-12,"Snodgrass","3","3","3",4.3,0.2,24,-2,22,17.9,5,0,1,2,3,3,4,6,"w1718","Motorized",0,"Fri","weekday"
"2080",2018-01-12,"Snodgrass","3","3","3",4.3,0.2,24,-2,22,17.9,5,0,1,2,3,3,4,6,"w1718","Hybrid",NA,"Fri","weekday"
"2081",2018-01-13,"Snodgrass","3","3","3",4.4,0.1,24,0,24,18.3,-2,5,0,1,-2,3,3,4,"w1718","Non.motorized",106,"Sat","weekend"
"2082",2018-01-13,"Snodgrass","3","3","3",4.4,0.1,24,0,24,18.3,-2,5,0,1,-2,3,3,4,"w1718","Mechanized",0,"Sat","weekend"
"2083",2018-01-13,"Snodgrass","3","3","3",4.4,0.1,24,0,24,18.3,-2,5,0,1,-2,3,3,4,"w1718","Motorized",3,"Sat","weekend"
"2084",2018-01-13,"Snodgrass","3","3","3",4.4,0.1,24,0,24,18.3,-2,5,0,1,-2,3,3,4,"w1718","Hybrid",NA,"Sat","weekend"
"2085",2018-01-14,"Snodgrass","3","3","2",4.4,0,24,0,27,18.3,0,-2,5,0,0,-2,3,3,"w1718","Non.motorized",151,"Sun","weekend"
"2086",2018-01-14,"Snodgrass","3","3","2",4.4,0,24,0,27,18.3,0,-2,5,0,0,-2,3,3,"w1718","Mechanized",2,"Sun","weekend"
"2087",2018-01-14,"Snodgrass","3","3","2",4.4,0,24,0,27,18.3,0,-2,5,0,0,-2,3,3,"w1718","Motorized",9,"Sun","weekend"
"2088",2018-01-14,"Snodgrass","3","3","2",4.4,0,24,0,27,18.3,0,-2,5,0,0,-2,3,3,"w1718","Hybrid",NA,"Sun","weekend"
"2089",2018-01-15,"Snodgrass","3","3","2",4.4,0,23,-1,27,19.1,0,0,-2,5,-1,-1,-3,2,"w1718","Non.motorized",94,"Mon","weekday"
"2090",2018-01-15,"Snodgrass","3","3","2",4.4,0,23,-1,27,19.1,0,0,-2,5,-1,-1,-3,2,"w1718","Mechanized",0,"Mon","weekday"
"2091",2018-01-15,"Snodgrass","3","3","2",4.4,0,23,-1,27,19.1,0,0,-2,5,-1,-1,-3,2,"w1718","Motorized",0,"Mon","weekday"
"2092",2018-01-15,"Snodgrass","3","3","2",4.4,0,23,-1,27,19.1,0,0,-2,5,-1,-1,-3,2,"w1718","Hybrid",NA,"Mon","weekday"
"2093",2018-01-16,"Snodgrass","3","3","2",4.4,0,22,-1,20,20,-1,0,0,-2,-2,-2,-2,-4,"w1718","Non.motorized",32,"Tue","weekday"
"2094",2018-01-16,"Snodgrass","3","3","2",4.4,0,22,-1,20,20,-1,0,0,-2,-2,-2,-2,-4,"w1718","Mechanized",0,"Tue","weekday"
"2095",2018-01-16,"Snodgrass","3","3","2",4.4,0,22,-1,20,20,-1,0,0,-2,-2,-2,-2,-4,"w1718","Motorized",0,"Tue","weekday"
"2096",2018-01-16,"Snodgrass","3","3","2",4.4,0,22,-1,20,20,-1,0,0,-2,-2,-2,-2,-4,"w1718","Hybrid",NA,"Tue","weekday"
"2097",2018-01-17,"Snodgrass","2","2","2",4.4,0,22,0,24,20,-1,-1,0,0,-1,-2,-2,-2,"w1718","Non.motorized",70,"Wed","weekday"
"2098",2018-01-17,"Snodgrass","2","2","2",4.4,0,22,0,24,20,-1,-1,0,0,-1,-2,-2,-2,"w1718","Mechanized",0,"Wed","weekday"
"2099",2018-01-17,"Snodgrass","2","2","2",4.4,0,22,0,24,20,-1,-1,0,0,-1,-2,-2,-2,"w1718","Motorized",1,"Wed","weekday"
"2100",2018-01-17,"Snodgrass","2","2","2",4.4,0,22,0,24,20,-1,-1,0,0,-1,-2,-2,-2,"w1718","Hybrid",NA,"Wed","weekday"
"2101",2018-01-18,"Snodgrass","2","2","2",4.4,0,21,-1,29,21,0,-1,-1,0,-1,-2,-3,-3,"w1718","Non.motorized",88,"Thu","weekday"
"2102",2018-01-18,"Snodgrass","2","2","2",4.4,0,21,-1,29,21,0,-1,-1,0,-1,-2,-3,-3,"w1718","Mechanized",2,"Thu","weekday"
"2103",2018-01-18,"Snodgrass","2","2","2",4.4,0,21,-1,29,21,0,-1,-1,0,-1,-2,-3,-3,"w1718","Motorized",0,"Thu","weekday"
"2104",2018-01-18,"Snodgrass","2","2","2",4.4,0,21,-1,29,21,0,-1,-1,0,-1,-2,-3,-3,"w1718","Hybrid",NA,"Thu","weekday"
"2105",2018-01-19,"Snodgrass","2","2","2",4.5,0.1,21,0,34,21.4,-1,0,-1,-1,-1,-1,-2,-3,"w1718","Non.motorized",84,"Fri","weekday"
"2106",2018-01-19,"Snodgrass","2","2","2",4.5,0.1,21,0,34,21.4,-1,0,-1,-1,-1,-1,-2,-3,"w1718","Mechanized",1,"Fri","weekday"
"2107",2018-01-19,"Snodgrass","2","2","2",4.5,0.1,21,0,34,21.4,-1,0,-1,-1,-1,-1,-2,-3,"w1718","Motorized",4,"Fri","weekday"
"2108",2018-01-19,"Snodgrass","2","2","2",4.5,0.1,21,0,34,21.4,-1,0,-1,-1,-1,-1,-2,-3,"w1718","Hybrid",NA,"Fri","weekday"
"2109",2018-01-20,"Snodgrass","2","2","2",4.5,0,21,0,32,21.4,0,-1,0,-1,0,-1,-1,-2,"w1718","Non.motorized",118,"Sat","weekend"
"2110",2018-01-20,"Snodgrass","2","2","2",4.5,0,21,0,32,21.4,0,-1,0,-1,0,-1,-1,-2,"w1718","Mechanized",5,"Sat","weekend"
"2111",2018-01-20,"Snodgrass","2","2","2",4.5,0,21,0,32,21.4,0,-1,0,-1,0,-1,-1,-2,"w1718","Motorized",1,"Sat","weekend"
"2112",2018-01-20,"Snodgrass","2","2","2",4.5,0,21,0,32,21.4,0,-1,0,-1,0,-1,-1,-2,"w1718","Hybrid",NA,"Sat","weekend"
"2113",2018-01-21,"Snodgrass","3","3","3",4.6,0.1,23,2,15,20,0,0,-1,0,2,2,1,1,"w1718","Non.motorized",10,"Sun","weekend"
"2114",2018-01-21,"Snodgrass","3","3","3",4.6,0.1,23,2,15,20,0,0,-1,0,2,2,1,1,"w1718","Mechanized",2,"Sun","weekend"
"2115",2018-01-21,"Snodgrass","3","3","3",4.6,0.1,23,2,15,20,0,0,-1,0,2,2,1,1,"w1718","Motorized",1,"Sun","weekend"
"2116",2018-01-21,"Snodgrass","3","3","3",4.6,0.1,23,2,15,20,0,0,-1,0,2,2,1,1,"w1718","Hybrid",NA,"Sun","weekend"
"2117",2018-01-22,"Snodgrass","3","3","3",4.6,0,21,-2,12,21.9,2,0,0,-1,0,0,0,-1,"w1718","Non.motorized",55,"Mon","weekday"
"2118",2018-01-22,"Snodgrass","3","3","3",4.6,0,21,-2,12,21.9,2,0,0,-1,0,0,0,-1,"w1718","Mechanized",1,"Mon","weekday"
"2119",2018-01-22,"Snodgrass","3","3","3",4.6,0,21,-2,12,21.9,2,0,0,-1,0,0,0,-1,"w1718","Motorized",1,"Mon","weekday"
"2120",2018-01-22,"Snodgrass","3","3","3",4.6,0,21,-2,12,21.9,2,0,0,-1,0,0,0,-1,"w1718","Hybrid",NA,"Mon","weekday"
"2121",2018-01-23,"Snodgrass","3","3","3",4.6,0,22,1,16,20.9,-2,2,0,0,-1,1,1,1,"w1718","Non.motorized",41,"Tue","weekday"
"2122",2018-01-23,"Snodgrass","3","3","3",4.6,0,22,1,16,20.9,-2,2,0,0,-1,1,1,1,"w1718","Mechanized",2,"Tue","weekday"
"2123",2018-01-23,"Snodgrass","3","3","3",4.6,0,22,1,16,20.9,-2,2,0,0,-1,1,1,1,"w1718","Motorized",6,"Tue","weekday"
"2124",2018-01-23,"Snodgrass","3","3","3",4.6,0,22,1,16,20.9,-2,2,0,0,-1,1,1,1,"w1718","Hybrid",NA,"Tue","weekday"
"2125",2018-01-24,"Snodgrass","2","2","2",4.6,0,22,0,22,20.9,1,-2,2,0,1,-1,1,1,"w1718","Non.motorized",62,"Wed","weekday"
"2126",2018-01-24,"Snodgrass","2","2","2",4.6,0,22,0,22,20.9,1,-2,2,0,1,-1,1,1,"w1718","Mechanized",1,"Wed","weekday"
"2127",2018-01-24,"Snodgrass","2","2","2",4.6,0,22,0,22,20.9,1,-2,2,0,1,-1,1,1,"w1718","Motorized",1,"Wed","weekday"
"2128",2018-01-24,"Snodgrass","2","2","2",4.6,0,22,0,22,20.9,1,-2,2,0,1,-1,1,1,"w1718","Hybrid",NA,"Wed","weekday"
"2129",2018-01-25,"Snodgrass","2","2","2",4.6,0,22,0,28,20.9,0,1,-2,2,0,1,-1,1,"w1718","Non.motorized",66,"Thu","weekday"
"2130",2018-01-25,"Snodgrass","2","2","2",4.6,0,22,0,28,20.9,0,1,-2,2,0,1,-1,1,"w1718","Mechanized",10,"Thu","weekday"
"2131",2018-01-25,"Snodgrass","2","2","2",4.6,0,22,0,28,20.9,0,1,-2,2,0,1,-1,1,"w1718","Motorized",1,"Thu","weekday"
"2132",2018-01-25,"Snodgrass","2","2","2",4.6,0,22,0,28,20.9,0,1,-2,2,0,1,-1,1,"w1718","Hybrid",NA,"Thu","weekday"
"2133",2018-01-26,"Snodgrass","2","2","2",4.7,0.1,22,0,15,21.4,0,0,1,-2,0,0,1,-1,"w1718","Non.motorized",29,"Fri","weekday"
"2134",2018-01-26,"Snodgrass","2","2","2",4.7,0.1,22,0,15,21.4,0,0,1,-2,0,0,1,-1,"w1718","Mechanized",7,"Fri","weekday"
"2135",2018-01-26,"Snodgrass","2","2","2",4.7,0.1,22,0,15,21.4,0,0,1,-2,0,0,1,-1,"w1718","Motorized",2,"Fri","weekday"
"2136",2018-01-26,"Snodgrass","2","2","2",4.7,0.1,22,0,15,21.4,0,0,1,-2,0,0,1,-1,"w1718","Hybrid",NA,"Fri","weekday"
"2137",2018-01-27,"Snodgrass","2","2","2",4.7,0,23,1,16,20.4,0,0,0,1,1,1,1,2,"w1718","Non.motorized",493,"Sat","weekend"
"2138",2018-01-27,"Snodgrass","2","2","2",4.7,0,23,1,16,20.4,0,0,0,1,1,1,1,2,"w1718","Mechanized",2,"Sat","weekend"
"2139",2018-01-27,"Snodgrass","2","2","2",4.7,0,23,1,16,20.4,0,0,0,1,1,1,1,2,"w1718","Motorized",0,"Sat","weekend"
"2140",2018-01-27,"Snodgrass","2","2","2",4.7,0,23,1,16,20.4,0,0,0,1,1,1,1,2,"w1718","Hybrid",NA,"Sat","weekend"
"2141",2018-01-28,"Snodgrass","2","2","2",4.7,0,23,0,25,20.4,1,0,0,0,1,1,1,1,"w1718","Non.motorized",109,"Sun","weekend"
"2142",2018-01-28,"Snodgrass","2","2","2",4.7,0,23,0,25,20.4,1,0,0,0,1,1,1,1,"w1718","Mechanized",13,"Sun","weekend"
"2143",2018-01-28,"Snodgrass","2","2","2",4.7,0,23,0,25,20.4,1,0,0,0,1,1,1,1,"w1718","Motorized",0,"Sun","weekend"
"2144",2018-01-28,"Snodgrass","2","2","2",4.7,0,23,0,25,20.4,1,0,0,0,1,1,1,1,"w1718","Hybrid",NA,"Sun","weekend"
"2145",2018-01-29,"Snodgrass","2","2","2",4.8,0.1,22,-1,30,21.8,0,1,0,0,-1,0,0,0,"w1718","Non.motorized",53,"Mon","weekday"
"2146",2018-01-29,"Snodgrass","2","2","2",4.8,0.1,22,-1,30,21.8,0,1,0,0,-1,0,0,0,"w1718","Mechanized",2,"Mon","weekday"
"2147",2018-01-29,"Snodgrass","2","2","2",4.8,0.1,22,-1,30,21.8,0,1,0,0,-1,0,0,0,"w1718","Motorized",0,"Mon","weekday"
"2148",2018-01-29,"Snodgrass","2","2","2",4.8,0.1,22,-1,30,21.8,0,1,0,0,-1,0,0,0,"w1718","Hybrid",NA,"Mon","weekday"
"2149",2018-01-30,"Snodgrass","2","2","2",4.8,0,22,0,34,21.8,-1,0,1,0,-1,-1,0,0,"w1718","Non.motorized",50,"Tue","weekday"
"2150",2018-01-30,"Snodgrass","2","2","2",4.8,0,22,0,34,21.8,-1,0,1,0,-1,-1,0,0,"w1718","Mechanized",2,"Tue","weekday"
"2151",2018-01-30,"Snodgrass","2","2","2",4.8,0,22,0,34,21.8,-1,0,1,0,-1,-1,0,0,"w1718","Motorized",3,"Tue","weekday"
"2152",2018-01-30,"Snodgrass","2","2","2",4.8,0,22,0,34,21.8,-1,0,1,0,-1,-1,0,0,"w1718","Hybrid",NA,"Tue","weekday"
"2153",2018-01-31,"Snodgrass","2","2","2",4.8,0,22,0,34,21.8,0,-1,0,1,0,-1,-1,0,"w1718","Non.motorized",31,"Wed","weekday"
"2154",2018-01-31,"Snodgrass","2","2","2",4.8,0,22,0,34,21.8,0,-1,0,1,0,-1,-1,0,"w1718","Mechanized",4,"Wed","weekday"
"2155",2018-01-31,"Snodgrass","2","2","2",4.8,0,22,0,34,21.8,0,-1,0,1,0,-1,-1,0,"w1718","Motorized",1,"Wed","weekday"
"2156",2018-01-31,"Snodgrass","2","2","2",4.8,0,22,0,34,21.8,0,-1,0,1,0,-1,-1,0,"w1718","Hybrid",NA,"Wed","weekday"
"2157",2018-02-01,"Snodgrass","2","2","2",4.9,0.1,21,-1,32,23.3,0,0,-1,0,-1,-1,-2,-2,"w1718","Non.motorized",45,"Thu","weekday"
"2158",2018-02-01,"Snodgrass","2","2","2",4.9,0.1,21,-1,32,23.3,0,0,-1,0,-1,-1,-2,-2,"w1718","Mechanized",4,"Thu","weekday"
"2159",2018-02-01,"Snodgrass","2","2","2",4.9,0.1,21,-1,32,23.3,0,0,-1,0,-1,-1,-2,-2,"w1718","Motorized",0,"Thu","weekday"
"2160",2018-02-01,"Snodgrass","2","2","2",4.9,0.1,21,-1,32,23.3,0,0,-1,0,-1,-1,-2,-2,"w1718","Hybrid",NA,"Thu","weekday"
"2161",2018-02-02,"Snodgrass","2","2","2",4.9,0,20,-1,33,24.5,-1,0,0,-1,-2,-2,-2,-3,"w1718","Non.motorized",49,"Fri","weekday"
"2162",2018-02-02,"Snodgrass","2","2","2",4.9,0,20,-1,33,24.5,-1,0,0,-1,-2,-2,-2,-3,"w1718","Mechanized",4,"Fri","weekday"
"2163",2018-02-02,"Snodgrass","2","2","2",4.9,0,20,-1,33,24.5,-1,0,0,-1,-2,-2,-2,-3,"w1718","Motorized",0,"Fri","weekday"
"2164",2018-02-02,"Snodgrass","2","2","2",4.9,0,20,-1,33,24.5,-1,0,0,-1,-2,-2,-2,-3,"w1718","Hybrid",NA,"Fri","weekday"
"2165",2018-02-03,"Snodgrass","2","2","2",4.9,0,21,1,32,23.3,-1,-1,0,0,0,-1,-1,-1,"w1718","Non.motorized",97,"Sat","weekend"
"2166",2018-02-03,"Snodgrass","2","2","2",4.9,0,21,1,32,23.3,-1,-1,0,0,0,-1,-1,-1,"w1718","Mechanized",0,"Sat","weekend"
"2167",2018-02-03,"Snodgrass","2","2","2",4.9,0,21,1,32,23.3,-1,-1,0,0,0,-1,-1,-1,"w1718","Motorized",0,"Sat","weekend"
"2168",2018-02-03,"Snodgrass","2","2","2",4.9,0,21,1,32,23.3,-1,-1,0,0,0,-1,-1,-1,"w1718","Hybrid",NA,"Sat","weekend"
"2169",2018-02-04,"Snodgrass","2","2","2",4.9,0,19,-2,32,25.8,1,-1,-1,0,-1,-2,-3,-3,"w1718","Non.motorized",95,"Sun","weekend"
"2170",2018-02-04,"Snodgrass","2","2","2",4.9,0,19,-2,32,25.8,1,-1,-1,0,-1,-2,-3,-3,"w1718","Mechanized",2,"Sun","weekend"
"2171",2018-02-04,"Snodgrass","2","2","2",4.9,0,19,-2,32,25.8,1,-1,-1,0,-1,-2,-3,-3,"w1718","Motorized",1,"Sun","weekend"
"2172",2018-02-04,"Snodgrass","2","2","2",4.9,0,19,-2,32,25.8,1,-1,-1,0,-1,-2,-3,-3,"w1718","Hybrid",NA,"Sun","weekend"
"2173",2018-02-05,"Snodgrass","2","2","2",5,0.1,18,-1,29,27.8,-2,1,-1,-1,-3,-2,-3,-4,"w1718","Non.motorized",29,"Mon","weekday"
"2174",2018-02-05,"Snodgrass","2","2","2",5,0.1,18,-1,29,27.8,-2,1,-1,-1,-3,-2,-3,-4,"w1718","Mechanized",0,"Mon","weekday"
"2175",2018-02-05,"Snodgrass","2","2","2",5,0.1,18,-1,29,27.8,-2,1,-1,-1,-3,-2,-3,-4,"w1718","Motorized",0,"Mon","weekday"
"2176",2018-02-05,"Snodgrass","2","2","2",5,0.1,18,-1,29,27.8,-2,1,-1,-1,-3,-2,-3,-4,"w1718","Hybrid",NA,"Mon","weekday"
"2177",2018-02-06,"Snodgrass","2","2","2",5.2,0.2,23,5,22,22.6,-1,-2,1,-1,4,2,3,2,"w1718","Non.motorized",34,"Tue","weekday"
"2178",2018-02-06,"Snodgrass","2","2","2",5.2,0.2,23,5,22,22.6,-1,-2,1,-1,4,2,3,2,"w1718","Mechanized",0,"Tue","weekday"
"2179",2018-02-06,"Snodgrass","2","2","2",5.2,0.2,23,5,22,22.6,-1,-2,1,-1,4,2,3,2,"w1718","Motorized",0,"Tue","weekday"
"2180",2018-02-06,"Snodgrass","2","2","2",5.2,0.2,23,5,22,22.6,-1,-2,1,-1,4,2,3,2,"w1718","Hybrid",NA,"Tue","weekday"
"2181",2018-02-07,"Snodgrass","2","2","2",5.2,0,23,0,24,22.6,5,-1,-2,1,5,4,2,3,"w1718","Non.motorized",62,"Wed","weekday"
"2182",2018-02-07,"Snodgrass","2","2","2",5.2,0,23,0,24,22.6,5,-1,-2,1,5,4,2,3,"w1718","Mechanized",0,"Wed","weekday"
"2183",2018-02-07,"Snodgrass","2","2","2",5.2,0,23,0,24,22.6,5,-1,-2,1,5,4,2,3,"w1718","Motorized",1,"Wed","weekday"
"2184",2018-02-07,"Snodgrass","2","2","2",5.2,0,23,0,24,22.6,5,-1,-2,1,5,4,2,3,"w1718","Hybrid",NA,"Wed","weekday"
"2185",2018-02-08,"Snodgrass","2","2","1",5.3,0.1,25,2,28,21.2,0,5,-1,-2,2,7,6,4,"w1718","Non.motorized",67,"Thu","weekday"
"2186",2018-02-08,"Snodgrass","2","2","1",5.3,0.1,25,2,28,21.2,0,5,-1,-2,2,7,6,4,"w1718","Mechanized",3,"Thu","weekday"
"2187",2018-02-08,"Snodgrass","2","2","1",5.3,0.1,25,2,28,21.2,0,5,-1,-2,2,7,6,4,"w1718","Motorized",1,"Thu","weekday"
"2188",2018-02-08,"Snodgrass","2","2","1",5.3,0.1,25,2,28,21.2,0,5,-1,-2,2,7,6,4,"w1718","Hybrid",NA,"Thu","weekday"
"2189",2018-02-09,"Snodgrass","2","2","1",5.3,0,24,-1,33,22.1,2,0,5,-1,1,1,6,5,"w1718","Non.motorized",55,"Fri","weekday"
"2190",2018-02-09,"Snodgrass","2","2","1",5.3,0,24,-1,33,22.1,2,0,5,-1,1,1,6,5,"w1718","Mechanized",1,"Fri","weekday"
"2191",2018-02-09,"Snodgrass","2","2","1",5.3,0,24,-1,33,22.1,2,0,5,-1,1,1,6,5,"w1718","Motorized",1,"Fri","weekday"
"2192",2018-02-09,"Snodgrass","2","2","1",5.3,0,24,-1,33,22.1,2,0,5,-1,1,1,6,5,"w1718","Hybrid",NA,"Fri","weekday"
"2193",2018-02-10,"Snodgrass","3","3","2",5.3,0,24,0,24,22.1,-1,2,0,5,-1,1,1,6,"w1718","Non.motorized",0,"Sat","weekend"
"2194",2018-02-10,"Snodgrass","3","3","2",5.3,0,24,0,24,22.1,-1,2,0,5,-1,1,1,6,"w1718","Mechanized",0,"Sat","weekend"
"2195",2018-02-10,"Snodgrass","3","3","2",5.3,0,24,0,24,22.1,-1,2,0,5,-1,1,1,6,"w1718","Motorized",0,"Sat","weekend"
"2196",2018-02-10,"Snodgrass","3","3","2",5.3,0,24,0,24,22.1,-1,2,0,5,-1,1,1,6,"w1718","Hybrid",NA,"Sat","weekend"
"2197",2018-02-11,"Snodgrass","3","3","2",5.6,0.3,27,3,13,20.7,0,-1,2,0,3,2,4,4,"w1718","Non.motorized",87,"Sun","weekend"
"2198",2018-02-11,"Snodgrass","3","3","2",5.6,0.3,27,3,13,20.7,0,-1,2,0,3,2,4,4,"w1718","Mechanized",0,"Sun","weekend"
"2199",2018-02-11,"Snodgrass","3","3","2",5.6,0.3,27,3,13,20.7,0,-1,2,0,3,2,4,4,"w1718","Motorized",3,"Sun","weekend"
"2200",2018-02-11,"Snodgrass","3","3","2",5.6,0.3,27,3,13,20.7,0,-1,2,0,3,2,4,4,"w1718","Hybrid",NA,"Sun","weekend"
"2201",2018-02-12,"Snodgrass","3","3","3",5.7,0.1,27,0,23,21.1,3,0,-1,2,3,3,2,4,"w1718","Non.motorized",49,"Mon","weekday"
"2202",2018-02-12,"Snodgrass","3","3","3",5.7,0.1,27,0,23,21.1,3,0,-1,2,3,3,2,4,"w1718","Mechanized",0,"Mon","weekday"
"2203",2018-02-12,"Snodgrass","3","3","3",5.7,0.1,27,0,23,21.1,3,0,-1,2,3,3,2,4,"w1718","Motorized",0,"Mon","weekday"
"2204",2018-02-12,"Snodgrass","3","3","3",5.7,0.1,27,0,23,21.1,3,0,-1,2,3,3,2,4,"w1718","Hybrid",NA,"Mon","weekday"
"2205",2018-02-13,"Snodgrass","3","3","3",6.1,0.4,29,2,28,21,0,3,0,-1,2,5,5,4,"w1718","Non.motorized",35,"Tue","weekday"
"2206",2018-02-13,"Snodgrass","3","3","3",6.1,0.4,29,2,28,21,0,3,0,-1,2,5,5,4,"w1718","Mechanized",0,"Tue","weekday"
"2207",2018-02-13,"Snodgrass","3","3","3",6.1,0.4,29,2,28,21,0,3,0,-1,2,5,5,4,"w1718","Motorized",0,"Tue","weekday"
"2208",2018-02-13,"Snodgrass","3","3","3",6.1,0.4,29,2,28,21,0,3,0,-1,2,5,5,4,"w1718","Hybrid",NA,"Tue","weekday"
"2209",2018-02-14,"Snodgrass","3","3","3",6.2,0.1,30,1,30,20.7,2,0,3,0,3,3,6,6,"w1718","Non.motorized",49,"Wed","weekday"
"2210",2018-02-14,"Snodgrass","3","3","3",6.2,0.1,30,1,30,20.7,2,0,3,0,3,3,6,6,"w1718","Mechanized",0,"Wed","weekday"
"2211",2018-02-14,"Snodgrass","3","3","3",6.2,0.1,30,1,30,20.7,2,0,3,0,3,3,6,6,"w1718","Motorized",2,"Wed","weekday"
"2212",2018-02-14,"Snodgrass","3","3","3",6.2,0.1,30,1,30,20.7,2,0,3,0,3,3,6,6,"w1718","Hybrid",NA,"Wed","weekday"
"2213",2018-02-15,"Snodgrass","3","3","3",6.3,0.1,28,-2,24,22.5,1,2,0,3,-1,1,1,4,"w1718","Non.motorized",29,"Thu","weekday"
"2214",2018-02-15,"Snodgrass","3","3","3",6.3,0.1,28,-2,24,22.5,1,2,0,3,-1,1,1,4,"w1718","Mechanized",0,"Thu","weekday"
"2215",2018-02-15,"Snodgrass","3","3","3",6.3,0.1,28,-2,24,22.5,1,2,0,3,-1,1,1,4,"w1718","Motorized",0,"Thu","weekday"
"2216",2018-02-15,"Snodgrass","3","3","3",6.3,0.1,28,-2,24,22.5,1,2,0,3,-1,1,1,4,"w1718","Hybrid",NA,"Thu","weekday"
"2217",2018-02-16,"Snodgrass","3","3","3",6.7,0.4,32,4,18,20.9,-2,1,2,0,2,3,5,5,"w1718","Non.motorized",66,"Fri","weekday"
"2218",2018-02-16,"Snodgrass","3","3","3",6.7,0.4,32,4,18,20.9,-2,1,2,0,2,3,5,5,"w1718","Mechanized",0,"Fri","weekday"
"2219",2018-02-16,"Snodgrass","3","3","3",6.7,0.4,32,4,18,20.9,-2,1,2,0,2,3,5,5,"w1718","Motorized",9,"Fri","weekday"
"2220",2018-02-16,"Snodgrass","3","3","3",6.7,0.4,32,4,18,20.9,-2,1,2,0,2,3,5,5,"w1718","Hybrid",NA,"Fri","weekday"
"2221",2018-02-17,"Snodgrass","3","3","2",6.7,0,32,0,25,20.9,4,-2,1,2,4,2,3,5,"w1718","Non.motorized",180,"Sat","weekend"
"2222",2018-02-17,"Snodgrass","3","3","2",6.7,0,32,0,25,20.9,4,-2,1,2,4,2,3,5,"w1718","Mechanized",1,"Sat","weekend"
"2223",2018-02-17,"Snodgrass","3","3","2",6.7,0,32,0,25,20.9,4,-2,1,2,4,2,3,5,"w1718","Motorized",6,"Sat","weekend"
"2224",2018-02-17,"Snodgrass","3","3","2",6.7,0,32,0,25,20.9,4,-2,1,2,4,2,3,5,"w1718","Hybrid",NA,"Sat","weekend"
"2225",2018-02-18,"Snodgrass","2","2","2",6.7,0,31,-1,32,21.6,0,4,-2,1,-1,3,1,2,"w1718","Non.motorized",163,"Sun","weekend"
"2226",2018-02-18,"Snodgrass","2","2","2",6.7,0,31,-1,32,21.6,0,4,-2,1,-1,3,1,2,"w1718","Mechanized",2,"Sun","weekend"
"2227",2018-02-18,"Snodgrass","2","2","2",6.7,0,31,-1,32,21.6,0,4,-2,1,-1,3,1,2,"w1718","Motorized",0,"Sun","weekend"
"2228",2018-02-18,"Snodgrass","2","2","2",6.7,0,31,-1,32,21.6,0,4,-2,1,-1,3,1,2,"w1718","Hybrid",NA,"Sun","weekend"
"2229",2018-02-19,"Snodgrass","2","2","2",6.8,0.1,29,-2,24,23.4,-1,0,4,-2,-3,-3,1,-1,"w1718","Non.motorized",59,"Mon","weekday"
"2230",2018-02-19,"Snodgrass","2","2","2",6.8,0.1,29,-2,24,23.4,-1,0,4,-2,-3,-3,1,-1,"w1718","Mechanized",1,"Mon","weekday"
"2231",2018-02-19,"Snodgrass","2","2","2",6.8,0.1,29,-2,24,23.4,-1,0,4,-2,-3,-3,1,-1,"w1718","Motorized",0,"Mon","weekday"
"2232",2018-02-19,"Snodgrass","2","2","2",6.8,0.1,29,-2,24,23.4,-1,0,4,-2,-3,-3,1,-1,"w1718","Hybrid",NA,"Mon","weekday"
"2233",2018-02-19,"Snodgrass","3","3","3",6.8,0.1,29,-2,24,23.4,-1,0,4,-2,-3,-3,1,-1,"w1718","Non.motorized",59,"Mon","weekday"
"2234",2018-02-19,"Snodgrass","3","3","3",6.8,0.1,29,-2,24,23.4,-1,0,4,-2,-3,-3,1,-1,"w1718","Mechanized",1,"Mon","weekday"
"2235",2018-02-19,"Snodgrass","3","3","3",6.8,0.1,29,-2,24,23.4,-1,0,4,-2,-3,-3,1,-1,"w1718","Motorized",0,"Mon","weekday"
"2236",2018-02-19,"Snodgrass","3","3","3",6.8,0.1,29,-2,24,23.4,-1,0,4,-2,-3,-3,1,-1,"w1718","Hybrid",NA,"Mon","weekday"
"2237",2018-02-20,"Snodgrass","3","3","3",6.8,0,31,2,8,21.9,-2,-1,0,4,0,-1,-1,3,"w1718","Non.motorized",26,"Tue","weekday"
"2238",2018-02-20,"Snodgrass","3","3","3",6.8,0,31,2,8,21.9,-2,-1,0,4,0,-1,-1,3,"w1718","Mechanized",0,"Tue","weekday"
"2239",2018-02-20,"Snodgrass","3","3","3",6.8,0,31,2,8,21.9,-2,-1,0,4,0,-1,-1,3,"w1718","Motorized",1,"Tue","weekday"
"2240",2018-02-20,"Snodgrass","3","3","3",6.8,0,31,2,8,21.9,-2,-1,0,4,0,-1,-1,3,"w1718","Hybrid",NA,"Tue","weekday"
"2241",2018-02-21,"Snodgrass","3","3","3",6.8,0,31,0,11,21.9,2,-2,-1,0,2,0,-1,-1,"w1718","Non.motorized",47,"Wed","weekday"
"2242",2018-02-21,"Snodgrass","3","3","3",6.8,0,31,0,11,21.9,2,-2,-1,0,2,0,-1,-1,"w1718","Mechanized",0,"Wed","weekday"
"2243",2018-02-21,"Snodgrass","3","3","3",6.8,0,31,0,11,21.9,2,-2,-1,0,2,0,-1,-1,"w1718","Motorized",0,"Wed","weekday"
"2244",2018-02-21,"Snodgrass","3","3","3",6.8,0,31,0,11,21.9,2,-2,-1,0,2,0,-1,-1,"w1718","Hybrid",NA,"Wed","weekday"
"2245",2018-02-22,"Snodgrass","3","3","2",6.8,0,30,-1,16,22.7,0,2,-2,-1,-1,1,-1,-2,"w1718","Non.motorized",28,"Thu","weekday"
"2246",2018-02-22,"Snodgrass","3","3","2",6.8,0,30,-1,16,22.7,0,2,-2,-1,-1,1,-1,-2,"w1718","Mechanized",1,"Thu","weekday"
"2247",2018-02-22,"Snodgrass","3","3","2",6.8,0,30,-1,16,22.7,0,2,-2,-1,-1,1,-1,-2,"w1718","Motorized",0,"Thu","weekday"
"2248",2018-02-22,"Snodgrass","3","3","2",6.8,0,30,-1,16,22.7,0,2,-2,-1,-1,1,-1,-2,"w1718","Hybrid",NA,"Thu","weekday"
"2249",2018-02-23,"Snodgrass","3","3","2",6.9,0.1,30,0,15,23,-1,0,2,-2,-1,-1,1,-1,"w1718","Non.motorized",63,"Fri","weekday"
"2250",2018-02-23,"Snodgrass","3","3","2",6.9,0.1,30,0,15,23,-1,0,2,-2,-1,-1,1,-1,"w1718","Mechanized",0,"Fri","weekday"
"2251",2018-02-23,"Snodgrass","3","3","2",6.9,0.1,30,0,15,23,-1,0,2,-2,-1,-1,1,-1,"w1718","Motorized",0,"Fri","weekday"
"2252",2018-02-23,"Snodgrass","3","3","2",6.9,0.1,30,0,15,23,-1,0,2,-2,-1,-1,1,-1,"w1718","Hybrid",NA,"Fri","weekday"
"2253",2018-02-24,"Snodgrass","3","3","2",6.9,0,31,1,10,22.3,0,-1,0,2,1,0,0,2,"w1718","Non.motorized",56,"Sat","weekend"
"2254",2018-02-24,"Snodgrass","3","3","2",6.9,0,31,1,10,22.3,0,-1,0,2,1,0,0,2,"w1718","Mechanized",0,"Sat","weekend"
"2255",2018-02-24,"Snodgrass","3","3","2",6.9,0,31,1,10,22.3,0,-1,0,2,1,0,0,2,"w1718","Motorized",2,"Sat","weekend"
"2256",2018-02-24,"Snodgrass","3","3","2",6.9,0,31,1,10,22.3,0,-1,0,2,1,0,0,2,"w1718","Hybrid",NA,"Sat","weekend"
"2257",2018-02-25,"Snodgrass","3","3","2",7.1,0.2,32,1,11,22.2,1,0,-1,0,2,2,1,1,"w1718","Non.motorized",49,"Sun","weekend"
"2258",2018-02-25,"Snodgrass","3","3","2",7.1,0.2,32,1,11,22.2,1,0,-1,0,2,2,1,1,"w1718","Mechanized",5,"Sun","weekend"
"2259",2018-02-25,"Snodgrass","3","3","2",7.1,0.2,32,1,11,22.2,1,0,-1,0,2,2,1,1,"w1718","Motorized",0,"Sun","weekend"
"2260",2018-02-25,"Snodgrass","3","3","2",7.1,0.2,32,1,11,22.2,1,0,-1,0,2,2,1,1,"w1718","Hybrid",NA,"Sun","weekend"
"2261",2018-02-26,"Snodgrass","2","2","2",7.1,0,32,0,20,22.2,1,1,0,-1,1,2,2,1,"w1718","Non.motorized",48,"Mon","weekday"
"2262",2018-02-26,"Snodgrass","2","2","2",7.1,0,32,0,20,22.2,1,1,0,-1,1,2,2,1,"w1718","Mechanized",0,"Mon","weekday"
"2263",2018-02-26,"Snodgrass","2","2","2",7.1,0,32,0,20,22.2,1,1,0,-1,1,2,2,1,"w1718","Motorized",7,"Mon","weekday"
"2264",2018-02-26,"Snodgrass","2","2","2",7.1,0,32,0,20,22.2,1,1,0,-1,1,2,2,1,"w1718","Hybrid",NA,"Mon","weekday"
"2265",2018-02-27,"Snodgrass","2","2","2",7.2,0.1,32,0,26,22.5,0,1,1,0,0,1,2,2,"w1718","Non.motorized",49,"Tue","weekday"
"2266",2018-02-27,"Snodgrass","2","2","2",7.2,0.1,32,0,26,22.5,0,1,1,0,0,1,2,2,"w1718","Mechanized",0,"Tue","weekday"
"2267",2018-02-27,"Snodgrass","2","2","2",7.2,0.1,32,0,26,22.5,0,1,1,0,0,1,2,2,"w1718","Motorized",1,"Tue","weekday"
"2268",2018-02-27,"Snodgrass","2","2","2",7.2,0.1,32,0,26,22.5,0,1,1,0,0,1,2,2,"w1718","Hybrid",NA,"Tue","weekday"
"2269",2018-02-28,"Snodgrass","2","2","2",7.2,0,31,-1,23,23.2,0,0,1,1,-1,-1,0,1,"w1718","Non.motorized",37,"Wed","weekday"
"2270",2018-02-28,"Snodgrass","2","2","2",7.2,0,31,-1,23,23.2,0,0,1,1,-1,-1,0,1,"w1718","Mechanized",0,"Wed","weekday"
"2271",2018-02-28,"Snodgrass","2","2","2",7.2,0,31,-1,23,23.2,0,0,1,1,-1,-1,0,1,"w1718","Motorized",1,"Wed","weekday"
"2272",2018-02-28,"Snodgrass","2","2","2",7.2,0,31,-1,23,23.2,0,0,1,1,-1,-1,0,1,"w1718","Hybrid",NA,"Wed","weekday"
"2273",2018-03-01,"Snodgrass","2","2","2",7.2,0,31,0,24,23.2,-1,0,0,1,-1,-1,-1,0,"w1718","Non.motorized",50,"Thu","weekday"
"2274",2018-03-01,"Snodgrass","2","2","2",7.2,0,31,0,24,23.2,-1,0,0,1,-1,-1,-1,0,"w1718","Mechanized",2,"Thu","weekday"
"2275",2018-03-01,"Snodgrass","2","2","2",7.2,0,31,0,24,23.2,-1,0,0,1,-1,-1,-1,0,"w1718","Motorized",1,"Thu","weekday"
"2276",2018-03-01,"Snodgrass","2","2","2",7.2,0,31,0,24,23.2,-1,0,0,1,-1,-1,-1,0,"w1718","Hybrid",NA,"Thu","weekday"
"2277",2018-03-02,"Snodgrass","2","2","1",7.2,0,31,0,30,23.2,0,-1,0,0,0,-1,-1,-1,"w1718","Non.motorized",75,"Fri","weekday"
"2278",2018-03-02,"Snodgrass","2","2","1",7.2,0,31,0,30,23.2,0,-1,0,0,0,-1,-1,-1,"w1718","Mechanized",1,"Fri","weekday"
"2279",2018-03-02,"Snodgrass","2","2","1",7.2,0,31,0,30,23.2,0,-1,0,0,0,-1,-1,-1,"w1718","Motorized",3,"Fri","weekday"
"2280",2018-03-02,"Snodgrass","2","2","1",7.2,0,31,0,30,23.2,0,-1,0,0,0,-1,-1,-1,"w1718","Hybrid",NA,"Fri","weekday"
"2281",2018-03-03,"Snodgrass","2","2","1",7.3,0.1,30,-1,34,24.3,0,0,-1,0,-1,-1,-2,-2,"w1718","Non.motorized",156,"Sat","weekend"
"2282",2018-03-03,"Snodgrass","2","2","1",7.3,0.1,30,-1,34,24.3,0,0,-1,0,-1,-1,-2,-2,"w1718","Mechanized",4,"Sat","weekend"
"2283",2018-03-03,"Snodgrass","2","2","1",7.3,0.1,30,-1,34,24.3,0,0,-1,0,-1,-1,-2,-2,"w1718","Motorized",5,"Sat","weekend"
"2284",2018-03-03,"Snodgrass","2","2","1",7.3,0.1,30,-1,34,24.3,0,0,-1,0,-1,-1,-2,-2,"w1718","Hybrid",NA,"Sat","weekend"
"2285",2018-03-04,"Snodgrass","2","2","1",7.3,0,29,-1,24,25.2,-1,0,0,-1,-2,-2,-2,-3,"w1718","Non.motorized",77,"Sun","weekend"
"2286",2018-03-04,"Snodgrass","2","2","1",7.3,0,29,-1,24,25.2,-1,0,0,-1,-2,-2,-2,-3,"w1718","Mechanized",3,"Sun","weekend"
"2287",2018-03-04,"Snodgrass","2","2","1",7.3,0,29,-1,24,25.2,-1,0,0,-1,-2,-2,-2,-3,"w1718","Motorized",2,"Sun","weekend"
"2288",2018-03-04,"Snodgrass","2","2","1",7.3,0,29,-1,24,25.2,-1,0,0,-1,-2,-2,-2,-3,"w1718","Hybrid",NA,"Sun","weekend"
"2289",2018-03-05,"Snodgrass","2","2","1",7.3,0,31,2,13,23.5,-1,-1,0,0,1,0,0,0,"w1718","Non.motorized",17,"Mon","weekday"
"2290",2018-03-05,"Snodgrass","2","2","1",7.3,0,31,2,13,23.5,-1,-1,0,0,1,0,0,0,"w1718","Mechanized",0,"Mon","weekday"
"2291",2018-03-05,"Snodgrass","2","2","1",7.3,0,31,2,13,23.5,-1,-1,0,0,1,0,0,0,"w1718","Motorized",0,"Mon","weekday"
"2292",2018-03-05,"Snodgrass","2","2","1",7.3,0,31,2,13,23.5,-1,-1,0,0,1,0,0,0,"w1718","Hybrid",NA,"Mon","weekday"
"2293",2018-03-06,"Snodgrass","2","2","1",7.3,0,31,0,19,23.5,2,-1,-1,0,2,1,0,0,"w1718","Non.motorized",50,"Tue","weekday"
"2294",2018-03-06,"Snodgrass","2","2","1",7.3,0,31,0,19,23.5,2,-1,-1,0,2,1,0,0,"w1718","Mechanized",0,"Tue","weekday"
"2295",2018-03-06,"Snodgrass","2","2","1",7.3,0,31,0,19,23.5,2,-1,-1,0,2,1,0,0,"w1718","Motorized",5,"Tue","weekday"
"2296",2018-03-06,"Snodgrass","2","2","1",7.3,0,31,0,19,23.5,2,-1,-1,0,2,1,0,0,"w1718","Hybrid",NA,"Tue","weekday"
"2297",2018-03-07,"Snodgrass","2","2","1",7.4,0.1,31,0,27,23.9,0,2,-1,-1,0,2,1,0,"w1718","Non.motorized",39,"Wed","weekday"
"2298",2018-03-07,"Snodgrass","2","2","1",7.4,0.1,31,0,27,23.9,0,2,-1,-1,0,2,1,0,"w1718","Mechanized",2,"Wed","weekday"
"2299",2018-03-07,"Snodgrass","2","2","1",7.4,0.1,31,0,27,23.9,0,2,-1,-1,0,2,1,0,"w1718","Motorized",0,"Wed","weekday"
"2300",2018-03-07,"Snodgrass","2","2","1",7.4,0.1,31,0,27,23.9,0,2,-1,-1,0,2,1,0,"w1718","Hybrid",NA,"Wed","weekday"
"2301",2018-03-08,"Snodgrass","2","2","1",7.4,0,30,-1,33,24.7,0,0,2,-1,-1,-1,1,0,"w1718","Non.motorized",39,"Thu","weekday"
"2302",2018-03-08,"Snodgrass","2","2","1",7.4,0,30,-1,33,24.7,0,0,2,-1,-1,-1,1,0,"w1718","Mechanized",0,"Thu","weekday"
"2303",2018-03-08,"Snodgrass","2","2","1",7.4,0,30,-1,33,24.7,0,0,2,-1,-1,-1,1,0,"w1718","Motorized",0,"Thu","weekday"
"2304",2018-03-08,"Snodgrass","2","2","1",7.4,0,30,-1,33,24.7,0,0,2,-1,-1,-1,1,0,"w1718","Hybrid",NA,"Thu","weekday"
"2305",2018-03-09,"Snodgrass","2","2","1",7.4,0,30,0,34,24.7,-1,0,0,2,-1,-1,-1,1,"w1718","Non.motorized",50,"Fri","weekday"
"2306",2018-03-09,"Snodgrass","2","2","1",7.4,0,30,0,34,24.7,-1,0,0,2,-1,-1,-1,1,"w1718","Mechanized",0,"Fri","weekday"
"2307",2018-03-09,"Snodgrass","2","2","1",7.4,0,30,0,34,24.7,-1,0,0,2,-1,-1,-1,1,"w1718","Motorized",1,"Fri","weekday"
"2308",2018-03-09,"Snodgrass","2","2","1",7.4,0,30,0,34,24.7,-1,0,0,2,-1,-1,-1,1,"w1718","Hybrid",NA,"Fri","weekday"
"2309",2018-03-10,"Snodgrass","1","1","1",7.4,0,30,0,31,24.7,0,-1,0,0,0,-1,-1,-1,"w1718","Non.motorized",64,"Sat","weekend"
"2310",2018-03-10,"Snodgrass","1","1","1",7.4,0,30,0,31,24.7,0,-1,0,0,0,-1,-1,-1,"w1718","Mechanized",3,"Sat","weekend"
"2311",2018-03-10,"Snodgrass","1","1","1",7.4,0,30,0,31,24.7,0,-1,0,0,0,-1,-1,-1,"w1718","Motorized",1,"Sat","weekend"
"2312",2018-03-10,"Snodgrass","1","1","1",7.4,0,30,0,31,24.7,0,-1,0,0,0,-1,-1,-1,"w1718","Hybrid",NA,"Sat","weekend"
"2313",2018-03-11,"Snodgrass","1","1","1",7.4,0,29,-1,31,25.5,0,0,-1,0,-1,-1,-2,-2,"w1718","Non.motorized",60,"Sun","weekend"
"2314",2018-03-11,"Snodgrass","1","1","1",7.4,0,29,-1,31,25.5,0,0,-1,0,-1,-1,-2,-2,"w1718","Mechanized",4,"Sun","weekend"
"2315",2018-03-11,"Snodgrass","1","1","1",7.4,0,29,-1,31,25.5,0,0,-1,0,-1,-1,-2,-2,"w1718","Motorized",13,"Sun","weekend"
"2316",2018-03-11,"Snodgrass","1","1","1",7.4,0,29,-1,31,25.5,0,0,-1,0,-1,-1,-2,-2,"w1718","Hybrid",NA,"Sun","weekend"
"2317",2018-03-12,"Snodgrass","1","1","1",7.4,0,29,0,33,25.5,-1,0,0,-1,-1,-1,-1,-2,"w1718","Non.motorized",46,"Mon","weekday"
"2318",2018-03-12,"Snodgrass","1","1","1",7.4,0,29,0,33,25.5,-1,0,0,-1,-1,-1,-1,-2,"w1718","Mechanized",1,"Mon","weekday"
"2319",2018-03-12,"Snodgrass","1","1","1",7.4,0,29,0,33,25.5,-1,0,0,-1,-1,-1,-1,-2,"w1718","Motorized",0,"Mon","weekday"
"2320",2018-03-12,"Snodgrass","1","1","1",7.4,0,29,0,33,25.5,-1,0,0,-1,-1,-1,-1,-2,"w1718","Hybrid",NA,"Mon","weekday"
"2321",2018-03-13,"Snodgrass","1","1","1",7.4,0,29,0,34,25.5,0,-1,0,0,0,-1,-1,-1,"w1718","Non.motorized",55,"Tue","weekday"
"2322",2018-03-13,"Snodgrass","1","1","1",7.4,0,29,0,34,25.5,0,-1,0,0,0,-1,-1,-1,"w1718","Mechanized",2,"Tue","weekday"
"2323",2018-03-13,"Snodgrass","1","1","1",7.4,0,29,0,34,25.5,0,-1,0,0,0,-1,-1,-1,"w1718","Motorized",12,"Tue","weekday"
"2324",2018-03-13,"Snodgrass","1","1","1",7.4,0,29,0,34,25.5,0,-1,0,0,0,-1,-1,-1,"w1718","Hybrid",NA,"Tue","weekday"
"2325",2018-03-14,"Snodgrass","1","2","2",7.4,0,29,0,39,25.5,0,0,-1,0,0,0,-1,-1,"w1718","Non.motorized",41,"Wed","weekday"
"2326",2018-03-14,"Snodgrass","1","2","2",7.4,0,29,0,39,25.5,0,0,-1,0,0,0,-1,-1,"w1718","Mechanized",4,"Wed","weekday"
"2327",2018-03-14,"Snodgrass","1","2","2",7.4,0,29,0,39,25.5,0,0,-1,0,0,0,-1,-1,"w1718","Motorized",6,"Wed","weekday"
"2328",2018-03-14,"Snodgrass","1","2","2",7.4,0,29,0,39,25.5,0,0,-1,0,0,0,-1,-1,"w1718","Hybrid",NA,"Wed","weekday"
"2329",2018-03-15,"Snodgrass","2","2","2",7.5,0.1,28,-1,31,26.8,0,0,0,-1,-1,-1,-1,-2,"w1718","Non.motorized",26,"Thu","weekday"
"2330",2018-03-15,"Snodgrass","2","2","2",7.5,0.1,28,-1,31,26.8,0,0,0,-1,-1,-1,-1,-2,"w1718","Mechanized",0,"Thu","weekday"
"2331",2018-03-15,"Snodgrass","2","2","2",7.5,0.1,28,-1,31,26.8,0,0,0,-1,-1,-1,-1,-2,"w1718","Motorized",2,"Thu","weekday"
"2332",2018-03-15,"Snodgrass","2","2","2",7.5,0.1,28,-1,31,26.8,0,0,0,-1,-1,-1,-1,-2,"w1718","Hybrid",NA,"Thu","weekday"
"2333",2018-03-16,"Snodgrass","2","2","2",7.7,0.2,29,1,25,26.6,-1,0,0,0,0,0,0,0,"w1718","Non.motorized",49,"Fri","weekday"
"2334",2018-03-16,"Snodgrass","2","2","2",7.7,0.2,29,1,25,26.6,-1,0,0,0,0,0,0,0,"w1718","Mechanized",0,"Fri","weekday"
"2335",2018-03-16,"Snodgrass","2","2","2",7.7,0.2,29,1,25,26.6,-1,0,0,0,0,0,0,0,"w1718","Motorized",1,"Fri","weekday"
"2336",2018-03-16,"Snodgrass","2","2","2",7.7,0.2,29,1,25,26.6,-1,0,0,0,0,0,0,0,"w1718","Hybrid",NA,"Fri","weekday"
"2337",2018-03-17,"Snodgrass","2","2","2",7.8,0.1,32,3,29,24.4,1,-1,0,0,4,3,3,3,"w1718","Non.motorized",85,"Sat","weekend"
"2338",2018-03-17,"Snodgrass","2","2","2",7.8,0.1,32,3,29,24.4,1,-1,0,0,4,3,3,3,"w1718","Mechanized",0,"Sat","weekend"
"2339",2018-03-17,"Snodgrass","2","2","2",7.8,0.1,32,3,29,24.4,1,-1,0,0,4,3,3,3,"w1718","Motorized",0,"Sat","weekend"
"2340",2018-03-17,"Snodgrass","2","2","2",7.8,0.1,32,3,29,24.4,1,-1,0,0,4,3,3,3,"w1718","Hybrid",NA,"Sat","weekend"
"2341",2018-03-18,"Snodgrass","2","2","2",7.9,0.1,31,-1,24,25.5,3,1,-1,0,2,3,2,2,"w1718","Non.motorized",48,"Sun","weekend"
"2342",2018-03-18,"Snodgrass","2","2","2",7.9,0.1,31,-1,24,25.5,3,1,-1,0,2,3,2,2,"w1718","Mechanized",0,"Sun","weekend"
"2343",2018-03-18,"Snodgrass","2","2","2",7.9,0.1,31,-1,24,25.5,3,1,-1,0,2,3,2,2,"w1718","Motorized",0,"Sun","weekend"
"2344",2018-03-18,"Snodgrass","2","2","2",7.9,0.1,31,-1,24,25.5,3,1,-1,0,2,3,2,2,"w1718","Hybrid",NA,"Sun","weekend"
"2345",2018-03-19,"Snodgrass","2","2","1",8,0.1,32,1,19,25,-1,3,1,-1,0,3,4,3,"w1718","Non.motorized",38,"Mon","weekday"
"2346",2018-03-19,"Snodgrass","2","2","1",8,0.1,32,1,19,25,-1,3,1,-1,0,3,4,3,"w1718","Mechanized",0,"Mon","weekday"
"2347",2018-03-19,"Snodgrass","2","2","1",8,0.1,32,1,19,25,-1,3,1,-1,0,3,4,3,"w1718","Motorized",1,"Mon","weekday"
"2348",2018-03-19,"Snodgrass","2","2","1",8,0.1,32,1,19,25,-1,3,1,-1,0,3,4,3,"w1718","Hybrid",NA,"Mon","weekday"
"2349",2018-03-20,"Snodgrass","2","2","1",8,0,30,-2,24,26.7,1,-1,3,1,-1,-2,1,2,"w1718","Non.motorized",42,"Tue","weekday"
"2350",2018-03-20,"Snodgrass","2","2","1",8,0,30,-2,24,26.7,1,-1,3,1,-1,-2,1,2,"w1718","Mechanized",0,"Tue","weekday"
"2351",2018-03-20,"Snodgrass","2","2","1",8,0,30,-2,24,26.7,1,-1,3,1,-1,-2,1,2,"w1718","Motorized",0,"Tue","weekday"
"2352",2018-03-20,"Snodgrass","2","2","1",8,0,30,-2,24,26.7,1,-1,3,1,-1,-2,1,2,"w1718","Hybrid",NA,"Tue","weekday"
"2353",2018-03-21,"Snodgrass","1","1","1",8.1,0.1,32,2,30,25.3,-2,1,-1,3,0,1,0,3,"w1718","Non.motorized",29,"Wed","weekday"
"2354",2018-03-21,"Snodgrass","1","1","1",8.1,0.1,32,2,30,25.3,-2,1,-1,3,0,1,0,3,"w1718","Mechanized",0,"Wed","weekday"
"2355",2018-03-21,"Snodgrass","1","1","1",8.1,0.1,32,2,30,25.3,-2,1,-1,3,0,1,0,3,"w1718","Motorized",0,"Wed","weekday"
"2356",2018-03-21,"Snodgrass","1","1","1",8.1,0.1,32,2,30,25.3,-2,1,-1,3,0,1,0,3,"w1718","Hybrid",NA,"Wed","weekday"
"2357",2018-03-22,"Snodgrass","1","1","1",8.1,0,30,-2,36,27,2,-2,1,-1,0,-2,-1,-2,"w1718","Non.motorized",37,"Thu","weekday"
"2358",2018-03-22,"Snodgrass","1","1","1",8.1,0,30,-2,36,27,2,-2,1,-1,0,-2,-1,-2,"w1718","Mechanized",0,"Thu","weekday"
"2359",2018-03-22,"Snodgrass","1","1","1",8.1,0,30,-2,36,27,2,-2,1,-1,0,-2,-1,-2,"w1718","Motorized",0,"Thu","weekday"
"2360",2018-03-22,"Snodgrass","1","1","1",8.1,0,30,-2,36,27,2,-2,1,-1,0,-2,-1,-2,"w1718","Hybrid",NA,"Thu","weekday"
"2361",2018-03-23,"Snodgrass","2","2","3",8.2,0.1,29,-1,34,28.3,-2,2,-2,1,-3,-1,-3,-2,"w1718","Non.motorized",5,"Fri","weekday"
"2362",2018-03-23,"Snodgrass","2","2","3",8.2,0.1,29,-1,34,28.3,-2,2,-2,1,-3,-1,-3,-2,"w1718","Mechanized",0,"Fri","weekday"
"2363",2018-03-23,"Snodgrass","2","2","3",8.2,0.1,29,-1,34,28.3,-2,2,-2,1,-3,-1,-3,-2,"w1718","Motorized",0,"Fri","weekday"
"2364",2018-03-23,"Snodgrass","2","2","3",8.2,0.1,29,-1,34,28.3,-2,2,-2,1,-3,-1,-3,-2,"w1718","Hybrid",NA,"Fri","weekday"
"2365",2018-03-24,"Snodgrass","2","2","1",8.9,0.7,34,5,32,26.2,-1,-2,2,-2,4,2,4,2,"w1718","Non.motorized",75,"Sat","weekend"
"2366",2018-03-24,"Snodgrass","2","2","1",8.9,0.7,34,5,32,26.2,-1,-2,2,-2,4,2,4,2,"w1718","Mechanized",6,"Sat","weekend"
"2367",2018-03-24,"Snodgrass","2","2","1",8.9,0.7,34,5,32,26.2,-1,-2,2,-2,4,2,4,2,"w1718","Motorized",2,"Sat","weekend"
"2368",2018-03-24,"Snodgrass","2","2","1",8.9,0.7,34,5,32,26.2,-1,-2,2,-2,4,2,4,2,"w1718","Hybrid",NA,"Sat","weekend"
"2369",2018-03-25,"Snodgrass","2","2","1",8.9,0,35,1,35,25.4,5,-1,-2,2,6,5,3,5,"w1718","Non.motorized",56,"Sun","weekend"
"2370",2018-03-25,"Snodgrass","2","2","1",8.9,0,35,1,35,25.4,5,-1,-2,2,6,5,3,5,"w1718","Mechanized",0,"Sun","weekend"
"2371",2018-03-25,"Snodgrass","2","2","1",8.9,0,35,1,35,25.4,5,-1,-2,2,6,5,3,5,"w1718","Motorized",4,"Sun","weekend"
"2372",2018-03-25,"Snodgrass","2","2","1",8.9,0,35,1,35,25.4,5,-1,-2,2,6,5,3,5,"w1718","Hybrid",NA,"Sun","weekend"
"2373",2018-03-26,"Snodgrass","1","1","1",8.9,0,34,-1,31,26.2,1,5,-1,-2,0,5,4,2,"w1718","Non.motorized",44,"Mon","weekday"
"2374",2018-03-26,"Snodgrass","1","1","1",8.9,0,34,-1,31,26.2,1,5,-1,-2,0,5,4,2,"w1718","Mechanized",4,"Mon","weekday"
"2375",2018-03-26,"Snodgrass","1","1","1",8.9,0,34,-1,31,26.2,1,5,-1,-2,0,5,4,2,"w1718","Motorized",2,"Mon","weekday"
"2376",2018-03-26,"Snodgrass","1","1","1",8.9,0,34,-1,31,26.2,1,5,-1,-2,0,5,4,2,"w1718","Hybrid",NA,"Mon","weekday"
"2377",2018-03-26,"Snodgrass","2","1","1",8.9,0,34,-1,31,26.2,1,5,-1,-2,0,5,4,2,"w1718","Non.motorized",44,"Mon","weekday"
"2378",2018-03-26,"Snodgrass","2","1","1",8.9,0,34,-1,31,26.2,1,5,-1,-2,0,5,4,2,"w1718","Mechanized",4,"Mon","weekday"
"2379",2018-03-26,"Snodgrass","2","1","1",8.9,0,34,-1,31,26.2,1,5,-1,-2,0,5,4,2,"w1718","Motorized",2,"Mon","weekday"
"2380",2018-03-26,"Snodgrass","2","1","1",8.9,0,34,-1,31,26.2,1,5,-1,-2,0,5,4,2,"w1718","Hybrid",NA,"Mon","weekday"
"2381",2018-03-27,"Snodgrass","1","1","1",8.9,0,33,-1,29,27,-1,1,5,-1,-2,-1,4,3,"w1718","Non.motorized",24,"Tue","weekday"
"2382",2018-03-27,"Snodgrass","1","1","1",8.9,0,33,-1,29,27,-1,1,5,-1,-2,-1,4,3,"w1718","Mechanized",1,"Tue","weekday"
"2383",2018-03-27,"Snodgrass","1","1","1",8.9,0,33,-1,29,27,-1,1,5,-1,-2,-1,4,3,"w1718","Motorized",4,"Tue","weekday"
"2384",2018-03-27,"Snodgrass","1","1","1",8.9,0,33,-1,29,27,-1,1,5,-1,-2,-1,4,3,"w1718","Hybrid",NA,"Tue","weekday"
"2385",2018-03-28,"Snodgrass","1","1","1",8.9,0,33,0,27,27,-1,-1,1,5,-1,-2,-1,4,"w1718","Non.motorized",34,"Wed","weekday"
"2386",2018-03-28,"Snodgrass","1","1","1",8.9,0,33,0,27,27,-1,-1,1,5,-1,-2,-1,4,"w1718","Mechanized",0,"Wed","weekday"
"2387",2018-03-28,"Snodgrass","1","1","1",8.9,0,33,0,27,27,-1,-1,1,5,-1,-2,-1,4,"w1718","Motorized",0,"Wed","weekday"
"2388",2018-03-28,"Snodgrass","1","1","1",8.9,0,33,0,27,27,-1,-1,1,5,-1,-2,-1,4,"w1718","Hybrid",NA,"Wed","weekday"
"2389",2018-03-29,"Snodgrass","1","1","1",8.9,0,33,0,27,27,0,-1,-1,1,0,-1,-2,-1,"w1718","Non.motorized",33,"Thu","weekday"
"2390",2018-03-29,"Snodgrass","1","1","1",8.9,0,33,0,27,27,0,-1,-1,1,0,-1,-2,-1,"w1718","Mechanized",0,"Thu","weekday"
"2391",2018-03-29,"Snodgrass","1","1","1",8.9,0,33,0,27,27,0,-1,-1,1,0,-1,-2,-1,"w1718","Motorized",1,"Thu","weekday"
"2392",2018-03-29,"Snodgrass","1","1","1",8.9,0,33,0,27,27,0,-1,-1,1,0,-1,-2,-1,"w1718","Hybrid",NA,"Thu","weekday"
"2393",2018-03-30,"Snodgrass","1","1","1",8.9,0,32,-1,33,27.8,0,0,-1,-1,-1,-1,-2,-3,"w1718","Non.motorized",39,"Fri","weekday"
"2394",2018-03-30,"Snodgrass","1","1","1",8.9,0,32,-1,33,27.8,0,0,-1,-1,-1,-1,-2,-3,"w1718","Mechanized",0,"Fri","weekday"
"2395",2018-03-30,"Snodgrass","1","1","1",8.9,0,32,-1,33,27.8,0,0,-1,-1,-1,-1,-2,-3,"w1718","Motorized",2,"Fri","weekday"
"2396",2018-03-30,"Snodgrass","1","1","1",8.9,0,32,-1,33,27.8,0,0,-1,-1,-1,-1,-2,-3,"w1718","Hybrid",NA,"Fri","weekday"
"2397",2018-03-31,"Snodgrass","1","1","1",8.9,0,32,0,39,27.8,-1,0,0,-1,-1,-1,-1,-2,"w1718","Non.motorized",63,"Sat","weekend"
"2398",2018-03-31,"Snodgrass","1","1","1",8.9,0,32,0,39,27.8,-1,0,0,-1,-1,-1,-1,-2,"w1718","Mechanized",0,"Sat","weekend"
"2399",2018-03-31,"Snodgrass","1","1","1",8.9,0,32,0,39,27.8,-1,0,0,-1,-1,-1,-1,-2,"w1718","Motorized",0,"Sat","weekend"
"2400",2018-03-31,"Snodgrass","1","1","1",8.9,0,32,0,39,27.8,-1,0,0,-1,-1,-1,-1,-2,"w1718","Hybrid",NA,"Sat","weekend"
"2401",2018-04-01,"Snodgrass","1","1","1",8.8,-0.1,30,-2,41,29.3,0,-1,0,0,-2,-3,-3,-3,"w1718","Non.motorized",41,"Sun","weekend"
"2402",2018-04-01,"Snodgrass","1","1","1",8.8,-0.1,30,-2,41,29.3,0,-1,0,0,-2,-3,-3,-3,"w1718","Mechanized",1,"Sun","weekend"
"2403",2018-04-01,"Snodgrass","1","1","1",8.8,-0.1,30,-2,41,29.3,0,-1,0,0,-2,-3,-3,-3,"w1718","Motorized",2,"Sun","weekend"
"2404",2018-04-01,"Snodgrass","1","1","1",8.8,-0.1,30,-2,41,29.3,0,-1,0,0,-2,-3,-3,-3,"w1718","Hybrid",NA,"Sun","weekend"
"2405",2018-04-02,"Snodgrass","1","1","1",8.7,-0.1,29,-1,39,30,-2,0,-1,0,-3,-3,-4,-4,"w1718","Non.motorized",10,"Mon","weekday"
"2406",2018-04-02,"Snodgrass","1","1","1",8.7,-0.1,29,-1,39,30,-2,0,-1,0,-3,-3,-4,-4,"w1718","Mechanized",0,"Mon","weekday"
"2407",2018-04-02,"Snodgrass","1","1","1",8.7,-0.1,29,-1,39,30,-2,0,-1,0,-3,-3,-4,-4,"w1718","Motorized",0,"Mon","weekday"
"2408",2018-04-02,"Snodgrass","1","1","1",8.7,-0.1,29,-1,39,30,-2,0,-1,0,-3,-3,-4,-4,"w1718","Hybrid",NA,"Mon","weekday"
"2409",2018-04-03,"Snodgrass","1","1","1",8.8,0.1,30,1,27,29.3,-1,-2,0,-1,0,-2,-2,-3,"w1718","Non.motorized",16,"Tue","weekday"
"2410",2018-04-03,"Snodgrass","1","1","1",8.8,0.1,30,1,27,29.3,-1,-2,0,-1,0,-2,-2,-3,"w1718","Mechanized",0,"Tue","weekday"
"2411",2018-04-03,"Snodgrass","1","1","1",8.8,0.1,30,1,27,29.3,-1,-2,0,-1,0,-2,-2,-3,"w1718","Motorized",0,"Tue","weekday"
"2412",2018-04-03,"Snodgrass","1","1","1",8.8,0.1,30,1,27,29.3,-1,-2,0,-1,0,-2,-2,-3,"w1718","Hybrid",NA,"Tue","weekday"
"2413",2018-04-04,"Snodgrass","1","2","2",8.9,0.1,28,-2,33,31.8,1,-1,-2,0,-1,-2,-4,-4,"w1718","Non.motorized",27,"Wed","weekday"
"2414",2018-04-04,"Snodgrass","1","2","2",8.9,0.1,28,-2,33,31.8,1,-1,-2,0,-1,-2,-4,-4,"w1718","Mechanized",0,"Wed","weekday"
"2415",2018-04-04,"Snodgrass","1","2","2",8.9,0.1,28,-2,33,31.8,1,-1,-2,0,-1,-2,-4,-4,"w1718","Motorized",0,"Wed","weekday"
"2416",2018-04-04,"Snodgrass","1","2","2",8.9,0.1,28,-2,33,31.8,1,-1,-2,0,-1,-2,-4,-4,"w1718","Hybrid",NA,"Wed","weekday"
"2417",2018-04-05,"Snodgrass","1","2","2",8.9,0,27,-1,35,33,-2,1,-1,-2,-3,-2,-3,-5,"w1718","Non.motorized",14,"Thu","weekday"
"2418",2018-04-05,"Snodgrass","1","2","2",8.9,0,27,-1,35,33,-2,1,-1,-2,-3,-2,-3,-5,"w1718","Mechanized",0,"Thu","weekday"
"2419",2018-04-05,"Snodgrass","1","2","2",8.9,0,27,-1,35,33,-2,1,-1,-2,-3,-2,-3,-5,"w1718","Motorized",0,"Thu","weekday"
"2420",2018-04-05,"Snodgrass","1","2","2",8.9,0,27,-1,35,33,-2,1,-1,-2,-3,-2,-3,-5,"w1718","Hybrid",NA,"Thu","weekday"
"2421",2018-04-06,"Snodgrass","1","2","2",8.9,0,25,-2,35,35.6,-1,-2,1,-1,-3,-5,-4,-5,"w1718","Non.motorized",11,"Fri","weekday"
"2422",2018-04-06,"Snodgrass","1","2","2",8.9,0,25,-2,35,35.6,-1,-2,1,-1,-3,-5,-4,-5,"w1718","Mechanized",0,"Fri","weekday"
"2423",2018-04-06,"Snodgrass","1","2","2",8.9,0,25,-2,35,35.6,-1,-2,1,-1,-3,-5,-4,-5,"w1718","Motorized",0,"Fri","weekday"
"2424",2018-04-06,"Snodgrass","1","2","2",8.9,0,25,-2,35,35.6,-1,-2,1,-1,-3,-5,-4,-5,"w1718","Hybrid",NA,"Fri","weekday"
"2425",2018-04-07,"Snodgrass","2","2","2",9.2,0.3,31,6,37,29.7,-2,-1,-2,1,4,3,1,2,"w1718","Non.motorized",30,"Sat","weekend"
"2426",2018-04-07,"Snodgrass","2","2","2",9.2,0.3,31,6,37,29.7,-2,-1,-2,1,4,3,1,2,"w1718","Mechanized",0,"Sat","weekend"
"2427",2018-04-07,"Snodgrass","2","2","2",9.2,0.3,31,6,37,29.7,-2,-1,-2,1,4,3,1,2,"w1718","Motorized",1,"Sat","weekend"
"2428",2018-04-07,"Snodgrass","2","2","2",9.2,0.3,31,6,37,29.7,-2,-1,-2,1,4,3,1,2,"w1718","Hybrid",NA,"Sat","weekend"
"2429",2018-04-08,"Snodgrass","3","3","3",10,0.8,33,2,33,30.3,6,-2,-1,-2,8,6,5,3,"w1718","Non.motorized",7,"Sun","weekend"
"2430",2018-04-08,"Snodgrass","3","3","3",10,0.8,33,2,33,30.3,6,-2,-1,-2,8,6,5,3,"w1718","Mechanized",0,"Sun","weekend"
"2431",2018-04-08,"Snodgrass","3","3","3",10,0.8,33,2,33,30.3,6,-2,-1,-2,8,6,5,3,"w1718","Motorized",0,"Sun","weekend"
"2432",2018-04-08,"Snodgrass","3","3","3",10,0.8,33,2,33,30.3,6,-2,-1,-2,8,6,5,3,"w1718","Hybrid",NA,"Sun","weekend"
"2433",2018-04-09,"Snodgrass","1","1","1",10.1,0.1,33,0,31,30.6,2,6,-2,-1,2,8,6,5,"w1718","Non.motorized",19,"Mon","weekday"
"2434",2018-04-09,"Snodgrass","1","1","1",10.1,0.1,33,0,31,30.6,2,6,-2,-1,2,8,6,5,"w1718","Mechanized",0,"Mon","weekday"
"2435",2018-04-09,"Snodgrass","1","1","1",10.1,0.1,33,0,31,30.6,2,6,-2,-1,2,8,6,5,"w1718","Motorized",0,"Mon","weekday"
"2436",2018-04-09,"Snodgrass","1","1","1",10.1,0.1,33,0,31,30.6,2,6,-2,-1,2,8,6,5,"w1718","Hybrid",NA,"Mon","weekday"
"2437",2018-04-10,"Snodgrass","1","1","1",10.1,0,31,-2,38,32.6,0,2,6,-2,-2,0,6,4,"w1718","Non.motorized",9,"Tue","weekday"
"2438",2018-04-10,"Snodgrass","1","1","1",10.1,0,31,-2,38,32.6,0,2,6,-2,-2,0,6,4,"w1718","Mechanized",0,"Tue","weekday"
"2439",2018-04-10,"Snodgrass","1","1","1",10.1,0,31,-2,38,32.6,0,2,6,-2,-2,0,6,4,"w1718","Motorized",0,"Tue","weekday"
"2440",2018-04-10,"Snodgrass","1","1","1",10.1,0,31,-2,38,32.6,0,2,6,-2,-2,0,6,4,"w1718","Hybrid",NA,"Tue","weekday"
"2441",2018-04-11,"Snodgrass","2","2","2",9.9,-0.2,29,-2,45,34.1,-2,0,2,6,-4,-4,-2,4,"w1718","Non.motorized",3,"Wed","weekday"
"2442",2018-04-11,"Snodgrass","2","2","2",9.9,-0.2,29,-2,45,34.1,-2,0,2,6,-4,-4,-2,4,"w1718","Mechanized",0,"Wed","weekday"
"2443",2018-04-11,"Snodgrass","2","2","2",9.9,-0.2,29,-2,45,34.1,-2,0,2,6,-4,-4,-2,4,"w1718","Motorized",0,"Wed","weekday"
"2444",2018-04-11,"Snodgrass","2","2","2",9.9,-0.2,29,-2,45,34.1,-2,0,2,6,-4,-4,-2,4,"w1718","Hybrid",NA,"Wed","weekday"
"2445",2018-04-12,"Snodgrass","1","2","2",9.5,-0.4,28,-1,40,33.9,-2,-2,0,2,-3,-5,-5,-3,"w1718","Non.motorized",3,"Thu","weekday"
"2446",2018-04-12,"Snodgrass","1","2","2",9.5,-0.4,28,-1,40,33.9,-2,-2,0,2,-3,-5,-5,-3,"w1718","Mechanized",0,"Thu","weekday"
"2447",2018-04-12,"Snodgrass","1","2","2",9.5,-0.4,28,-1,40,33.9,-2,-2,0,2,-3,-5,-5,-3,"w1718","Motorized",0,"Thu","weekday"
"2448",2018-04-12,"Snodgrass","1","2","2",9.5,-0.4,28,-1,40,33.9,-2,-2,0,2,-3,-5,-5,-3,"w1718","Hybrid",NA,"Thu","weekday"
"2449",2018-04-13,"Snodgrass","2","2","1",9.4,-0.1,26,-2,23,36.2,-1,-2,-2,0,-3,-5,-7,-7,"w1718","Non.motorized",0,"Fri","weekday"
"2450",2018-04-13,"Snodgrass","2","2","1",9.4,-0.1,26,-2,23,36.2,-1,-2,-2,0,-3,-5,-7,-7,"w1718","Mechanized",0,"Fri","weekday"
"2451",2018-04-13,"Snodgrass","2","2","1",9.4,-0.1,26,-2,23,36.2,-1,-2,-2,0,-3,-5,-7,-7,"w1718","Motorized",0,"Fri","weekday"
"2452",2018-04-13,"Snodgrass","2","2","1",9.4,-0.1,26,-2,23,36.2,-1,-2,-2,0,-3,-5,-7,-7,"w1718","Hybrid",NA,"Fri","weekday"
"2453",2018-04-14,"Snodgrass","2","2","1",9.4,0,28,2,28,33.6,-2,-1,-2,-2,0,-1,-3,-5,"w1718","Non.motorized",13,"Sat","weekend"
"2454",2018-04-14,"Snodgrass","2","2","1",9.4,0,28,2,28,33.6,-2,-1,-2,-2,0,-1,-3,-5,"w1718","Mechanized",0,"Sat","weekend"
"2455",2018-04-14,"Snodgrass","2","2","1",9.4,0,28,2,28,33.6,-2,-1,-2,-2,0,-1,-3,-5,"w1718","Motorized",0,"Sat","weekend"
"2456",2018-04-14,"Snodgrass","2","2","1",9.4,0,28,2,28,33.6,-2,-1,-2,-2,0,-1,-3,-5,"w1718","Hybrid",NA,"Sat","weekend"
"2457",2018-04-15,"Snodgrass","2","2","1",9.2,-0.2,27,-1,37,34.1,2,-2,-1,-2,1,-1,-2,-4,"w1718","Non.motorized",11,"Sun","weekend"
"2458",2018-04-15,"Snodgrass","2","2","1",9.2,-0.2,27,-1,37,34.1,2,-2,-1,-2,1,-1,-2,-4,"w1718","Mechanized",0,"Sun","weekend"
"2459",2018-04-15,"Snodgrass","2","2","1",9.2,-0.2,27,-1,37,34.1,2,-2,-1,-2,1,-1,-2,-4,"w1718","Motorized",0,"Sun","weekend"
"2460",2018-04-15,"Snodgrass","2","2","1",9.2,-0.2,27,-1,37,34.1,2,-2,-1,-2,1,-1,-2,-4,"w1718","Hybrid",NA,"Sun","weekend"
"2461",2017-12-22,"Washington Gulch","2","2","1",2,0,11,3,17,18.2,0,0,0,0,3,3,3,3,"w1718","Non.motorized",0,"Fri","weekday"
"2462",2017-12-22,"Washington Gulch","2","2","1",2,0,11,3,17,18.2,0,0,0,0,3,3,3,3,"w1718","Mechanized",0,"Fri","weekday"
"2463",2017-12-22,"Washington Gulch","2","2","1",2,0,11,3,17,18.2,0,0,0,0,3,3,3,3,"w1718","Motorized",1,"Fri","weekday"
"2464",2017-12-22,"Washington Gulch","2","2","1",2,0,11,3,17,18.2,0,0,0,0,3,3,3,3,"w1718","Hybrid",0,"Fri","weekday"
"2465",2017-12-23,"Washington Gulch","2","1","1",2.1,0.1,10,-1,21,21,3,0,0,0,2,2,2,2,"w1718","Non.motorized",0,"Sat","weekend"
"2466",2017-12-23,"Washington Gulch","2","1","1",2.1,0.1,10,-1,21,21,3,0,0,0,2,2,2,2,"w1718","Mechanized",0,"Sat","weekend"
"2467",2017-12-23,"Washington Gulch","2","1","1",2.1,0.1,10,-1,21,21,3,0,0,0,2,2,2,2,"w1718","Motorized",0,"Sat","weekend"
"2468",2017-12-23,"Washington Gulch","2","1","1",2.1,0.1,10,-1,21,21,3,0,0,0,2,2,2,2,"w1718","Hybrid",0,"Sat","weekend"
"2469",2017-12-24,"Washington Gulch","1","1","1",2.4,0.3,14,4,19,17.1,-1,3,0,0,3,6,6,6,"w1718","Non.motorized",17,"Sun","weekend"
"2470",2017-12-24,"Washington Gulch","1","1","1",2.4,0.3,14,4,19,17.1,-1,3,0,0,3,6,6,6,"w1718","Mechanized",2,"Sun","weekend"
"2471",2017-12-24,"Washington Gulch","1","1","1",2.4,0.3,14,4,19,17.1,-1,3,0,0,3,6,6,6,"w1718","Motorized",7,"Sun","weekend"
"2472",2017-12-24,"Washington Gulch","1","1","1",2.4,0.3,14,4,19,17.1,-1,3,0,0,3,6,6,6,"w1718","Hybrid",4,"Sun","weekend"
"2473",2017-12-25,"Washington Gulch","2","1","1",2.6,0.2,14,0,25,18.6,4,-1,3,0,4,3,6,6,"w1718","Non.motorized",14,"Mon","weekday"
"2474",2017-12-25,"Washington Gulch","2","1","1",2.6,0.2,14,0,25,18.6,4,-1,3,0,4,3,6,6,"w1718","Mechanized",2,"Mon","weekday"
"2475",2017-12-25,"Washington Gulch","2","1","1",2.6,0.2,14,0,25,18.6,4,-1,3,0,4,3,6,6,"w1718","Motorized",1,"Mon","weekday"
"2476",2017-12-25,"Washington Gulch","2","1","1",2.6,0.2,14,0,25,18.6,4,-1,3,0,4,3,6,6,"w1718","Hybrid",0,"Mon","weekday"
"2477",2017-12-26,"Washington Gulch","1","1","1",3.1,0.5,20,6,25,15.5,0,4,-1,3,6,10,9,12,"w1718","Non.motorized",24,"Tue","weekday"
"2478",2017-12-26,"Washington Gulch","1","1","1",3.1,0.5,20,6,25,15.5,0,4,-1,3,6,10,9,12,"w1718","Mechanized",0,"Tue","weekday"
"2479",2017-12-26,"Washington Gulch","1","1","1",3.1,0.5,20,6,25,15.5,0,4,-1,3,6,10,9,12,"w1718","Motorized",3,"Tue","weekday"
"2480",2017-12-26,"Washington Gulch","1","1","1",3.1,0.5,20,6,25,15.5,0,4,-1,3,6,10,9,12,"w1718","Hybrid",3,"Tue","weekday"
"2481",2017-12-27,"Washington Gulch","1","1","1",3.1,0,18,-2,27,17.2,6,0,4,-1,4,4,8,7,"w1718","Non.motorized",60,"Wed","weekday"
"2482",2017-12-27,"Washington Gulch","1","1","1",3.1,0,18,-2,27,17.2,6,0,4,-1,4,4,8,7,"w1718","Mechanized",0,"Wed","weekday"
"2483",2017-12-27,"Washington Gulch","1","1","1",3.1,0,18,-2,27,17.2,6,0,4,-1,4,4,8,7,"w1718","Motorized",2,"Wed","weekday"
"2484",2017-12-27,"Washington Gulch","1","1","1",3.1,0,18,-2,27,17.2,6,0,4,-1,4,4,8,7,"w1718","Hybrid",2,"Wed","weekday"
"2485",2017-12-28,"Washington Gulch","1","1","1",3.2,0.1,17,-1,31,18.8,-2,6,0,4,-3,3,3,7,"w1718","Non.motorized",74,"Thu","weekday"
"2486",2017-12-28,"Washington Gulch","1","1","1",3.2,0.1,17,-1,31,18.8,-2,6,0,4,-3,3,3,7,"w1718","Mechanized",2,"Thu","weekday"
"2487",2017-12-28,"Washington Gulch","1","1","1",3.2,0.1,17,-1,31,18.8,-2,6,0,4,-3,3,3,7,"w1718","Motorized",4,"Thu","weekday"
"2488",2017-12-28,"Washington Gulch","1","1","1",3.2,0.1,17,-1,31,18.8,-2,6,0,4,-3,3,3,7,"w1718","Hybrid",1,"Thu","weekday"
"2489",2017-12-29,"Washington Gulch","1","1","1",3.2,0,17,0,36,18.8,-1,-2,6,0,-1,-3,3,3,"w1718","Non.motorized",33,"Fri","weekday"
"2490",2017-12-29,"Washington Gulch","1","1","1",3.2,0,17,0,36,18.8,-1,-2,6,0,-1,-3,3,3,"w1718","Mechanized",0,"Fri","weekday"
"2491",2017-12-29,"Washington Gulch","1","1","1",3.2,0,17,0,36,18.8,-1,-2,6,0,-1,-3,3,3,"w1718","Motorized",13,"Fri","weekday"
"2492",2017-12-29,"Washington Gulch","1","1","1",3.2,0,17,0,36,18.8,-1,-2,6,0,-1,-3,3,3,"w1718","Hybrid",8,"Fri","weekday"
"2493",2017-12-30,"Washington Gulch","1","1","1",3.2,0,15,-2,37,21.3,0,-1,-2,6,-2,-3,-5,1,"w1718","Non.motorized",111,"Sat","weekend"
"2494",2017-12-30,"Washington Gulch","1","1","1",3.2,0,15,-2,37,21.3,0,-1,-2,6,-2,-3,-5,1,"w1718","Mechanized",1,"Sat","weekend"
"2495",2017-12-30,"Washington Gulch","1","1","1",3.2,0,15,-2,37,21.3,0,-1,-2,6,-2,-3,-5,1,"w1718","Motorized",2,"Sat","weekend"
"2496",2017-12-30,"Washington Gulch","1","1","1",3.2,0,15,-2,37,21.3,0,-1,-2,6,-2,-3,-5,1,"w1718","Hybrid",0,"Sat","weekend"
"2497",2017-12-31,"Washington Gulch","1","1","1",3.2,0,15,0,31,21.3,-2,0,-1,-2,-2,-2,-3,-5,"w1718","Non.motorized",109,"Sun","weekend"
"2498",2017-12-31,"Washington Gulch","1","1","1",3.2,0,15,0,31,21.3,-2,0,-1,-2,-2,-2,-3,-5,"w1718","Mechanized",0,"Sun","weekend"
"2499",2017-12-31,"Washington Gulch","1","1","1",3.2,0,15,0,31,21.3,-2,0,-1,-2,-2,-2,-3,-5,"w1718","Motorized",6,"Sun","weekend"
"2500",2017-12-31,"Washington Gulch","1","1","1",3.2,0,15,0,31,21.3,-2,0,-1,-2,-2,-2,-3,-5,"w1718","Hybrid",2,"Sun","weekend"
"2501",2018-01-01,"Washington Gulch","1","1","1",3.2,0,15,0,27,21.3,0,-2,0,-1,0,-2,-2,-3,"w1718","Non.motorized",73,"Mon","weekday"
"2502",2018-01-01,"Washington Gulch","1","1","1",3.2,0,15,0,27,21.3,0,-2,0,-1,0,-2,-2,-3,"w1718","Mechanized",2,"Mon","weekday"
"2503",2018-01-01,"Washington Gulch","1","1","1",3.2,0,15,0,27,21.3,0,-2,0,-1,0,-2,-2,-3,"w1718","Motorized",16,"Mon","weekday"
"2504",2018-01-01,"Washington Gulch","1","1","1",3.2,0,15,0,27,21.3,0,-2,0,-1,0,-2,-2,-3,"w1718","Hybrid",4,"Mon","weekday"
"2505",2018-01-02,"Washington Gulch","1","1","1",3.2,0,15,0,22,21.3,0,0,-2,0,0,0,-2,-2,"w1718","Non.motorized",35,"Tue","weekday"
"2506",2018-01-02,"Washington Gulch","1","1","1",3.2,0,15,0,22,21.3,0,0,-2,0,0,0,-2,-2,"w1718","Mechanized",0,"Tue","weekday"
"2507",2018-01-02,"Washington Gulch","1","1","1",3.2,0,15,0,22,21.3,0,0,-2,0,0,0,-2,-2,"w1718","Motorized",1,"Tue","weekday"
"2508",2018-01-02,"Washington Gulch","1","1","1",3.2,0,15,0,22,21.3,0,0,-2,0,0,0,-2,-2,"w1718","Hybrid",0,"Tue","weekday"
"2509",2018-01-03,"Washington Gulch","1","1","1",3.2,0,15,0,27,21.3,0,0,0,-2,0,0,0,-2,"w1718","Non.motorized",NA,"Wed","weekday"
"2510",2018-01-03,"Washington Gulch","1","1","1",3.2,0,15,0,27,21.3,0,0,0,-2,0,0,0,-2,"w1718","Mechanized",NA,"Wed","weekday"
"2511",2018-01-03,"Washington Gulch","1","1","1",3.2,0,15,0,27,21.3,0,0,0,-2,0,0,0,-2,"w1718","Motorized",NA,"Wed","weekday"
"2512",2018-01-03,"Washington Gulch","1","1","1",3.2,0,15,0,27,21.3,0,0,0,-2,0,0,0,-2,"w1718","Hybrid",NA,"Wed","weekday"
"2513",2018-01-04,"Washington Gulch","1","1","1",3.2,0,15,0,29,21.3,0,0,0,0,0,0,0,0,"w1718","Non.motorized",NA,"Thu","weekday"
"2514",2018-01-04,"Washington Gulch","1","1","1",3.2,0,15,0,29,21.3,0,0,0,0,0,0,0,0,"w1718","Mechanized",NA,"Thu","weekday"
"2515",2018-01-04,"Washington Gulch","1","1","1",3.2,0,15,0,29,21.3,0,0,0,0,0,0,0,0,"w1718","Motorized",NA,"Thu","weekday"
"2516",2018-01-04,"Washington Gulch","1","1","1",3.2,0,15,0,29,21.3,0,0,0,0,0,0,0,0,"w1718","Hybrid",NA,"Thu","weekday"
"2517",2018-01-05,"Washington Gulch","1","1","1",3.2,0,14,-1,32,22.9,0,0,0,0,-1,-1,-1,-1,"w1718","Non.motorized",NA,"Fri","weekday"
"2518",2018-01-05,"Washington Gulch","1","1","1",3.2,0,14,-1,32,22.9,0,0,0,0,-1,-1,-1,-1,"w1718","Mechanized",NA,"Fri","weekday"
"2519",2018-01-05,"Washington Gulch","1","1","1",3.2,0,14,-1,32,22.9,0,0,0,0,-1,-1,-1,-1,"w1718","Motorized",NA,"Fri","weekday"
"2520",2018-01-05,"Washington Gulch","1","1","1",3.2,0,14,-1,32,22.9,0,0,0,0,-1,-1,-1,-1,"w1718","Hybrid",NA,"Fri","weekday"
"2521",2018-01-06,"Washington Gulch","1","1","1",3.2,0,14,0,30,22.9,-1,0,0,0,-1,-1,-1,-1,"w1718","Non.motorized",0,"Sat","weekend"
"2522",2018-01-06,"Washington Gulch","1","1","1",3.2,0,14,0,30,22.9,-1,0,0,0,-1,-1,-1,-1,"w1718","Mechanized",1,"Sat","weekend"
"2523",2018-01-06,"Washington Gulch","1","1","1",3.2,0,14,0,30,22.9,-1,0,0,0,-1,-1,-1,-1,"w1718","Motorized",0,"Sat","weekend"
"2524",2018-01-06,"Washington Gulch","1","1","1",3.2,0,14,0,30,22.9,-1,0,0,0,-1,-1,-1,-1,"w1718","Hybrid",0,"Sat","weekend"
"2525",2018-01-07,"Washington Gulch","2","2","2",3.5,0.3,18,4,25,19.4,0,-1,0,0,4,3,3,3,"w1718","Non.motorized",36,"Sun","weekend"
"2526",2018-01-07,"Washington Gulch","2","2","2",3.5,0.3,18,4,25,19.4,0,-1,0,0,4,3,3,3,"w1718","Mechanized",0,"Sun","weekend"
"2527",2018-01-07,"Washington Gulch","2","2","2",3.5,0.3,18,4,25,19.4,0,-1,0,0,4,3,3,3,"w1718","Motorized",8,"Sun","weekend"
"2528",2018-01-07,"Washington Gulch","2","2","2",3.5,0.3,18,4,25,19.4,0,-1,0,0,4,3,3,3,"w1718","Hybrid",2,"Sun","weekend"
"2529",2018-01-08,"Washington Gulch","2","2","1",3.7,0.2,20,2,29,18.5,4,0,-1,0,6,6,5,5,"w1718","Non.motorized",18,"Mon","weekday"
"2530",2018-01-08,"Washington Gulch","2","2","1",3.7,0.2,20,2,29,18.5,4,0,-1,0,6,6,5,5,"w1718","Mechanized",0,"Mon","weekday"
"2531",2018-01-08,"Washington Gulch","2","2","1",3.7,0.2,20,2,29,18.5,4,0,-1,0,6,6,5,5,"w1718","Motorized",4,"Mon","weekday"
"2532",2018-01-08,"Washington Gulch","2","2","1",3.7,0.2,20,2,29,18.5,4,0,-1,0,6,6,5,5,"w1718","Hybrid",4,"Mon","weekday"
"2533",2018-01-09,"Washington Gulch","2","2","1",3.8,0.1,21,1,34,18.1,2,4,0,-1,3,7,7,6,"w1718","Non.motorized",18,"Tue","weekday"
"2534",2018-01-09,"Washington Gulch","2","2","1",3.8,0.1,21,1,34,18.1,2,4,0,-1,3,7,7,6,"w1718","Mechanized",0,"Tue","weekday"
"2535",2018-01-09,"Washington Gulch","2","2","1",3.8,0.1,21,1,34,18.1,2,4,0,-1,3,7,7,6,"w1718","Motorized",3,"Tue","weekday"
"2536",2018-01-09,"Washington Gulch","2","2","1",3.8,0.1,21,1,34,18.1,2,4,0,-1,3,7,7,6,"w1718","Hybrid",1,"Tue","weekday"
"2537",2018-01-10,"Washington Gulch","3","3","3",4,0.2,21,0,28,19,1,2,4,0,1,3,7,7,"w1718","Non.motorized",20,"Wed","weekday"
"2538",2018-01-10,"Washington Gulch","3","3","3",4,0.2,21,0,28,19,1,2,4,0,1,3,7,7,"w1718","Mechanized",0,"Wed","weekday"
"2539",2018-01-10,"Washington Gulch","3","3","3",4,0.2,21,0,28,19,1,2,4,0,1,3,7,7,"w1718","Motorized",0,"Wed","weekday"
"2540",2018-01-10,"Washington Gulch","3","3","3",4,0.2,21,0,28,19,1,2,4,0,1,3,7,7,"w1718","Hybrid",0,"Wed","weekday"
"2541",2018-01-11,"Washington Gulch","3","3","3",4.1,0.1,26,5,17,15.8,0,1,2,4,5,6,8,12,"w1718","Non.motorized",9,"Thu","weekday"
"2542",2018-01-11,"Washington Gulch","3","3","3",4.1,0.1,26,5,17,15.8,0,1,2,4,5,6,8,12,"w1718","Mechanized",0,"Thu","weekday"
"2543",2018-01-11,"Washington Gulch","3","3","3",4.1,0.1,26,5,17,15.8,0,1,2,4,5,6,8,12,"w1718","Motorized",7,"Thu","weekday"
"2544",2018-01-11,"Washington Gulch","3","3","3",4.1,0.1,26,5,17,15.8,0,1,2,4,5,6,8,12,"w1718","Hybrid",7,"Thu","weekday"
"2545",2018-01-12,"Washington Gulch","3","3","3",4.3,0.2,24,-2,22,17.9,5,0,1,2,3,3,4,6,"w1718","Non.motorized",13,"Fri","weekday"
"2546",2018-01-12,"Washington Gulch","3","3","3",4.3,0.2,24,-2,22,17.9,5,0,1,2,3,3,4,6,"w1718","Mechanized",0,"Fri","weekday"
"2547",2018-01-12,"Washington Gulch","3","3","3",4.3,0.2,24,-2,22,17.9,5,0,1,2,3,3,4,6,"w1718","Motorized",0,"Fri","weekday"
"2548",2018-01-12,"Washington Gulch","3","3","3",4.3,0.2,24,-2,22,17.9,5,0,1,2,3,3,4,6,"w1718","Hybrid",0,"Fri","weekday"
"2549",2018-01-13,"Washington Gulch","3","3","3",4.4,0.1,24,0,24,18.3,-2,5,0,1,-2,3,3,4,"w1718","Non.motorized",55,"Sat","weekend"
"2550",2018-01-13,"Washington Gulch","3","3","3",4.4,0.1,24,0,24,18.3,-2,5,0,1,-2,3,3,4,"w1718","Mechanized",0,"Sat","weekend"
"2551",2018-01-13,"Washington Gulch","3","3","3",4.4,0.1,24,0,24,18.3,-2,5,0,1,-2,3,3,4,"w1718","Motorized",5,"Sat","weekend"
"2552",2018-01-13,"Washington Gulch","3","3","3",4.4,0.1,24,0,24,18.3,-2,5,0,1,-2,3,3,4,"w1718","Hybrid",3,"Sat","weekend"
"2553",2018-01-14,"Washington Gulch","3","3","2",4.4,0,24,0,27,18.3,0,-2,5,0,0,-2,3,3,"w1718","Non.motorized",61,"Sun","weekend"
"2554",2018-01-14,"Washington Gulch","3","3","2",4.4,0,24,0,27,18.3,0,-2,5,0,0,-2,3,3,"w1718","Mechanized",0,"Sun","weekend"
"2555",2018-01-14,"Washington Gulch","3","3","2",4.4,0,24,0,27,18.3,0,-2,5,0,0,-2,3,3,"w1718","Motorized",11,"Sun","weekend"
"2556",2018-01-14,"Washington Gulch","3","3","2",4.4,0,24,0,27,18.3,0,-2,5,0,0,-2,3,3,"w1718","Hybrid",10,"Sun","weekend"
"2557",2018-01-15,"Washington Gulch","3","3","2",4.4,0,23,-1,27,19.1,0,0,-2,5,-1,-1,-3,2,"w1718","Non.motorized",39,"Mon","weekday"
"2558",2018-01-15,"Washington Gulch","3","3","2",4.4,0,23,-1,27,19.1,0,0,-2,5,-1,-1,-3,2,"w1718","Mechanized",0,"Mon","weekday"
"2559",2018-01-15,"Washington Gulch","3","3","2",4.4,0,23,-1,27,19.1,0,0,-2,5,-1,-1,-3,2,"w1718","Motorized",4,"Mon","weekday"
"2560",2018-01-15,"Washington Gulch","3","3","2",4.4,0,23,-1,27,19.1,0,0,-2,5,-1,-1,-3,2,"w1718","Hybrid",4,"Mon","weekday"
"2561",2018-01-16,"Washington Gulch","3","3","2",4.4,0,22,-1,20,20,-1,0,0,-2,-2,-2,-2,-4,"w1718","Non.motorized",19,"Tue","weekday"
"2562",2018-01-16,"Washington Gulch","3","3","2",4.4,0,22,-1,20,20,-1,0,0,-2,-2,-2,-2,-4,"w1718","Mechanized",3,"Tue","weekday"
"2563",2018-01-16,"Washington Gulch","3","3","2",4.4,0,22,-1,20,20,-1,0,0,-2,-2,-2,-2,-4,"w1718","Motorized",5,"Tue","weekday"
"2564",2018-01-16,"Washington Gulch","3","3","2",4.4,0,22,-1,20,20,-1,0,0,-2,-2,-2,-2,-4,"w1718","Hybrid",4,"Tue","weekday"
"2565",2018-01-17,"Washington Gulch","2","2","2",4.4,0,22,0,24,20,-1,-1,0,0,-1,-2,-2,-2,"w1718","Non.motorized",15,"Wed","weekday"
"2566",2018-01-17,"Washington Gulch","2","2","2",4.4,0,22,0,24,20,-1,-1,0,0,-1,-2,-2,-2,"w1718","Mechanized",0,"Wed","weekday"
"2567",2018-01-17,"Washington Gulch","2","2","2",4.4,0,22,0,24,20,-1,-1,0,0,-1,-2,-2,-2,"w1718","Motorized",8,"Wed","weekday"
"2568",2018-01-17,"Washington Gulch","2","2","2",4.4,0,22,0,24,20,-1,-1,0,0,-1,-2,-2,-2,"w1718","Hybrid",5,"Wed","weekday"
"2569",2018-01-18,"Washington Gulch","2","2","2",4.4,0,21,-1,29,21,0,-1,-1,0,-1,-2,-3,-3,"w1718","Non.motorized",22,"Thu","weekday"
"2570",2018-01-18,"Washington Gulch","2","2","2",4.4,0,21,-1,29,21,0,-1,-1,0,-1,-2,-3,-3,"w1718","Mechanized",0,"Thu","weekday"
"2571",2018-01-18,"Washington Gulch","2","2","2",4.4,0,21,-1,29,21,0,-1,-1,0,-1,-2,-3,-3,"w1718","Motorized",0,"Thu","weekday"
"2572",2018-01-18,"Washington Gulch","2","2","2",4.4,0,21,-1,29,21,0,-1,-1,0,-1,-2,-3,-3,"w1718","Hybrid",0,"Thu","weekday"
"2573",2018-01-19,"Washington Gulch","2","2","2",4.5,0.1,21,0,34,21.4,-1,0,-1,-1,-1,-1,-2,-3,"w1718","Non.motorized",39,"Fri","weekday"
"2574",2018-01-19,"Washington Gulch","2","2","2",4.5,0.1,21,0,34,21.4,-1,0,-1,-1,-1,-1,-2,-3,"w1718","Mechanized",0,"Fri","weekday"
"2575",2018-01-19,"Washington Gulch","2","2","2",4.5,0.1,21,0,34,21.4,-1,0,-1,-1,-1,-1,-2,-3,"w1718","Motorized",5,"Fri","weekday"
"2576",2018-01-19,"Washington Gulch","2","2","2",4.5,0.1,21,0,34,21.4,-1,0,-1,-1,-1,-1,-2,-3,"w1718","Hybrid",5,"Fri","weekday"
"2577",2018-01-20,"Washington Gulch","2","2","2",4.5,0,21,0,32,21.4,0,-1,0,-1,0,-1,-1,-2,"w1718","Non.motorized",44,"Sat","weekend"
"2578",2018-01-20,"Washington Gulch","2","2","2",4.5,0,21,0,32,21.4,0,-1,0,-1,0,-1,-1,-2,"w1718","Mechanized",1,"Sat","weekend"
"2579",2018-01-20,"Washington Gulch","2","2","2",4.5,0,21,0,32,21.4,0,-1,0,-1,0,-1,-1,-2,"w1718","Motorized",5,"Sat","weekend"
"2580",2018-01-20,"Washington Gulch","2","2","2",4.5,0,21,0,32,21.4,0,-1,0,-1,0,-1,-1,-2,"w1718","Hybrid",2,"Sat","weekend"
"2581",2018-01-21,"Washington Gulch","3","3","3",4.6,0.1,23,2,15,20,0,0,-1,0,2,2,1,1,"w1718","Non.motorized",0,"Sun","weekend"
"2582",2018-01-21,"Washington Gulch","3","3","3",4.6,0.1,23,2,15,20,0,0,-1,0,2,2,1,1,"w1718","Mechanized",0,"Sun","weekend"
"2583",2018-01-21,"Washington Gulch","3","3","3",4.6,0.1,23,2,15,20,0,0,-1,0,2,2,1,1,"w1718","Motorized",0,"Sun","weekend"
"2584",2018-01-21,"Washington Gulch","3","3","3",4.6,0.1,23,2,15,20,0,0,-1,0,2,2,1,1,"w1718","Hybrid",0,"Sun","weekend"
"2585",2018-01-22,"Washington Gulch","3","3","3",4.6,0,21,-2,12,21.9,2,0,0,-1,0,0,0,-1,"w1718","Non.motorized",28,"Mon","weekday"
"2586",2018-01-22,"Washington Gulch","3","3","3",4.6,0,21,-2,12,21.9,2,0,0,-1,0,0,0,-1,"w1718","Mechanized",0,"Mon","weekday"
"2587",2018-01-22,"Washington Gulch","3","3","3",4.6,0,21,-2,12,21.9,2,0,0,-1,0,0,0,-1,"w1718","Motorized",6,"Mon","weekday"
"2588",2018-01-22,"Washington Gulch","3","3","3",4.6,0,21,-2,12,21.9,2,0,0,-1,0,0,0,-1,"w1718","Hybrid",2,"Mon","weekday"
"2589",2018-01-23,"Washington Gulch","3","3","3",4.6,0,22,1,16,20.9,-2,2,0,0,-1,1,1,1,"w1718","Non.motorized",28,"Tue","weekday"
"2590",2018-01-23,"Washington Gulch","3","3","3",4.6,0,22,1,16,20.9,-2,2,0,0,-1,1,1,1,"w1718","Mechanized",1,"Tue","weekday"
"2591",2018-01-23,"Washington Gulch","3","3","3",4.6,0,22,1,16,20.9,-2,2,0,0,-1,1,1,1,"w1718","Motorized",6,"Tue","weekday"
"2592",2018-01-23,"Washington Gulch","3","3","3",4.6,0,22,1,16,20.9,-2,2,0,0,-1,1,1,1,"w1718","Hybrid",6,"Tue","weekday"
"2593",2018-01-24,"Washington Gulch","2","2","2",4.6,0,22,0,22,20.9,1,-2,2,0,1,-1,1,1,"w1718","Non.motorized",21,"Wed","weekday"
"2594",2018-01-24,"Washington Gulch","2","2","2",4.6,0,22,0,22,20.9,1,-2,2,0,1,-1,1,1,"w1718","Mechanized",0,"Wed","weekday"
"2595",2018-01-24,"Washington Gulch","2","2","2",4.6,0,22,0,22,20.9,1,-2,2,0,1,-1,1,1,"w1718","Motorized",10,"Wed","weekday"
"2596",2018-01-24,"Washington Gulch","2","2","2",4.6,0,22,0,22,20.9,1,-2,2,0,1,-1,1,1,"w1718","Hybrid",9,"Wed","weekday"
"2597",2018-01-25,"Washington Gulch","2","2","2",4.6,0,22,0,28,20.9,0,1,-2,2,0,1,-1,1,"w1718","Non.motorized",25,"Thu","weekday"
"2598",2018-01-25,"Washington Gulch","2","2","2",4.6,0,22,0,28,20.9,0,1,-2,2,0,1,-1,1,"w1718","Mechanized",1,"Thu","weekday"
"2599",2018-01-25,"Washington Gulch","2","2","2",4.6,0,22,0,28,20.9,0,1,-2,2,0,1,-1,1,"w1718","Motorized",13,"Thu","weekday"
"2600",2018-01-25,"Washington Gulch","2","2","2",4.6,0,22,0,28,20.9,0,1,-2,2,0,1,-1,1,"w1718","Hybrid",8,"Thu","weekday"
"2601",2018-01-26,"Washington Gulch","2","2","2",4.7,0.1,22,0,15,21.4,0,0,1,-2,0,0,1,-1,"w1718","Non.motorized",14,"Fri","weekday"
"2602",2018-01-26,"Washington Gulch","2","2","2",4.7,0.1,22,0,15,21.4,0,0,1,-2,0,0,1,-1,"w1718","Mechanized",2,"Fri","weekday"
"2603",2018-01-26,"Washington Gulch","2","2","2",4.7,0.1,22,0,15,21.4,0,0,1,-2,0,0,1,-1,"w1718","Motorized",3,"Fri","weekday"
"2604",2018-01-26,"Washington Gulch","2","2","2",4.7,0.1,22,0,15,21.4,0,0,1,-2,0,0,1,-1,"w1718","Hybrid",1,"Fri","weekday"
"2605",2018-01-27,"Washington Gulch","2","2","2",4.7,0,23,1,16,20.4,0,0,0,1,1,1,1,2,"w1718","Non.motorized",53,"Sat","weekend"
"2606",2018-01-27,"Washington Gulch","2","2","2",4.7,0,23,1,16,20.4,0,0,0,1,1,1,1,2,"w1718","Mechanized",1,"Sat","weekend"
"2607",2018-01-27,"Washington Gulch","2","2","2",4.7,0,23,1,16,20.4,0,0,0,1,1,1,1,2,"w1718","Motorized",9,"Sat","weekend"
"2608",2018-01-27,"Washington Gulch","2","2","2",4.7,0,23,1,16,20.4,0,0,0,1,1,1,1,2,"w1718","Hybrid",9,"Sat","weekend"
"2609",2018-01-28,"Washington Gulch","2","2","2",4.7,0,23,0,25,20.4,1,0,0,0,1,1,1,1,"w1718","Non.motorized",101,"Sun","weekend"
"2610",2018-01-28,"Washington Gulch","2","2","2",4.7,0,23,0,25,20.4,1,0,0,0,1,1,1,1,"w1718","Mechanized",1,"Sun","weekend"
"2611",2018-01-28,"Washington Gulch","2","2","2",4.7,0,23,0,25,20.4,1,0,0,0,1,1,1,1,"w1718","Motorized",18,"Sun","weekend"
"2612",2018-01-28,"Washington Gulch","2","2","2",4.7,0,23,0,25,20.4,1,0,0,0,1,1,1,1,"w1718","Hybrid",12,"Sun","weekend"
"2613",2018-01-29,"Washington Gulch","2","2","2",4.8,0.1,22,-1,30,21.8,0,1,0,0,-1,0,0,0,"w1718","Non.motorized",18,"Mon","weekday"
"2614",2018-01-29,"Washington Gulch","2","2","2",4.8,0.1,22,-1,30,21.8,0,1,0,0,-1,0,0,0,"w1718","Mechanized",0,"Mon","weekday"
"2615",2018-01-29,"Washington Gulch","2","2","2",4.8,0.1,22,-1,30,21.8,0,1,0,0,-1,0,0,0,"w1718","Motorized",4,"Mon","weekday"
"2616",2018-01-29,"Washington Gulch","2","2","2",4.8,0.1,22,-1,30,21.8,0,1,0,0,-1,0,0,0,"w1718","Hybrid",4,"Mon","weekday"
"2617",2018-01-30,"Washington Gulch","2","2","2",4.8,0,22,0,34,21.8,-1,0,1,0,-1,-1,0,0,"w1718","Non.motorized",22,"Tue","weekday"
"2618",2018-01-30,"Washington Gulch","2","2","2",4.8,0,22,0,34,21.8,-1,0,1,0,-1,-1,0,0,"w1718","Mechanized",1,"Tue","weekday"
"2619",2018-01-30,"Washington Gulch","2","2","2",4.8,0,22,0,34,21.8,-1,0,1,0,-1,-1,0,0,"w1718","Motorized",6,"Tue","weekday"
"2620",2018-01-30,"Washington Gulch","2","2","2",4.8,0,22,0,34,21.8,-1,0,1,0,-1,-1,0,0,"w1718","Hybrid",2,"Tue","weekday"
"2621",2018-01-31,"Washington Gulch","2","2","2",4.8,0,22,0,34,21.8,0,-1,0,1,0,-1,-1,0,"w1718","Non.motorized",20,"Wed","weekday"
"2622",2018-01-31,"Washington Gulch","2","2","2",4.8,0,22,0,34,21.8,0,-1,0,1,0,-1,-1,0,"w1718","Mechanized",0,"Wed","weekday"
"2623",2018-01-31,"Washington Gulch","2","2","2",4.8,0,22,0,34,21.8,0,-1,0,1,0,-1,-1,0,"w1718","Motorized",3,"Wed","weekday"
"2624",2018-01-31,"Washington Gulch","2","2","2",4.8,0,22,0,34,21.8,0,-1,0,1,0,-1,-1,0,"w1718","Hybrid",2,"Wed","weekday"
"2625",2018-02-01,"Washington Gulch","2","2","2",4.9,0.1,21,-1,32,23.3,0,0,-1,0,-1,-1,-2,-2,"w1718","Non.motorized",21,"Thu","weekday"
"2626",2018-02-01,"Washington Gulch","2","2","2",4.9,0.1,21,-1,32,23.3,0,0,-1,0,-1,-1,-2,-2,"w1718","Mechanized",0,"Thu","weekday"
"2627",2018-02-01,"Washington Gulch","2","2","2",4.9,0.1,21,-1,32,23.3,0,0,-1,0,-1,-1,-2,-2,"w1718","Motorized",5,"Thu","weekday"
"2628",2018-02-01,"Washington Gulch","2","2","2",4.9,0.1,21,-1,32,23.3,0,0,-1,0,-1,-1,-2,-2,"w1718","Hybrid",2,"Thu","weekday"
"2629",2018-02-02,"Washington Gulch","2","2","2",4.9,0,20,-1,33,24.5,-1,0,0,-1,-2,-2,-2,-3,"w1718","Non.motorized",35,"Fri","weekday"
"2630",2018-02-02,"Washington Gulch","2","2","2",4.9,0,20,-1,33,24.5,-1,0,0,-1,-2,-2,-2,-3,"w1718","Mechanized",0,"Fri","weekday"
"2631",2018-02-02,"Washington Gulch","2","2","2",4.9,0,20,-1,33,24.5,-1,0,0,-1,-2,-2,-2,-3,"w1718","Motorized",4,"Fri","weekday"
"2632",2018-02-02,"Washington Gulch","2","2","2",4.9,0,20,-1,33,24.5,-1,0,0,-1,-2,-2,-2,-3,"w1718","Hybrid",4,"Fri","weekday"
"2633",2018-02-03,"Washington Gulch","2","2","2",4.9,0,21,1,32,23.3,-1,-1,0,0,0,-1,-1,-1,"w1718","Non.motorized",53,"Sat","weekend"
"2634",2018-02-03,"Washington Gulch","2","2","2",4.9,0,21,1,32,23.3,-1,-1,0,0,0,-1,-1,-1,"w1718","Mechanized",0,"Sat","weekend"
"2635",2018-02-03,"Washington Gulch","2","2","2",4.9,0,21,1,32,23.3,-1,-1,0,0,0,-1,-1,-1,"w1718","Motorized",3,"Sat","weekend"
"2636",2018-02-03,"Washington Gulch","2","2","2",4.9,0,21,1,32,23.3,-1,-1,0,0,0,-1,-1,-1,"w1718","Hybrid",3,"Sat","weekend"
"2637",2018-02-04,"Washington Gulch","2","2","2",4.9,0,19,-2,32,25.8,1,-1,-1,0,-1,-2,-3,-3,"w1718","Non.motorized",69,"Sun","weekend"
"2638",2018-02-04,"Washington Gulch","2","2","2",4.9,0,19,-2,32,25.8,1,-1,-1,0,-1,-2,-3,-3,"w1718","Mechanized",2,"Sun","weekend"
"2639",2018-02-04,"Washington Gulch","2","2","2",4.9,0,19,-2,32,25.8,1,-1,-1,0,-1,-2,-3,-3,"w1718","Motorized",11,"Sun","weekend"
"2640",2018-02-04,"Washington Gulch","2","2","2",4.9,0,19,-2,32,25.8,1,-1,-1,0,-1,-2,-3,-3,"w1718","Hybrid",5,"Sun","weekend"
"2641",2018-02-05,"Washington Gulch","2","2","2",5,0.1,18,-1,29,27.8,-2,1,-1,-1,-3,-2,-3,-4,"w1718","Non.motorized",10,"Mon","weekday"
"2642",2018-02-05,"Washington Gulch","2","2","2",5,0.1,18,-1,29,27.8,-2,1,-1,-1,-3,-2,-3,-4,"w1718","Mechanized",0,"Mon","weekday"
"2643",2018-02-05,"Washington Gulch","2","2","2",5,0.1,18,-1,29,27.8,-2,1,-1,-1,-3,-2,-3,-4,"w1718","Motorized",2,"Mon","weekday"
"2644",2018-02-05,"Washington Gulch","2","2","2",5,0.1,18,-1,29,27.8,-2,1,-1,-1,-3,-2,-3,-4,"w1718","Hybrid",0,"Mon","weekday"
"2645",2018-02-06,"Washington Gulch","2","2","2",5.2,0.2,23,5,22,22.6,-1,-2,1,-1,4,2,3,2,"w1718","Non.motorized",18,"Tue","weekday"
"2646",2018-02-06,"Washington Gulch","2","2","2",5.2,0.2,23,5,22,22.6,-1,-2,1,-1,4,2,3,2,"w1718","Mechanized",0,"Tue","weekday"
"2647",2018-02-06,"Washington Gulch","2","2","2",5.2,0.2,23,5,22,22.6,-1,-2,1,-1,4,2,3,2,"w1718","Motorized",8,"Tue","weekday"
"2648",2018-02-06,"Washington Gulch","2","2","2",5.2,0.2,23,5,22,22.6,-1,-2,1,-1,4,2,3,2,"w1718","Hybrid",6,"Tue","weekday"
"2649",2018-02-07,"Washington Gulch","2","2","2",5.2,0,23,0,24,22.6,5,-1,-2,1,5,4,2,3,"w1718","Non.motorized",43,"Wed","weekday"
"2650",2018-02-07,"Washington Gulch","2","2","2",5.2,0,23,0,24,22.6,5,-1,-2,1,5,4,2,3,"w1718","Mechanized",0,"Wed","weekday"
"2651",2018-02-07,"Washington Gulch","2","2","2",5.2,0,23,0,24,22.6,5,-1,-2,1,5,4,2,3,"w1718","Motorized",6,"Wed","weekday"
"2652",2018-02-07,"Washington Gulch","2","2","2",5.2,0,23,0,24,22.6,5,-1,-2,1,5,4,2,3,"w1718","Hybrid",4,"Wed","weekday"
"2653",2018-02-08,"Washington Gulch","2","2","1",5.3,0.1,25,2,28,21.2,0,5,-1,-2,2,7,6,4,"w1718","Non.motorized",18,"Thu","weekday"
"2654",2018-02-08,"Washington Gulch","2","2","1",5.3,0.1,25,2,28,21.2,0,5,-1,-2,2,7,6,4,"w1718","Mechanized",0,"Thu","weekday"
"2655",2018-02-08,"Washington Gulch","2","2","1",5.3,0.1,25,2,28,21.2,0,5,-1,-2,2,7,6,4,"w1718","Motorized",10,"Thu","weekday"
"2656",2018-02-08,"Washington Gulch","2","2","1",5.3,0.1,25,2,28,21.2,0,5,-1,-2,2,7,6,4,"w1718","Hybrid",8,"Thu","weekday"
"2657",2018-02-09,"Washington Gulch","2","2","1",5.3,0,24,-1,33,22.1,2,0,5,-1,1,1,6,5,"w1718","Non.motorized",27,"Fri","weekday"
"2658",2018-02-09,"Washington Gulch","2","2","1",5.3,0,24,-1,33,22.1,2,0,5,-1,1,1,6,5,"w1718","Mechanized",2,"Fri","weekday"
"2659",2018-02-09,"Washington Gulch","2","2","1",5.3,0,24,-1,33,22.1,2,0,5,-1,1,1,6,5,"w1718","Motorized",4,"Fri","weekday"
"2660",2018-02-09,"Washington Gulch","2","2","1",5.3,0,24,-1,33,22.1,2,0,5,-1,1,1,6,5,"w1718","Hybrid",3,"Fri","weekday"
"2661",2018-02-10,"Washington Gulch","3","3","2",5.3,0,24,0,24,22.1,-1,2,0,5,-1,1,1,6,"w1718","Non.motorized",28,"Sat","weekend"
"2662",2018-02-10,"Washington Gulch","3","3","2",5.3,0,24,0,24,22.1,-1,2,0,5,-1,1,1,6,"w1718","Mechanized",0,"Sat","weekend"
"2663",2018-02-10,"Washington Gulch","3","3","2",5.3,0,24,0,24,22.1,-1,2,0,5,-1,1,1,6,"w1718","Motorized",3,"Sat","weekend"
"2664",2018-02-10,"Washington Gulch","3","3","2",5.3,0,24,0,24,22.1,-1,2,0,5,-1,1,1,6,"w1718","Hybrid",2,"Sat","weekend"
"2665",2018-02-11,"Washington Gulch","3","3","2",5.6,0.3,27,3,13,20.7,0,-1,2,0,3,2,4,4,"w1718","Non.motorized",43,"Sun","weekend"
"2666",2018-02-11,"Washington Gulch","3","3","2",5.6,0.3,27,3,13,20.7,0,-1,2,0,3,2,4,4,"w1718","Mechanized",1,"Sun","weekend"
"2667",2018-02-11,"Washington Gulch","3","3","2",5.6,0.3,27,3,13,20.7,0,-1,2,0,3,2,4,4,"w1718","Motorized",13,"Sun","weekend"
"2668",2018-02-11,"Washington Gulch","3","3","2",5.6,0.3,27,3,13,20.7,0,-1,2,0,3,2,4,4,"w1718","Hybrid",9,"Sun","weekend"
"2669",2018-02-12,"Washington Gulch","3","3","3",5.7,0.1,27,0,23,21.1,3,0,-1,2,3,3,2,4,"w1718","Non.motorized",20,"Mon","weekday"
"2670",2018-02-12,"Washington Gulch","3","3","3",5.7,0.1,27,0,23,21.1,3,0,-1,2,3,3,2,4,"w1718","Mechanized",0,"Mon","weekday"
"2671",2018-02-12,"Washington Gulch","3","3","3",5.7,0.1,27,0,23,21.1,3,0,-1,2,3,3,2,4,"w1718","Motorized",2,"Mon","weekday"
"2672",2018-02-12,"Washington Gulch","3","3","3",5.7,0.1,27,0,23,21.1,3,0,-1,2,3,3,2,4,"w1718","Hybrid",2,"Mon","weekday"
"2673",2018-02-13,"Washington Gulch","3","3","3",6.1,0.4,29,2,28,21,0,3,0,-1,2,5,5,4,"w1718","Non.motorized",9,"Tue","weekday"
"2674",2018-02-13,"Washington Gulch","3","3","3",6.1,0.4,29,2,28,21,0,3,0,-1,2,5,5,4,"w1718","Mechanized",0,"Tue","weekday"
"2675",2018-02-13,"Washington Gulch","3","3","3",6.1,0.4,29,2,28,21,0,3,0,-1,2,5,5,4,"w1718","Motorized",1,"Tue","weekday"
"2676",2018-02-13,"Washington Gulch","3","3","3",6.1,0.4,29,2,28,21,0,3,0,-1,2,5,5,4,"w1718","Hybrid",0,"Tue","weekday"
"2677",2018-02-14,"Washington Gulch","3","3","3",6.2,0.1,30,1,30,20.7,2,0,3,0,3,3,6,6,"w1718","Non.motorized",30,"Wed","weekday"
"2678",2018-02-14,"Washington Gulch","3","3","3",6.2,0.1,30,1,30,20.7,2,0,3,0,3,3,6,6,"w1718","Mechanized",0,"Wed","weekday"
"2679",2018-02-14,"Washington Gulch","3","3","3",6.2,0.1,30,1,30,20.7,2,0,3,0,3,3,6,6,"w1718","Motorized",2,"Wed","weekday"
"2680",2018-02-14,"Washington Gulch","3","3","3",6.2,0.1,30,1,30,20.7,2,0,3,0,3,3,6,6,"w1718","Hybrid",0,"Wed","weekday"
"2681",2018-02-15,"Washington Gulch","3","3","3",6.3,0.1,28,-2,24,22.5,1,2,0,3,-1,1,1,4,"w1718","Non.motorized",13,"Thu","weekday"
"2682",2018-02-15,"Washington Gulch","3","3","3",6.3,0.1,28,-2,24,22.5,1,2,0,3,-1,1,1,4,"w1718","Mechanized",0,"Thu","weekday"
"2683",2018-02-15,"Washington Gulch","3","3","3",6.3,0.1,28,-2,24,22.5,1,2,0,3,-1,1,1,4,"w1718","Motorized",3,"Thu","weekday"
"2684",2018-02-15,"Washington Gulch","3","3","3",6.3,0.1,28,-2,24,22.5,1,2,0,3,-1,1,1,4,"w1718","Hybrid",3,"Thu","weekday"
"2685",2018-02-16,"Washington Gulch","3","3","3",6.7,0.4,32,4,18,20.9,-2,1,2,0,2,3,5,5,"w1718","Non.motorized",33,"Fri","weekday"
"2686",2018-02-16,"Washington Gulch","3","3","3",6.7,0.4,32,4,18,20.9,-2,1,2,0,2,3,5,5,"w1718","Mechanized",0,"Fri","weekday"
"2687",2018-02-16,"Washington Gulch","3","3","3",6.7,0.4,32,4,18,20.9,-2,1,2,0,2,3,5,5,"w1718","Motorized",4,"Fri","weekday"
"2688",2018-02-16,"Washington Gulch","3","3","3",6.7,0.4,32,4,18,20.9,-2,1,2,0,2,3,5,5,"w1718","Hybrid",3,"Fri","weekday"
"2689",2018-02-17,"Washington Gulch","3","3","2",6.7,0,32,0,25,20.9,4,-2,1,2,4,2,3,5,"w1718","Non.motorized",84,"Sat","weekend"
"2690",2018-02-17,"Washington Gulch","3","3","2",6.7,0,32,0,25,20.9,4,-2,1,2,4,2,3,5,"w1718","Mechanized",1,"Sat","weekend"
"2691",2018-02-17,"Washington Gulch","3","3","2",6.7,0,32,0,25,20.9,4,-2,1,2,4,2,3,5,"w1718","Motorized",18,"Sat","weekend"
"2692",2018-02-17,"Washington Gulch","3","3","2",6.7,0,32,0,25,20.9,4,-2,1,2,4,2,3,5,"w1718","Hybrid",9,"Sat","weekend"
"2693",2018-02-18,"Washington Gulch","2","2","2",6.7,0,31,-1,32,21.6,0,4,-2,1,-1,3,1,2,"w1718","Non.motorized",81,"Sun","weekend"
"2694",2018-02-18,"Washington Gulch","2","2","2",6.7,0,31,-1,32,21.6,0,4,-2,1,-1,3,1,2,"w1718","Mechanized",0,"Sun","weekend"
"2695",2018-02-18,"Washington Gulch","2","2","2",6.7,0,31,-1,32,21.6,0,4,-2,1,-1,3,1,2,"w1718","Motorized",14,"Sun","weekend"
"2696",2018-02-18,"Washington Gulch","2","2","2",6.7,0,31,-1,32,21.6,0,4,-2,1,-1,3,1,2,"w1718","Hybrid",5,"Sun","weekend"
"2697",2018-02-19,"Washington Gulch","2","2","2",6.8,0.1,29,-2,24,23.4,-1,0,4,-2,-3,-3,1,-1,"w1718","Non.motorized",21,"Mon","weekday"
"2698",2018-02-19,"Washington Gulch","2","2","2",6.8,0.1,29,-2,24,23.4,-1,0,4,-2,-3,-3,1,-1,"w1718","Mechanized",0,"Mon","weekday"
"2699",2018-02-19,"Washington Gulch","2","2","2",6.8,0.1,29,-2,24,23.4,-1,0,4,-2,-3,-3,1,-1,"w1718","Motorized",2,"Mon","weekday"
"2700",2018-02-19,"Washington Gulch","2","2","2",6.8,0.1,29,-2,24,23.4,-1,0,4,-2,-3,-3,1,-1,"w1718","Hybrid",0,"Mon","weekday"
"2701",2018-02-19,"Washington Gulch","3","3","3",6.8,0.1,29,-2,24,23.4,-1,0,4,-2,-3,-3,1,-1,"w1718","Non.motorized",21,"Mon","weekday"
"2702",2018-02-19,"Washington Gulch","3","3","3",6.8,0.1,29,-2,24,23.4,-1,0,4,-2,-3,-3,1,-1,"w1718","Mechanized",0,"Mon","weekday"
"2703",2018-02-19,"Washington Gulch","3","3","3",6.8,0.1,29,-2,24,23.4,-1,0,4,-2,-3,-3,1,-1,"w1718","Motorized",2,"Mon","weekday"
"2704",2018-02-19,"Washington Gulch","3","3","3",6.8,0.1,29,-2,24,23.4,-1,0,4,-2,-3,-3,1,-1,"w1718","Hybrid",0,"Mon","weekday"
"2705",2018-02-20,"Washington Gulch","3","3","3",6.8,0,31,2,8,21.9,-2,-1,0,4,0,-1,-1,3,"w1718","Non.motorized",19,"Tue","weekday"
"2706",2018-02-20,"Washington Gulch","3","3","3",6.8,0,31,2,8,21.9,-2,-1,0,4,0,-1,-1,3,"w1718","Mechanized",0,"Tue","weekday"
"2707",2018-02-20,"Washington Gulch","3","3","3",6.8,0,31,2,8,21.9,-2,-1,0,4,0,-1,-1,3,"w1718","Motorized",2,"Tue","weekday"
"2708",2018-02-20,"Washington Gulch","3","3","3",6.8,0,31,2,8,21.9,-2,-1,0,4,0,-1,-1,3,"w1718","Hybrid",0,"Tue","weekday"
"2709",2018-02-21,"Washington Gulch","3","3","3",6.8,0,31,0,11,21.9,2,-2,-1,0,2,0,-1,-1,"w1718","Non.motorized",16,"Wed","weekday"
"2710",2018-02-21,"Washington Gulch","3","3","3",6.8,0,31,0,11,21.9,2,-2,-1,0,2,0,-1,-1,"w1718","Mechanized",0,"Wed","weekday"
"2711",2018-02-21,"Washington Gulch","3","3","3",6.8,0,31,0,11,21.9,2,-2,-1,0,2,0,-1,-1,"w1718","Motorized",4,"Wed","weekday"
"2712",2018-02-21,"Washington Gulch","3","3","3",6.8,0,31,0,11,21.9,2,-2,-1,0,2,0,-1,-1,"w1718","Hybrid",2,"Wed","weekday"
"2713",2018-02-22,"Washington Gulch","3","3","2",6.8,0,30,-1,16,22.7,0,2,-2,-1,-1,1,-1,-2,"w1718","Non.motorized",20,"Thu","weekday"
"2714",2018-02-22,"Washington Gulch","3","3","2",6.8,0,30,-1,16,22.7,0,2,-2,-1,-1,1,-1,-2,"w1718","Mechanized",0,"Thu","weekday"
"2715",2018-02-22,"Washington Gulch","3","3","2",6.8,0,30,-1,16,22.7,0,2,-2,-1,-1,1,-1,-2,"w1718","Motorized",0,"Thu","weekday"
"2716",2018-02-22,"Washington Gulch","3","3","2",6.8,0,30,-1,16,22.7,0,2,-2,-1,-1,1,-1,-2,"w1718","Hybrid",0,"Thu","weekday"
"2717",2018-02-23,"Washington Gulch","3","3","2",6.9,0.1,30,0,15,23,-1,0,2,-2,-1,-1,1,-1,"w1718","Non.motorized",21,"Fri","weekday"
"2718",2018-02-23,"Washington Gulch","3","3","2",6.9,0.1,30,0,15,23,-1,0,2,-2,-1,-1,1,-1,"w1718","Mechanized",0,"Fri","weekday"
"2719",2018-02-23,"Washington Gulch","3","3","2",6.9,0.1,30,0,15,23,-1,0,2,-2,-1,-1,1,-1,"w1718","Motorized",5,"Fri","weekday"
"2720",2018-02-23,"Washington Gulch","3","3","2",6.9,0.1,30,0,15,23,-1,0,2,-2,-1,-1,1,-1,"w1718","Hybrid",1,"Fri","weekday"
"2721",2018-02-24,"Washington Gulch","3","3","2",6.9,0,31,1,10,22.3,0,-1,0,2,1,0,0,2,"w1718","Non.motorized",40,"Sat","weekend"
"2722",2018-02-24,"Washington Gulch","3","3","2",6.9,0,31,1,10,22.3,0,-1,0,2,1,0,0,2,"w1718","Mechanized",0,"Sat","weekend"
"2723",2018-02-24,"Washington Gulch","3","3","2",6.9,0,31,1,10,22.3,0,-1,0,2,1,0,0,2,"w1718","Motorized",20,"Sat","weekend"
"2724",2018-02-24,"Washington Gulch","3","3","2",6.9,0,31,1,10,22.3,0,-1,0,2,1,0,0,2,"w1718","Hybrid",11,"Sat","weekend"
"2725",2018-02-25,"Washington Gulch","3","3","2",7.1,0.2,32,1,11,22.2,1,0,-1,0,2,2,1,1,"w1718","Non.motorized",35,"Sun","weekend"
"2726",2018-02-25,"Washington Gulch","3","3","2",7.1,0.2,32,1,11,22.2,1,0,-1,0,2,2,1,1,"w1718","Mechanized",0,"Sun","weekend"
"2727",2018-02-25,"Washington Gulch","3","3","2",7.1,0.2,32,1,11,22.2,1,0,-1,0,2,2,1,1,"w1718","Motorized",11,"Sun","weekend"
"2728",2018-02-25,"Washington Gulch","3","3","2",7.1,0.2,32,1,11,22.2,1,0,-1,0,2,2,1,1,"w1718","Hybrid",6,"Sun","weekend"
"2729",2018-02-26,"Washington Gulch","2","2","2",7.1,0,32,0,20,22.2,1,1,0,-1,1,2,2,1,"w1718","Non.motorized",19,"Mon","weekday"
"2730",2018-02-26,"Washington Gulch","2","2","2",7.1,0,32,0,20,22.2,1,1,0,-1,1,2,2,1,"w1718","Mechanized",0,"Mon","weekday"
"2731",2018-02-26,"Washington Gulch","2","2","2",7.1,0,32,0,20,22.2,1,1,0,-1,1,2,2,1,"w1718","Motorized",13,"Mon","weekday"
"2732",2018-02-26,"Washington Gulch","2","2","2",7.1,0,32,0,20,22.2,1,1,0,-1,1,2,2,1,"w1718","Hybrid",9,"Mon","weekday"
"2733",2018-02-27,"Washington Gulch","2","2","2",7.2,0.1,32,0,26,22.5,0,1,1,0,0,1,2,2,"w1718","Non.motorized",30,"Tue","weekday"
"2734",2018-02-27,"Washington Gulch","2","2","2",7.2,0.1,32,0,26,22.5,0,1,1,0,0,1,2,2,"w1718","Mechanized",1,"Tue","weekday"
"2735",2018-02-27,"Washington Gulch","2","2","2",7.2,0.1,32,0,26,22.5,0,1,1,0,0,1,2,2,"w1718","Motorized",10,"Tue","weekday"
"2736",2018-02-27,"Washington Gulch","2","2","2",7.2,0.1,32,0,26,22.5,0,1,1,0,0,1,2,2,"w1718","Hybrid",5,"Tue","weekday"
"2737",2018-02-28,"Washington Gulch","2","2","2",7.2,0,31,-1,23,23.2,0,0,1,1,-1,-1,0,1,"w1718","Non.motorized",17,"Wed","weekday"
"2738",2018-02-28,"Washington Gulch","2","2","2",7.2,0,31,-1,23,23.2,0,0,1,1,-1,-1,0,1,"w1718","Mechanized",0,"Wed","weekday"
"2739",2018-02-28,"Washington Gulch","2","2","2",7.2,0,31,-1,23,23.2,0,0,1,1,-1,-1,0,1,"w1718","Motorized",7,"Wed","weekday"
"2740",2018-02-28,"Washington Gulch","2","2","2",7.2,0,31,-1,23,23.2,0,0,1,1,-1,-1,0,1,"w1718","Hybrid",3,"Wed","weekday"
"2741",2018-03-01,"Washington Gulch","2","2","2",7.2,0,31,0,24,23.2,-1,0,0,1,-1,-1,-1,0,"w1718","Non.motorized",25,"Thu","weekday"
"2742",2018-03-01,"Washington Gulch","2","2","2",7.2,0,31,0,24,23.2,-1,0,0,1,-1,-1,-1,0,"w1718","Mechanized",2,"Thu","weekday"
"2743",2018-03-01,"Washington Gulch","2","2","2",7.2,0,31,0,24,23.2,-1,0,0,1,-1,-1,-1,0,"w1718","Motorized",8,"Thu","weekday"
"2744",2018-03-01,"Washington Gulch","2","2","2",7.2,0,31,0,24,23.2,-1,0,0,1,-1,-1,-1,0,"w1718","Hybrid",4,"Thu","weekday"
"2745",2018-03-02,"Washington Gulch","2","2","1",7.2,0,31,0,30,23.2,0,-1,0,0,0,-1,-1,-1,"w1718","Non.motorized",17,"Fri","weekday"
"2746",2018-03-02,"Washington Gulch","2","2","1",7.2,0,31,0,30,23.2,0,-1,0,0,0,-1,-1,-1,"w1718","Mechanized",0,"Fri","weekday"
"2747",2018-03-02,"Washington Gulch","2","2","1",7.2,0,31,0,30,23.2,0,-1,0,0,0,-1,-1,-1,"w1718","Motorized",11,"Fri","weekday"
"2748",2018-03-02,"Washington Gulch","2","2","1",7.2,0,31,0,30,23.2,0,-1,0,0,0,-1,-1,-1,"w1718","Hybrid",6,"Fri","weekday"
"2749",2018-03-03,"Washington Gulch","2","2","1",7.3,0.1,30,-1,34,24.3,0,0,-1,0,-1,-1,-2,-2,"w1718","Non.motorized",103,"Sat","weekend"
"2750",2018-03-03,"Washington Gulch","2","2","1",7.3,0.1,30,-1,34,24.3,0,0,-1,0,-1,-1,-2,-2,"w1718","Mechanized",0,"Sat","weekend"
"2751",2018-03-03,"Washington Gulch","2","2","1",7.3,0.1,30,-1,34,24.3,0,0,-1,0,-1,-1,-2,-2,"w1718","Motorized",21,"Sat","weekend"
"2752",2018-03-03,"Washington Gulch","2","2","1",7.3,0.1,30,-1,34,24.3,0,0,-1,0,-1,-1,-2,-2,"w1718","Hybrid",5,"Sat","weekend"
"2753",2018-03-04,"Washington Gulch","2","2","1",7.3,0,29,-1,24,25.2,-1,0,0,-1,-2,-2,-2,-3,"w1718","Non.motorized",39,"Sun","weekend"
"2754",2018-03-04,"Washington Gulch","2","2","1",7.3,0,29,-1,24,25.2,-1,0,0,-1,-2,-2,-2,-3,"w1718","Mechanized",2,"Sun","weekend"
"2755",2018-03-04,"Washington Gulch","2","2","1",7.3,0,29,-1,24,25.2,-1,0,0,-1,-2,-2,-2,-3,"w1718","Motorized",6,"Sun","weekend"
"2756",2018-03-04,"Washington Gulch","2","2","1",7.3,0,29,-1,24,25.2,-1,0,0,-1,-2,-2,-2,-3,"w1718","Hybrid",0,"Sun","weekend"
"2757",2018-03-05,"Washington Gulch","2","2","1",7.3,0,31,2,13,23.5,-1,-1,0,0,1,0,0,0,"w1718","Non.motorized",10,"Mon","weekday"
"2758",2018-03-05,"Washington Gulch","2","2","1",7.3,0,31,2,13,23.5,-1,-1,0,0,1,0,0,0,"w1718","Mechanized",0,"Mon","weekday"
"2759",2018-03-05,"Washington Gulch","2","2","1",7.3,0,31,2,13,23.5,-1,-1,0,0,1,0,0,0,"w1718","Motorized",5,"Mon","weekday"
"2760",2018-03-05,"Washington Gulch","2","2","1",7.3,0,31,2,13,23.5,-1,-1,0,0,1,0,0,0,"w1718","Hybrid",0,"Mon","weekday"
"2761",2018-03-06,"Washington Gulch","2","2","1",7.3,0,31,0,19,23.5,2,-1,-1,0,2,1,0,0,"w1718","Non.motorized",17,"Tue","weekday"
"2762",2018-03-06,"Washington Gulch","2","2","1",7.3,0,31,0,19,23.5,2,-1,-1,0,2,1,0,0,"w1718","Mechanized",0,"Tue","weekday"
"2763",2018-03-06,"Washington Gulch","2","2","1",7.3,0,31,0,19,23.5,2,-1,-1,0,2,1,0,0,"w1718","Motorized",10,"Tue","weekday"
"2764",2018-03-06,"Washington Gulch","2","2","1",7.3,0,31,0,19,23.5,2,-1,-1,0,2,1,0,0,"w1718","Hybrid",6,"Tue","weekday"
"2765",2018-03-07,"Washington Gulch","2","2","1",7.4,0.1,31,0,27,23.9,0,2,-1,-1,0,2,1,0,"w1718","Non.motorized",22,"Wed","weekday"
"2766",2018-03-07,"Washington Gulch","2","2","1",7.4,0.1,31,0,27,23.9,0,2,-1,-1,0,2,1,0,"w1718","Mechanized",0,"Wed","weekday"
"2767",2018-03-07,"Washington Gulch","2","2","1",7.4,0.1,31,0,27,23.9,0,2,-1,-1,0,2,1,0,"w1718","Motorized",2,"Wed","weekday"
"2768",2018-03-07,"Washington Gulch","2","2","1",7.4,0.1,31,0,27,23.9,0,2,-1,-1,0,2,1,0,"w1718","Hybrid",2,"Wed","weekday"
"2769",2018-03-08,"Washington Gulch","2","2","1",7.4,0,30,-1,33,24.7,0,0,2,-1,-1,-1,1,0,"w1718","Non.motorized",17,"Thu","weekday"
"2770",2018-03-08,"Washington Gulch","2","2","1",7.4,0,30,-1,33,24.7,0,0,2,-1,-1,-1,1,0,"w1718","Mechanized",1,"Thu","weekday"
"2771",2018-03-08,"Washington Gulch","2","2","1",7.4,0,30,-1,33,24.7,0,0,2,-1,-1,-1,1,0,"w1718","Motorized",15,"Thu","weekday"
"2772",2018-03-08,"Washington Gulch","2","2","1",7.4,0,30,-1,33,24.7,0,0,2,-1,-1,-1,1,0,"w1718","Hybrid",8,"Thu","weekday"
"2773",2018-03-09,"Washington Gulch","2","2","1",7.4,0,30,0,34,24.7,-1,0,0,2,-1,-1,-1,1,"w1718","Non.motorized",26,"Fri","weekday"
"2774",2018-03-09,"Washington Gulch","2","2","1",7.4,0,30,0,34,24.7,-1,0,0,2,-1,-1,-1,1,"w1718","Mechanized",3,"Fri","weekday"
"2775",2018-03-09,"Washington Gulch","2","2","1",7.4,0,30,0,34,24.7,-1,0,0,2,-1,-1,-1,1,"w1718","Motorized",3,"Fri","weekday"
"2776",2018-03-09,"Washington Gulch","2","2","1",7.4,0,30,0,34,24.7,-1,0,0,2,-1,-1,-1,1,"w1718","Hybrid",2,"Fri","weekday"
"2777",2018-03-10,"Washington Gulch","1","1","1",7.4,0,30,0,31,24.7,0,-1,0,0,0,-1,-1,-1,"w1718","Non.motorized",69,"Sat","weekend"
"2778",2018-03-10,"Washington Gulch","1","1","1",7.4,0,30,0,31,24.7,0,-1,0,0,0,-1,-1,-1,"w1718","Mechanized",2,"Sat","weekend"
"2779",2018-03-10,"Washington Gulch","1","1","1",7.4,0,30,0,31,24.7,0,-1,0,0,0,-1,-1,-1,"w1718","Motorized",4,"Sat","weekend"
"2780",2018-03-10,"Washington Gulch","1","1","1",7.4,0,30,0,31,24.7,0,-1,0,0,0,-1,-1,-1,"w1718","Hybrid",3,"Sat","weekend"
"2781",2018-03-11,"Washington Gulch","1","1","1",7.4,0,29,-1,31,25.5,0,0,-1,0,-1,-1,-2,-2,"w1718","Non.motorized",35,"Sun","weekend"
"2782",2018-03-11,"Washington Gulch","1","1","1",7.4,0,29,-1,31,25.5,0,0,-1,0,-1,-1,-2,-2,"w1718","Mechanized",3,"Sun","weekend"
"2783",2018-03-11,"Washington Gulch","1","1","1",7.4,0,29,-1,31,25.5,0,0,-1,0,-1,-1,-2,-2,"w1718","Motorized",15,"Sun","weekend"
"2784",2018-03-11,"Washington Gulch","1","1","1",7.4,0,29,-1,31,25.5,0,0,-1,0,-1,-1,-2,-2,"w1718","Hybrid",10,"Sun","weekend"
"2785",2018-03-12,"Washington Gulch","1","1","1",7.4,0,29,0,33,25.5,-1,0,0,-1,-1,-1,-1,-2,"w1718","Non.motorized",18,"Mon","weekday"
"2786",2018-03-12,"Washington Gulch","1","1","1",7.4,0,29,0,33,25.5,-1,0,0,-1,-1,-1,-1,-2,"w1718","Mechanized",0,"Mon","weekday"
"2787",2018-03-12,"Washington Gulch","1","1","1",7.4,0,29,0,33,25.5,-1,0,0,-1,-1,-1,-1,-2,"w1718","Motorized",12,"Mon","weekday"
"2788",2018-03-12,"Washington Gulch","1","1","1",7.4,0,29,0,33,25.5,-1,0,0,-1,-1,-1,-1,-2,"w1718","Hybrid",9,"Mon","weekday"
"2789",2018-03-13,"Washington Gulch","1","1","1",7.4,0,29,0,34,25.5,0,-1,0,0,0,-1,-1,-1,"w1718","Non.motorized",20,"Tue","weekday"
"2790",2018-03-13,"Washington Gulch","1","1","1",7.4,0,29,0,34,25.5,0,-1,0,0,0,-1,-1,-1,"w1718","Mechanized",2,"Tue","weekday"
"2791",2018-03-13,"Washington Gulch","1","1","1",7.4,0,29,0,34,25.5,0,-1,0,0,0,-1,-1,-1,"w1718","Motorized",7,"Tue","weekday"
"2792",2018-03-13,"Washington Gulch","1","1","1",7.4,0,29,0,34,25.5,0,-1,0,0,0,-1,-1,-1,"w1718","Hybrid",6,"Tue","weekday"
"2793",2018-03-14,"Washington Gulch","1","2","2",7.4,0,29,0,39,25.5,0,0,-1,0,0,0,-1,-1,"w1718","Non.motorized",31,"Wed","weekday"
"2794",2018-03-14,"Washington Gulch","1","2","2",7.4,0,29,0,39,25.5,0,0,-1,0,0,0,-1,-1,"w1718","Mechanized",1,"Wed","weekday"
"2795",2018-03-14,"Washington Gulch","1","2","2",7.4,0,29,0,39,25.5,0,0,-1,0,0,0,-1,-1,"w1718","Motorized",9,"Wed","weekday"
"2796",2018-03-14,"Washington Gulch","1","2","2",7.4,0,29,0,39,25.5,0,0,-1,0,0,0,-1,-1,"w1718","Hybrid",5,"Wed","weekday"
"2797",2018-03-15,"Washington Gulch","2","2","2",7.5,0.1,28,-1,31,26.8,0,0,0,-1,-1,-1,-1,-2,"w1718","Non.motorized",20,"Thu","weekday"
"2798",2018-03-15,"Washington Gulch","2","2","2",7.5,0.1,28,-1,31,26.8,0,0,0,-1,-1,-1,-1,-2,"w1718","Mechanized",0,"Thu","weekday"
"2799",2018-03-15,"Washington Gulch","2","2","2",7.5,0.1,28,-1,31,26.8,0,0,0,-1,-1,-1,-1,-2,"w1718","Motorized",16,"Thu","weekday"
"2800",2018-03-15,"Washington Gulch","2","2","2",7.5,0.1,28,-1,31,26.8,0,0,0,-1,-1,-1,-1,-2,"w1718","Hybrid",7,"Thu","weekday"
"2801",2018-03-16,"Washington Gulch","2","2","2",7.7,0.2,29,1,25,26.6,-1,0,0,0,0,0,0,0,"w1718","Non.motorized",11,"Fri","weekday"
"2802",2018-03-16,"Washington Gulch","2","2","2",7.7,0.2,29,1,25,26.6,-1,0,0,0,0,0,0,0,"w1718","Mechanized",0,"Fri","weekday"
"2803",2018-03-16,"Washington Gulch","2","2","2",7.7,0.2,29,1,25,26.6,-1,0,0,0,0,0,0,0,"w1718","Motorized",24,"Fri","weekday"
"2804",2018-03-16,"Washington Gulch","2","2","2",7.7,0.2,29,1,25,26.6,-1,0,0,0,0,0,0,0,"w1718","Hybrid",7,"Fri","weekday"
"2805",2018-03-17,"Washington Gulch","2","2","2",7.8,0.1,32,3,29,24.4,1,-1,0,0,4,3,3,3,"w1718","Non.motorized",57,"Sat","weekend"
"2806",2018-03-17,"Washington Gulch","2","2","2",7.8,0.1,32,3,29,24.4,1,-1,0,0,4,3,3,3,"w1718","Mechanized",2,"Sat","weekend"
"2807",2018-03-17,"Washington Gulch","2","2","2",7.8,0.1,32,3,29,24.4,1,-1,0,0,4,3,3,3,"w1718","Motorized",24,"Sat","weekend"
"2808",2018-03-17,"Washington Gulch","2","2","2",7.8,0.1,32,3,29,24.4,1,-1,0,0,4,3,3,3,"w1718","Hybrid",8,"Sat","weekend"
"2809",2018-03-18,"Washington Gulch","2","2","2",7.9,0.1,31,-1,24,25.5,3,1,-1,0,2,3,2,2,"w1718","Non.motorized",12,"Sun","weekend"
"2810",2018-03-18,"Washington Gulch","2","2","2",7.9,0.1,31,-1,24,25.5,3,1,-1,0,2,3,2,2,"w1718","Mechanized",0,"Sun","weekend"
"2811",2018-03-18,"Washington Gulch","2","2","2",7.9,0.1,31,-1,24,25.5,3,1,-1,0,2,3,2,2,"w1718","Motorized",11,"Sun","weekend"
"2812",2018-03-18,"Washington Gulch","2","2","2",7.9,0.1,31,-1,24,25.5,3,1,-1,0,2,3,2,2,"w1718","Hybrid",6,"Sun","weekend"
"2813",2018-03-19,"Washington Gulch","2","2","1",8,0.1,32,1,19,25,-1,3,1,-1,0,3,4,3,"w1718","Non.motorized",17,"Mon","weekday"
"2814",2018-03-19,"Washington Gulch","2","2","1",8,0.1,32,1,19,25,-1,3,1,-1,0,3,4,3,"w1718","Mechanized",0,"Mon","weekday"
"2815",2018-03-19,"Washington Gulch","2","2","1",8,0.1,32,1,19,25,-1,3,1,-1,0,3,4,3,"w1718","Motorized",5,"Mon","weekday"
"2816",2018-03-19,"Washington Gulch","2","2","1",8,0.1,32,1,19,25,-1,3,1,-1,0,3,4,3,"w1718","Hybrid",1,"Mon","weekday"
"2817",2018-03-20,"Washington Gulch","2","2","1",8,0,30,-2,24,26.7,1,-1,3,1,-1,-2,1,2,"w1718","Non.motorized",16,"Tue","weekday"
"2818",2018-03-20,"Washington Gulch","2","2","1",8,0,30,-2,24,26.7,1,-1,3,1,-1,-2,1,2,"w1718","Mechanized",0,"Tue","weekday"
"2819",2018-03-20,"Washington Gulch","2","2","1",8,0,30,-2,24,26.7,1,-1,3,1,-1,-2,1,2,"w1718","Motorized",9,"Tue","weekday"
"2820",2018-03-20,"Washington Gulch","2","2","1",8,0,30,-2,24,26.7,1,-1,3,1,-1,-2,1,2,"w1718","Hybrid",4,"Tue","weekday"
"2821",2018-03-21,"Washington Gulch","1","1","1",8.1,0.1,32,2,30,25.3,-2,1,-1,3,0,1,0,3,"w1718","Non.motorized",31,"Wed","weekday"
"2822",2018-03-21,"Washington Gulch","1","1","1",8.1,0.1,32,2,30,25.3,-2,1,-1,3,0,1,0,3,"w1718","Mechanized",0,"Wed","weekday"
"2823",2018-03-21,"Washington Gulch","1","1","1",8.1,0.1,32,2,30,25.3,-2,1,-1,3,0,1,0,3,"w1718","Motorized",2,"Wed","weekday"
"2824",2018-03-21,"Washington Gulch","1","1","1",8.1,0.1,32,2,30,25.3,-2,1,-1,3,0,1,0,3,"w1718","Hybrid",2,"Wed","weekday"
"2825",2018-03-22,"Washington Gulch","1","1","1",8.1,0,30,-2,36,27,2,-2,1,-1,0,-2,-1,-2,"w1718","Non.motorized",18,"Thu","weekday"
"2826",2018-03-22,"Washington Gulch","1","1","1",8.1,0,30,-2,36,27,2,-2,1,-1,0,-2,-1,-2,"w1718","Mechanized",0,"Thu","weekday"
"2827",2018-03-22,"Washington Gulch","1","1","1",8.1,0,30,-2,36,27,2,-2,1,-1,0,-2,-1,-2,"w1718","Motorized",2,"Thu","weekday"
"2828",2018-03-22,"Washington Gulch","1","1","1",8.1,0,30,-2,36,27,2,-2,1,-1,0,-2,-1,-2,"w1718","Hybrid",0,"Thu","weekday"
"2829",2018-03-23,"Washington Gulch","2","2","3",8.2,0.1,29,-1,34,28.3,-2,2,-2,1,-3,-1,-3,-2,"w1718","Non.motorized",1,"Fri","weekday"
"2830",2018-03-23,"Washington Gulch","2","2","3",8.2,0.1,29,-1,34,28.3,-2,2,-2,1,-3,-1,-3,-2,"w1718","Mechanized",0,"Fri","weekday"
"2831",2018-03-23,"Washington Gulch","2","2","3",8.2,0.1,29,-1,34,28.3,-2,2,-2,1,-3,-1,-3,-2,"w1718","Motorized",0,"Fri","weekday"
"2832",2018-03-23,"Washington Gulch","2","2","3",8.2,0.1,29,-1,34,28.3,-2,2,-2,1,-3,-1,-3,-2,"w1718","Hybrid",0,"Fri","weekday"
"2833",2018-03-24,"Washington Gulch","2","2","1",8.9,0.7,34,5,32,26.2,-1,-2,2,-2,4,2,4,2,"w1718","Non.motorized",25,"Sat","weekend"
"2834",2018-03-24,"Washington Gulch","2","2","1",8.9,0.7,34,5,32,26.2,-1,-2,2,-2,4,2,4,2,"w1718","Mechanized",0,"Sat","weekend"
"2835",2018-03-24,"Washington Gulch","2","2","1",8.9,0.7,34,5,32,26.2,-1,-2,2,-2,4,2,4,2,"w1718","Motorized",16,"Sat","weekend"
"2836",2018-03-24,"Washington Gulch","2","2","1",8.9,0.7,34,5,32,26.2,-1,-2,2,-2,4,2,4,2,"w1718","Hybrid",1,"Sat","weekend"
"2837",2018-03-25,"Washington Gulch","2","2","1",8.9,0,35,1,35,25.4,5,-1,-2,2,6,5,3,5,"w1718","Non.motorized",36,"Sun","weekend"
"2838",2018-03-25,"Washington Gulch","2","2","1",8.9,0,35,1,35,25.4,5,-1,-2,2,6,5,3,5,"w1718","Mechanized",0,"Sun","weekend"
"2839",2018-03-25,"Washington Gulch","2","2","1",8.9,0,35,1,35,25.4,5,-1,-2,2,6,5,3,5,"w1718","Motorized",10,"Sun","weekend"
"2840",2018-03-25,"Washington Gulch","2","2","1",8.9,0,35,1,35,25.4,5,-1,-2,2,6,5,3,5,"w1718","Hybrid",6,"Sun","weekend"
"2841",2018-03-26,"Washington Gulch","1","1","1",8.9,0,34,-1,31,26.2,1,5,-1,-2,0,5,4,2,"w1718","Non.motorized",29,"Mon","weekday"
"2842",2018-03-26,"Washington Gulch","1","1","1",8.9,0,34,-1,31,26.2,1,5,-1,-2,0,5,4,2,"w1718","Mechanized",0,"Mon","weekday"
"2843",2018-03-26,"Washington Gulch","1","1","1",8.9,0,34,-1,31,26.2,1,5,-1,-2,0,5,4,2,"w1718","Motorized",6,"Mon","weekday"
"2844",2018-03-26,"Washington Gulch","1","1","1",8.9,0,34,-1,31,26.2,1,5,-1,-2,0,5,4,2,"w1718","Hybrid",3,"Mon","weekday"
"2845",2018-03-26,"Washington Gulch","2","1","1",8.9,0,34,-1,31,26.2,1,5,-1,-2,0,5,4,2,"w1718","Non.motorized",29,"Mon","weekday"
"2846",2018-03-26,"Washington Gulch","2","1","1",8.9,0,34,-1,31,26.2,1,5,-1,-2,0,5,4,2,"w1718","Mechanized",0,"Mon","weekday"
"2847",2018-03-26,"Washington Gulch","2","1","1",8.9,0,34,-1,31,26.2,1,5,-1,-2,0,5,4,2,"w1718","Motorized",6,"Mon","weekday"
"2848",2018-03-26,"Washington Gulch","2","1","1",8.9,0,34,-1,31,26.2,1,5,-1,-2,0,5,4,2,"w1718","Hybrid",3,"Mon","weekday"
"2849",2018-03-27,"Washington Gulch","1","1","1",8.9,0,33,-1,29,27,-1,1,5,-1,-2,-1,4,3,"w1718","Non.motorized",20,"Tue","weekday"
"2850",2018-03-27,"Washington Gulch","1","1","1",8.9,0,33,-1,29,27,-1,1,5,-1,-2,-1,4,3,"w1718","Mechanized",0,"Tue","weekday"
"2851",2018-03-27,"Washington Gulch","1","1","1",8.9,0,33,-1,29,27,-1,1,5,-1,-2,-1,4,3,"w1718","Motorized",10,"Tue","weekday"
"2852",2018-03-27,"Washington Gulch","1","1","1",8.9,0,33,-1,29,27,-1,1,5,-1,-2,-1,4,3,"w1718","Hybrid",2,"Tue","weekday"
"2853",2018-03-28,"Washington Gulch","1","1","1",8.9,0,33,0,27,27,-1,-1,1,5,-1,-2,-1,4,"w1718","Non.motorized",20,"Wed","weekday"
"2854",2018-03-28,"Washington Gulch","1","1","1",8.9,0,33,0,27,27,-1,-1,1,5,-1,-2,-1,4,"w1718","Mechanized",0,"Wed","weekday"
"2855",2018-03-28,"Washington Gulch","1","1","1",8.9,0,33,0,27,27,-1,-1,1,5,-1,-2,-1,4,"w1718","Motorized",3,"Wed","weekday"
"2856",2018-03-28,"Washington Gulch","1","1","1",8.9,0,33,0,27,27,-1,-1,1,5,-1,-2,-1,4,"w1718","Hybrid",2,"Wed","weekday"
"2857",2018-03-29,"Washington Gulch","1","1","1",8.9,0,33,0,27,27,0,-1,-1,1,0,-1,-2,-1,"w1718","Non.motorized",20,"Thu","weekday"
"2858",2018-03-29,"Washington Gulch","1","1","1",8.9,0,33,0,27,27,0,-1,-1,1,0,-1,-2,-1,"w1718","Mechanized",0,"Thu","weekday"
"2859",2018-03-29,"Washington Gulch","1","1","1",8.9,0,33,0,27,27,0,-1,-1,1,0,-1,-2,-1,"w1718","Motorized",3,"Thu","weekday"
"2860",2018-03-29,"Washington Gulch","1","1","1",8.9,0,33,0,27,27,0,-1,-1,1,0,-1,-2,-1,"w1718","Hybrid",2,"Thu","weekday"
"2861",2018-03-30,"Washington Gulch","1","1","1",8.9,0,32,-1,33,27.8,0,0,-1,-1,-1,-1,-2,-3,"w1718","Non.motorized",30,"Fri","weekday"
"2862",2018-03-30,"Washington Gulch","1","1","1",8.9,0,32,-1,33,27.8,0,0,-1,-1,-1,-1,-2,-3,"w1718","Mechanized",0,"Fri","weekday"
"2863",2018-03-30,"Washington Gulch","1","1","1",8.9,0,32,-1,33,27.8,0,0,-1,-1,-1,-1,-2,-3,"w1718","Motorized",3,"Fri","weekday"
"2864",2018-03-30,"Washington Gulch","1","1","1",8.9,0,32,-1,33,27.8,0,0,-1,-1,-1,-1,-2,-3,"w1718","Hybrid",0,"Fri","weekday"
"2865",2018-03-31,"Washington Gulch","1","1","1",8.9,0,32,0,39,27.8,-1,0,0,-1,-1,-1,-1,-2,"w1718","Non.motorized",50,"Sat","weekend"
"2866",2018-03-31,"Washington Gulch","1","1","1",8.9,0,32,0,39,27.8,-1,0,0,-1,-1,-1,-1,-2,"w1718","Mechanized",0,"Sat","weekend"
"2867",2018-03-31,"Washington Gulch","1","1","1",8.9,0,32,0,39,27.8,-1,0,0,-1,-1,-1,-1,-2,"w1718","Motorized",10,"Sat","weekend"
"2868",2018-03-31,"Washington Gulch","1","1","1",8.9,0,32,0,39,27.8,-1,0,0,-1,-1,-1,-1,-2,"w1718","Hybrid",5,"Sat","weekend"
"2869",2018-04-01,"Washington Gulch","1","1","1",8.8,-0.1,30,-2,41,29.3,0,-1,0,0,-2,-3,-3,-3,"w1718","Non.motorized",18,"Sun","weekend"
"2870",2018-04-01,"Washington Gulch","1","1","1",8.8,-0.1,30,-2,41,29.3,0,-1,0,0,-2,-3,-3,-3,"w1718","Mechanized",0,"Sun","weekend"
"2871",2018-04-01,"Washington Gulch","1","1","1",8.8,-0.1,30,-2,41,29.3,0,-1,0,0,-2,-3,-3,-3,"w1718","Motorized",19,"Sun","weekend"
"2872",2018-04-01,"Washington Gulch","1","1","1",8.8,-0.1,30,-2,41,29.3,0,-1,0,0,-2,-3,-3,-3,"w1718","Hybrid",12,"Sun","weekend"
"2873",2018-04-02,"Washington Gulch","1","1","1",8.7,-0.1,29,-1,39,30,-2,0,-1,0,-3,-3,-4,-4,"w1718","Non.motorized",10,"Mon","weekday"
"2874",2018-04-02,"Washington Gulch","1","1","1",8.7,-0.1,29,-1,39,30,-2,0,-1,0,-3,-3,-4,-4,"w1718","Mechanized",0,"Mon","weekday"
"2875",2018-04-02,"Washington Gulch","1","1","1",8.7,-0.1,29,-1,39,30,-2,0,-1,0,-3,-3,-4,-4,"w1718","Motorized",0,"Mon","weekday"
"2876",2018-04-02,"Washington Gulch","1","1","1",8.7,-0.1,29,-1,39,30,-2,0,-1,0,-3,-3,-4,-4,"w1718","Hybrid",0,"Mon","weekday"
"2877",2018-04-03,"Washington Gulch","1","1","1",8.8,0.1,30,1,27,29.3,-1,-2,0,-1,0,-2,-2,-3,"w1718","Non.motorized",7,"Tue","weekday"
"2878",2018-04-03,"Washington Gulch","1","1","1",8.8,0.1,30,1,27,29.3,-1,-2,0,-1,0,-2,-2,-3,"w1718","Mechanized",0,"Tue","weekday"
"2879",2018-04-03,"Washington Gulch","1","1","1",8.8,0.1,30,1,27,29.3,-1,-2,0,-1,0,-2,-2,-3,"w1718","Motorized",0,"Tue","weekday"
"2880",2018-04-03,"Washington Gulch","1","1","1",8.8,0.1,30,1,27,29.3,-1,-2,0,-1,0,-2,-2,-3,"w1718","Hybrid",0,"Tue","weekday"
"2881",2018-04-04,"Washington Gulch","1","2","2",8.9,0.1,28,-2,33,31.8,1,-1,-2,0,-1,-2,-4,-4,"w1718","Non.motorized",18,"Wed","weekday"
"2882",2018-04-04,"Washington Gulch","1","2","2",8.9,0.1,28,-2,33,31.8,1,-1,-2,0,-1,-2,-4,-4,"w1718","Mechanized",0,"Wed","weekday"
"2883",2018-04-04,"Washington Gulch","1","2","2",8.9,0.1,28,-2,33,31.8,1,-1,-2,0,-1,-2,-4,-4,"w1718","Motorized",0,"Wed","weekday"
"2884",2018-04-04,"Washington Gulch","1","2","2",8.9,0.1,28,-2,33,31.8,1,-1,-2,0,-1,-2,-4,-4,"w1718","Hybrid",0,"Wed","weekday"
"2885",2018-04-05,"Washington Gulch","1","2","2",8.9,0,27,-1,35,33,-2,1,-1,-2,-3,-2,-3,-5,"w1718","Non.motorized",7,"Thu","weekday"
"2886",2018-04-05,"Washington Gulch","1","2","2",8.9,0,27,-1,35,33,-2,1,-1,-2,-3,-2,-3,-5,"w1718","Mechanized",0,"Thu","weekday"
"2887",2018-04-05,"Washington Gulch","1","2","2",8.9,0,27,-1,35,33,-2,1,-1,-2,-3,-2,-3,-5,"w1718","Motorized",8,"Thu","weekday"
"2888",2018-04-05,"Washington Gulch","1","2","2",8.9,0,27,-1,35,33,-2,1,-1,-2,-3,-2,-3,-5,"w1718","Hybrid",8,"Thu","weekday"
"2889",2018-04-06,"Washington Gulch","1","2","2",8.9,0,25,-2,35,35.6,-1,-2,1,-1,-3,-5,-4,-5,"w1718","Non.motorized",8,"Fri","weekday"
"2890",2018-04-06,"Washington Gulch","1","2","2",8.9,0,25,-2,35,35.6,-1,-2,1,-1,-3,-5,-4,-5,"w1718","Mechanized",0,"Fri","weekday"
"2891",2018-04-06,"Washington Gulch","1","2","2",8.9,0,25,-2,35,35.6,-1,-2,1,-1,-3,-5,-4,-5,"w1718","Motorized",0,"Fri","weekday"
"2892",2018-04-06,"Washington Gulch","1","2","2",8.9,0,25,-2,35,35.6,-1,-2,1,-1,-3,-5,-4,-5,"w1718","Hybrid",0,"Fri","weekday"
"2893",2018-04-07,"Washington Gulch","2","2","2",9.2,0.3,31,6,37,29.7,-2,-1,-2,1,4,3,1,2,"w1718","Non.motorized",11,"Sat","weekend"
"2894",2018-04-07,"Washington Gulch","2","2","2",9.2,0.3,31,6,37,29.7,-2,-1,-2,1,4,3,1,2,"w1718","Mechanized",0,"Sat","weekend"
"2895",2018-04-07,"Washington Gulch","2","2","2",9.2,0.3,31,6,37,29.7,-2,-1,-2,1,4,3,1,2,"w1718","Motorized",5,"Sat","weekend"
"2896",2018-04-07,"Washington Gulch","2","2","2",9.2,0.3,31,6,37,29.7,-2,-1,-2,1,4,3,1,2,"w1718","Hybrid",0,"Sat","weekend"
"2897",2018-04-08,"Washington Gulch","3","3","3",10,0.8,33,2,33,30.3,6,-2,-1,-2,8,6,5,3,"w1718","Non.motorized",7,"Sun","weekend"
"2898",2018-04-08,"Washington Gulch","3","3","3",10,0.8,33,2,33,30.3,6,-2,-1,-2,8,6,5,3,"w1718","Mechanized",1,"Sun","weekend"
"2899",2018-04-08,"Washington Gulch","3","3","3",10,0.8,33,2,33,30.3,6,-2,-1,-2,8,6,5,3,"w1718","Motorized",5,"Sun","weekend"
"2900",2018-04-08,"Washington Gulch","3","3","3",10,0.8,33,2,33,30.3,6,-2,-1,-2,8,6,5,3,"w1718","Hybrid",0,"Sun","weekend"
"2901",2018-04-09,"Washington Gulch","1","1","1",10.1,0.1,33,0,31,30.6,2,6,-2,-1,2,8,6,5,"w1718","Non.motorized",9,"Mon","weekday"
"2902",2018-04-09,"Washington Gulch","1","1","1",10.1,0.1,33,0,31,30.6,2,6,-2,-1,2,8,6,5,"w1718","Mechanized",0,"Mon","weekday"
"2903",2018-04-09,"Washington Gulch","1","1","1",10.1,0.1,33,0,31,30.6,2,6,-2,-1,2,8,6,5,"w1718","Motorized",1,"Mon","weekday"
"2904",2018-04-09,"Washington Gulch","1","1","1",10.1,0.1,33,0,31,30.6,2,6,-2,-1,2,8,6,5,"w1718","Hybrid",0,"Mon","weekday"
"2905",2018-04-10,"Washington Gulch","1","1","1",10.1,0,31,-2,38,32.6,0,2,6,-2,-2,0,6,4,"w1718","Non.motorized",11,"Tue","weekday"
"2906",2018-04-10,"Washington Gulch","1","1","1",10.1,0,31,-2,38,32.6,0,2,6,-2,-2,0,6,4,"w1718","Mechanized",0,"Tue","weekday"
"2907",2018-04-10,"Washington Gulch","1","1","1",10.1,0,31,-2,38,32.6,0,2,6,-2,-2,0,6,4,"w1718","Motorized",6,"Tue","weekday"
"2908",2018-04-10,"Washington Gulch","1","1","1",10.1,0,31,-2,38,32.6,0,2,6,-2,-2,0,6,4,"w1718","Hybrid",5,"Tue","weekday"
"2909",2018-04-11,"Washington Gulch","2","2","2",9.9,-0.2,29,-2,45,34.1,-2,0,2,6,-4,-4,-2,4,"w1718","Non.motorized",5,"Wed","weekday"
"2910",2018-04-11,"Washington Gulch","2","2","2",9.9,-0.2,29,-2,45,34.1,-2,0,2,6,-4,-4,-2,4,"w1718","Mechanized",0,"Wed","weekday"
"2911",2018-04-11,"Washington Gulch","2","2","2",9.9,-0.2,29,-2,45,34.1,-2,0,2,6,-4,-4,-2,4,"w1718","Motorized",6,"Wed","weekday"
"2912",2018-04-11,"Washington Gulch","2","2","2",9.9,-0.2,29,-2,45,34.1,-2,0,2,6,-4,-4,-2,4,"w1718","Hybrid",5,"Wed","weekday"
"2913",2018-04-12,"Washington Gulch","1","2","2",9.5,-0.4,28,-1,40,33.9,-2,-2,0,2,-3,-5,-5,-3,"w1718","Non.motorized",8,"Thu","weekday"
"2914",2018-04-12,"Washington Gulch","1","2","2",9.5,-0.4,28,-1,40,33.9,-2,-2,0,2,-3,-5,-5,-3,"w1718","Mechanized",0,"Thu","weekday"
"2915",2018-04-12,"Washington Gulch","1","2","2",9.5,-0.4,28,-1,40,33.9,-2,-2,0,2,-3,-5,-5,-3,"w1718","Motorized",5,"Thu","weekday"
"2916",2018-04-12,"Washington Gulch","1","2","2",9.5,-0.4,28,-1,40,33.9,-2,-2,0,2,-3,-5,-5,-3,"w1718","Hybrid",3,"Thu","weekday"
"2917",2018-04-13,"Washington Gulch","2","2","1",9.4,-0.1,26,-2,23,36.2,-1,-2,-2,0,-3,-5,-7,-7,"w1718","Non.motorized",14,"Fri","weekday"
"2918",2018-04-13,"Washington Gulch","2","2","1",9.4,-0.1,26,-2,23,36.2,-1,-2,-2,0,-3,-5,-7,-7,"w1718","Mechanized",0,"Fri","weekday"
"2919",2018-04-13,"Washington Gulch","2","2","1",9.4,-0.1,26,-2,23,36.2,-1,-2,-2,0,-3,-5,-7,-7,"w1718","Motorized",1,"Fri","weekday"
"2920",2018-04-13,"Washington Gulch","2","2","1",9.4,-0.1,26,-2,23,36.2,-1,-2,-2,0,-3,-5,-7,-7,"w1718","Hybrid",0,"Fri","weekday"
"2921",2018-04-14,"Washington Gulch","2","2","1",9.4,0,28,2,28,33.6,-2,-1,-2,-2,0,-1,-3,-5,"w1718","Non.motorized",11,"Sat","weekend"
"2922",2018-04-14,"Washington Gulch","2","2","1",9.4,0,28,2,28,33.6,-2,-1,-2,-2,0,-1,-3,-5,"w1718","Mechanized",0,"Sat","weekend"
"2923",2018-04-14,"Washington Gulch","2","2","1",9.4,0,28,2,28,33.6,-2,-1,-2,-2,0,-1,-3,-5,"w1718","Motorized",6,"Sat","weekend"
"2924",2018-04-14,"Washington Gulch","2","2","1",9.4,0,28,2,28,33.6,-2,-1,-2,-2,0,-1,-3,-5,"w1718","Hybrid",1,"Sat","weekend"
"2925",2018-04-15,"Washington Gulch","2","2","1",9.2,-0.2,27,-1,37,34.1,2,-2,-1,-2,1,-1,-2,-4,"w1718","Non.motorized",15,"Sun","weekend"
"2926",2018-04-15,"Washington Gulch","2","2","1",9.2,-0.2,27,-1,37,34.1,2,-2,-1,-2,1,-1,-2,-4,"w1718","Mechanized",0,"Sun","weekend"
"2927",2018-04-15,"Washington Gulch","2","2","1",9.2,-0.2,27,-1,37,34.1,2,-2,-1,-2,1,-1,-2,-4,"w1718","Motorized",4,"Sun","weekend"
"2928",2018-04-15,"Washington Gulch","2","2","1",9.2,-0.2,27,-1,37,34.1,2,-2,-1,-2,1,-1,-2,-4,"w1718","Hybrid",1,"Sun","weekend"
"2929",2018-04-16,"Washington Gulch",NA,NA,NA,8.9,-0.3,24,-3,43,37.1,-1,2,-2,-1,-4,-2,-4,-5,"w1718","Non.motorized",3,"Mon","weekday"
"2930",2018-04-16,"Washington Gulch",NA,NA,NA,8.9,-0.3,24,-3,43,37.1,-1,2,-2,-1,-4,-2,-4,-5,"w1718","Mechanized",0,"Mon","weekday"
"2931",2018-04-16,"Washington Gulch",NA,NA,NA,8.9,-0.3,24,-3,43,37.1,-1,2,-2,-1,-4,-2,-4,-5,"w1718","Motorized",1,"Mon","weekday"
"2932",2018-04-16,"Washington Gulch",NA,NA,NA,8.9,-0.3,24,-3,43,37.1,-1,2,-2,-1,-4,-2,-4,-5,"w1718","Hybrid",0,"Mon","weekday"
"2933",2018-12-01,"Brush Creek Trailhead","3","3","2",3.3,0.2,19,1,16,17.4,0,0,0,0,1,1,1,1,"w1819","Non.motorized",0,"Sat","weekend"
"2934",2018-12-01,"Brush Creek Trailhead","3","3","2",3.3,0.2,19,1,16,17.4,0,0,0,0,1,1,1,1,"w1819","Mechanized",0,"Sat","weekend"
"2935",2018-12-01,"Brush Creek Trailhead","3","3","2",3.3,0.2,19,1,16,17.4,0,0,0,0,1,1,1,1,"w1819","Motorized",0,"Sat","weekend"
"2936",2018-12-01,"Brush Creek Trailhead","3","3","2",3.3,0.2,19,1,16,17.4,0,0,0,0,1,1,1,1,"w1819","Hybrid",0,"Sat","weekend"
"2937",2018-12-02,"Brush Creek Trailhead","3","3","3",3.3,0,20,1,14,16.5,1,0,0,0,2,2,2,2,"w1819","Non.motorized",0,"Sun","weekend"
"2938",2018-12-02,"Brush Creek Trailhead","3","3","3",3.3,0,20,1,14,16.5,1,0,0,0,2,2,2,2,"w1819","Mechanized",0,"Sun","weekend"
"2939",2018-12-02,"Brush Creek Trailhead","3","3","3",3.3,0,20,1,14,16.5,1,0,0,0,2,2,2,2,"w1819","Motorized",0,"Sun","weekend"
"2940",2018-12-02,"Brush Creek Trailhead","3","3","3",3.3,0,20,1,14,16.5,1,0,0,0,2,2,2,2,"w1819","Hybrid",0,"Sun","weekend"
"2941",2018-12-03,"Brush Creek Trailhead","3","3","2",3.4,0.1,19,-1,13,17.9,1,1,0,0,0,1,1,1,"w1819","Non.motorized",0,"Mon","weekday"
"2942",2018-12-03,"Brush Creek Trailhead","3","3","2",3.4,0.1,19,-1,13,17.9,1,1,0,0,0,1,1,1,"w1819","Mechanized",0,"Mon","weekday"
"2943",2018-12-03,"Brush Creek Trailhead","3","3","2",3.4,0.1,19,-1,13,17.9,1,1,0,0,0,1,1,1,"w1819","Motorized",0,"Mon","weekday"
"2944",2018-12-03,"Brush Creek Trailhead","3","3","2",3.4,0.1,19,-1,13,17.9,1,1,0,0,0,1,1,1,"w1819","Hybrid",0,"Mon","weekday"
"2945",2018-12-04,"Brush Creek Trailhead","3","3","2",3.5,0.1,20,1,8,17.5,-1,1,1,0,0,1,2,2,"w1819","Non.motorized",0,"Tue","weekday"
"2946",2018-12-04,"Brush Creek Trailhead","3","3","2",3.5,0.1,20,1,8,17.5,-1,1,1,0,0,1,2,2,"w1819","Mechanized",0,"Tue","weekday"
"2947",2018-12-04,"Brush Creek Trailhead","3","3","2",3.5,0.1,20,1,8,17.5,-1,1,1,0,0,1,2,2,"w1819","Motorized",0,"Tue","weekday"
"2948",2018-12-04,"Brush Creek Trailhead","3","3","2",3.5,0.1,20,1,8,17.5,-1,1,1,0,0,1,2,2,"w1819","Hybrid",0,"Tue","weekday"
"2949",2018-12-05,"Brush Creek Trailhead","3","3","2",3.5,0,19,-1,21,18.4,1,-1,1,1,0,-1,0,1,"w1819","Non.motorized",0,"Wed","weekday"
"2950",2018-12-05,"Brush Creek Trailhead","3","3","2",3.5,0,19,-1,21,18.4,1,-1,1,1,0,-1,0,1,"w1819","Mechanized",0,"Wed","weekday"
"2951",2018-12-05,"Brush Creek Trailhead","3","3","2",3.5,0,19,-1,21,18.4,1,-1,1,1,0,-1,0,1,"w1819","Motorized",0,"Wed","weekday"
"2952",2018-12-05,"Brush Creek Trailhead","3","3","2",3.5,0,19,-1,21,18.4,1,-1,1,1,0,-1,0,1,"w1819","Hybrid",0,"Wed","weekday"
"2953",2018-12-06,"Brush Creek Trailhead","2","2","2",3.7,0.2,18,-1,25,20.6,-1,1,-1,1,-2,-1,-2,-1,"w1819","Non.motorized",8,"Thu","weekday"
"2954",2018-12-06,"Brush Creek Trailhead","2","2","2",3.7,0.2,18,-1,25,20.6,-1,1,-1,1,-2,-1,-2,-1,"w1819","Mechanized",0,"Thu","weekday"
"2955",2018-12-06,"Brush Creek Trailhead","2","2","2",3.7,0.2,18,-1,25,20.6,-1,1,-1,1,-2,-1,-2,-1,"w1819","Motorized",0,"Thu","weekday"
"2956",2018-12-06,"Brush Creek Trailhead","2","2","2",3.7,0.2,18,-1,25,20.6,-1,1,-1,1,-2,-1,-2,-1,"w1819","Hybrid",0,"Thu","weekday"
"2957",2018-12-07,"Brush Creek Trailhead","2","2","2",3.8,0.1,21,3,23,18.1,-1,-1,1,-1,2,1,2,1,"w1819","Non.motorized",13,"Fri","weekday"
"2958",2018-12-07,"Brush Creek Trailhead","2","2","2",3.8,0.1,21,3,23,18.1,-1,-1,1,-1,2,1,2,1,"w1819","Mechanized",0,"Fri","weekday"
"2959",2018-12-07,"Brush Creek Trailhead","2","2","2",3.8,0.1,21,3,23,18.1,-1,-1,1,-1,2,1,2,1,"w1819","Motorized",0,"Fri","weekday"
"2960",2018-12-07,"Brush Creek Trailhead","2","2","2",3.8,0.1,21,3,23,18.1,-1,-1,1,-1,2,1,2,1,"w1819","Hybrid",0,"Fri","weekday"
"2961",2018-12-08,"Brush Creek Trailhead","2","2","2",3.8,0,20,-1,23,19,3,-1,-1,1,2,1,0,1,"w1819","Non.motorized",11,"Sat","weekend"
"2962",2018-12-08,"Brush Creek Trailhead","2","2","2",3.8,0,20,-1,23,19,3,-1,-1,1,2,1,0,1,"w1819","Mechanized",0,"Sat","weekend"
"2963",2018-12-08,"Brush Creek Trailhead","2","2","2",3.8,0,20,-1,23,19,3,-1,-1,1,2,1,0,1,"w1819","Motorized",0,"Sat","weekend"
"2964",2018-12-08,"Brush Creek Trailhead","2","2","2",3.8,0,20,-1,23,19,3,-1,-1,1,2,1,0,1,"w1819","Hybrid",0,"Sat","weekend"
"2965",2018-12-09,"Brush Creek Trailhead","2","2","2",3.8,0,20,0,19,19,-1,3,-1,-1,-1,2,1,0,"w1819","Non.motorized",26,"Sun","weekend"
"2966",2018-12-09,"Brush Creek Trailhead","2","2","2",3.8,0,20,0,19,19,-1,3,-1,-1,-1,2,1,0,"w1819","Mechanized",0,"Sun","weekend"
"2967",2018-12-09,"Brush Creek Trailhead","2","2","2",3.8,0,20,0,19,19,-1,3,-1,-1,-1,2,1,0,"w1819","Motorized",0,"Sun","weekend"
"2968",2018-12-09,"Brush Creek Trailhead","2","2","2",3.8,0,20,0,19,19,-1,3,-1,-1,-1,2,1,0,"w1819","Hybrid",0,"Sun","weekend"
"2969",2018-12-10,"Brush Creek Trailhead","2","2","2",3.8,0,20,0,21,19,0,-1,3,-1,0,-1,2,1,"w1819","Non.motorized",5,"Mon","weekday"
"2970",2018-12-10,"Brush Creek Trailhead","2","2","2",3.8,0,20,0,21,19,0,-1,3,-1,0,-1,2,1,"w1819","Mechanized",0,"Mon","weekday"
"2971",2018-12-10,"Brush Creek Trailhead","2","2","2",3.8,0,20,0,21,19,0,-1,3,-1,0,-1,2,1,"w1819","Motorized",0,"Mon","weekday"
"2972",2018-12-10,"Brush Creek Trailhead","2","2","2",3.8,0,20,0,21,19,0,-1,3,-1,0,-1,2,1,"w1819","Hybrid",0,"Mon","weekday"
"2973",2018-12-11,"Brush Creek Trailhead","2","2","2",3.9,0.1,19,-1,27,20.5,0,0,-1,3,-1,-1,-2,1,"w1819","Non.motorized",5,"Tue","weekday"
"2974",2018-12-11,"Brush Creek Trailhead","2","2","2",3.9,0.1,19,-1,27,20.5,0,0,-1,3,-1,-1,-2,1,"w1819","Mechanized",0,"Tue","weekday"
"2975",2018-12-11,"Brush Creek Trailhead","2","2","2",3.9,0.1,19,-1,27,20.5,0,0,-1,3,-1,-1,-2,1,"w1819","Motorized",0,"Tue","weekday"
"2976",2018-12-11,"Brush Creek Trailhead","2","2","2",3.9,0.1,19,-1,27,20.5,0,0,-1,3,-1,-1,-2,1,"w1819","Hybrid",0,"Tue","weekday"
"2977",2018-12-12,"Brush Creek Trailhead","2","2","1",3.9,0,19,0,21,20.5,-1,0,0,-1,-1,-1,-1,-2,"w1819","Non.motorized",3,"Wed","weekday"
"2978",2018-12-12,"Brush Creek Trailhead","2","2","1",3.9,0,19,0,21,20.5,-1,0,0,-1,-1,-1,-1,-2,"w1819","Mechanized",0,"Wed","weekday"
"2979",2018-12-12,"Brush Creek Trailhead","2","2","1",3.9,0,19,0,21,20.5,-1,0,0,-1,-1,-1,-1,-2,"w1819","Motorized",0,"Wed","weekday"
"2980",2018-12-12,"Brush Creek Trailhead","2","2","1",3.9,0,19,0,21,20.5,-1,0,0,-1,-1,-1,-1,-2,"w1819","Hybrid",0,"Wed","weekday"
"2981",2018-12-13,"Brush Creek Trailhead","3","3","2",4,0.1,21,2,15,19,0,-1,0,0,2,1,1,1,"w1819","Non.motorized",3,"Thu","weekday"
"2982",2018-12-13,"Brush Creek Trailhead","3","3","2",4,0.1,21,2,15,19,0,-1,0,0,2,1,1,1,"w1819","Mechanized",0,"Thu","weekday"
"2983",2018-12-13,"Brush Creek Trailhead","3","3","2",4,0.1,21,2,15,19,0,-1,0,0,2,1,1,1,"w1819","Motorized",0,"Thu","weekday"
"2984",2018-12-13,"Brush Creek Trailhead","3","3","2",4,0.1,21,2,15,19,0,-1,0,0,2,1,1,1,"w1819","Hybrid",0,"Thu","weekday"
"2985",2018-12-14,"Brush Creek Trailhead","3","3","2",4,0,20,-1,24,20,2,0,-1,0,1,1,0,0,"w1819","Non.motorized",1,"Fri","weekday"
"2986",2018-12-14,"Brush Creek Trailhead","3","3","2",4,0,20,-1,24,20,2,0,-1,0,1,1,0,0,"w1819","Mechanized",0,"Fri","weekday"
"2987",2018-12-14,"Brush Creek Trailhead","3","3","2",4,0,20,-1,24,20,2,0,-1,0,1,1,0,0,"w1819","Motorized",0,"Fri","weekday"
"2988",2018-12-14,"Brush Creek Trailhead","3","3","2",4,0,20,-1,24,20,2,0,-1,0,1,1,0,0,"w1819","Hybrid",0,"Fri","weekday"
"2989",2018-12-15,"Brush Creek Trailhead","2","2","2",4,0,20,0,29,20,-1,2,0,-1,-1,1,1,0,"w1819","Non.motorized",19,"Sat","weekend"
"2990",2018-12-15,"Brush Creek Trailhead","2","2","2",4,0,20,0,29,20,-1,2,0,-1,-1,1,1,0,"w1819","Mechanized",1,"Sat","weekend"
"2991",2018-12-15,"Brush Creek Trailhead","2","2","2",4,0,20,0,29,20,-1,2,0,-1,-1,1,1,0,"w1819","Motorized",0,"Sat","weekend"
"2992",2018-12-15,"Brush Creek Trailhead","2","2","2",4,0,20,0,29,20,-1,2,0,-1,-1,1,1,0,"w1819","Hybrid",0,"Sat","weekend"
"2993",2018-12-16,"Brush Creek Trailhead","2","2","2",4.1,0.1,19,-1,28,21.6,0,-1,2,0,-1,-2,0,0,"w1819","Non.motorized",10,"Sun","weekend"
"2994",2018-12-16,"Brush Creek Trailhead","2","2","2",4.1,0.1,19,-1,28,21.6,0,-1,2,0,-1,-2,0,0,"w1819","Mechanized",0,"Sun","weekend"
"2995",2018-12-16,"Brush Creek Trailhead","2","2","2",4.1,0.1,19,-1,28,21.6,0,-1,2,0,-1,-2,0,0,"w1819","Motorized",0,"Sun","weekend"
"2996",2018-12-16,"Brush Creek Trailhead","2","2","2",4.1,0.1,19,-1,28,21.6,0,-1,2,0,-1,-2,0,0,"w1819","Hybrid",0,"Sun","weekend"
"2997",2018-12-17,"Brush Creek Trailhead","2","2","2",4.1,0,19,0,29,21.6,-1,0,-1,2,-1,-1,-2,0,"w1819","Non.motorized",5,"Mon","weekday"
"2998",2018-12-17,"Brush Creek Trailhead","2","2","2",4.1,0,19,0,29,21.6,-1,0,-1,2,-1,-1,-2,0,"w1819","Mechanized",0,"Mon","weekday"
"2999",2018-12-17,"Brush Creek Trailhead","2","2","2",4.1,0,19,0,29,21.6,-1,0,-1,2,-1,-1,-2,0,"w1819","Motorized",0,"Mon","weekday"
"3000",2018-12-17,"Brush Creek Trailhead","2","2","2",4.1,0,19,0,29,21.6,-1,0,-1,2,-1,-1,-2,0,"w1819","Hybrid",0,"Mon","weekday"
"3001",2018-12-18,"Brush Creek Trailhead","2","2","2",4.1,0,19,0,27,21.6,0,-1,0,-1,0,-1,-1,-2,"w1819","Non.motorized",12,"Tue","weekday"
"3002",2018-12-18,"Brush Creek Trailhead","2","2","2",4.1,0,19,0,27,21.6,0,-1,0,-1,0,-1,-1,-2,"w1819","Mechanized",1,"Tue","weekday"
"3003",2018-12-18,"Brush Creek Trailhead","2","2","2",4.1,0,19,0,27,21.6,0,-1,0,-1,0,-1,-1,-2,"w1819","Motorized",0,"Tue","weekday"
"3004",2018-12-18,"Brush Creek Trailhead","2","2","2",4.1,0,19,0,27,21.6,0,-1,0,-1,0,-1,-1,-2,"w1819","Hybrid",0,"Tue","weekday"
"3005",2018-12-19,"Brush Creek Trailhead","2","2","2",4.1,0,19,0,24,21.6,0,0,-1,0,0,0,-1,-1,"w1819","Non.motorized",11,"Wed","weekday"
"3006",2018-12-19,"Brush Creek Trailhead","2","2","2",4.1,0,19,0,24,21.6,0,0,-1,0,0,0,-1,-1,"w1819","Mechanized",0,"Wed","weekday"
"3007",2018-12-19,"Brush Creek Trailhead","2","2","2",4.1,0,19,0,24,21.6,0,0,-1,0,0,0,-1,-1,"w1819","Motorized",0,"Wed","weekday"
"3008",2018-12-19,"Brush Creek Trailhead","2","2","2",4.1,0,19,0,24,21.6,0,0,-1,0,0,0,-1,-1,"w1819","Hybrid",0,"Wed","weekday"
"3009",2018-12-20,"Brush Creek Trailhead","2","2","1",4.1,0,20,1,25,20.5,0,0,0,-1,1,1,1,0,"w1819","Non.motorized",12,"Thu","weekday"
"3010",2018-12-20,"Brush Creek Trailhead","2","2","1",4.1,0,20,1,25,20.5,0,0,0,-1,1,1,1,0,"w1819","Mechanized",0,"Thu","weekday"
"3011",2018-12-20,"Brush Creek Trailhead","2","2","1",4.1,0,20,1,25,20.5,0,0,0,-1,1,1,1,0,"w1819","Motorized",0,"Thu","weekday"
"3012",2018-12-20,"Brush Creek Trailhead","2","2","1",4.1,0,20,1,25,20.5,0,0,0,-1,1,1,1,0,"w1819","Hybrid",0,"Thu","weekday"
"3013",2018-12-21,"Brush Creek Trailhead","2","2","1",4.1,0,19,-1,28,21.6,1,0,0,0,0,0,0,0,"w1819","Non.motorized",7,"Fri","weekday"
"3014",2018-12-21,"Brush Creek Trailhead","2","2","1",4.1,0,19,-1,28,21.6,1,0,0,0,0,0,0,0,"w1819","Mechanized",0,"Fri","weekday"
"3015",2018-12-21,"Brush Creek Trailhead","2","2","1",4.1,0,19,-1,28,21.6,1,0,0,0,0,0,0,0,"w1819","Motorized",0,"Fri","weekday"
"3016",2018-12-21,"Brush Creek Trailhead","2","2","1",4.1,0,19,-1,28,21.6,1,0,0,0,0,0,0,0,"w1819","Hybrid",0,"Fri","weekday"
"3017",2018-12-22,"Brush Creek Trailhead","2","2","1",4.2,0.1,19,0,20,22.1,-1,1,0,0,-1,0,0,0,"w1819","Non.motorized",11,"Sat","weekend"
"3018",2018-12-22,"Brush Creek Trailhead","2","2","1",4.2,0.1,19,0,20,22.1,-1,1,0,0,-1,0,0,0,"w1819","Mechanized",0,"Sat","weekend"
"3019",2018-12-22,"Brush Creek Trailhead","2","2","1",4.2,0.1,19,0,20,22.1,-1,1,0,0,-1,0,0,0,"w1819","Motorized",0,"Sat","weekend"
"3020",2018-12-22,"Brush Creek Trailhead","2","2","1",4.2,0.1,19,0,20,22.1,-1,1,0,0,-1,0,0,0,"w1819","Hybrid",0,"Sat","weekend"
"3021",2018-12-23,"Brush Creek Trailhead","2","2","1",4.2,0,21,2,19,20,0,-1,1,0,2,1,2,2,"w1819","Non.motorized",17,"Sun","weekend"
"3022",2018-12-23,"Brush Creek Trailhead","2","2","1",4.2,0,21,2,19,20,0,-1,1,0,2,1,2,2,"w1819","Mechanized",0,"Sun","weekend"
"3023",2018-12-23,"Brush Creek Trailhead","2","2","1",4.2,0,21,2,19,20,0,-1,1,0,2,1,2,2,"w1819","Motorized",0,"Sun","weekend"
"3024",2018-12-23,"Brush Creek Trailhead","2","2","1",4.2,0,21,2,19,20,0,-1,1,0,2,1,2,2,"w1819","Hybrid",0,"Sun","weekend"
"3025",2018-12-24,"Brush Creek Trailhead","2","2","2",4.3,0.1,20,-1,21,21.5,2,0,-1,1,1,1,0,1,"w1819","Non.motorized",1,"Mon","weekday"
"3026",2018-12-24,"Brush Creek Trailhead","2","2","2",4.3,0.1,20,-1,21,21.5,2,0,-1,1,1,1,0,1,"w1819","Mechanized",0,"Mon","weekday"
"3027",2018-12-24,"Brush Creek Trailhead","2","2","2",4.3,0.1,20,-1,21,21.5,2,0,-1,1,1,1,0,1,"w1819","Motorized",0,"Mon","weekday"
"3028",2018-12-24,"Brush Creek Trailhead","2","2","2",4.3,0.1,20,-1,21,21.5,2,0,-1,1,1,1,0,1,"w1819","Hybrid",0,"Mon","weekday"
"3029",2018-12-25,"Brush Creek Trailhead","2","2","2",4.7,0.4,25,5,25,18.8,-1,2,0,-1,4,6,6,5,"w1819","Non.motorized",14,"Tue","weekday"
"3030",2018-12-25,"Brush Creek Trailhead","2","2","2",4.7,0.4,25,5,25,18.8,-1,2,0,-1,4,6,6,5,"w1819","Mechanized",0,"Tue","weekday"
"3031",2018-12-25,"Brush Creek Trailhead","2","2","2",4.7,0.4,25,5,25,18.8,-1,2,0,-1,4,6,6,5,"w1819","Motorized",0,"Tue","weekday"
"3032",2018-12-25,"Brush Creek Trailhead","2","2","2",4.7,0.4,25,5,25,18.8,-1,2,0,-1,4,6,6,5,"w1819","Hybrid",0,"Tue","weekday"
"3033",2018-12-26,"Brush Creek Trailhead","3","3","3",4.7,0,23,-2,24,20.4,5,-1,2,0,3,2,4,4,"w1819","Non.motorized",21,"Wed","weekday"
"3034",2018-12-26,"Brush Creek Trailhead","3","3","3",4.7,0,23,-2,24,20.4,5,-1,2,0,3,2,4,4,"w1819","Mechanized",0,"Wed","weekday"
"3035",2018-12-26,"Brush Creek Trailhead","3","3","3",4.7,0,23,-2,24,20.4,5,-1,2,0,3,2,4,4,"w1819","Motorized",0,"Wed","weekday"
"3036",2018-12-26,"Brush Creek Trailhead","3","3","3",4.7,0,23,-2,24,20.4,5,-1,2,0,3,2,4,4,"w1819","Hybrid",0,"Wed","weekday"
"3037",2018-12-27,"Brush Creek Trailhead","3","3","2",4.7,0,24,1,12,19.6,-2,5,-1,2,-1,4,3,5,"w1819","Non.motorized",14,"Thu","weekday"
"3038",2018-12-27,"Brush Creek Trailhead","3","3","2",4.7,0,24,1,12,19.6,-2,5,-1,2,-1,4,3,5,"w1819","Mechanized",0,"Thu","weekday"
"3039",2018-12-27,"Brush Creek Trailhead","3","3","2",4.7,0,24,1,12,19.6,-2,5,-1,2,-1,4,3,5,"w1819","Motorized",0,"Thu","weekday"
"3040",2018-12-27,"Brush Creek Trailhead","3","3","2",4.7,0,24,1,12,19.6,-2,5,-1,2,-1,4,3,5,"w1819","Hybrid",0,"Thu","weekday"
"3041",2018-12-28,"Brush Creek Trailhead","3","3","2",4.7,0,24,0,12,19.6,1,-2,5,-1,1,-1,4,3,"w1819","Non.motorized",16,"Fri","weekday"
"3042",2018-12-28,"Brush Creek Trailhead","3","3","2",4.7,0,24,0,12,19.6,1,-2,5,-1,1,-1,4,3,"w1819","Mechanized",0,"Fri","weekday"
"3043",2018-12-28,"Brush Creek Trailhead","3","3","2",4.7,0,24,0,12,19.6,1,-2,5,-1,1,-1,4,3,"w1819","Motorized",0,"Fri","weekday"
"3044",2018-12-28,"Brush Creek Trailhead","3","3","2",4.7,0,24,0,12,19.6,1,-2,5,-1,1,-1,4,3,"w1819","Hybrid",0,"Fri","weekday"
"3045",2018-12-29,"Brush Creek Trailhead","3","3","2",4.7,0,24,0,8,19.6,0,1,-2,5,0,1,-1,4,"w1819","Non.motorized",38,"Sat","weekend"
"3046",2018-12-29,"Brush Creek Trailhead","3","3","2",4.7,0,24,0,8,19.6,0,1,-2,5,0,1,-1,4,"w1819","Mechanized",0,"Sat","weekend"
"3047",2018-12-29,"Brush Creek Trailhead","3","3","2",4.7,0,24,0,8,19.6,0,1,-2,5,0,1,-1,4,"w1819","Motorized",0,"Sat","weekend"
"3048",2018-12-29,"Brush Creek Trailhead","3","3","2",4.7,0,24,0,8,19.6,0,1,-2,5,0,1,-1,4,"w1819","Hybrid",0,"Sat","weekend"
"3049",2018-12-30,"Brush Creek Trailhead","3","3","2",4.7,0,24,0,16,19.6,0,0,1,-2,0,0,1,-1,"w1819","Non.motorized",29,"Sun","weekend"
"3050",2018-12-30,"Brush Creek Trailhead","3","3","2",4.7,0,24,0,16,19.6,0,0,1,-2,0,0,1,-1,"w1819","Mechanized",0,"Sun","weekend"
"3051",2018-12-30,"Brush Creek Trailhead","3","3","2",4.7,0,24,0,16,19.6,0,0,1,-2,0,0,1,-1,"w1819","Motorized",0,"Sun","weekend"
"3052",2018-12-30,"Brush Creek Trailhead","3","3","2",4.7,0,24,0,16,19.6,0,0,1,-2,0,0,1,-1,"w1819","Hybrid",0,"Sun","weekend"
"3053",2018-12-31,"Brush Creek Trailhead","3","3","3",4.9,0.2,23,-1,14,21.3,0,0,0,1,-1,-1,-1,0,"w1819","Non.motorized",2,"Mon","weekday"
"3054",2018-12-31,"Brush Creek Trailhead","3","3","3",4.9,0.2,23,-1,14,21.3,0,0,0,1,-1,-1,-1,0,"w1819","Mechanized",0,"Mon","weekday"
"3055",2018-12-31,"Brush Creek Trailhead","3","3","3",4.9,0.2,23,-1,14,21.3,0,0,0,1,-1,-1,-1,0,"w1819","Motorized",0,"Mon","weekday"
"3056",2018-12-31,"Brush Creek Trailhead","3","3","3",4.9,0.2,23,-1,14,21.3,0,0,0,1,-1,-1,-1,0,"w1819","Hybrid",0,"Mon","weekday"
"3057",2019-01-01,"Brush Creek Trailhead","3","3","3",5.1,0.2,29,6,11,17.6,-1,0,0,0,5,5,5,5,"w1819","Non.motorized",22,"Tue","weekday"
"3058",2019-01-01,"Brush Creek Trailhead","3","3","3",5.1,0.2,29,6,11,17.6,-1,0,0,0,5,5,5,5,"w1819","Mechanized",0,"Tue","weekday"
"3059",2019-01-01,"Brush Creek Trailhead","3","3","3",5.1,0.2,29,6,11,17.6,-1,0,0,0,5,5,5,5,"w1819","Motorized",0,"Tue","weekday"
"3060",2019-01-01,"Brush Creek Trailhead","3","3","3",5.1,0.2,29,6,11,17.6,-1,0,0,0,5,5,5,5,"w1819","Hybrid",0,"Tue","weekday"
"3061",2019-01-02,"Brush Creek Trailhead","3","3","2",5.1,0,28,-1,10,18.2,6,-1,0,0,5,4,4,4,"w1819","Non.motorized",22,"Wed","weekday"
"3062",2019-01-02,"Brush Creek Trailhead","3","3","2",5.1,0,28,-1,10,18.2,6,-1,0,0,5,4,4,4,"w1819","Mechanized",0,"Wed","weekday"
"3063",2019-01-02,"Brush Creek Trailhead","3","3","2",5.1,0,28,-1,10,18.2,6,-1,0,0,5,4,4,4,"w1819","Motorized",0,"Wed","weekday"
"3064",2019-01-02,"Brush Creek Trailhead","3","3","2",5.1,0,28,-1,10,18.2,6,-1,0,0,5,4,4,4,"w1819","Hybrid",0,"Wed","weekday"
"3065",2019-01-03,"Brush Creek Trailhead","3","3","2",5.1,0,27,-1,22,18.9,-1,6,-1,0,-2,4,3,3,"w1819","Non.motorized",6,"Thu","weekday"
"3066",2019-01-03,"Brush Creek Trailhead","3","3","2",5.1,0,27,-1,22,18.9,-1,6,-1,0,-2,4,3,3,"w1819","Mechanized",0,"Thu","weekday"
"3067",2019-01-03,"Brush Creek Trailhead","3","3","2",5.1,0,27,-1,22,18.9,-1,6,-1,0,-2,4,3,3,"w1819","Motorized",0,"Thu","weekday"
"3068",2019-01-03,"Brush Creek Trailhead","3","3","2",5.1,0,27,-1,22,18.9,-1,6,-1,0,-2,4,3,3,"w1819","Hybrid",0,"Thu","weekday"
"3069",2019-01-04,"Brush Creek Trailhead","3","3","2",5.3,0.2,26,-1,29,20.4,-1,-1,6,-1,-2,-3,3,2,"w1819","Non.motorized",9,"Fri","weekday"
"3070",2019-01-04,"Brush Creek Trailhead","3","3","2",5.3,0.2,26,-1,29,20.4,-1,-1,6,-1,-2,-3,3,2,"w1819","Mechanized",0,"Fri","weekday"
"3071",2019-01-04,"Brush Creek Trailhead","3","3","2",5.3,0.2,26,-1,29,20.4,-1,-1,6,-1,-2,-3,3,2,"w1819","Motorized",0,"Fri","weekday"
"3072",2019-01-04,"Brush Creek Trailhead","3","3","2",5.3,0.2,26,-1,29,20.4,-1,-1,6,-1,-2,-3,3,2,"w1819","Hybrid",0,"Fri","weekday"
"3073",2019-01-05,"Brush Creek Trailhead","2","2","2",5.3,0,25,-1,30,21.2,-1,-1,-1,6,-2,-3,-4,2,"w1819","Non.motorized",19,"Sat","weekend"
"3074",2019-01-05,"Brush Creek Trailhead","2","2","2",5.3,0,25,-1,30,21.2,-1,-1,-1,6,-2,-3,-4,2,"w1819","Mechanized",0,"Sat","weekend"
"3075",2019-01-05,"Brush Creek Trailhead","2","2","2",5.3,0,25,-1,30,21.2,-1,-1,-1,6,-2,-3,-4,2,"w1819","Motorized",0,"Sat","weekend"
"3076",2019-01-05,"Brush Creek Trailhead","2","2","2",5.3,0,25,-1,30,21.2,-1,-1,-1,6,-2,-3,-4,2,"w1819","Hybrid",0,"Sat","weekend"
"3077",2019-01-06,"Brush Creek Trailhead","3","3","3",5.3,0,25,0,26,21.2,-1,-1,-1,-1,-1,-2,-3,-4,"w1819","Non.motorized",6,"Sun","weekend"
"3078",2019-01-06,"Brush Creek Trailhead","3","3","3",5.3,0,25,0,26,21.2,-1,-1,-1,-1,-1,-2,-3,-4,"w1819","Mechanized",0,"Sun","weekend"
"3079",2019-01-06,"Brush Creek Trailhead","3","3","3",5.3,0,25,0,26,21.2,-1,-1,-1,-1,-1,-2,-3,-4,"w1819","Motorized",0,"Sun","weekend"
"3080",2019-01-06,"Brush Creek Trailhead","3","3","3",5.3,0,25,0,26,21.2,-1,-1,-1,-1,-1,-2,-3,-4,"w1819","Hybrid",0,"Sun","weekend"
"3081",2019-01-07,"Brush Creek Trailhead","3","3","3",5.8,0.5,32,7,21,18.1,0,-1,-1,-1,7,6,5,4,"w1819","Non.motorized",5,"Mon","weekday"
"3082",2019-01-07,"Brush Creek Trailhead","3","3","3",5.8,0.5,32,7,21,18.1,0,-1,-1,-1,7,6,5,4,"w1819","Mechanized",0,"Mon","weekday"
"3083",2019-01-07,"Brush Creek Trailhead","3","3","3",5.8,0.5,32,7,21,18.1,0,-1,-1,-1,7,6,5,4,"w1819","Motorized",0,"Mon","weekday"
"3084",2019-01-07,"Brush Creek Trailhead","3","3","3",5.8,0.5,32,7,21,18.1,0,-1,-1,-1,7,6,5,4,"w1819","Hybrid",0,"Mon","weekday"
"3085",2019-01-08,"Brush Creek Trailhead","3","3","3",5.9,0.1,32,0,24,18.4,7,0,-1,-1,7,7,6,5,"w1819","Non.motorized",6,"Tue","weekday"
"3086",2019-01-08,"Brush Creek Trailhead","3","3","3",5.9,0.1,32,0,24,18.4,7,0,-1,-1,7,7,6,5,"w1819","Mechanized",0,"Tue","weekday"
"3087",2019-01-08,"Brush Creek Trailhead","3","3","3",5.9,0.1,32,0,24,18.4,7,0,-1,-1,7,7,6,5,"w1819","Motorized",0,"Tue","weekday"
"3088",2019-01-08,"Brush Creek Trailhead","3","3","3",5.9,0.1,32,0,24,18.4,7,0,-1,-1,7,7,6,5,"w1819","Hybrid",0,"Tue","weekday"
"3089",2019-01-09,"Brush Creek Trailhead","3","3","3",6,0.1,30,-2,29,20,0,7,0,-1,-2,5,5,4,"w1819","Non.motorized",9,"Wed","weekday"
"3090",2019-01-09,"Brush Creek Trailhead","3","3","3",6,0.1,30,-2,29,20,0,7,0,-1,-2,5,5,4,"w1819","Mechanized",0,"Wed","weekday"
"3091",2019-01-09,"Brush Creek Trailhead","3","3","3",6,0.1,30,-2,29,20,0,7,0,-1,-2,5,5,4,"w1819","Motorized",0,"Wed","weekday"
"3092",2019-01-09,"Brush Creek Trailhead","3","3","3",6,0.1,30,-2,29,20,0,7,0,-1,-2,5,5,4,"w1819","Hybrid",0,"Wed","weekday"
"3093",2019-01-10,"Brush Creek Trailhead","3","3","3",6,0,29,-1,29,20.7,-2,0,7,0,-3,-3,4,4,"w1819","Non.motorized",9,"Thu","weekday"
"3094",2019-01-10,"Brush Creek Trailhead","3","3","3",6,0,29,-1,29,20.7,-2,0,7,0,-3,-3,4,4,"w1819","Mechanized",0,"Thu","weekday"
"3095",2019-01-10,"Brush Creek Trailhead","3","3","3",6,0,29,-1,29,20.7,-2,0,7,0,-3,-3,4,4,"w1819","Motorized",0,"Thu","weekday"
"3096",2019-01-10,"Brush Creek Trailhead","3","3","3",6,0,29,-1,29,20.7,-2,0,7,0,-3,-3,4,4,"w1819","Hybrid",0,"Thu","weekday"
"3097",2019-01-11,"Brush Creek Trailhead","2","2","2",6.1,0.1,29,0,25,21,-1,-2,0,7,-1,-3,-3,4,"w1819","Non.motorized",2,"Fri","weekday"
"3098",2019-01-11,"Brush Creek Trailhead","2","2","2",6.1,0.1,29,0,25,21,-1,-2,0,7,-1,-3,-3,4,"w1819","Mechanized",0,"Fri","weekday"
"3099",2019-01-11,"Brush Creek Trailhead","2","2","2",6.1,0.1,29,0,25,21,-1,-2,0,7,-1,-3,-3,4,"w1819","Motorized",0,"Fri","weekday"
"3100",2019-01-11,"Brush Creek Trailhead","2","2","2",6.1,0.1,29,0,25,21,-1,-2,0,7,-1,-3,-3,4,"w1819","Hybrid",0,"Fri","weekday"
"3101",2019-01-12,"Brush Creek Trailhead","3","3","2",6.1,0,28,-1,21,21.8,0,-1,-2,0,-1,-2,-4,-4,"w1819","Non.motorized",8,"Sat","weekend"
"3102",2019-01-12,"Brush Creek Trailhead","3","3","2",6.1,0,28,-1,21,21.8,0,-1,-2,0,-1,-2,-4,-4,"w1819","Mechanized",0,"Sat","weekend"
"3103",2019-01-12,"Brush Creek Trailhead","3","3","2",6.1,0,28,-1,21,21.8,0,-1,-2,0,-1,-2,-4,-4,"w1819","Motorized",0,"Sat","weekend"
"3104",2019-01-12,"Brush Creek Trailhead","3","3","2",6.1,0,28,-1,21,21.8,0,-1,-2,0,-1,-2,-4,-4,"w1819","Hybrid",0,"Sat","weekend"
"3105",2019-01-13,"Brush Creek Trailhead","2","2","2",6.2,0.1,30,2,18,20.7,-1,0,-1,-2,1,1,0,-2,"w1819","Non.motorized",10,"Sun","weekend"
"3106",2019-01-13,"Brush Creek Trailhead","2","2","2",6.2,0.1,30,2,18,20.7,-1,0,-1,-2,1,1,0,-2,"w1819","Mechanized",0,"Sun","weekend"
"3107",2019-01-13,"Brush Creek Trailhead","2","2","2",6.2,0.1,30,2,18,20.7,-1,0,-1,-2,1,1,0,-2,"w1819","Motorized",0,"Sun","weekend"
"3108",2019-01-13,"Brush Creek Trailhead","2","2","2",6.2,0.1,30,2,18,20.7,-1,0,-1,-2,1,1,0,-2,"w1819","Hybrid",0,"Sun","weekend"
"3109",2019-01-14,"Brush Creek Trailhead","2","2","2",6.2,0,30,0,18,20.7,2,-1,0,-1,2,1,1,0,"w1819","Non.motorized",5,"Mon","weekday"
"3110",2019-01-14,"Brush Creek Trailhead","2","2","2",6.2,0,30,0,18,20.7,2,-1,0,-1,2,1,1,0,"w1819","Mechanized",0,"Mon","weekday"
"3111",2019-01-14,"Brush Creek Trailhead","2","2","2",6.2,0,30,0,18,20.7,2,-1,0,-1,2,1,1,0,"w1819","Motorized",0,"Mon","weekday"
"3112",2019-01-14,"Brush Creek Trailhead","2","2","2",6.2,0,30,0,18,20.7,2,-1,0,-1,2,1,1,0,"w1819","Hybrid",0,"Mon","weekday"
"3113",2019-01-15,"Brush Creek Trailhead","2","2","2",6.2,0,29,-1,24,21.4,0,2,-1,0,-1,1,0,0,"w1819","Non.motorized",8,"Tue","weekday"
"3114",2019-01-15,"Brush Creek Trailhead","2","2","2",6.2,0,29,-1,24,21.4,0,2,-1,0,-1,1,0,0,"w1819","Mechanized",0,"Tue","weekday"
"3115",2019-01-15,"Brush Creek Trailhead","2","2","2",6.2,0,29,-1,24,21.4,0,2,-1,0,-1,1,0,0,"w1819","Motorized",0,"Tue","weekday"
"3116",2019-01-15,"Brush Creek Trailhead","2","2","2",6.2,0,29,-1,24,21.4,0,2,-1,0,-1,1,0,0,"w1819","Hybrid",0,"Tue","weekday"
"3117",2019-01-16,"Brush Creek Trailhead","4","4","3",6.3,0.1,29,0,26,21.7,-1,0,2,-1,-1,-1,1,0,"w1819","Non.motorized",1,"Wed","weekday"
"3118",2019-01-16,"Brush Creek Trailhead","4","4","3",6.3,0.1,29,0,26,21.7,-1,0,2,-1,-1,-1,1,0,"w1819","Mechanized",0,"Wed","weekday"
"3119",2019-01-16,"Brush Creek Trailhead","4","4","3",6.3,0.1,29,0,26,21.7,-1,0,2,-1,-1,-1,1,0,"w1819","Motorized",0,"Wed","weekday"
"3120",2019-01-16,"Brush Creek Trailhead","4","4","3",6.3,0.1,29,0,26,21.7,-1,0,2,-1,-1,-1,1,0,"w1819","Hybrid",0,"Wed","weekday"
"3121",2019-01-17,"Brush Creek Trailhead","3","3","2",7,0.7,38,9,28,18.4,0,-1,0,2,9,8,8,10,"w1819","Non.motorized",1,"Thu","weekday"
"3122",2019-01-17,"Brush Creek Trailhead","3","3","2",7,0.7,38,9,28,18.4,0,-1,0,2,9,8,8,10,"w1819","Mechanized",0,"Thu","weekday"
"3123",2019-01-17,"Brush Creek Trailhead","3","3","2",7,0.7,38,9,28,18.4,0,-1,0,2,9,8,8,10,"w1819","Motorized",0,"Thu","weekday"
"3124",2019-01-17,"Brush Creek Trailhead","3","3","2",7,0.7,38,9,28,18.4,0,-1,0,2,9,8,8,10,"w1819","Hybrid",0,"Thu","weekday"
"3125",2019-01-18,"Brush Creek Trailhead","4","4","4",7.5,0.5,41,3,22,18.3,9,0,-1,0,12,12,11,11,"w1819","Non.motorized",0,"Fri","weekday"
"3126",2019-01-18,"Brush Creek Trailhead","4","4","4",7.5,0.5,41,3,22,18.3,9,0,-1,0,12,12,11,11,"w1819","Mechanized",0,"Fri","weekday"
"3127",2019-01-18,"Brush Creek Trailhead","4","4","4",7.5,0.5,41,3,22,18.3,9,0,-1,0,12,12,11,11,"w1819","Motorized",0,"Fri","weekday"
"3128",2019-01-18,"Brush Creek Trailhead","4","4","4",7.5,0.5,41,3,22,18.3,9,0,-1,0,12,12,11,11,"w1819","Hybrid",0,"Fri","weekday"
"3129",2019-01-19,"Brush Creek Trailhead","3","3","3",7.8,0.3,43,2,20,18.1,3,9,0,-1,5,14,14,13,"w1819","Non.motorized",0,"Sat","weekend"
"3130",2019-01-19,"Brush Creek Trailhead","3","3","3",7.8,0.3,43,2,20,18.1,3,9,0,-1,5,14,14,13,"w1819","Mechanized",0,"Sat","weekend"
"3131",2019-01-19,"Brush Creek Trailhead","3","3","3",7.8,0.3,43,2,20,18.1,3,9,0,-1,5,14,14,13,"w1819","Motorized",0,"Sat","weekend"
"3132",2019-01-19,"Brush Creek Trailhead","3","3","3",7.8,0.3,43,2,20,18.1,3,9,0,-1,5,14,14,13,"w1819","Hybrid",0,"Sat","weekend"
"3133",2019-01-20,"Brush Creek Trailhead","3","3","3",7.9,0.1,41,-2,27,19.3,2,3,9,0,0,3,12,12,"w1819","Non.motorized",0,"Sun","weekend"
"3134",2019-01-20,"Brush Creek Trailhead","3","3","3",7.9,0.1,41,-2,27,19.3,2,3,9,0,0,3,12,12,"w1819","Mechanized",0,"Sun","weekend"
"3135",2019-01-20,"Brush Creek Trailhead","3","3","3",7.9,0.1,41,-2,27,19.3,2,3,9,0,0,3,12,12,"w1819","Motorized",0,"Sun","weekend"
"3136",2019-01-20,"Brush Creek Trailhead","3","3","3",7.9,0.1,41,-2,27,19.3,2,3,9,0,0,3,12,12,"w1819","Hybrid",0,"Sun","weekend"
"3137",2019-01-21,"Brush Creek Trailhead","3","3","3",7.9,0,39,-2,23,20.3,-2,2,3,9,-4,-2,1,10,"w1819","Non.motorized",NA,"Mon","weekday"
"3138",2019-01-21,"Brush Creek Trailhead","3","3","3",7.9,0,39,-2,23,20.3,-2,2,3,9,-4,-2,1,10,"w1819","Mechanized",NA,"Mon","weekday"
"3139",2019-01-21,"Brush Creek Trailhead","3","3","3",7.9,0,39,-2,23,20.3,-2,2,3,9,-4,-2,1,10,"w1819","Motorized",NA,"Mon","weekday"
"3140",2019-01-21,"Brush Creek Trailhead","3","3","3",7.9,0,39,-2,23,20.3,-2,2,3,9,-4,-2,1,10,"w1819","Hybrid",NA,"Mon","weekday"
"3141",2019-01-22,"Brush Creek Trailhead","3","3","3",8,0.1,41,2,12,19.5,-2,-2,2,3,0,-2,0,3,"w1819","Non.motorized",9,"Tue","weekday"
"3142",2019-01-22,"Brush Creek Trailhead","3","3","3",8,0.1,41,2,12,19.5,-2,-2,2,3,0,-2,0,3,"w1819","Mechanized",0,"Tue","weekday"
"3143",2019-01-22,"Brush Creek Trailhead","3","3","3",8,0.1,41,2,12,19.5,-2,-2,2,3,0,-2,0,3,"w1819","Motorized",0,"Tue","weekday"
"3144",2019-01-22,"Brush Creek Trailhead","3","3","3",8,0.1,41,2,12,19.5,-2,-2,2,3,0,-2,0,3,"w1819","Hybrid",0,"Tue","weekday"
"3145",2019-01-23,"Brush Creek Trailhead","3","3","2",8,0,40,-1,14,20,2,-2,-2,2,1,-1,-3,-1,"w1819","Non.motorized",3,"Wed","weekday"
"3146",2019-01-23,"Brush Creek Trailhead","3","3","2",8,0,40,-1,14,20,2,-2,-2,2,1,-1,-3,-1,"w1819","Mechanized",0,"Wed","weekday"
"3147",2019-01-23,"Brush Creek Trailhead","3","3","2",8,0,40,-1,14,20,2,-2,-2,2,1,-1,-3,-1,"w1819","Motorized",0,"Wed","weekday"
"3148",2019-01-23,"Brush Creek Trailhead","3","3","2",8,0,40,-1,14,20,2,-2,-2,2,1,-1,-3,-1,"w1819","Hybrid",0,"Wed","weekday"
"3149",2019-01-24,"Brush Creek Trailhead","3","3","2",8.2,0.2,40,0,17,20.5,-1,2,-2,-2,-1,1,-1,-3,"w1819","Non.motorized",5,"Thu","weekday"
"3150",2019-01-24,"Brush Creek Trailhead","3","3","2",8.2,0.2,40,0,17,20.5,-1,2,-2,-2,-1,1,-1,-3,"w1819","Mechanized",0,"Thu","weekday"
"3151",2019-01-24,"Brush Creek Trailhead","3","3","2",8.2,0.2,40,0,17,20.5,-1,2,-2,-2,-1,1,-1,-3,"w1819","Motorized",0,"Thu","weekday"
"3152",2019-01-24,"Brush Creek Trailhead","3","3","2",8.2,0.2,40,0,17,20.5,-1,2,-2,-2,-1,1,-1,-3,"w1819","Hybrid",0,"Thu","weekday"
"3153",2019-01-25,"Brush Creek Trailhead","3","3","2",8.3,0.1,40,0,15,20.8,0,-1,2,-2,0,-1,1,-1,"w1819","Non.motorized",7,"Fri","weekday"
"3154",2019-01-25,"Brush Creek Trailhead","3","3","2",8.3,0.1,40,0,15,20.8,0,-1,2,-2,0,-1,1,-1,"w1819","Mechanized",2,"Fri","weekday"
"3155",2019-01-25,"Brush Creek Trailhead","3","3","2",8.3,0.1,40,0,15,20.8,0,-1,2,-2,0,-1,1,-1,"w1819","Motorized",0,"Fri","weekday"
"3156",2019-01-25,"Brush Creek Trailhead","3","3","2",8.3,0.1,40,0,15,20.8,0,-1,2,-2,0,-1,1,-1,"w1819","Hybrid",0,"Fri","weekday"
"3157",2019-01-26,"Brush Creek Trailhead","3","3","2",8.3,0,39,-1,19,21.3,0,0,-1,2,-1,-1,-2,0,"w1819","Non.motorized",25,"Sat","weekend"
"3158",2019-01-26,"Brush Creek Trailhead","3","3","2",8.3,0,39,-1,19,21.3,0,0,-1,2,-1,-1,-2,0,"w1819","Mechanized",1,"Sat","weekend"
"3159",2019-01-26,"Brush Creek Trailhead","3","3","2",8.3,0,39,-1,19,21.3,0,0,-1,2,-1,-1,-2,0,"w1819","Motorized",0,"Sat","weekend"
"3160",2019-01-26,"Brush Creek Trailhead","3","3","2",8.3,0,39,-1,19,21.3,0,0,-1,2,-1,-1,-2,0,"w1819","Hybrid",0,"Sat","weekend"
"3161",2019-01-27,"Brush Creek Trailhead","3","3","2",8.3,0,38,-1,24,21.8,-1,0,0,-1,-2,-2,-2,-3,"w1819","Non.motorized",15,"Sun","weekend"
"3162",2019-01-27,"Brush Creek Trailhead","3","3","2",8.3,0,38,-1,24,21.8,-1,0,0,-1,-2,-2,-2,-3,"w1819","Mechanized",0,"Sun","weekend"
"3163",2019-01-27,"Brush Creek Trailhead","3","3","2",8.3,0,38,-1,24,21.8,-1,0,0,-1,-2,-2,-2,-3,"w1819","Motorized",0,"Sun","weekend"
"3164",2019-01-27,"Brush Creek Trailhead","3","3","2",8.3,0,38,-1,24,21.8,-1,0,0,-1,-2,-2,-2,-3,"w1819","Hybrid",0,"Sun","weekend"
"3165",2019-01-28,"Brush Creek Trailhead","2","2","2",8.3,0,38,0,17,21.8,-1,-1,0,0,-1,-2,-2,-2,"w1819","Non.motorized",5,"Mon","weekday"
"3166",2019-01-28,"Brush Creek Trailhead","2","2","2",8.3,0,38,0,17,21.8,-1,-1,0,0,-1,-2,-2,-2,"w1819","Mechanized",0,"Mon","weekday"
"3167",2019-01-28,"Brush Creek Trailhead","2","2","2",8.3,0,38,0,17,21.8,-1,-1,0,0,-1,-2,-2,-2,"w1819","Motorized",0,"Mon","weekday"
"3168",2019-01-28,"Brush Creek Trailhead","2","2","2",8.3,0,38,0,17,21.8,-1,-1,0,0,-1,-2,-2,-2,"w1819","Hybrid",0,"Mon","weekday"
"3169",2019-01-29,"Brush Creek Trailhead","2","2","2",8.3,0,38,0,16,21.8,0,-1,-1,0,0,-1,-2,-2,"w1819","Non.motorized",0,"Tue","weekday"
"3170",2019-01-29,"Brush Creek Trailhead","2","2","2",8.3,0,38,0,16,21.8,0,-1,-1,0,0,-1,-2,-2,"w1819","Mechanized",0,"Tue","weekday"
"3171",2019-01-29,"Brush Creek Trailhead","2","2","2",8.3,0,38,0,16,21.8,0,-1,-1,0,0,-1,-2,-2,"w1819","Motorized",0,"Tue","weekday"
"3172",2019-01-29,"Brush Creek Trailhead","2","2","2",8.3,0,38,0,16,21.8,0,-1,-1,0,0,-1,-2,-2,"w1819","Hybrid",0,"Tue","weekday"
"3173",2019-01-30,"Brush Creek Trailhead","2","2","1",8.3,0,37,-1,20,22.4,0,0,-1,-1,-1,-1,-2,-3,"w1819","Non.motorized",0,"Wed","weekday"
"3174",2019-01-30,"Brush Creek Trailhead","2","2","1",8.3,0,37,-1,20,22.4,0,0,-1,-1,-1,-1,-2,-3,"w1819","Mechanized",0,"Wed","weekday"
"3175",2019-01-30,"Brush Creek Trailhead","2","2","1",8.3,0,37,-1,20,22.4,0,0,-1,-1,-1,-1,-2,-3,"w1819","Motorized",0,"Wed","weekday"
"3176",2019-01-30,"Brush Creek Trailhead","2","2","1",8.3,0,37,-1,20,22.4,0,0,-1,-1,-1,-1,-2,-3,"w1819","Hybrid",0,"Wed","weekday"
"3177",2019-01-31,"Brush Creek Trailhead","2","2","1",8.3,0,36,-1,24,23.1,-1,0,0,-1,-2,-2,-2,-3,"w1819","Non.motorized",0,"Thu","weekday"
"3178",2019-01-31,"Brush Creek Trailhead","2","2","1",8.3,0,36,-1,24,23.1,-1,0,0,-1,-2,-2,-2,-3,"w1819","Mechanized",0,"Thu","weekday"
"3179",2019-01-31,"Brush Creek Trailhead","2","2","1",8.3,0,36,-1,24,23.1,-1,0,0,-1,-2,-2,-2,-3,"w1819","Motorized",0,"Thu","weekday"
"3180",2019-01-31,"Brush Creek Trailhead","2","2","1",8.3,0,36,-1,24,23.1,-1,0,0,-1,-2,-2,-2,-3,"w1819","Hybrid",0,"Thu","weekday"
"3181",2019-02-01,"Brush Creek Trailhead","2","2","1",8.3,0,36,0,25,23.1,-1,-1,0,0,-1,-2,-2,-2,"w1819","Non.motorized",5,"Fri","weekday"
"3182",2019-02-01,"Brush Creek Trailhead","2","2","1",8.3,0,36,0,25,23.1,-1,-1,0,0,-1,-2,-2,-2,"w1819","Mechanized",0,"Fri","weekday"
"3183",2019-02-01,"Brush Creek Trailhead","2","2","1",8.3,0,36,0,25,23.1,-1,-1,0,0,-1,-2,-2,-2,"w1819","Motorized",0,"Fri","weekday"
"3184",2019-02-01,"Brush Creek Trailhead","2","2","1",8.3,0,36,0,25,23.1,-1,-1,0,0,-1,-2,-2,-2,"w1819","Hybrid",0,"Fri","weekday"
"3185",2019-02-02,"Brush Creek Trailhead","2","2","1",8.3,0,36,0,26,23.1,0,-1,-1,0,0,-1,-2,-2,"w1819","Non.motorized",27,"Sat","weekend"
"3186",2019-02-02,"Brush Creek Trailhead","2","2","1",8.3,0,36,0,26,23.1,0,-1,-1,0,0,-1,-2,-2,"w1819","Mechanized",2,"Sat","weekend"
"3187",2019-02-02,"Brush Creek Trailhead","2","2","1",8.3,0,36,0,26,23.1,0,-1,-1,0,0,-1,-2,-2,"w1819","Motorized",0,"Sat","weekend"
"3188",2019-02-02,"Brush Creek Trailhead","2","2","1",8.3,0,36,0,26,23.1,0,-1,-1,0,0,-1,-2,-2,"w1819","Hybrid",0,"Sat","weekend"
"3189",2019-02-03,"Brush Creek Trailhead","3","3","2",8.4,0.1,36,0,28,23.3,0,0,-1,-1,0,0,-1,-2,"w1819","Non.motorized",8,"Sun","weekend"
"3190",2019-02-03,"Brush Creek Trailhead","3","3","2",8.4,0.1,36,0,28,23.3,0,0,-1,-1,0,0,-1,-2,"w1819","Mechanized",0,"Sun","weekend"
"3191",2019-02-03,"Brush Creek Trailhead","3","3","2",8.4,0.1,36,0,28,23.3,0,0,-1,-1,0,0,-1,-2,"w1819","Motorized",0,"Sun","weekend"
"3192",2019-02-03,"Brush Creek Trailhead","3","3","2",8.4,0.1,36,0,28,23.3,0,0,-1,-1,0,0,-1,-2,"w1819","Hybrid",0,"Sun","weekend"
"3193",2019-02-04,"Brush Creek Trailhead","3","3","2",8.8,0.4,39,3,28,22.6,0,0,0,-1,3,3,3,2,"w1819","Non.motorized",4,"Mon","weekday"
"3194",2019-02-04,"Brush Creek Trailhead","3","3","2",8.8,0.4,39,3,28,22.6,0,0,0,-1,3,3,3,2,"w1819","Mechanized",0,"Mon","weekday"
"3195",2019-02-04,"Brush Creek Trailhead","3","3","2",8.8,0.4,39,3,28,22.6,0,0,0,-1,3,3,3,2,"w1819","Motorized",0,"Mon","weekday"
"3196",2019-02-04,"Brush Creek Trailhead","3","3","2",8.8,0.4,39,3,28,22.6,0,0,0,-1,3,3,3,2,"w1819","Hybrid",0,"Mon","weekday"
"3197",2019-02-05,"Brush Creek Trailhead","3","2","2",9,0.2,40,1,26,22.5,3,0,0,0,4,4,4,4,"w1819","Non.motorized",6,"Tue","weekday"
"3198",2019-02-05,"Brush Creek Trailhead","3","2","2",9,0.2,40,1,26,22.5,3,0,0,0,4,4,4,4,"w1819","Mechanized",1,"Tue","weekday"
"3199",2019-02-05,"Brush Creek Trailhead","3","2","2",9,0.2,40,1,26,22.5,3,0,0,0,4,4,4,4,"w1819","Motorized",0,"Tue","weekday"
"3200",2019-02-05,"Brush Creek Trailhead","3","2","2",9,0.2,40,1,26,22.5,3,0,0,0,4,4,4,4,"w1819","Hybrid",0,"Tue","weekday"
"3201",2019-02-06,"Brush Creek Trailhead","4","4","3",9,0,40,0,16,22.5,1,3,0,0,1,4,4,4,"w1819","Non.motorized",2,"Wed","weekday"
"3202",2019-02-06,"Brush Creek Trailhead","4","4","3",9,0,40,0,16,22.5,1,3,0,0,1,4,4,4,"w1819","Mechanized",0,"Wed","weekday"
"3203",2019-02-06,"Brush Creek Trailhead","4","4","3",9,0,40,0,16,22.5,1,3,0,0,1,4,4,4,"w1819","Motorized",0,"Wed","weekday"
"3204",2019-02-06,"Brush Creek Trailhead","4","4","3",9,0,40,0,16,22.5,1,3,0,0,1,4,4,4,"w1819","Hybrid",0,"Wed","weekday"
"3205",2019-02-07,"Brush Creek Trailhead","3","3","2",9.2,0.2,43,3,4,21.4,0,1,3,0,3,4,7,7,"w1819","Non.motorized",0,"Thu","weekday"
"3206",2019-02-07,"Brush Creek Trailhead","3","3","2",9.2,0.2,43,3,4,21.4,0,1,3,0,3,4,7,7,"w1819","Mechanized",0,"Thu","weekday"
"3207",2019-02-07,"Brush Creek Trailhead","3","3","2",9.2,0.2,43,3,4,21.4,0,1,3,0,3,4,7,7,"w1819","Motorized",0,"Thu","weekday"
"3208",2019-02-07,"Brush Creek Trailhead","3","3","2",9.2,0.2,43,3,4,21.4,0,1,3,0,3,4,7,7,"w1819","Hybrid",0,"Thu","weekday"
"3209",2019-02-08,"Brush Creek Trailhead","3","2","2",9.2,0,42,-1,10,21.9,3,0,1,3,2,2,3,6,"w1819","Non.motorized",2,"Fri","weekday"
"3210",2019-02-08,"Brush Creek Trailhead","3","2","2",9.2,0,42,-1,10,21.9,3,0,1,3,2,2,3,6,"w1819","Mechanized",0,"Fri","weekday"
"3211",2019-02-08,"Brush Creek Trailhead","3","2","2",9.2,0,42,-1,10,21.9,3,0,1,3,2,2,3,6,"w1819","Motorized",0,"Fri","weekday"
"3212",2019-02-08,"Brush Creek Trailhead","3","2","2",9.2,0,42,-1,10,21.9,3,0,1,3,2,2,3,6,"w1819","Hybrid",0,"Fri","weekday"
"3213",2019-02-09,"Brush Creek Trailhead","3","2","2",9.2,0,41,-1,20,22.4,-1,3,0,1,-2,1,1,2,"w1819","Non.motorized",7,"Sat","weekend"
"3214",2019-02-09,"Brush Creek Trailhead","3","2","2",9.2,0,41,-1,20,22.4,-1,3,0,1,-2,1,1,2,"w1819","Mechanized",0,"Sat","weekend"
"3215",2019-02-09,"Brush Creek Trailhead","3","2","2",9.2,0,41,-1,20,22.4,-1,3,0,1,-2,1,1,2,"w1819","Motorized",0,"Sat","weekend"
"3216",2019-02-09,"Brush Creek Trailhead","3","2","2",9.2,0,41,-1,20,22.4,-1,3,0,1,-2,1,1,2,"w1819","Hybrid",0,"Sat","weekend"
"3217",2019-02-10,"Brush Creek Trailhead","2","2","2",9.3,0.1,40,-1,20,23.2,-1,-1,3,0,-2,-3,0,0,"w1819","Non.motorized",21,"Sun","weekend"
"3218",2019-02-10,"Brush Creek Trailhead","2","2","2",9.3,0.1,40,-1,20,23.2,-1,-1,3,0,-2,-3,0,0,"w1819","Mechanized",0,"Sun","weekend"
"3219",2019-02-10,"Brush Creek Trailhead","2","2","2",9.3,0.1,40,-1,20,23.2,-1,-1,3,0,-2,-3,0,0,"w1819","Motorized",0,"Sun","weekend"
"3220",2019-02-10,"Brush Creek Trailhead","2","2","2",9.3,0.1,40,-1,20,23.2,-1,-1,3,0,-2,-3,0,0,"w1819","Hybrid",0,"Sun","weekend"
"3221",2019-02-11,"Brush Creek Trailhead","2","2","1",9.3,0,40,0,15,23.2,-1,-1,-1,3,-1,-2,-3,0,"w1819","Non.motorized",7,"Mon","weekday"
"3222",2019-02-11,"Brush Creek Trailhead","2","2","1",9.3,0,40,0,15,23.2,-1,-1,-1,3,-1,-2,-3,0,"w1819","Mechanized",0,"Mon","weekday"
"3223",2019-02-11,"Brush Creek Trailhead","2","2","1",9.3,0,40,0,15,23.2,-1,-1,-1,3,-1,-2,-3,0,"w1819","Motorized",0,"Mon","weekday"
"3224",2019-02-11,"Brush Creek Trailhead","2","2","1",9.3,0,40,0,15,23.2,-1,-1,-1,3,-1,-2,-3,0,"w1819","Hybrid",0,"Mon","weekday"
"3225",2019-02-12,"Brush Creek Trailhead","2","2","1",9.3,0,40,0,18,23.2,0,-1,-1,-1,0,-1,-2,-3,"w1819","Non.motorized",7,"Tue","weekday"
"3226",2019-02-12,"Brush Creek Trailhead","2","2","1",9.3,0,40,0,18,23.2,0,-1,-1,-1,0,-1,-2,-3,"w1819","Mechanized",0,"Tue","weekday"
"3227",2019-02-12,"Brush Creek Trailhead","2","2","1",9.3,0,40,0,18,23.2,0,-1,-1,-1,0,-1,-2,-3,"w1819","Motorized",0,"Tue","weekday"
"3228",2019-02-12,"Brush Creek Trailhead","2","2","1",9.3,0,40,0,18,23.2,0,-1,-1,-1,0,-1,-2,-3,"w1819","Hybrid",0,"Tue","weekday"
"3229",2019-02-13,"Brush Creek Trailhead","2","2","1",9.4,0.1,40,0,26,23.5,0,0,-1,-1,0,0,-1,-2,"w1819","Non.motorized",NA,"Wed","weekday"
"3230",2019-02-13,"Brush Creek Trailhead","2","2","1",9.4,0.1,40,0,26,23.5,0,0,-1,-1,0,0,-1,-2,"w1819","Mechanized",NA,"Wed","weekday"
"3231",2019-02-13,"Brush Creek Trailhead","2","2","1",9.4,0.1,40,0,26,23.5,0,0,-1,-1,0,0,-1,-2,"w1819","Motorized",NA,"Wed","weekday"
"3232",2019-02-13,"Brush Creek Trailhead","2","2","1",9.4,0.1,40,0,26,23.5,0,0,-1,-1,0,0,-1,-2,"w1819","Hybrid",NA,"Wed","weekday"
"3233",2019-02-14,"Brush Creek Trailhead","3","2","2",9.7,0.3,41,1,29,23.7,0,0,0,-1,1,1,1,0,"w1819","Non.motorized",5,"Thu","weekday"
"3234",2019-02-14,"Brush Creek Trailhead","3","2","2",9.7,0.3,41,1,29,23.7,0,0,0,-1,1,1,1,0,"w1819","Mechanized",0,"Thu","weekday"
"3235",2019-02-14,"Brush Creek Trailhead","3","2","2",9.7,0.3,41,1,29,23.7,0,0,0,-1,1,1,1,0,"w1819","Motorized",0,"Thu","weekday"
"3236",2019-02-14,"Brush Creek Trailhead","3","2","2",9.7,0.3,41,1,29,23.7,0,0,0,-1,1,1,1,0,"w1819","Hybrid",0,"Thu","weekday"
"3237",2019-02-15,"Brush Creek Trailhead","4","4","3",10.8,1.1,51,10,27,21.2,1,0,0,0,11,11,11,11,"w1819","Non.motorized",2,"Fri","weekday"
"3238",2019-02-15,"Brush Creek Trailhead","4","4","3",10.8,1.1,51,10,27,21.2,1,0,0,0,11,11,11,11,"w1819","Mechanized",0,"Fri","weekday"
"3239",2019-02-15,"Brush Creek Trailhead","4","4","3",10.8,1.1,51,10,27,21.2,1,0,0,0,11,11,11,11,"w1819","Motorized",0,"Fri","weekday"
"3240",2019-02-15,"Brush Creek Trailhead","4","4","3",10.8,1.1,51,10,27,21.2,1,0,0,0,11,11,11,11,"w1819","Hybrid",0,"Fri","weekday"
"3241",2019-02-16,"Brush Creek Trailhead","3","3","3",11.1,0.3,52,1,14,21.3,10,1,0,0,11,12,12,12,"w1819","Non.motorized",0,"Sat","weekend"
"3242",2019-02-16,"Brush Creek Trailhead","3","3","3",11.1,0.3,52,1,14,21.3,10,1,0,0,11,12,12,12,"w1819","Mechanized",0,"Sat","weekend"
"3243",2019-02-16,"Brush Creek Trailhead","3","3","3",11.1,0.3,52,1,14,21.3,10,1,0,0,11,12,12,12,"w1819","Motorized",0,"Sat","weekend"
"3244",2019-02-16,"Brush Creek Trailhead","3","3","3",11.1,0.3,52,1,14,21.3,10,1,0,0,11,12,12,12,"w1819","Hybrid",0,"Sat","weekend"
"3245",2019-02-17,"Brush Creek Trailhead","3","3","3",11.3,0.2,55,3,10,20.5,1,10,1,0,4,14,15,15,"w1819","Non.motorized",5,"Sun","weekend"
"3246",2019-02-17,"Brush Creek Trailhead","3","3","3",11.3,0.2,55,3,10,20.5,1,10,1,0,4,14,15,15,"w1819","Mechanized",0,"Sun","weekend"
"3247",2019-02-17,"Brush Creek Trailhead","3","3","3",11.3,0.2,55,3,10,20.5,1,10,1,0,4,14,15,15,"w1819","Motorized",0,"Sun","weekend"
"3248",2019-02-17,"Brush Creek Trailhead","3","3","3",11.3,0.2,55,3,10,20.5,1,10,1,0,4,14,15,15,"w1819","Hybrid",0,"Sun","weekend"
"3249",2019-02-18,"Brush Creek Trailhead","3","3","2",11.4,0.1,53,-2,13,21.5,3,1,10,1,1,2,12,13,"w1819","Non.motorized",6,"Mon","weekday"
"3250",2019-02-18,"Brush Creek Trailhead","3","3","2",11.4,0.1,53,-2,13,21.5,3,1,10,1,1,2,12,13,"w1819","Mechanized",0,"Mon","weekday"
"3251",2019-02-18,"Brush Creek Trailhead","3","3","2",11.4,0.1,53,-2,13,21.5,3,1,10,1,1,2,12,13,"w1819","Motorized",0,"Mon","weekday"
"3252",2019-02-18,"Brush Creek Trailhead","3","3","2",11.4,0.1,53,-2,13,21.5,3,1,10,1,1,2,12,13,"w1819","Hybrid",0,"Mon","weekday"
"3253",2019-02-19,"Brush Creek Trailhead","3","3","2",11.5,0.1,53,0,11,21.7,-2,3,1,10,-2,1,2,12,"w1819","Non.motorized",0,"Tue","weekday"
"3254",2019-02-19,"Brush Creek Trailhead","3","3","2",11.5,0.1,53,0,11,21.7,-2,3,1,10,-2,1,2,12,"w1819","Mechanized",0,"Tue","weekday"
"3255",2019-02-19,"Brush Creek Trailhead","3","3","2",11.5,0.1,53,0,11,21.7,-2,3,1,10,-2,1,2,12,"w1819","Motorized",0,"Tue","weekday"
"3256",2019-02-19,"Brush Creek Trailhead","3","3","2",11.5,0.1,53,0,11,21.7,-2,3,1,10,-2,1,2,12,"w1819","Hybrid",0,"Tue","weekday"
"3257",2019-02-20,"Brush Creek Trailhead","3","3","2",11.6,0.1,53,0,7,21.9,0,-2,3,1,0,-2,1,2,"w1819","Non.motorized",0,"Wed","weekday"
"3258",2019-02-20,"Brush Creek Trailhead","3","3","2",11.6,0.1,53,0,7,21.9,0,-2,3,1,0,-2,1,2,"w1819","Mechanized",0,"Wed","weekday"
"3259",2019-02-20,"Brush Creek Trailhead","3","3","2",11.6,0.1,53,0,7,21.9,0,-2,3,1,0,-2,1,2,"w1819","Motorized",0,"Wed","weekday"
"3260",2019-02-20,"Brush Creek Trailhead","3","3","2",11.6,0.1,53,0,7,21.9,0,-2,3,1,0,-2,1,2,"w1819","Hybrid",0,"Wed","weekday"
"3261",2019-02-21,"Brush Creek Trailhead","3","3","3",11.6,0,52,-1,15,22.3,0,0,-2,3,-1,-1,-3,0,"w1819","Non.motorized",0,"Thu","weekday"
"3262",2019-02-21,"Brush Creek Trailhead","3","3","3",11.6,0,52,-1,15,22.3,0,0,-2,3,-1,-1,-3,0,"w1819","Mechanized",0,"Thu","weekday"
"3263",2019-02-21,"Brush Creek Trailhead","3","3","3",11.6,0,52,-1,15,22.3,0,0,-2,3,-1,-1,-3,0,"w1819","Motorized",0,"Thu","weekday"
"3264",2019-02-21,"Brush Creek Trailhead","3","3","3",11.6,0,52,-1,15,22.3,0,0,-2,3,-1,-1,-3,0,"w1819","Hybrid",0,"Thu","weekday"
"3265",2019-02-22,"Brush Creek Trailhead","3","3","3",11.8,0.2,52,0,20,22.7,-1,0,0,-2,-1,-1,-1,-3,"w1819","Non.motorized",0,"Fri","weekday"
"3266",2019-02-22,"Brush Creek Trailhead","3","3","3",11.8,0.2,52,0,20,22.7,-1,0,0,-2,-1,-1,-1,-3,"w1819","Mechanized",0,"Fri","weekday"
"3267",2019-02-22,"Brush Creek Trailhead","3","3","3",11.8,0.2,52,0,20,22.7,-1,0,0,-2,-1,-1,-1,-3,"w1819","Motorized",0,"Fri","weekday"
"3268",2019-02-22,"Brush Creek Trailhead","3","3","3",11.8,0.2,52,0,20,22.7,-1,0,0,-2,-1,-1,-1,-3,"w1819","Hybrid",0,"Fri","weekday"
"3269",2019-02-23,"Brush Creek Trailhead","3","3","3",12.1,0.3,53,1,13,22.8,0,-1,0,0,1,0,0,0,"w1819","Non.motorized",8,"Sat","weekend"
"3270",2019-02-23,"Brush Creek Trailhead","3","3","3",12.1,0.3,53,1,13,22.8,0,-1,0,0,1,0,0,0,"w1819","Mechanized",0,"Sat","weekend"
"3271",2019-02-23,"Brush Creek Trailhead","3","3","3",12.1,0.3,53,1,13,22.8,0,-1,0,0,1,0,0,0,"w1819","Motorized",0,"Sat","weekend"
"3272",2019-02-23,"Brush Creek Trailhead","3","3","3",12.1,0.3,53,1,13,22.8,0,-1,0,0,1,0,0,0,"w1819","Hybrid",0,"Sat","weekend"
"3273",2019-02-24,"Brush Creek Trailhead","3","3","2",12.1,0,52,-1,14,23.3,1,0,-1,0,0,0,-1,-1,"w1819","Non.motorized",13,"Sun","weekend"
"3274",2019-02-24,"Brush Creek Trailhead","3","3","2",12.1,0,52,-1,14,23.3,1,0,-1,0,0,0,-1,-1,"w1819","Mechanized",0,"Sun","weekend"
"3275",2019-02-24,"Brush Creek Trailhead","3","3","2",12.1,0,52,-1,14,23.3,1,0,-1,0,0,0,-1,-1,"w1819","Motorized",0,"Sun","weekend"
"3276",2019-02-24,"Brush Creek Trailhead","3","3","2",12.1,0,52,-1,14,23.3,1,0,-1,0,0,0,-1,-1,"w1819","Hybrid",0,"Sun","weekend"
"3277",2019-02-25,"Brush Creek Trailhead","3","3","2",12.1,0,51,-1,22,23.7,-1,1,0,-1,-2,-1,-1,-2,"w1819","Non.motorized",10,"Mon","weekday"
"3278",2019-02-25,"Brush Creek Trailhead","3","3","2",12.1,0,51,-1,22,23.7,-1,1,0,-1,-2,-1,-1,-2,"w1819","Mechanized",0,"Mon","weekday"
"3279",2019-02-25,"Brush Creek Trailhead","3","3","2",12.1,0,51,-1,22,23.7,-1,1,0,-1,-2,-1,-1,-2,"w1819","Motorized",0,"Mon","weekday"
"3280",2019-02-25,"Brush Creek Trailhead","3","3","2",12.1,0,51,-1,22,23.7,-1,1,0,-1,-2,-1,-1,-2,"w1819","Hybrid",0,"Mon","weekday"
"3281",2019-02-26,"Brush Creek Trailhead","2","2","2",12.1,0,50,-1,27,24.2,-1,-1,1,0,-2,-3,-2,-2,"w1819","Non.motorized",8,"Tue","weekday"
"3282",2019-02-26,"Brush Creek Trailhead","2","2","2",12.1,0,50,-1,27,24.2,-1,-1,1,0,-2,-3,-2,-2,"w1819","Mechanized",0,"Tue","weekday"
"3283",2019-02-26,"Brush Creek Trailhead","2","2","2",12.1,0,50,-1,27,24.2,-1,-1,1,0,-2,-3,-2,-2,"w1819","Motorized",0,"Tue","weekday"
"3284",2019-02-26,"Brush Creek Trailhead","2","2","2",12.1,0,50,-1,27,24.2,-1,-1,1,0,-2,-3,-2,-2,"w1819","Hybrid",0,"Tue","weekday"
"3285",2019-02-27,"Brush Creek Trailhead","2","2","2",12.1,0,50,0,30,24.2,-1,-1,-1,1,-1,-2,-3,-2,"w1819","Non.motorized",1,"Wed","weekday"
"3286",2019-02-27,"Brush Creek Trailhead","2","2","2",12.1,0,50,0,30,24.2,-1,-1,-1,1,-1,-2,-3,-2,"w1819","Mechanized",0,"Wed","weekday"
"3287",2019-02-27,"Brush Creek Trailhead","2","2","2",12.1,0,50,0,30,24.2,-1,-1,-1,1,-1,-2,-3,-2,"w1819","Motorized",0,"Wed","weekday"
"3288",2019-02-27,"Brush Creek Trailhead","2","2","2",12.1,0,50,0,30,24.2,-1,-1,-1,1,-1,-2,-3,-2,"w1819","Hybrid",0,"Wed","weekday"
"3289",2019-02-28,"Brush Creek Trailhead","2","2","2",12.2,0.1,49,-1,30,24.9,0,-1,-1,-1,-1,-2,-3,-4,"w1819","Non.motorized",6,"Thu","weekday"
"3290",2019-02-28,"Brush Creek Trailhead","2","2","2",12.2,0.1,49,-1,30,24.9,0,-1,-1,-1,-1,-2,-3,-4,"w1819","Mechanized",0,"Thu","weekday"
"3291",2019-02-28,"Brush Creek Trailhead","2","2","2",12.2,0.1,49,-1,30,24.9,0,-1,-1,-1,-1,-2,-3,-4,"w1819","Motorized",0,"Thu","weekday"
"3292",2019-02-28,"Brush Creek Trailhead","2","2","2",12.2,0.1,49,-1,30,24.9,0,-1,-1,-1,-1,-2,-3,-4,"w1819","Hybrid",0,"Thu","weekday"
"3293",2019-03-01,"Brush Creek Trailhead","2","2","1",12.3,0.1,49,0,29,25.1,-1,0,-1,-1,-1,-1,-2,-3,"w1819","Non.motorized",0,"Fri","weekday"
"3294",2019-03-01,"Brush Creek Trailhead","2","2","1",12.3,0.1,49,0,29,25.1,-1,0,-1,-1,-1,-1,-2,-3,"w1819","Mechanized",0,"Fri","weekday"
"3295",2019-03-01,"Brush Creek Trailhead","2","2","1",12.3,0.1,49,0,29,25.1,-1,0,-1,-1,-1,-1,-2,-3,"w1819","Motorized",0,"Fri","weekday"
"3296",2019-03-01,"Brush Creek Trailhead","2","2","1",12.3,0.1,49,0,29,25.1,-1,0,-1,-1,-1,-1,-2,-3,"w1819","Hybrid",0,"Fri","weekday"
"3297",2019-03-02,"Brush Creek Trailhead","3","3","2",13,0.7,58,9,30,22.4,0,-1,0,-1,9,8,8,7,"w1819","Non.motorized",0,"Sat","weekend"
"3298",2019-03-02,"Brush Creek Trailhead","3","3","2",13,0.7,58,9,30,22.4,0,-1,0,-1,9,8,8,7,"w1819","Mechanized",0,"Sat","weekend"
"3299",2019-03-02,"Brush Creek Trailhead","3","3","2",13,0.7,58,9,30,22.4,0,-1,0,-1,9,8,8,7,"w1819","Motorized",0,"Sat","weekend"
"3300",2019-03-02,"Brush Creek Trailhead","3","3","2",13,0.7,58,9,30,22.4,0,-1,0,-1,9,8,8,7,"w1819","Hybrid",0,"Sat","weekend"
"3301",2019-03-03,"Brush Creek Trailhead","3","3","3",13.7,0.7,64,6,27,21.4,9,0,-1,0,15,15,14,14,"w1819","Non.motorized",0,"Sun","weekend"
"3302",2019-03-03,"Brush Creek Trailhead","3","3","3",13.7,0.7,64,6,27,21.4,9,0,-1,0,15,15,14,14,"w1819","Mechanized",0,"Sun","weekend"
"3303",2019-03-03,"Brush Creek Trailhead","3","3","3",13.7,0.7,64,6,27,21.4,9,0,-1,0,15,15,14,14,"w1819","Motorized",0,"Sun","weekend"
"3304",2019-03-03,"Brush Creek Trailhead","3","3","3",13.7,0.7,64,6,27,21.4,9,0,-1,0,15,15,14,14,"w1819","Hybrid",0,"Sun","weekend"
"3305",2019-03-04,"Brush Creek Trailhead","3","3","3",14.4,0.7,66,2,23,21.8,6,9,0,-1,8,17,17,16,"w1819","Non.motorized",10,"Mon","weekday"
"3306",2019-03-04,"Brush Creek Trailhead","3","3","3",14.4,0.7,66,2,23,21.8,6,9,0,-1,8,17,17,16,"w1819","Mechanized",0,"Mon","weekday"
"3307",2019-03-04,"Brush Creek Trailhead","3","3","3",14.4,0.7,66,2,23,21.8,6,9,0,-1,8,17,17,16,"w1819","Motorized",0,"Mon","weekday"
"3308",2019-03-04,"Brush Creek Trailhead","3","3","3",14.4,0.7,66,2,23,21.8,6,9,0,-1,8,17,17,16,"w1819","Hybrid",0,"Mon","weekday"
"3309",2019-03-05,"Brush Creek Trailhead","3","3","3",14.4,0,64,-2,24,22.5,2,6,9,0,0,6,15,15,"w1819","Non.motorized",5,"Tue","weekday"
"3310",2019-03-05,"Brush Creek Trailhead","3","3","3",14.4,0,64,-2,24,22.5,2,6,9,0,0,6,15,15,"w1819","Mechanized",0,"Tue","weekday"
"3311",2019-03-05,"Brush Creek Trailhead","3","3","3",14.4,0,64,-2,24,22.5,2,6,9,0,0,6,15,15,"w1819","Motorized",0,"Tue","weekday"
"3312",2019-03-05,"Brush Creek Trailhead","3","3","3",14.4,0,64,-2,24,22.5,2,6,9,0,0,6,15,15,"w1819","Hybrid",0,"Tue","weekday"
"3313",2019-03-06,"Brush Creek Trailhead","3","3","2",14.5,0.1,62,-2,31,23.4,-2,2,6,9,-4,-2,4,13,"w1819","Non.motorized",1,"Wed","weekday"
"3314",2019-03-06,"Brush Creek Trailhead","3","3","2",14.5,0.1,62,-2,31,23.4,-2,2,6,9,-4,-2,4,13,"w1819","Mechanized",0,"Wed","weekday"
"3315",2019-03-06,"Brush Creek Trailhead","3","3","2",14.5,0.1,62,-2,31,23.4,-2,2,6,9,-4,-2,4,13,"w1819","Motorized",0,"Wed","weekday"
"3316",2019-03-06,"Brush Creek Trailhead","3","3","2",14.5,0.1,62,-2,31,23.4,-2,2,6,9,-4,-2,4,13,"w1819","Hybrid",0,"Wed","weekday"
"3317",2019-03-06,"Brush Creek Trailhead","4","4","3",14.5,0.1,62,-2,31,23.4,-2,2,6,9,-4,-2,4,13,"w1819","Non.motorized",1,"Wed","weekday"
"3318",2019-03-06,"Brush Creek Trailhead","4","4","3",14.5,0.1,62,-2,31,23.4,-2,2,6,9,-4,-2,4,13,"w1819","Mechanized",0,"Wed","weekday"
"3319",2019-03-06,"Brush Creek Trailhead","4","4","3",14.5,0.1,62,-2,31,23.4,-2,2,6,9,-4,-2,4,13,"w1819","Motorized",0,"Wed","weekday"
"3320",2019-03-06,"Brush Creek Trailhead","4","4","3",14.5,0.1,62,-2,31,23.4,-2,2,6,9,-4,-2,4,13,"w1819","Hybrid",0,"Wed","weekday"
"3321",2019-03-07,"Brush Creek Trailhead","4","4","3",16.2,1.7,71,9,30,22.8,-2,-2,2,6,7,5,7,13,"w1819","Non.motorized",1,"Thu","weekday"
"3322",2019-03-07,"Brush Creek Trailhead","4","4","3",16.2,1.7,71,9,30,22.8,-2,-2,2,6,7,5,7,13,"w1819","Mechanized",0,"Thu","weekday"
"3323",2019-03-07,"Brush Creek Trailhead","4","4","3",16.2,1.7,71,9,30,22.8,-2,-2,2,6,7,5,7,13,"w1819","Motorized",0,"Thu","weekday"
"3324",2019-03-07,"Brush Creek Trailhead","4","4","3",16.2,1.7,71,9,30,22.8,-2,-2,2,6,7,5,7,13,"w1819","Hybrid",0,"Thu","weekday"
"3325",2019-03-08,"Brush Creek Trailhead","3","3","3",16.6,0.4,71,0,27,23.4,9,-2,-2,2,9,7,5,7,"w1819","Non.motorized",1,"Fri","weekday"
"3326",2019-03-08,"Brush Creek Trailhead","3","3","3",16.6,0.4,71,0,27,23.4,9,-2,-2,2,9,7,5,7,"w1819","Mechanized",0,"Fri","weekday"
"3327",2019-03-08,"Brush Creek Trailhead","3","3","3",16.6,0.4,71,0,27,23.4,9,-2,-2,2,9,7,5,7,"w1819","Motorized",0,"Fri","weekday"
"3328",2019-03-08,"Brush Creek Trailhead","3","3","3",16.6,0.4,71,0,27,23.4,9,-2,-2,2,9,7,5,7,"w1819","Hybrid",0,"Fri","weekday"
"3329",2019-03-09,"Brush Creek Trailhead","4","4","3",17.2,0.6,76,5,22,22.6,0,9,-2,-2,5,14,12,10,"w1819","Non.motorized",0,"Sat","weekend"
"3330",2019-03-09,"Brush Creek Trailhead","4","4","3",17.2,0.6,76,5,22,22.6,0,9,-2,-2,5,14,12,10,"w1819","Mechanized",0,"Sat","weekend"
"3331",2019-03-09,"Brush Creek Trailhead","4","4","3",17.2,0.6,76,5,22,22.6,0,9,-2,-2,5,14,12,10,"w1819","Motorized",0,"Sat","weekend"
"3332",2019-03-09,"Brush Creek Trailhead","4","4","3",17.2,0.6,76,5,22,22.6,0,9,-2,-2,5,14,12,10,"w1819","Hybrid",0,"Sat","weekend"
"3333",2019-03-10,"Brush Creek Trailhead","3","3","3",17.3,0.1,73,-3,25,23.7,5,0,9,-2,2,2,11,9,"w1819","Non.motorized",10,"Sun","weekend"
"3334",2019-03-10,"Brush Creek Trailhead","3","3","3",17.3,0.1,73,-3,25,23.7,5,0,9,-2,2,2,11,9,"w1819","Mechanized",0,"Sun","weekend"
"3335",2019-03-10,"Brush Creek Trailhead","3","3","3",17.3,0.1,73,-3,25,23.7,5,0,9,-2,2,2,11,9,"w1819","Motorized",2,"Sun","weekend"
"3336",2019-03-10,"Brush Creek Trailhead","3","3","3",17.3,0.1,73,-3,25,23.7,5,0,9,-2,2,2,11,9,"w1819","Hybrid",0,"Sun","weekend"
"3337",2019-03-11,"Brush Creek Trailhead","3","3","2",17.3,0,71,-2,29,24.4,-3,5,0,9,-5,0,0,9,"w1819","Non.motorized",1,"Mon","weekday"
"3338",2019-03-11,"Brush Creek Trailhead","3","3","2",17.3,0,71,-2,29,24.4,-3,5,0,9,-5,0,0,9,"w1819","Mechanized",0,"Mon","weekday"
"3339",2019-03-11,"Brush Creek Trailhead","3","3","2",17.3,0,71,-2,29,24.4,-3,5,0,9,-5,0,0,9,"w1819","Motorized",0,"Mon","weekday"
"3340",2019-03-11,"Brush Creek Trailhead","3","3","2",17.3,0,71,-2,29,24.4,-3,5,0,9,-5,0,0,9,"w1819","Hybrid",0,"Mon","weekday"
"3341",2019-03-12,"Brush Creek Trailhead","3","3","3",17.4,0.1,70,-1,32,24.9,-2,-3,5,0,-3,-6,-1,-1,"w1819","Non.motorized",0,"Tue","weekday"
"3342",2019-03-12,"Brush Creek Trailhead","3","3","3",17.4,0.1,70,-1,32,24.9,-2,-3,5,0,-3,-6,-1,-1,"w1819","Mechanized",0,"Tue","weekday"
"3343",2019-03-12,"Brush Creek Trailhead","3","3","3",17.4,0.1,70,-1,32,24.9,-2,-3,5,0,-3,-6,-1,-1,"w1819","Motorized",0,"Tue","weekday"
"3344",2019-03-12,"Brush Creek Trailhead","3","3","3",17.4,0.1,70,-1,32,24.9,-2,-3,5,0,-3,-6,-1,-1,"w1819","Hybrid",0,"Tue","weekday"
"3345",2019-03-12,"Brush Creek Trailhead","4","4","4",17.4,0.1,70,-1,32,24.9,-2,-3,5,0,-3,-6,-1,-1,"w1819","Non.motorized",0,"Tue","weekday"
"3346",2019-03-12,"Brush Creek Trailhead","4","4","4",17.4,0.1,70,-1,32,24.9,-2,-3,5,0,-3,-6,-1,-1,"w1819","Mechanized",0,"Tue","weekday"
"3347",2019-03-12,"Brush Creek Trailhead","4","4","4",17.4,0.1,70,-1,32,24.9,-2,-3,5,0,-3,-6,-1,-1,"w1819","Motorized",0,"Tue","weekday"
"3348",2019-03-12,"Brush Creek Trailhead","4","4","4",17.4,0.1,70,-1,32,24.9,-2,-3,5,0,-3,-6,-1,-1,"w1819","Hybrid",0,"Tue","weekday"
"3349",2019-03-13,"Brush Creek Trailhead","4","4","3",18.1,0.7,74,4,24,24.5,-1,-2,-3,5,3,1,-2,3,"w1819","Non.motorized",1,"Wed","weekday"
"3350",2019-03-13,"Brush Creek Trailhead","4","4","3",18.1,0.7,74,4,24,24.5,-1,-2,-3,5,3,1,-2,3,"w1819","Mechanized",0,"Wed","weekday"
"3351",2019-03-13,"Brush Creek Trailhead","4","4","3",18.1,0.7,74,4,24,24.5,-1,-2,-3,5,3,1,-2,3,"w1819","Motorized",0,"Wed","weekday"
"3352",2019-03-13,"Brush Creek Trailhead","4","4","3",18.1,0.7,74,4,24,24.5,-1,-2,-3,5,3,1,-2,3,"w1819","Hybrid",0,"Wed","weekday"
"3353",2019-03-14,"Brush Creek Trailhead","4","4","3",18.1,0,74,0,17,24.5,4,-1,-2,-3,4,3,1,-2,"w1819","Non.motorized",0,"Thu","weekday"
"3354",2019-03-14,"Brush Creek Trailhead","4","4","3",18.1,0,74,0,17,24.5,4,-1,-2,-3,4,3,1,-2,"w1819","Mechanized",0,"Thu","weekday"
"3355",2019-03-14,"Brush Creek Trailhead","4","4","3",18.1,0,74,0,17,24.5,4,-1,-2,-3,4,3,1,-2,"w1819","Motorized",0,"Thu","weekday"
"3356",2019-03-14,"Brush Creek Trailhead","4","4","3",18.1,0,74,0,17,24.5,4,-1,-2,-3,4,3,1,-2,"w1819","Hybrid",0,"Thu","weekday"
"3357",2019-03-15,"Brush Creek Trailhead","3","3","2",18.1,0,72,-2,18,25.1,0,4,-1,-2,-2,2,1,-1,"w1819","Non.motorized",3,"Fri","weekday"
"3358",2019-03-15,"Brush Creek Trailhead","3","3","2",18.1,0,72,-2,18,25.1,0,4,-1,-2,-2,2,1,-1,"w1819","Mechanized",0,"Fri","weekday"
"3359",2019-03-15,"Brush Creek Trailhead","3","3","2",18.1,0,72,-2,18,25.1,0,4,-1,-2,-2,2,1,-1,"w1819","Motorized",0,"Fri","weekday"
"3360",2019-03-15,"Brush Creek Trailhead","3","3","2",18.1,0,72,-2,18,25.1,0,4,-1,-2,-2,2,1,-1,"w1819","Hybrid",0,"Fri","weekday"
"3361",2019-03-16,"Brush Creek Trailhead","3","3","2",18.2,0.1,70,-2,26,26,-2,0,4,-1,-4,-4,0,-1,"w1819","Non.motorized",8,"Sat","weekend"
"3362",2019-03-16,"Brush Creek Trailhead","3","3","2",18.2,0.1,70,-2,26,26,-2,0,4,-1,-4,-4,0,-1,"w1819","Mechanized",0,"Sat","weekend"
"3363",2019-03-16,"Brush Creek Trailhead","3","3","2",18.2,0.1,70,-2,26,26,-2,0,4,-1,-4,-4,0,-1,"w1819","Motorized",0,"Sat","weekend"
"3364",2019-03-16,"Brush Creek Trailhead","3","3","2",18.2,0.1,70,-2,26,26,-2,0,4,-1,-4,-4,0,-1,"w1819","Hybrid",0,"Sat","weekend"
"3365",2019-03-17,"Brush Creek Trailhead","3","3","2",18.2,0,69,-1,28,26.4,-2,-2,0,4,-3,-5,-5,-1,"w1819","Non.motorized",13,"Sun","weekend"
"3366",2019-03-17,"Brush Creek Trailhead","3","3","2",18.2,0,69,-1,28,26.4,-2,-2,0,4,-3,-5,-5,-1,"w1819","Mechanized",0,"Sun","weekend"
"3367",2019-03-17,"Brush Creek Trailhead","3","3","2",18.2,0,69,-1,28,26.4,-2,-2,0,4,-3,-5,-5,-1,"w1819","Motorized",0,"Sun","weekend"
"3368",2019-03-17,"Brush Creek Trailhead","3","3","2",18.2,0,69,-1,28,26.4,-2,-2,0,4,-3,-5,-5,-1,"w1819","Hybrid",0,"Sun","weekend"
"3369",2019-03-18,"Brush Creek Trailhead","2","2","2",18.3,0.1,68,-1,29,26.9,-1,-2,-2,0,-2,-4,-6,-6,"w1819","Non.motorized",4,"Mon","weekday"
"3370",2019-03-18,"Brush Creek Trailhead","2","2","2",18.3,0.1,68,-1,29,26.9,-1,-2,-2,0,-2,-4,-6,-6,"w1819","Mechanized",0,"Mon","weekday"
"3371",2019-03-18,"Brush Creek Trailhead","2","2","2",18.3,0.1,68,-1,29,26.9,-1,-2,-2,0,-2,-4,-6,-6,"w1819","Motorized",0,"Mon","weekday"
"3372",2019-03-18,"Brush Creek Trailhead","2","2","2",18.3,0.1,68,-1,29,26.9,-1,-2,-2,0,-2,-4,-6,-6,"w1819","Hybrid",0,"Mon","weekday"
"3373",2019-03-19,"Brush Creek Trailhead","2","2","2",18.3,0,67,-1,28,27.3,-1,-1,-2,-2,-2,-3,-5,-7,"w1819","Non.motorized",5,"Tue","weekday"
"3374",2019-03-19,"Brush Creek Trailhead","2","2","2",18.3,0,67,-1,28,27.3,-1,-1,-2,-2,-2,-3,-5,-7,"w1819","Mechanized",0,"Tue","weekday"
"3375",2019-03-19,"Brush Creek Trailhead","2","2","2",18.3,0,67,-1,28,27.3,-1,-1,-2,-2,-2,-3,-5,-7,"w1819","Motorized",0,"Tue","weekday"
"3376",2019-03-19,"Brush Creek Trailhead","2","2","2",18.3,0,67,-1,28,27.3,-1,-1,-2,-2,-2,-3,-5,-7,"w1819","Hybrid",0,"Tue","weekday"
"3377",2019-03-20,"Brush Creek Trailhead","2","2","2",18.3,0,66,-1,30,27.7,-1,-1,-1,-2,-2,-3,-4,-6,"w1819","Non.motorized",0,"Wed","weekday"
"3378",2019-03-20,"Brush Creek Trailhead","2","2","2",18.3,0,66,-1,30,27.7,-1,-1,-1,-2,-2,-3,-4,-6,"w1819","Mechanized",0,"Wed","weekday"
"3379",2019-03-20,"Brush Creek Trailhead","2","2","2",18.3,0,66,-1,30,27.7,-1,-1,-1,-2,-2,-3,-4,-6,"w1819","Motorized",0,"Wed","weekday"
"3380",2019-03-20,"Brush Creek Trailhead","2","2","2",18.3,0,66,-1,30,27.7,-1,-1,-1,-2,-2,-3,-4,-6,"w1819","Hybrid",0,"Wed","weekday"
"3381",2019-03-21,"Brush Creek Trailhead","2","2","2",18.4,0.1,65,-1,33,28.3,-1,-1,-1,-1,-2,-3,-4,-5,"w1819","Non.motorized",1,"Thu","weekday"
"3382",2019-03-21,"Brush Creek Trailhead","2","2","2",18.4,0.1,65,-1,33,28.3,-1,-1,-1,-1,-2,-3,-4,-5,"w1819","Mechanized",0,"Thu","weekday"
"3383",2019-03-21,"Brush Creek Trailhead","2","2","2",18.4,0.1,65,-1,33,28.3,-1,-1,-1,-1,-2,-3,-4,-5,"w1819","Motorized",0,"Thu","weekday"
"3384",2019-03-21,"Brush Creek Trailhead","2","2","2",18.4,0.1,65,-1,33,28.3,-1,-1,-1,-1,-2,-3,-4,-5,"w1819","Hybrid",0,"Thu","weekday"
"3385",2019-03-22,"Brush Creek Trailhead","3","3","2",18.4,0,64,-1,28,28.8,-1,-1,-1,-1,-2,-3,-4,-5,"w1819","Non.motorized",5,"Fri","weekday"
"3386",2019-03-22,"Brush Creek Trailhead","3","3","2",18.4,0,64,-1,28,28.8,-1,-1,-1,-1,-2,-3,-4,-5,"w1819","Mechanized",0,"Fri","weekday"
"3387",2019-03-22,"Brush Creek Trailhead","3","3","2",18.4,0,64,-1,28,28.8,-1,-1,-1,-1,-2,-3,-4,-5,"w1819","Motorized",1,"Fri","weekday"
"3388",2019-03-22,"Brush Creek Trailhead","3","3","2",18.4,0,64,-1,28,28.8,-1,-1,-1,-1,-2,-3,-4,-5,"w1819","Hybrid",0,"Fri","weekday"
"3389",2019-03-23,"Brush Creek Trailhead","2","2","1",18.4,0,65,1,28,28.3,-1,-1,-1,-1,0,-1,-2,-3,"w1819","Non.motorized",6,"Sat","weekend"
"3390",2019-03-23,"Brush Creek Trailhead","2","2","1",18.4,0,65,1,28,28.3,-1,-1,-1,-1,0,-1,-2,-3,"w1819","Mechanized",0,"Sat","weekend"
"3391",2019-03-23,"Brush Creek Trailhead","2","2","1",18.4,0,65,1,28,28.3,-1,-1,-1,-1,0,-1,-2,-3,"w1819","Motorized",0,"Sat","weekend"
"3392",2019-03-23,"Brush Creek Trailhead","2","2","1",18.4,0,65,1,28,28.3,-1,-1,-1,-1,0,-1,-2,-3,"w1819","Hybrid",0,"Sat","weekend"
"3393",2019-03-24,"Brush Creek Trailhead","2","2","1",18.4,0,64,-1,29,28.8,1,-1,-1,-1,0,-1,-2,-3,"w1819","Non.motorized",8,"Sun","weekend"
"3394",2019-03-24,"Brush Creek Trailhead","2","2","1",18.4,0,64,-1,29,28.8,1,-1,-1,-1,0,-1,-2,-3,"w1819","Mechanized",0,"Sun","weekend"
"3395",2019-03-24,"Brush Creek Trailhead","2","2","1",18.4,0,64,-1,29,28.8,1,-1,-1,-1,0,-1,-2,-3,"w1819","Motorized",0,"Sun","weekend"
"3396",2019-03-24,"Brush Creek Trailhead","2","2","1",18.4,0,64,-1,29,28.8,1,-1,-1,-1,0,-1,-2,-3,"w1819","Hybrid",0,"Sun","weekend"
"3397",2019-03-25,"Brush Creek Trailhead","2","2","2",18.6,0.2,64,0,31,29.1,-1,1,-1,-1,-1,0,-1,-2,"w1819","Non.motorized",3,"Mon","weekday"
"3398",2019-03-25,"Brush Creek Trailhead","2","2","2",18.6,0.2,64,0,31,29.1,-1,1,-1,-1,-1,0,-1,-2,"w1819","Mechanized",0,"Mon","weekday"
"3399",2019-03-25,"Brush Creek Trailhead","2","2","2",18.6,0.2,64,0,31,29.1,-1,1,-1,-1,-1,0,-1,-2,"w1819","Motorized",0,"Mon","weekday"
"3400",2019-03-25,"Brush Creek Trailhead","2","2","2",18.6,0.2,64,0,31,29.1,-1,1,-1,-1,-1,0,-1,-2,"w1819","Hybrid",0,"Mon","weekday"
"3401",2019-03-26,"Brush Creek Trailhead","2","2","2",18.9,0.3,63,-1,36,30,0,-1,1,-1,-1,-2,-1,-2,"w1819","Non.motorized",0,"Tue","weekday"
"3402",2019-03-26,"Brush Creek Trailhead","2","2","2",18.9,0.3,63,-1,36,30,0,-1,1,-1,-1,-2,-1,-2,"w1819","Mechanized",0,"Tue","weekday"
"3403",2019-03-26,"Brush Creek Trailhead","2","2","2",18.9,0.3,63,-1,36,30,0,-1,1,-1,-1,-2,-1,-2,"w1819","Motorized",0,"Tue","weekday"
"3404",2019-03-26,"Brush Creek Trailhead","2","2","2",18.9,0.3,63,-1,36,30,0,-1,1,-1,-1,-2,-1,-2,"w1819","Hybrid",0,"Tue","weekday"
"3405",2019-03-27,"Brush Creek Trailhead","1","2","2",18.9,0,62,-1,42,30.5,-1,0,-1,1,-2,-2,-3,-2,"w1819","Non.motorized",7,"Wed","weekday"
"3406",2019-03-27,"Brush Creek Trailhead","1","2","2",18.9,0,62,-1,42,30.5,-1,0,-1,1,-2,-2,-3,-2,"w1819","Mechanized",0,"Wed","weekday"
"3407",2019-03-27,"Brush Creek Trailhead","1","2","2",18.9,0,62,-1,42,30.5,-1,0,-1,1,-2,-2,-3,-2,"w1819","Motorized",0,"Wed","weekday"
"3408",2019-03-27,"Brush Creek Trailhead","1","2","2",18.9,0,62,-1,42,30.5,-1,0,-1,1,-2,-2,-3,-2,"w1819","Hybrid",0,"Wed","weekday"
"3409",2019-03-28,"Brush Creek Trailhead","1","2","2",18.9,0,60,-2,40,31.5,-1,-1,0,-1,-3,-4,-4,-5,"w1819","Non.motorized",2,"Thu","weekday"
"3410",2019-03-28,"Brush Creek Trailhead","1","2","2",18.9,0,60,-2,40,31.5,-1,-1,0,-1,-3,-4,-4,-5,"w1819","Mechanized",0,"Thu","weekday"
"3411",2019-03-28,"Brush Creek Trailhead","1","2","2",18.9,0,60,-2,40,31.5,-1,-1,0,-1,-3,-4,-4,-5,"w1819","Motorized",0,"Thu","weekday"
"3412",2019-03-28,"Brush Creek Trailhead","1","2","2",18.9,0,60,-2,40,31.5,-1,-1,0,-1,-3,-4,-4,-5,"w1819","Hybrid",0,"Thu","weekday"
"3413",2019-03-29,"Brush Creek Trailhead","1","1","1",19,0.1,58,-2,26,32.8,-2,-1,-1,0,-4,-5,-6,-6,"w1819","Non.motorized",4,"Fri","weekday"
"3414",2019-03-29,"Brush Creek Trailhead","1","1","1",19,0.1,58,-2,26,32.8,-2,-1,-1,0,-4,-5,-6,-6,"w1819","Mechanized",0,"Fri","weekday"
"3415",2019-03-29,"Brush Creek Trailhead","1","1","1",19,0.1,58,-2,26,32.8,-2,-1,-1,0,-4,-5,-6,-6,"w1819","Motorized",0,"Fri","weekday"
"3416",2019-03-29,"Brush Creek Trailhead","1","1","1",19,0.1,58,-2,26,32.8,-2,-1,-1,0,-4,-5,-6,-6,"w1819","Hybrid",0,"Fri","weekday"
"3417",2019-03-30,"Brush Creek Trailhead","1","1","1",19.1,0.1,61,3,24,31.3,-2,-2,-1,-1,1,-1,-2,-3,"w1819","Non.motorized",12,"Sat","weekend"
"3418",2019-03-30,"Brush Creek Trailhead","1","1","1",19.1,0.1,61,3,24,31.3,-2,-2,-1,-1,1,-1,-2,-3,"w1819","Mechanized",0,"Sat","weekend"
"3419",2019-03-30,"Brush Creek Trailhead","1","1","1",19.1,0.1,61,3,24,31.3,-2,-2,-1,-1,1,-1,-2,-3,"w1819","Motorized",0,"Sat","weekend"
"3420",2019-03-30,"Brush Creek Trailhead","1","1","1",19.1,0.1,61,3,24,31.3,-2,-2,-1,-1,1,-1,-2,-3,"w1819","Hybrid",0,"Sat","weekend"
"3421",2019-03-31,"Brush Creek Trailhead","1","1","1",19.1,0,59,-2,24,32.4,3,-2,-2,-1,1,-1,-3,-4,"w1819","Non.motorized",4,"Sun","weekend"
"3422",2019-03-31,"Brush Creek Trailhead","1","1","1",19.1,0,59,-2,24,32.4,3,-2,-2,-1,1,-1,-3,-4,"w1819","Mechanized",0,"Sun","weekend"
"3423",2019-03-31,"Brush Creek Trailhead","1","1","1",19.1,0,59,-2,24,32.4,3,-2,-2,-1,1,-1,-3,-4,"w1819","Motorized",0,"Sun","weekend"
"3424",2019-03-31,"Brush Creek Trailhead","1","1","1",19.1,0,59,-2,24,32.4,3,-2,-2,-1,1,-1,-3,-4,"w1819","Hybrid",0,"Sun","weekend"
"3425",2019-04-01,"Brush Creek Trailhead","2","1","1",19.1,0,58,-1,29,32.9,-2,3,-2,-2,-3,0,-2,-4,"w1819","Non.motorized",6,"Mon","weekday"
"3426",2019-04-01,"Brush Creek Trailhead","2","1","1",19.1,0,58,-1,29,32.9,-2,3,-2,-2,-3,0,-2,-4,"w1819","Mechanized",0,"Mon","weekday"
"3427",2019-04-01,"Brush Creek Trailhead","2","1","1",19.1,0,58,-1,29,32.9,-2,3,-2,-2,-3,0,-2,-4,"w1819","Motorized",2,"Mon","weekday"
"3428",2019-04-01,"Brush Creek Trailhead","2","1","1",19.1,0,58,-1,29,32.9,-2,3,-2,-2,-3,0,-2,-4,"w1819","Hybrid",2,"Mon","weekday"
"3429",2019-04-02,"Brush Creek Trailhead","1","1","1",19.1,0,58,0,33,32.9,-1,-2,3,-2,-1,-3,0,-2,"w1819","Non.motorized",4,"Tue","weekday"
"3430",2019-04-02,"Brush Creek Trailhead","1","1","1",19.1,0,58,0,33,32.9,-1,-2,3,-2,-1,-3,0,-2,"w1819","Mechanized",0,"Tue","weekday"
"3431",2019-04-02,"Brush Creek Trailhead","1","1","1",19.1,0,58,0,33,32.9,-1,-2,3,-2,-1,-3,0,-2,"w1819","Motorized",0,"Tue","weekday"
"3432",2019-04-02,"Brush Creek Trailhead","1","1","1",19.1,0,58,0,33,32.9,-1,-2,3,-2,-1,-3,0,-2,"w1819","Hybrid",0,"Tue","weekday"
"3433",2019-04-03,"Brush Creek Trailhead","2","1","1",19.2,0.1,58,0,31,33.1,0,-1,-2,3,0,-1,-3,0,"w1819","Non.motorized",5,"Wed","weekday"
"3434",2019-04-03,"Brush Creek Trailhead","2","1","1",19.2,0.1,58,0,31,33.1,0,-1,-2,3,0,-1,-3,0,"w1819","Mechanized",0,"Wed","weekday"
"3435",2019-04-03,"Brush Creek Trailhead","2","1","1",19.2,0.1,58,0,31,33.1,0,-1,-2,3,0,-1,-3,0,"w1819","Motorized",0,"Wed","weekday"
"3436",2019-04-03,"Brush Creek Trailhead","2","1","1",19.2,0.1,58,0,31,33.1,0,-1,-2,3,0,-1,-3,0,"w1819","Hybrid",0,"Wed","weekday"
"3437",2019-04-04,"Brush Creek Trailhead","2","1","1",19.4,0.2,59,1,35,32.9,0,0,-1,-2,1,1,0,-2,"w1819","Non.motorized",5,"Thu","weekday"
"3438",2019-04-04,"Brush Creek Trailhead","2","1","1",19.4,0.2,59,1,35,32.9,0,0,-1,-2,1,1,0,-2,"w1819","Mechanized",0,"Thu","weekday"
"3439",2019-04-04,"Brush Creek Trailhead","2","1","1",19.4,0.2,59,1,35,32.9,0,0,-1,-2,1,1,0,-2,"w1819","Motorized",0,"Thu","weekday"
"3440",2019-04-04,"Brush Creek Trailhead","2","1","1",19.4,0.2,59,1,35,32.9,0,0,-1,-2,1,1,0,-2,"w1819","Hybrid",0,"Thu","weekday"
"3441",2019-04-05,"Brush Creek Trailhead","1","1","1",19.4,0,57,-2,38,34,1,0,0,-1,-1,-1,-1,-2,"w1819","Non.motorized",6,"Fri","weekday"
"3442",2019-04-05,"Brush Creek Trailhead","1","1","1",19.4,0,57,-2,38,34,1,0,0,-1,-1,-1,-1,-2,"w1819","Mechanized",0,"Fri","weekday"
"3443",2019-04-05,"Brush Creek Trailhead","1","1","1",19.4,0,57,-2,38,34,1,0,0,-1,-1,-1,-1,-2,"w1819","Motorized",0,"Fri","weekday"
"3444",2019-04-05,"Brush Creek Trailhead","1","1","1",19.4,0,57,-2,38,34,1,0,0,-1,-1,-1,-1,-2,"w1819","Hybrid",0,"Fri","weekday"
"3445",2019-04-06,"Brush Creek Trailhead","1","1","1",19.3,-0.1,57,0,35,33.9,-2,1,0,0,-2,-1,-1,-1,"w1819","Non.motorized",6,"Sat","weekend"
"3446",2019-04-06,"Brush Creek Trailhead","1","1","1",19.3,-0.1,57,0,35,33.9,-2,1,0,0,-2,-1,-1,-1,"w1819","Mechanized",0,"Sat","weekend"
"3447",2019-04-06,"Brush Creek Trailhead","1","1","1",19.3,-0.1,57,0,35,33.9,-2,1,0,0,-2,-1,-1,-1,"w1819","Motorized",1,"Sat","weekend"
"3448",2019-04-06,"Brush Creek Trailhead","1","1","1",19.3,-0.1,57,0,35,33.9,-2,1,0,0,-2,-1,-1,-1,"w1819","Hybrid",1,"Sat","weekend"
"3449",2019-04-07,"Brush Creek Trailhead","1","1","1",19.1,-0.2,57,0,37,33.5,0,-2,1,0,0,-2,-1,-1,"w1819","Non.motorized",14,"Sun","weekend"
"3450",2019-04-07,"Brush Creek Trailhead","1","1","1",19.1,-0.2,57,0,37,33.5,0,-2,1,0,0,-2,-1,-1,"w1819","Mechanized",0,"Sun","weekend"
"3451",2019-04-07,"Brush Creek Trailhead","1","1","1",19.1,-0.2,57,0,37,33.5,0,-2,1,0,0,-2,-1,-1,"w1819","Motorized",1,"Sun","weekend"
"3452",2019-04-07,"Brush Creek Trailhead","1","1","1",19.1,-0.2,57,0,37,33.5,0,-2,1,0,0,-2,-1,-1,"w1819","Hybrid",1,"Sun","weekend"
"3453",2019-04-08,"Brush Creek Trailhead","1","2","2",19.3,0.2,54,-3,41,35.7,0,0,-2,1,-3,-3,-5,-4,"w1819","Non.motorized",7,"Mon","weekday"
"3454",2019-04-08,"Brush Creek Trailhead","1","2","2",19.3,0.2,54,-3,41,35.7,0,0,-2,1,-3,-3,-5,-4,"w1819","Mechanized",0,"Mon","weekday"
"3455",2019-04-08,"Brush Creek Trailhead","1","2","2",19.3,0.2,54,-3,41,35.7,0,0,-2,1,-3,-3,-5,-4,"w1819","Motorized",3,"Mon","weekday"
"3456",2019-04-08,"Brush Creek Trailhead","1","2","2",19.3,0.2,54,-3,41,35.7,0,0,-2,1,-3,-3,-5,-4,"w1819","Hybrid",2,"Mon","weekday"
"3457",2019-04-09,"Brush Creek Trailhead","1","2","2",19.3,0,53,-1,43,36.4,-3,0,0,-2,-4,-4,-4,-6,"w1819","Non.motorized",2,"Tue","weekday"
"3458",2019-04-09,"Brush Creek Trailhead","1","2","2",19.3,0,53,-1,43,36.4,-3,0,0,-2,-4,-4,-4,-6,"w1819","Mechanized",0,"Tue","weekday"
"3459",2019-04-09,"Brush Creek Trailhead","1","2","2",19.3,0,53,-1,43,36.4,-3,0,0,-2,-4,-4,-4,-6,"w1819","Motorized",0,"Tue","weekday"
"3460",2019-04-09,"Brush Creek Trailhead","1","2","2",19.3,0,53,-1,43,36.4,-3,0,0,-2,-4,-4,-4,-6,"w1819","Hybrid",0,"Tue","weekday"
"3461",2019-04-10,"Brush Creek Trailhead","2","2","1",19,-0.3,51,-2,30,37.3,-1,-3,0,0,-3,-6,-6,-6,"w1819","Non.motorized",0,"Wed","weekday"
"3462",2019-04-10,"Brush Creek Trailhead","2","2","1",19,-0.3,51,-2,30,37.3,-1,-3,0,0,-3,-6,-6,-6,"w1819","Mechanized",0,"Wed","weekday"
"3463",2019-04-10,"Brush Creek Trailhead","2","2","1",19,-0.3,51,-2,30,37.3,-1,-3,0,0,-3,-6,-6,-6,"w1819","Motorized",0,"Wed","weekday"
"3464",2019-04-10,"Brush Creek Trailhead","2","2","1",19,-0.3,51,-2,30,37.3,-1,-3,0,0,-3,-6,-6,-6,"w1819","Hybrid",0,"Wed","weekday"
"3465",2019-04-11,"Brush Creek Trailhead","3","3","2",18.9,-0.1,53,2,20,35.7,-2,-1,-3,0,0,-1,-4,-4,"w1819","Non.motorized",1,"Thu","weekday"
"3466",2019-04-11,"Brush Creek Trailhead","3","3","2",18.9,-0.1,53,2,20,35.7,-2,-1,-3,0,0,-1,-4,-4,"w1819","Mechanized",0,"Thu","weekday"
"3467",2019-04-11,"Brush Creek Trailhead","3","3","2",18.9,-0.1,53,2,20,35.7,-2,-1,-3,0,0,-1,-4,-4,"w1819","Motorized",0,"Thu","weekday"
"3468",2019-04-11,"Brush Creek Trailhead","3","3","2",18.9,-0.1,53,2,20,35.7,-2,-1,-3,0,0,-1,-4,-4,"w1819","Hybrid",0,"Thu","weekday"
"3469",2019-04-12,"Brush Creek Trailhead","2","2","1",18.7,-0.2,53,0,24,35.3,2,-2,-1,-3,2,0,-1,-4,"w1819","Non.motorized",6,"Fri","weekday"
"3470",2019-04-12,"Brush Creek Trailhead","2","2","1",18.7,-0.2,53,0,24,35.3,2,-2,-1,-3,2,0,-1,-4,"w1819","Mechanized",0,"Fri","weekday"
"3471",2019-04-12,"Brush Creek Trailhead","2","2","1",18.7,-0.2,53,0,24,35.3,2,-2,-1,-3,2,0,-1,-4,"w1819","Motorized",0,"Fri","weekday"
"3472",2019-04-12,"Brush Creek Trailhead","2","2","1",18.7,-0.2,53,0,24,35.3,2,-2,-1,-3,2,0,-1,-4,"w1819","Hybrid",0,"Fri","weekday"
"3473",2019-04-13,"Brush Creek Trailhead","1","1","1",18.8,0.1,52,-1,27,36.2,0,2,-2,-1,-1,1,-1,-2,"w1819","Non.motorized",9,"Sat","weekend"
"3474",2019-04-13,"Brush Creek Trailhead","1","1","1",18.8,0.1,52,-1,27,36.2,0,2,-2,-1,-1,1,-1,-2,"w1819","Mechanized",0,"Sat","weekend"
"3475",2019-04-13,"Brush Creek Trailhead","1","1","1",18.8,0.1,52,-1,27,36.2,0,2,-2,-1,-1,1,-1,-2,"w1819","Motorized",0,"Sat","weekend"
"3476",2019-04-13,"Brush Creek Trailhead","1","1","1",18.8,0.1,52,-1,27,36.2,0,2,-2,-1,-1,1,-1,-2,"w1819","Hybrid",0,"Sat","weekend"
"3477",2019-04-14,"Brush Creek Trailhead","1","1","1",18.7,-0.1,51,-1,35,36.7,-1,0,2,-2,-2,-2,0,-2,"w1819","Non.motorized",3,"Sun","weekend"
"3478",2019-04-14,"Brush Creek Trailhead","1","1","1",18.7,-0.1,51,-1,35,36.7,-1,0,2,-2,-2,-2,0,-2,"w1819","Mechanized",1,"Sun","weekend"
"3479",2019-04-14,"Brush Creek Trailhead","1","1","1",18.7,-0.1,51,-1,35,36.7,-1,0,2,-2,-2,-2,0,-2,"w1819","Motorized",0,"Sun","weekend"
"3480",2019-04-14,"Brush Creek Trailhead","1","1","1",18.7,-0.1,51,-1,35,36.7,-1,0,2,-2,-2,-2,0,-2,"w1819","Hybrid",0,"Sun","weekend"
"3481",2019-04-15,"Brush Creek Trailhead",NA,NA,NA,18.6,-0.1,50,-1,41,37.2,-1,-1,0,2,-2,-3,-3,-1,"w1819","Non.motorized",6,"Mon","weekday"
"3482",2019-04-15,"Brush Creek Trailhead",NA,NA,NA,18.6,-0.1,50,-1,41,37.2,-1,-1,0,2,-2,-3,-3,-1,"w1819","Mechanized",0,"Mon","weekday"
"3483",2019-04-15,"Brush Creek Trailhead",NA,NA,NA,18.6,-0.1,50,-1,41,37.2,-1,-1,0,2,-2,-3,-3,-1,"w1819","Motorized",0,"Mon","weekday"
"3484",2019-04-15,"Brush Creek Trailhead",NA,NA,NA,18.6,-0.1,50,-1,41,37.2,-1,-1,0,2,-2,-3,-3,-1,"w1819","Hybrid",0,"Mon","weekday"
"3485",2018-12-01,"Cement Creek","3","3","2",3.3,0.2,19,1,16,17.4,0,0,0,0,1,1,1,1,"w1819","Non.motorized",0,"Sat","weekend"
"3486",2018-12-01,"Cement Creek","3","3","2",3.3,0.2,19,1,16,17.4,0,0,0,0,1,1,1,1,"w1819","Mechanized",0,"Sat","weekend"
"3487",2018-12-01,"Cement Creek","3","3","2",3.3,0.2,19,1,16,17.4,0,0,0,0,1,1,1,1,"w1819","Motorized",0,"Sat","weekend"
"3488",2018-12-01,"Cement Creek","3","3","2",3.3,0.2,19,1,16,17.4,0,0,0,0,1,1,1,1,"w1819","Hybrid",0,"Sat","weekend"
"3489",2018-12-02,"Cement Creek","3","3","3",3.3,0,20,1,14,16.5,1,0,0,0,2,2,2,2,"w1819","Non.motorized",0,"Sun","weekend"
"3490",2018-12-02,"Cement Creek","3","3","3",3.3,0,20,1,14,16.5,1,0,0,0,2,2,2,2,"w1819","Mechanized",0,"Sun","weekend"
"3491",2018-12-02,"Cement Creek","3","3","3",3.3,0,20,1,14,16.5,1,0,0,0,2,2,2,2,"w1819","Motorized",0,"Sun","weekend"
"3492",2018-12-02,"Cement Creek","3","3","3",3.3,0,20,1,14,16.5,1,0,0,0,2,2,2,2,"w1819","Hybrid",0,"Sun","weekend"
"3493",2018-12-03,"Cement Creek","3","3","2",3.4,0.1,19,-1,13,17.9,1,1,0,0,0,1,1,1,"w1819","Non.motorized",0,"Mon","weekday"
"3494",2018-12-03,"Cement Creek","3","3","2",3.4,0.1,19,-1,13,17.9,1,1,0,0,0,1,1,1,"w1819","Mechanized",0,"Mon","weekday"
"3495",2018-12-03,"Cement Creek","3","3","2",3.4,0.1,19,-1,13,17.9,1,1,0,0,0,1,1,1,"w1819","Motorized",0,"Mon","weekday"
"3496",2018-12-03,"Cement Creek","3","3","2",3.4,0.1,19,-1,13,17.9,1,1,0,0,0,1,1,1,"w1819","Hybrid",0,"Mon","weekday"
"3497",2018-12-04,"Cement Creek","3","3","2",3.5,0.1,20,1,8,17.5,-1,1,1,0,0,1,2,2,"w1819","Non.motorized",0,"Tue","weekday"
"3498",2018-12-04,"Cement Creek","3","3","2",3.5,0.1,20,1,8,17.5,-1,1,1,0,0,1,2,2,"w1819","Mechanized",0,"Tue","weekday"
"3499",2018-12-04,"Cement Creek","3","3","2",3.5,0.1,20,1,8,17.5,-1,1,1,0,0,1,2,2,"w1819","Motorized",0,"Tue","weekday"
"3500",2018-12-04,"Cement Creek","3","3","2",3.5,0.1,20,1,8,17.5,-1,1,1,0,0,1,2,2,"w1819","Hybrid",0,"Tue","weekday"
"3501",2018-12-05,"Cement Creek","3","3","2",3.5,0,19,-1,21,18.4,1,-1,1,1,0,-1,0,1,"w1819","Non.motorized",17,"Wed","weekday"
"3502",2018-12-05,"Cement Creek","3","3","2",3.5,0,19,-1,21,18.4,1,-1,1,1,0,-1,0,1,"w1819","Mechanized",0,"Wed","weekday"
"3503",2018-12-05,"Cement Creek","3","3","2",3.5,0,19,-1,21,18.4,1,-1,1,1,0,-1,0,1,"w1819","Motorized",1,"Wed","weekday"
"3504",2018-12-05,"Cement Creek","3","3","2",3.5,0,19,-1,21,18.4,1,-1,1,1,0,-1,0,1,"w1819","Hybrid",0,"Wed","weekday"
"3505",2018-12-06,"Cement Creek","2","2","2",3.7,0.2,18,-1,25,20.6,-1,1,-1,1,-2,-1,-2,-1,"w1819","Non.motorized",3,"Thu","weekday"
"3506",2018-12-06,"Cement Creek","2","2","2",3.7,0.2,18,-1,25,20.6,-1,1,-1,1,-2,-1,-2,-1,"w1819","Mechanized",0,"Thu","weekday"
"3507",2018-12-06,"Cement Creek","2","2","2",3.7,0.2,18,-1,25,20.6,-1,1,-1,1,-2,-1,-2,-1,"w1819","Motorized",4,"Thu","weekday"
"3508",2018-12-06,"Cement Creek","2","2","2",3.7,0.2,18,-1,25,20.6,-1,1,-1,1,-2,-1,-2,-1,"w1819","Hybrid",0,"Thu","weekday"
"3509",2018-12-07,"Cement Creek","2","2","2",3.8,0.1,21,3,23,18.1,-1,-1,1,-1,2,1,2,1,"w1819","Non.motorized",6,"Fri","weekday"
"3510",2018-12-07,"Cement Creek","2","2","2",3.8,0.1,21,3,23,18.1,-1,-1,1,-1,2,1,2,1,"w1819","Mechanized",4,"Fri","weekday"
"3511",2018-12-07,"Cement Creek","2","2","2",3.8,0.1,21,3,23,18.1,-1,-1,1,-1,2,1,2,1,"w1819","Motorized",5,"Fri","weekday"
"3512",2018-12-07,"Cement Creek","2","2","2",3.8,0.1,21,3,23,18.1,-1,-1,1,-1,2,1,2,1,"w1819","Hybrid",0,"Fri","weekday"
"3513",2018-12-08,"Cement Creek","2","2","2",3.8,0,20,-1,23,19,3,-1,-1,1,2,1,0,1,"w1819","Non.motorized",20,"Sat","weekend"
"3514",2018-12-08,"Cement Creek","2","2","2",3.8,0,20,-1,23,19,3,-1,-1,1,2,1,0,1,"w1819","Mechanized",3,"Sat","weekend"
"3515",2018-12-08,"Cement Creek","2","2","2",3.8,0,20,-1,23,19,3,-1,-1,1,2,1,0,1,"w1819","Motorized",15,"Sat","weekend"
"3516",2018-12-08,"Cement Creek","2","2","2",3.8,0,20,-1,23,19,3,-1,-1,1,2,1,0,1,"w1819","Hybrid",0,"Sat","weekend"
"3517",2018-12-09,"Cement Creek","2","2","2",3.8,0,20,0,19,19,-1,3,-1,-1,-1,2,1,0,"w1819","Non.motorized",32,"Sun","weekend"
"3518",2018-12-09,"Cement Creek","2","2","2",3.8,0,20,0,19,19,-1,3,-1,-1,-1,2,1,0,"w1819","Mechanized",3,"Sun","weekend"
"3519",2018-12-09,"Cement Creek","2","2","2",3.8,0,20,0,19,19,-1,3,-1,-1,-1,2,1,0,"w1819","Motorized",10,"Sun","weekend"
"3520",2018-12-09,"Cement Creek","2","2","2",3.8,0,20,0,19,19,-1,3,-1,-1,-1,2,1,0,"w1819","Hybrid",2,"Sun","weekend"
"3521",2018-12-10,"Cement Creek","2","2","2",3.8,0,20,0,21,19,0,-1,3,-1,0,-1,2,1,"w1819","Non.motorized",10,"Mon","weekday"
"3522",2018-12-10,"Cement Creek","2","2","2",3.8,0,20,0,21,19,0,-1,3,-1,0,-1,2,1,"w1819","Mechanized",0,"Mon","weekday"
"3523",2018-12-10,"Cement Creek","2","2","2",3.8,0,20,0,21,19,0,-1,3,-1,0,-1,2,1,"w1819","Motorized",7,"Mon","weekday"
"3524",2018-12-10,"Cement Creek","2","2","2",3.8,0,20,0,21,19,0,-1,3,-1,0,-1,2,1,"w1819","Hybrid",0,"Mon","weekday"
"3525",2018-12-11,"Cement Creek","2","2","2",3.9,0.1,19,-1,27,20.5,0,0,-1,3,-1,-1,-2,1,"w1819","Non.motorized",10,"Tue","weekday"
"3526",2018-12-11,"Cement Creek","2","2","2",3.9,0.1,19,-1,27,20.5,0,0,-1,3,-1,-1,-2,1,"w1819","Mechanized",0,"Tue","weekday"
"3527",2018-12-11,"Cement Creek","2","2","2",3.9,0.1,19,-1,27,20.5,0,0,-1,3,-1,-1,-2,1,"w1819","Motorized",2,"Tue","weekday"
"3528",2018-12-11,"Cement Creek","2","2","2",3.9,0.1,19,-1,27,20.5,0,0,-1,3,-1,-1,-2,1,"w1819","Hybrid",0,"Tue","weekday"
"3529",2018-12-12,"Cement Creek","2","2","1",3.9,0,19,0,21,20.5,-1,0,0,-1,-1,-1,-1,-2,"w1819","Non.motorized",20,"Wed","weekday"
"3530",2018-12-12,"Cement Creek","2","2","1",3.9,0,19,0,21,20.5,-1,0,0,-1,-1,-1,-1,-2,"w1819","Mechanized",1,"Wed","weekday"
"3531",2018-12-12,"Cement Creek","2","2","1",3.9,0,19,0,21,20.5,-1,0,0,-1,-1,-1,-1,-2,"w1819","Motorized",2,"Wed","weekday"
"3532",2018-12-12,"Cement Creek","2","2","1",3.9,0,19,0,21,20.5,-1,0,0,-1,-1,-1,-1,-2,"w1819","Hybrid",0,"Wed","weekday"
"3533",2018-12-13,"Cement Creek","3","3","2",4,0.1,21,2,15,19,0,-1,0,0,2,1,1,1,"w1819","Non.motorized",7,"Thu","weekday"
"3534",2018-12-13,"Cement Creek","3","3","2",4,0.1,21,2,15,19,0,-1,0,0,2,1,1,1,"w1819","Mechanized",0,"Thu","weekday"
"3535",2018-12-13,"Cement Creek","3","3","2",4,0.1,21,2,15,19,0,-1,0,0,2,1,1,1,"w1819","Motorized",5,"Thu","weekday"
"3536",2018-12-13,"Cement Creek","3","3","2",4,0.1,21,2,15,19,0,-1,0,0,2,1,1,1,"w1819","Hybrid",0,"Thu","weekday"
"3537",2018-12-14,"Cement Creek","3","3","2",4,0,20,-1,24,20,2,0,-1,0,1,1,0,0,"w1819","Non.motorized",3,"Fri","weekday"
"3538",2018-12-14,"Cement Creek","3","3","2",4,0,20,-1,24,20,2,0,-1,0,1,1,0,0,"w1819","Mechanized",0,"Fri","weekday"
"3539",2018-12-14,"Cement Creek","3","3","2",4,0,20,-1,24,20,2,0,-1,0,1,1,0,0,"w1819","Motorized",3,"Fri","weekday"
"3540",2018-12-14,"Cement Creek","3","3","2",4,0,20,-1,24,20,2,0,-1,0,1,1,0,0,"w1819","Hybrid",0,"Fri","weekday"
"3541",2018-12-15,"Cement Creek","2","2","2",4,0,20,0,29,20,-1,2,0,-1,-1,1,1,0,"w1819","Non.motorized",45,"Sat","weekend"
"3542",2018-12-15,"Cement Creek","2","2","2",4,0,20,0,29,20,-1,2,0,-1,-1,1,1,0,"w1819","Mechanized",1,"Sat","weekend"
"3543",2018-12-15,"Cement Creek","2","2","2",4,0,20,0,29,20,-1,2,0,-1,-1,1,1,0,"w1819","Motorized",6,"Sat","weekend"
"3544",2018-12-15,"Cement Creek","2","2","2",4,0,20,0,29,20,-1,2,0,-1,-1,1,1,0,"w1819","Hybrid",0,"Sat","weekend"
"3545",2018-12-16,"Cement Creek","2","2","2",4.1,0.1,19,-1,28,21.6,0,-1,2,0,-1,-2,0,0,"w1819","Non.motorized",12,"Sun","weekend"
"3546",2018-12-16,"Cement Creek","2","2","2",4.1,0.1,19,-1,28,21.6,0,-1,2,0,-1,-2,0,0,"w1819","Mechanized",1,"Sun","weekend"
"3547",2018-12-16,"Cement Creek","2","2","2",4.1,0.1,19,-1,28,21.6,0,-1,2,0,-1,-2,0,0,"w1819","Motorized",9,"Sun","weekend"
"3548",2018-12-16,"Cement Creek","2","2","2",4.1,0.1,19,-1,28,21.6,0,-1,2,0,-1,-2,0,0,"w1819","Hybrid",0,"Sun","weekend"
"3549",2018-12-17,"Cement Creek","2","2","2",4.1,0,19,0,29,21.6,-1,0,-1,2,-1,-1,-2,0,"w1819","Non.motorized",4,"Mon","weekday"
"3550",2018-12-17,"Cement Creek","2","2","2",4.1,0,19,0,29,21.6,-1,0,-1,2,-1,-1,-2,0,"w1819","Mechanized",3,"Mon","weekday"
"3551",2018-12-17,"Cement Creek","2","2","2",4.1,0,19,0,29,21.6,-1,0,-1,2,-1,-1,-2,0,"w1819","Motorized",9,"Mon","weekday"
"3552",2018-12-17,"Cement Creek","2","2","2",4.1,0,19,0,29,21.6,-1,0,-1,2,-1,-1,-2,0,"w1819","Hybrid",0,"Mon","weekday"
"3553",2018-12-18,"Cement Creek","2","2","2",4.1,0,19,0,27,21.6,0,-1,0,-1,0,-1,-1,-2,"w1819","Non.motorized",10,"Tue","weekday"
"3554",2018-12-18,"Cement Creek","2","2","2",4.1,0,19,0,27,21.6,0,-1,0,-1,0,-1,-1,-2,"w1819","Mechanized",1,"Tue","weekday"
"3555",2018-12-18,"Cement Creek","2","2","2",4.1,0,19,0,27,21.6,0,-1,0,-1,0,-1,-1,-2,"w1819","Motorized",5,"Tue","weekday"
"3556",2018-12-18,"Cement Creek","2","2","2",4.1,0,19,0,27,21.6,0,-1,0,-1,0,-1,-1,-2,"w1819","Hybrid",0,"Tue","weekday"
"3557",2018-12-19,"Cement Creek","2","2","2",4.1,0,19,0,24,21.6,0,0,-1,0,0,0,-1,-1,"w1819","Non.motorized",9,"Wed","weekday"
"3558",2018-12-19,"Cement Creek","2","2","2",4.1,0,19,0,24,21.6,0,0,-1,0,0,0,-1,-1,"w1819","Mechanized",0,"Wed","weekday"
"3559",2018-12-19,"Cement Creek","2","2","2",4.1,0,19,0,24,21.6,0,0,-1,0,0,0,-1,-1,"w1819","Motorized",1,"Wed","weekday"
"3560",2018-12-19,"Cement Creek","2","2","2",4.1,0,19,0,24,21.6,0,0,-1,0,0,0,-1,-1,"w1819","Hybrid",0,"Wed","weekday"
"3561",2018-12-20,"Cement Creek","2","2","1",4.1,0,20,1,25,20.5,0,0,0,-1,1,1,1,0,"w1819","Non.motorized",14,"Thu","weekday"
"3562",2018-12-20,"Cement Creek","2","2","1",4.1,0,20,1,25,20.5,0,0,0,-1,1,1,1,0,"w1819","Mechanized",2,"Thu","weekday"
"3563",2018-12-20,"Cement Creek","2","2","1",4.1,0,20,1,25,20.5,0,0,0,-1,1,1,1,0,"w1819","Motorized",10,"Thu","weekday"
"3564",2018-12-20,"Cement Creek","2","2","1",4.1,0,20,1,25,20.5,0,0,0,-1,1,1,1,0,"w1819","Hybrid",0,"Thu","weekday"
"3565",2018-12-21,"Cement Creek","2","2","1",4.1,0,19,-1,28,21.6,1,0,0,0,0,0,0,0,"w1819","Non.motorized",14,"Fri","weekday"
"3566",2018-12-21,"Cement Creek","2","2","1",4.1,0,19,-1,28,21.6,1,0,0,0,0,0,0,0,"w1819","Mechanized",1,"Fri","weekday"
"3567",2018-12-21,"Cement Creek","2","2","1",4.1,0,19,-1,28,21.6,1,0,0,0,0,0,0,0,"w1819","Motorized",8,"Fri","weekday"
"3568",2018-12-21,"Cement Creek","2","2","1",4.1,0,19,-1,28,21.6,1,0,0,0,0,0,0,0,"w1819","Hybrid",0,"Fri","weekday"
"3569",2018-12-22,"Cement Creek","2","2","1",4.2,0.1,19,0,20,22.1,-1,1,0,0,-1,0,0,0,"w1819","Non.motorized",10,"Sat","weekend"
"3570",2018-12-22,"Cement Creek","2","2","1",4.2,0.1,19,0,20,22.1,-1,1,0,0,-1,0,0,0,"w1819","Mechanized",1,"Sat","weekend"
"3571",2018-12-22,"Cement Creek","2","2","1",4.2,0.1,19,0,20,22.1,-1,1,0,0,-1,0,0,0,"w1819","Motorized",7,"Sat","weekend"
"3572",2018-12-22,"Cement Creek","2","2","1",4.2,0.1,19,0,20,22.1,-1,1,0,0,-1,0,0,0,"w1819","Hybrid",0,"Sat","weekend"
"3573",2018-12-23,"Cement Creek","2","2","1",4.2,0,21,2,19,20,0,-1,1,0,2,1,2,2,"w1819","Non.motorized",67,"Sun","weekend"
"3574",2018-12-23,"Cement Creek","2","2","1",4.2,0,21,2,19,20,0,-1,1,0,2,1,2,2,"w1819","Mechanized",4,"Sun","weekend"
"3575",2018-12-23,"Cement Creek","2","2","1",4.2,0,21,2,19,20,0,-1,1,0,2,1,2,2,"w1819","Motorized",6,"Sun","weekend"
"3576",2018-12-23,"Cement Creek","2","2","1",4.2,0,21,2,19,20,0,-1,1,0,2,1,2,2,"w1819","Hybrid",0,"Sun","weekend"
"3577",2018-12-24,"Cement Creek","2","2","2",4.3,0.1,20,-1,21,21.5,2,0,-1,1,1,1,0,1,"w1819","Non.motorized",23,"Mon","weekday"
"3578",2018-12-24,"Cement Creek","2","2","2",4.3,0.1,20,-1,21,21.5,2,0,-1,1,1,1,0,1,"w1819","Mechanized",0,"Mon","weekday"
"3579",2018-12-24,"Cement Creek","2","2","2",4.3,0.1,20,-1,21,21.5,2,0,-1,1,1,1,0,1,"w1819","Motorized",5,"Mon","weekday"
"3580",2018-12-24,"Cement Creek","2","2","2",4.3,0.1,20,-1,21,21.5,2,0,-1,1,1,1,0,1,"w1819","Hybrid",0,"Mon","weekday"
"3581",2018-12-25,"Cement Creek","2","2","2",4.7,0.4,25,5,25,18.8,-1,2,0,-1,4,6,6,5,"w1819","Non.motorized",40,"Tue","weekday"
"3582",2018-12-25,"Cement Creek","2","2","2",4.7,0.4,25,5,25,18.8,-1,2,0,-1,4,6,6,5,"w1819","Mechanized",0,"Tue","weekday"
"3583",2018-12-25,"Cement Creek","2","2","2",4.7,0.4,25,5,25,18.8,-1,2,0,-1,4,6,6,5,"w1819","Motorized",13,"Tue","weekday"
"3584",2018-12-25,"Cement Creek","2","2","2",4.7,0.4,25,5,25,18.8,-1,2,0,-1,4,6,6,5,"w1819","Hybrid",0,"Tue","weekday"
"3585",2018-12-26,"Cement Creek","3","3","3",4.7,0,23,-2,24,20.4,5,-1,2,0,3,2,4,4,"w1819","Non.motorized",24,"Wed","weekday"
"3586",2018-12-26,"Cement Creek","3","3","3",4.7,0,23,-2,24,20.4,5,-1,2,0,3,2,4,4,"w1819","Mechanized",2,"Wed","weekday"
"3587",2018-12-26,"Cement Creek","3","3","3",4.7,0,23,-2,24,20.4,5,-1,2,0,3,2,4,4,"w1819","Motorized",8,"Wed","weekday"
"3588",2018-12-26,"Cement Creek","3","3","3",4.7,0,23,-2,24,20.4,5,-1,2,0,3,2,4,4,"w1819","Hybrid",0,"Wed","weekday"
"3589",2018-12-27,"Cement Creek","3","3","2",4.7,0,24,1,12,19.6,-2,5,-1,2,-1,4,3,5,"w1819","Non.motorized",26,"Thu","weekday"
"3590",2018-12-27,"Cement Creek","3","3","2",4.7,0,24,1,12,19.6,-2,5,-1,2,-1,4,3,5,"w1819","Mechanized",0,"Thu","weekday"
"3591",2018-12-27,"Cement Creek","3","3","2",4.7,0,24,1,12,19.6,-2,5,-1,2,-1,4,3,5,"w1819","Motorized",8,"Thu","weekday"
"3592",2018-12-27,"Cement Creek","3","3","2",4.7,0,24,1,12,19.6,-2,5,-1,2,-1,4,3,5,"w1819","Hybrid",0,"Thu","weekday"
"3593",2018-12-28,"Cement Creek","3","3","2",4.7,0,24,0,12,19.6,1,-2,5,-1,1,-1,4,3,"w1819","Non.motorized",38,"Fri","weekday"
"3594",2018-12-28,"Cement Creek","3","3","2",4.7,0,24,0,12,19.6,1,-2,5,-1,1,-1,4,3,"w1819","Mechanized",4,"Fri","weekday"
"3595",2018-12-28,"Cement Creek","3","3","2",4.7,0,24,0,12,19.6,1,-2,5,-1,1,-1,4,3,"w1819","Motorized",13,"Fri","weekday"
"3596",2018-12-28,"Cement Creek","3","3","2",4.7,0,24,0,12,19.6,1,-2,5,-1,1,-1,4,3,"w1819","Hybrid",3,"Fri","weekday"
"3597",2018-12-29,"Cement Creek","3","3","2",4.7,0,24,0,8,19.6,0,1,-2,5,0,1,-1,4,"w1819","Non.motorized",39,"Sat","weekend"
"3598",2018-12-29,"Cement Creek","3","3","2",4.7,0,24,0,8,19.6,0,1,-2,5,0,1,-1,4,"w1819","Mechanized",3,"Sat","weekend"
"3599",2018-12-29,"Cement Creek","3","3","2",4.7,0,24,0,8,19.6,0,1,-2,5,0,1,-1,4,"w1819","Motorized",9,"Sat","weekend"
"3600",2018-12-29,"Cement Creek","3","3","2",4.7,0,24,0,8,19.6,0,1,-2,5,0,1,-1,4,"w1819","Hybrid",2,"Sat","weekend"
"3601",2018-12-30,"Cement Creek","3","3","2",4.7,0,24,0,16,19.6,0,0,1,-2,0,0,1,-1,"w1819","Non.motorized",29,"Sun","weekend"
"3602",2018-12-30,"Cement Creek","3","3","2",4.7,0,24,0,16,19.6,0,0,1,-2,0,0,1,-1,"w1819","Mechanized",2,"Sun","weekend"
"3603",2018-12-30,"Cement Creek","3","3","2",4.7,0,24,0,16,19.6,0,0,1,-2,0,0,1,-1,"w1819","Motorized",9,"Sun","weekend"
"3604",2018-12-30,"Cement Creek","3","3","2",4.7,0,24,0,16,19.6,0,0,1,-2,0,0,1,-1,"w1819","Hybrid",0,"Sun","weekend"
"3605",2018-12-31,"Cement Creek","3","3","3",4.9,0.2,23,-1,14,21.3,0,0,0,1,-1,-1,-1,0,"w1819","Non.motorized",33,"Mon","weekday"
"3606",2018-12-31,"Cement Creek","3","3","3",4.9,0.2,23,-1,14,21.3,0,0,0,1,-1,-1,-1,0,"w1819","Mechanized",0,"Mon","weekday"
"3607",2018-12-31,"Cement Creek","3","3","3",4.9,0.2,23,-1,14,21.3,0,0,0,1,-1,-1,-1,0,"w1819","Motorized",11,"Mon","weekday"
"3608",2018-12-31,"Cement Creek","3","3","3",4.9,0.2,23,-1,14,21.3,0,0,0,1,-1,-1,-1,0,"w1819","Hybrid",0,"Mon","weekday"
"3609",2019-01-01,"Cement Creek","3","3","3",5.1,0.2,29,6,11,17.6,-1,0,0,0,5,5,5,5,"w1819","Non.motorized",20,"Tue","weekday"
"3610",2019-01-01,"Cement Creek","3","3","3",5.1,0.2,29,6,11,17.6,-1,0,0,0,5,5,5,5,"w1819","Mechanized",1,"Tue","weekday"
"3611",2019-01-01,"Cement Creek","3","3","3",5.1,0.2,29,6,11,17.6,-1,0,0,0,5,5,5,5,"w1819","Motorized",2,"Tue","weekday"
"3612",2019-01-01,"Cement Creek","3","3","3",5.1,0.2,29,6,11,17.6,-1,0,0,0,5,5,5,5,"w1819","Hybrid",0,"Tue","weekday"
"3613",2019-01-02,"Cement Creek","3","3","2",5.1,0,28,-1,10,18.2,6,-1,0,0,5,4,4,4,"w1819","Non.motorized",13,"Wed","weekday"
"3614",2019-01-02,"Cement Creek","3","3","2",5.1,0,28,-1,10,18.2,6,-1,0,0,5,4,4,4,"w1819","Mechanized",0,"Wed","weekday"
"3615",2019-01-02,"Cement Creek","3","3","2",5.1,0,28,-1,10,18.2,6,-1,0,0,5,4,4,4,"w1819","Motorized",3,"Wed","weekday"
"3616",2019-01-02,"Cement Creek","3","3","2",5.1,0,28,-1,10,18.2,6,-1,0,0,5,4,4,4,"w1819","Hybrid",0,"Wed","weekday"
"3617",2019-01-03,"Cement Creek","3","3","2",5.1,0,27,-1,22,18.9,-1,6,-1,0,-2,4,3,3,"w1819","Non.motorized",19,"Thu","weekday"
"3618",2019-01-03,"Cement Creek","3","3","2",5.1,0,27,-1,22,18.9,-1,6,-1,0,-2,4,3,3,"w1819","Mechanized",1,"Thu","weekday"
"3619",2019-01-03,"Cement Creek","3","3","2",5.1,0,27,-1,22,18.9,-1,6,-1,0,-2,4,3,3,"w1819","Motorized",2,"Thu","weekday"
"3620",2019-01-03,"Cement Creek","3","3","2",5.1,0,27,-1,22,18.9,-1,6,-1,0,-2,4,3,3,"w1819","Hybrid",0,"Thu","weekday"
"3621",2019-01-04,"Cement Creek","3","3","2",5.3,0.2,26,-1,29,20.4,-1,-1,6,-1,-2,-3,3,2,"w1819","Non.motorized",30,"Fri","weekday"
"3622",2019-01-04,"Cement Creek","3","3","2",5.3,0.2,26,-1,29,20.4,-1,-1,6,-1,-2,-3,3,2,"w1819","Mechanized",5,"Fri","weekday"
"3623",2019-01-04,"Cement Creek","3","3","2",5.3,0.2,26,-1,29,20.4,-1,-1,6,-1,-2,-3,3,2,"w1819","Motorized",8,"Fri","weekday"
"3624",2019-01-04,"Cement Creek","3","3","2",5.3,0.2,26,-1,29,20.4,-1,-1,6,-1,-2,-3,3,2,"w1819","Hybrid",0,"Fri","weekday"
"3625",2019-01-05,"Cement Creek","2","2","2",5.3,0,25,-1,30,21.2,-1,-1,-1,6,-2,-3,-4,2,"w1819","Non.motorized",32,"Sat","weekend"
"3626",2019-01-05,"Cement Creek","2","2","2",5.3,0,25,-1,30,21.2,-1,-1,-1,6,-2,-3,-4,2,"w1819","Mechanized",0,"Sat","weekend"
"3627",2019-01-05,"Cement Creek","2","2","2",5.3,0,25,-1,30,21.2,-1,-1,-1,6,-2,-3,-4,2,"w1819","Motorized",6,"Sat","weekend"
"3628",2019-01-05,"Cement Creek","2","2","2",5.3,0,25,-1,30,21.2,-1,-1,-1,6,-2,-3,-4,2,"w1819","Hybrid",0,"Sat","weekend"
"3629",2019-01-06,"Cement Creek","3","3","3",5.3,0,25,0,26,21.2,-1,-1,-1,-1,-1,-2,-3,-4,"w1819","Non.motorized",22,"Sun","weekend"
"3630",2019-01-06,"Cement Creek","3","3","3",5.3,0,25,0,26,21.2,-1,-1,-1,-1,-1,-2,-3,-4,"w1819","Mechanized",0,"Sun","weekend"
"3631",2019-01-06,"Cement Creek","3","3","3",5.3,0,25,0,26,21.2,-1,-1,-1,-1,-1,-2,-3,-4,"w1819","Motorized",2,"Sun","weekend"
"3632",2019-01-06,"Cement Creek","3","3","3",5.3,0,25,0,26,21.2,-1,-1,-1,-1,-1,-2,-3,-4,"w1819","Hybrid",0,"Sun","weekend"
"3633",2019-01-07,"Cement Creek","3","3","3",5.8,0.5,32,7,21,18.1,0,-1,-1,-1,7,6,5,4,"w1819","Non.motorized",7,"Mon","weekday"
"3634",2019-01-07,"Cement Creek","3","3","3",5.8,0.5,32,7,21,18.1,0,-1,-1,-1,7,6,5,4,"w1819","Mechanized",0,"Mon","weekday"
"3635",2019-01-07,"Cement Creek","3","3","3",5.8,0.5,32,7,21,18.1,0,-1,-1,-1,7,6,5,4,"w1819","Motorized",2,"Mon","weekday"
"3636",2019-01-07,"Cement Creek","3","3","3",5.8,0.5,32,7,21,18.1,0,-1,-1,-1,7,6,5,4,"w1819","Hybrid",0,"Mon","weekday"
"3637",2019-01-08,"Cement Creek","3","3","3",5.9,0.1,32,0,24,18.4,7,0,-1,-1,7,7,6,5,"w1819","Non.motorized",9,"Tue","weekday"
"3638",2019-01-08,"Cement Creek","3","3","3",5.9,0.1,32,0,24,18.4,7,0,-1,-1,7,7,6,5,"w1819","Mechanized",0,"Tue","weekday"
"3639",2019-01-08,"Cement Creek","3","3","3",5.9,0.1,32,0,24,18.4,7,0,-1,-1,7,7,6,5,"w1819","Motorized",3,"Tue","weekday"
"3640",2019-01-08,"Cement Creek","3","3","3",5.9,0.1,32,0,24,18.4,7,0,-1,-1,7,7,6,5,"w1819","Hybrid",0,"Tue","weekday"
"3641",2019-01-09,"Cement Creek","3","3","3",6,0.1,30,-2,29,20,0,7,0,-1,-2,5,5,4,"w1819","Non.motorized",8,"Wed","weekday"
"3642",2019-01-09,"Cement Creek","3","3","3",6,0.1,30,-2,29,20,0,7,0,-1,-2,5,5,4,"w1819","Mechanized",3,"Wed","weekday"
"3643",2019-01-09,"Cement Creek","3","3","3",6,0.1,30,-2,29,20,0,7,0,-1,-2,5,5,4,"w1819","Motorized",1,"Wed","weekday"
"3644",2019-01-09,"Cement Creek","3","3","3",6,0.1,30,-2,29,20,0,7,0,-1,-2,5,5,4,"w1819","Hybrid",0,"Wed","weekday"
"3645",2019-01-10,"Cement Creek","3","3","3",6,0,29,-1,29,20.7,-2,0,7,0,-3,-3,4,4,"w1819","Non.motorized",10,"Thu","weekday"
"3646",2019-01-10,"Cement Creek","3","3","3",6,0,29,-1,29,20.7,-2,0,7,0,-3,-3,4,4,"w1819","Mechanized",0,"Thu","weekday"
"3647",2019-01-10,"Cement Creek","3","3","3",6,0,29,-1,29,20.7,-2,0,7,0,-3,-3,4,4,"w1819","Motorized",2,"Thu","weekday"
"3648",2019-01-10,"Cement Creek","3","3","3",6,0,29,-1,29,20.7,-2,0,7,0,-3,-3,4,4,"w1819","Hybrid",0,"Thu","weekday"
"3649",2019-01-11,"Cement Creek","2","2","2",6.1,0.1,29,0,25,21,-1,-2,0,7,-1,-3,-3,4,"w1819","Non.motorized",18,"Fri","weekday"
"3650",2019-01-11,"Cement Creek","2","2","2",6.1,0.1,29,0,25,21,-1,-2,0,7,-1,-3,-3,4,"w1819","Mechanized",2,"Fri","weekday"
"3651",2019-01-11,"Cement Creek","2","2","2",6.1,0.1,29,0,25,21,-1,-2,0,7,-1,-3,-3,4,"w1819","Motorized",6,"Fri","weekday"
"3652",2019-01-11,"Cement Creek","2","2","2",6.1,0.1,29,0,25,21,-1,-2,0,7,-1,-3,-3,4,"w1819","Hybrid",0,"Fri","weekday"
"3653",2019-01-12,"Cement Creek","3","3","2",6.1,0,28,-1,21,21.8,0,-1,-2,0,-1,-2,-4,-4,"w1819","Non.motorized",32,"Sat","weekend"
"3654",2019-01-12,"Cement Creek","3","3","2",6.1,0,28,-1,21,21.8,0,-1,-2,0,-1,-2,-4,-4,"w1819","Mechanized",0,"Sat","weekend"
"3655",2019-01-12,"Cement Creek","3","3","2",6.1,0,28,-1,21,21.8,0,-1,-2,0,-1,-2,-4,-4,"w1819","Motorized",6,"Sat","weekend"
"3656",2019-01-12,"Cement Creek","3","3","2",6.1,0,28,-1,21,21.8,0,-1,-2,0,-1,-2,-4,-4,"w1819","Hybrid",0,"Sat","weekend"
"3657",2019-01-13,"Cement Creek","2","2","2",6.2,0.1,30,2,18,20.7,-1,0,-1,-2,1,1,0,-2,"w1819","Non.motorized",32,"Sun","weekend"
"3658",2019-01-13,"Cement Creek","2","2","2",6.2,0.1,30,2,18,20.7,-1,0,-1,-2,1,1,0,-2,"w1819","Mechanized",2,"Sun","weekend"
"3659",2019-01-13,"Cement Creek","2","2","2",6.2,0.1,30,2,18,20.7,-1,0,-1,-2,1,1,0,-2,"w1819","Motorized",5,"Sun","weekend"
"3660",2019-01-13,"Cement Creek","2","2","2",6.2,0.1,30,2,18,20.7,-1,0,-1,-2,1,1,0,-2,"w1819","Hybrid",0,"Sun","weekend"
"3661",2019-01-14,"Cement Creek","2","2","2",6.2,0,30,0,18,20.7,2,-1,0,-1,2,1,1,0,"w1819","Non.motorized",7,"Mon","weekday"
"3662",2019-01-14,"Cement Creek","2","2","2",6.2,0,30,0,18,20.7,2,-1,0,-1,2,1,1,0,"w1819","Mechanized",1,"Mon","weekday"
"3663",2019-01-14,"Cement Creek","2","2","2",6.2,0,30,0,18,20.7,2,-1,0,-1,2,1,1,0,"w1819","Motorized",4,"Mon","weekday"
"3664",2019-01-14,"Cement Creek","2","2","2",6.2,0,30,0,18,20.7,2,-1,0,-1,2,1,1,0,"w1819","Hybrid",0,"Mon","weekday"
"3665",2019-01-15,"Cement Creek","2","2","2",6.2,0,29,-1,24,21.4,0,2,-1,0,-1,1,0,0,"w1819","Non.motorized",13,"Tue","weekday"
"3666",2019-01-15,"Cement Creek","2","2","2",6.2,0,29,-1,24,21.4,0,2,-1,0,-1,1,0,0,"w1819","Mechanized",1,"Tue","weekday"
"3667",2019-01-15,"Cement Creek","2","2","2",6.2,0,29,-1,24,21.4,0,2,-1,0,-1,1,0,0,"w1819","Motorized",3,"Tue","weekday"
"3668",2019-01-15,"Cement Creek","2","2","2",6.2,0,29,-1,24,21.4,0,2,-1,0,-1,1,0,0,"w1819","Hybrid",0,"Tue","weekday"
"3669",2019-01-16,"Cement Creek","4","4","3",6.3,0.1,29,0,26,21.7,-1,0,2,-1,-1,-1,1,0,"w1819","Non.motorized",0,"Wed","weekday"
"3670",2019-01-16,"Cement Creek","4","4","3",6.3,0.1,29,0,26,21.7,-1,0,2,-1,-1,-1,1,0,"w1819","Mechanized",0,"Wed","weekday"
"3671",2019-01-16,"Cement Creek","4","4","3",6.3,0.1,29,0,26,21.7,-1,0,2,-1,-1,-1,1,0,"w1819","Motorized",2,"Wed","weekday"
"3672",2019-01-16,"Cement Creek","4","4","3",6.3,0.1,29,0,26,21.7,-1,0,2,-1,-1,-1,1,0,"w1819","Hybrid",0,"Wed","weekday"
"3673",2019-01-17,"Cement Creek","3","3","2",7,0.7,38,9,28,18.4,0,-1,0,2,9,8,8,10,"w1819","Non.motorized",0,"Thu","weekday"
"3674",2019-01-17,"Cement Creek","3","3","2",7,0.7,38,9,28,18.4,0,-1,0,2,9,8,8,10,"w1819","Mechanized",0,"Thu","weekday"
"3675",2019-01-17,"Cement Creek","3","3","2",7,0.7,38,9,28,18.4,0,-1,0,2,9,8,8,10,"w1819","Motorized",0,"Thu","weekday"
"3676",2019-01-17,"Cement Creek","3","3","2",7,0.7,38,9,28,18.4,0,-1,0,2,9,8,8,10,"w1819","Hybrid",0,"Thu","weekday"
"3677",2019-01-18,"Cement Creek","4","4","4",7.5,0.5,41,3,22,18.3,9,0,-1,0,12,12,11,11,"w1819","Non.motorized",0,"Fri","weekday"
"3678",2019-01-18,"Cement Creek","4","4","4",7.5,0.5,41,3,22,18.3,9,0,-1,0,12,12,11,11,"w1819","Mechanized",0,"Fri","weekday"
"3679",2019-01-18,"Cement Creek","4","4","4",7.5,0.5,41,3,22,18.3,9,0,-1,0,12,12,11,11,"w1819","Motorized",0,"Fri","weekday"
"3680",2019-01-18,"Cement Creek","4","4","4",7.5,0.5,41,3,22,18.3,9,0,-1,0,12,12,11,11,"w1819","Hybrid",0,"Fri","weekday"
"3681",2019-01-19,"Cement Creek","3","3","3",7.8,0.3,43,2,20,18.1,3,9,0,-1,5,14,14,13,"w1819","Non.motorized",0,"Sat","weekend"
"3682",2019-01-19,"Cement Creek","3","3","3",7.8,0.3,43,2,20,18.1,3,9,0,-1,5,14,14,13,"w1819","Mechanized",0,"Sat","weekend"
"3683",2019-01-19,"Cement Creek","3","3","3",7.8,0.3,43,2,20,18.1,3,9,0,-1,5,14,14,13,"w1819","Motorized",0,"Sat","weekend"
"3684",2019-01-19,"Cement Creek","3","3","3",7.8,0.3,43,2,20,18.1,3,9,0,-1,5,14,14,13,"w1819","Hybrid",0,"Sat","weekend"
"3685",2019-01-20,"Cement Creek","3","3","3",7.9,0.1,41,-2,27,19.3,2,3,9,0,0,3,12,12,"w1819","Non.motorized",0,"Sun","weekend"
"3686",2019-01-20,"Cement Creek","3","3","3",7.9,0.1,41,-2,27,19.3,2,3,9,0,0,3,12,12,"w1819","Mechanized",0,"Sun","weekend"
"3687",2019-01-20,"Cement Creek","3","3","3",7.9,0.1,41,-2,27,19.3,2,3,9,0,0,3,12,12,"w1819","Motorized",0,"Sun","weekend"
"3688",2019-01-20,"Cement Creek","3","3","3",7.9,0.1,41,-2,27,19.3,2,3,9,0,0,3,12,12,"w1819","Hybrid",0,"Sun","weekend"
"3689",2019-01-21,"Cement Creek","3","3","3",7.9,0,39,-2,23,20.3,-2,2,3,9,-4,-2,1,10,"w1819","Non.motorized",1,"Mon","weekday"
"3690",2019-01-21,"Cement Creek","3","3","3",7.9,0,39,-2,23,20.3,-2,2,3,9,-4,-2,1,10,"w1819","Mechanized",0,"Mon","weekday"
"3691",2019-01-21,"Cement Creek","3","3","3",7.9,0,39,-2,23,20.3,-2,2,3,9,-4,-2,1,10,"w1819","Motorized",1,"Mon","weekday"
"3692",2019-01-21,"Cement Creek","3","3","3",7.9,0,39,-2,23,20.3,-2,2,3,9,-4,-2,1,10,"w1819","Hybrid",0,"Mon","weekday"
"3693",2019-01-22,"Cement Creek","3","3","3",8,0.1,41,2,12,19.5,-2,-2,2,3,0,-2,0,3,"w1819","Non.motorized",6,"Tue","weekday"
"3694",2019-01-22,"Cement Creek","3","3","3",8,0.1,41,2,12,19.5,-2,-2,2,3,0,-2,0,3,"w1819","Mechanized",0,"Tue","weekday"
"3695",2019-01-22,"Cement Creek","3","3","3",8,0.1,41,2,12,19.5,-2,-2,2,3,0,-2,0,3,"w1819","Motorized",4,"Tue","weekday"
"3696",2019-01-22,"Cement Creek","3","3","3",8,0.1,41,2,12,19.5,-2,-2,2,3,0,-2,0,3,"w1819","Hybrid",0,"Tue","weekday"
"3697",2019-01-23,"Cement Creek","3","3","2",8,0,40,-1,14,20,2,-2,-2,2,1,-1,-3,-1,"w1819","Non.motorized",12,"Wed","weekday"
"3698",2019-01-23,"Cement Creek","3","3","2",8,0,40,-1,14,20,2,-2,-2,2,1,-1,-3,-1,"w1819","Mechanized",2,"Wed","weekday"
"3699",2019-01-23,"Cement Creek","3","3","2",8,0,40,-1,14,20,2,-2,-2,2,1,-1,-3,-1,"w1819","Motorized",5,"Wed","weekday"
"3700",2019-01-23,"Cement Creek","3","3","2",8,0,40,-1,14,20,2,-2,-2,2,1,-1,-3,-1,"w1819","Hybrid",0,"Wed","weekday"
"3701",2019-01-24,"Cement Creek","3","3","2",8.2,0.2,40,0,17,20.5,-1,2,-2,-2,-1,1,-1,-3,"w1819","Non.motorized",7,"Thu","weekday"
"3702",2019-01-24,"Cement Creek","3","3","2",8.2,0.2,40,0,17,20.5,-1,2,-2,-2,-1,1,-1,-3,"w1819","Mechanized",0,"Thu","weekday"
"3703",2019-01-24,"Cement Creek","3","3","2",8.2,0.2,40,0,17,20.5,-1,2,-2,-2,-1,1,-1,-3,"w1819","Motorized",1,"Thu","weekday"
"3704",2019-01-24,"Cement Creek","3","3","2",8.2,0.2,40,0,17,20.5,-1,2,-2,-2,-1,1,-1,-3,"w1819","Hybrid",0,"Thu","weekday"
"3705",2019-01-25,"Cement Creek","3","3","2",8.3,0.1,40,0,15,20.8,0,-1,2,-2,0,-1,1,-1,"w1819","Non.motorized",15,"Fri","weekday"
"3706",2019-01-25,"Cement Creek","3","3","2",8.3,0.1,40,0,15,20.8,0,-1,2,-2,0,-1,1,-1,"w1819","Mechanized",0,"Fri","weekday"
"3707",2019-01-25,"Cement Creek","3","3","2",8.3,0.1,40,0,15,20.8,0,-1,2,-2,0,-1,1,-1,"w1819","Motorized",3,"Fri","weekday"
"3708",2019-01-25,"Cement Creek","3","3","2",8.3,0.1,40,0,15,20.8,0,-1,2,-2,0,-1,1,-1,"w1819","Hybrid",0,"Fri","weekday"
"3709",2019-01-26,"Cement Creek","3","3","2",8.3,0,39,-1,19,21.3,0,0,-1,2,-1,-1,-2,0,"w1819","Non.motorized",41,"Sat","weekend"
"3710",2019-01-26,"Cement Creek","3","3","2",8.3,0,39,-1,19,21.3,0,0,-1,2,-1,-1,-2,0,"w1819","Mechanized",0,"Sat","weekend"
"3711",2019-01-26,"Cement Creek","3","3","2",8.3,0,39,-1,19,21.3,0,0,-1,2,-1,-1,-2,0,"w1819","Motorized",8,"Sat","weekend"
"3712",2019-01-26,"Cement Creek","3","3","2",8.3,0,39,-1,19,21.3,0,0,-1,2,-1,-1,-2,0,"w1819","Hybrid",0,"Sat","weekend"
"3713",2019-01-27,"Cement Creek","3","3","2",8.3,0,38,-1,24,21.8,-1,0,0,-1,-2,-2,-2,-3,"w1819","Non.motorized",27,"Sun","weekend"
"3714",2019-01-27,"Cement Creek","3","3","2",8.3,0,38,-1,24,21.8,-1,0,0,-1,-2,-2,-2,-3,"w1819","Mechanized",2,"Sun","weekend"
"3715",2019-01-27,"Cement Creek","3","3","2",8.3,0,38,-1,24,21.8,-1,0,0,-1,-2,-2,-2,-3,"w1819","Motorized",4,"Sun","weekend"
"3716",2019-01-27,"Cement Creek","3","3","2",8.3,0,38,-1,24,21.8,-1,0,0,-1,-2,-2,-2,-3,"w1819","Hybrid",0,"Sun","weekend"
"3717",2019-01-28,"Cement Creek","2","2","2",8.3,0,38,0,17,21.8,-1,-1,0,0,-1,-2,-2,-2,"w1819","Non.motorized",8,"Mon","weekday"
"3718",2019-01-28,"Cement Creek","2","2","2",8.3,0,38,0,17,21.8,-1,-1,0,0,-1,-2,-2,-2,"w1819","Mechanized",0,"Mon","weekday"
"3719",2019-01-28,"Cement Creek","2","2","2",8.3,0,38,0,17,21.8,-1,-1,0,0,-1,-2,-2,-2,"w1819","Motorized",4,"Mon","weekday"
"3720",2019-01-28,"Cement Creek","2","2","2",8.3,0,38,0,17,21.8,-1,-1,0,0,-1,-2,-2,-2,"w1819","Hybrid",0,"Mon","weekday"
"3721",2019-01-29,"Cement Creek","2","2","2",8.3,0,38,0,16,21.8,0,-1,-1,0,0,-1,-2,-2,"w1819","Non.motorized",12,"Tue","weekday"
"3722",2019-01-29,"Cement Creek","2","2","2",8.3,0,38,0,16,21.8,0,-1,-1,0,0,-1,-2,-2,"w1819","Mechanized",1,"Tue","weekday"
"3723",2019-01-29,"Cement Creek","2","2","2",8.3,0,38,0,16,21.8,0,-1,-1,0,0,-1,-2,-2,"w1819","Motorized",3,"Tue","weekday"
"3724",2019-01-29,"Cement Creek","2","2","2",8.3,0,38,0,16,21.8,0,-1,-1,0,0,-1,-2,-2,"w1819","Hybrid",0,"Tue","weekday"
"3725",2019-01-30,"Cement Creek","2","2","1",8.3,0,37,-1,20,22.4,0,0,-1,-1,-1,-1,-2,-3,"w1819","Non.motorized",11,"Wed","weekday"
"3726",2019-01-30,"Cement Creek","2","2","1",8.3,0,37,-1,20,22.4,0,0,-1,-1,-1,-1,-2,-3,"w1819","Mechanized",1,"Wed","weekday"
"3727",2019-01-30,"Cement Creek","2","2","1",8.3,0,37,-1,20,22.4,0,0,-1,-1,-1,-1,-2,-3,"w1819","Motorized",3,"Wed","weekday"
"3728",2019-01-30,"Cement Creek","2","2","1",8.3,0,37,-1,20,22.4,0,0,-1,-1,-1,-1,-2,-3,"w1819","Hybrid",0,"Wed","weekday"
"3729",2019-01-31,"Cement Creek","2","2","1",8.3,0,36,-1,24,23.1,-1,0,0,-1,-2,-2,-2,-3,"w1819","Non.motorized",9,"Thu","weekday"
"3730",2019-01-31,"Cement Creek","2","2","1",8.3,0,36,-1,24,23.1,-1,0,0,-1,-2,-2,-2,-3,"w1819","Mechanized",0,"Thu","weekday"
"3731",2019-01-31,"Cement Creek","2","2","1",8.3,0,36,-1,24,23.1,-1,0,0,-1,-2,-2,-2,-3,"w1819","Motorized",1,"Thu","weekday"
"3732",2019-01-31,"Cement Creek","2","2","1",8.3,0,36,-1,24,23.1,-1,0,0,-1,-2,-2,-2,-3,"w1819","Hybrid",0,"Thu","weekday"
"3733",2019-02-01,"Cement Creek","2","2","1",8.3,0,36,0,25,23.1,-1,-1,0,0,-1,-2,-2,-2,"w1819","Non.motorized",23,"Fri","weekday"
"3734",2019-02-01,"Cement Creek","2","2","1",8.3,0,36,0,25,23.1,-1,-1,0,0,-1,-2,-2,-2,"w1819","Mechanized",3,"Fri","weekday"
"3735",2019-02-01,"Cement Creek","2","2","1",8.3,0,36,0,25,23.1,-1,-1,0,0,-1,-2,-2,-2,"w1819","Motorized",2,"Fri","weekday"
"3736",2019-02-01,"Cement Creek","2","2","1",8.3,0,36,0,25,23.1,-1,-1,0,0,-1,-2,-2,-2,"w1819","Hybrid",0,"Fri","weekday"
"3737",2019-02-02,"Cement Creek","2","2","1",8.3,0,36,0,26,23.1,0,-1,-1,0,0,-1,-2,-2,"w1819","Non.motorized",33,"Sat","weekend"
"3738",2019-02-02,"Cement Creek","2","2","1",8.3,0,36,0,26,23.1,0,-1,-1,0,0,-1,-2,-2,"w1819","Mechanized",5,"Sat","weekend"
"3739",2019-02-02,"Cement Creek","2","2","1",8.3,0,36,0,26,23.1,0,-1,-1,0,0,-1,-2,-2,"w1819","Motorized",3,"Sat","weekend"
"3740",2019-02-02,"Cement Creek","2","2","1",8.3,0,36,0,26,23.1,0,-1,-1,0,0,-1,-2,-2,"w1819","Hybrid",0,"Sat","weekend"
"3741",2019-02-03,"Cement Creek","3","3","2",8.4,0.1,36,0,28,23.3,0,0,-1,-1,0,0,-1,-2,"w1819","Non.motorized",24,"Sun","weekend"
"3742",2019-02-03,"Cement Creek","3","3","2",8.4,0.1,36,0,28,23.3,0,0,-1,-1,0,0,-1,-2,"w1819","Mechanized",2,"Sun","weekend"
"3743",2019-02-03,"Cement Creek","3","3","2",8.4,0.1,36,0,28,23.3,0,0,-1,-1,0,0,-1,-2,"w1819","Motorized",2,"Sun","weekend"
"3744",2019-02-03,"Cement Creek","3","3","2",8.4,0.1,36,0,28,23.3,0,0,-1,-1,0,0,-1,-2,"w1819","Hybrid",0,"Sun","weekend"
"3745",2019-02-04,"Cement Creek","3","3","2",8.8,0.4,39,3,28,22.6,0,0,0,-1,3,3,3,2,"w1819","Non.motorized",10,"Mon","weekday"
"3746",2019-02-04,"Cement Creek","3","3","2",8.8,0.4,39,3,28,22.6,0,0,0,-1,3,3,3,2,"w1819","Mechanized",1,"Mon","weekday"
"3747",2019-02-04,"Cement Creek","3","3","2",8.8,0.4,39,3,28,22.6,0,0,0,-1,3,3,3,2,"w1819","Motorized",4,"Mon","weekday"
"3748",2019-02-04,"Cement Creek","3","3","2",8.8,0.4,39,3,28,22.6,0,0,0,-1,3,3,3,2,"w1819","Hybrid",0,"Mon","weekday"
"3749",2019-02-05,"Cement Creek","3","2","2",9,0.2,40,1,26,22.5,3,0,0,0,4,4,4,4,"w1819","Non.motorized",15,"Tue","weekday"
"3750",2019-02-05,"Cement Creek","3","2","2",9,0.2,40,1,26,22.5,3,0,0,0,4,4,4,4,"w1819","Mechanized",0,"Tue","weekday"
"3751",2019-02-05,"Cement Creek","3","2","2",9,0.2,40,1,26,22.5,3,0,0,0,4,4,4,4,"w1819","Motorized",4,"Tue","weekday"
"3752",2019-02-05,"Cement Creek","3","2","2",9,0.2,40,1,26,22.5,3,0,0,0,4,4,4,4,"w1819","Hybrid",0,"Tue","weekday"
"3753",2019-02-06,"Cement Creek","4","4","3",9,0,40,0,16,22.5,1,3,0,0,1,4,4,4,"w1819","Non.motorized",7,"Wed","weekday"
"3754",2019-02-06,"Cement Creek","4","4","3",9,0,40,0,16,22.5,1,3,0,0,1,4,4,4,"w1819","Mechanized",0,"Wed","weekday"
"3755",2019-02-06,"Cement Creek","4","4","3",9,0,40,0,16,22.5,1,3,0,0,1,4,4,4,"w1819","Motorized",3,"Wed","weekday"
"3756",2019-02-06,"Cement Creek","4","4","3",9,0,40,0,16,22.5,1,3,0,0,1,4,4,4,"w1819","Hybrid",0,"Wed","weekday"
"3757",2019-02-07,"Cement Creek","3","3","2",9.2,0.2,43,3,4,21.4,0,1,3,0,3,4,7,7,"w1819","Non.motorized",4,"Thu","weekday"
"3758",2019-02-07,"Cement Creek","3","3","2",9.2,0.2,43,3,4,21.4,0,1,3,0,3,4,7,7,"w1819","Mechanized",0,"Thu","weekday"
"3759",2019-02-07,"Cement Creek","3","3","2",9.2,0.2,43,3,4,21.4,0,1,3,0,3,4,7,7,"w1819","Motorized",3,"Thu","weekday"
"3760",2019-02-07,"Cement Creek","3","3","2",9.2,0.2,43,3,4,21.4,0,1,3,0,3,4,7,7,"w1819","Hybrid",0,"Thu","weekday"
"3761",2019-02-08,"Cement Creek","3","2","2",9.2,0,42,-1,10,21.9,3,0,1,3,2,2,3,6,"w1819","Non.motorized",20,"Fri","weekday"
"3762",2019-02-08,"Cement Creek","3","2","2",9.2,0,42,-1,10,21.9,3,0,1,3,2,2,3,6,"w1819","Mechanized",0,"Fri","weekday"
"3763",2019-02-08,"Cement Creek","3","2","2",9.2,0,42,-1,10,21.9,3,0,1,3,2,2,3,6,"w1819","Motorized",1,"Fri","weekday"
"3764",2019-02-08,"Cement Creek","3","2","2",9.2,0,42,-1,10,21.9,3,0,1,3,2,2,3,6,"w1819","Hybrid",0,"Fri","weekday"
"3765",2019-02-09,"Cement Creek","3","2","2",9.2,0,41,-1,20,22.4,-1,3,0,1,-2,1,1,2,"w1819","Non.motorized",25,"Sat","weekend"
"3766",2019-02-09,"Cement Creek","3","2","2",9.2,0,41,-1,20,22.4,-1,3,0,1,-2,1,1,2,"w1819","Mechanized",0,"Sat","weekend"
"3767",2019-02-09,"Cement Creek","3","2","2",9.2,0,41,-1,20,22.4,-1,3,0,1,-2,1,1,2,"w1819","Motorized",4,"Sat","weekend"
"3768",2019-02-09,"Cement Creek","3","2","2",9.2,0,41,-1,20,22.4,-1,3,0,1,-2,1,1,2,"w1819","Hybrid",0,"Sat","weekend"
"3769",2019-02-10,"Cement Creek","2","2","2",9.3,0.1,40,-1,20,23.2,-1,-1,3,0,-2,-3,0,0,"w1819","Non.motorized",0,"Sun","weekend"
"3770",2019-02-10,"Cement Creek","2","2","2",9.3,0.1,40,-1,20,23.2,-1,-1,3,0,-2,-3,0,0,"w1819","Mechanized",0,"Sun","weekend"
"3771",2019-02-10,"Cement Creek","2","2","2",9.3,0.1,40,-1,20,23.2,-1,-1,3,0,-2,-3,0,0,"w1819","Motorized",0,"Sun","weekend"
"3772",2019-02-10,"Cement Creek","2","2","2",9.3,0.1,40,-1,20,23.2,-1,-1,3,0,-2,-3,0,0,"w1819","Hybrid",0,"Sun","weekend"
"3773",2019-02-11,"Cement Creek","2","2","1",9.3,0,40,0,15,23.2,-1,-1,-1,3,-1,-2,-3,0,"w1819","Non.motorized",5,"Mon","weekday"
"3774",2019-02-11,"Cement Creek","2","2","1",9.3,0,40,0,15,23.2,-1,-1,-1,3,-1,-2,-3,0,"w1819","Mechanized",0,"Mon","weekday"
"3775",2019-02-11,"Cement Creek","2","2","1",9.3,0,40,0,15,23.2,-1,-1,-1,3,-1,-2,-3,0,"w1819","Motorized",3,"Mon","weekday"
"3776",2019-02-11,"Cement Creek","2","2","1",9.3,0,40,0,15,23.2,-1,-1,-1,3,-1,-2,-3,0,"w1819","Hybrid",0,"Mon","weekday"
"3777",2019-02-12,"Cement Creek","2","2","1",9.3,0,40,0,18,23.2,0,-1,-1,-1,0,-1,-2,-3,"w1819","Non.motorized",17,"Tue","weekday"
"3778",2019-02-12,"Cement Creek","2","2","1",9.3,0,40,0,18,23.2,0,-1,-1,-1,0,-1,-2,-3,"w1819","Mechanized",0,"Tue","weekday"
"3779",2019-02-12,"Cement Creek","2","2","1",9.3,0,40,0,18,23.2,0,-1,-1,-1,0,-1,-2,-3,"w1819","Motorized",8,"Tue","weekday"
"3780",2019-02-12,"Cement Creek","2","2","1",9.3,0,40,0,18,23.2,0,-1,-1,-1,0,-1,-2,-3,"w1819","Hybrid",0,"Tue","weekday"
"3781",2019-02-13,"Cement Creek","2","2","1",9.4,0.1,40,0,26,23.5,0,0,-1,-1,0,0,-1,-2,"w1819","Non.motorized",16,"Wed","weekday"
"3782",2019-02-13,"Cement Creek","2","2","1",9.4,0.1,40,0,26,23.5,0,0,-1,-1,0,0,-1,-2,"w1819","Mechanized",1,"Wed","weekday"
"3783",2019-02-13,"Cement Creek","2","2","1",9.4,0.1,40,0,26,23.5,0,0,-1,-1,0,0,-1,-2,"w1819","Motorized",2,"Wed","weekday"
"3784",2019-02-13,"Cement Creek","2","2","1",9.4,0.1,40,0,26,23.5,0,0,-1,-1,0,0,-1,-2,"w1819","Hybrid",0,"Wed","weekday"
"3785",2019-02-14,"Cement Creek","3","2","2",9.7,0.3,41,1,29,23.7,0,0,0,-1,1,1,1,0,"w1819","Non.motorized",4,"Thu","weekday"
"3786",2019-02-14,"Cement Creek","3","2","2",9.7,0.3,41,1,29,23.7,0,0,0,-1,1,1,1,0,"w1819","Mechanized",0,"Thu","weekday"
"3787",2019-02-14,"Cement Creek","3","2","2",9.7,0.3,41,1,29,23.7,0,0,0,-1,1,1,1,0,"w1819","Motorized",12,"Thu","weekday"
"3788",2019-02-14,"Cement Creek","3","2","2",9.7,0.3,41,1,29,23.7,0,0,0,-1,1,1,1,0,"w1819","Hybrid",0,"Thu","weekday"
"3789",2019-02-15,"Cement Creek","4","4","3",10.8,1.1,51,10,27,21.2,1,0,0,0,11,11,11,11,"w1819","Non.motorized",18,"Fri","weekday"
"3790",2019-02-15,"Cement Creek","4","4","3",10.8,1.1,51,10,27,21.2,1,0,0,0,11,11,11,11,"w1819","Mechanized",0,"Fri","weekday"
"3791",2019-02-15,"Cement Creek","4","4","3",10.8,1.1,51,10,27,21.2,1,0,0,0,11,11,11,11,"w1819","Motorized",7,"Fri","weekday"
"3792",2019-02-15,"Cement Creek","4","4","3",10.8,1.1,51,10,27,21.2,1,0,0,0,11,11,11,11,"w1819","Hybrid",0,"Fri","weekday"
"3793",2019-02-16,"Cement Creek","3","3","3",11.1,0.3,52,1,14,21.3,10,1,0,0,11,12,12,12,"w1819","Non.motorized",0,"Sat","weekend"
"3794",2019-02-16,"Cement Creek","3","3","3",11.1,0.3,52,1,14,21.3,10,1,0,0,11,12,12,12,"w1819","Mechanized",0,"Sat","weekend"
"3795",2019-02-16,"Cement Creek","3","3","3",11.1,0.3,52,1,14,21.3,10,1,0,0,11,12,12,12,"w1819","Motorized",0,"Sat","weekend"
"3796",2019-02-16,"Cement Creek","3","3","3",11.1,0.3,52,1,14,21.3,10,1,0,0,11,12,12,12,"w1819","Hybrid",0,"Sat","weekend"
"3797",2019-02-17,"Cement Creek","3","3","3",11.3,0.2,55,3,10,20.5,1,10,1,0,4,14,15,15,"w1819","Non.motorized",21,"Sun","weekend"
"3798",2019-02-17,"Cement Creek","3","3","3",11.3,0.2,55,3,10,20.5,1,10,1,0,4,14,15,15,"w1819","Mechanized",1,"Sun","weekend"
"3799",2019-02-17,"Cement Creek","3","3","3",11.3,0.2,55,3,10,20.5,1,10,1,0,4,14,15,15,"w1819","Motorized",6,"Sun","weekend"
"3800",2019-02-17,"Cement Creek","3","3","3",11.3,0.2,55,3,10,20.5,1,10,1,0,4,14,15,15,"w1819","Hybrid",0,"Sun","weekend"
"3801",2019-02-18,"Cement Creek","3","3","2",11.4,0.1,53,-2,13,21.5,3,1,10,1,1,2,12,13,"w1819","Non.motorized",9,"Mon","weekday"
"3802",2019-02-18,"Cement Creek","3","3","2",11.4,0.1,53,-2,13,21.5,3,1,10,1,1,2,12,13,"w1819","Mechanized",0,"Mon","weekday"
"3803",2019-02-18,"Cement Creek","3","3","2",11.4,0.1,53,-2,13,21.5,3,1,10,1,1,2,12,13,"w1819","Motorized",5,"Mon","weekday"
"3804",2019-02-18,"Cement Creek","3","3","2",11.4,0.1,53,-2,13,21.5,3,1,10,1,1,2,12,13,"w1819","Hybrid",0,"Mon","weekday"
"3805",2019-02-19,"Cement Creek","3","3","2",11.5,0.1,53,0,11,21.7,-2,3,1,10,-2,1,2,12,"w1819","Non.motorized",0,"Tue","weekday"
"3806",2019-02-19,"Cement Creek","3","3","2",11.5,0.1,53,0,11,21.7,-2,3,1,10,-2,1,2,12,"w1819","Mechanized",0,"Tue","weekday"
"3807",2019-02-19,"Cement Creek","3","3","2",11.5,0.1,53,0,11,21.7,-2,3,1,10,-2,1,2,12,"w1819","Motorized",0,"Tue","weekday"
"3808",2019-02-19,"Cement Creek","3","3","2",11.5,0.1,53,0,11,21.7,-2,3,1,10,-2,1,2,12,"w1819","Hybrid",0,"Tue","weekday"
"3809",2019-02-20,"Cement Creek","3","3","2",11.6,0.1,53,0,7,21.9,0,-2,3,1,0,-2,1,2,"w1819","Non.motorized",0,"Wed","weekday"
"3810",2019-02-20,"Cement Creek","3","3","2",11.6,0.1,53,0,7,21.9,0,-2,3,1,0,-2,1,2,"w1819","Mechanized",0,"Wed","weekday"
"3811",2019-02-20,"Cement Creek","3","3","2",11.6,0.1,53,0,7,21.9,0,-2,3,1,0,-2,1,2,"w1819","Motorized",0,"Wed","weekday"
"3812",2019-02-20,"Cement Creek","3","3","2",11.6,0.1,53,0,7,21.9,0,-2,3,1,0,-2,1,2,"w1819","Hybrid",0,"Wed","weekday"
"3813",2019-02-21,"Cement Creek","3","3","3",11.6,0,52,-1,15,22.3,0,0,-2,3,-1,-1,-3,0,"w1819","Non.motorized",0,"Thu","weekday"
"3814",2019-02-21,"Cement Creek","3","3","3",11.6,0,52,-1,15,22.3,0,0,-2,3,-1,-1,-3,0,"w1819","Mechanized",0,"Thu","weekday"
"3815",2019-02-21,"Cement Creek","3","3","3",11.6,0,52,-1,15,22.3,0,0,-2,3,-1,-1,-3,0,"w1819","Motorized",0,"Thu","weekday"
"3816",2019-02-21,"Cement Creek","3","3","3",11.6,0,52,-1,15,22.3,0,0,-2,3,-1,-1,-3,0,"w1819","Hybrid",0,"Thu","weekday"
"3817",2019-02-22,"Cement Creek","3","3","3",11.8,0.2,52,0,20,22.7,-1,0,0,-2,-1,-1,-1,-3,"w1819","Non.motorized",2,"Fri","weekday"
"3818",2019-02-22,"Cement Creek","3","3","3",11.8,0.2,52,0,20,22.7,-1,0,0,-2,-1,-1,-1,-3,"w1819","Mechanized",0,"Fri","weekday"
"3819",2019-02-22,"Cement Creek","3","3","3",11.8,0.2,52,0,20,22.7,-1,0,0,-2,-1,-1,-1,-3,"w1819","Motorized",0,"Fri","weekday"
"3820",2019-02-22,"Cement Creek","3","3","3",11.8,0.2,52,0,20,22.7,-1,0,0,-2,-1,-1,-1,-3,"w1819","Hybrid",0,"Fri","weekday"
"3821",2019-02-23,"Cement Creek","3","3","3",12.1,0.3,53,1,13,22.8,0,-1,0,0,1,0,0,0,"w1819","Non.motorized",29,"Sat","weekend"
"3822",2019-02-23,"Cement Creek","3","3","3",12.1,0.3,53,1,13,22.8,0,-1,0,0,1,0,0,0,"w1819","Mechanized",0,"Sat","weekend"
"3823",2019-02-23,"Cement Creek","3","3","3",12.1,0.3,53,1,13,22.8,0,-1,0,0,1,0,0,0,"w1819","Motorized",6,"Sat","weekend"
"3824",2019-02-23,"Cement Creek","3","3","3",12.1,0.3,53,1,13,22.8,0,-1,0,0,1,0,0,0,"w1819","Hybrid",0,"Sat","weekend"
"3825",2019-02-24,"Cement Creek","3","3","2",12.1,0,52,-1,14,23.3,1,0,-1,0,0,0,-1,-1,"w1819","Non.motorized",29,"Sun","weekend"
"3826",2019-02-24,"Cement Creek","3","3","2",12.1,0,52,-1,14,23.3,1,0,-1,0,0,0,-1,-1,"w1819","Mechanized",1,"Sun","weekend"
"3827",2019-02-24,"Cement Creek","3","3","2",12.1,0,52,-1,14,23.3,1,0,-1,0,0,0,-1,-1,"w1819","Motorized",13,"Sun","weekend"
"3828",2019-02-24,"Cement Creek","3","3","2",12.1,0,52,-1,14,23.3,1,0,-1,0,0,0,-1,-1,"w1819","Hybrid",0,"Sun","weekend"
"3829",2019-02-25,"Cement Creek","3","3","2",12.1,0,51,-1,22,23.7,-1,1,0,-1,-2,-1,-1,-2,"w1819","Non.motorized",13,"Mon","weekday"
"3830",2019-02-25,"Cement Creek","3","3","2",12.1,0,51,-1,22,23.7,-1,1,0,-1,-2,-1,-1,-2,"w1819","Mechanized",5,"Mon","weekday"
"3831",2019-02-25,"Cement Creek","3","3","2",12.1,0,51,-1,22,23.7,-1,1,0,-1,-2,-1,-1,-2,"w1819","Motorized",10,"Mon","weekday"
"3832",2019-02-25,"Cement Creek","3","3","2",12.1,0,51,-1,22,23.7,-1,1,0,-1,-2,-1,-1,-2,"w1819","Hybrid",0,"Mon","weekday"
"3833",2019-02-26,"Cement Creek","2","2","2",12.1,0,50,-1,27,24.2,-1,-1,1,0,-2,-3,-2,-2,"w1819","Non.motorized",13,"Tue","weekday"
"3834",2019-02-26,"Cement Creek","2","2","2",12.1,0,50,-1,27,24.2,-1,-1,1,0,-2,-3,-2,-2,"w1819","Mechanized",0,"Tue","weekday"
"3835",2019-02-26,"Cement Creek","2","2","2",12.1,0,50,-1,27,24.2,-1,-1,1,0,-2,-3,-2,-2,"w1819","Motorized",2,"Tue","weekday"
"3836",2019-02-26,"Cement Creek","2","2","2",12.1,0,50,-1,27,24.2,-1,-1,1,0,-2,-3,-2,-2,"w1819","Hybrid",0,"Tue","weekday"
"3837",2019-02-27,"Cement Creek","2","2","2",12.1,0,50,0,30,24.2,-1,-1,-1,1,-1,-2,-3,-2,"w1819","Non.motorized",10,"Wed","weekday"
"3838",2019-02-27,"Cement Creek","2","2","2",12.1,0,50,0,30,24.2,-1,-1,-1,1,-1,-2,-3,-2,"w1819","Mechanized",1,"Wed","weekday"
"3839",2019-02-27,"Cement Creek","2","2","2",12.1,0,50,0,30,24.2,-1,-1,-1,1,-1,-2,-3,-2,"w1819","Motorized",10,"Wed","weekday"
"3840",2019-02-27,"Cement Creek","2","2","2",12.1,0,50,0,30,24.2,-1,-1,-1,1,-1,-2,-3,-2,"w1819","Hybrid",0,"Wed","weekday"
"3841",2019-02-28,"Cement Creek","2","2","2",12.2,0.1,49,-1,30,24.9,0,-1,-1,-1,-1,-2,-3,-4,"w1819","Non.motorized",20,"Thu","weekday"
"3842",2019-02-28,"Cement Creek","2","2","2",12.2,0.1,49,-1,30,24.9,0,-1,-1,-1,-1,-2,-3,-4,"w1819","Mechanized",2,"Thu","weekday"
"3843",2019-02-28,"Cement Creek","2","2","2",12.2,0.1,49,-1,30,24.9,0,-1,-1,-1,-1,-2,-3,-4,"w1819","Motorized",2,"Thu","weekday"
"3844",2019-02-28,"Cement Creek","2","2","2",12.2,0.1,49,-1,30,24.9,0,-1,-1,-1,-1,-2,-3,-4,"w1819","Hybrid",0,"Thu","weekday"
"3845",2019-03-01,"Cement Creek","2","2","1",12.3,0.1,49,0,29,25.1,-1,0,-1,-1,-1,-1,-2,-3,"w1819","Non.motorized",0,"Fri","weekday"
"3846",2019-03-01,"Cement Creek","2","2","1",12.3,0.1,49,0,29,25.1,-1,0,-1,-1,-1,-1,-2,-3,"w1819","Mechanized",0,"Fri","weekday"
"3847",2019-03-01,"Cement Creek","2","2","1",12.3,0.1,49,0,29,25.1,-1,0,-1,-1,-1,-1,-2,-3,"w1819","Motorized",2,"Fri","weekday"
"3848",2019-03-01,"Cement Creek","2","2","1",12.3,0.1,49,0,29,25.1,-1,0,-1,-1,-1,-1,-2,-3,"w1819","Hybrid",0,"Fri","weekday"
"3849",2019-03-02,"Cement Creek","3","3","2",13,0.7,58,9,30,22.4,0,-1,0,-1,9,8,8,7,"w1819","Non.motorized",12,"Sat","weekend"
"3850",2019-03-02,"Cement Creek","3","3","2",13,0.7,58,9,30,22.4,0,-1,0,-1,9,8,8,7,"w1819","Mechanized",0,"Sat","weekend"
"3851",2019-03-02,"Cement Creek","3","3","2",13,0.7,58,9,30,22.4,0,-1,0,-1,9,8,8,7,"w1819","Motorized",2,"Sat","weekend"
"3852",2019-03-02,"Cement Creek","3","3","2",13,0.7,58,9,30,22.4,0,-1,0,-1,9,8,8,7,"w1819","Hybrid",0,"Sat","weekend"
"3853",2019-03-03,"Cement Creek","3","3","3",13.7,0.7,64,6,27,21.4,9,0,-1,0,15,15,14,14,"w1819","Non.motorized",3,"Sun","weekend"
"3854",2019-03-03,"Cement Creek","3","3","3",13.7,0.7,64,6,27,21.4,9,0,-1,0,15,15,14,14,"w1819","Mechanized",0,"Sun","weekend"
"3855",2019-03-03,"Cement Creek","3","3","3",13.7,0.7,64,6,27,21.4,9,0,-1,0,15,15,14,14,"w1819","Motorized",0,"Sun","weekend"
"3856",2019-03-03,"Cement Creek","3","3","3",13.7,0.7,64,6,27,21.4,9,0,-1,0,15,15,14,14,"w1819","Hybrid",0,"Sun","weekend"
"3857",2019-03-04,"Cement Creek","3","3","3",14.4,0.7,66,2,23,21.8,6,9,0,-1,8,17,17,16,"w1819","Non.motorized",9,"Mon","weekday"
"3858",2019-03-04,"Cement Creek","3","3","3",14.4,0.7,66,2,23,21.8,6,9,0,-1,8,17,17,16,"w1819","Mechanized",0,"Mon","weekday"
"3859",2019-03-04,"Cement Creek","3","3","3",14.4,0.7,66,2,23,21.8,6,9,0,-1,8,17,17,16,"w1819","Motorized",4,"Mon","weekday"
"3860",2019-03-04,"Cement Creek","3","3","3",14.4,0.7,66,2,23,21.8,6,9,0,-1,8,17,17,16,"w1819","Hybrid",0,"Mon","weekday"
"3861",2019-03-05,"Cement Creek","3","3","3",14.4,0,64,-2,24,22.5,2,6,9,0,0,6,15,15,"w1819","Non.motorized",13,"Tue","weekday"
"3862",2019-03-05,"Cement Creek","3","3","3",14.4,0,64,-2,24,22.5,2,6,9,0,0,6,15,15,"w1819","Mechanized",0,"Tue","weekday"
"3863",2019-03-05,"Cement Creek","3","3","3",14.4,0,64,-2,24,22.5,2,6,9,0,0,6,15,15,"w1819","Motorized",3,"Tue","weekday"
"3864",2019-03-05,"Cement Creek","3","3","3",14.4,0,64,-2,24,22.5,2,6,9,0,0,6,15,15,"w1819","Hybrid",0,"Tue","weekday"
"3865",2019-03-06,"Cement Creek","3","3","2",14.5,0.1,62,-2,31,23.4,-2,2,6,9,-4,-2,4,13,"w1819","Non.motorized",0,"Wed","weekday"
"3866",2019-03-06,"Cement Creek","3","3","2",14.5,0.1,62,-2,31,23.4,-2,2,6,9,-4,-2,4,13,"w1819","Mechanized",0,"Wed","weekday"
"3867",2019-03-06,"Cement Creek","3","3","2",14.5,0.1,62,-2,31,23.4,-2,2,6,9,-4,-2,4,13,"w1819","Motorized",0,"Wed","weekday"
"3868",2019-03-06,"Cement Creek","3","3","2",14.5,0.1,62,-2,31,23.4,-2,2,6,9,-4,-2,4,13,"w1819","Hybrid",0,"Wed","weekday"
"3869",2019-03-06,"Cement Creek","4","4","3",14.5,0.1,62,-2,31,23.4,-2,2,6,9,-4,-2,4,13,"w1819","Non.motorized",0,"Wed","weekday"
"3870",2019-03-06,"Cement Creek","4","4","3",14.5,0.1,62,-2,31,23.4,-2,2,6,9,-4,-2,4,13,"w1819","Mechanized",0,"Wed","weekday"
"3871",2019-03-06,"Cement Creek","4","4","3",14.5,0.1,62,-2,31,23.4,-2,2,6,9,-4,-2,4,13,"w1819","Motorized",0,"Wed","weekday"
"3872",2019-03-06,"Cement Creek","4","4","3",14.5,0.1,62,-2,31,23.4,-2,2,6,9,-4,-2,4,13,"w1819","Hybrid",0,"Wed","weekday"
"3873",2019-03-07,"Cement Creek","4","4","3",16.2,1.7,71,9,30,22.8,-2,-2,2,6,7,5,7,13,"w1819","Non.motorized",0,"Thu","weekday"
"3874",2019-03-07,"Cement Creek","4","4","3",16.2,1.7,71,9,30,22.8,-2,-2,2,6,7,5,7,13,"w1819","Mechanized",0,"Thu","weekday"
"3875",2019-03-07,"Cement Creek","4","4","3",16.2,1.7,71,9,30,22.8,-2,-2,2,6,7,5,7,13,"w1819","Motorized",0,"Thu","weekday"
"3876",2019-03-07,"Cement Creek","4","4","3",16.2,1.7,71,9,30,22.8,-2,-2,2,6,7,5,7,13,"w1819","Hybrid",0,"Thu","weekday"
"3877",2019-03-08,"Cement Creek","3","3","3",16.6,0.4,71,0,27,23.4,9,-2,-2,2,9,7,5,7,"w1819","Non.motorized",0,"Fri","weekday"
"3878",2019-03-08,"Cement Creek","3","3","3",16.6,0.4,71,0,27,23.4,9,-2,-2,2,9,7,5,7,"w1819","Mechanized",0,"Fri","weekday"
"3879",2019-03-08,"Cement Creek","3","3","3",16.6,0.4,71,0,27,23.4,9,-2,-2,2,9,7,5,7,"w1819","Motorized",0,"Fri","weekday"
"3880",2019-03-08,"Cement Creek","3","3","3",16.6,0.4,71,0,27,23.4,9,-2,-2,2,9,7,5,7,"w1819","Hybrid",0,"Fri","weekday"
"3881",2019-03-09,"Cement Creek","4","4","3",17.2,0.6,76,5,22,22.6,0,9,-2,-2,5,14,12,10,"w1819","Non.motorized",0,"Sat","weekend"
"3882",2019-03-09,"Cement Creek","4","4","3",17.2,0.6,76,5,22,22.6,0,9,-2,-2,5,14,12,10,"w1819","Mechanized",0,"Sat","weekend"
"3883",2019-03-09,"Cement Creek","4","4","3",17.2,0.6,76,5,22,22.6,0,9,-2,-2,5,14,12,10,"w1819","Motorized",1,"Sat","weekend"
"3884",2019-03-09,"Cement Creek","4","4","3",17.2,0.6,76,5,22,22.6,0,9,-2,-2,5,14,12,10,"w1819","Hybrid",0,"Sat","weekend"
"3885",2019-03-10,"Cement Creek","3","3","3",17.3,0.1,73,-3,25,23.7,5,0,9,-2,2,2,11,9,"w1819","Non.motorized",11,"Sun","weekend"
"3886",2019-03-10,"Cement Creek","3","3","3",17.3,0.1,73,-3,25,23.7,5,0,9,-2,2,2,11,9,"w1819","Mechanized",0,"Sun","weekend"
"3887",2019-03-10,"Cement Creek","3","3","3",17.3,0.1,73,-3,25,23.7,5,0,9,-2,2,2,11,9,"w1819","Motorized",3,"Sun","weekend"
"3888",2019-03-10,"Cement Creek","3","3","3",17.3,0.1,73,-3,25,23.7,5,0,9,-2,2,2,11,9,"w1819","Hybrid",0,"Sun","weekend"
"3889",2019-03-11,"Cement Creek","3","3","2",17.3,0,71,-2,29,24.4,-3,5,0,9,-5,0,0,9,"w1819","Non.motorized",6,"Mon","weekday"
"3890",2019-03-11,"Cement Creek","3","3","2",17.3,0,71,-2,29,24.4,-3,5,0,9,-5,0,0,9,"w1819","Mechanized",1,"Mon","weekday"
"3891",2019-03-11,"Cement Creek","3","3","2",17.3,0,71,-2,29,24.4,-3,5,0,9,-5,0,0,9,"w1819","Motorized",2,"Mon","weekday"
"3892",2019-03-11,"Cement Creek","3","3","2",17.3,0,71,-2,29,24.4,-3,5,0,9,-5,0,0,9,"w1819","Hybrid",0,"Mon","weekday"
"3893",2019-03-12,"Cement Creek","3","3","3",17.4,0.1,70,-1,32,24.9,-2,-3,5,0,-3,-6,-1,-1,"w1819","Non.motorized",1,"Tue","weekday"
"3894",2019-03-12,"Cement Creek","3","3","3",17.4,0.1,70,-1,32,24.9,-2,-3,5,0,-3,-6,-1,-1,"w1819","Mechanized",0,"Tue","weekday"
"3895",2019-03-12,"Cement Creek","3","3","3",17.4,0.1,70,-1,32,24.9,-2,-3,5,0,-3,-6,-1,-1,"w1819","Motorized",2,"Tue","weekday"
"3896",2019-03-12,"Cement Creek","3","3","3",17.4,0.1,70,-1,32,24.9,-2,-3,5,0,-3,-6,-1,-1,"w1819","Hybrid",0,"Tue","weekday"
"3897",2019-03-12,"Cement Creek","4","4","4",17.4,0.1,70,-1,32,24.9,-2,-3,5,0,-3,-6,-1,-1,"w1819","Non.motorized",1,"Tue","weekday"
"3898",2019-03-12,"Cement Creek","4","4","4",17.4,0.1,70,-1,32,24.9,-2,-3,5,0,-3,-6,-1,-1,"w1819","Mechanized",0,"Tue","weekday"
"3899",2019-03-12,"Cement Creek","4","4","4",17.4,0.1,70,-1,32,24.9,-2,-3,5,0,-3,-6,-1,-1,"w1819","Motorized",2,"Tue","weekday"
"3900",2019-03-12,"Cement Creek","4","4","4",17.4,0.1,70,-1,32,24.9,-2,-3,5,0,-3,-6,-1,-1,"w1819","Hybrid",0,"Tue","weekday"
"3901",2019-03-13,"Cement Creek","4","4","3",18.1,0.7,74,4,24,24.5,-1,-2,-3,5,3,1,-2,3,"w1819","Non.motorized",0,"Wed","weekday"
"3902",2019-03-13,"Cement Creek","4","4","3",18.1,0.7,74,4,24,24.5,-1,-2,-3,5,3,1,-2,3,"w1819","Mechanized",0,"Wed","weekday"
"3903",2019-03-13,"Cement Creek","4","4","3",18.1,0.7,74,4,24,24.5,-1,-2,-3,5,3,1,-2,3,"w1819","Motorized",0,"Wed","weekday"
"3904",2019-03-13,"Cement Creek","4","4","3",18.1,0.7,74,4,24,24.5,-1,-2,-3,5,3,1,-2,3,"w1819","Hybrid",0,"Wed","weekday"
"3905",2019-03-14,"Cement Creek","4","4","3",18.1,0,74,0,17,24.5,4,-1,-2,-3,4,3,1,-2,"w1819","Non.motorized",3,"Thu","weekday"
"3906",2019-03-14,"Cement Creek","4","4","3",18.1,0,74,0,17,24.5,4,-1,-2,-3,4,3,1,-2,"w1819","Mechanized",0,"Thu","weekday"
"3907",2019-03-14,"Cement Creek","4","4","3",18.1,0,74,0,17,24.5,4,-1,-2,-3,4,3,1,-2,"w1819","Motorized",2,"Thu","weekday"
"3908",2019-03-14,"Cement Creek","4","4","3",18.1,0,74,0,17,24.5,4,-1,-2,-3,4,3,1,-2,"w1819","Hybrid",0,"Thu","weekday"
"3909",2019-03-15,"Cement Creek","3","3","2",18.1,0,72,-2,18,25.1,0,4,-1,-2,-2,2,1,-1,"w1819","Non.motorized",13,"Fri","weekday"
"3910",2019-03-15,"Cement Creek","3","3","2",18.1,0,72,-2,18,25.1,0,4,-1,-2,-2,2,1,-1,"w1819","Mechanized",1,"Fri","weekday"
"3911",2019-03-15,"Cement Creek","3","3","2",18.1,0,72,-2,18,25.1,0,4,-1,-2,-2,2,1,-1,"w1819","Motorized",2,"Fri","weekday"
"3912",2019-03-15,"Cement Creek","3","3","2",18.1,0,72,-2,18,25.1,0,4,-1,-2,-2,2,1,-1,"w1819","Hybrid",0,"Fri","weekday"
"3913",2019-03-16,"Cement Creek","3","3","2",18.2,0.1,70,-2,26,26,-2,0,4,-1,-4,-4,0,-1,"w1819","Non.motorized",37,"Sat","weekend"
"3914",2019-03-16,"Cement Creek","3","3","2",18.2,0.1,70,-2,26,26,-2,0,4,-1,-4,-4,0,-1,"w1819","Mechanized",0,"Sat","weekend"
"3915",2019-03-16,"Cement Creek","3","3","2",18.2,0.1,70,-2,26,26,-2,0,4,-1,-4,-4,0,-1,"w1819","Motorized",8,"Sat","weekend"
"3916",2019-03-16,"Cement Creek","3","3","2",18.2,0.1,70,-2,26,26,-2,0,4,-1,-4,-4,0,-1,"w1819","Hybrid",0,"Sat","weekend"
"3917",2019-03-17,"Cement Creek","3","3","2",18.2,0,69,-1,28,26.4,-2,-2,0,4,-3,-5,-5,-1,"w1819","Non.motorized",30,"Sun","weekend"
"3918",2019-03-17,"Cement Creek","3","3","2",18.2,0,69,-1,28,26.4,-2,-2,0,4,-3,-5,-5,-1,"w1819","Mechanized",0,"Sun","weekend"
"3919",2019-03-17,"Cement Creek","3","3","2",18.2,0,69,-1,28,26.4,-2,-2,0,4,-3,-5,-5,-1,"w1819","Motorized",6,"Sun","weekend"
"3920",2019-03-17,"Cement Creek","3","3","2",18.2,0,69,-1,28,26.4,-2,-2,0,4,-3,-5,-5,-1,"w1819","Hybrid",0,"Sun","weekend"
"3921",2019-03-18,"Cement Creek","2","2","2",18.3,0.1,68,-1,29,26.9,-1,-2,-2,0,-2,-4,-6,-6,"w1819","Non.motorized",14,"Mon","weekday"
"3922",2019-03-18,"Cement Creek","2","2","2",18.3,0.1,68,-1,29,26.9,-1,-2,-2,0,-2,-4,-6,-6,"w1819","Mechanized",0,"Mon","weekday"
"3923",2019-03-18,"Cement Creek","2","2","2",18.3,0.1,68,-1,29,26.9,-1,-2,-2,0,-2,-4,-6,-6,"w1819","Motorized",1,"Mon","weekday"
"3924",2019-03-18,"Cement Creek","2","2","2",18.3,0.1,68,-1,29,26.9,-1,-2,-2,0,-2,-4,-6,-6,"w1819","Hybrid",0,"Mon","weekday"
"3925",2019-03-19,"Cement Creek","2","2","2",18.3,0,67,-1,28,27.3,-1,-1,-2,-2,-2,-3,-5,-7,"w1819","Non.motorized",12,"Tue","weekday"
"3926",2019-03-19,"Cement Creek","2","2","2",18.3,0,67,-1,28,27.3,-1,-1,-2,-2,-2,-3,-5,-7,"w1819","Mechanized",1,"Tue","weekday"
"3927",2019-03-19,"Cement Creek","2","2","2",18.3,0,67,-1,28,27.3,-1,-1,-2,-2,-2,-3,-5,-7,"w1819","Motorized",4,"Tue","weekday"
"3928",2019-03-19,"Cement Creek","2","2","2",18.3,0,67,-1,28,27.3,-1,-1,-2,-2,-2,-3,-5,-7,"w1819","Hybrid",0,"Tue","weekday"
"3929",2019-03-20,"Cement Creek","2","2","2",18.3,0,66,-1,30,27.7,-1,-1,-1,-2,-2,-3,-4,-6,"w1819","Non.motorized",6,"Wed","weekday"
"3930",2019-03-20,"Cement Creek","2","2","2",18.3,0,66,-1,30,27.7,-1,-1,-1,-2,-2,-3,-4,-6,"w1819","Mechanized",0,"Wed","weekday"
"3931",2019-03-20,"Cement Creek","2","2","2",18.3,0,66,-1,30,27.7,-1,-1,-1,-2,-2,-3,-4,-6,"w1819","Motorized",2,"Wed","weekday"
"3932",2019-03-20,"Cement Creek","2","2","2",18.3,0,66,-1,30,27.7,-1,-1,-1,-2,-2,-3,-4,-6,"w1819","Hybrid",0,"Wed","weekday"
"3933",2019-03-21,"Cement Creek","2","2","2",18.4,0.1,65,-1,33,28.3,-1,-1,-1,-1,-2,-3,-4,-5,"w1819","Non.motorized",6,"Thu","weekday"
"3934",2019-03-21,"Cement Creek","2","2","2",18.4,0.1,65,-1,33,28.3,-1,-1,-1,-1,-2,-3,-4,-5,"w1819","Mechanized",0,"Thu","weekday"
"3935",2019-03-21,"Cement Creek","2","2","2",18.4,0.1,65,-1,33,28.3,-1,-1,-1,-1,-2,-3,-4,-5,"w1819","Motorized",3,"Thu","weekday"
"3936",2019-03-21,"Cement Creek","2","2","2",18.4,0.1,65,-1,33,28.3,-1,-1,-1,-1,-2,-3,-4,-5,"w1819","Hybrid",0,"Thu","weekday"
"3937",2019-03-22,"Cement Creek","3","3","2",18.4,0,64,-1,28,28.8,-1,-1,-1,-1,-2,-3,-4,-5,"w1819","Non.motorized",13,"Fri","weekday"
"3938",2019-03-22,"Cement Creek","3","3","2",18.4,0,64,-1,28,28.8,-1,-1,-1,-1,-2,-3,-4,-5,"w1819","Mechanized",0,"Fri","weekday"
"3939",2019-03-22,"Cement Creek","3","3","2",18.4,0,64,-1,28,28.8,-1,-1,-1,-1,-2,-3,-4,-5,"w1819","Motorized",5,"Fri","weekday"
"3940",2019-03-22,"Cement Creek","3","3","2",18.4,0,64,-1,28,28.8,-1,-1,-1,-1,-2,-3,-4,-5,"w1819","Hybrid",0,"Fri","weekday"
"3941",2019-03-23,"Cement Creek","2","2","1",18.4,0,65,1,28,28.3,-1,-1,-1,-1,0,-1,-2,-3,"w1819","Non.motorized",35,"Sat","weekend"
"3942",2019-03-23,"Cement Creek","2","2","1",18.4,0,65,1,28,28.3,-1,-1,-1,-1,0,-1,-2,-3,"w1819","Mechanized",0,"Sat","weekend"
"3943",2019-03-23,"Cement Creek","2","2","1",18.4,0,65,1,28,28.3,-1,-1,-1,-1,0,-1,-2,-3,"w1819","Motorized",7,"Sat","weekend"
"3944",2019-03-23,"Cement Creek","2","2","1",18.4,0,65,1,28,28.3,-1,-1,-1,-1,0,-1,-2,-3,"w1819","Hybrid",2,"Sat","weekend"
"3945",2019-03-24,"Cement Creek","2","2","1",18.4,0,64,-1,29,28.8,1,-1,-1,-1,0,-1,-2,-3,"w1819","Non.motorized",28,"Sun","weekend"
"3946",2019-03-24,"Cement Creek","2","2","1",18.4,0,64,-1,29,28.8,1,-1,-1,-1,0,-1,-2,-3,"w1819","Mechanized",4,"Sun","weekend"
"3947",2019-03-24,"Cement Creek","2","2","1",18.4,0,64,-1,29,28.8,1,-1,-1,-1,0,-1,-2,-3,"w1819","Motorized",1,"Sun","weekend"
"3948",2019-03-24,"Cement Creek","2","2","1",18.4,0,64,-1,29,28.8,1,-1,-1,-1,0,-1,-2,-3,"w1819","Hybrid",0,"Sun","weekend"
"3949",2019-03-25,"Cement Creek","2","2","2",18.6,0.2,64,0,31,29.1,-1,1,-1,-1,-1,0,-1,-2,"w1819","Non.motorized",13,"Mon","weekday"
"3950",2019-03-25,"Cement Creek","2","2","2",18.6,0.2,64,0,31,29.1,-1,1,-1,-1,-1,0,-1,-2,"w1819","Mechanized",0,"Mon","weekday"
"3951",2019-03-25,"Cement Creek","2","2","2",18.6,0.2,64,0,31,29.1,-1,1,-1,-1,-1,0,-1,-2,"w1819","Motorized",4,"Mon","weekday"
"3952",2019-03-25,"Cement Creek","2","2","2",18.6,0.2,64,0,31,29.1,-1,1,-1,-1,-1,0,-1,-2,"w1819","Hybrid",0,"Mon","weekday"
"3953",2019-03-26,"Cement Creek","2","2","2",18.9,0.3,63,-1,36,30,0,-1,1,-1,-1,-2,-1,-2,"w1819","Non.motorized",6,"Tue","weekday"
"3954",2019-03-26,"Cement Creek","2","2","2",18.9,0.3,63,-1,36,30,0,-1,1,-1,-1,-2,-1,-2,"w1819","Mechanized",0,"Tue","weekday"
"3955",2019-03-26,"Cement Creek","2","2","2",18.9,0.3,63,-1,36,30,0,-1,1,-1,-1,-2,-1,-2,"w1819","Motorized",5,"Tue","weekday"
"3956",2019-03-26,"Cement Creek","2","2","2",18.9,0.3,63,-1,36,30,0,-1,1,-1,-1,-2,-1,-2,"w1819","Hybrid",0,"Tue","weekday"
"3957",2019-03-27,"Cement Creek","1","2","2",18.9,0,62,-1,42,30.5,-1,0,-1,1,-2,-2,-3,-2,"w1819","Non.motorized",20,"Wed","weekday"
"3958",2019-03-27,"Cement Creek","1","2","2",18.9,0,62,-1,42,30.5,-1,0,-1,1,-2,-2,-3,-2,"w1819","Mechanized",0,"Wed","weekday"
"3959",2019-03-27,"Cement Creek","1","2","2",18.9,0,62,-1,42,30.5,-1,0,-1,1,-2,-2,-3,-2,"w1819","Motorized",6,"Wed","weekday"
"3960",2019-03-27,"Cement Creek","1","2","2",18.9,0,62,-1,42,30.5,-1,0,-1,1,-2,-2,-3,-2,"w1819","Hybrid",0,"Wed","weekday"
"3961",2019-03-28,"Cement Creek","1","2","2",18.9,0,60,-2,40,31.5,-1,-1,0,-1,-3,-4,-4,-5,"w1819","Non.motorized",17,"Thu","weekday"
"3962",2019-03-28,"Cement Creek","1","2","2",18.9,0,60,-2,40,31.5,-1,-1,0,-1,-3,-4,-4,-5,"w1819","Mechanized",0,"Thu","weekday"
"3963",2019-03-28,"Cement Creek","1","2","2",18.9,0,60,-2,40,31.5,-1,-1,0,-1,-3,-4,-4,-5,"w1819","Motorized",1,"Thu","weekday"
"3964",2019-03-28,"Cement Creek","1","2","2",18.9,0,60,-2,40,31.5,-1,-1,0,-1,-3,-4,-4,-5,"w1819","Hybrid",0,"Thu","weekday"
"3965",2019-03-29,"Cement Creek","1","1","1",19,0.1,58,-2,26,32.8,-2,-1,-1,0,-4,-5,-6,-6,"w1819","Non.motorized",19,"Fri","weekday"
"3966",2019-03-29,"Cement Creek","1","1","1",19,0.1,58,-2,26,32.8,-2,-1,-1,0,-4,-5,-6,-6,"w1819","Mechanized",1,"Fri","weekday"
"3967",2019-03-29,"Cement Creek","1","1","1",19,0.1,58,-2,26,32.8,-2,-1,-1,0,-4,-5,-6,-6,"w1819","Motorized",1,"Fri","weekday"
"3968",2019-03-29,"Cement Creek","1","1","1",19,0.1,58,-2,26,32.8,-2,-1,-1,0,-4,-5,-6,-6,"w1819","Hybrid",0,"Fri","weekday"
"3969",2019-03-30,"Cement Creek","1","1","1",19.1,0.1,61,3,24,31.3,-2,-2,-1,-1,1,-1,-2,-3,"w1819","Non.motorized",35,"Sat","weekend"
"3970",2019-03-30,"Cement Creek","1","1","1",19.1,0.1,61,3,24,31.3,-2,-2,-1,-1,1,-1,-2,-3,"w1819","Mechanized",0,"Sat","weekend"
"3971",2019-03-30,"Cement Creek","1","1","1",19.1,0.1,61,3,24,31.3,-2,-2,-1,-1,1,-1,-2,-3,"w1819","Motorized",1,"Sat","weekend"
"3972",2019-03-30,"Cement Creek","1","1","1",19.1,0.1,61,3,24,31.3,-2,-2,-1,-1,1,-1,-2,-3,"w1819","Hybrid",0,"Sat","weekend"
"3973",2019-03-31,"Cement Creek","1","1","1",19.1,0,59,-2,24,32.4,3,-2,-2,-1,1,-1,-3,-4,"w1819","Non.motorized",13,"Sun","weekend"
"3974",2019-03-31,"Cement Creek","1","1","1",19.1,0,59,-2,24,32.4,3,-2,-2,-1,1,-1,-3,-4,"w1819","Mechanized",3,"Sun","weekend"
"3975",2019-03-31,"Cement Creek","1","1","1",19.1,0,59,-2,24,32.4,3,-2,-2,-1,1,-1,-3,-4,"w1819","Motorized",2,"Sun","weekend"
"3976",2019-03-31,"Cement Creek","1","1","1",19.1,0,59,-2,24,32.4,3,-2,-2,-1,1,-1,-3,-4,"w1819","Hybrid",0,"Sun","weekend"
"3977",2019-04-01,"Cement Creek","2","1","1",19.1,0,58,-1,29,32.9,-2,3,-2,-2,-3,0,-2,-4,"w1819","Non.motorized",13,"Mon","weekday"
"3978",2019-04-01,"Cement Creek","2","1","1",19.1,0,58,-1,29,32.9,-2,3,-2,-2,-3,0,-2,-4,"w1819","Mechanized",0,"Mon","weekday"
"3979",2019-04-01,"Cement Creek","2","1","1",19.1,0,58,-1,29,32.9,-2,3,-2,-2,-3,0,-2,-4,"w1819","Motorized",3,"Mon","weekday"
"3980",2019-04-01,"Cement Creek","2","1","1",19.1,0,58,-1,29,32.9,-2,3,-2,-2,-3,0,-2,-4,"w1819","Hybrid",0,"Mon","weekday"
"3981",2019-04-02,"Cement Creek","1","1","1",19.1,0,58,0,33,32.9,-1,-2,3,-2,-1,-3,0,-2,"w1819","Non.motorized",9,"Tue","weekday"
"3982",2019-04-02,"Cement Creek","1","1","1",19.1,0,58,0,33,32.9,-1,-2,3,-2,-1,-3,0,-2,"w1819","Mechanized",1,"Tue","weekday"
"3983",2019-04-02,"Cement Creek","1","1","1",19.1,0,58,0,33,32.9,-1,-2,3,-2,-1,-3,0,-2,"w1819","Motorized",0,"Tue","weekday"
"3984",2019-04-02,"Cement Creek","1","1","1",19.1,0,58,0,33,32.9,-1,-2,3,-2,-1,-3,0,-2,"w1819","Hybrid",0,"Tue","weekday"
"3985",2019-04-03,"Cement Creek","2","1","1",19.2,0.1,58,0,31,33.1,0,-1,-2,3,0,-1,-3,0,"w1819","Non.motorized",10,"Wed","weekday"
"3986",2019-04-03,"Cement Creek","2","1","1",19.2,0.1,58,0,31,33.1,0,-1,-2,3,0,-1,-3,0,"w1819","Mechanized",0,"Wed","weekday"
"3987",2019-04-03,"Cement Creek","2","1","1",19.2,0.1,58,0,31,33.1,0,-1,-2,3,0,-1,-3,0,"w1819","Motorized",3,"Wed","weekday"
"3988",2019-04-03,"Cement Creek","2","1","1",19.2,0.1,58,0,31,33.1,0,-1,-2,3,0,-1,-3,0,"w1819","Hybrid",0,"Wed","weekday"
"3989",2019-04-04,"Cement Creek","2","1","1",19.4,0.2,59,1,35,32.9,0,0,-1,-2,1,1,0,-2,"w1819","Non.motorized",8,"Thu","weekday"
"3990",2019-04-04,"Cement Creek","2","1","1",19.4,0.2,59,1,35,32.9,0,0,-1,-2,1,1,0,-2,"w1819","Mechanized",0,"Thu","weekday"
"3991",2019-04-04,"Cement Creek","2","1","1",19.4,0.2,59,1,35,32.9,0,0,-1,-2,1,1,0,-2,"w1819","Motorized",1,"Thu","weekday"
"3992",2019-04-04,"Cement Creek","2","1","1",19.4,0.2,59,1,35,32.9,0,0,-1,-2,1,1,0,-2,"w1819","Hybrid",0,"Thu","weekday"
"3993",2019-04-05,"Cement Creek","1","1","1",19.4,0,57,-2,38,34,1,0,0,-1,-1,-1,-1,-2,"w1819","Non.motorized",11,"Fri","weekday"
"3994",2019-04-05,"Cement Creek","1","1","1",19.4,0,57,-2,38,34,1,0,0,-1,-1,-1,-1,-2,"w1819","Mechanized",5,"Fri","weekday"
"3995",2019-04-05,"Cement Creek","1","1","1",19.4,0,57,-2,38,34,1,0,0,-1,-1,-1,-1,-2,"w1819","Motorized",2,"Fri","weekday"
"3996",2019-04-05,"Cement Creek","1","1","1",19.4,0,57,-2,38,34,1,0,0,-1,-1,-1,-1,-2,"w1819","Hybrid",0,"Fri","weekday"
"3997",2019-04-06,"Cement Creek","1","1","1",19.3,-0.1,57,0,35,33.9,-2,1,0,0,-2,-1,-1,-1,"w1819","Non.motorized",27,"Sat","weekend"
"3998",2019-04-06,"Cement Creek","1","1","1",19.3,-0.1,57,0,35,33.9,-2,1,0,0,-2,-1,-1,-1,"w1819","Mechanized",2,"Sat","weekend"
"3999",2019-04-06,"Cement Creek","1","1","1",19.3,-0.1,57,0,35,33.9,-2,1,0,0,-2,-1,-1,-1,"w1819","Motorized",5,"Sat","weekend"
"4000",2019-04-06,"Cement Creek","1","1","1",19.3,-0.1,57,0,35,33.9,-2,1,0,0,-2,-1,-1,-1,"w1819","Hybrid",0,"Sat","weekend"
"4001",2019-04-07,"Cement Creek","1","1","1",19.1,-0.2,57,0,37,33.5,0,-2,1,0,0,-2,-1,-1,"w1819","Non.motorized",12,"Sun","weekend"
"4002",2019-04-07,"Cement Creek","1","1","1",19.1,-0.2,57,0,37,33.5,0,-2,1,0,0,-2,-1,-1,"w1819","Mechanized",2,"Sun","weekend"
"4003",2019-04-07,"Cement Creek","1","1","1",19.1,-0.2,57,0,37,33.5,0,-2,1,0,0,-2,-1,-1,"w1819","Motorized",2,"Sun","weekend"
"4004",2019-04-07,"Cement Creek","1","1","1",19.1,-0.2,57,0,37,33.5,0,-2,1,0,0,-2,-1,-1,"w1819","Hybrid",0,"Sun","weekend"
"4005",2019-04-08,"Cement Creek","1","2","2",19.3,0.2,54,-3,41,35.7,0,0,-2,1,-3,-3,-5,-4,"w1819","Non.motorized",14,"Mon","weekday"
"4006",2019-04-08,"Cement Creek","1","2","2",19.3,0.2,54,-3,41,35.7,0,0,-2,1,-3,-3,-5,-4,"w1819","Mechanized",0,"Mon","weekday"
"4007",2019-04-08,"Cement Creek","1","2","2",19.3,0.2,54,-3,41,35.7,0,0,-2,1,-3,-3,-5,-4,"w1819","Motorized",1,"Mon","weekday"
"4008",2019-04-08,"Cement Creek","1","2","2",19.3,0.2,54,-3,41,35.7,0,0,-2,1,-3,-3,-5,-4,"w1819","Hybrid",0,"Mon","weekday"
"4009",2019-04-09,"Cement Creek","1","2","2",19.3,0,53,-1,43,36.4,-3,0,0,-2,-4,-4,-4,-6,"w1819","Non.motorized",6,"Tue","weekday"
"4010",2019-04-09,"Cement Creek","1","2","2",19.3,0,53,-1,43,36.4,-3,0,0,-2,-4,-4,-4,-6,"w1819","Mechanized",0,"Tue","weekday"
"4011",2019-04-09,"Cement Creek","1","2","2",19.3,0,53,-1,43,36.4,-3,0,0,-2,-4,-4,-4,-6,"w1819","Motorized",2,"Tue","weekday"
"4012",2019-04-09,"Cement Creek","1","2","2",19.3,0,53,-1,43,36.4,-3,0,0,-2,-4,-4,-4,-6,"w1819","Hybrid",0,"Tue","weekday"
"4013",2019-04-10,"Cement Creek","2","2","1",19,-0.3,51,-2,30,37.3,-1,-3,0,0,-3,-6,-6,-6,"w1819","Non.motorized",2,"Wed","weekday"
"4014",2019-04-10,"Cement Creek","2","2","1",19,-0.3,51,-2,30,37.3,-1,-3,0,0,-3,-6,-6,-6,"w1819","Mechanized",0,"Wed","weekday"
"4015",2019-04-10,"Cement Creek","2","2","1",19,-0.3,51,-2,30,37.3,-1,-3,0,0,-3,-6,-6,-6,"w1819","Motorized",0,"Wed","weekday"
"4016",2019-04-10,"Cement Creek","2","2","1",19,-0.3,51,-2,30,37.3,-1,-3,0,0,-3,-6,-6,-6,"w1819","Hybrid",0,"Wed","weekday"
"4017",2019-04-11,"Cement Creek","3","3","2",18.9,-0.1,53,2,20,35.7,-2,-1,-3,0,0,-1,-4,-4,"w1819","Non.motorized",4,"Thu","weekday"
"4018",2019-04-11,"Cement Creek","3","3","2",18.9,-0.1,53,2,20,35.7,-2,-1,-3,0,0,-1,-4,-4,"w1819","Mechanized",0,"Thu","weekday"
"4019",2019-04-11,"Cement Creek","3","3","2",18.9,-0.1,53,2,20,35.7,-2,-1,-3,0,0,-1,-4,-4,"w1819","Motorized",4,"Thu","weekday"
"4020",2019-04-11,"Cement Creek","3","3","2",18.9,-0.1,53,2,20,35.7,-2,-1,-3,0,0,-1,-4,-4,"w1819","Hybrid",0,"Thu","weekday"
"4021",2019-04-12,"Cement Creek","2","2","1",18.7,-0.2,53,0,24,35.3,2,-2,-1,-3,2,0,-1,-4,"w1819","Non.motorized",13,"Fri","weekday"
"4022",2019-04-12,"Cement Creek","2","2","1",18.7,-0.2,53,0,24,35.3,2,-2,-1,-3,2,0,-1,-4,"w1819","Mechanized",1,"Fri","weekday"
"4023",2019-04-12,"Cement Creek","2","2","1",18.7,-0.2,53,0,24,35.3,2,-2,-1,-3,2,0,-1,-4,"w1819","Motorized",0,"Fri","weekday"
"4024",2019-04-12,"Cement Creek","2","2","1",18.7,-0.2,53,0,24,35.3,2,-2,-1,-3,2,0,-1,-4,"w1819","Hybrid",0,"Fri","weekday"
"4025",2019-04-13,"Cement Creek","1","1","1",18.8,0.1,52,-1,27,36.2,0,2,-2,-1,-1,1,-1,-2,"w1819","Non.motorized",17,"Sat","weekend"
"4026",2019-04-13,"Cement Creek","1","1","1",18.8,0.1,52,-1,27,36.2,0,2,-2,-1,-1,1,-1,-2,"w1819","Mechanized",3,"Sat","weekend"
"4027",2019-04-13,"Cement Creek","1","1","1",18.8,0.1,52,-1,27,36.2,0,2,-2,-1,-1,1,-1,-2,"w1819","Motorized",3,"Sat","weekend"
"4028",2019-04-13,"Cement Creek","1","1","1",18.8,0.1,52,-1,27,36.2,0,2,-2,-1,-1,1,-1,-2,"w1819","Hybrid",1,"Sat","weekend"
"4029",2019-04-14,"Cement Creek","1","1","1",18.7,-0.1,51,-1,35,36.7,-1,0,2,-2,-2,-2,0,-2,"w1819","Non.motorized",10,"Sun","weekend"
"4030",2019-04-14,"Cement Creek","1","1","1",18.7,-0.1,51,-1,35,36.7,-1,0,2,-2,-2,-2,0,-2,"w1819","Mechanized",1,"Sun","weekend"
"4031",2019-04-14,"Cement Creek","1","1","1",18.7,-0.1,51,-1,35,36.7,-1,0,2,-2,-2,-2,0,-2,"w1819","Motorized",8,"Sun","weekend"
"4032",2019-04-14,"Cement Creek","1","1","1",18.7,-0.1,51,-1,35,36.7,-1,0,2,-2,-2,-2,0,-2,"w1819","Hybrid",5,"Sun","weekend"
"4033",2019-04-15,"Cement Creek",NA,NA,NA,18.6,-0.1,50,-1,41,37.2,-1,-1,0,2,-2,-3,-3,-1,"w1819","Non.motorized",6,"Mon","weekday"
"4034",2019-04-15,"Cement Creek",NA,NA,NA,18.6,-0.1,50,-1,41,37.2,-1,-1,0,2,-2,-3,-3,-1,"w1819","Mechanized",0,"Mon","weekday"
"4035",2019-04-15,"Cement Creek",NA,NA,NA,18.6,-0.1,50,-1,41,37.2,-1,-1,0,2,-2,-3,-3,-1,"w1819","Motorized",1,"Mon","weekday"
"4036",2019-04-15,"Cement Creek",NA,NA,NA,18.6,-0.1,50,-1,41,37.2,-1,-1,0,2,-2,-3,-3,-1,"w1819","Hybrid",0,"Mon","weekday"
"4037",2018-12-01,"Gothic Rd","3","3","2",3.3,0.2,19,1,16,17.4,0,0,0,0,1,1,1,1,"w1819","Non.motorized",23,"Sat","weekend"
"4038",2018-12-01,"Gothic Rd","3","3","2",3.3,0.2,19,1,16,17.4,0,0,0,0,1,1,1,1,"w1819","Mechanized",1,"Sat","weekend"
"4039",2018-12-01,"Gothic Rd","3","3","2",3.3,0.2,19,1,16,17.4,0,0,0,0,1,1,1,1,"w1819","Motorized",0,"Sat","weekend"
"4040",2018-12-01,"Gothic Rd","3","3","2",3.3,0.2,19,1,16,17.4,0,0,0,0,1,1,1,1,"w1819","Hybrid",0,"Sat","weekend"
"4041",2018-12-02,"Gothic Rd","3","3","3",3.3,0,20,1,14,16.5,1,0,0,0,2,2,2,2,"w1819","Non.motorized",25,"Sun","weekend"
"4042",2018-12-02,"Gothic Rd","3","3","3",3.3,0,20,1,14,16.5,1,0,0,0,2,2,2,2,"w1819","Mechanized",0,"Sun","weekend"
"4043",2018-12-02,"Gothic Rd","3","3","3",3.3,0,20,1,14,16.5,1,0,0,0,2,2,2,2,"w1819","Motorized",0,"Sun","weekend"
"4044",2018-12-02,"Gothic Rd","3","3","3",3.3,0,20,1,14,16.5,1,0,0,0,2,2,2,2,"w1819","Hybrid",0,"Sun","weekend"
"4045",2018-12-03,"Gothic Rd","3","3","2",3.4,0.1,19,-1,13,17.9,1,1,0,0,0,1,1,1,"w1819","Non.motorized",14,"Mon","weekday"
"4046",2018-12-03,"Gothic Rd","3","3","2",3.4,0.1,19,-1,13,17.9,1,1,0,0,0,1,1,1,"w1819","Mechanized",0,"Mon","weekday"
"4047",2018-12-03,"Gothic Rd","3","3","2",3.4,0.1,19,-1,13,17.9,1,1,0,0,0,1,1,1,"w1819","Motorized",1,"Mon","weekday"
"4048",2018-12-03,"Gothic Rd","3","3","2",3.4,0.1,19,-1,13,17.9,1,1,0,0,0,1,1,1,"w1819","Hybrid",0,"Mon","weekday"
"4049",2018-12-04,"Gothic Rd","3","3","2",3.5,0.1,20,1,8,17.5,-1,1,1,0,0,1,2,2,"w1819","Non.motorized",9,"Tue","weekday"
"4050",2018-12-04,"Gothic Rd","3","3","2",3.5,0.1,20,1,8,17.5,-1,1,1,0,0,1,2,2,"w1819","Mechanized",1,"Tue","weekday"
"4051",2018-12-04,"Gothic Rd","3","3","2",3.5,0.1,20,1,8,17.5,-1,1,1,0,0,1,2,2,"w1819","Motorized",1,"Tue","weekday"
"4052",2018-12-04,"Gothic Rd","3","3","2",3.5,0.1,20,1,8,17.5,-1,1,1,0,0,1,2,2,"w1819","Hybrid",1,"Tue","weekday"
"4053",2018-12-05,"Gothic Rd","3","3","2",3.5,0,19,-1,21,18.4,1,-1,1,1,0,-1,0,1,"w1819","Non.motorized",19,"Wed","weekday"
"4054",2018-12-05,"Gothic Rd","3","3","2",3.5,0,19,-1,21,18.4,1,-1,1,1,0,-1,0,1,"w1819","Mechanized",0,"Wed","weekday"
"4055",2018-12-05,"Gothic Rd","3","3","2",3.5,0,19,-1,21,18.4,1,-1,1,1,0,-1,0,1,"w1819","Motorized",0,"Wed","weekday"
"4056",2018-12-05,"Gothic Rd","3","3","2",3.5,0,19,-1,21,18.4,1,-1,1,1,0,-1,0,1,"w1819","Hybrid",0,"Wed","weekday"
"4057",2018-12-06,"Gothic Rd","2","2","2",3.7,0.2,18,-1,25,20.6,-1,1,-1,1,-2,-1,-2,-1,"w1819","Non.motorized",14,"Thu","weekday"
"4058",2018-12-06,"Gothic Rd","2","2","2",3.7,0.2,18,-1,25,20.6,-1,1,-1,1,-2,-1,-2,-1,"w1819","Mechanized",0,"Thu","weekday"
"4059",2018-12-06,"Gothic Rd","2","2","2",3.7,0.2,18,-1,25,20.6,-1,1,-1,1,-2,-1,-2,-1,"w1819","Motorized",2,"Thu","weekday"
"4060",2018-12-06,"Gothic Rd","2","2","2",3.7,0.2,18,-1,25,20.6,-1,1,-1,1,-2,-1,-2,-1,"w1819","Hybrid",2,"Thu","weekday"
"4061",2018-12-07,"Gothic Rd","2","2","2",3.8,0.1,21,3,23,18.1,-1,-1,1,-1,2,1,2,1,"w1819","Non.motorized",13,"Fri","weekday"
"4062",2018-12-07,"Gothic Rd","2","2","2",3.8,0.1,21,3,23,18.1,-1,-1,1,-1,2,1,2,1,"w1819","Mechanized",0,"Fri","weekday"
"4063",2018-12-07,"Gothic Rd","2","2","2",3.8,0.1,21,3,23,18.1,-1,-1,1,-1,2,1,2,1,"w1819","Motorized",1,"Fri","weekday"
"4064",2018-12-07,"Gothic Rd","2","2","2",3.8,0.1,21,3,23,18.1,-1,-1,1,-1,2,1,2,1,"w1819","Hybrid",0,"Fri","weekday"
"4065",2018-12-08,"Gothic Rd","2","2","2",3.8,0,20,-1,23,19,3,-1,-1,1,2,1,0,1,"w1819","Non.motorized",38,"Sat","weekend"
"4066",2018-12-08,"Gothic Rd","2","2","2",3.8,0,20,-1,23,19,3,-1,-1,1,2,1,0,1,"w1819","Mechanized",5,"Sat","weekend"
"4067",2018-12-08,"Gothic Rd","2","2","2",3.8,0,20,-1,23,19,3,-1,-1,1,2,1,0,1,"w1819","Motorized",1,"Sat","weekend"
"4068",2018-12-08,"Gothic Rd","2","2","2",3.8,0,20,-1,23,19,3,-1,-1,1,2,1,0,1,"w1819","Hybrid",0,"Sat","weekend"
"4069",2018-12-09,"Gothic Rd","2","2","2",3.8,0,20,0,19,19,-1,3,-1,-1,-1,2,1,0,"w1819","Non.motorized",32,"Sun","weekend"
"4070",2018-12-09,"Gothic Rd","2","2","2",3.8,0,20,0,19,19,-1,3,-1,-1,-1,2,1,0,"w1819","Mechanized",6,"Sun","weekend"
"4071",2018-12-09,"Gothic Rd","2","2","2",3.8,0,20,0,19,19,-1,3,-1,-1,-1,2,1,0,"w1819","Motorized",0,"Sun","weekend"
"4072",2018-12-09,"Gothic Rd","2","2","2",3.8,0,20,0,19,19,-1,3,-1,-1,-1,2,1,0,"w1819","Hybrid",0,"Sun","weekend"
"4073",2018-12-10,"Gothic Rd","2","2","2",3.8,0,20,0,21,19,0,-1,3,-1,0,-1,2,1,"w1819","Non.motorized",12,"Mon","weekday"
"4074",2018-12-10,"Gothic Rd","2","2","2",3.8,0,20,0,21,19,0,-1,3,-1,0,-1,2,1,"w1819","Mechanized",2,"Mon","weekday"
"4075",2018-12-10,"Gothic Rd","2","2","2",3.8,0,20,0,21,19,0,-1,3,-1,0,-1,2,1,"w1819","Motorized",2,"Mon","weekday"
"4076",2018-12-10,"Gothic Rd","2","2","2",3.8,0,20,0,21,19,0,-1,3,-1,0,-1,2,1,"w1819","Hybrid",0,"Mon","weekday"
"4077",2018-12-11,"Gothic Rd","2","2","2",3.9,0.1,19,-1,27,20.5,0,0,-1,3,-1,-1,-2,1,"w1819","Non.motorized",18,"Tue","weekday"
"4078",2018-12-11,"Gothic Rd","2","2","2",3.9,0.1,19,-1,27,20.5,0,0,-1,3,-1,-1,-2,1,"w1819","Mechanized",1,"Tue","weekday"
"4079",2018-12-11,"Gothic Rd","2","2","2",3.9,0.1,19,-1,27,20.5,0,0,-1,3,-1,-1,-2,1,"w1819","Motorized",1,"Tue","weekday"
"4080",2018-12-11,"Gothic Rd","2","2","2",3.9,0.1,19,-1,27,20.5,0,0,-1,3,-1,-1,-2,1,"w1819","Hybrid",0,"Tue","weekday"
"4081",2018-12-12,"Gothic Rd","2","2","1",3.9,0,19,0,21,20.5,-1,0,0,-1,-1,-1,-1,-2,"w1819","Non.motorized",13,"Wed","weekday"
"4082",2018-12-12,"Gothic Rd","2","2","1",3.9,0,19,0,21,20.5,-1,0,0,-1,-1,-1,-1,-2,"w1819","Mechanized",1,"Wed","weekday"
"4083",2018-12-12,"Gothic Rd","2","2","1",3.9,0,19,0,21,20.5,-1,0,0,-1,-1,-1,-1,-2,"w1819","Motorized",0,"Wed","weekday"
"4084",2018-12-12,"Gothic Rd","2","2","1",3.9,0,19,0,21,20.5,-1,0,0,-1,-1,-1,-1,-2,"w1819","Hybrid",0,"Wed","weekday"
"4085",2018-12-13,"Gothic Rd","3","3","2",4,0.1,21,2,15,19,0,-1,0,0,2,1,1,1,"w1819","Non.motorized",9,"Thu","weekday"
"4086",2018-12-13,"Gothic Rd","3","3","2",4,0.1,21,2,15,19,0,-1,0,0,2,1,1,1,"w1819","Mechanized",2,"Thu","weekday"
"4087",2018-12-13,"Gothic Rd","3","3","2",4,0.1,21,2,15,19,0,-1,0,0,2,1,1,1,"w1819","Motorized",0,"Thu","weekday"
"4088",2018-12-13,"Gothic Rd","3","3","2",4,0.1,21,2,15,19,0,-1,0,0,2,1,1,1,"w1819","Hybrid",0,"Thu","weekday"
"4089",2018-12-14,"Gothic Rd","3","3","2",4,0,20,-1,24,20,2,0,-1,0,1,1,0,0,"w1819","Non.motorized",0,"Fri","weekday"
"4090",2018-12-14,"Gothic Rd","3","3","2",4,0,20,-1,24,20,2,0,-1,0,1,1,0,0,"w1819","Mechanized",0,"Fri","weekday"
"4091",2018-12-14,"Gothic Rd","3","3","2",4,0,20,-1,24,20,2,0,-1,0,1,1,0,0,"w1819","Motorized",0,"Fri","weekday"
"4092",2018-12-14,"Gothic Rd","3","3","2",4,0,20,-1,24,20,2,0,-1,0,1,1,0,0,"w1819","Hybrid",0,"Fri","weekday"
"4093",2018-12-15,"Gothic Rd","2","2","2",4,0,20,0,29,20,-1,2,0,-1,-1,1,1,0,"w1819","Non.motorized",9,"Sat","weekend"
"4094",2018-12-15,"Gothic Rd","2","2","2",4,0,20,0,29,20,-1,2,0,-1,-1,1,1,0,"w1819","Mechanized",6,"Sat","weekend"
"4095",2018-12-15,"Gothic Rd","2","2","2",4,0,20,0,29,20,-1,2,0,-1,-1,1,1,0,"w1819","Motorized",1,"Sat","weekend"
"4096",2018-12-15,"Gothic Rd","2","2","2",4,0,20,0,29,20,-1,2,0,-1,-1,1,1,0,"w1819","Hybrid",1,"Sat","weekend"
"4097",2018-12-16,"Gothic Rd","2","2","2",4.1,0.1,19,-1,28,21.6,0,-1,2,0,-1,-2,0,0,"w1819","Non.motorized",63,"Sun","weekend"
"4098",2018-12-16,"Gothic Rd","2","2","2",4.1,0.1,19,-1,28,21.6,0,-1,2,0,-1,-2,0,0,"w1819","Mechanized",6,"Sun","weekend"
"4099",2018-12-16,"Gothic Rd","2","2","2",4.1,0.1,19,-1,28,21.6,0,-1,2,0,-1,-2,0,0,"w1819","Motorized",0,"Sun","weekend"
"4100",2018-12-16,"Gothic Rd","2","2","2",4.1,0.1,19,-1,28,21.6,0,-1,2,0,-1,-2,0,0,"w1819","Hybrid",0,"Sun","weekend"
"4101",2018-12-17,"Gothic Rd","2","2","2",4.1,0,19,0,29,21.6,-1,0,-1,2,-1,-1,-2,0,"w1819","Non.motorized",16,"Mon","weekday"
"4102",2018-12-17,"Gothic Rd","2","2","2",4.1,0,19,0,29,21.6,-1,0,-1,2,-1,-1,-2,0,"w1819","Mechanized",4,"Mon","weekday"
"4103",2018-12-17,"Gothic Rd","2","2","2",4.1,0,19,0,29,21.6,-1,0,-1,2,-1,-1,-2,0,"w1819","Motorized",0,"Mon","weekday"
"4104",2018-12-17,"Gothic Rd","2","2","2",4.1,0,19,0,29,21.6,-1,0,-1,2,-1,-1,-2,0,"w1819","Hybrid",0,"Mon","weekday"
"4105",2018-12-18,"Gothic Rd","2","2","2",4.1,0,19,0,27,21.6,0,-1,0,-1,0,-1,-1,-2,"w1819","Non.motorized",0,"Tue","weekday"
"4106",2018-12-18,"Gothic Rd","2","2","2",4.1,0,19,0,27,21.6,0,-1,0,-1,0,-1,-1,-2,"w1819","Mechanized",0,"Tue","weekday"
"4107",2018-12-18,"Gothic Rd","2","2","2",4.1,0,19,0,27,21.6,0,-1,0,-1,0,-1,-1,-2,"w1819","Motorized",0,"Tue","weekday"
"4108",2018-12-18,"Gothic Rd","2","2","2",4.1,0,19,0,27,21.6,0,-1,0,-1,0,-1,-1,-2,"w1819","Hybrid",0,"Tue","weekday"
"4109",2018-12-19,"Gothic Rd","2","2","2",4.1,0,19,0,24,21.6,0,0,-1,0,0,0,-1,-1,"w1819","Non.motorized",28,"Wed","weekday"
"4110",2018-12-19,"Gothic Rd","2","2","2",4.1,0,19,0,24,21.6,0,0,-1,0,0,0,-1,-1,"w1819","Mechanized",0,"Wed","weekday"
"4111",2018-12-19,"Gothic Rd","2","2","2",4.1,0,19,0,24,21.6,0,0,-1,0,0,0,-1,-1,"w1819","Motorized",0,"Wed","weekday"
"4112",2018-12-19,"Gothic Rd","2","2","2",4.1,0,19,0,24,21.6,0,0,-1,0,0,0,-1,-1,"w1819","Hybrid",0,"Wed","weekday"
"4113",2018-12-20,"Gothic Rd","2","2","1",4.1,0,20,1,25,20.5,0,0,0,-1,1,1,1,0,"w1819","Non.motorized",42,"Thu","weekday"
"4114",2018-12-20,"Gothic Rd","2","2","1",4.1,0,20,1,25,20.5,0,0,0,-1,1,1,1,0,"w1819","Mechanized",2,"Thu","weekday"
"4115",2018-12-20,"Gothic Rd","2","2","1",4.1,0,20,1,25,20.5,0,0,0,-1,1,1,1,0,"w1819","Motorized",1,"Thu","weekday"
"4116",2018-12-20,"Gothic Rd","2","2","1",4.1,0,20,1,25,20.5,0,0,0,-1,1,1,1,0,"w1819","Hybrid",0,"Thu","weekday"
"4117",2018-12-21,"Gothic Rd","2","2","1",4.1,0,19,-1,28,21.6,1,0,0,0,0,0,0,0,"w1819","Non.motorized",46,"Fri","weekday"
"4118",2018-12-21,"Gothic Rd","2","2","1",4.1,0,19,-1,28,21.6,1,0,0,0,0,0,0,0,"w1819","Mechanized",6,"Fri","weekday"
"4119",2018-12-21,"Gothic Rd","2","2","1",4.1,0,19,-1,28,21.6,1,0,0,0,0,0,0,0,"w1819","Motorized",0,"Fri","weekday"
"4120",2018-12-21,"Gothic Rd","2","2","1",4.1,0,19,-1,28,21.6,1,0,0,0,0,0,0,0,"w1819","Hybrid",0,"Fri","weekday"
"4121",2018-12-22,"Gothic Rd","2","2","1",4.2,0.1,19,0,20,22.1,-1,1,0,0,-1,0,0,0,"w1819","Non.motorized",54,"Sat","weekend"
"4122",2018-12-22,"Gothic Rd","2","2","1",4.2,0.1,19,0,20,22.1,-1,1,0,0,-1,0,0,0,"w1819","Mechanized",0,"Sat","weekend"
"4123",2018-12-22,"Gothic Rd","2","2","1",4.2,0.1,19,0,20,22.1,-1,1,0,0,-1,0,0,0,"w1819","Motorized",0,"Sat","weekend"
"4124",2018-12-22,"Gothic Rd","2","2","1",4.2,0.1,19,0,20,22.1,-1,1,0,0,-1,0,0,0,"w1819","Hybrid",0,"Sat","weekend"
"4125",2018-12-23,"Gothic Rd","2","2","1",4.2,0,21,2,19,20,0,-1,1,0,2,1,2,2,"w1819","Non.motorized",44,"Sun","weekend"
"4126",2018-12-23,"Gothic Rd","2","2","1",4.2,0,21,2,19,20,0,-1,1,0,2,1,2,2,"w1819","Mechanized",4,"Sun","weekend"
"4127",2018-12-23,"Gothic Rd","2","2","1",4.2,0,21,2,19,20,0,-1,1,0,2,1,2,2,"w1819","Motorized",0,"Sun","weekend"
"4128",2018-12-23,"Gothic Rd","2","2","1",4.2,0,21,2,19,20,0,-1,1,0,2,1,2,2,"w1819","Hybrid",0,"Sun","weekend"
"4129",2018-12-24,"Gothic Rd","2","2","2",4.3,0.1,20,-1,21,21.5,2,0,-1,1,1,1,0,1,"w1819","Non.motorized",NA,"Mon","weekday"
"4130",2018-12-24,"Gothic Rd","2","2","2",4.3,0.1,20,-1,21,21.5,2,0,-1,1,1,1,0,1,"w1819","Mechanized",NA,"Mon","weekday"
"4131",2018-12-24,"Gothic Rd","2","2","2",4.3,0.1,20,-1,21,21.5,2,0,-1,1,1,1,0,1,"w1819","Motorized",NA,"Mon","weekday"
"4132",2018-12-24,"Gothic Rd","2","2","2",4.3,0.1,20,-1,21,21.5,2,0,-1,1,1,1,0,1,"w1819","Hybrid",NA,"Mon","weekday"
"4133",2018-12-25,"Gothic Rd","2","2","2",4.7,0.4,25,5,25,18.8,-1,2,0,-1,4,6,6,5,"w1819","Non.motorized",NA,"Tue","weekday"
"4134",2018-12-25,"Gothic Rd","2","2","2",4.7,0.4,25,5,25,18.8,-1,2,0,-1,4,6,6,5,"w1819","Mechanized",NA,"Tue","weekday"
"4135",2018-12-25,"Gothic Rd","2","2","2",4.7,0.4,25,5,25,18.8,-1,2,0,-1,4,6,6,5,"w1819","Motorized",NA,"Tue","weekday"
"4136",2018-12-25,"Gothic Rd","2","2","2",4.7,0.4,25,5,25,18.8,-1,2,0,-1,4,6,6,5,"w1819","Hybrid",NA,"Tue","weekday"
"4137",2018-12-26,"Gothic Rd","3","3","3",4.7,0,23,-2,24,20.4,5,-1,2,0,3,2,4,4,"w1819","Non.motorized",NA,"Wed","weekday"
"4138",2018-12-26,"Gothic Rd","3","3","3",4.7,0,23,-2,24,20.4,5,-1,2,0,3,2,4,4,"w1819","Mechanized",NA,"Wed","weekday"
"4139",2018-12-26,"Gothic Rd","3","3","3",4.7,0,23,-2,24,20.4,5,-1,2,0,3,2,4,4,"w1819","Motorized",NA,"Wed","weekday"
"4140",2018-12-26,"Gothic Rd","3","3","3",4.7,0,23,-2,24,20.4,5,-1,2,0,3,2,4,4,"w1819","Hybrid",NA,"Wed","weekday"
"4141",2018-12-27,"Gothic Rd","3","3","2",4.7,0,24,1,12,19.6,-2,5,-1,2,-1,4,3,5,"w1819","Non.motorized",NA,"Thu","weekday"
"4142",2018-12-27,"Gothic Rd","3","3","2",4.7,0,24,1,12,19.6,-2,5,-1,2,-1,4,3,5,"w1819","Mechanized",NA,"Thu","weekday"
"4143",2018-12-27,"Gothic Rd","3","3","2",4.7,0,24,1,12,19.6,-2,5,-1,2,-1,4,3,5,"w1819","Motorized",NA,"Thu","weekday"
"4144",2018-12-27,"Gothic Rd","3","3","2",4.7,0,24,1,12,19.6,-2,5,-1,2,-1,4,3,5,"w1819","Hybrid",NA,"Thu","weekday"
"4145",2018-12-28,"Gothic Rd","3","3","2",4.7,0,24,0,12,19.6,1,-2,5,-1,1,-1,4,3,"w1819","Non.motorized",1,"Fri","weekday"
"4146",2018-12-28,"Gothic Rd","3","3","2",4.7,0,24,0,12,19.6,1,-2,5,-1,1,-1,4,3,"w1819","Mechanized",0,"Fri","weekday"
"4147",2018-12-28,"Gothic Rd","3","3","2",4.7,0,24,0,12,19.6,1,-2,5,-1,1,-1,4,3,"w1819","Motorized",0,"Fri","weekday"
"4148",2018-12-28,"Gothic Rd","3","3","2",4.7,0,24,0,12,19.6,1,-2,5,-1,1,-1,4,3,"w1819","Hybrid",0,"Fri","weekday"
"4149",2018-12-29,"Gothic Rd","3","3","2",4.7,0,24,0,8,19.6,0,1,-2,5,0,1,-1,4,"w1819","Non.motorized",126,"Sat","weekend"
"4150",2018-12-29,"Gothic Rd","3","3","2",4.7,0,24,0,8,19.6,0,1,-2,5,0,1,-1,4,"w1819","Mechanized",6,"Sat","weekend"
"4151",2018-12-29,"Gothic Rd","3","3","2",4.7,0,24,0,8,19.6,0,1,-2,5,0,1,-1,4,"w1819","Motorized",8,"Sat","weekend"
"4152",2018-12-29,"Gothic Rd","3","3","2",4.7,0,24,0,8,19.6,0,1,-2,5,0,1,-1,4,"w1819","Hybrid",0,"Sat","weekend"
"4153",2018-12-30,"Gothic Rd","3","3","2",4.7,0,24,0,16,19.6,0,0,1,-2,0,0,1,-1,"w1819","Non.motorized",79,"Sun","weekend"
"4154",2018-12-30,"Gothic Rd","3","3","2",4.7,0,24,0,16,19.6,0,0,1,-2,0,0,1,-1,"w1819","Mechanized",13,"Sun","weekend"
"4155",2018-12-30,"Gothic Rd","3","3","2",4.7,0,24,0,16,19.6,0,0,1,-2,0,0,1,-1,"w1819","Motorized",0,"Sun","weekend"
"4156",2018-12-30,"Gothic Rd","3","3","2",4.7,0,24,0,16,19.6,0,0,1,-2,0,0,1,-1,"w1819","Hybrid",0,"Sun","weekend"
"4157",2018-12-31,"Gothic Rd","3","3","3",4.9,0.2,23,-1,14,21.3,0,0,0,1,-1,-1,-1,0,"w1819","Non.motorized",4,"Mon","weekday"
"4158",2018-12-31,"Gothic Rd","3","3","3",4.9,0.2,23,-1,14,21.3,0,0,0,1,-1,-1,-1,0,"w1819","Mechanized",0,"Mon","weekday"
"4159",2018-12-31,"Gothic Rd","3","3","3",4.9,0.2,23,-1,14,21.3,0,0,0,1,-1,-1,-1,0,"w1819","Motorized",0,"Mon","weekday"
"4160",2018-12-31,"Gothic Rd","3","3","3",4.9,0.2,23,-1,14,21.3,0,0,0,1,-1,-1,-1,0,"w1819","Hybrid",0,"Mon","weekday"
"4161",2019-01-01,"Gothic Rd","3","3","3",5.1,0.2,29,6,11,17.6,-1,0,0,0,5,5,5,5,"w1819","Non.motorized",60,"Tue","weekday"
"4162",2019-01-01,"Gothic Rd","3","3","3",5.1,0.2,29,6,11,17.6,-1,0,0,0,5,5,5,5,"w1819","Mechanized",3,"Tue","weekday"
"4163",2019-01-01,"Gothic Rd","3","3","3",5.1,0.2,29,6,11,17.6,-1,0,0,0,5,5,5,5,"w1819","Motorized",0,"Tue","weekday"
"4164",2019-01-01,"Gothic Rd","3","3","3",5.1,0.2,29,6,11,17.6,-1,0,0,0,5,5,5,5,"w1819","Hybrid",0,"Tue","weekday"
"4165",2019-01-02,"Gothic Rd","3","3","2",5.1,0,28,-1,10,18.2,6,-1,0,0,5,4,4,4,"w1819","Non.motorized",48,"Wed","weekday"
"4166",2019-01-02,"Gothic Rd","3","3","2",5.1,0,28,-1,10,18.2,6,-1,0,0,5,4,4,4,"w1819","Mechanized",1,"Wed","weekday"
"4167",2019-01-02,"Gothic Rd","3","3","2",5.1,0,28,-1,10,18.2,6,-1,0,0,5,4,4,4,"w1819","Motorized",1,"Wed","weekday"
"4168",2019-01-02,"Gothic Rd","3","3","2",5.1,0,28,-1,10,18.2,6,-1,0,0,5,4,4,4,"w1819","Hybrid",0,"Wed","weekday"
"4169",2019-01-03,"Gothic Rd","3","3","2",5.1,0,27,-1,22,18.9,-1,6,-1,0,-2,4,3,3,"w1819","Non.motorized",53,"Thu","weekday"
"4170",2019-01-03,"Gothic Rd","3","3","2",5.1,0,27,-1,22,18.9,-1,6,-1,0,-2,4,3,3,"w1819","Mechanized",0,"Thu","weekday"
"4171",2019-01-03,"Gothic Rd","3","3","2",5.1,0,27,-1,22,18.9,-1,6,-1,0,-2,4,3,3,"w1819","Motorized",0,"Thu","weekday"
"4172",2019-01-03,"Gothic Rd","3","3","2",5.1,0,27,-1,22,18.9,-1,6,-1,0,-2,4,3,3,"w1819","Hybrid",0,"Thu","weekday"
"4173",2019-01-04,"Gothic Rd","3","3","2",5.3,0.2,26,-1,29,20.4,-1,-1,6,-1,-2,-3,3,2,"w1819","Non.motorized",7,"Fri","weekday"
"4174",2019-01-04,"Gothic Rd","3","3","2",5.3,0.2,26,-1,29,20.4,-1,-1,6,-1,-2,-3,3,2,"w1819","Mechanized",2,"Fri","weekday"
"4175",2019-01-04,"Gothic Rd","3","3","2",5.3,0.2,26,-1,29,20.4,-1,-1,6,-1,-2,-3,3,2,"w1819","Motorized",0,"Fri","weekday"
"4176",2019-01-04,"Gothic Rd","3","3","2",5.3,0.2,26,-1,29,20.4,-1,-1,6,-1,-2,-3,3,2,"w1819","Hybrid",0,"Fri","weekday"
"4177",2019-01-05,"Gothic Rd","2","2","2",5.3,0,25,-1,30,21.2,-1,-1,-1,6,-2,-3,-4,2,"w1819","Non.motorized",0,"Sat","weekend"
"4178",2019-01-05,"Gothic Rd","2","2","2",5.3,0,25,-1,30,21.2,-1,-1,-1,6,-2,-3,-4,2,"w1819","Mechanized",0,"Sat","weekend"
"4179",2019-01-05,"Gothic Rd","2","2","2",5.3,0,25,-1,30,21.2,-1,-1,-1,6,-2,-3,-4,2,"w1819","Motorized",0,"Sat","weekend"
"4180",2019-01-05,"Gothic Rd","2","2","2",5.3,0,25,-1,30,21.2,-1,-1,-1,6,-2,-3,-4,2,"w1819","Hybrid",0,"Sat","weekend"
"4181",2019-01-06,"Gothic Rd","3","3","3",5.3,0,25,0,26,21.2,-1,-1,-1,-1,-1,-2,-3,-4,"w1819","Non.motorized",0,"Sun","weekend"
"4182",2019-01-06,"Gothic Rd","3","3","3",5.3,0,25,0,26,21.2,-1,-1,-1,-1,-1,-2,-3,-4,"w1819","Mechanized",0,"Sun","weekend"
"4183",2019-01-06,"Gothic Rd","3","3","3",5.3,0,25,0,26,21.2,-1,-1,-1,-1,-1,-2,-3,-4,"w1819","Motorized",0,"Sun","weekend"
"4184",2019-01-06,"Gothic Rd","3","3","3",5.3,0,25,0,26,21.2,-1,-1,-1,-1,-1,-2,-3,-4,"w1819","Hybrid",0,"Sun","weekend"
"4185",2019-01-07,"Gothic Rd","3","3","3",5.8,0.5,32,7,21,18.1,0,-1,-1,-1,7,6,5,4,"w1819","Non.motorized",0,"Mon","weekday"
"4186",2019-01-07,"Gothic Rd","3","3","3",5.8,0.5,32,7,21,18.1,0,-1,-1,-1,7,6,5,4,"w1819","Mechanized",0,"Mon","weekday"
"4187",2019-01-07,"Gothic Rd","3","3","3",5.8,0.5,32,7,21,18.1,0,-1,-1,-1,7,6,5,4,"w1819","Motorized",0,"Mon","weekday"
"4188",2019-01-07,"Gothic Rd","3","3","3",5.8,0.5,32,7,21,18.1,0,-1,-1,-1,7,6,5,4,"w1819","Hybrid",0,"Mon","weekday"
"4189",2019-01-08,"Gothic Rd","3","3","3",5.9,0.1,32,0,24,18.4,7,0,-1,-1,7,7,6,5,"w1819","Non.motorized",0,"Tue","weekday"
"4190",2019-01-08,"Gothic Rd","3","3","3",5.9,0.1,32,0,24,18.4,7,0,-1,-1,7,7,6,5,"w1819","Mechanized",0,"Tue","weekday"
"4191",2019-01-08,"Gothic Rd","3","3","3",5.9,0.1,32,0,24,18.4,7,0,-1,-1,7,7,6,5,"w1819","Motorized",0,"Tue","weekday"
"4192",2019-01-08,"Gothic Rd","3","3","3",5.9,0.1,32,0,24,18.4,7,0,-1,-1,7,7,6,5,"w1819","Hybrid",0,"Tue","weekday"
"4193",2019-01-09,"Gothic Rd","3","3","3",6,0.1,30,-2,29,20,0,7,0,-1,-2,5,5,4,"w1819","Non.motorized",22,"Wed","weekday"
"4194",2019-01-09,"Gothic Rd","3","3","3",6,0.1,30,-2,29,20,0,7,0,-1,-2,5,5,4,"w1819","Mechanized",0,"Wed","weekday"
"4195",2019-01-09,"Gothic Rd","3","3","3",6,0.1,30,-2,29,20,0,7,0,-1,-2,5,5,4,"w1819","Motorized",0,"Wed","weekday"
"4196",2019-01-09,"Gothic Rd","3","3","3",6,0.1,30,-2,29,20,0,7,0,-1,-2,5,5,4,"w1819","Hybrid",0,"Wed","weekday"
"4197",2019-01-10,"Gothic Rd","3","3","3",6,0,29,-1,29,20.7,-2,0,7,0,-3,-3,4,4,"w1819","Non.motorized",37,"Thu","weekday"
"4198",2019-01-10,"Gothic Rd","3","3","3",6,0,29,-1,29,20.7,-2,0,7,0,-3,-3,4,4,"w1819","Mechanized",3,"Thu","weekday"
"4199",2019-01-10,"Gothic Rd","3","3","3",6,0,29,-1,29,20.7,-2,0,7,0,-3,-3,4,4,"w1819","Motorized",0,"Thu","weekday"
"4200",2019-01-10,"Gothic Rd","3","3","3",6,0,29,-1,29,20.7,-2,0,7,0,-3,-3,4,4,"w1819","Hybrid",0,"Thu","weekday"
"4201",2019-01-11,"Gothic Rd","2","2","2",6.1,0.1,29,0,25,21,-1,-2,0,7,-1,-3,-3,4,"w1819","Non.motorized",47,"Fri","weekday"
"4202",2019-01-11,"Gothic Rd","2","2","2",6.1,0.1,29,0,25,21,-1,-2,0,7,-1,-3,-3,4,"w1819","Mechanized",2,"Fri","weekday"
"4203",2019-01-11,"Gothic Rd","2","2","2",6.1,0.1,29,0,25,21,-1,-2,0,7,-1,-3,-3,4,"w1819","Motorized",0,"Fri","weekday"
"4204",2019-01-11,"Gothic Rd","2","2","2",6.1,0.1,29,0,25,21,-1,-2,0,7,-1,-3,-3,4,"w1819","Hybrid",0,"Fri","weekday"
"4205",2019-01-12,"Gothic Rd","3","3","2",6.1,0,28,-1,21,21.8,0,-1,-2,0,-1,-2,-4,-4,"w1819","Non.motorized",48,"Sat","weekend"
"4206",2019-01-12,"Gothic Rd","3","3","2",6.1,0,28,-1,21,21.8,0,-1,-2,0,-1,-2,-4,-4,"w1819","Mechanized",1,"Sat","weekend"
"4207",2019-01-12,"Gothic Rd","3","3","2",6.1,0,28,-1,21,21.8,0,-1,-2,0,-1,-2,-4,-4,"w1819","Motorized",0,"Sat","weekend"
"4208",2019-01-12,"Gothic Rd","3","3","2",6.1,0,28,-1,21,21.8,0,-1,-2,0,-1,-2,-4,-4,"w1819","Hybrid",0,"Sat","weekend"
"4209",2019-01-13,"Gothic Rd","2","2","2",6.2,0.1,30,2,18,20.7,-1,0,-1,-2,1,1,0,-2,"w1819","Non.motorized",0,"Sun","weekend"
"4210",2019-01-13,"Gothic Rd","2","2","2",6.2,0.1,30,2,18,20.7,-1,0,-1,-2,1,1,0,-2,"w1819","Mechanized",0,"Sun","weekend"
"4211",2019-01-13,"Gothic Rd","2","2","2",6.2,0.1,30,2,18,20.7,-1,0,-1,-2,1,1,0,-2,"w1819","Motorized",0,"Sun","weekend"
"4212",2019-01-13,"Gothic Rd","2","2","2",6.2,0.1,30,2,18,20.7,-1,0,-1,-2,1,1,0,-2,"w1819","Hybrid",0,"Sun","weekend"
"4213",2019-01-14,"Gothic Rd","2","2","2",6.2,0,30,0,18,20.7,2,-1,0,-1,2,1,1,0,"w1819","Non.motorized",11,"Mon","weekday"
"4214",2019-01-14,"Gothic Rd","2","2","2",6.2,0,30,0,18,20.7,2,-1,0,-1,2,1,1,0,"w1819","Mechanized",0,"Mon","weekday"
"4215",2019-01-14,"Gothic Rd","2","2","2",6.2,0,30,0,18,20.7,2,-1,0,-1,2,1,1,0,"w1819","Motorized",1,"Mon","weekday"
"4216",2019-01-14,"Gothic Rd","2","2","2",6.2,0,30,0,18,20.7,2,-1,0,-1,2,1,1,0,"w1819","Hybrid",0,"Mon","weekday"
"4217",2019-01-15,"Gothic Rd","2","2","2",6.2,0,29,-1,24,21.4,0,2,-1,0,-1,1,0,0,"w1819","Non.motorized",40,"Tue","weekday"
"4218",2019-01-15,"Gothic Rd","2","2","2",6.2,0,29,-1,24,21.4,0,2,-1,0,-1,1,0,0,"w1819","Mechanized",1,"Tue","weekday"
"4219",2019-01-15,"Gothic Rd","2","2","2",6.2,0,29,-1,24,21.4,0,2,-1,0,-1,1,0,0,"w1819","Motorized",0,"Tue","weekday"
"4220",2019-01-15,"Gothic Rd","2","2","2",6.2,0,29,-1,24,21.4,0,2,-1,0,-1,1,0,0,"w1819","Hybrid",0,"Tue","weekday"
"4221",2019-01-16,"Gothic Rd","4","4","3",6.3,0.1,29,0,26,21.7,-1,0,2,-1,-1,-1,1,0,"w1819","Non.motorized",9,"Wed","weekday"
"4222",2019-01-16,"Gothic Rd","4","4","3",6.3,0.1,29,0,26,21.7,-1,0,2,-1,-1,-1,1,0,"w1819","Mechanized",0,"Wed","weekday"
"4223",2019-01-16,"Gothic Rd","4","4","3",6.3,0.1,29,0,26,21.7,-1,0,2,-1,-1,-1,1,0,"w1819","Motorized",0,"Wed","weekday"
"4224",2019-01-16,"Gothic Rd","4","4","3",6.3,0.1,29,0,26,21.7,-1,0,2,-1,-1,-1,1,0,"w1819","Hybrid",0,"Wed","weekday"
"4225",2019-01-17,"Gothic Rd","3","3","2",7,0.7,38,9,28,18.4,0,-1,0,2,9,8,8,10,"w1819","Non.motorized",14,"Thu","weekday"
"4226",2019-01-17,"Gothic Rd","3","3","2",7,0.7,38,9,28,18.4,0,-1,0,2,9,8,8,10,"w1819","Mechanized",0,"Thu","weekday"
"4227",2019-01-17,"Gothic Rd","3","3","2",7,0.7,38,9,28,18.4,0,-1,0,2,9,8,8,10,"w1819","Motorized",0,"Thu","weekday"
"4228",2019-01-17,"Gothic Rd","3","3","2",7,0.7,38,9,28,18.4,0,-1,0,2,9,8,8,10,"w1819","Hybrid",0,"Thu","weekday"
"4229",2019-01-18,"Gothic Rd","4","4","4",7.5,0.5,41,3,22,18.3,9,0,-1,0,12,12,11,11,"w1819","Non.motorized",1,"Fri","weekday"
"4230",2019-01-18,"Gothic Rd","4","4","4",7.5,0.5,41,3,22,18.3,9,0,-1,0,12,12,11,11,"w1819","Mechanized",0,"Fri","weekday"
"4231",2019-01-18,"Gothic Rd","4","4","4",7.5,0.5,41,3,22,18.3,9,0,-1,0,12,12,11,11,"w1819","Motorized",0,"Fri","weekday"
"4232",2019-01-18,"Gothic Rd","4","4","4",7.5,0.5,41,3,22,18.3,9,0,-1,0,12,12,11,11,"w1819","Hybrid",0,"Fri","weekday"
"4233",2019-01-19,"Gothic Rd","3","3","3",7.8,0.3,43,2,20,18.1,3,9,0,-1,5,14,14,13,"w1819","Non.motorized",105,"Sat","weekend"
"4234",2019-01-19,"Gothic Rd","3","3","3",7.8,0.3,43,2,20,18.1,3,9,0,-1,5,14,14,13,"w1819","Mechanized",0,"Sat","weekend"
"4235",2019-01-19,"Gothic Rd","3","3","3",7.8,0.3,43,2,20,18.1,3,9,0,-1,5,14,14,13,"w1819","Motorized",2,"Sat","weekend"
"4236",2019-01-19,"Gothic Rd","3","3","3",7.8,0.3,43,2,20,18.1,3,9,0,-1,5,14,14,13,"w1819","Hybrid",0,"Sat","weekend"
"4237",2019-01-20,"Gothic Rd","3","3","3",7.9,0.1,41,-2,27,19.3,2,3,9,0,0,3,12,12,"w1819","Non.motorized",137,"Sun","weekend"
"4238",2019-01-20,"Gothic Rd","3","3","3",7.9,0.1,41,-2,27,19.3,2,3,9,0,0,3,12,12,"w1819","Mechanized",3,"Sun","weekend"
"4239",2019-01-20,"Gothic Rd","3","3","3",7.9,0.1,41,-2,27,19.3,2,3,9,0,0,3,12,12,"w1819","Motorized",12,"Sun","weekend"
"4240",2019-01-20,"Gothic Rd","3","3","3",7.9,0.1,41,-2,27,19.3,2,3,9,0,0,3,12,12,"w1819","Hybrid",0,"Sun","weekend"
"4241",2019-01-21,"Gothic Rd","3","3","3",7.9,0,39,-2,23,20.3,-2,2,3,9,-4,-2,1,10,"w1819","Non.motorized",NA,"Mon","weekday"
"4242",2019-01-21,"Gothic Rd","3","3","3",7.9,0,39,-2,23,20.3,-2,2,3,9,-4,-2,1,10,"w1819","Mechanized",NA,"Mon","weekday"
"4243",2019-01-21,"Gothic Rd","3","3","3",7.9,0,39,-2,23,20.3,-2,2,3,9,-4,-2,1,10,"w1819","Motorized",NA,"Mon","weekday"
"4244",2019-01-21,"Gothic Rd","3","3","3",7.9,0,39,-2,23,20.3,-2,2,3,9,-4,-2,1,10,"w1819","Hybrid",NA,"Mon","weekday"
"4245",2019-01-22,"Gothic Rd","3","3","3",8,0.1,41,2,12,19.5,-2,-2,2,3,0,-2,0,3,"w1819","Non.motorized",19,"Tue","weekday"
"4246",2019-01-22,"Gothic Rd","3","3","3",8,0.1,41,2,12,19.5,-2,-2,2,3,0,-2,0,3,"w1819","Mechanized",0,"Tue","weekday"
"4247",2019-01-22,"Gothic Rd","3","3","3",8,0.1,41,2,12,19.5,-2,-2,2,3,0,-2,0,3,"w1819","Motorized",2,"Tue","weekday"
"4248",2019-01-22,"Gothic Rd","3","3","3",8,0.1,41,2,12,19.5,-2,-2,2,3,0,-2,0,3,"w1819","Hybrid",0,"Tue","weekday"
"4249",2019-01-23,"Gothic Rd","3","3","2",8,0,40,-1,14,20,2,-2,-2,2,1,-1,-3,-1,"w1819","Non.motorized",17,"Wed","weekday"
"4250",2019-01-23,"Gothic Rd","3","3","2",8,0,40,-1,14,20,2,-2,-2,2,1,-1,-3,-1,"w1819","Mechanized",0,"Wed","weekday"
"4251",2019-01-23,"Gothic Rd","3","3","2",8,0,40,-1,14,20,2,-2,-2,2,1,-1,-3,-1,"w1819","Motorized",0,"Wed","weekday"
"4252",2019-01-23,"Gothic Rd","3","3","2",8,0,40,-1,14,20,2,-2,-2,2,1,-1,-3,-1,"w1819","Hybrid",0,"Wed","weekday"
"4253",2019-01-24,"Gothic Rd","3","3","2",8.2,0.2,40,0,17,20.5,-1,2,-2,-2,-1,1,-1,-3,"w1819","Non.motorized",8,"Thu","weekday"
"4254",2019-01-24,"Gothic Rd","3","3","2",8.2,0.2,40,0,17,20.5,-1,2,-2,-2,-1,1,-1,-3,"w1819","Mechanized",12,"Thu","weekday"
"4255",2019-01-24,"Gothic Rd","3","3","2",8.2,0.2,40,0,17,20.5,-1,2,-2,-2,-1,1,-1,-3,"w1819","Motorized",1,"Thu","weekday"
"4256",2019-01-24,"Gothic Rd","3","3","2",8.2,0.2,40,0,17,20.5,-1,2,-2,-2,-1,1,-1,-3,"w1819","Hybrid",0,"Thu","weekday"
"4257",2019-01-25,"Gothic Rd","3","3","2",8.3,0.1,40,0,15,20.8,0,-1,2,-2,0,-1,1,-1,"w1819","Non.motorized",38,"Fri","weekday"
"4258",2019-01-25,"Gothic Rd","3","3","2",8.3,0.1,40,0,15,20.8,0,-1,2,-2,0,-1,1,-1,"w1819","Mechanized",50,"Fri","weekday"
"4259",2019-01-25,"Gothic Rd","3","3","2",8.3,0.1,40,0,15,20.8,0,-1,2,-2,0,-1,1,-1,"w1819","Motorized",0,"Fri","weekday"
"4260",2019-01-25,"Gothic Rd","3","3","2",8.3,0.1,40,0,15,20.8,0,-1,2,-2,0,-1,1,-1,"w1819","Hybrid",0,"Fri","weekday"
"4261",2019-01-26,"Gothic Rd","3","3","2",8.3,0,39,-1,19,21.3,0,0,-1,2,-1,-1,-2,0,"w1819","Non.motorized",111,"Sat","weekend"
"4262",2019-01-26,"Gothic Rd","3","3","2",8.3,0,39,-1,19,21.3,0,0,-1,2,-1,-1,-2,0,"w1819","Mechanized",6,"Sat","weekend"
"4263",2019-01-26,"Gothic Rd","3","3","2",8.3,0,39,-1,19,21.3,0,0,-1,2,-1,-1,-2,0,"w1819","Motorized",3,"Sat","weekend"
"4264",2019-01-26,"Gothic Rd","3","3","2",8.3,0,39,-1,19,21.3,0,0,-1,2,-1,-1,-2,0,"w1819","Hybrid",0,"Sat","weekend"
"4265",2019-01-27,"Gothic Rd","3","3","2",8.3,0,38,-1,24,21.8,-1,0,0,-1,-2,-2,-2,-3,"w1819","Non.motorized",61,"Sun","weekend"
"4266",2019-01-27,"Gothic Rd","3","3","2",8.3,0,38,-1,24,21.8,-1,0,0,-1,-2,-2,-2,-3,"w1819","Mechanized",2,"Sun","weekend"
"4267",2019-01-27,"Gothic Rd","3","3","2",8.3,0,38,-1,24,21.8,-1,0,0,-1,-2,-2,-2,-3,"w1819","Motorized",0,"Sun","weekend"
"4268",2019-01-27,"Gothic Rd","3","3","2",8.3,0,38,-1,24,21.8,-1,0,0,-1,-2,-2,-2,-3,"w1819","Hybrid",0,"Sun","weekend"
"4269",2019-01-28,"Gothic Rd","2","2","2",8.3,0,38,0,17,21.8,-1,-1,0,0,-1,-2,-2,-2,"w1819","Non.motorized",3,"Mon","weekday"
"4270",2019-01-28,"Gothic Rd","2","2","2",8.3,0,38,0,17,21.8,-1,-1,0,0,-1,-2,-2,-2,"w1819","Mechanized",0,"Mon","weekday"
"4271",2019-01-28,"Gothic Rd","2","2","2",8.3,0,38,0,17,21.8,-1,-1,0,0,-1,-2,-2,-2,"w1819","Motorized",0,"Mon","weekday"
"4272",2019-01-28,"Gothic Rd","2","2","2",8.3,0,38,0,17,21.8,-1,-1,0,0,-1,-2,-2,-2,"w1819","Hybrid",0,"Mon","weekday"
"4273",2019-01-29,"Gothic Rd","2","2","2",8.3,0,38,0,16,21.8,0,-1,-1,0,0,-1,-2,-2,"w1819","Non.motorized",0,"Tue","weekday"
"4274",2019-01-29,"Gothic Rd","2","2","2",8.3,0,38,0,16,21.8,0,-1,-1,0,0,-1,-2,-2,"w1819","Mechanized",0,"Tue","weekday"
"4275",2019-01-29,"Gothic Rd","2","2","2",8.3,0,38,0,16,21.8,0,-1,-1,0,0,-1,-2,-2,"w1819","Motorized",0,"Tue","weekday"
"4276",2019-01-29,"Gothic Rd","2","2","2",8.3,0,38,0,16,21.8,0,-1,-1,0,0,-1,-2,-2,"w1819","Hybrid",0,"Tue","weekday"
"4277",2019-01-30,"Gothic Rd","2","2","1",8.3,0,37,-1,20,22.4,0,0,-1,-1,-1,-1,-2,-3,"w1819","Non.motorized",0,"Wed","weekday"
"4278",2019-01-30,"Gothic Rd","2","2","1",8.3,0,37,-1,20,22.4,0,0,-1,-1,-1,-1,-2,-3,"w1819","Mechanized",0,"Wed","weekday"
"4279",2019-01-30,"Gothic Rd","2","2","1",8.3,0,37,-1,20,22.4,0,0,-1,-1,-1,-1,-2,-3,"w1819","Motorized",0,"Wed","weekday"
"4280",2019-01-30,"Gothic Rd","2","2","1",8.3,0,37,-1,20,22.4,0,0,-1,-1,-1,-1,-2,-3,"w1819","Hybrid",0,"Wed","weekday"
"4281",2019-01-31,"Gothic Rd","2","2","1",8.3,0,36,-1,24,23.1,-1,0,0,-1,-2,-2,-2,-3,"w1819","Non.motorized",0,"Thu","weekday"
"4282",2019-01-31,"Gothic Rd","2","2","1",8.3,0,36,-1,24,23.1,-1,0,0,-1,-2,-2,-2,-3,"w1819","Mechanized",0,"Thu","weekday"
"4283",2019-01-31,"Gothic Rd","2","2","1",8.3,0,36,-1,24,23.1,-1,0,0,-1,-2,-2,-2,-3,"w1819","Motorized",0,"Thu","weekday"
"4284",2019-01-31,"Gothic Rd","2","2","1",8.3,0,36,-1,24,23.1,-1,0,0,-1,-2,-2,-2,-3,"w1819","Hybrid",0,"Thu","weekday"
"4285",2019-02-01,"Gothic Rd","2","2","1",8.3,0,36,0,25,23.1,-1,-1,0,0,-1,-2,-2,-2,"w1819","Non.motorized",6,"Fri","weekday"
"4286",2019-02-01,"Gothic Rd","2","2","1",8.3,0,36,0,25,23.1,-1,-1,0,0,-1,-2,-2,-2,"w1819","Mechanized",1,"Fri","weekday"
"4287",2019-02-01,"Gothic Rd","2","2","1",8.3,0,36,0,25,23.1,-1,-1,0,0,-1,-2,-2,-2,"w1819","Motorized",0,"Fri","weekday"
"4288",2019-02-01,"Gothic Rd","2","2","1",8.3,0,36,0,25,23.1,-1,-1,0,0,-1,-2,-2,-2,"w1819","Hybrid",0,"Fri","weekday"
"4289",2019-02-02,"Gothic Rd","2","2","1",8.3,0,36,0,26,23.1,0,-1,-1,0,0,-1,-2,-2,"w1819","Non.motorized",72,"Sat","weekend"
"4290",2019-02-02,"Gothic Rd","2","2","1",8.3,0,36,0,26,23.1,0,-1,-1,0,0,-1,-2,-2,"w1819","Mechanized",9,"Sat","weekend"
"4291",2019-02-02,"Gothic Rd","2","2","1",8.3,0,36,0,26,23.1,0,-1,-1,0,0,-1,-2,-2,"w1819","Motorized",0,"Sat","weekend"
"4292",2019-02-02,"Gothic Rd","2","2","1",8.3,0,36,0,26,23.1,0,-1,-1,0,0,-1,-2,-2,"w1819","Hybrid",0,"Sat","weekend"
"4293",2019-02-03,"Gothic Rd","3","3","2",8.4,0.1,36,0,28,23.3,0,0,-1,-1,0,0,-1,-2,"w1819","Non.motorized",25,"Sun","weekend"
"4294",2019-02-03,"Gothic Rd","3","3","2",8.4,0.1,36,0,28,23.3,0,0,-1,-1,0,0,-1,-2,"w1819","Mechanized",2,"Sun","weekend"
"4295",2019-02-03,"Gothic Rd","3","3","2",8.4,0.1,36,0,28,23.3,0,0,-1,-1,0,0,-1,-2,"w1819","Motorized",0,"Sun","weekend"
"4296",2019-02-03,"Gothic Rd","3","3","2",8.4,0.1,36,0,28,23.3,0,0,-1,-1,0,0,-1,-2,"w1819","Hybrid",0,"Sun","weekend"
"4297",2019-02-04,"Gothic Rd","3","3","2",8.8,0.4,39,3,28,22.6,0,0,0,-1,3,3,3,2,"w1819","Non.motorized",22,"Mon","weekday"
"4298",2019-02-04,"Gothic Rd","3","3","2",8.8,0.4,39,3,28,22.6,0,0,0,-1,3,3,3,2,"w1819","Mechanized",0,"Mon","weekday"
"4299",2019-02-04,"Gothic Rd","3","3","2",8.8,0.4,39,3,28,22.6,0,0,0,-1,3,3,3,2,"w1819","Motorized",0,"Mon","weekday"
"4300",2019-02-04,"Gothic Rd","3","3","2",8.8,0.4,39,3,28,22.6,0,0,0,-1,3,3,3,2,"w1819","Hybrid",0,"Mon","weekday"
"4301",2019-02-05,"Gothic Rd","3","2","2",9,0.2,40,1,26,22.5,3,0,0,0,4,4,4,4,"w1819","Non.motorized",6,"Tue","weekday"
"4302",2019-02-05,"Gothic Rd","3","2","2",9,0.2,40,1,26,22.5,3,0,0,0,4,4,4,4,"w1819","Mechanized",0,"Tue","weekday"
"4303",2019-02-05,"Gothic Rd","3","2","2",9,0.2,40,1,26,22.5,3,0,0,0,4,4,4,4,"w1819","Motorized",0,"Tue","weekday"
"4304",2019-02-05,"Gothic Rd","3","2","2",9,0.2,40,1,26,22.5,3,0,0,0,4,4,4,4,"w1819","Hybrid",0,"Tue","weekday"
"4305",2019-02-06,"Gothic Rd","4","4","3",9,0,40,0,16,22.5,1,3,0,0,1,4,4,4,"w1819","Non.motorized",18,"Wed","weekday"
"4306",2019-02-06,"Gothic Rd","4","4","3",9,0,40,0,16,22.5,1,3,0,0,1,4,4,4,"w1819","Mechanized",0,"Wed","weekday"
"4307",2019-02-06,"Gothic Rd","4","4","3",9,0,40,0,16,22.5,1,3,0,0,1,4,4,4,"w1819","Motorized",0,"Wed","weekday"
"4308",2019-02-06,"Gothic Rd","4","4","3",9,0,40,0,16,22.5,1,3,0,0,1,4,4,4,"w1819","Hybrid",0,"Wed","weekday"
"4309",2019-02-07,"Gothic Rd","3","3","2",9.2,0.2,43,3,4,21.4,0,1,3,0,3,4,7,7,"w1819","Non.motorized",10,"Thu","weekday"
"4310",2019-02-07,"Gothic Rd","3","3","2",9.2,0.2,43,3,4,21.4,0,1,3,0,3,4,7,7,"w1819","Mechanized",0,"Thu","weekday"
"4311",2019-02-07,"Gothic Rd","3","3","2",9.2,0.2,43,3,4,21.4,0,1,3,0,3,4,7,7,"w1819","Motorized",0,"Thu","weekday"
"4312",2019-02-07,"Gothic Rd","3","3","2",9.2,0.2,43,3,4,21.4,0,1,3,0,3,4,7,7,"w1819","Hybrid",0,"Thu","weekday"
"4313",2019-02-08,"Gothic Rd","3","2","2",9.2,0,42,-1,10,21.9,3,0,1,3,2,2,3,6,"w1819","Non.motorized",24,"Fri","weekday"
"4314",2019-02-08,"Gothic Rd","3","2","2",9.2,0,42,-1,10,21.9,3,0,1,3,2,2,3,6,"w1819","Mechanized",0,"Fri","weekday"
"4315",2019-02-08,"Gothic Rd","3","2","2",9.2,0,42,-1,10,21.9,3,0,1,3,2,2,3,6,"w1819","Motorized",0,"Fri","weekday"
"4316",2019-02-08,"Gothic Rd","3","2","2",9.2,0,42,-1,10,21.9,3,0,1,3,2,2,3,6,"w1819","Hybrid",0,"Fri","weekday"
"4317",2019-02-09,"Gothic Rd","3","2","2",9.2,0,41,-1,20,22.4,-1,3,0,1,-2,1,1,2,"w1819","Non.motorized",59,"Sat","weekend"
"4318",2019-02-09,"Gothic Rd","3","2","2",9.2,0,41,-1,20,22.4,-1,3,0,1,-2,1,1,2,"w1819","Mechanized",2,"Sat","weekend"
"4319",2019-02-09,"Gothic Rd","3","2","2",9.2,0,41,-1,20,22.4,-1,3,0,1,-2,1,1,2,"w1819","Motorized",0,"Sat","weekend"
"4320",2019-02-09,"Gothic Rd","3","2","2",9.2,0,41,-1,20,22.4,-1,3,0,1,-2,1,1,2,"w1819","Hybrid",0,"Sat","weekend"
"4321",2019-02-10,"Gothic Rd","2","2","2",9.3,0.1,40,-1,20,23.2,-1,-1,3,0,-2,-3,0,0,"w1819","Non.motorized",68,"Sun","weekend"
"4322",2019-02-10,"Gothic Rd","2","2","2",9.3,0.1,40,-1,20,23.2,-1,-1,3,0,-2,-3,0,0,"w1819","Mechanized",5,"Sun","weekend"
"4323",2019-02-10,"Gothic Rd","2","2","2",9.3,0.1,40,-1,20,23.2,-1,-1,3,0,-2,-3,0,0,"w1819","Motorized",0,"Sun","weekend"
"4324",2019-02-10,"Gothic Rd","2","2","2",9.3,0.1,40,-1,20,23.2,-1,-1,3,0,-2,-3,0,0,"w1819","Hybrid",0,"Sun","weekend"
"4325",2019-02-11,"Gothic Rd","2","2","1",9.3,0,40,0,15,23.2,-1,-1,-1,3,-1,-2,-3,0,"w1819","Non.motorized",31,"Mon","weekday"
"4326",2019-02-11,"Gothic Rd","2","2","1",9.3,0,40,0,15,23.2,-1,-1,-1,3,-1,-2,-3,0,"w1819","Mechanized",0,"Mon","weekday"
"4327",2019-02-11,"Gothic Rd","2","2","1",9.3,0,40,0,15,23.2,-1,-1,-1,3,-1,-2,-3,0,"w1819","Motorized",0,"Mon","weekday"
"4328",2019-02-11,"Gothic Rd","2","2","1",9.3,0,40,0,15,23.2,-1,-1,-1,3,-1,-2,-3,0,"w1819","Hybrid",0,"Mon","weekday"
"4329",2019-02-12,"Gothic Rd","2","2","1",9.3,0,40,0,18,23.2,0,-1,-1,-1,0,-1,-2,-3,"w1819","Non.motorized",31,"Tue","weekday"
"4330",2019-02-12,"Gothic Rd","2","2","1",9.3,0,40,0,18,23.2,0,-1,-1,-1,0,-1,-2,-3,"w1819","Mechanized",3,"Tue","weekday"
"4331",2019-02-12,"Gothic Rd","2","2","1",9.3,0,40,0,18,23.2,0,-1,-1,-1,0,-1,-2,-3,"w1819","Motorized",0,"Tue","weekday"
"4332",2019-02-12,"Gothic Rd","2","2","1",9.3,0,40,0,18,23.2,0,-1,-1,-1,0,-1,-2,-3,"w1819","Hybrid",0,"Tue","weekday"
"4333",2019-02-13,"Gothic Rd","2","2","1",9.4,0.1,40,0,26,23.5,0,0,-1,-1,0,0,-1,-2,"w1819","Non.motorized",21,"Wed","weekday"
"4334",2019-02-13,"Gothic Rd","2","2","1",9.4,0.1,40,0,26,23.5,0,0,-1,-1,0,0,-1,-2,"w1819","Mechanized",2,"Wed","weekday"
"4335",2019-02-13,"Gothic Rd","2","2","1",9.4,0.1,40,0,26,23.5,0,0,-1,-1,0,0,-1,-2,"w1819","Motorized",0,"Wed","weekday"
"4336",2019-02-13,"Gothic Rd","2","2","1",9.4,0.1,40,0,26,23.5,0,0,-1,-1,0,0,-1,-2,"w1819","Hybrid",0,"Wed","weekday"
"4337",2019-02-14,"Gothic Rd","3","2","2",9.7,0.3,41,1,29,23.7,0,0,0,-1,1,1,1,0,"w1819","Non.motorized",19,"Thu","weekday"
"4338",2019-02-14,"Gothic Rd","3","2","2",9.7,0.3,41,1,29,23.7,0,0,0,-1,1,1,1,0,"w1819","Mechanized",0,"Thu","weekday"
"4339",2019-02-14,"Gothic Rd","3","2","2",9.7,0.3,41,1,29,23.7,0,0,0,-1,1,1,1,0,"w1819","Motorized",0,"Thu","weekday"
"4340",2019-02-14,"Gothic Rd","3","2","2",9.7,0.3,41,1,29,23.7,0,0,0,-1,1,1,1,0,"w1819","Hybrid",0,"Thu","weekday"
"4341",2019-02-15,"Gothic Rd","4","4","3",10.8,1.1,51,10,27,21.2,1,0,0,0,11,11,11,11,"w1819","Non.motorized",3,"Fri","weekday"
"4342",2019-02-15,"Gothic Rd","4","4","3",10.8,1.1,51,10,27,21.2,1,0,0,0,11,11,11,11,"w1819","Mechanized",0,"Fri","weekday"
"4343",2019-02-15,"Gothic Rd","4","4","3",10.8,1.1,51,10,27,21.2,1,0,0,0,11,11,11,11,"w1819","Motorized",0,"Fri","weekday"
"4344",2019-02-15,"Gothic Rd","4","4","3",10.8,1.1,51,10,27,21.2,1,0,0,0,11,11,11,11,"w1819","Hybrid",0,"Fri","weekday"
"4345",2019-02-16,"Gothic Rd","3","3","3",11.1,0.3,52,1,14,21.3,10,1,0,0,11,12,12,12,"w1819","Non.motorized",3,"Sat","weekend"
"4346",2019-02-16,"Gothic Rd","3","3","3",11.1,0.3,52,1,14,21.3,10,1,0,0,11,12,12,12,"w1819","Mechanized",0,"Sat","weekend"
"4347",2019-02-16,"Gothic Rd","3","3","3",11.1,0.3,52,1,14,21.3,10,1,0,0,11,12,12,12,"w1819","Motorized",0,"Sat","weekend"
"4348",2019-02-16,"Gothic Rd","3","3","3",11.1,0.3,52,1,14,21.3,10,1,0,0,11,12,12,12,"w1819","Hybrid",0,"Sat","weekend"
"4349",2019-02-17,"Gothic Rd","3","3","3",11.3,0.2,55,3,10,20.5,1,10,1,0,4,14,15,15,"w1819","Non.motorized",38,"Sun","weekend"
"4350",2019-02-17,"Gothic Rd","3","3","3",11.3,0.2,55,3,10,20.5,1,10,1,0,4,14,15,15,"w1819","Mechanized",2,"Sun","weekend"
"4351",2019-02-17,"Gothic Rd","3","3","3",11.3,0.2,55,3,10,20.5,1,10,1,0,4,14,15,15,"w1819","Motorized",0,"Sun","weekend"
"4352",2019-02-17,"Gothic Rd","3","3","3",11.3,0.2,55,3,10,20.5,1,10,1,0,4,14,15,15,"w1819","Hybrid",0,"Sun","weekend"
"4353",2019-02-18,"Gothic Rd","3","3","2",11.4,0.1,53,-2,13,21.5,3,1,10,1,1,2,12,13,"w1819","Non.motorized",16,"Mon","weekday"
"4354",2019-02-18,"Gothic Rd","3","3","2",11.4,0.1,53,-2,13,21.5,3,1,10,1,1,2,12,13,"w1819","Mechanized",0,"Mon","weekday"
"4355",2019-02-18,"Gothic Rd","3","3","2",11.4,0.1,53,-2,13,21.5,3,1,10,1,1,2,12,13,"w1819","Motorized",0,"Mon","weekday"
"4356",2019-02-18,"Gothic Rd","3","3","2",11.4,0.1,53,-2,13,21.5,3,1,10,1,1,2,12,13,"w1819","Hybrid",0,"Mon","weekday"
"4357",2019-02-19,"Gothic Rd","3","3","2",11.5,0.1,53,0,11,21.7,-2,3,1,10,-2,1,2,12,"w1819","Non.motorized",13,"Tue","weekday"
"4358",2019-02-19,"Gothic Rd","3","3","2",11.5,0.1,53,0,11,21.7,-2,3,1,10,-2,1,2,12,"w1819","Mechanized",0,"Tue","weekday"
"4359",2019-02-19,"Gothic Rd","3","3","2",11.5,0.1,53,0,11,21.7,-2,3,1,10,-2,1,2,12,"w1819","Motorized",1,"Tue","weekday"
"4360",2019-02-19,"Gothic Rd","3","3","2",11.5,0.1,53,0,11,21.7,-2,3,1,10,-2,1,2,12,"w1819","Hybrid",0,"Tue","weekday"
"4361",2019-02-20,"Gothic Rd","3","3","2",11.6,0.1,53,0,7,21.9,0,-2,3,1,0,-2,1,2,"w1819","Non.motorized",15,"Wed","weekday"
"4362",2019-02-20,"Gothic Rd","3","3","2",11.6,0.1,53,0,7,21.9,0,-2,3,1,0,-2,1,2,"w1819","Mechanized",0,"Wed","weekday"
"4363",2019-02-20,"Gothic Rd","3","3","2",11.6,0.1,53,0,7,21.9,0,-2,3,1,0,-2,1,2,"w1819","Motorized",0,"Wed","weekday"
"4364",2019-02-20,"Gothic Rd","3","3","2",11.6,0.1,53,0,7,21.9,0,-2,3,1,0,-2,1,2,"w1819","Hybrid",0,"Wed","weekday"
"4365",2019-02-21,"Gothic Rd","3","3","3",11.6,0,52,-1,15,22.3,0,0,-2,3,-1,-1,-3,0,"w1819","Non.motorized",24,"Thu","weekday"
"4366",2019-02-21,"Gothic Rd","3","3","3",11.6,0,52,-1,15,22.3,0,0,-2,3,-1,-1,-3,0,"w1819","Mechanized",0,"Thu","weekday"
"4367",2019-02-21,"Gothic Rd","3","3","3",11.6,0,52,-1,15,22.3,0,0,-2,3,-1,-1,-3,0,"w1819","Motorized",0,"Thu","weekday"
"4368",2019-02-21,"Gothic Rd","3","3","3",11.6,0,52,-1,15,22.3,0,0,-2,3,-1,-1,-3,0,"w1819","Hybrid",0,"Thu","weekday"
"4369",2019-02-22,"Gothic Rd","3","3","3",11.8,0.2,52,0,20,22.7,-1,0,0,-2,-1,-1,-1,-3,"w1819","Non.motorized",24,"Fri","weekday"
"4370",2019-02-22,"Gothic Rd","3","3","3",11.8,0.2,52,0,20,22.7,-1,0,0,-2,-1,-1,-1,-3,"w1819","Mechanized",0,"Fri","weekday"
"4371",2019-02-22,"Gothic Rd","3","3","3",11.8,0.2,52,0,20,22.7,-1,0,0,-2,-1,-1,-1,-3,"w1819","Motorized",0,"Fri","weekday"
"4372",2019-02-22,"Gothic Rd","3","3","3",11.8,0.2,52,0,20,22.7,-1,0,0,-2,-1,-1,-1,-3,"w1819","Hybrid",0,"Fri","weekday"
"4373",2019-02-23,"Gothic Rd","3","3","3",12.1,0.3,53,1,13,22.8,0,-1,0,0,1,0,0,0,"w1819","Non.motorized",140,"Sat","weekend"
"4374",2019-02-23,"Gothic Rd","3","3","3",12.1,0.3,53,1,13,22.8,0,-1,0,0,1,0,0,0,"w1819","Mechanized",1,"Sat","weekend"
"4375",2019-02-23,"Gothic Rd","3","3","3",12.1,0.3,53,1,13,22.8,0,-1,0,0,1,0,0,0,"w1819","Motorized",0,"Sat","weekend"
"4376",2019-02-23,"Gothic Rd","3","3","3",12.1,0.3,53,1,13,22.8,0,-1,0,0,1,0,0,0,"w1819","Hybrid",0,"Sat","weekend"
"4377",2019-02-24,"Gothic Rd","3","3","2",12.1,0,52,-1,14,23.3,1,0,-1,0,0,0,-1,-1,"w1819","Non.motorized",50,"Sun","weekend"
"4378",2019-02-24,"Gothic Rd","3","3","2",12.1,0,52,-1,14,23.3,1,0,-1,0,0,0,-1,-1,"w1819","Mechanized",1,"Sun","weekend"
"4379",2019-02-24,"Gothic Rd","3","3","2",12.1,0,52,-1,14,23.3,1,0,-1,0,0,0,-1,-1,"w1819","Motorized",1,"Sun","weekend"
"4380",2019-02-24,"Gothic Rd","3","3","2",12.1,0,52,-1,14,23.3,1,0,-1,0,0,0,-1,-1,"w1819","Hybrid",0,"Sun","weekend"
"4381",2019-02-25,"Gothic Rd","3","3","2",12.1,0,51,-1,22,23.7,-1,1,0,-1,-2,-1,-1,-2,"w1819","Non.motorized",36,"Mon","weekday"
"4382",2019-02-25,"Gothic Rd","3","3","2",12.1,0,51,-1,22,23.7,-1,1,0,-1,-2,-1,-1,-2,"w1819","Mechanized",2,"Mon","weekday"
"4383",2019-02-25,"Gothic Rd","3","3","2",12.1,0,51,-1,22,23.7,-1,1,0,-1,-2,-1,-1,-2,"w1819","Motorized",0,"Mon","weekday"
"4384",2019-02-25,"Gothic Rd","3","3","2",12.1,0,51,-1,22,23.7,-1,1,0,-1,-2,-1,-1,-2,"w1819","Hybrid",0,"Mon","weekday"
"4385",2019-02-26,"Gothic Rd","2","2","2",12.1,0,50,-1,27,24.2,-1,-1,1,0,-2,-3,-2,-2,"w1819","Non.motorized",34,"Tue","weekday"
"4386",2019-02-26,"Gothic Rd","2","2","2",12.1,0,50,-1,27,24.2,-1,-1,1,0,-2,-3,-2,-2,"w1819","Mechanized",2,"Tue","weekday"
"4387",2019-02-26,"Gothic Rd","2","2","2",12.1,0,50,-1,27,24.2,-1,-1,1,0,-2,-3,-2,-2,"w1819","Motorized",0,"Tue","weekday"
"4388",2019-02-26,"Gothic Rd","2","2","2",12.1,0,50,-1,27,24.2,-1,-1,1,0,-2,-3,-2,-2,"w1819","Hybrid",0,"Tue","weekday"
"4389",2019-02-27,"Gothic Rd","2","2","2",12.1,0,50,0,30,24.2,-1,-1,-1,1,-1,-2,-3,-2,"w1819","Non.motorized",51,"Wed","weekday"
"4390",2019-02-27,"Gothic Rd","2","2","2",12.1,0,50,0,30,24.2,-1,-1,-1,1,-1,-2,-3,-2,"w1819","Mechanized",6,"Wed","weekday"
"4391",2019-02-27,"Gothic Rd","2","2","2",12.1,0,50,0,30,24.2,-1,-1,-1,1,-1,-2,-3,-2,"w1819","Motorized",0,"Wed","weekday"
"4392",2019-02-27,"Gothic Rd","2","2","2",12.1,0,50,0,30,24.2,-1,-1,-1,1,-1,-2,-3,-2,"w1819","Hybrid",0,"Wed","weekday"
"4393",2019-02-28,"Gothic Rd","2","2","2",12.2,0.1,49,-1,30,24.9,0,-1,-1,-1,-1,-2,-3,-4,"w1819","Non.motorized",28,"Thu","weekday"
"4394",2019-02-28,"Gothic Rd","2","2","2",12.2,0.1,49,-1,30,24.9,0,-1,-1,-1,-1,-2,-3,-4,"w1819","Mechanized",0,"Thu","weekday"
"4395",2019-02-28,"Gothic Rd","2","2","2",12.2,0.1,49,-1,30,24.9,0,-1,-1,-1,-1,-2,-3,-4,"w1819","Motorized",0,"Thu","weekday"
"4396",2019-02-28,"Gothic Rd","2","2","2",12.2,0.1,49,-1,30,24.9,0,-1,-1,-1,-1,-2,-3,-4,"w1819","Hybrid",0,"Thu","weekday"
"4397",2019-03-01,"Gothic Rd","2","2","1",12.3,0.1,49,0,29,25.1,-1,0,-1,-1,-1,-1,-2,-3,"w1819","Non.motorized",17,"Fri","weekday"
"4398",2019-03-01,"Gothic Rd","2","2","1",12.3,0.1,49,0,29,25.1,-1,0,-1,-1,-1,-1,-2,-3,"w1819","Mechanized",0,"Fri","weekday"
"4399",2019-03-01,"Gothic Rd","2","2","1",12.3,0.1,49,0,29,25.1,-1,0,-1,-1,-1,-1,-2,-3,"w1819","Motorized",0,"Fri","weekday"
"4400",2019-03-01,"Gothic Rd","2","2","1",12.3,0.1,49,0,29,25.1,-1,0,-1,-1,-1,-1,-2,-3,"w1819","Hybrid",0,"Fri","weekday"
"4401",2019-03-02,"Gothic Rd","3","3","2",13,0.7,58,9,30,22.4,0,-1,0,-1,9,8,8,7,"w1819","Non.motorized",20,"Sat","weekend"
"4402",2019-03-02,"Gothic Rd","3","3","2",13,0.7,58,9,30,22.4,0,-1,0,-1,9,8,8,7,"w1819","Mechanized",0,"Sat","weekend"
"4403",2019-03-02,"Gothic Rd","3","3","2",13,0.7,58,9,30,22.4,0,-1,0,-1,9,8,8,7,"w1819","Motorized",0,"Sat","weekend"
"4404",2019-03-02,"Gothic Rd","3","3","2",13,0.7,58,9,30,22.4,0,-1,0,-1,9,8,8,7,"w1819","Hybrid",0,"Sat","weekend"
"4405",2019-03-03,"Gothic Rd","3","3","3",13.7,0.7,64,6,27,21.4,9,0,-1,0,15,15,14,14,"w1819","Non.motorized",6,"Sun","weekend"
"4406",2019-03-03,"Gothic Rd","3","3","3",13.7,0.7,64,6,27,21.4,9,0,-1,0,15,15,14,14,"w1819","Mechanized",0,"Sun","weekend"
"4407",2019-03-03,"Gothic Rd","3","3","3",13.7,0.7,64,6,27,21.4,9,0,-1,0,15,15,14,14,"w1819","Motorized",0,"Sun","weekend"
"4408",2019-03-03,"Gothic Rd","3","3","3",13.7,0.7,64,6,27,21.4,9,0,-1,0,15,15,14,14,"w1819","Hybrid",0,"Sun","weekend"
"4409",2019-03-04,"Gothic Rd","3","3","3",14.4,0.7,66,2,23,21.8,6,9,0,-1,8,17,17,16,"w1819","Non.motorized",0,"Mon","weekday"
"4410",2019-03-04,"Gothic Rd","3","3","3",14.4,0.7,66,2,23,21.8,6,9,0,-1,8,17,17,16,"w1819","Mechanized",0,"Mon","weekday"
"4411",2019-03-04,"Gothic Rd","3","3","3",14.4,0.7,66,2,23,21.8,6,9,0,-1,8,17,17,16,"w1819","Motorized",0,"Mon","weekday"
"4412",2019-03-04,"Gothic Rd","3","3","3",14.4,0.7,66,2,23,21.8,6,9,0,-1,8,17,17,16,"w1819","Hybrid",0,"Mon","weekday"
"4413",2019-03-05,"Gothic Rd","3","3","3",14.4,0,64,-2,24,22.5,2,6,9,0,0,6,15,15,"w1819","Non.motorized",8,"Tue","weekday"
"4414",2019-03-05,"Gothic Rd","3","3","3",14.4,0,64,-2,24,22.5,2,6,9,0,0,6,15,15,"w1819","Mechanized",0,"Tue","weekday"
"4415",2019-03-05,"Gothic Rd","3","3","3",14.4,0,64,-2,24,22.5,2,6,9,0,0,6,15,15,"w1819","Motorized",0,"Tue","weekday"
"4416",2019-03-05,"Gothic Rd","3","3","3",14.4,0,64,-2,24,22.5,2,6,9,0,0,6,15,15,"w1819","Hybrid",0,"Tue","weekday"
"4417",2019-03-06,"Gothic Rd","3","3","2",14.5,0.1,62,-2,31,23.4,-2,2,6,9,-4,-2,4,13,"w1819","Non.motorized",12,"Wed","weekday"
"4418",2019-03-06,"Gothic Rd","3","3","2",14.5,0.1,62,-2,31,23.4,-2,2,6,9,-4,-2,4,13,"w1819","Mechanized",0,"Wed","weekday"
"4419",2019-03-06,"Gothic Rd","3","3","2",14.5,0.1,62,-2,31,23.4,-2,2,6,9,-4,-2,4,13,"w1819","Motorized",0,"Wed","weekday"
"4420",2019-03-06,"Gothic Rd","3","3","2",14.5,0.1,62,-2,31,23.4,-2,2,6,9,-4,-2,4,13,"w1819","Hybrid",0,"Wed","weekday"
"4421",2019-03-06,"Gothic Rd","4","4","3",14.5,0.1,62,-2,31,23.4,-2,2,6,9,-4,-2,4,13,"w1819","Non.motorized",12,"Wed","weekday"
"4422",2019-03-06,"Gothic Rd","4","4","3",14.5,0.1,62,-2,31,23.4,-2,2,6,9,-4,-2,4,13,"w1819","Mechanized",0,"Wed","weekday"
"4423",2019-03-06,"Gothic Rd","4","4","3",14.5,0.1,62,-2,31,23.4,-2,2,6,9,-4,-2,4,13,"w1819","Motorized",0,"Wed","weekday"
"4424",2019-03-06,"Gothic Rd","4","4","3",14.5,0.1,62,-2,31,23.4,-2,2,6,9,-4,-2,4,13,"w1819","Hybrid",0,"Wed","weekday"
"4425",2019-03-07,"Gothic Rd","4","4","3",16.2,1.7,71,9,30,22.8,-2,-2,2,6,7,5,7,13,"w1819","Non.motorized",0,"Thu","weekday"
"4426",2019-03-07,"Gothic Rd","4","4","3",16.2,1.7,71,9,30,22.8,-2,-2,2,6,7,5,7,13,"w1819","Mechanized",0,"Thu","weekday"
"4427",2019-03-07,"Gothic Rd","4","4","3",16.2,1.7,71,9,30,22.8,-2,-2,2,6,7,5,7,13,"w1819","Motorized",0,"Thu","weekday"
"4428",2019-03-07,"Gothic Rd","4","4","3",16.2,1.7,71,9,30,22.8,-2,-2,2,6,7,5,7,13,"w1819","Hybrid",0,"Thu","weekday"
"4429",2019-03-08,"Gothic Rd","3","3","3",16.6,0.4,71,0,27,23.4,9,-2,-2,2,9,7,5,7,"w1819","Non.motorized",0,"Fri","weekday"
"4430",2019-03-08,"Gothic Rd","3","3","3",16.6,0.4,71,0,27,23.4,9,-2,-2,2,9,7,5,7,"w1819","Mechanized",0,"Fri","weekday"
"4431",2019-03-08,"Gothic Rd","3","3","3",16.6,0.4,71,0,27,23.4,9,-2,-2,2,9,7,5,7,"w1819","Motorized",0,"Fri","weekday"
"4432",2019-03-08,"Gothic Rd","3","3","3",16.6,0.4,71,0,27,23.4,9,-2,-2,2,9,7,5,7,"w1819","Hybrid",0,"Fri","weekday"
"4433",2019-03-09,"Gothic Rd","4","4","3",17.2,0.6,76,5,22,22.6,0,9,-2,-2,5,14,12,10,"w1819","Non.motorized",0,"Sat","weekend"
"4434",2019-03-09,"Gothic Rd","4","4","3",17.2,0.6,76,5,22,22.6,0,9,-2,-2,5,14,12,10,"w1819","Mechanized",0,"Sat","weekend"
"4435",2019-03-09,"Gothic Rd","4","4","3",17.2,0.6,76,5,22,22.6,0,9,-2,-2,5,14,12,10,"w1819","Motorized",0,"Sat","weekend"
"4436",2019-03-09,"Gothic Rd","4","4","3",17.2,0.6,76,5,22,22.6,0,9,-2,-2,5,14,12,10,"w1819","Hybrid",0,"Sat","weekend"
"4437",2019-03-10,"Gothic Rd","3","3","3",17.3,0.1,73,-3,25,23.7,5,0,9,-2,2,2,11,9,"w1819","Non.motorized",0,"Sun","weekend"
"4438",2019-03-10,"Gothic Rd","3","3","3",17.3,0.1,73,-3,25,23.7,5,0,9,-2,2,2,11,9,"w1819","Mechanized",0,"Sun","weekend"
"4439",2019-03-10,"Gothic Rd","3","3","3",17.3,0.1,73,-3,25,23.7,5,0,9,-2,2,2,11,9,"w1819","Motorized",0,"Sun","weekend"
"4440",2019-03-10,"Gothic Rd","3","3","3",17.3,0.1,73,-3,25,23.7,5,0,9,-2,2,2,11,9,"w1819","Hybrid",0,"Sun","weekend"
"4441",2019-03-11,"Gothic Rd","3","3","2",17.3,0,71,-2,29,24.4,-3,5,0,9,-5,0,0,9,"w1819","Non.motorized",9,"Mon","weekday"
"4442",2019-03-11,"Gothic Rd","3","3","2",17.3,0,71,-2,29,24.4,-3,5,0,9,-5,0,0,9,"w1819","Mechanized",0,"Mon","weekday"
"4443",2019-03-11,"Gothic Rd","3","3","2",17.3,0,71,-2,29,24.4,-3,5,0,9,-5,0,0,9,"w1819","Motorized",0,"Mon","weekday"
"4444",2019-03-11,"Gothic Rd","3","3","2",17.3,0,71,-2,29,24.4,-3,5,0,9,-5,0,0,9,"w1819","Hybrid",0,"Mon","weekday"
"4445",2019-03-12,"Gothic Rd","3","3","3",17.4,0.1,70,-1,32,24.9,-2,-3,5,0,-3,-6,-1,-1,"w1819","Non.motorized",7,"Tue","weekday"
"4446",2019-03-12,"Gothic Rd","3","3","3",17.4,0.1,70,-1,32,24.9,-2,-3,5,0,-3,-6,-1,-1,"w1819","Mechanized",1,"Tue","weekday"
"4447",2019-03-12,"Gothic Rd","3","3","3",17.4,0.1,70,-1,32,24.9,-2,-3,5,0,-3,-6,-1,-1,"w1819","Motorized",0,"Tue","weekday"
"4448",2019-03-12,"Gothic Rd","3","3","3",17.4,0.1,70,-1,32,24.9,-2,-3,5,0,-3,-6,-1,-1,"w1819","Hybrid",0,"Tue","weekday"
"4449",2019-03-12,"Gothic Rd","4","4","4",17.4,0.1,70,-1,32,24.9,-2,-3,5,0,-3,-6,-1,-1,"w1819","Non.motorized",7,"Tue","weekday"
"4450",2019-03-12,"Gothic Rd","4","4","4",17.4,0.1,70,-1,32,24.9,-2,-3,5,0,-3,-6,-1,-1,"w1819","Mechanized",1,"Tue","weekday"
"4451",2019-03-12,"Gothic Rd","4","4","4",17.4,0.1,70,-1,32,24.9,-2,-3,5,0,-3,-6,-1,-1,"w1819","Motorized",0,"Tue","weekday"
"4452",2019-03-12,"Gothic Rd","4","4","4",17.4,0.1,70,-1,32,24.9,-2,-3,5,0,-3,-6,-1,-1,"w1819","Hybrid",0,"Tue","weekday"
"4453",2019-03-13,"Gothic Rd","4","4","3",18.1,0.7,74,4,24,24.5,-1,-2,-3,5,3,1,-2,3,"w1819","Non.motorized",0,"Wed","weekday"
"4454",2019-03-13,"Gothic Rd","4","4","3",18.1,0.7,74,4,24,24.5,-1,-2,-3,5,3,1,-2,3,"w1819","Mechanized",0,"Wed","weekday"
"4455",2019-03-13,"Gothic Rd","4","4","3",18.1,0.7,74,4,24,24.5,-1,-2,-3,5,3,1,-2,3,"w1819","Motorized",0,"Wed","weekday"
"4456",2019-03-13,"Gothic Rd","4","4","3",18.1,0.7,74,4,24,24.5,-1,-2,-3,5,3,1,-2,3,"w1819","Hybrid",0,"Wed","weekday"
"4457",2019-03-14,"Gothic Rd","4","4","3",18.1,0,74,0,17,24.5,4,-1,-2,-3,4,3,1,-2,"w1819","Non.motorized",9,"Thu","weekday"
"4458",2019-03-14,"Gothic Rd","4","4","3",18.1,0,74,0,17,24.5,4,-1,-2,-3,4,3,1,-2,"w1819","Mechanized",0,"Thu","weekday"
"4459",2019-03-14,"Gothic Rd","4","4","3",18.1,0,74,0,17,24.5,4,-1,-2,-3,4,3,1,-2,"w1819","Motorized",0,"Thu","weekday"
"4460",2019-03-14,"Gothic Rd","4","4","3",18.1,0,74,0,17,24.5,4,-1,-2,-3,4,3,1,-2,"w1819","Hybrid",0,"Thu","weekday"
"4461",2019-03-15,"Gothic Rd","3","3","2",18.1,0,72,-2,18,25.1,0,4,-1,-2,-2,2,1,-1,"w1819","Non.motorized",7,"Fri","weekday"
"4462",2019-03-15,"Gothic Rd","3","3","2",18.1,0,72,-2,18,25.1,0,4,-1,-2,-2,2,1,-1,"w1819","Mechanized",0,"Fri","weekday"
"4463",2019-03-15,"Gothic Rd","3","3","2",18.1,0,72,-2,18,25.1,0,4,-1,-2,-2,2,1,-1,"w1819","Motorized",0,"Fri","weekday"
"4464",2019-03-15,"Gothic Rd","3","3","2",18.1,0,72,-2,18,25.1,0,4,-1,-2,-2,2,1,-1,"w1819","Hybrid",0,"Fri","weekday"
"4465",2019-03-16,"Gothic Rd","3","3","2",18.2,0.1,70,-2,26,26,-2,0,4,-1,-4,-4,0,-1,"w1819","Non.motorized",17,"Sat","weekend"
"4466",2019-03-16,"Gothic Rd","3","3","2",18.2,0.1,70,-2,26,26,-2,0,4,-1,-4,-4,0,-1,"w1819","Mechanized",1,"Sat","weekend"
"4467",2019-03-16,"Gothic Rd","3","3","2",18.2,0.1,70,-2,26,26,-2,0,4,-1,-4,-4,0,-1,"w1819","Motorized",0,"Sat","weekend"
"4468",2019-03-16,"Gothic Rd","3","3","2",18.2,0.1,70,-2,26,26,-2,0,4,-1,-4,-4,0,-1,"w1819","Hybrid",0,"Sat","weekend"
"4469",2019-03-17,"Gothic Rd","3","3","2",18.2,0,69,-1,28,26.4,-2,-2,0,4,-3,-5,-5,-1,"w1819","Non.motorized",26,"Sun","weekend"
"4470",2019-03-17,"Gothic Rd","3","3","2",18.2,0,69,-1,28,26.4,-2,-2,0,4,-3,-5,-5,-1,"w1819","Mechanized",2,"Sun","weekend"
"4471",2019-03-17,"Gothic Rd","3","3","2",18.2,0,69,-1,28,26.4,-2,-2,0,4,-3,-5,-5,-1,"w1819","Motorized",0,"Sun","weekend"
"4472",2019-03-17,"Gothic Rd","3","3","2",18.2,0,69,-1,28,26.4,-2,-2,0,4,-3,-5,-5,-1,"w1819","Hybrid",0,"Sun","weekend"
"4473",2019-03-18,"Gothic Rd","2","2","2",18.3,0.1,68,-1,29,26.9,-1,-2,-2,0,-2,-4,-6,-6,"w1819","Non.motorized",19,"Mon","weekday"
"4474",2019-03-18,"Gothic Rd","2","2","2",18.3,0.1,68,-1,29,26.9,-1,-2,-2,0,-2,-4,-6,-6,"w1819","Mechanized",0,"Mon","weekday"
"4475",2019-03-18,"Gothic Rd","2","2","2",18.3,0.1,68,-1,29,26.9,-1,-2,-2,0,-2,-4,-6,-6,"w1819","Motorized",1,"Mon","weekday"
"4476",2019-03-18,"Gothic Rd","2","2","2",18.3,0.1,68,-1,29,26.9,-1,-2,-2,0,-2,-4,-6,-6,"w1819","Hybrid",0,"Mon","weekday"
"4477",2019-03-19,"Gothic Rd","2","2","2",18.3,0,67,-1,28,27.3,-1,-1,-2,-2,-2,-3,-5,-7,"w1819","Non.motorized",0,"Tue","weekday"
"4478",2019-03-19,"Gothic Rd","2","2","2",18.3,0,67,-1,28,27.3,-1,-1,-2,-2,-2,-3,-5,-7,"w1819","Mechanized",0,"Tue","weekday"
"4479",2019-03-19,"Gothic Rd","2","2","2",18.3,0,67,-1,28,27.3,-1,-1,-2,-2,-2,-3,-5,-7,"w1819","Motorized",0,"Tue","weekday"
"4480",2019-03-19,"Gothic Rd","2","2","2",18.3,0,67,-1,28,27.3,-1,-1,-2,-2,-2,-3,-5,-7,"w1819","Hybrid",0,"Tue","weekday"
"4481",2019-03-20,"Gothic Rd","2","2","2",18.3,0,66,-1,30,27.7,-1,-1,-1,-2,-2,-3,-4,-6,"w1819","Non.motorized",0,"Wed","weekday"
"4482",2019-03-20,"Gothic Rd","2","2","2",18.3,0,66,-1,30,27.7,-1,-1,-1,-2,-2,-3,-4,-6,"w1819","Mechanized",0,"Wed","weekday"
"4483",2019-03-20,"Gothic Rd","2","2","2",18.3,0,66,-1,30,27.7,-1,-1,-1,-2,-2,-3,-4,-6,"w1819","Motorized",0,"Wed","weekday"
"4484",2019-03-20,"Gothic Rd","2","2","2",18.3,0,66,-1,30,27.7,-1,-1,-1,-2,-2,-3,-4,-6,"w1819","Hybrid",0,"Wed","weekday"
"4485",2019-03-21,"Gothic Rd","2","2","2",18.4,0.1,65,-1,33,28.3,-1,-1,-1,-1,-2,-3,-4,-5,"w1819","Non.motorized",0,"Thu","weekday"
"4486",2019-03-21,"Gothic Rd","2","2","2",18.4,0.1,65,-1,33,28.3,-1,-1,-1,-1,-2,-3,-4,-5,"w1819","Mechanized",0,"Thu","weekday"
"4487",2019-03-21,"Gothic Rd","2","2","2",18.4,0.1,65,-1,33,28.3,-1,-1,-1,-1,-2,-3,-4,-5,"w1819","Motorized",0,"Thu","weekday"
"4488",2019-03-21,"Gothic Rd","2","2","2",18.4,0.1,65,-1,33,28.3,-1,-1,-1,-1,-2,-3,-4,-5,"w1819","Hybrid",0,"Thu","weekday"
"4489",2019-03-22,"Gothic Rd","3","3","2",18.4,0,64,-1,28,28.8,-1,-1,-1,-1,-2,-3,-4,-5,"w1819","Non.motorized",0,"Fri","weekday"
"4490",2019-03-22,"Gothic Rd","3","3","2",18.4,0,64,-1,28,28.8,-1,-1,-1,-1,-2,-3,-4,-5,"w1819","Mechanized",0,"Fri","weekday"
"4491",2019-03-22,"Gothic Rd","3","3","2",18.4,0,64,-1,28,28.8,-1,-1,-1,-1,-2,-3,-4,-5,"w1819","Motorized",0,"Fri","weekday"
"4492",2019-03-22,"Gothic Rd","3","3","2",18.4,0,64,-1,28,28.8,-1,-1,-1,-1,-2,-3,-4,-5,"w1819","Hybrid",0,"Fri","weekday"
"4493",2019-03-23,"Gothic Rd","2","2","1",18.4,0,65,1,28,28.3,-1,-1,-1,-1,0,-1,-2,-3,"w1819","Non.motorized",0,"Sat","weekend"
"4494",2019-03-23,"Gothic Rd","2","2","1",18.4,0,65,1,28,28.3,-1,-1,-1,-1,0,-1,-2,-3,"w1819","Mechanized",0,"Sat","weekend"
"4495",2019-03-23,"Gothic Rd","2","2","1",18.4,0,65,1,28,28.3,-1,-1,-1,-1,0,-1,-2,-3,"w1819","Motorized",0,"Sat","weekend"
"4496",2019-03-23,"Gothic Rd","2","2","1",18.4,0,65,1,28,28.3,-1,-1,-1,-1,0,-1,-2,-3,"w1819","Hybrid",0,"Sat","weekend"
"4497",2019-03-24,"Gothic Rd","2","2","1",18.4,0,64,-1,29,28.8,1,-1,-1,-1,0,-1,-2,-3,"w1819","Non.motorized",0,"Sun","weekend"
"4498",2019-03-24,"Gothic Rd","2","2","1",18.4,0,64,-1,29,28.8,1,-1,-1,-1,0,-1,-2,-3,"w1819","Mechanized",0,"Sun","weekend"
"4499",2019-03-24,"Gothic Rd","2","2","1",18.4,0,64,-1,29,28.8,1,-1,-1,-1,0,-1,-2,-3,"w1819","Motorized",0,"Sun","weekend"
"4500",2019-03-24,"Gothic Rd","2","2","1",18.4,0,64,-1,29,28.8,1,-1,-1,-1,0,-1,-2,-3,"w1819","Hybrid",0,"Sun","weekend"
"4501",2019-03-25,"Gothic Rd","2","2","2",18.6,0.2,64,0,31,29.1,-1,1,-1,-1,-1,0,-1,-2,"w1819","Non.motorized",4,"Mon","weekday"
"4502",2019-03-25,"Gothic Rd","2","2","2",18.6,0.2,64,0,31,29.1,-1,1,-1,-1,-1,0,-1,-2,"w1819","Mechanized",0,"Mon","weekday"
"4503",2019-03-25,"Gothic Rd","2","2","2",18.6,0.2,64,0,31,29.1,-1,1,-1,-1,-1,0,-1,-2,"w1819","Motorized",0,"Mon","weekday"
"4504",2019-03-25,"Gothic Rd","2","2","2",18.6,0.2,64,0,31,29.1,-1,1,-1,-1,-1,0,-1,-2,"w1819","Hybrid",0,"Mon","weekday"
"4505",2019-03-26,"Gothic Rd","2","2","2",18.9,0.3,63,-1,36,30,0,-1,1,-1,-1,-2,-1,-2,"w1819","Non.motorized",31,"Tue","weekday"
"4506",2019-03-26,"Gothic Rd","2","2","2",18.9,0.3,63,-1,36,30,0,-1,1,-1,-1,-2,-1,-2,"w1819","Mechanized",0,"Tue","weekday"
"4507",2019-03-26,"Gothic Rd","2","2","2",18.9,0.3,63,-1,36,30,0,-1,1,-1,-1,-2,-1,-2,"w1819","Motorized",0,"Tue","weekday"
"4508",2019-03-26,"Gothic Rd","2","2","2",18.9,0.3,63,-1,36,30,0,-1,1,-1,-1,-2,-1,-2,"w1819","Hybrid",0,"Tue","weekday"
"4509",2019-03-27,"Gothic Rd","1","2","2",18.9,0,62,-1,42,30.5,-1,0,-1,1,-2,-2,-3,-2,"w1819","Non.motorized",21,"Wed","weekday"
"4510",2019-03-27,"Gothic Rd","1","2","2",18.9,0,62,-1,42,30.5,-1,0,-1,1,-2,-2,-3,-2,"w1819","Mechanized",5,"Wed","weekday"
"4511",2019-03-27,"Gothic Rd","1","2","2",18.9,0,62,-1,42,30.5,-1,0,-1,1,-2,-2,-3,-2,"w1819","Motorized",0,"Wed","weekday"
"4512",2019-03-27,"Gothic Rd","1","2","2",18.9,0,62,-1,42,30.5,-1,0,-1,1,-2,-2,-3,-2,"w1819","Hybrid",0,"Wed","weekday"
"4513",2019-03-28,"Gothic Rd","1","2","2",18.9,0,60,-2,40,31.5,-1,-1,0,-1,-3,-4,-4,-5,"w1819","Non.motorized",21,"Thu","weekday"
"4514",2019-03-28,"Gothic Rd","1","2","2",18.9,0,60,-2,40,31.5,-1,-1,0,-1,-3,-4,-4,-5,"w1819","Mechanized",1,"Thu","weekday"
"4515",2019-03-28,"Gothic Rd","1","2","2",18.9,0,60,-2,40,31.5,-1,-1,0,-1,-3,-4,-4,-5,"w1819","Motorized",0,"Thu","weekday"
"4516",2019-03-28,"Gothic Rd","1","2","2",18.9,0,60,-2,40,31.5,-1,-1,0,-1,-3,-4,-4,-5,"w1819","Hybrid",0,"Thu","weekday"
"4517",2019-03-29,"Gothic Rd","1","1","1",19,0.1,58,-2,26,32.8,-2,-1,-1,0,-4,-5,-6,-6,"w1819","Non.motorized",16,"Fri","weekday"
"4518",2019-03-29,"Gothic Rd","1","1","1",19,0.1,58,-2,26,32.8,-2,-1,-1,0,-4,-5,-6,-6,"w1819","Mechanized",1,"Fri","weekday"
"4519",2019-03-29,"Gothic Rd","1","1","1",19,0.1,58,-2,26,32.8,-2,-1,-1,0,-4,-5,-6,-6,"w1819","Motorized",0,"Fri","weekday"
"4520",2019-03-29,"Gothic Rd","1","1","1",19,0.1,58,-2,26,32.8,-2,-1,-1,0,-4,-5,-6,-6,"w1819","Hybrid",0,"Fri","weekday"
"4521",2019-03-30,"Gothic Rd","1","1","1",19.1,0.1,61,3,24,31.3,-2,-2,-1,-1,1,-1,-2,-3,"w1819","Non.motorized",37,"Sat","weekend"
"4522",2019-03-30,"Gothic Rd","1","1","1",19.1,0.1,61,3,24,31.3,-2,-2,-1,-1,1,-1,-2,-3,"w1819","Mechanized",3,"Sat","weekend"
"4523",2019-03-30,"Gothic Rd","1","1","1",19.1,0.1,61,3,24,31.3,-2,-2,-1,-1,1,-1,-2,-3,"w1819","Motorized",0,"Sat","weekend"
"4524",2019-03-30,"Gothic Rd","1","1","1",19.1,0.1,61,3,24,31.3,-2,-2,-1,-1,1,-1,-2,-3,"w1819","Hybrid",0,"Sat","weekend"
"4525",2019-03-31,"Gothic Rd","1","1","1",19.1,0,59,-2,24,32.4,3,-2,-2,-1,1,-1,-3,-4,"w1819","Non.motorized",10,"Sun","weekend"
"4526",2019-03-31,"Gothic Rd","1","1","1",19.1,0,59,-2,24,32.4,3,-2,-2,-1,1,-1,-3,-4,"w1819","Mechanized",0,"Sun","weekend"
"4527",2019-03-31,"Gothic Rd","1","1","1",19.1,0,59,-2,24,32.4,3,-2,-2,-1,1,-1,-3,-4,"w1819","Motorized",0,"Sun","weekend"
"4528",2019-03-31,"Gothic Rd","1","1","1",19.1,0,59,-2,24,32.4,3,-2,-2,-1,1,-1,-3,-4,"w1819","Hybrid",0,"Sun","weekend"
"4529",2019-04-01,"Gothic Rd","2","1","1",19.1,0,58,-1,29,32.9,-2,3,-2,-2,-3,0,-2,-4,"w1819","Non.motorized",0,"Mon","weekday"
"4530",2019-04-01,"Gothic Rd","2","1","1",19.1,0,58,-1,29,32.9,-2,3,-2,-2,-3,0,-2,-4,"w1819","Mechanized",0,"Mon","weekday"
"4531",2019-04-01,"Gothic Rd","2","1","1",19.1,0,58,-1,29,32.9,-2,3,-2,-2,-3,0,-2,-4,"w1819","Motorized",0,"Mon","weekday"
"4532",2019-04-01,"Gothic Rd","2","1","1",19.1,0,58,-1,29,32.9,-2,3,-2,-2,-3,0,-2,-4,"w1819","Hybrid",0,"Mon","weekday"
"4533",2019-04-02,"Gothic Rd","1","1","1",19.1,0,58,0,33,32.9,-1,-2,3,-2,-1,-3,0,-2,"w1819","Non.motorized",0,"Tue","weekday"
"4534",2019-04-02,"Gothic Rd","1","1","1",19.1,0,58,0,33,32.9,-1,-2,3,-2,-1,-3,0,-2,"w1819","Mechanized",0,"Tue","weekday"
"4535",2019-04-02,"Gothic Rd","1","1","1",19.1,0,58,0,33,32.9,-1,-2,3,-2,-1,-3,0,-2,"w1819","Motorized",0,"Tue","weekday"
"4536",2019-04-02,"Gothic Rd","1","1","1",19.1,0,58,0,33,32.9,-1,-2,3,-2,-1,-3,0,-2,"w1819","Hybrid",0,"Tue","weekday"
"4537",2019-04-03,"Gothic Rd","2","1","1",19.2,0.1,58,0,31,33.1,0,-1,-2,3,0,-1,-3,0,"w1819","Non.motorized",0,"Wed","weekday"
"4538",2019-04-03,"Gothic Rd","2","1","1",19.2,0.1,58,0,31,33.1,0,-1,-2,3,0,-1,-3,0,"w1819","Mechanized",0,"Wed","weekday"
"4539",2019-04-03,"Gothic Rd","2","1","1",19.2,0.1,58,0,31,33.1,0,-1,-2,3,0,-1,-3,0,"w1819","Motorized",0,"Wed","weekday"
"4540",2019-04-03,"Gothic Rd","2","1","1",19.2,0.1,58,0,31,33.1,0,-1,-2,3,0,-1,-3,0,"w1819","Hybrid",0,"Wed","weekday"
"4541",2019-04-04,"Gothic Rd","2","1","1",19.4,0.2,59,1,35,32.9,0,0,-1,-2,1,1,0,-2,"w1819","Non.motorized",0,"Thu","weekday"
"4542",2019-04-04,"Gothic Rd","2","1","1",19.4,0.2,59,1,35,32.9,0,0,-1,-2,1,1,0,-2,"w1819","Mechanized",0,"Thu","weekday"
"4543",2019-04-04,"Gothic Rd","2","1","1",19.4,0.2,59,1,35,32.9,0,0,-1,-2,1,1,0,-2,"w1819","Motorized",0,"Thu","weekday"
"4544",2019-04-04,"Gothic Rd","2","1","1",19.4,0.2,59,1,35,32.9,0,0,-1,-2,1,1,0,-2,"w1819","Hybrid",0,"Thu","weekday"
"4545",2019-04-05,"Gothic Rd","1","1","1",19.4,0,57,-2,38,34,1,0,0,-1,-1,-1,-1,-2,"w1819","Non.motorized",0,"Fri","weekday"
"4546",2019-04-05,"Gothic Rd","1","1","1",19.4,0,57,-2,38,34,1,0,0,-1,-1,-1,-1,-2,"w1819","Mechanized",0,"Fri","weekday"
"4547",2019-04-05,"Gothic Rd","1","1","1",19.4,0,57,-2,38,34,1,0,0,-1,-1,-1,-1,-2,"w1819","Motorized",0,"Fri","weekday"
"4548",2019-04-05,"Gothic Rd","1","1","1",19.4,0,57,-2,38,34,1,0,0,-1,-1,-1,-1,-2,"w1819","Hybrid",0,"Fri","weekday"
"4549",2019-04-06,"Gothic Rd","1","1","1",19.3,-0.1,57,0,35,33.9,-2,1,0,0,-2,-1,-1,-1,"w1819","Non.motorized",0,"Sat","weekend"
"4550",2019-04-06,"Gothic Rd","1","1","1",19.3,-0.1,57,0,35,33.9,-2,1,0,0,-2,-1,-1,-1,"w1819","Mechanized",0,"Sat","weekend"
"4551",2019-04-06,"Gothic Rd","1","1","1",19.3,-0.1,57,0,35,33.9,-2,1,0,0,-2,-1,-1,-1,"w1819","Motorized",0,"Sat","weekend"
"4552",2019-04-06,"Gothic Rd","1","1","1",19.3,-0.1,57,0,35,33.9,-2,1,0,0,-2,-1,-1,-1,"w1819","Hybrid",0,"Sat","weekend"
"4553",2019-04-07,"Gothic Rd","1","1","1",19.1,-0.2,57,0,37,33.5,0,-2,1,0,0,-2,-1,-1,"w1819","Non.motorized",0,"Sun","weekend"
"4554",2019-04-07,"Gothic Rd","1","1","1",19.1,-0.2,57,0,37,33.5,0,-2,1,0,0,-2,-1,-1,"w1819","Mechanized",0,"Sun","weekend"
"4555",2019-04-07,"Gothic Rd","1","1","1",19.1,-0.2,57,0,37,33.5,0,-2,1,0,0,-2,-1,-1,"w1819","Motorized",0,"Sun","weekend"
"4556",2019-04-07,"Gothic Rd","1","1","1",19.1,-0.2,57,0,37,33.5,0,-2,1,0,0,-2,-1,-1,"w1819","Hybrid",0,"Sun","weekend"
"4557",2019-04-08,"Gothic Rd","1","2","2",19.3,0.2,54,-3,41,35.7,0,0,-2,1,-3,-3,-5,-4,"w1819","Non.motorized",0,"Mon","weekday"
"4558",2019-04-08,"Gothic Rd","1","2","2",19.3,0.2,54,-3,41,35.7,0,0,-2,1,-3,-3,-5,-4,"w1819","Mechanized",0,"Mon","weekday"
"4559",2019-04-08,"Gothic Rd","1","2","2",19.3,0.2,54,-3,41,35.7,0,0,-2,1,-3,-3,-5,-4,"w1819","Motorized",0,"Mon","weekday"
"4560",2019-04-08,"Gothic Rd","1","2","2",19.3,0.2,54,-3,41,35.7,0,0,-2,1,-3,-3,-5,-4,"w1819","Hybrid",0,"Mon","weekday"
"4561",2019-04-09,"Gothic Rd","1","2","2",19.3,0,53,-1,43,36.4,-3,0,0,-2,-4,-4,-4,-6,"w1819","Non.motorized",0,"Tue","weekday"
"4562",2019-04-09,"Gothic Rd","1","2","2",19.3,0,53,-1,43,36.4,-3,0,0,-2,-4,-4,-4,-6,"w1819","Mechanized",0,"Tue","weekday"
"4563",2019-04-09,"Gothic Rd","1","2","2",19.3,0,53,-1,43,36.4,-3,0,0,-2,-4,-4,-4,-6,"w1819","Motorized",0,"Tue","weekday"
"4564",2019-04-09,"Gothic Rd","1","2","2",19.3,0,53,-1,43,36.4,-3,0,0,-2,-4,-4,-4,-6,"w1819","Hybrid",0,"Tue","weekday"
"4565",2019-04-10,"Gothic Rd","2","2","1",19,-0.3,51,-2,30,37.3,-1,-3,0,0,-3,-6,-6,-6,"w1819","Non.motorized",0,"Wed","weekday"
"4566",2019-04-10,"Gothic Rd","2","2","1",19,-0.3,51,-2,30,37.3,-1,-3,0,0,-3,-6,-6,-6,"w1819","Mechanized",0,"Wed","weekday"
"4567",2019-04-10,"Gothic Rd","2","2","1",19,-0.3,51,-2,30,37.3,-1,-3,0,0,-3,-6,-6,-6,"w1819","Motorized",0,"Wed","weekday"
"4568",2019-04-10,"Gothic Rd","2","2","1",19,-0.3,51,-2,30,37.3,-1,-3,0,0,-3,-6,-6,-6,"w1819","Hybrid",0,"Wed","weekday"
"4569",2019-04-11,"Gothic Rd","3","3","2",18.9,-0.1,53,2,20,35.7,-2,-1,-3,0,0,-1,-4,-4,"w1819","Non.motorized",0,"Thu","weekday"
"4570",2019-04-11,"Gothic Rd","3","3","2",18.9,-0.1,53,2,20,35.7,-2,-1,-3,0,0,-1,-4,-4,"w1819","Mechanized",0,"Thu","weekday"
"4571",2019-04-11,"Gothic Rd","3","3","2",18.9,-0.1,53,2,20,35.7,-2,-1,-3,0,0,-1,-4,-4,"w1819","Motorized",0,"Thu","weekday"
"4572",2019-04-11,"Gothic Rd","3","3","2",18.9,-0.1,53,2,20,35.7,-2,-1,-3,0,0,-1,-4,-4,"w1819","Hybrid",0,"Thu","weekday"
"4573",2019-04-12,"Gothic Rd","2","2","1",18.7,-0.2,53,0,24,35.3,2,-2,-1,-3,2,0,-1,-4,"w1819","Non.motorized",0,"Fri","weekday"
"4574",2019-04-12,"Gothic Rd","2","2","1",18.7,-0.2,53,0,24,35.3,2,-2,-1,-3,2,0,-1,-4,"w1819","Mechanized",0,"Fri","weekday"
"4575",2019-04-12,"Gothic Rd","2","2","1",18.7,-0.2,53,0,24,35.3,2,-2,-1,-3,2,0,-1,-4,"w1819","Motorized",0,"Fri","weekday"
"4576",2019-04-12,"Gothic Rd","2","2","1",18.7,-0.2,53,0,24,35.3,2,-2,-1,-3,2,0,-1,-4,"w1819","Hybrid",0,"Fri","weekday"
"4577",2019-04-13,"Gothic Rd","1","1","1",18.8,0.1,52,-1,27,36.2,0,2,-2,-1,-1,1,-1,-2,"w1819","Non.motorized",0,"Sat","weekend"
"4578",2019-04-13,"Gothic Rd","1","1","1",18.8,0.1,52,-1,27,36.2,0,2,-2,-1,-1,1,-1,-2,"w1819","Mechanized",0,"Sat","weekend"
"4579",2019-04-13,"Gothic Rd","1","1","1",18.8,0.1,52,-1,27,36.2,0,2,-2,-1,-1,1,-1,-2,"w1819","Motorized",0,"Sat","weekend"
"4580",2019-04-13,"Gothic Rd","1","1","1",18.8,0.1,52,-1,27,36.2,0,2,-2,-1,-1,1,-1,-2,"w1819","Hybrid",0,"Sat","weekend"
"4581",2019-04-14,"Gothic Rd","1","1","1",18.7,-0.1,51,-1,35,36.7,-1,0,2,-2,-2,-2,0,-2,"w1819","Non.motorized",0,"Sun","weekend"
"4582",2019-04-14,"Gothic Rd","1","1","1",18.7,-0.1,51,-1,35,36.7,-1,0,2,-2,-2,-2,0,-2,"w1819","Mechanized",0,"Sun","weekend"
"4583",2019-04-14,"Gothic Rd","1","1","1",18.7,-0.1,51,-1,35,36.7,-1,0,2,-2,-2,-2,0,-2,"w1819","Motorized",0,"Sun","weekend"
"4584",2019-04-14,"Gothic Rd","1","1","1",18.7,-0.1,51,-1,35,36.7,-1,0,2,-2,-2,-2,0,-2,"w1819","Hybrid",0,"Sun","weekend"
"4585",2019-04-15,"Gothic Rd",NA,NA,NA,18.6,-0.1,50,-1,41,37.2,-1,-1,0,2,-2,-3,-3,-1,"w1819","Non.motorized",0,"Mon","weekday"
"4586",2019-04-15,"Gothic Rd",NA,NA,NA,18.6,-0.1,50,-1,41,37.2,-1,-1,0,2,-2,-3,-3,-1,"w1819","Mechanized",0,"Mon","weekday"
"4587",2019-04-15,"Gothic Rd",NA,NA,NA,18.6,-0.1,50,-1,41,37.2,-1,-1,0,2,-2,-3,-3,-1,"w1819","Motorized",0,"Mon","weekday"
"4588",2019-04-15,"Gothic Rd",NA,NA,NA,18.6,-0.1,50,-1,41,37.2,-1,-1,0,2,-2,-3,-3,-1,"w1819","Hybrid",0,"Mon","weekday"
"4589",2018-12-01,"Kebler","3","3","2",3.3,0.2,19,1,16,17.4,0,0,0,0,1,1,1,1,"w1819","Non.motorized",NA,"Sat","weekend"
"4590",2018-12-01,"Kebler","3","3","2",3.3,0.2,19,1,16,17.4,0,0,0,0,1,1,1,1,"w1819","Mechanized",NA,"Sat","weekend"
"4591",2018-12-01,"Kebler","3","3","2",3.3,0.2,19,1,16,17.4,0,0,0,0,1,1,1,1,"w1819","Motorized",NA,"Sat","weekend"
"4592",2018-12-01,"Kebler","3","3","2",3.3,0.2,19,1,16,17.4,0,0,0,0,1,1,1,1,"w1819","Hybrid",NA,"Sat","weekend"
"4593",2018-12-02,"Kebler","3","3","3",3.3,0,20,1,14,16.5,1,0,0,0,2,2,2,2,"w1819","Non.motorized",NA,"Sun","weekend"
"4594",2018-12-02,"Kebler","3","3","3",3.3,0,20,1,14,16.5,1,0,0,0,2,2,2,2,"w1819","Mechanized",NA,"Sun","weekend"
"4595",2018-12-02,"Kebler","3","3","3",3.3,0,20,1,14,16.5,1,0,0,0,2,2,2,2,"w1819","Motorized",NA,"Sun","weekend"
"4596",2018-12-02,"Kebler","3","3","3",3.3,0,20,1,14,16.5,1,0,0,0,2,2,2,2,"w1819","Hybrid",NA,"Sun","weekend"
"4597",2018-12-03,"Kebler","3","3","2",3.4,0.1,19,-1,13,17.9,1,1,0,0,0,1,1,1,"w1819","Non.motorized",NA,"Mon","weekday"
"4598",2018-12-03,"Kebler","3","3","2",3.4,0.1,19,-1,13,17.9,1,1,0,0,0,1,1,1,"w1819","Mechanized",NA,"Mon","weekday"
"4599",2018-12-03,"Kebler","3","3","2",3.4,0.1,19,-1,13,17.9,1,1,0,0,0,1,1,1,"w1819","Motorized",NA,"Mon","weekday"
"4600",2018-12-03,"Kebler","3","3","2",3.4,0.1,19,-1,13,17.9,1,1,0,0,0,1,1,1,"w1819","Hybrid",NA,"Mon","weekday"
"4601",2018-12-04,"Kebler","3","3","2",3.5,0.1,20,1,8,17.5,-1,1,1,0,0,1,2,2,"w1819","Non.motorized",NA,"Tue","weekday"
"4602",2018-12-04,"Kebler","3","3","2",3.5,0.1,20,1,8,17.5,-1,1,1,0,0,1,2,2,"w1819","Mechanized",NA,"Tue","weekday"
"4603",2018-12-04,"Kebler","3","3","2",3.5,0.1,20,1,8,17.5,-1,1,1,0,0,1,2,2,"w1819","Motorized",NA,"Tue","weekday"
"4604",2018-12-04,"Kebler","3","3","2",3.5,0.1,20,1,8,17.5,-1,1,1,0,0,1,2,2,"w1819","Hybrid",NA,"Tue","weekday"
"4605",2018-12-05,"Kebler","3","3","2",3.5,0,19,-1,21,18.4,1,-1,1,1,0,-1,0,1,"w1819","Non.motorized",0,"Wed","weekday"
"4606",2018-12-05,"Kebler","3","3","2",3.5,0,19,-1,21,18.4,1,-1,1,1,0,-1,0,1,"w1819","Mechanized",0,"Wed","weekday"
"4607",2018-12-05,"Kebler","3","3","2",3.5,0,19,-1,21,18.4,1,-1,1,1,0,-1,0,1,"w1819","Motorized",4,"Wed","weekday"
"4608",2018-12-05,"Kebler","3","3","2",3.5,0,19,-1,21,18.4,1,-1,1,1,0,-1,0,1,"w1819","Hybrid",0,"Wed","weekday"
"4609",2018-12-06,"Kebler","2","2","2",3.7,0.2,18,-1,25,20.6,-1,1,-1,1,-2,-1,-2,-1,"w1819","Non.motorized",0,"Thu","weekday"
"4610",2018-12-06,"Kebler","2","2","2",3.7,0.2,18,-1,25,20.6,-1,1,-1,1,-2,-1,-2,-1,"w1819","Mechanized",0,"Thu","weekday"
"4611",2018-12-06,"Kebler","2","2","2",3.7,0.2,18,-1,25,20.6,-1,1,-1,1,-2,-1,-2,-1,"w1819","Motorized",7,"Thu","weekday"
"4612",2018-12-06,"Kebler","2","2","2",3.7,0.2,18,-1,25,20.6,-1,1,-1,1,-2,-1,-2,-1,"w1819","Hybrid",0,"Thu","weekday"
"4613",2018-12-07,"Kebler","2","2","2",3.8,0.1,21,3,23,18.1,-1,-1,1,-1,2,1,2,1,"w1819","Non.motorized",4,"Fri","weekday"
"4614",2018-12-07,"Kebler","2","2","2",3.8,0.1,21,3,23,18.1,-1,-1,1,-1,2,1,2,1,"w1819","Mechanized",0,"Fri","weekday"
"4615",2018-12-07,"Kebler","2","2","2",3.8,0.1,21,3,23,18.1,-1,-1,1,-1,2,1,2,1,"w1819","Motorized",8,"Fri","weekday"
"4616",2018-12-07,"Kebler","2","2","2",3.8,0.1,21,3,23,18.1,-1,-1,1,-1,2,1,2,1,"w1819","Hybrid",0,"Fri","weekday"
"4617",2018-12-08,"Kebler","2","2","2",3.8,0,20,-1,23,19,3,-1,-1,1,2,1,0,1,"w1819","Non.motorized",9,"Sat","weekend"
"4618",2018-12-08,"Kebler","2","2","2",3.8,0,20,-1,23,19,3,-1,-1,1,2,1,0,1,"w1819","Mechanized",0,"Sat","weekend"
"4619",2018-12-08,"Kebler","2","2","2",3.8,0,20,-1,23,19,3,-1,-1,1,2,1,0,1,"w1819","Motorized",30,"Sat","weekend"
"4620",2018-12-08,"Kebler","2","2","2",3.8,0,20,-1,23,19,3,-1,-1,1,2,1,0,1,"w1819","Hybrid",0,"Sat","weekend"
"4621",2018-12-09,"Kebler","2","2","2",3.8,0,20,0,19,19,-1,3,-1,-1,-1,2,1,0,"w1819","Non.motorized",0,"Sun","weekend"
"4622",2018-12-09,"Kebler","2","2","2",3.8,0,20,0,19,19,-1,3,-1,-1,-1,2,1,0,"w1819","Mechanized",1,"Sun","weekend"
"4623",2018-12-09,"Kebler","2","2","2",3.8,0,20,0,19,19,-1,3,-1,-1,-1,2,1,0,"w1819","Motorized",26,"Sun","weekend"
"4624",2018-12-09,"Kebler","2","2","2",3.8,0,20,0,19,19,-1,3,-1,-1,-1,2,1,0,"w1819","Hybrid",0,"Sun","weekend"
"4625",2018-12-10,"Kebler","2","2","2",3.8,0,20,0,21,19,0,-1,3,-1,0,-1,2,1,"w1819","Non.motorized",0,"Mon","weekday"
"4626",2018-12-10,"Kebler","2","2","2",3.8,0,20,0,21,19,0,-1,3,-1,0,-1,2,1,"w1819","Mechanized",0,"Mon","weekday"
"4627",2018-12-10,"Kebler","2","2","2",3.8,0,20,0,21,19,0,-1,3,-1,0,-1,2,1,"w1819","Motorized",19,"Mon","weekday"
"4628",2018-12-10,"Kebler","2","2","2",3.8,0,20,0,21,19,0,-1,3,-1,0,-1,2,1,"w1819","Hybrid",0,"Mon","weekday"
"4629",2018-12-11,"Kebler","2","2","2",3.9,0.1,19,-1,27,20.5,0,0,-1,3,-1,-1,-2,1,"w1819","Non.motorized",1,"Tue","weekday"
"4630",2018-12-11,"Kebler","2","2","2",3.9,0.1,19,-1,27,20.5,0,0,-1,3,-1,-1,-2,1,"w1819","Mechanized",0,"Tue","weekday"
"4631",2018-12-11,"Kebler","2","2","2",3.9,0.1,19,-1,27,20.5,0,0,-1,3,-1,-1,-2,1,"w1819","Motorized",10,"Tue","weekday"
"4632",2018-12-11,"Kebler","2","2","2",3.9,0.1,19,-1,27,20.5,0,0,-1,3,-1,-1,-2,1,"w1819","Hybrid",0,"Tue","weekday"
"4633",2018-12-12,"Kebler","2","2","1",3.9,0,19,0,21,20.5,-1,0,0,-1,-1,-1,-1,-2,"w1819","Non.motorized",3,"Wed","weekday"
"4634",2018-12-12,"Kebler","2","2","1",3.9,0,19,0,21,20.5,-1,0,0,-1,-1,-1,-1,-2,"w1819","Mechanized",0,"Wed","weekday"
"4635",2018-12-12,"Kebler","2","2","1",3.9,0,19,0,21,20.5,-1,0,0,-1,-1,-1,-1,-2,"w1819","Motorized",6,"Wed","weekday"
"4636",2018-12-12,"Kebler","2","2","1",3.9,0,19,0,21,20.5,-1,0,0,-1,-1,-1,-1,-2,"w1819","Hybrid",0,"Wed","weekday"
"4637",2018-12-13,"Kebler","3","3","2",4,0.1,21,2,15,19,0,-1,0,0,2,1,1,1,"w1819","Non.motorized",0,"Thu","weekday"
"4638",2018-12-13,"Kebler","3","3","2",4,0.1,21,2,15,19,0,-1,0,0,2,1,1,1,"w1819","Mechanized",0,"Thu","weekday"
"4639",2018-12-13,"Kebler","3","3","2",4,0.1,21,2,15,19,0,-1,0,0,2,1,1,1,"w1819","Motorized",13,"Thu","weekday"
"4640",2018-12-13,"Kebler","3","3","2",4,0.1,21,2,15,19,0,-1,0,0,2,1,1,1,"w1819","Hybrid",0,"Thu","weekday"
"4641",2018-12-14,"Kebler","3","3","2",4,0,20,-1,24,20,2,0,-1,0,1,1,0,0,"w1819","Non.motorized",1,"Fri","weekday"
"4642",2018-12-14,"Kebler","3","3","2",4,0,20,-1,24,20,2,0,-1,0,1,1,0,0,"w1819","Mechanized",0,"Fri","weekday"
"4643",2018-12-14,"Kebler","3","3","2",4,0,20,-1,24,20,2,0,-1,0,1,1,0,0,"w1819","Motorized",23,"Fri","weekday"
"4644",2018-12-14,"Kebler","3","3","2",4,0,20,-1,24,20,2,0,-1,0,1,1,0,0,"w1819","Hybrid",0,"Fri","weekday"
"4645",2018-12-15,"Kebler","2","2","2",4,0,20,0,29,20,-1,2,0,-1,-1,1,1,0,"w1819","Non.motorized",1,"Sat","weekend"
"4646",2018-12-15,"Kebler","2","2","2",4,0,20,0,29,20,-1,2,0,-1,-1,1,1,0,"w1819","Mechanized",0,"Sat","weekend"
"4647",2018-12-15,"Kebler","2","2","2",4,0,20,0,29,20,-1,2,0,-1,-1,1,1,0,"w1819","Motorized",20,"Sat","weekend"
"4648",2018-12-15,"Kebler","2","2","2",4,0,20,0,29,20,-1,2,0,-1,-1,1,1,0,"w1819","Hybrid",0,"Sat","weekend"
"4649",2018-12-16,"Kebler","2","2","2",4.1,0.1,19,-1,28,21.6,0,-1,2,0,-1,-2,0,0,"w1819","Non.motorized",6,"Sun","weekend"
"4650",2018-12-16,"Kebler","2","2","2",4.1,0.1,19,-1,28,21.6,0,-1,2,0,-1,-2,0,0,"w1819","Mechanized",0,"Sun","weekend"
"4651",2018-12-16,"Kebler","2","2","2",4.1,0.1,19,-1,28,21.6,0,-1,2,0,-1,-2,0,0,"w1819","Motorized",20,"Sun","weekend"
"4652",2018-12-16,"Kebler","2","2","2",4.1,0.1,19,-1,28,21.6,0,-1,2,0,-1,-2,0,0,"w1819","Hybrid",0,"Sun","weekend"
"4653",2018-12-17,"Kebler","2","2","2",4.1,0,19,0,29,21.6,-1,0,-1,2,-1,-1,-2,0,"w1819","Non.motorized",1,"Mon","weekday"
"4654",2018-12-17,"Kebler","2","2","2",4.1,0,19,0,29,21.6,-1,0,-1,2,-1,-1,-2,0,"w1819","Mechanized",0,"Mon","weekday"
"4655",2018-12-17,"Kebler","2","2","2",4.1,0,19,0,29,21.6,-1,0,-1,2,-1,-1,-2,0,"w1819","Motorized",15,"Mon","weekday"
"4656",2018-12-17,"Kebler","2","2","2",4.1,0,19,0,29,21.6,-1,0,-1,2,-1,-1,-2,0,"w1819","Hybrid",0,"Mon","weekday"
"4657",2018-12-18,"Kebler","2","2","2",4.1,0,19,0,27,21.6,0,-1,0,-1,0,-1,-1,-2,"w1819","Non.motorized",1,"Tue","weekday"
"4658",2018-12-18,"Kebler","2","2","2",4.1,0,19,0,27,21.6,0,-1,0,-1,0,-1,-1,-2,"w1819","Mechanized",0,"Tue","weekday"
"4659",2018-12-18,"Kebler","2","2","2",4.1,0,19,0,27,21.6,0,-1,0,-1,0,-1,-1,-2,"w1819","Motorized",18,"Tue","weekday"
"4660",2018-12-18,"Kebler","2","2","2",4.1,0,19,0,27,21.6,0,-1,0,-1,0,-1,-1,-2,"w1819","Hybrid",0,"Tue","weekday"
"4661",2018-12-19,"Kebler","2","2","2",4.1,0,19,0,24,21.6,0,0,-1,0,0,0,-1,-1,"w1819","Non.motorized",0,"Wed","weekday"
"4662",2018-12-19,"Kebler","2","2","2",4.1,0,19,0,24,21.6,0,0,-1,0,0,0,-1,-1,"w1819","Mechanized",0,"Wed","weekday"
"4663",2018-12-19,"Kebler","2","2","2",4.1,0,19,0,24,21.6,0,0,-1,0,0,0,-1,-1,"w1819","Motorized",12,"Wed","weekday"
"4664",2018-12-19,"Kebler","2","2","2",4.1,0,19,0,24,21.6,0,0,-1,0,0,0,-1,-1,"w1819","Hybrid",0,"Wed","weekday"
"4665",2018-12-20,"Kebler","2","2","1",4.1,0,20,1,25,20.5,0,0,0,-1,1,1,1,0,"w1819","Non.motorized",0,"Thu","weekday"
"4666",2018-12-20,"Kebler","2","2","1",4.1,0,20,1,25,20.5,0,0,0,-1,1,1,1,0,"w1819","Mechanized",0,"Thu","weekday"
"4667",2018-12-20,"Kebler","2","2","1",4.1,0,20,1,25,20.5,0,0,0,-1,1,1,1,0,"w1819","Motorized",5,"Thu","weekday"
"4668",2018-12-20,"Kebler","2","2","1",4.1,0,20,1,25,20.5,0,0,0,-1,1,1,1,0,"w1819","Hybrid",0,"Thu","weekday"
"4669",2018-12-21,"Kebler","2","2","1",4.1,0,19,-1,28,21.6,1,0,0,0,0,0,0,0,"w1819","Non.motorized",6,"Fri","weekday"
"4670",2018-12-21,"Kebler","2","2","1",4.1,0,19,-1,28,21.6,1,0,0,0,0,0,0,0,"w1819","Mechanized",0,"Fri","weekday"
"4671",2018-12-21,"Kebler","2","2","1",4.1,0,19,-1,28,21.6,1,0,0,0,0,0,0,0,"w1819","Motorized",24,"Fri","weekday"
"4672",2018-12-21,"Kebler","2","2","1",4.1,0,19,-1,28,21.6,1,0,0,0,0,0,0,0,"w1819","Hybrid",0,"Fri","weekday"
"4673",2018-12-22,"Kebler","2","2","1",4.2,0.1,19,0,20,22.1,-1,1,0,0,-1,0,0,0,"w1819","Non.motorized",NA,"Sat","weekend"
"4674",2018-12-22,"Kebler","2","2","1",4.2,0.1,19,0,20,22.1,-1,1,0,0,-1,0,0,0,"w1819","Mechanized",NA,"Sat","weekend"
"4675",2018-12-22,"Kebler","2","2","1",4.2,0.1,19,0,20,22.1,-1,1,0,0,-1,0,0,0,"w1819","Motorized",NA,"Sat","weekend"
"4676",2018-12-22,"Kebler","2","2","1",4.2,0.1,19,0,20,22.1,-1,1,0,0,-1,0,0,0,"w1819","Hybrid",NA,"Sat","weekend"
"4677",2018-12-23,"Kebler","2","2","1",4.2,0,21,2,19,20,0,-1,1,0,2,1,2,2,"w1819","Non.motorized",18,"Sun","weekend"
"4678",2018-12-23,"Kebler","2","2","1",4.2,0,21,2,19,20,0,-1,1,0,2,1,2,2,"w1819","Mechanized",0,"Sun","weekend"
"4679",2018-12-23,"Kebler","2","2","1",4.2,0,21,2,19,20,0,-1,1,0,2,1,2,2,"w1819","Motorized",44,"Sun","weekend"
"4680",2018-12-23,"Kebler","2","2","1",4.2,0,21,2,19,20,0,-1,1,0,2,1,2,2,"w1819","Hybrid",0,"Sun","weekend"
"4681",2018-12-24,"Kebler","2","2","2",4.3,0.1,20,-1,21,21.5,2,0,-1,1,1,1,0,1,"w1819","Non.motorized",0,"Mon","weekday"
"4682",2018-12-24,"Kebler","2","2","2",4.3,0.1,20,-1,21,21.5,2,0,-1,1,1,1,0,1,"w1819","Mechanized",1,"Mon","weekday"
"4683",2018-12-24,"Kebler","2","2","2",4.3,0.1,20,-1,21,21.5,2,0,-1,1,1,1,0,1,"w1819","Motorized",12,"Mon","weekday"
"4684",2018-12-24,"Kebler","2","2","2",4.3,0.1,20,-1,21,21.5,2,0,-1,1,1,1,0,1,"w1819","Hybrid",0,"Mon","weekday"
"4685",2018-12-25,"Kebler","2","2","2",4.7,0.4,25,5,25,18.8,-1,2,0,-1,4,6,6,5,"w1819","Non.motorized",0,"Tue","weekday"
"4686",2018-12-25,"Kebler","2","2","2",4.7,0.4,25,5,25,18.8,-1,2,0,-1,4,6,6,5,"w1819","Mechanized",0,"Tue","weekday"
"4687",2018-12-25,"Kebler","2","2","2",4.7,0.4,25,5,25,18.8,-1,2,0,-1,4,6,6,5,"w1819","Motorized",69,"Tue","weekday"
"4688",2018-12-25,"Kebler","2","2","2",4.7,0.4,25,5,25,18.8,-1,2,0,-1,4,6,6,5,"w1819","Hybrid",0,"Tue","weekday"
"4689",2018-12-26,"Kebler","3","3","3",4.7,0,23,-2,24,20.4,5,-1,2,0,3,2,4,4,"w1819","Non.motorized",2,"Wed","weekday"
"4690",2018-12-26,"Kebler","3","3","3",4.7,0,23,-2,24,20.4,5,-1,2,0,3,2,4,4,"w1819","Mechanized",0,"Wed","weekday"
"4691",2018-12-26,"Kebler","3","3","3",4.7,0,23,-2,24,20.4,5,-1,2,0,3,2,4,4,"w1819","Motorized",89,"Wed","weekday"
"4692",2018-12-26,"Kebler","3","3","3",4.7,0,23,-2,24,20.4,5,-1,2,0,3,2,4,4,"w1819","Hybrid",0,"Wed","weekday"
"4693",2018-12-27,"Kebler","3","3","2",4.7,0,24,1,12,19.6,-2,5,-1,2,-1,4,3,5,"w1819","Non.motorized",6,"Thu","weekday"
"4694",2018-12-27,"Kebler","3","3","2",4.7,0,24,1,12,19.6,-2,5,-1,2,-1,4,3,5,"w1819","Mechanized",0,"Thu","weekday"
"4695",2018-12-27,"Kebler","3","3","2",4.7,0,24,1,12,19.6,-2,5,-1,2,-1,4,3,5,"w1819","Motorized",46,"Thu","weekday"
"4696",2018-12-27,"Kebler","3","3","2",4.7,0,24,1,12,19.6,-2,5,-1,2,-1,4,3,5,"w1819","Hybrid",0,"Thu","weekday"
"4697",2018-12-28,"Kebler","3","3","2",4.7,0,24,0,12,19.6,1,-2,5,-1,1,-1,4,3,"w1819","Non.motorized",3,"Fri","weekday"
"4698",2018-12-28,"Kebler","3","3","2",4.7,0,24,0,12,19.6,1,-2,5,-1,1,-1,4,3,"w1819","Mechanized",0,"Fri","weekday"
"4699",2018-12-28,"Kebler","3","3","2",4.7,0,24,0,12,19.6,1,-2,5,-1,1,-1,4,3,"w1819","Motorized",62,"Fri","weekday"
"4700",2018-12-28,"Kebler","3","3","2",4.7,0,24,0,12,19.6,1,-2,5,-1,1,-1,4,3,"w1819","Hybrid",0,"Fri","weekday"
"4701",2018-12-29,"Kebler","3","3","2",4.7,0,24,0,8,19.6,0,1,-2,5,0,1,-1,4,"w1819","Non.motorized",6,"Sat","weekend"
"4702",2018-12-29,"Kebler","3","3","2",4.7,0,24,0,8,19.6,0,1,-2,5,0,1,-1,4,"w1819","Mechanized",0,"Sat","weekend"
"4703",2018-12-29,"Kebler","3","3","2",4.7,0,24,0,8,19.6,0,1,-2,5,0,1,-1,4,"w1819","Motorized",179,"Sat","weekend"
"4704",2018-12-29,"Kebler","3","3","2",4.7,0,24,0,8,19.6,0,1,-2,5,0,1,-1,4,"w1819","Hybrid",2,"Sat","weekend"
"4705",2018-12-30,"Kebler","3","3","2",4.7,0,24,0,16,19.6,0,0,1,-2,0,0,1,-1,"w1819","Non.motorized",13,"Sun","weekend"
"4706",2018-12-30,"Kebler","3","3","2",4.7,0,24,0,16,19.6,0,0,1,-2,0,0,1,-1,"w1819","Mechanized",0,"Sun","weekend"
"4707",2018-12-30,"Kebler","3","3","2",4.7,0,24,0,16,19.6,0,0,1,-2,0,0,1,-1,"w1819","Motorized",167,"Sun","weekend"
"4708",2018-12-30,"Kebler","3","3","2",4.7,0,24,0,16,19.6,0,0,1,-2,0,0,1,-1,"w1819","Hybrid",0,"Sun","weekend"
"4709",2018-12-31,"Kebler","3","3","3",4.9,0.2,23,-1,14,21.3,0,0,0,1,-1,-1,-1,0,"w1819","Non.motorized",1,"Mon","weekday"
"4710",2018-12-31,"Kebler","3","3","3",4.9,0.2,23,-1,14,21.3,0,0,0,1,-1,-1,-1,0,"w1819","Mechanized",0,"Mon","weekday"
"4711",2018-12-31,"Kebler","3","3","3",4.9,0.2,23,-1,14,21.3,0,0,0,1,-1,-1,-1,0,"w1819","Motorized",38,"Mon","weekday"
"4712",2018-12-31,"Kebler","3","3","3",4.9,0.2,23,-1,14,21.3,0,0,0,1,-1,-1,-1,0,"w1819","Hybrid",0,"Mon","weekday"
"4713",2019-01-01,"Kebler","3","3","3",5.1,0.2,29,6,11,17.6,-1,0,0,0,5,5,5,5,"w1819","Non.motorized",2,"Tue","weekday"
"4714",2019-01-01,"Kebler","3","3","3",5.1,0.2,29,6,11,17.6,-1,0,0,0,5,5,5,5,"w1819","Mechanized",0,"Tue","weekday"
"4715",2019-01-01,"Kebler","3","3","3",5.1,0.2,29,6,11,17.6,-1,0,0,0,5,5,5,5,"w1819","Motorized",88,"Tue","weekday"
"4716",2019-01-01,"Kebler","3","3","3",5.1,0.2,29,6,11,17.6,-1,0,0,0,5,5,5,5,"w1819","Hybrid",0,"Tue","weekday"
"4717",2019-01-02,"Kebler","3","3","2",5.1,0,28,-1,10,18.2,6,-1,0,0,5,4,4,4,"w1819","Non.motorized",2,"Wed","weekday"
"4718",2019-01-02,"Kebler","3","3","2",5.1,0,28,-1,10,18.2,6,-1,0,0,5,4,4,4,"w1819","Mechanized",0,"Wed","weekday"
"4719",2019-01-02,"Kebler","3","3","2",5.1,0,28,-1,10,18.2,6,-1,0,0,5,4,4,4,"w1819","Motorized",116,"Wed","weekday"
"4720",2019-01-02,"Kebler","3","3","2",5.1,0,28,-1,10,18.2,6,-1,0,0,5,4,4,4,"w1819","Hybrid",0,"Wed","weekday"
"4721",2019-01-03,"Kebler","3","3","2",5.1,0,27,-1,22,18.9,-1,6,-1,0,-2,4,3,3,"w1819","Non.motorized",0,"Thu","weekday"
"4722",2019-01-03,"Kebler","3","3","2",5.1,0,27,-1,22,18.9,-1,6,-1,0,-2,4,3,3,"w1819","Mechanized",0,"Thu","weekday"
"4723",2019-01-03,"Kebler","3","3","2",5.1,0,27,-1,22,18.9,-1,6,-1,0,-2,4,3,3,"w1819","Motorized",172,"Thu","weekday"
"4724",2019-01-03,"Kebler","3","3","2",5.1,0,27,-1,22,18.9,-1,6,-1,0,-2,4,3,3,"w1819","Hybrid",8,"Thu","weekday"
"4725",2019-01-04,"Kebler","3","3","2",5.3,0.2,26,-1,29,20.4,-1,-1,6,-1,-2,-3,3,2,"w1819","Non.motorized",0,"Fri","weekday"
"4726",2019-01-04,"Kebler","3","3","2",5.3,0.2,26,-1,29,20.4,-1,-1,6,-1,-2,-3,3,2,"w1819","Mechanized",0,"Fri","weekday"
"4727",2019-01-04,"Kebler","3","3","2",5.3,0.2,26,-1,29,20.4,-1,-1,6,-1,-2,-3,3,2,"w1819","Motorized",148,"Fri","weekday"
"4728",2019-01-04,"Kebler","3","3","2",5.3,0.2,26,-1,29,20.4,-1,-1,6,-1,-2,-3,3,2,"w1819","Hybrid",9,"Fri","weekday"
"4729",2019-01-05,"Kebler","2","2","2",5.3,0,25,-1,30,21.2,-1,-1,-1,6,-2,-3,-4,2,"w1819","Non.motorized",5,"Sat","weekend"
"4730",2019-01-05,"Kebler","2","2","2",5.3,0,25,-1,30,21.2,-1,-1,-1,6,-2,-3,-4,2,"w1819","Mechanized",2,"Sat","weekend"
"4731",2019-01-05,"Kebler","2","2","2",5.3,0,25,-1,30,21.2,-1,-1,-1,6,-2,-3,-4,2,"w1819","Motorized",96,"Sat","weekend"
"4732",2019-01-05,"Kebler","2","2","2",5.3,0,25,-1,30,21.2,-1,-1,-1,6,-2,-3,-4,2,"w1819","Hybrid",3,"Sat","weekend"
"4733",2019-01-06,"Kebler","3","3","3",5.3,0,25,0,26,21.2,-1,-1,-1,-1,-1,-2,-3,-4,"w1819","Non.motorized",NA,"Sun","weekend"
"4734",2019-01-06,"Kebler","3","3","3",5.3,0,25,0,26,21.2,-1,-1,-1,-1,-1,-2,-3,-4,"w1819","Mechanized",NA,"Sun","weekend"
"4735",2019-01-06,"Kebler","3","3","3",5.3,0,25,0,26,21.2,-1,-1,-1,-1,-1,-2,-3,-4,"w1819","Motorized",NA,"Sun","weekend"
"4736",2019-01-06,"Kebler","3","3","3",5.3,0,25,0,26,21.2,-1,-1,-1,-1,-1,-2,-3,-4,"w1819","Hybrid",NA,"Sun","weekend"
"4737",2019-01-07,"Kebler","3","3","3",5.8,0.5,32,7,21,18.1,0,-1,-1,-1,7,6,5,4,"w1819","Non.motorized",NA,"Mon","weekday"
"4738",2019-01-07,"Kebler","3","3","3",5.8,0.5,32,7,21,18.1,0,-1,-1,-1,7,6,5,4,"w1819","Mechanized",NA,"Mon","weekday"
"4739",2019-01-07,"Kebler","3","3","3",5.8,0.5,32,7,21,18.1,0,-1,-1,-1,7,6,5,4,"w1819","Motorized",NA,"Mon","weekday"
"4740",2019-01-07,"Kebler","3","3","3",5.8,0.5,32,7,21,18.1,0,-1,-1,-1,7,6,5,4,"w1819","Hybrid",NA,"Mon","weekday"
"4741",2019-01-08,"Kebler","3","3","3",5.9,0.1,32,0,24,18.4,7,0,-1,-1,7,7,6,5,"w1819","Non.motorized",3,"Tue","weekday"
"4742",2019-01-08,"Kebler","3","3","3",5.9,0.1,32,0,24,18.4,7,0,-1,-1,7,7,6,5,"w1819","Mechanized",0,"Tue","weekday"
"4743",2019-01-08,"Kebler","3","3","3",5.9,0.1,32,0,24,18.4,7,0,-1,-1,7,7,6,5,"w1819","Motorized",48,"Tue","weekday"
"4744",2019-01-08,"Kebler","3","3","3",5.9,0.1,32,0,24,18.4,7,0,-1,-1,7,7,6,5,"w1819","Hybrid",2,"Tue","weekday"
"4745",2019-01-09,"Kebler","3","3","3",6,0.1,30,-2,29,20,0,7,0,-1,-2,5,5,4,"w1819","Non.motorized",7,"Wed","weekday"
"4746",2019-01-09,"Kebler","3","3","3",6,0.1,30,-2,29,20,0,7,0,-1,-2,5,5,4,"w1819","Mechanized",0,"Wed","weekday"
"4747",2019-01-09,"Kebler","3","3","3",6,0.1,30,-2,29,20,0,7,0,-1,-2,5,5,4,"w1819","Motorized",56,"Wed","weekday"
"4748",2019-01-09,"Kebler","3","3","3",6,0.1,30,-2,29,20,0,7,0,-1,-2,5,5,4,"w1819","Hybrid",7,"Wed","weekday"
"4749",2019-01-10,"Kebler","3","3","3",6,0,29,-1,29,20.7,-2,0,7,0,-3,-3,4,4,"w1819","Non.motorized",4,"Thu","weekday"
"4750",2019-01-10,"Kebler","3","3","3",6,0,29,-1,29,20.7,-2,0,7,0,-3,-3,4,4,"w1819","Mechanized",4,"Thu","weekday"
"4751",2019-01-10,"Kebler","3","3","3",6,0,29,-1,29,20.7,-2,0,7,0,-3,-3,4,4,"w1819","Motorized",72,"Thu","weekday"
"4752",2019-01-10,"Kebler","3","3","3",6,0,29,-1,29,20.7,-2,0,7,0,-3,-3,4,4,"w1819","Hybrid",1,"Thu","weekday"
"4753",2019-01-11,"Kebler","2","2","2",6.1,0.1,29,0,25,21,-1,-2,0,7,-1,-3,-3,4,"w1819","Non.motorized",0,"Fri","weekday"
"4754",2019-01-11,"Kebler","2","2","2",6.1,0.1,29,0,25,21,-1,-2,0,7,-1,-3,-3,4,"w1819","Mechanized",1,"Fri","weekday"
"4755",2019-01-11,"Kebler","2","2","2",6.1,0.1,29,0,25,21,-1,-2,0,7,-1,-3,-3,4,"w1819","Motorized",41,"Fri","weekday"
"4756",2019-01-11,"Kebler","2","2","2",6.1,0.1,29,0,25,21,-1,-2,0,7,-1,-3,-3,4,"w1819","Hybrid",2,"Fri","weekday"
"4757",2019-01-12,"Kebler","3","3","2",6.1,0,28,-1,21,21.8,0,-1,-2,0,-1,-2,-4,-4,"w1819","Non.motorized",0,"Sat","weekend"
"4758",2019-01-12,"Kebler","3","3","2",6.1,0,28,-1,21,21.8,0,-1,-2,0,-1,-2,-4,-4,"w1819","Mechanized",1,"Sat","weekend"
"4759",2019-01-12,"Kebler","3","3","2",6.1,0,28,-1,21,21.8,0,-1,-2,0,-1,-2,-4,-4,"w1819","Motorized",26,"Sat","weekend"
"4760",2019-01-12,"Kebler","3","3","2",6.1,0,28,-1,21,21.8,0,-1,-2,0,-1,-2,-4,-4,"w1819","Hybrid",2,"Sat","weekend"
"4761",2019-01-13,"Kebler","2","2","2",6.2,0.1,30,2,18,20.7,-1,0,-1,-2,1,1,0,-2,"w1819","Non.motorized",2,"Sun","weekend"
"4762",2019-01-13,"Kebler","2","2","2",6.2,0.1,30,2,18,20.7,-1,0,-1,-2,1,1,0,-2,"w1819","Mechanized",1,"Sun","weekend"
"4763",2019-01-13,"Kebler","2","2","2",6.2,0.1,30,2,18,20.7,-1,0,-1,-2,1,1,0,-2,"w1819","Motorized",41,"Sun","weekend"
"4764",2019-01-13,"Kebler","2","2","2",6.2,0.1,30,2,18,20.7,-1,0,-1,-2,1,1,0,-2,"w1819","Hybrid",3,"Sun","weekend"
"4765",2019-01-14,"Kebler","2","2","2",6.2,0,30,0,18,20.7,2,-1,0,-1,2,1,1,0,"w1819","Non.motorized",0,"Mon","weekday"
"4766",2019-01-14,"Kebler","2","2","2",6.2,0,30,0,18,20.7,2,-1,0,-1,2,1,1,0,"w1819","Mechanized",0,"Mon","weekday"
"4767",2019-01-14,"Kebler","2","2","2",6.2,0,30,0,18,20.7,2,-1,0,-1,2,1,1,0,"w1819","Motorized",25,"Mon","weekday"
"4768",2019-01-14,"Kebler","2","2","2",6.2,0,30,0,18,20.7,2,-1,0,-1,2,1,1,0,"w1819","Hybrid",2,"Mon","weekday"
"4769",2019-01-15,"Kebler","2","2","2",6.2,0,29,-1,24,21.4,0,2,-1,0,-1,1,0,0,"w1819","Non.motorized",8,"Tue","weekday"
"4770",2019-01-15,"Kebler","2","2","2",6.2,0,29,-1,24,21.4,0,2,-1,0,-1,1,0,0,"w1819","Mechanized",0,"Tue","weekday"
"4771",2019-01-15,"Kebler","2","2","2",6.2,0,29,-1,24,21.4,0,2,-1,0,-1,1,0,0,"w1819","Motorized",54,"Tue","weekday"
"4772",2019-01-15,"Kebler","2","2","2",6.2,0,29,-1,24,21.4,0,2,-1,0,-1,1,0,0,"w1819","Hybrid",7,"Tue","weekday"
"4773",2019-01-16,"Kebler","4","4","3",6.3,0.1,29,0,26,21.7,-1,0,2,-1,-1,-1,1,0,"w1819","Non.motorized",NA,"Wed","weekday"
"4774",2019-01-16,"Kebler","4","4","3",6.3,0.1,29,0,26,21.7,-1,0,2,-1,-1,-1,1,0,"w1819","Mechanized",NA,"Wed","weekday"
"4775",2019-01-16,"Kebler","4","4","3",6.3,0.1,29,0,26,21.7,-1,0,2,-1,-1,-1,1,0,"w1819","Motorized",NA,"Wed","weekday"
"4776",2019-01-16,"Kebler","4","4","3",6.3,0.1,29,0,26,21.7,-1,0,2,-1,-1,-1,1,0,"w1819","Hybrid",NA,"Wed","weekday"
"4777",2019-01-17,"Kebler","3","3","2",7,0.7,38,9,28,18.4,0,-1,0,2,9,8,8,10,"w1819","Non.motorized",5,"Thu","weekday"
"4778",2019-01-17,"Kebler","3","3","2",7,0.7,38,9,28,18.4,0,-1,0,2,9,8,8,10,"w1819","Mechanized",0,"Thu","weekday"
"4779",2019-01-17,"Kebler","3","3","2",7,0.7,38,9,28,18.4,0,-1,0,2,9,8,8,10,"w1819","Motorized",19,"Thu","weekday"
"4780",2019-01-17,"Kebler","3","3","2",7,0.7,38,9,28,18.4,0,-1,0,2,9,8,8,10,"w1819","Hybrid",5,"Thu","weekday"
"4781",2019-01-18,"Kebler","4","4","4",7.5,0.5,41,3,22,18.3,9,0,-1,0,12,12,11,11,"w1819","Non.motorized",9,"Fri","weekday"
"4782",2019-01-18,"Kebler","4","4","4",7.5,0.5,41,3,22,18.3,9,0,-1,0,12,12,11,11,"w1819","Mechanized",0,"Fri","weekday"
"4783",2019-01-18,"Kebler","4","4","4",7.5,0.5,41,3,22,18.3,9,0,-1,0,12,12,11,11,"w1819","Motorized",8,"Fri","weekday"
"4784",2019-01-18,"Kebler","4","4","4",7.5,0.5,41,3,22,18.3,9,0,-1,0,12,12,11,11,"w1819","Hybrid",0,"Fri","weekday"
"4785",2019-01-19,"Kebler","3","3","3",7.8,0.3,43,2,20,18.1,3,9,0,-1,5,14,14,13,"w1819","Non.motorized",14,"Sat","weekend"
"4786",2019-01-19,"Kebler","3","3","3",7.8,0.3,43,2,20,18.1,3,9,0,-1,5,14,14,13,"w1819","Mechanized",0,"Sat","weekend"
"4787",2019-01-19,"Kebler","3","3","3",7.8,0.3,43,2,20,18.1,3,9,0,-1,5,14,14,13,"w1819","Motorized",81,"Sat","weekend"
"4788",2019-01-19,"Kebler","3","3","3",7.8,0.3,43,2,20,18.1,3,9,0,-1,5,14,14,13,"w1819","Hybrid",6,"Sat","weekend"
"4789",2019-01-20,"Kebler","3","3","3",7.9,0.1,41,-2,27,19.3,2,3,9,0,0,3,12,12,"w1819","Non.motorized",5,"Sun","weekend"
"4790",2019-01-20,"Kebler","3","3","3",7.9,0.1,41,-2,27,19.3,2,3,9,0,0,3,12,12,"w1819","Mechanized",0,"Sun","weekend"
"4791",2019-01-20,"Kebler","3","3","3",7.9,0.1,41,-2,27,19.3,2,3,9,0,0,3,12,12,"w1819","Motorized",98,"Sun","weekend"
"4792",2019-01-20,"Kebler","3","3","3",7.9,0.1,41,-2,27,19.3,2,3,9,0,0,3,12,12,"w1819","Hybrid",8,"Sun","weekend"
"4793",2019-01-21,"Kebler","3","3","3",7.9,0,39,-2,23,20.3,-2,2,3,9,-4,-2,1,10,"w1819","Non.motorized",0,"Mon","weekday"
"4794",2019-01-21,"Kebler","3","3","3",7.9,0,39,-2,23,20.3,-2,2,3,9,-4,-2,1,10,"w1819","Mechanized",0,"Mon","weekday"
"4795",2019-01-21,"Kebler","3","3","3",7.9,0,39,-2,23,20.3,-2,2,3,9,-4,-2,1,10,"w1819","Motorized",12,"Mon","weekday"
"4796",2019-01-21,"Kebler","3","3","3",7.9,0,39,-2,23,20.3,-2,2,3,9,-4,-2,1,10,"w1819","Hybrid",0,"Mon","weekday"
"4797",2019-01-22,"Kebler","3","3","3",8,0.1,41,2,12,19.5,-2,-2,2,3,0,-2,0,3,"w1819","Non.motorized",NA,"Tue","weekday"
"4798",2019-01-22,"Kebler","3","3","3",8,0.1,41,2,12,19.5,-2,-2,2,3,0,-2,0,3,"w1819","Mechanized",NA,"Tue","weekday"
"4799",2019-01-22,"Kebler","3","3","3",8,0.1,41,2,12,19.5,-2,-2,2,3,0,-2,0,3,"w1819","Motorized",NA,"Tue","weekday"
"4800",2019-01-22,"Kebler","3","3","3",8,0.1,41,2,12,19.5,-2,-2,2,3,0,-2,0,3,"w1819","Hybrid",NA,"Tue","weekday"
"4801",2019-01-23,"Kebler","3","3","2",8,0,40,-1,14,20,2,-2,-2,2,1,-1,-3,-1,"w1819","Non.motorized",NA,"Wed","weekday"
"4802",2019-01-23,"Kebler","3","3","2",8,0,40,-1,14,20,2,-2,-2,2,1,-1,-3,-1,"w1819","Mechanized",NA,"Wed","weekday"
"4803",2019-01-23,"Kebler","3","3","2",8,0,40,-1,14,20,2,-2,-2,2,1,-1,-3,-1,"w1819","Motorized",NA,"Wed","weekday"
"4804",2019-01-23,"Kebler","3","3","2",8,0,40,-1,14,20,2,-2,-2,2,1,-1,-3,-1,"w1819","Hybrid",NA,"Wed","weekday"
"4805",2019-01-24,"Kebler","3","3","2",8.2,0.2,40,0,17,20.5,-1,2,-2,-2,-1,1,-1,-3,"w1819","Non.motorized",NA,"Thu","weekday"
"4806",2019-01-24,"Kebler","3","3","2",8.2,0.2,40,0,17,20.5,-1,2,-2,-2,-1,1,-1,-3,"w1819","Mechanized",NA,"Thu","weekday"
"4807",2019-01-24,"Kebler","3","3","2",8.2,0.2,40,0,17,20.5,-1,2,-2,-2,-1,1,-1,-3,"w1819","Motorized",NA,"Thu","weekday"
"4808",2019-01-24,"Kebler","3","3","2",8.2,0.2,40,0,17,20.5,-1,2,-2,-2,-1,1,-1,-3,"w1819","Hybrid",NA,"Thu","weekday"
"4809",2019-01-25,"Kebler","3","3","2",8.3,0.1,40,0,15,20.8,0,-1,2,-2,0,-1,1,-1,"w1819","Non.motorized",NA,"Fri","weekday"
"4810",2019-01-25,"Kebler","3","3","2",8.3,0.1,40,0,15,20.8,0,-1,2,-2,0,-1,1,-1,"w1819","Mechanized",NA,"Fri","weekday"
"4811",2019-01-25,"Kebler","3","3","2",8.3,0.1,40,0,15,20.8,0,-1,2,-2,0,-1,1,-1,"w1819","Motorized",NA,"Fri","weekday"
"4812",2019-01-25,"Kebler","3","3","2",8.3,0.1,40,0,15,20.8,0,-1,2,-2,0,-1,1,-1,"w1819","Hybrid",NA,"Fri","weekday"
"4813",2019-01-26,"Kebler","3","3","2",8.3,0,39,-1,19,21.3,0,0,-1,2,-1,-1,-2,0,"w1819","Non.motorized",NA,"Sat","weekend"
"4814",2019-01-26,"Kebler","3","3","2",8.3,0,39,-1,19,21.3,0,0,-1,2,-1,-1,-2,0,"w1819","Mechanized",NA,"Sat","weekend"
"4815",2019-01-26,"Kebler","3","3","2",8.3,0,39,-1,19,21.3,0,0,-1,2,-1,-1,-2,0,"w1819","Motorized",NA,"Sat","weekend"
"4816",2019-01-26,"Kebler","3","3","2",8.3,0,39,-1,19,21.3,0,0,-1,2,-1,-1,-2,0,"w1819","Hybrid",NA,"Sat","weekend"
"4817",2019-01-27,"Kebler","3","3","2",8.3,0,38,-1,24,21.8,-1,0,0,-1,-2,-2,-2,-3,"w1819","Non.motorized",NA,"Sun","weekend"
"4818",2019-01-27,"Kebler","3","3","2",8.3,0,38,-1,24,21.8,-1,0,0,-1,-2,-2,-2,-3,"w1819","Mechanized",NA,"Sun","weekend"
"4819",2019-01-27,"Kebler","3","3","2",8.3,0,38,-1,24,21.8,-1,0,0,-1,-2,-2,-2,-3,"w1819","Motorized",NA,"Sun","weekend"
"4820",2019-01-27,"Kebler","3","3","2",8.3,0,38,-1,24,21.8,-1,0,0,-1,-2,-2,-2,-3,"w1819","Hybrid",NA,"Sun","weekend"
"4821",2019-01-28,"Kebler","2","2","2",8.3,0,38,0,17,21.8,-1,-1,0,0,-1,-2,-2,-2,"w1819","Non.motorized",NA,"Mon","weekday"
"4822",2019-01-28,"Kebler","2","2","2",8.3,0,38,0,17,21.8,-1,-1,0,0,-1,-2,-2,-2,"w1819","Mechanized",NA,"Mon","weekday"
"4823",2019-01-28,"Kebler","2","2","2",8.3,0,38,0,17,21.8,-1,-1,0,0,-1,-2,-2,-2,"w1819","Motorized",NA,"Mon","weekday"
"4824",2019-01-28,"Kebler","2","2","2",8.3,0,38,0,17,21.8,-1,-1,0,0,-1,-2,-2,-2,"w1819","Hybrid",NA,"Mon","weekday"
"4825",2019-01-29,"Kebler","2","2","2",8.3,0,38,0,16,21.8,0,-1,-1,0,0,-1,-2,-2,"w1819","Non.motorized",0,"Tue","weekday"
"4826",2019-01-29,"Kebler","2","2","2",8.3,0,38,0,16,21.8,0,-1,-1,0,0,-1,-2,-2,"w1819","Mechanized",0,"Tue","weekday"
"4827",2019-01-29,"Kebler","2","2","2",8.3,0,38,0,16,21.8,0,-1,-1,0,0,-1,-2,-2,"w1819","Motorized",79,"Tue","weekday"
"4828",2019-01-29,"Kebler","2","2","2",8.3,0,38,0,16,21.8,0,-1,-1,0,0,-1,-2,-2,"w1819","Hybrid",0,"Tue","weekday"
"4829",2019-01-30,"Kebler","2","2","1",8.3,0,37,-1,20,22.4,0,0,-1,-1,-1,-1,-2,-3,"w1819","Non.motorized",4,"Wed","weekday"
"4830",2019-01-30,"Kebler","2","2","1",8.3,0,37,-1,20,22.4,0,0,-1,-1,-1,-1,-2,-3,"w1819","Mechanized",0,"Wed","weekday"
"4831",2019-01-30,"Kebler","2","2","1",8.3,0,37,-1,20,22.4,0,0,-1,-1,-1,-1,-2,-3,"w1819","Motorized",74,"Wed","weekday"
"4832",2019-01-30,"Kebler","2","2","1",8.3,0,37,-1,20,22.4,0,0,-1,-1,-1,-1,-2,-3,"w1819","Hybrid",12,"Wed","weekday"
"4833",2019-01-31,"Kebler","2","2","1",8.3,0,36,-1,24,23.1,-1,0,0,-1,-2,-2,-2,-3,"w1819","Non.motorized",3,"Thu","weekday"
"4834",2019-01-31,"Kebler","2","2","1",8.3,0,36,-1,24,23.1,-1,0,0,-1,-2,-2,-2,-3,"w1819","Mechanized",0,"Thu","weekday"
"4835",2019-01-31,"Kebler","2","2","1",8.3,0,36,-1,24,23.1,-1,0,0,-1,-2,-2,-2,-3,"w1819","Motorized",91,"Thu","weekday"
"4836",2019-01-31,"Kebler","2","2","1",8.3,0,36,-1,24,23.1,-1,0,0,-1,-2,-2,-2,-3,"w1819","Hybrid",20,"Thu","weekday"
"4837",2019-02-01,"Kebler","2","2","1",8.3,0,36,0,25,23.1,-1,-1,0,0,-1,-2,-2,-2,"w1819","Non.motorized",0,"Fri","weekday"
"4838",2019-02-01,"Kebler","2","2","1",8.3,0,36,0,25,23.1,-1,-1,0,0,-1,-2,-2,-2,"w1819","Mechanized",1,"Fri","weekday"
"4839",2019-02-01,"Kebler","2","2","1",8.3,0,36,0,25,23.1,-1,-1,0,0,-1,-2,-2,-2,"w1819","Motorized",99,"Fri","weekday"
"4840",2019-02-01,"Kebler","2","2","1",8.3,0,36,0,25,23.1,-1,-1,0,0,-1,-2,-2,-2,"w1819","Hybrid",8,"Fri","weekday"
"4841",2019-02-02,"Kebler","2","2","1",8.3,0,36,0,26,23.1,0,-1,-1,0,0,-1,-2,-2,"w1819","Non.motorized",1,"Sat","weekend"
"4842",2019-02-02,"Kebler","2","2","1",8.3,0,36,0,26,23.1,0,-1,-1,0,0,-1,-2,-2,"w1819","Mechanized",0,"Sat","weekend"
"4843",2019-02-02,"Kebler","2","2","1",8.3,0,36,0,26,23.1,0,-1,-1,0,0,-1,-2,-2,"w1819","Motorized",113,"Sat","weekend"
"4844",2019-02-02,"Kebler","2","2","1",8.3,0,36,0,26,23.1,0,-1,-1,0,0,-1,-2,-2,"w1819","Hybrid",10,"Sat","weekend"
"4845",2019-02-03,"Kebler","3","3","2",8.4,0.1,36,0,28,23.3,0,0,-1,-1,0,0,-1,-2,"w1819","Non.motorized",2,"Sun","weekend"
"4846",2019-02-03,"Kebler","3","3","2",8.4,0.1,36,0,28,23.3,0,0,-1,-1,0,0,-1,-2,"w1819","Mechanized",0,"Sun","weekend"
"4847",2019-02-03,"Kebler","3","3","2",8.4,0.1,36,0,28,23.3,0,0,-1,-1,0,0,-1,-2,"w1819","Motorized",64,"Sun","weekend"
"4848",2019-02-03,"Kebler","3","3","2",8.4,0.1,36,0,28,23.3,0,0,-1,-1,0,0,-1,-2,"w1819","Hybrid",2,"Sun","weekend"
"4849",2019-02-04,"Kebler","3","3","2",8.8,0.4,39,3,28,22.6,0,0,0,-1,3,3,3,2,"w1819","Non.motorized",2,"Mon","weekday"
"4850",2019-02-04,"Kebler","3","3","2",8.8,0.4,39,3,28,22.6,0,0,0,-1,3,3,3,2,"w1819","Mechanized",0,"Mon","weekday"
"4851",2019-02-04,"Kebler","3","3","2",8.8,0.4,39,3,28,22.6,0,0,0,-1,3,3,3,2,"w1819","Motorized",77,"Mon","weekday"
"4852",2019-02-04,"Kebler","3","3","2",8.8,0.4,39,3,28,22.6,0,0,0,-1,3,3,3,2,"w1819","Hybrid",11,"Mon","weekday"
"4853",2019-02-05,"Kebler","3","2","2",9,0.2,40,1,26,22.5,3,0,0,0,4,4,4,4,"w1819","Non.motorized",1,"Tue","weekday"
"4854",2019-02-05,"Kebler","3","2","2",9,0.2,40,1,26,22.5,3,0,0,0,4,4,4,4,"w1819","Mechanized",0,"Tue","weekday"
"4855",2019-02-05,"Kebler","3","2","2",9,0.2,40,1,26,22.5,3,0,0,0,4,4,4,4,"w1819","Motorized",49,"Tue","weekday"
"4856",2019-02-05,"Kebler","3","2","2",9,0.2,40,1,26,22.5,3,0,0,0,4,4,4,4,"w1819","Hybrid",6,"Tue","weekday"
"4857",2019-02-06,"Kebler","4","4","3",9,0,40,0,16,22.5,1,3,0,0,1,4,4,4,"w1819","Non.motorized",0,"Wed","weekday"
"4858",2019-02-06,"Kebler","4","4","3",9,0,40,0,16,22.5,1,3,0,0,1,4,4,4,"w1819","Mechanized",0,"Wed","weekday"
"4859",2019-02-06,"Kebler","4","4","3",9,0,40,0,16,22.5,1,3,0,0,1,4,4,4,"w1819","Motorized",0,"Wed","weekday"
"4860",2019-02-06,"Kebler","4","4","3",9,0,40,0,16,22.5,1,3,0,0,1,4,4,4,"w1819","Hybrid",0,"Wed","weekday"
"4861",2019-02-07,"Kebler","3","3","2",9.2,0.2,43,3,4,21.4,0,1,3,0,3,4,7,7,"w1819","Non.motorized",0,"Thu","weekday"
"4862",2019-02-07,"Kebler","3","3","2",9.2,0.2,43,3,4,21.4,0,1,3,0,3,4,7,7,"w1819","Mechanized",0,"Thu","weekday"
"4863",2019-02-07,"Kebler","3","3","2",9.2,0.2,43,3,4,21.4,0,1,3,0,3,4,7,7,"w1819","Motorized",25,"Thu","weekday"
"4864",2019-02-07,"Kebler","3","3","2",9.2,0.2,43,3,4,21.4,0,1,3,0,3,4,7,7,"w1819","Hybrid",3,"Thu","weekday"
"4865",2019-02-08,"Kebler","3","2","2",9.2,0,42,-1,10,21.9,3,0,1,3,2,2,3,6,"w1819","Non.motorized",0,"Fri","weekday"
"4866",2019-02-08,"Kebler","3","2","2",9.2,0,42,-1,10,21.9,3,0,1,3,2,2,3,6,"w1819","Mechanized",0,"Fri","weekday"
"4867",2019-02-08,"Kebler","3","2","2",9.2,0,42,-1,10,21.9,3,0,1,3,2,2,3,6,"w1819","Motorized",59,"Fri","weekday"
"4868",2019-02-08,"Kebler","3","2","2",9.2,0,42,-1,10,21.9,3,0,1,3,2,2,3,6,"w1819","Hybrid",5,"Fri","weekday"
"4869",2019-02-09,"Kebler","3","2","2",9.2,0,41,-1,20,22.4,-1,3,0,1,-2,1,1,2,"w1819","Non.motorized",0,"Sat","weekend"
"4870",2019-02-09,"Kebler","3","2","2",9.2,0,41,-1,20,22.4,-1,3,0,1,-2,1,1,2,"w1819","Mechanized",0,"Sat","weekend"
"4871",2019-02-09,"Kebler","3","2","2",9.2,0,41,-1,20,22.4,-1,3,0,1,-2,1,1,2,"w1819","Motorized",0,"Sat","weekend"
"4872",2019-02-09,"Kebler","3","2","2",9.2,0,41,-1,20,22.4,-1,3,0,1,-2,1,1,2,"w1819","Hybrid",0,"Sat","weekend"
"4873",2019-02-10,"Kebler","2","2","2",9.3,0.1,40,-1,20,23.2,-1,-1,3,0,-2,-3,0,0,"w1819","Non.motorized",0,"Sun","weekend"
"4874",2019-02-10,"Kebler","2","2","2",9.3,0.1,40,-1,20,23.2,-1,-1,3,0,-2,-3,0,0,"w1819","Mechanized",0,"Sun","weekend"
"4875",2019-02-10,"Kebler","2","2","2",9.3,0.1,40,-1,20,23.2,-1,-1,3,0,-2,-3,0,0,"w1819","Motorized",0,"Sun","weekend"
"4876",2019-02-10,"Kebler","2","2","2",9.3,0.1,40,-1,20,23.2,-1,-1,3,0,-2,-3,0,0,"w1819","Hybrid",0,"Sun","weekend"
"4877",2019-02-11,"Kebler","2","2","1",9.3,0,40,0,15,23.2,-1,-1,-1,3,-1,-2,-3,0,"w1819","Non.motorized",0,"Mon","weekday"
"4878",2019-02-11,"Kebler","2","2","1",9.3,0,40,0,15,23.2,-1,-1,-1,3,-1,-2,-3,0,"w1819","Mechanized",0,"Mon","weekday"
"4879",2019-02-11,"Kebler","2","2","1",9.3,0,40,0,15,23.2,-1,-1,-1,3,-1,-2,-3,0,"w1819","Motorized",7,"Mon","weekday"
"4880",2019-02-11,"Kebler","2","2","1",9.3,0,40,0,15,23.2,-1,-1,-1,3,-1,-2,-3,0,"w1819","Hybrid",0,"Mon","weekday"
"4881",2019-02-12,"Kebler","2","2","1",9.3,0,40,0,18,23.2,0,-1,-1,-1,0,-1,-2,-3,"w1819","Non.motorized",1,"Tue","weekday"
"4882",2019-02-12,"Kebler","2","2","1",9.3,0,40,0,18,23.2,0,-1,-1,-1,0,-1,-2,-3,"w1819","Mechanized",0,"Tue","weekday"
"4883",2019-02-12,"Kebler","2","2","1",9.3,0,40,0,18,23.2,0,-1,-1,-1,0,-1,-2,-3,"w1819","Motorized",21,"Tue","weekday"
"4884",2019-02-12,"Kebler","2","2","1",9.3,0,40,0,18,23.2,0,-1,-1,-1,0,-1,-2,-3,"w1819","Hybrid",0,"Tue","weekday"
"4885",2019-02-13,"Kebler","2","2","1",9.4,0.1,40,0,26,23.5,0,0,-1,-1,0,0,-1,-2,"w1819","Non.motorized",0,"Wed","weekday"
"4886",2019-02-13,"Kebler","2","2","1",9.4,0.1,40,0,26,23.5,0,0,-1,-1,0,0,-1,-2,"w1819","Mechanized",0,"Wed","weekday"
"4887",2019-02-13,"Kebler","2","2","1",9.4,0.1,40,0,26,23.5,0,0,-1,-1,0,0,-1,-2,"w1819","Motorized",45,"Wed","weekday"
"4888",2019-02-13,"Kebler","2","2","1",9.4,0.1,40,0,26,23.5,0,0,-1,-1,0,0,-1,-2,"w1819","Hybrid",0,"Wed","weekday"
"4889",2019-02-14,"Kebler","3","2","2",9.7,0.3,41,1,29,23.7,0,0,0,-1,1,1,1,0,"w1819","Non.motorized",1,"Thu","weekday"
"4890",2019-02-14,"Kebler","3","2","2",9.7,0.3,41,1,29,23.7,0,0,0,-1,1,1,1,0,"w1819","Mechanized",0,"Thu","weekday"
"4891",2019-02-14,"Kebler","3","2","2",9.7,0.3,41,1,29,23.7,0,0,0,-1,1,1,1,0,"w1819","Motorized",7,"Thu","weekday"
"4892",2019-02-14,"Kebler","3","2","2",9.7,0.3,41,1,29,23.7,0,0,0,-1,1,1,1,0,"w1819","Hybrid",0,"Thu","weekday"
"4893",2019-02-15,"Kebler","4","4","3",10.8,1.1,51,10,27,21.2,1,0,0,0,11,11,11,11,"w1819","Non.motorized",1,"Fri","weekday"
"4894",2019-02-15,"Kebler","4","4","3",10.8,1.1,51,10,27,21.2,1,0,0,0,11,11,11,11,"w1819","Mechanized",0,"Fri","weekday"
"4895",2019-02-15,"Kebler","4","4","3",10.8,1.1,51,10,27,21.2,1,0,0,0,11,11,11,11,"w1819","Motorized",38,"Fri","weekday"
"4896",2019-02-15,"Kebler","4","4","3",10.8,1.1,51,10,27,21.2,1,0,0,0,11,11,11,11,"w1819","Hybrid",0,"Fri","weekday"
"4897",2019-02-16,"Kebler","3","3","3",11.1,0.3,52,1,14,21.3,10,1,0,0,11,12,12,12,"w1819","Non.motorized",0,"Sat","weekend"
"4898",2019-02-16,"Kebler","3","3","3",11.1,0.3,52,1,14,21.3,10,1,0,0,11,12,12,12,"w1819","Mechanized",0,"Sat","weekend"
"4899",2019-02-16,"Kebler","3","3","3",11.1,0.3,52,1,14,21.3,10,1,0,0,11,12,12,12,"w1819","Motorized",0,"Sat","weekend"
"4900",2019-02-16,"Kebler","3","3","3",11.1,0.3,52,1,14,21.3,10,1,0,0,11,12,12,12,"w1819","Hybrid",0,"Sat","weekend"
"4901",2019-02-17,"Kebler","3","3","3",11.3,0.2,55,3,10,20.5,1,10,1,0,4,14,15,15,"w1819","Non.motorized",9,"Sun","weekend"
"4902",2019-02-17,"Kebler","3","3","3",11.3,0.2,55,3,10,20.5,1,10,1,0,4,14,15,15,"w1819","Mechanized",0,"Sun","weekend"
"4903",2019-02-17,"Kebler","3","3","3",11.3,0.2,55,3,10,20.5,1,10,1,0,4,14,15,15,"w1819","Motorized",117,"Sun","weekend"
"4904",2019-02-17,"Kebler","3","3","3",11.3,0.2,55,3,10,20.5,1,10,1,0,4,14,15,15,"w1819","Hybrid",5,"Sun","weekend"
"4905",2019-02-18,"Kebler","3","3","2",11.4,0.1,53,-2,13,21.5,3,1,10,1,1,2,12,13,"w1819","Non.motorized",6,"Mon","weekday"
"4906",2019-02-18,"Kebler","3","3","2",11.4,0.1,53,-2,13,21.5,3,1,10,1,1,2,12,13,"w1819","Mechanized",0,"Mon","weekday"
"4907",2019-02-18,"Kebler","3","3","2",11.4,0.1,53,-2,13,21.5,3,1,10,1,1,2,12,13,"w1819","Motorized",75,"Mon","weekday"
"4908",2019-02-18,"Kebler","3","3","2",11.4,0.1,53,-2,13,21.5,3,1,10,1,1,2,12,13,"w1819","Hybrid",5,"Mon","weekday"
"4909",2019-02-19,"Kebler","3","3","2",11.5,0.1,53,0,11,21.7,-2,3,1,10,-2,1,2,12,"w1819","Non.motorized",0,"Tue","weekday"
"4910",2019-02-19,"Kebler","3","3","2",11.5,0.1,53,0,11,21.7,-2,3,1,10,-2,1,2,12,"w1819","Mechanized",0,"Tue","weekday"
"4911",2019-02-19,"Kebler","3","3","2",11.5,0.1,53,0,11,21.7,-2,3,1,10,-2,1,2,12,"w1819","Motorized",0,"Tue","weekday"
"4912",2019-02-19,"Kebler","3","3","2",11.5,0.1,53,0,11,21.7,-2,3,1,10,-2,1,2,12,"w1819","Hybrid",0,"Tue","weekday"
"4913",2019-02-20,"Kebler","3","3","2",11.6,0.1,53,0,7,21.9,0,-2,3,1,0,-2,1,2,"w1819","Non.motorized",0,"Wed","weekday"
"4914",2019-02-20,"Kebler","3","3","2",11.6,0.1,53,0,7,21.9,0,-2,3,1,0,-2,1,2,"w1819","Mechanized",0,"Wed","weekday"
"4915",2019-02-20,"Kebler","3","3","2",11.6,0.1,53,0,7,21.9,0,-2,3,1,0,-2,1,2,"w1819","Motorized",0,"Wed","weekday"
"4916",2019-02-20,"Kebler","3","3","2",11.6,0.1,53,0,7,21.9,0,-2,3,1,0,-2,1,2,"w1819","Hybrid",0,"Wed","weekday"
"4917",2019-02-21,"Kebler","3","3","3",11.6,0,52,-1,15,22.3,0,0,-2,3,-1,-1,-3,0,"w1819","Non.motorized",0,"Thu","weekday"
"4918",2019-02-21,"Kebler","3","3","3",11.6,0,52,-1,15,22.3,0,0,-2,3,-1,-1,-3,0,"w1819","Mechanized",0,"Thu","weekday"
"4919",2019-02-21,"Kebler","3","3","3",11.6,0,52,-1,15,22.3,0,0,-2,3,-1,-1,-3,0,"w1819","Motorized",0,"Thu","weekday"
"4920",2019-02-21,"Kebler","3","3","3",11.6,0,52,-1,15,22.3,0,0,-2,3,-1,-1,-3,0,"w1819","Hybrid",0,"Thu","weekday"
"4921",2019-02-22,"Kebler","3","3","3",11.8,0.2,52,0,20,22.7,-1,0,0,-2,-1,-1,-1,-3,"w1819","Non.motorized",0,"Fri","weekday"
"4922",2019-02-22,"Kebler","3","3","3",11.8,0.2,52,0,20,22.7,-1,0,0,-2,-1,-1,-1,-3,"w1819","Mechanized",0,"Fri","weekday"
"4923",2019-02-22,"Kebler","3","3","3",11.8,0.2,52,0,20,22.7,-1,0,0,-2,-1,-1,-1,-3,"w1819","Motorized",0,"Fri","weekday"
"4924",2019-02-22,"Kebler","3","3","3",11.8,0.2,52,0,20,22.7,-1,0,0,-2,-1,-1,-1,-3,"w1819","Hybrid",0,"Fri","weekday"
"4925",2019-02-23,"Kebler","3","3","3",12.1,0.3,53,1,13,22.8,0,-1,0,0,1,0,0,0,"w1819","Non.motorized",1,"Sat","weekend"
"4926",2019-02-23,"Kebler","3","3","3",12.1,0.3,53,1,13,22.8,0,-1,0,0,1,0,0,0,"w1819","Mechanized",0,"Sat","weekend"
"4927",2019-02-23,"Kebler","3","3","3",12.1,0.3,53,1,13,22.8,0,-1,0,0,1,0,0,0,"w1819","Motorized",66,"Sat","weekend"
"4928",2019-02-23,"Kebler","3","3","3",12.1,0.3,53,1,13,22.8,0,-1,0,0,1,0,0,0,"w1819","Hybrid",4,"Sat","weekend"
"4929",2019-02-24,"Kebler","3","3","2",12.1,0,52,-1,14,23.3,1,0,-1,0,0,0,-1,-1,"w1819","Non.motorized",0,"Sun","weekend"
"4930",2019-02-24,"Kebler","3","3","2",12.1,0,52,-1,14,23.3,1,0,-1,0,0,0,-1,-1,"w1819","Mechanized",0,"Sun","weekend"
"4931",2019-02-24,"Kebler","3","3","2",12.1,0,52,-1,14,23.3,1,0,-1,0,0,0,-1,-1,"w1819","Motorized",0,"Sun","weekend"
"4932",2019-02-24,"Kebler","3","3","2",12.1,0,52,-1,14,23.3,1,0,-1,0,0,0,-1,-1,"w1819","Hybrid",0,"Sun","weekend"
"4933",2019-02-25,"Kebler","3","3","2",12.1,0,51,-1,22,23.7,-1,1,0,-1,-2,-1,-1,-2,"w1819","Non.motorized",0,"Mon","weekday"
"4934",2019-02-25,"Kebler","3","3","2",12.1,0,51,-1,22,23.7,-1,1,0,-1,-2,-1,-1,-2,"w1819","Mechanized",0,"Mon","weekday"
"4935",2019-02-25,"Kebler","3","3","2",12.1,0,51,-1,22,23.7,-1,1,0,-1,-2,-1,-1,-2,"w1819","Motorized",22,"Mon","weekday"
"4936",2019-02-25,"Kebler","3","3","2",12.1,0,51,-1,22,23.7,-1,1,0,-1,-2,-1,-1,-2,"w1819","Hybrid",2,"Mon","weekday"
"4937",2019-02-26,"Kebler","2","2","2",12.1,0,50,-1,27,24.2,-1,-1,1,0,-2,-3,-2,-2,"w1819","Non.motorized",1,"Tue","weekday"
"4938",2019-02-26,"Kebler","2","2","2",12.1,0,50,-1,27,24.2,-1,-1,1,0,-2,-3,-2,-2,"w1819","Mechanized",0,"Tue","weekday"
"4939",2019-02-26,"Kebler","2","2","2",12.1,0,50,-1,27,24.2,-1,-1,1,0,-2,-3,-2,-2,"w1819","Motorized",77,"Tue","weekday"
"4940",2019-02-26,"Kebler","2","2","2",12.1,0,50,-1,27,24.2,-1,-1,1,0,-2,-3,-2,-2,"w1819","Hybrid",10,"Tue","weekday"
"4941",2019-02-27,"Kebler","2","2","2",12.1,0,50,0,30,24.2,-1,-1,-1,1,-1,-2,-3,-2,"w1819","Non.motorized",2,"Wed","weekday"
"4942",2019-02-27,"Kebler","2","2","2",12.1,0,50,0,30,24.2,-1,-1,-1,1,-1,-2,-3,-2,"w1819","Mechanized",0,"Wed","weekday"
"4943",2019-02-27,"Kebler","2","2","2",12.1,0,50,0,30,24.2,-1,-1,-1,1,-1,-2,-3,-2,"w1819","Motorized",102,"Wed","weekday"
"4944",2019-02-27,"Kebler","2","2","2",12.1,0,50,0,30,24.2,-1,-1,-1,1,-1,-2,-3,-2,"w1819","Hybrid",5,"Wed","weekday"
"4945",2019-02-28,"Kebler","2","2","2",12.2,0.1,49,-1,30,24.9,0,-1,-1,-1,-1,-2,-3,-4,"w1819","Non.motorized",1,"Thu","weekday"
"4946",2019-02-28,"Kebler","2","2","2",12.2,0.1,49,-1,30,24.9,0,-1,-1,-1,-1,-2,-3,-4,"w1819","Mechanized",0,"Thu","weekday"
"4947",2019-02-28,"Kebler","2","2","2",12.2,0.1,49,-1,30,24.9,0,-1,-1,-1,-1,-2,-3,-4,"w1819","Motorized",60,"Thu","weekday"
"4948",2019-02-28,"Kebler","2","2","2",12.2,0.1,49,-1,30,24.9,0,-1,-1,-1,-1,-2,-3,-4,"w1819","Hybrid",6,"Thu","weekday"
"4949",2019-03-01,"Kebler","2","2","1",12.3,0.1,49,0,29,25.1,-1,0,-1,-1,-1,-1,-2,-3,"w1819","Non.motorized",0,"Fri","weekday"
"4950",2019-03-01,"Kebler","2","2","1",12.3,0.1,49,0,29,25.1,-1,0,-1,-1,-1,-1,-2,-3,"w1819","Mechanized",1,"Fri","weekday"
"4951",2019-03-01,"Kebler","2","2","1",12.3,0.1,49,0,29,25.1,-1,0,-1,-1,-1,-1,-2,-3,"w1819","Motorized",34,"Fri","weekday"
"4952",2019-03-01,"Kebler","2","2","1",12.3,0.1,49,0,29,25.1,-1,0,-1,-1,-1,-1,-2,-3,"w1819","Hybrid",1,"Fri","weekday"
"4953",2019-03-02,"Kebler","3","3","2",13,0.7,58,9,30,22.4,0,-1,0,-1,9,8,8,7,"w1819","Non.motorized",4,"Sat","weekend"
"4954",2019-03-02,"Kebler","3","3","2",13,0.7,58,9,30,22.4,0,-1,0,-1,9,8,8,7,"w1819","Mechanized",0,"Sat","weekend"
"4955",2019-03-02,"Kebler","3","3","2",13,0.7,58,9,30,22.4,0,-1,0,-1,9,8,8,7,"w1819","Motorized",113,"Sat","weekend"
"4956",2019-03-02,"Kebler","3","3","2",13,0.7,58,9,30,22.4,0,-1,0,-1,9,8,8,7,"w1819","Hybrid",0,"Sat","weekend"
"4957",2019-03-03,"Kebler","3","3","3",13.7,0.7,64,6,27,21.4,9,0,-1,0,15,15,14,14,"w1819","Non.motorized",0,"Sun","weekend"
"4958",2019-03-03,"Kebler","3","3","3",13.7,0.7,64,6,27,21.4,9,0,-1,0,15,15,14,14,"w1819","Mechanized",0,"Sun","weekend"
"4959",2019-03-03,"Kebler","3","3","3",13.7,0.7,64,6,27,21.4,9,0,-1,0,15,15,14,14,"w1819","Motorized",49,"Sun","weekend"
"4960",2019-03-03,"Kebler","3","3","3",13.7,0.7,64,6,27,21.4,9,0,-1,0,15,15,14,14,"w1819","Hybrid",0,"Sun","weekend"
"4961",2019-03-04,"Kebler","3","3","3",14.4,0.7,66,2,23,21.8,6,9,0,-1,8,17,17,16,"w1819","Non.motorized",0,"Mon","weekday"
"4962",2019-03-04,"Kebler","3","3","3",14.4,0.7,66,2,23,21.8,6,9,0,-1,8,17,17,16,"w1819","Mechanized",0,"Mon","weekday"
"4963",2019-03-04,"Kebler","3","3","3",14.4,0.7,66,2,23,21.8,6,9,0,-1,8,17,17,16,"w1819","Motorized",27,"Mon","weekday"
"4964",2019-03-04,"Kebler","3","3","3",14.4,0.7,66,2,23,21.8,6,9,0,-1,8,17,17,16,"w1819","Hybrid",0,"Mon","weekday"
"4965",2019-03-05,"Kebler","3","3","3",14.4,0,64,-2,24,22.5,2,6,9,0,0,6,15,15,"w1819","Non.motorized",3,"Tue","weekday"
"4966",2019-03-05,"Kebler","3","3","3",14.4,0,64,-2,24,22.5,2,6,9,0,0,6,15,15,"w1819","Mechanized",1,"Tue","weekday"
"4967",2019-03-05,"Kebler","3","3","3",14.4,0,64,-2,24,22.5,2,6,9,0,0,6,15,15,"w1819","Motorized",96,"Tue","weekday"
"4968",2019-03-05,"Kebler","3","3","3",14.4,0,64,-2,24,22.5,2,6,9,0,0,6,15,15,"w1819","Hybrid",5,"Tue","weekday"
"4969",2019-03-06,"Kebler","3","3","2",14.5,0.1,62,-2,31,23.4,-2,2,6,9,-4,-2,4,13,"w1819","Non.motorized",0,"Wed","weekday"
"4970",2019-03-06,"Kebler","3","3","2",14.5,0.1,62,-2,31,23.4,-2,2,6,9,-4,-2,4,13,"w1819","Mechanized",0,"Wed","weekday"
"4971",2019-03-06,"Kebler","3","3","2",14.5,0.1,62,-2,31,23.4,-2,2,6,9,-4,-2,4,13,"w1819","Motorized",82,"Wed","weekday"
"4972",2019-03-06,"Kebler","3","3","2",14.5,0.1,62,-2,31,23.4,-2,2,6,9,-4,-2,4,13,"w1819","Hybrid",5,"Wed","weekday"
"4973",2019-03-06,"Kebler","4","4","3",14.5,0.1,62,-2,31,23.4,-2,2,6,9,-4,-2,4,13,"w1819","Non.motorized",0,"Wed","weekday"
"4974",2019-03-06,"Kebler","4","4","3",14.5,0.1,62,-2,31,23.4,-2,2,6,9,-4,-2,4,13,"w1819","Mechanized",0,"Wed","weekday"
"4975",2019-03-06,"Kebler","4","4","3",14.5,0.1,62,-2,31,23.4,-2,2,6,9,-4,-2,4,13,"w1819","Motorized",82,"Wed","weekday"
"4976",2019-03-06,"Kebler","4","4","3",14.5,0.1,62,-2,31,23.4,-2,2,6,9,-4,-2,4,13,"w1819","Hybrid",5,"Wed","weekday"
"4977",2019-03-07,"Kebler","4","4","3",16.2,1.7,71,9,30,22.8,-2,-2,2,6,7,5,7,13,"w1819","Non.motorized",0,"Thu","weekday"
"4978",2019-03-07,"Kebler","4","4","3",16.2,1.7,71,9,30,22.8,-2,-2,2,6,7,5,7,13,"w1819","Mechanized",0,"Thu","weekday"
"4979",2019-03-07,"Kebler","4","4","3",16.2,1.7,71,9,30,22.8,-2,-2,2,6,7,5,7,13,"w1819","Motorized",0,"Thu","weekday"
"4980",2019-03-07,"Kebler","4","4","3",16.2,1.7,71,9,30,22.8,-2,-2,2,6,7,5,7,13,"w1819","Hybrid",0,"Thu","weekday"
"4981",2019-03-08,"Kebler","3","3","3",16.6,0.4,71,0,27,23.4,9,-2,-2,2,9,7,5,7,"w1819","Non.motorized",0,"Fri","weekday"
"4982",2019-03-08,"Kebler","3","3","3",16.6,0.4,71,0,27,23.4,9,-2,-2,2,9,7,5,7,"w1819","Mechanized",0,"Fri","weekday"
"4983",2019-03-08,"Kebler","3","3","3",16.6,0.4,71,0,27,23.4,9,-2,-2,2,9,7,5,7,"w1819","Motorized",10,"Fri","weekday"
"4984",2019-03-08,"Kebler","3","3","3",16.6,0.4,71,0,27,23.4,9,-2,-2,2,9,7,5,7,"w1819","Hybrid",0,"Fri","weekday"
"4985",2019-03-09,"Kebler","4","4","3",17.2,0.6,76,5,22,22.6,0,9,-2,-2,5,14,12,10,"w1819","Non.motorized",2,"Sat","weekend"
"4986",2019-03-09,"Kebler","4","4","3",17.2,0.6,76,5,22,22.6,0,9,-2,-2,5,14,12,10,"w1819","Mechanized",0,"Sat","weekend"
"4987",2019-03-09,"Kebler","4","4","3",17.2,0.6,76,5,22,22.6,0,9,-2,-2,5,14,12,10,"w1819","Motorized",29,"Sat","weekend"
"4988",2019-03-09,"Kebler","4","4","3",17.2,0.6,76,5,22,22.6,0,9,-2,-2,5,14,12,10,"w1819","Hybrid",0,"Sat","weekend"
"4989",2019-03-10,"Kebler","3","3","3",17.3,0.1,73,-3,25,23.7,5,0,9,-2,2,2,11,9,"w1819","Non.motorized",7,"Sun","weekend"
"4990",2019-03-10,"Kebler","3","3","3",17.3,0.1,73,-3,25,23.7,5,0,9,-2,2,2,11,9,"w1819","Mechanized",0,"Sun","weekend"
"4991",2019-03-10,"Kebler","3","3","3",17.3,0.1,73,-3,25,23.7,5,0,9,-2,2,2,11,9,"w1819","Motorized",64,"Sun","weekend"
"4992",2019-03-10,"Kebler","3","3","3",17.3,0.1,73,-3,25,23.7,5,0,9,-2,2,2,11,9,"w1819","Hybrid",6,"Sun","weekend"
"4993",2019-03-11,"Kebler","3","3","2",17.3,0,71,-2,29,24.4,-3,5,0,9,-5,0,0,9,"w1819","Non.motorized",0,"Mon","weekday"
"4994",2019-03-11,"Kebler","3","3","2",17.3,0,71,-2,29,24.4,-3,5,0,9,-5,0,0,9,"w1819","Mechanized",0,"Mon","weekday"
"4995",2019-03-11,"Kebler","3","3","2",17.3,0,71,-2,29,24.4,-3,5,0,9,-5,0,0,9,"w1819","Motorized",89,"Mon","weekday"
"4996",2019-03-11,"Kebler","3","3","2",17.3,0,71,-2,29,24.4,-3,5,0,9,-5,0,0,9,"w1819","Hybrid",1,"Mon","weekday"
"4997",2019-03-12,"Kebler","3","3","3",17.4,0.1,70,-1,32,24.9,-2,-3,5,0,-3,-6,-1,-1,"w1819","Non.motorized",0,"Tue","weekday"
"4998",2019-03-12,"Kebler","3","3","3",17.4,0.1,70,-1,32,24.9,-2,-3,5,0,-3,-6,-1,-1,"w1819","Mechanized",0,"Tue","weekday"
"4999",2019-03-12,"Kebler","3","3","3",17.4,0.1,70,-1,32,24.9,-2,-3,5,0,-3,-6,-1,-1,"w1819","Motorized",70,"Tue","weekday"
"5000",2019-03-12,"Kebler","3","3","3",17.4,0.1,70,-1,32,24.9,-2,-3,5,0,-3,-6,-1,-1,"w1819","Hybrid",1,"Tue","weekday"
"5001",2019-03-12,"Kebler","4","4","4",17.4,0.1,70,-1,32,24.9,-2,-3,5,0,-3,-6,-1,-1,"w1819","Non.motorized",0,"Tue","weekday"
"5002",2019-03-12,"Kebler","4","4","4",17.4,0.1,70,-1,32,24.9,-2,-3,5,0,-3,-6,-1,-1,"w1819","Mechanized",0,"Tue","weekday"
"5003",2019-03-12,"Kebler","4","4","4",17.4,0.1,70,-1,32,24.9,-2,-3,5,0,-3,-6,-1,-1,"w1819","Motorized",70,"Tue","weekday"
"5004",2019-03-12,"Kebler","4","4","4",17.4,0.1,70,-1,32,24.9,-2,-3,5,0,-3,-6,-1,-1,"w1819","Hybrid",1,"Tue","weekday"
"5005",2019-03-13,"Kebler","4","4","3",18.1,0.7,74,4,24,24.5,-1,-2,-3,5,3,1,-2,3,"w1819","Non.motorized",0,"Wed","weekday"
"5006",2019-03-13,"Kebler","4","4","3",18.1,0.7,74,4,24,24.5,-1,-2,-3,5,3,1,-2,3,"w1819","Mechanized",0,"Wed","weekday"
"5007",2019-03-13,"Kebler","4","4","3",18.1,0.7,74,4,24,24.5,-1,-2,-3,5,3,1,-2,3,"w1819","Motorized",0,"Wed","weekday"
"5008",2019-03-13,"Kebler","4","4","3",18.1,0.7,74,4,24,24.5,-1,-2,-3,5,3,1,-2,3,"w1819","Hybrid",0,"Wed","weekday"
"5009",2019-03-14,"Kebler","4","4","3",18.1,0,74,0,17,24.5,4,-1,-2,-3,4,3,1,-2,"w1819","Non.motorized",0,"Thu","weekday"
"5010",2019-03-14,"Kebler","4","4","3",18.1,0,74,0,17,24.5,4,-1,-2,-3,4,3,1,-2,"w1819","Mechanized",0,"Thu","weekday"
"5011",2019-03-14,"Kebler","4","4","3",18.1,0,74,0,17,24.5,4,-1,-2,-3,4,3,1,-2,"w1819","Motorized",2,"Thu","weekday"
"5012",2019-03-14,"Kebler","4","4","3",18.1,0,74,0,17,24.5,4,-1,-2,-3,4,3,1,-2,"w1819","Hybrid",0,"Thu","weekday"
"5013",2019-03-15,"Kebler","3","3","2",18.1,0,72,-2,18,25.1,0,4,-1,-2,-2,2,1,-1,"w1819","Non.motorized",0,"Fri","weekday"
"5014",2019-03-15,"Kebler","3","3","2",18.1,0,72,-2,18,25.1,0,4,-1,-2,-2,2,1,-1,"w1819","Mechanized",0,"Fri","weekday"
"5015",2019-03-15,"Kebler","3","3","2",18.1,0,72,-2,18,25.1,0,4,-1,-2,-2,2,1,-1,"w1819","Motorized",36,"Fri","weekday"
"5016",2019-03-15,"Kebler","3","3","2",18.1,0,72,-2,18,25.1,0,4,-1,-2,-2,2,1,-1,"w1819","Hybrid",1,"Fri","weekday"
"5017",2019-03-16,"Kebler","3","3","2",18.2,0.1,70,-2,26,26,-2,0,4,-1,-4,-4,0,-1,"w1819","Non.motorized",1,"Sat","weekend"
"5018",2019-03-16,"Kebler","3","3","2",18.2,0.1,70,-2,26,26,-2,0,4,-1,-4,-4,0,-1,"w1819","Mechanized",0,"Sat","weekend"
"5019",2019-03-16,"Kebler","3","3","2",18.2,0.1,70,-2,26,26,-2,0,4,-1,-4,-4,0,-1,"w1819","Motorized",103,"Sat","weekend"
"5020",2019-03-16,"Kebler","3","3","2",18.2,0.1,70,-2,26,26,-2,0,4,-1,-4,-4,0,-1,"w1819","Hybrid",0,"Sat","weekend"
"5021",2019-03-17,"Kebler","3","3","2",18.2,0,69,-1,28,26.4,-2,-2,0,4,-3,-5,-5,-1,"w1819","Non.motorized",7,"Sun","weekend"
"5022",2019-03-17,"Kebler","3","3","2",18.2,0,69,-1,28,26.4,-2,-2,0,4,-3,-5,-5,-1,"w1819","Mechanized",1,"Sun","weekend"
"5023",2019-03-17,"Kebler","3","3","2",18.2,0,69,-1,28,26.4,-2,-2,0,4,-3,-5,-5,-1,"w1819","Motorized",103,"Sun","weekend"
"5024",2019-03-17,"Kebler","3","3","2",18.2,0,69,-1,28,26.4,-2,-2,0,4,-3,-5,-5,-1,"w1819","Hybrid",0,"Sun","weekend"
"5025",2019-03-18,"Kebler","2","2","2",18.3,0.1,68,-1,29,26.9,-1,-2,-2,0,-2,-4,-6,-6,"w1819","Non.motorized",0,"Mon","weekday"
"5026",2019-03-18,"Kebler","2","2","2",18.3,0.1,68,-1,29,26.9,-1,-2,-2,0,-2,-4,-6,-6,"w1819","Mechanized",0,"Mon","weekday"
"5027",2019-03-18,"Kebler","2","2","2",18.3,0.1,68,-1,29,26.9,-1,-2,-2,0,-2,-4,-6,-6,"w1819","Motorized",85,"Mon","weekday"
"5028",2019-03-18,"Kebler","2","2","2",18.3,0.1,68,-1,29,26.9,-1,-2,-2,0,-2,-4,-6,-6,"w1819","Hybrid",2,"Mon","weekday"
"5029",2019-03-19,"Kebler","2","2","2",18.3,0,67,-1,28,27.3,-1,-1,-2,-2,-2,-3,-5,-7,"w1819","Non.motorized",2,"Tue","weekday"
"5030",2019-03-19,"Kebler","2","2","2",18.3,0,67,-1,28,27.3,-1,-1,-2,-2,-2,-3,-5,-7,"w1819","Mechanized",0,"Tue","weekday"
"5031",2019-03-19,"Kebler","2","2","2",18.3,0,67,-1,28,27.3,-1,-1,-2,-2,-2,-3,-5,-7,"w1819","Motorized",138,"Tue","weekday"
"5032",2019-03-19,"Kebler","2","2","2",18.3,0,67,-1,28,27.3,-1,-1,-2,-2,-2,-3,-5,-7,"w1819","Hybrid",2,"Tue","weekday"
"5033",2019-03-20,"Kebler","2","2","2",18.3,0,66,-1,30,27.7,-1,-1,-1,-2,-2,-3,-4,-6,"w1819","Non.motorized",2,"Wed","weekday"
"5034",2019-03-20,"Kebler","2","2","2",18.3,0,66,-1,30,27.7,-1,-1,-1,-2,-2,-3,-4,-6,"w1819","Mechanized",0,"Wed","weekday"
"5035",2019-03-20,"Kebler","2","2","2",18.3,0,66,-1,30,27.7,-1,-1,-1,-2,-2,-3,-4,-6,"w1819","Motorized",194,"Wed","weekday"
"5036",2019-03-20,"Kebler","2","2","2",18.3,0,66,-1,30,27.7,-1,-1,-1,-2,-2,-3,-4,-6,"w1819","Hybrid",2,"Wed","weekday"
"5037",2019-03-21,"Kebler","2","2","2",18.4,0.1,65,-1,33,28.3,-1,-1,-1,-1,-2,-3,-4,-5,"w1819","Non.motorized",3,"Thu","weekday"
"5038",2019-03-21,"Kebler","2","2","2",18.4,0.1,65,-1,33,28.3,-1,-1,-1,-1,-2,-3,-4,-5,"w1819","Mechanized",2,"Thu","weekday"
"5039",2019-03-21,"Kebler","2","2","2",18.4,0.1,65,-1,33,28.3,-1,-1,-1,-1,-2,-3,-4,-5,"w1819","Motorized",167,"Thu","weekday"
"5040",2019-03-21,"Kebler","2","2","2",18.4,0.1,65,-1,33,28.3,-1,-1,-1,-1,-2,-3,-4,-5,"w1819","Hybrid",7,"Thu","weekday"
"5041",2019-03-22,"Kebler","3","3","2",18.4,0,64,-1,28,28.8,-1,-1,-1,-1,-2,-3,-4,-5,"w1819","Non.motorized",1,"Fri","weekday"
"5042",2019-03-22,"Kebler","3","3","2",18.4,0,64,-1,28,28.8,-1,-1,-1,-1,-2,-3,-4,-5,"w1819","Mechanized",1,"Fri","weekday"
"5043",2019-03-22,"Kebler","3","3","2",18.4,0,64,-1,28,28.8,-1,-1,-1,-1,-2,-3,-4,-5,"w1819","Motorized",46,"Fri","weekday"
"5044",2019-03-22,"Kebler","3","3","2",18.4,0,64,-1,28,28.8,-1,-1,-1,-1,-2,-3,-4,-5,"w1819","Hybrid",9,"Fri","weekday"
"5045",2019-03-23,"Kebler","2","2","1",18.4,0,65,1,28,28.3,-1,-1,-1,-1,0,-1,-2,-3,"w1819","Non.motorized",3,"Sat","weekend"
"5046",2019-03-23,"Kebler","2","2","1",18.4,0,65,1,28,28.3,-1,-1,-1,-1,0,-1,-2,-3,"w1819","Mechanized",0,"Sat","weekend"
"5047",2019-03-23,"Kebler","2","2","1",18.4,0,65,1,28,28.3,-1,-1,-1,-1,0,-1,-2,-3,"w1819","Motorized",128,"Sat","weekend"
"5048",2019-03-23,"Kebler","2","2","1",18.4,0,65,1,28,28.3,-1,-1,-1,-1,0,-1,-2,-3,"w1819","Hybrid",12,"Sat","weekend"
"5049",2019-03-24,"Kebler","2","2","1",18.4,0,64,-1,29,28.8,1,-1,-1,-1,0,-1,-2,-3,"w1819","Non.motorized",4,"Sun","weekend"
"5050",2019-03-24,"Kebler","2","2","1",18.4,0,64,-1,29,28.8,1,-1,-1,-1,0,-1,-2,-3,"w1819","Mechanized",2,"Sun","weekend"
"5051",2019-03-24,"Kebler","2","2","1",18.4,0,64,-1,29,28.8,1,-1,-1,-1,0,-1,-2,-3,"w1819","Motorized",63,"Sun","weekend"
"5052",2019-03-24,"Kebler","2","2","1",18.4,0,64,-1,29,28.8,1,-1,-1,-1,0,-1,-2,-3,"w1819","Hybrid",7,"Sun","weekend"
"5053",2019-03-25,"Kebler","2","2","2",18.6,0.2,64,0,31,29.1,-1,1,-1,-1,-1,0,-1,-2,"w1819","Non.motorized",2,"Mon","weekday"
"5054",2019-03-25,"Kebler","2","2","2",18.6,0.2,64,0,31,29.1,-1,1,-1,-1,-1,0,-1,-2,"w1819","Mechanized",2,"Mon","weekday"
"5055",2019-03-25,"Kebler","2","2","2",18.6,0.2,64,0,31,29.1,-1,1,-1,-1,-1,0,-1,-2,"w1819","Motorized",110,"Mon","weekday"
"5056",2019-03-25,"Kebler","2","2","2",18.6,0.2,64,0,31,29.1,-1,1,-1,-1,-1,0,-1,-2,"w1819","Hybrid",17,"Mon","weekday"
"5057",2019-03-26,"Kebler","2","2","2",18.9,0.3,63,-1,36,30,0,-1,1,-1,-1,-2,-1,-2,"w1819","Non.motorized",4,"Tue","weekday"
"5058",2019-03-26,"Kebler","2","2","2",18.9,0.3,63,-1,36,30,0,-1,1,-1,-1,-2,-1,-2,"w1819","Mechanized",0,"Tue","weekday"
"5059",2019-03-26,"Kebler","2","2","2",18.9,0.3,63,-1,36,30,0,-1,1,-1,-1,-2,-1,-2,"w1819","Motorized",67,"Tue","weekday"
"5060",2019-03-26,"Kebler","2","2","2",18.9,0.3,63,-1,36,30,0,-1,1,-1,-1,-2,-1,-2,"w1819","Hybrid",0,"Tue","weekday"
"5061",2019-03-27,"Kebler","1","2","2",18.9,0,62,-1,42,30.5,-1,0,-1,1,-2,-2,-3,-2,"w1819","Non.motorized",9,"Wed","weekday"
"5062",2019-03-27,"Kebler","1","2","2",18.9,0,62,-1,42,30.5,-1,0,-1,1,-2,-2,-3,-2,"w1819","Mechanized",0,"Wed","weekday"
"5063",2019-03-27,"Kebler","1","2","2",18.9,0,62,-1,42,30.5,-1,0,-1,1,-2,-2,-3,-2,"w1819","Motorized",82,"Wed","weekday"
"5064",2019-03-27,"Kebler","1","2","2",18.9,0,62,-1,42,30.5,-1,0,-1,1,-2,-2,-3,-2,"w1819","Hybrid",0,"Wed","weekday"
"5065",2019-03-28,"Kebler","1","2","2",18.9,0,60,-2,40,31.5,-1,-1,0,-1,-3,-4,-4,-5,"w1819","Non.motorized",2,"Thu","weekday"
"5066",2019-03-28,"Kebler","1","2","2",18.9,0,60,-2,40,31.5,-1,-1,0,-1,-3,-4,-4,-5,"w1819","Mechanized",0,"Thu","weekday"
"5067",2019-03-28,"Kebler","1","2","2",18.9,0,60,-2,40,31.5,-1,-1,0,-1,-3,-4,-4,-5,"w1819","Motorized",91,"Thu","weekday"
"5068",2019-03-28,"Kebler","1","2","2",18.9,0,60,-2,40,31.5,-1,-1,0,-1,-3,-4,-4,-5,"w1819","Hybrid",2,"Thu","weekday"
"5069",2019-03-29,"Kebler","1","1","1",19,0.1,58,-2,26,32.8,-2,-1,-1,0,-4,-5,-6,-6,"w1819","Non.motorized",0,"Fri","weekday"
"5070",2019-03-29,"Kebler","1","1","1",19,0.1,58,-2,26,32.8,-2,-1,-1,0,-4,-5,-6,-6,"w1819","Mechanized",0,"Fri","weekday"
"5071",2019-03-29,"Kebler","1","1","1",19,0.1,58,-2,26,32.8,-2,-1,-1,0,-4,-5,-6,-6,"w1819","Motorized",19,"Fri","weekday"
"5072",2019-03-29,"Kebler","1","1","1",19,0.1,58,-2,26,32.8,-2,-1,-1,0,-4,-5,-6,-6,"w1819","Hybrid",2,"Fri","weekday"
"5073",2019-03-30,"Kebler","1","1","1",19.1,0.1,61,3,24,31.3,-2,-2,-1,-1,1,-1,-2,-3,"w1819","Non.motorized",1,"Sat","weekend"
"5074",2019-03-30,"Kebler","1","1","1",19.1,0.1,61,3,24,31.3,-2,-2,-1,-1,1,-1,-2,-3,"w1819","Mechanized",0,"Sat","weekend"
"5075",2019-03-30,"Kebler","1","1","1",19.1,0.1,61,3,24,31.3,-2,-2,-1,-1,1,-1,-2,-3,"w1819","Motorized",81,"Sat","weekend"
"5076",2019-03-30,"Kebler","1","1","1",19.1,0.1,61,3,24,31.3,-2,-2,-1,-1,1,-1,-2,-3,"w1819","Hybrid",2,"Sat","weekend"
"5077",2019-03-31,"Kebler","1","1","1",19.1,0,59,-2,24,32.4,3,-2,-2,-1,1,-1,-3,-4,"w1819","Non.motorized",4,"Sun","weekend"
"5078",2019-03-31,"Kebler","1","1","1",19.1,0,59,-2,24,32.4,3,-2,-2,-1,1,-1,-3,-4,"w1819","Mechanized",2,"Sun","weekend"
"5079",2019-03-31,"Kebler","1","1","1",19.1,0,59,-2,24,32.4,3,-2,-2,-1,1,-1,-3,-4,"w1819","Motorized",94,"Sun","weekend"
"5080",2019-03-31,"Kebler","1","1","1",19.1,0,59,-2,24,32.4,3,-2,-2,-1,1,-1,-3,-4,"w1819","Hybrid",16,"Sun","weekend"
"5081",2019-04-01,"Kebler","2","1","1",19.1,0,58,-1,29,32.9,-2,3,-2,-2,-3,0,-2,-4,"w1819","Non.motorized",0,"Mon","weekday"
"5082",2019-04-01,"Kebler","2","1","1",19.1,0,58,-1,29,32.9,-2,3,-2,-2,-3,0,-2,-4,"w1819","Mechanized",0,"Mon","weekday"
"5083",2019-04-01,"Kebler","2","1","1",19.1,0,58,-1,29,32.9,-2,3,-2,-2,-3,0,-2,-4,"w1819","Motorized",59,"Mon","weekday"
"5084",2019-04-01,"Kebler","2","1","1",19.1,0,58,-1,29,32.9,-2,3,-2,-2,-3,0,-2,-4,"w1819","Hybrid",17,"Mon","weekday"
"5085",2019-04-02,"Kebler","1","1","1",19.1,0,58,0,33,32.9,-1,-2,3,-2,-1,-3,0,-2,"w1819","Non.motorized",0,"Tue","weekday"
"5086",2019-04-02,"Kebler","1","1","1",19.1,0,58,0,33,32.9,-1,-2,3,-2,-1,-3,0,-2,"w1819","Mechanized",0,"Tue","weekday"
"5087",2019-04-02,"Kebler","1","1","1",19.1,0,58,0,33,32.9,-1,-2,3,-2,-1,-3,0,-2,"w1819","Motorized",42,"Tue","weekday"
"5088",2019-04-02,"Kebler","1","1","1",19.1,0,58,0,33,32.9,-1,-2,3,-2,-1,-3,0,-2,"w1819","Hybrid",13,"Tue","weekday"
"5089",2019-04-03,"Kebler","2","1","1",19.2,0.1,58,0,31,33.1,0,-1,-2,3,0,-1,-3,0,"w1819","Non.motorized",3,"Wed","weekday"
"5090",2019-04-03,"Kebler","2","1","1",19.2,0.1,58,0,31,33.1,0,-1,-2,3,0,-1,-3,0,"w1819","Mechanized",0,"Wed","weekday"
"5091",2019-04-03,"Kebler","2","1","1",19.2,0.1,58,0,31,33.1,0,-1,-2,3,0,-1,-3,0,"w1819","Motorized",46,"Wed","weekday"
"5092",2019-04-03,"Kebler","2","1","1",19.2,0.1,58,0,31,33.1,0,-1,-2,3,0,-1,-3,0,"w1819","Hybrid",21,"Wed","weekday"
"5093",2019-04-04,"Kebler","2","1","1",19.4,0.2,59,1,35,32.9,0,0,-1,-2,1,1,0,-2,"w1819","Non.motorized",1,"Thu","weekday"
"5094",2019-04-04,"Kebler","2","1","1",19.4,0.2,59,1,35,32.9,0,0,-1,-2,1,1,0,-2,"w1819","Mechanized",0,"Thu","weekday"
"5095",2019-04-04,"Kebler","2","1","1",19.4,0.2,59,1,35,32.9,0,0,-1,-2,1,1,0,-2,"w1819","Motorized",45,"Thu","weekday"
"5096",2019-04-04,"Kebler","2","1","1",19.4,0.2,59,1,35,32.9,0,0,-1,-2,1,1,0,-2,"w1819","Hybrid",6,"Thu","weekday"
"5097",2019-04-05,"Kebler","1","1","1",19.4,0,57,-2,38,34,1,0,0,-1,-1,-1,-1,-2,"w1819","Non.motorized",0,"Fri","weekday"
"5098",2019-04-05,"Kebler","1","1","1",19.4,0,57,-2,38,34,1,0,0,-1,-1,-1,-1,-2,"w1819","Mechanized",0,"Fri","weekday"
"5099",2019-04-05,"Kebler","1","1","1",19.4,0,57,-2,38,34,1,0,0,-1,-1,-1,-1,-2,"w1819","Motorized",47,"Fri","weekday"
"5100",2019-04-05,"Kebler","1","1","1",19.4,0,57,-2,38,34,1,0,0,-1,-1,-1,-1,-2,"w1819","Hybrid",7,"Fri","weekday"
"5101",2019-04-06,"Kebler","1","1","1",19.3,-0.1,57,0,35,33.9,-2,1,0,0,-2,-1,-1,-1,"w1819","Non.motorized",1,"Sat","weekend"
"5102",2019-04-06,"Kebler","1","1","1",19.3,-0.1,57,0,35,33.9,-2,1,0,0,-2,-1,-1,-1,"w1819","Mechanized",0,"Sat","weekend"
"5103",2019-04-06,"Kebler","1","1","1",19.3,-0.1,57,0,35,33.9,-2,1,0,0,-2,-1,-1,-1,"w1819","Motorized",55,"Sat","weekend"
"5104",2019-04-06,"Kebler","1","1","1",19.3,-0.1,57,0,35,33.9,-2,1,0,0,-2,-1,-1,-1,"w1819","Hybrid",16,"Sat","weekend"
"5105",2019-04-07,"Kebler","1","1","1",19.1,-0.2,57,0,37,33.5,0,-2,1,0,0,-2,-1,-1,"w1819","Non.motorized",0,"Sun","weekend"
"5106",2019-04-07,"Kebler","1","1","1",19.1,-0.2,57,0,37,33.5,0,-2,1,0,0,-2,-1,-1,"w1819","Mechanized",0,"Sun","weekend"
"5107",2019-04-07,"Kebler","1","1","1",19.1,-0.2,57,0,37,33.5,0,-2,1,0,0,-2,-1,-1,"w1819","Motorized",31,"Sun","weekend"
"5108",2019-04-07,"Kebler","1","1","1",19.1,-0.2,57,0,37,33.5,0,-2,1,0,0,-2,-1,-1,"w1819","Hybrid",0,"Sun","weekend"
"5109",2019-04-08,"Kebler","1","2","2",19.3,0.2,54,-3,41,35.7,0,0,-2,1,-3,-3,-5,-4,"w1819","Non.motorized",3,"Mon","weekday"
"5110",2019-04-08,"Kebler","1","2","2",19.3,0.2,54,-3,41,35.7,0,0,-2,1,-3,-3,-5,-4,"w1819","Mechanized",3,"Mon","weekday"
"5111",2019-04-08,"Kebler","1","2","2",19.3,0.2,54,-3,41,35.7,0,0,-2,1,-3,-3,-5,-4,"w1819","Motorized",32,"Mon","weekday"
"5112",2019-04-08,"Kebler","1","2","2",19.3,0.2,54,-3,41,35.7,0,0,-2,1,-3,-3,-5,-4,"w1819","Hybrid",7,"Mon","weekday"
"5113",2019-04-09,"Kebler","1","2","2",19.3,0,53,-1,43,36.4,-3,0,0,-2,-4,-4,-4,-6,"w1819","Non.motorized",0,"Tue","weekday"
"5114",2019-04-09,"Kebler","1","2","2",19.3,0,53,-1,43,36.4,-3,0,0,-2,-4,-4,-4,-6,"w1819","Mechanized",1,"Tue","weekday"
"5115",2019-04-09,"Kebler","1","2","2",19.3,0,53,-1,43,36.4,-3,0,0,-2,-4,-4,-4,-6,"w1819","Motorized",32,"Tue","weekday"
"5116",2019-04-09,"Kebler","1","2","2",19.3,0,53,-1,43,36.4,-3,0,0,-2,-4,-4,-4,-6,"w1819","Hybrid",2,"Tue","weekday"
"5117",2019-04-10,"Kebler","2","2","1",19,-0.3,51,-2,30,37.3,-1,-3,0,0,-3,-6,-6,-6,"w1819","Non.motorized",0,"Wed","weekday"
"5118",2019-04-10,"Kebler","2","2","1",19,-0.3,51,-2,30,37.3,-1,-3,0,0,-3,-6,-6,-6,"w1819","Mechanized",0,"Wed","weekday"
"5119",2019-04-10,"Kebler","2","2","1",19,-0.3,51,-2,30,37.3,-1,-3,0,0,-3,-6,-6,-6,"w1819","Motorized",7,"Wed","weekday"
"5120",2019-04-10,"Kebler","2","2","1",19,-0.3,51,-2,30,37.3,-1,-3,0,0,-3,-6,-6,-6,"w1819","Hybrid",0,"Wed","weekday"
"5121",2019-04-11,"Kebler","3","3","2",18.9,-0.1,53,2,20,35.7,-2,-1,-3,0,0,-1,-4,-4,"w1819","Non.motorized",0,"Thu","weekday"
"5122",2019-04-11,"Kebler","3","3","2",18.9,-0.1,53,2,20,35.7,-2,-1,-3,0,0,-1,-4,-4,"w1819","Mechanized",0,"Thu","weekday"
"5123",2019-04-11,"Kebler","3","3","2",18.9,-0.1,53,2,20,35.7,-2,-1,-3,0,0,-1,-4,-4,"w1819","Motorized",0,"Thu","weekday"
"5124",2019-04-11,"Kebler","3","3","2",18.9,-0.1,53,2,20,35.7,-2,-1,-3,0,0,-1,-4,-4,"w1819","Hybrid",0,"Thu","weekday"
"5125",2019-04-12,"Kebler","2","2","1",18.7,-0.2,53,0,24,35.3,2,-2,-1,-3,2,0,-1,-4,"w1819","Non.motorized",0,"Fri","weekday"
"5126",2019-04-12,"Kebler","2","2","1",18.7,-0.2,53,0,24,35.3,2,-2,-1,-3,2,0,-1,-4,"w1819","Mechanized",0,"Fri","weekday"
"5127",2019-04-12,"Kebler","2","2","1",18.7,-0.2,53,0,24,35.3,2,-2,-1,-3,2,0,-1,-4,"w1819","Motorized",31,"Fri","weekday"
"5128",2019-04-12,"Kebler","2","2","1",18.7,-0.2,53,0,24,35.3,2,-2,-1,-3,2,0,-1,-4,"w1819","Hybrid",4,"Fri","weekday"
"5129",2019-04-13,"Kebler","1","1","1",18.8,0.1,52,-1,27,36.2,0,2,-2,-1,-1,1,-1,-2,"w1819","Non.motorized",4,"Sat","weekend"
"5130",2019-04-13,"Kebler","1","1","1",18.8,0.1,52,-1,27,36.2,0,2,-2,-1,-1,1,-1,-2,"w1819","Mechanized",0,"Sat","weekend"
"5131",2019-04-13,"Kebler","1","1","1",18.8,0.1,52,-1,27,36.2,0,2,-2,-1,-1,1,-1,-2,"w1819","Motorized",61,"Sat","weekend"
"5132",2019-04-13,"Kebler","1","1","1",18.8,0.1,52,-1,27,36.2,0,2,-2,-1,-1,1,-1,-2,"w1819","Hybrid",29,"Sat","weekend"
"5133",2019-04-14,"Kebler","1","1","1",18.7,-0.1,51,-1,35,36.7,-1,0,2,-2,-2,-2,0,-2,"w1819","Non.motorized",1,"Sun","weekend"
"5134",2019-04-14,"Kebler","1","1","1",18.7,-0.1,51,-1,35,36.7,-1,0,2,-2,-2,-2,0,-2,"w1819","Mechanized",0,"Sun","weekend"
"5135",2019-04-14,"Kebler","1","1","1",18.7,-0.1,51,-1,35,36.7,-1,0,2,-2,-2,-2,0,-2,"w1819","Motorized",45,"Sun","weekend"
"5136",2019-04-14,"Kebler","1","1","1",18.7,-0.1,51,-1,35,36.7,-1,0,2,-2,-2,-2,0,-2,"w1819","Hybrid",14,"Sun","weekend"
"5137",2019-04-15,"Kebler",NA,NA,NA,18.6,-0.1,50,-1,41,37.2,-1,-1,0,2,-2,-3,-3,-1,"w1819","Non.motorized",2,"Mon","weekday"
"5138",2019-04-15,"Kebler",NA,NA,NA,18.6,-0.1,50,-1,41,37.2,-1,-1,0,2,-2,-3,-3,-1,"w1819","Mechanized",0,"Mon","weekday"
"5139",2019-04-15,"Kebler",NA,NA,NA,18.6,-0.1,50,-1,41,37.2,-1,-1,0,2,-2,-3,-3,-1,"w1819","Motorized",16,"Mon","weekday"
"5140",2019-04-15,"Kebler",NA,NA,NA,18.6,-0.1,50,-1,41,37.2,-1,-1,0,2,-2,-3,-3,-1,"w1819","Hybrid",5,"Mon","weekday"
"5141",2018-12-01,"Slate River Rd","3","3","2",3.3,0.2,19,1,16,17.4,0,0,0,0,1,1,1,1,"w1819","Non.motorized",NA,"Sat","weekend"
"5142",2018-12-01,"Slate River Rd","3","3","2",3.3,0.2,19,1,16,17.4,0,0,0,0,1,1,1,1,"w1819","Mechanized",NA,"Sat","weekend"
"5143",2018-12-01,"Slate River Rd","3","3","2",3.3,0.2,19,1,16,17.4,0,0,0,0,1,1,1,1,"w1819","Motorized",NA,"Sat","weekend"
"5144",2018-12-01,"Slate River Rd","3","3","2",3.3,0.2,19,1,16,17.4,0,0,0,0,1,1,1,1,"w1819","Hybrid",NA,"Sat","weekend"
"5145",2018-12-02,"Slate River Rd","3","3","3",3.3,0,20,1,14,16.5,1,0,0,0,2,2,2,2,"w1819","Non.motorized",NA,"Sun","weekend"
"5146",2018-12-02,"Slate River Rd","3","3","3",3.3,0,20,1,14,16.5,1,0,0,0,2,2,2,2,"w1819","Mechanized",NA,"Sun","weekend"
"5147",2018-12-02,"Slate River Rd","3","3","3",3.3,0,20,1,14,16.5,1,0,0,0,2,2,2,2,"w1819","Motorized",NA,"Sun","weekend"
"5148",2018-12-02,"Slate River Rd","3","3","3",3.3,0,20,1,14,16.5,1,0,0,0,2,2,2,2,"w1819","Hybrid",NA,"Sun","weekend"
"5149",2018-12-03,"Slate River Rd","3","3","2",3.4,0.1,19,-1,13,17.9,1,1,0,0,0,1,1,1,"w1819","Non.motorized",NA,"Mon","weekday"
"5150",2018-12-03,"Slate River Rd","3","3","2",3.4,0.1,19,-1,13,17.9,1,1,0,0,0,1,1,1,"w1819","Mechanized",NA,"Mon","weekday"
"5151",2018-12-03,"Slate River Rd","3","3","2",3.4,0.1,19,-1,13,17.9,1,1,0,0,0,1,1,1,"w1819","Motorized",NA,"Mon","weekday"
"5152",2018-12-03,"Slate River Rd","3","3","2",3.4,0.1,19,-1,13,17.9,1,1,0,0,0,1,1,1,"w1819","Hybrid",NA,"Mon","weekday"
"5153",2018-12-04,"Slate River Rd","3","3","2",3.5,0.1,20,1,8,17.5,-1,1,1,0,0,1,2,2,"w1819","Non.motorized",NA,"Tue","weekday"
"5154",2018-12-04,"Slate River Rd","3","3","2",3.5,0.1,20,1,8,17.5,-1,1,1,0,0,1,2,2,"w1819","Mechanized",NA,"Tue","weekday"
"5155",2018-12-04,"Slate River Rd","3","3","2",3.5,0.1,20,1,8,17.5,-1,1,1,0,0,1,2,2,"w1819","Motorized",NA,"Tue","weekday"
"5156",2018-12-04,"Slate River Rd","3","3","2",3.5,0.1,20,1,8,17.5,-1,1,1,0,0,1,2,2,"w1819","Hybrid",NA,"Tue","weekday"
"5157",2018-12-05,"Slate River Rd","3","3","2",3.5,0,19,-1,21,18.4,1,-1,1,1,0,-1,0,1,"w1819","Non.motorized",14,"Wed","weekday"
"5158",2018-12-05,"Slate River Rd","3","3","2",3.5,0,19,-1,21,18.4,1,-1,1,1,0,-1,0,1,"w1819","Mechanized",0,"Wed","weekday"
"5159",2018-12-05,"Slate River Rd","3","3","2",3.5,0,19,-1,21,18.4,1,-1,1,1,0,-1,0,1,"w1819","Motorized",10,"Wed","weekday"
"5160",2018-12-05,"Slate River Rd","3","3","2",3.5,0,19,-1,21,18.4,1,-1,1,1,0,-1,0,1,"w1819","Hybrid",10,"Wed","weekday"
"5161",2018-12-06,"Slate River Rd","2","2","2",3.7,0.2,18,-1,25,20.6,-1,1,-1,1,-2,-1,-2,-1,"w1819","Non.motorized",5,"Thu","weekday"
"5162",2018-12-06,"Slate River Rd","2","2","2",3.7,0.2,18,-1,25,20.6,-1,1,-1,1,-2,-1,-2,-1,"w1819","Mechanized",0,"Thu","weekday"
"5163",2018-12-06,"Slate River Rd","2","2","2",3.7,0.2,18,-1,25,20.6,-1,1,-1,1,-2,-1,-2,-1,"w1819","Motorized",6,"Thu","weekday"
"5164",2018-12-06,"Slate River Rd","2","2","2",3.7,0.2,18,-1,25,20.6,-1,1,-1,1,-2,-1,-2,-1,"w1819","Hybrid",6,"Thu","weekday"
"5165",2018-12-07,"Slate River Rd","2","2","2",3.8,0.1,21,3,23,18.1,-1,-1,1,-1,2,1,2,1,"w1819","Non.motorized",11,"Fri","weekday"
"5166",2018-12-07,"Slate River Rd","2","2","2",3.8,0.1,21,3,23,18.1,-1,-1,1,-1,2,1,2,1,"w1819","Mechanized",0,"Fri","weekday"
"5167",2018-12-07,"Slate River Rd","2","2","2",3.8,0.1,21,3,23,18.1,-1,-1,1,-1,2,1,2,1,"w1819","Motorized",13,"Fri","weekday"
"5168",2018-12-07,"Slate River Rd","2","2","2",3.8,0.1,21,3,23,18.1,-1,-1,1,-1,2,1,2,1,"w1819","Hybrid",13,"Fri","weekday"
"5169",2018-12-08,"Slate River Rd","2","2","2",3.8,0,20,-1,23,19,3,-1,-1,1,2,1,0,1,"w1819","Non.motorized",24,"Sat","weekend"
"5170",2018-12-08,"Slate River Rd","2","2","2",3.8,0,20,-1,23,19,3,-1,-1,1,2,1,0,1,"w1819","Mechanized",0,"Sat","weekend"
"5171",2018-12-08,"Slate River Rd","2","2","2",3.8,0,20,-1,23,19,3,-1,-1,1,2,1,0,1,"w1819","Motorized",23,"Sat","weekend"
"5172",2018-12-08,"Slate River Rd","2","2","2",3.8,0,20,-1,23,19,3,-1,-1,1,2,1,0,1,"w1819","Hybrid",22,"Sat","weekend"
"5173",2018-12-09,"Slate River Rd","2","2","2",3.8,0,20,0,19,19,-1,3,-1,-1,-1,2,1,0,"w1819","Non.motorized",39,"Sun","weekend"
"5174",2018-12-09,"Slate River Rd","2","2","2",3.8,0,20,0,19,19,-1,3,-1,-1,-1,2,1,0,"w1819","Mechanized",0,"Sun","weekend"
"5175",2018-12-09,"Slate River Rd","2","2","2",3.8,0,20,0,19,19,-1,3,-1,-1,-1,2,1,0,"w1819","Motorized",10,"Sun","weekend"
"5176",2018-12-09,"Slate River Rd","2","2","2",3.8,0,20,0,19,19,-1,3,-1,-1,-1,2,1,0,"w1819","Hybrid",10,"Sun","weekend"
"5177",2018-12-10,"Slate River Rd","2","2","2",3.8,0,20,0,21,19,0,-1,3,-1,0,-1,2,1,"w1819","Non.motorized",10,"Mon","weekday"
"5178",2018-12-10,"Slate River Rd","2","2","2",3.8,0,20,0,21,19,0,-1,3,-1,0,-1,2,1,"w1819","Mechanized",0,"Mon","weekday"
"5179",2018-12-10,"Slate River Rd","2","2","2",3.8,0,20,0,21,19,0,-1,3,-1,0,-1,2,1,"w1819","Motorized",10,"Mon","weekday"
"5180",2018-12-10,"Slate River Rd","2","2","2",3.8,0,20,0,21,19,0,-1,3,-1,0,-1,2,1,"w1819","Hybrid",10,"Mon","weekday"
"5181",2018-12-11,"Slate River Rd","2","2","2",3.9,0.1,19,-1,27,20.5,0,0,-1,3,-1,-1,-2,1,"w1819","Non.motorized",8,"Tue","weekday"
"5182",2018-12-11,"Slate River Rd","2","2","2",3.9,0.1,19,-1,27,20.5,0,0,-1,3,-1,-1,-2,1,"w1819","Mechanized",0,"Tue","weekday"
"5183",2018-12-11,"Slate River Rd","2","2","2",3.9,0.1,19,-1,27,20.5,0,0,-1,3,-1,-1,-2,1,"w1819","Motorized",7,"Tue","weekday"
"5184",2018-12-11,"Slate River Rd","2","2","2",3.9,0.1,19,-1,27,20.5,0,0,-1,3,-1,-1,-2,1,"w1819","Hybrid",7,"Tue","weekday"
"5185",2018-12-12,"Slate River Rd","2","2","1",3.9,0,19,0,21,20.5,-1,0,0,-1,-1,-1,-1,-2,"w1819","Non.motorized",6,"Wed","weekday"
"5186",2018-12-12,"Slate River Rd","2","2","1",3.9,0,19,0,21,20.5,-1,0,0,-1,-1,-1,-1,-2,"w1819","Mechanized",0,"Wed","weekday"
"5187",2018-12-12,"Slate River Rd","2","2","1",3.9,0,19,0,21,20.5,-1,0,0,-1,-1,-1,-1,-2,"w1819","Motorized",4,"Wed","weekday"
"5188",2018-12-12,"Slate River Rd","2","2","1",3.9,0,19,0,21,20.5,-1,0,0,-1,-1,-1,-1,-2,"w1819","Hybrid",4,"Wed","weekday"
"5189",2018-12-13,"Slate River Rd","3","3","2",4,0.1,21,2,15,19,0,-1,0,0,2,1,1,1,"w1819","Non.motorized",0,"Thu","weekday"
"5190",2018-12-13,"Slate River Rd","3","3","2",4,0.1,21,2,15,19,0,-1,0,0,2,1,1,1,"w1819","Mechanized",0,"Thu","weekday"
"5191",2018-12-13,"Slate River Rd","3","3","2",4,0.1,21,2,15,19,0,-1,0,0,2,1,1,1,"w1819","Motorized",0,"Thu","weekday"
"5192",2018-12-13,"Slate River Rd","3","3","2",4,0.1,21,2,15,19,0,-1,0,0,2,1,1,1,"w1819","Hybrid",0,"Thu","weekday"
"5193",2018-12-14,"Slate River Rd","3","3","2",4,0,20,-1,24,20,2,0,-1,0,1,1,0,0,"w1819","Non.motorized",12,"Fri","weekday"
"5194",2018-12-14,"Slate River Rd","3","3","2",4,0,20,-1,24,20,2,0,-1,0,1,1,0,0,"w1819","Mechanized",0,"Fri","weekday"
"5195",2018-12-14,"Slate River Rd","3","3","2",4,0,20,-1,24,20,2,0,-1,0,1,1,0,0,"w1819","Motorized",6,"Fri","weekday"
"5196",2018-12-14,"Slate River Rd","3","3","2",4,0,20,-1,24,20,2,0,-1,0,1,1,0,0,"w1819","Hybrid",6,"Fri","weekday"
"5197",2018-12-15,"Slate River Rd","2","2","2",4,0,20,0,29,20,-1,2,0,-1,-1,1,1,0,"w1819","Non.motorized",42,"Sat","weekend"
"5198",2018-12-15,"Slate River Rd","2","2","2",4,0,20,0,29,20,-1,2,0,-1,-1,1,1,0,"w1819","Mechanized",0,"Sat","weekend"
"5199",2018-12-15,"Slate River Rd","2","2","2",4,0,20,0,29,20,-1,2,0,-1,-1,1,1,0,"w1819","Motorized",14,"Sat","weekend"
"5200",2018-12-15,"Slate River Rd","2","2","2",4,0,20,0,29,20,-1,2,0,-1,-1,1,1,0,"w1819","Hybrid",8,"Sat","weekend"
"5201",2018-12-16,"Slate River Rd","2","2","2",4.1,0.1,19,-1,28,21.6,0,-1,2,0,-1,-2,0,0,"w1819","Non.motorized",29,"Sun","weekend"
"5202",2018-12-16,"Slate River Rd","2","2","2",4.1,0.1,19,-1,28,21.6,0,-1,2,0,-1,-2,0,0,"w1819","Mechanized",0,"Sun","weekend"
"5203",2018-12-16,"Slate River Rd","2","2","2",4.1,0.1,19,-1,28,21.6,0,-1,2,0,-1,-2,0,0,"w1819","Motorized",21,"Sun","weekend"
"5204",2018-12-16,"Slate River Rd","2","2","2",4.1,0.1,19,-1,28,21.6,0,-1,2,0,-1,-2,0,0,"w1819","Hybrid",21,"Sun","weekend"
"5205",2018-12-17,"Slate River Rd","2","2","2",4.1,0,19,0,29,21.6,-1,0,-1,2,-1,-1,-2,0,"w1819","Non.motorized",14,"Mon","weekday"
"5206",2018-12-17,"Slate River Rd","2","2","2",4.1,0,19,0,29,21.6,-1,0,-1,2,-1,-1,-2,0,"w1819","Mechanized",0,"Mon","weekday"
"5207",2018-12-17,"Slate River Rd","2","2","2",4.1,0,19,0,29,21.6,-1,0,-1,2,-1,-1,-2,0,"w1819","Motorized",2,"Mon","weekday"
"5208",2018-12-17,"Slate River Rd","2","2","2",4.1,0,19,0,29,21.6,-1,0,-1,2,-1,-1,-2,0,"w1819","Hybrid",2,"Mon","weekday"
"5209",2018-12-18,"Slate River Rd","2","2","2",4.1,0,19,0,27,21.6,0,-1,0,-1,0,-1,-1,-2,"w1819","Non.motorized",21,"Tue","weekday"
"5210",2018-12-18,"Slate River Rd","2","2","2",4.1,0,19,0,27,21.6,0,-1,0,-1,0,-1,-1,-2,"w1819","Mechanized",0,"Tue","weekday"
"5211",2018-12-18,"Slate River Rd","2","2","2",4.1,0,19,0,27,21.6,0,-1,0,-1,0,-1,-1,-2,"w1819","Motorized",7,"Tue","weekday"
"5212",2018-12-18,"Slate River Rd","2","2","2",4.1,0,19,0,27,21.6,0,-1,0,-1,0,-1,-1,-2,"w1819","Hybrid",7,"Tue","weekday"
"5213",2018-12-19,"Slate River Rd","2","2","2",4.1,0,19,0,24,21.6,0,0,-1,0,0,0,-1,-1,"w1819","Non.motorized",10,"Wed","weekday"
"5214",2018-12-19,"Slate River Rd","2","2","2",4.1,0,19,0,24,21.6,0,0,-1,0,0,0,-1,-1,"w1819","Mechanized",0,"Wed","weekday"
"5215",2018-12-19,"Slate River Rd","2","2","2",4.1,0,19,0,24,21.6,0,0,-1,0,0,0,-1,-1,"w1819","Motorized",3,"Wed","weekday"
"5216",2018-12-19,"Slate River Rd","2","2","2",4.1,0,19,0,24,21.6,0,0,-1,0,0,0,-1,-1,"w1819","Hybrid",3,"Wed","weekday"
"5217",2018-12-20,"Slate River Rd","2","2","1",4.1,0,20,1,25,20.5,0,0,0,-1,1,1,1,0,"w1819","Non.motorized",24,"Thu","weekday"
"5218",2018-12-20,"Slate River Rd","2","2","1",4.1,0,20,1,25,20.5,0,0,0,-1,1,1,1,0,"w1819","Mechanized",0,"Thu","weekday"
"5219",2018-12-20,"Slate River Rd","2","2","1",4.1,0,20,1,25,20.5,0,0,0,-1,1,1,1,0,"w1819","Motorized",7,"Thu","weekday"
"5220",2018-12-20,"Slate River Rd","2","2","1",4.1,0,20,1,25,20.5,0,0,0,-1,1,1,1,0,"w1819","Hybrid",7,"Thu","weekday"
"5221",2018-12-21,"Slate River Rd","2","2","1",4.1,0,19,-1,28,21.6,1,0,0,0,0,0,0,0,"w1819","Non.motorized",9,"Fri","weekday"
"5222",2018-12-21,"Slate River Rd","2","2","1",4.1,0,19,-1,28,21.6,1,0,0,0,0,0,0,0,"w1819","Mechanized",0,"Fri","weekday"
"5223",2018-12-21,"Slate River Rd","2","2","1",4.1,0,19,-1,28,21.6,1,0,0,0,0,0,0,0,"w1819","Motorized",6,"Fri","weekday"
"5224",2018-12-21,"Slate River Rd","2","2","1",4.1,0,19,-1,28,21.6,1,0,0,0,0,0,0,0,"w1819","Hybrid",6,"Fri","weekday"
"5225",2018-12-22,"Slate River Rd","2","2","1",4.2,0.1,19,0,20,22.1,-1,1,0,0,-1,0,0,0,"w1819","Non.motorized",29,"Sat","weekend"
"5226",2018-12-22,"Slate River Rd","2","2","1",4.2,0.1,19,0,20,22.1,-1,1,0,0,-1,0,0,0,"w1819","Mechanized",0,"Sat","weekend"
"5227",2018-12-22,"Slate River Rd","2","2","1",4.2,0.1,19,0,20,22.1,-1,1,0,0,-1,0,0,0,"w1819","Motorized",8,"Sat","weekend"
"5228",2018-12-22,"Slate River Rd","2","2","1",4.2,0.1,19,0,20,22.1,-1,1,0,0,-1,0,0,0,"w1819","Hybrid",8,"Sat","weekend"
"5229",2018-12-23,"Slate River Rd","2","2","1",4.2,0,21,2,19,20,0,-1,1,0,2,1,2,2,"w1819","Non.motorized",39,"Sun","weekend"
"5230",2018-12-23,"Slate River Rd","2","2","1",4.2,0,21,2,19,20,0,-1,1,0,2,1,2,2,"w1819","Mechanized",0,"Sun","weekend"
"5231",2018-12-23,"Slate River Rd","2","2","1",4.2,0,21,2,19,20,0,-1,1,0,2,1,2,2,"w1819","Motorized",16,"Sun","weekend"
"5232",2018-12-23,"Slate River Rd","2","2","1",4.2,0,21,2,19,20,0,-1,1,0,2,1,2,2,"w1819","Hybrid",16,"Sun","weekend"
"5233",2018-12-24,"Slate River Rd","2","2","2",4.3,0.1,20,-1,21,21.5,2,0,-1,1,1,1,0,1,"w1819","Non.motorized",37,"Mon","weekday"
"5234",2018-12-24,"Slate River Rd","2","2","2",4.3,0.1,20,-1,21,21.5,2,0,-1,1,1,1,0,1,"w1819","Mechanized",1,"Mon","weekday"
"5235",2018-12-24,"Slate River Rd","2","2","2",4.3,0.1,20,-1,21,21.5,2,0,-1,1,1,1,0,1,"w1819","Motorized",11,"Mon","weekday"
"5236",2018-12-24,"Slate River Rd","2","2","2",4.3,0.1,20,-1,21,21.5,2,0,-1,1,1,1,0,1,"w1819","Hybrid",11,"Mon","weekday"
"5237",2018-12-25,"Slate River Rd","2","2","2",4.7,0.4,25,5,25,18.8,-1,2,0,-1,4,6,6,5,"w1819","Non.motorized",61,"Tue","weekday"
"5238",2018-12-25,"Slate River Rd","2","2","2",4.7,0.4,25,5,25,18.8,-1,2,0,-1,4,6,6,5,"w1819","Mechanized",0,"Tue","weekday"
"5239",2018-12-25,"Slate River Rd","2","2","2",4.7,0.4,25,5,25,18.8,-1,2,0,-1,4,6,6,5,"w1819","Motorized",15,"Tue","weekday"
"5240",2018-12-25,"Slate River Rd","2","2","2",4.7,0.4,25,5,25,18.8,-1,2,0,-1,4,6,6,5,"w1819","Hybrid",15,"Tue","weekday"
"5241",2018-12-26,"Slate River Rd","3","3","3",4.7,0,23,-2,24,20.4,5,-1,2,0,3,2,4,4,"w1819","Non.motorized",35,"Wed","weekday"
"5242",2018-12-26,"Slate River Rd","3","3","3",4.7,0,23,-2,24,20.4,5,-1,2,0,3,2,4,4,"w1819","Mechanized",0,"Wed","weekday"
"5243",2018-12-26,"Slate River Rd","3","3","3",4.7,0,23,-2,24,20.4,5,-1,2,0,3,2,4,4,"w1819","Motorized",16,"Wed","weekday"
"5244",2018-12-26,"Slate River Rd","3","3","3",4.7,0,23,-2,24,20.4,5,-1,2,0,3,2,4,4,"w1819","Hybrid",11,"Wed","weekday"
"5245",2018-12-27,"Slate River Rd","3","3","2",4.7,0,24,1,12,19.6,-2,5,-1,2,-1,4,3,5,"w1819","Non.motorized",19,"Thu","weekday"
"5246",2018-12-27,"Slate River Rd","3","3","2",4.7,0,24,1,12,19.6,-2,5,-1,2,-1,4,3,5,"w1819","Mechanized",1,"Thu","weekday"
"5247",2018-12-27,"Slate River Rd","3","3","2",4.7,0,24,1,12,19.6,-2,5,-1,2,-1,4,3,5,"w1819","Motorized",7,"Thu","weekday"
"5248",2018-12-27,"Slate River Rd","3","3","2",4.7,0,24,1,12,19.6,-2,5,-1,2,-1,4,3,5,"w1819","Hybrid",5,"Thu","weekday"
"5249",2018-12-28,"Slate River Rd","3","3","2",4.7,0,24,0,12,19.6,1,-2,5,-1,1,-1,4,3,"w1819","Non.motorized",60,"Fri","weekday"
"5250",2018-12-28,"Slate River Rd","3","3","2",4.7,0,24,0,12,19.6,1,-2,5,-1,1,-1,4,3,"w1819","Mechanized",0,"Fri","weekday"
"5251",2018-12-28,"Slate River Rd","3","3","2",4.7,0,24,0,12,19.6,1,-2,5,-1,1,-1,4,3,"w1819","Motorized",10,"Fri","weekday"
"5252",2018-12-28,"Slate River Rd","3","3","2",4.7,0,24,0,12,19.6,1,-2,5,-1,1,-1,4,3,"w1819","Hybrid",8,"Fri","weekday"
"5253",2018-12-29,"Slate River Rd","3","3","2",4.7,0,24,0,8,19.6,0,1,-2,5,0,1,-1,4,"w1819","Non.motorized",50,"Sat","weekend"
"5254",2018-12-29,"Slate River Rd","3","3","2",4.7,0,24,0,8,19.6,0,1,-2,5,0,1,-1,4,"w1819","Mechanized",2,"Sat","weekend"
"5255",2018-12-29,"Slate River Rd","3","3","2",4.7,0,24,0,8,19.6,0,1,-2,5,0,1,-1,4,"w1819","Motorized",51,"Sat","weekend"
"5256",2018-12-29,"Slate River Rd","3","3","2",4.7,0,24,0,8,19.6,0,1,-2,5,0,1,-1,4,"w1819","Hybrid",10,"Sat","weekend"
"5257",2018-12-30,"Slate River Rd","3","3","2",4.7,0,24,0,16,19.6,0,0,1,-2,0,0,1,-1,"w1819","Non.motorized",54,"Sun","weekend"
"5258",2018-12-30,"Slate River Rd","3","3","2",4.7,0,24,0,16,19.6,0,0,1,-2,0,0,1,-1,"w1819","Mechanized",1,"Sun","weekend"
"5259",2018-12-30,"Slate River Rd","3","3","2",4.7,0,24,0,16,19.6,0,0,1,-2,0,0,1,-1,"w1819","Motorized",26,"Sun","weekend"
"5260",2018-12-30,"Slate River Rd","3","3","2",4.7,0,24,0,16,19.6,0,0,1,-2,0,0,1,-1,"w1819","Hybrid",20,"Sun","weekend"
"5261",2018-12-31,"Slate River Rd","3","3","3",4.9,0.2,23,-1,14,21.3,0,0,0,1,-1,-1,-1,0,"w1819","Non.motorized",36,"Mon","weekday"
"5262",2018-12-31,"Slate River Rd","3","3","3",4.9,0.2,23,-1,14,21.3,0,0,0,1,-1,-1,-1,0,"w1819","Mechanized",0,"Mon","weekday"
"5263",2018-12-31,"Slate River Rd","3","3","3",4.9,0.2,23,-1,14,21.3,0,0,0,1,-1,-1,-1,0,"w1819","Motorized",6,"Mon","weekday"
"5264",2018-12-31,"Slate River Rd","3","3","3",4.9,0.2,23,-1,14,21.3,0,0,0,1,-1,-1,-1,0,"w1819","Hybrid",6,"Mon","weekday"
"5265",2019-01-01,"Slate River Rd","3","3","3",5.1,0.2,29,6,11,17.6,-1,0,0,0,5,5,5,5,"w1819","Non.motorized",29,"Tue","weekday"
"5266",2019-01-01,"Slate River Rd","3","3","3",5.1,0.2,29,6,11,17.6,-1,0,0,0,5,5,5,5,"w1819","Mechanized",2,"Tue","weekday"
"5267",2019-01-01,"Slate River Rd","3","3","3",5.1,0.2,29,6,11,17.6,-1,0,0,0,5,5,5,5,"w1819","Motorized",23,"Tue","weekday"
"5268",2019-01-01,"Slate River Rd","3","3","3",5.1,0.2,29,6,11,17.6,-1,0,0,0,5,5,5,5,"w1819","Hybrid",23,"Tue","weekday"
"5269",2019-01-02,"Slate River Rd","3","3","2",5.1,0,28,-1,10,18.2,6,-1,0,0,5,4,4,4,"w1819","Non.motorized",25,"Wed","weekday"
"5270",2019-01-02,"Slate River Rd","3","3","2",5.1,0,28,-1,10,18.2,6,-1,0,0,5,4,4,4,"w1819","Mechanized",0,"Wed","weekday"
"5271",2019-01-02,"Slate River Rd","3","3","2",5.1,0,28,-1,10,18.2,6,-1,0,0,5,4,4,4,"w1819","Motorized",4,"Wed","weekday"
"5272",2019-01-02,"Slate River Rd","3","3","2",5.1,0,28,-1,10,18.2,6,-1,0,0,5,4,4,4,"w1819","Hybrid",4,"Wed","weekday"
"5273",2019-01-03,"Slate River Rd","3","3","2",5.1,0,27,-1,22,18.9,-1,6,-1,0,-2,4,3,3,"w1819","Non.motorized",45,"Thu","weekday"
"5274",2019-01-03,"Slate River Rd","3","3","2",5.1,0,27,-1,22,18.9,-1,6,-1,0,-2,4,3,3,"w1819","Mechanized",1,"Thu","weekday"
"5275",2019-01-03,"Slate River Rd","3","3","2",5.1,0,27,-1,22,18.9,-1,6,-1,0,-2,4,3,3,"w1819","Motorized",2,"Thu","weekday"
"5276",2019-01-03,"Slate River Rd","3","3","2",5.1,0,27,-1,22,18.9,-1,6,-1,0,-2,4,3,3,"w1819","Hybrid",1,"Thu","weekday"
"5277",2019-01-04,"Slate River Rd","3","3","2",5.3,0.2,26,-1,29,20.4,-1,-1,6,-1,-2,-3,3,2,"w1819","Non.motorized",18,"Fri","weekday"
"5278",2019-01-04,"Slate River Rd","3","3","2",5.3,0.2,26,-1,29,20.4,-1,-1,6,-1,-2,-3,3,2,"w1819","Mechanized",1,"Fri","weekday"
"5279",2019-01-04,"Slate River Rd","3","3","2",5.3,0.2,26,-1,29,20.4,-1,-1,6,-1,-2,-3,3,2,"w1819","Motorized",8,"Fri","weekday"
"5280",2019-01-04,"Slate River Rd","3","3","2",5.3,0.2,26,-1,29,20.4,-1,-1,6,-1,-2,-3,3,2,"w1819","Hybrid",8,"Fri","weekday"
"5281",2019-01-05,"Slate River Rd","2","2","2",5.3,0,25,-1,30,21.2,-1,-1,-1,6,-2,-3,-4,2,"w1819","Non.motorized",49,"Sat","weekend"
"5282",2019-01-05,"Slate River Rd","2","2","2",5.3,0,25,-1,30,21.2,-1,-1,-1,6,-2,-3,-4,2,"w1819","Mechanized",4,"Sat","weekend"
"5283",2019-01-05,"Slate River Rd","2","2","2",5.3,0,25,-1,30,21.2,-1,-1,-1,6,-2,-3,-4,2,"w1819","Motorized",16,"Sat","weekend"
"5284",2019-01-05,"Slate River Rd","2","2","2",5.3,0,25,-1,30,21.2,-1,-1,-1,6,-2,-3,-4,2,"w1819","Hybrid",16,"Sat","weekend"
"5285",2019-01-06,"Slate River Rd","3","3","3",5.3,0,25,0,26,21.2,-1,-1,-1,-1,-1,-2,-3,-4,"w1819","Non.motorized",23,"Sun","weekend"
"5286",2019-01-06,"Slate River Rd","3","3","3",5.3,0,25,0,26,21.2,-1,-1,-1,-1,-1,-2,-3,-4,"w1819","Mechanized",0,"Sun","weekend"
"5287",2019-01-06,"Slate River Rd","3","3","3",5.3,0,25,0,26,21.2,-1,-1,-1,-1,-1,-2,-3,-4,"w1819","Motorized",10,"Sun","weekend"
"5288",2019-01-06,"Slate River Rd","3","3","3",5.3,0,25,0,26,21.2,-1,-1,-1,-1,-1,-2,-3,-4,"w1819","Hybrid",8,"Sun","weekend"
"5289",2019-01-07,"Slate River Rd","3","3","3",5.8,0.5,32,7,21,18.1,0,-1,-1,-1,7,6,5,4,"w1819","Non.motorized",5,"Mon","weekday"
"5290",2019-01-07,"Slate River Rd","3","3","3",5.8,0.5,32,7,21,18.1,0,-1,-1,-1,7,6,5,4,"w1819","Mechanized",0,"Mon","weekday"
"5291",2019-01-07,"Slate River Rd","3","3","3",5.8,0.5,32,7,21,18.1,0,-1,-1,-1,7,6,5,4,"w1819","Motorized",7,"Mon","weekday"
"5292",2019-01-07,"Slate River Rd","3","3","3",5.8,0.5,32,7,21,18.1,0,-1,-1,-1,7,6,5,4,"w1819","Hybrid",7,"Mon","weekday"
"5293",2019-01-08,"Slate River Rd","3","3","3",5.9,0.1,32,0,24,18.4,7,0,-1,-1,7,7,6,5,"w1819","Non.motorized",17,"Tue","weekday"
"5294",2019-01-08,"Slate River Rd","3","3","3",5.9,0.1,32,0,24,18.4,7,0,-1,-1,7,7,6,5,"w1819","Mechanized",0,"Tue","weekday"
"5295",2019-01-08,"Slate River Rd","3","3","3",5.9,0.1,32,0,24,18.4,7,0,-1,-1,7,7,6,5,"w1819","Motorized",3,"Tue","weekday"
"5296",2019-01-08,"Slate River Rd","3","3","3",5.9,0.1,32,0,24,18.4,7,0,-1,-1,7,7,6,5,"w1819","Hybrid",3,"Tue","weekday"
"5297",2019-01-09,"Slate River Rd","3","3","3",6,0.1,30,-2,29,20,0,7,0,-1,-2,5,5,4,"w1819","Non.motorized",25,"Wed","weekday"
"5298",2019-01-09,"Slate River Rd","3","3","3",6,0.1,30,-2,29,20,0,7,0,-1,-2,5,5,4,"w1819","Mechanized",0,"Wed","weekday"
"5299",2019-01-09,"Slate River Rd","3","3","3",6,0.1,30,-2,29,20,0,7,0,-1,-2,5,5,4,"w1819","Motorized",7,"Wed","weekday"
"5300",2019-01-09,"Slate River Rd","3","3","3",6,0.1,30,-2,29,20,0,7,0,-1,-2,5,5,4,"w1819","Hybrid",7,"Wed","weekday"
"5301",2019-01-10,"Slate River Rd","3","3","3",6,0,29,-1,29,20.7,-2,0,7,0,-3,-3,4,4,"w1819","Non.motorized",20,"Thu","weekday"
"5302",2019-01-10,"Slate River Rd","3","3","3",6,0,29,-1,29,20.7,-2,0,7,0,-3,-3,4,4,"w1819","Mechanized",0,"Thu","weekday"
"5303",2019-01-10,"Slate River Rd","3","3","3",6,0,29,-1,29,20.7,-2,0,7,0,-3,-3,4,4,"w1819","Motorized",10,"Thu","weekday"
"5304",2019-01-10,"Slate River Rd","3","3","3",6,0,29,-1,29,20.7,-2,0,7,0,-3,-3,4,4,"w1819","Hybrid",10,"Thu","weekday"
"5305",2019-01-11,"Slate River Rd","2","2","2",6.1,0.1,29,0,25,21,-1,-2,0,7,-1,-3,-3,4,"w1819","Non.motorized",17,"Fri","weekday"
"5306",2019-01-11,"Slate River Rd","2","2","2",6.1,0.1,29,0,25,21,-1,-2,0,7,-1,-3,-3,4,"w1819","Mechanized",0,"Fri","weekday"
"5307",2019-01-11,"Slate River Rd","2","2","2",6.1,0.1,29,0,25,21,-1,-2,0,7,-1,-3,-3,4,"w1819","Motorized",13,"Fri","weekday"
"5308",2019-01-11,"Slate River Rd","2","2","2",6.1,0.1,29,0,25,21,-1,-2,0,7,-1,-3,-3,4,"w1819","Hybrid",12,"Fri","weekday"
"5309",2019-01-12,"Slate River Rd","3","3","2",6.1,0,28,-1,21,21.8,0,-1,-2,0,-1,-2,-4,-4,"w1819","Non.motorized",14,"Sat","weekend"
"5310",2019-01-12,"Slate River Rd","3","3","2",6.1,0,28,-1,21,21.8,0,-1,-2,0,-1,-2,-4,-4,"w1819","Mechanized",0,"Sat","weekend"
"5311",2019-01-12,"Slate River Rd","3","3","2",6.1,0,28,-1,21,21.8,0,-1,-2,0,-1,-2,-4,-4,"w1819","Motorized",14,"Sat","weekend"
"5312",2019-01-12,"Slate River Rd","3","3","2",6.1,0,28,-1,21,21.8,0,-1,-2,0,-1,-2,-4,-4,"w1819","Hybrid",14,"Sat","weekend"
"5313",2019-01-13,"Slate River Rd","2","2","2",6.2,0.1,30,2,18,20.7,-1,0,-1,-2,1,1,0,-2,"w1819","Non.motorized",23,"Sun","weekend"
"5314",2019-01-13,"Slate River Rd","2","2","2",6.2,0.1,30,2,18,20.7,-1,0,-1,-2,1,1,0,-2,"w1819","Mechanized",0,"Sun","weekend"
"5315",2019-01-13,"Slate River Rd","2","2","2",6.2,0.1,30,2,18,20.7,-1,0,-1,-2,1,1,0,-2,"w1819","Motorized",6,"Sun","weekend"
"5316",2019-01-13,"Slate River Rd","2","2","2",6.2,0.1,30,2,18,20.7,-1,0,-1,-2,1,1,0,-2,"w1819","Hybrid",6,"Sun","weekend"
"5317",2019-01-14,"Slate River Rd","2","2","2",6.2,0,30,0,18,20.7,2,-1,0,-1,2,1,1,0,"w1819","Non.motorized",22,"Mon","weekday"
"5318",2019-01-14,"Slate River Rd","2","2","2",6.2,0,30,0,18,20.7,2,-1,0,-1,2,1,1,0,"w1819","Mechanized",0,"Mon","weekday"
"5319",2019-01-14,"Slate River Rd","2","2","2",6.2,0,30,0,18,20.7,2,-1,0,-1,2,1,1,0,"w1819","Motorized",9,"Mon","weekday"
"5320",2019-01-14,"Slate River Rd","2","2","2",6.2,0,30,0,18,20.7,2,-1,0,-1,2,1,1,0,"w1819","Hybrid",8,"Mon","weekday"
"5321",2019-01-15,"Slate River Rd","2","2","2",6.2,0,29,-1,24,21.4,0,2,-1,0,-1,1,0,0,"w1819","Non.motorized",18,"Tue","weekday"
"5322",2019-01-15,"Slate River Rd","2","2","2",6.2,0,29,-1,24,21.4,0,2,-1,0,-1,1,0,0,"w1819","Mechanized",0,"Tue","weekday"
"5323",2019-01-15,"Slate River Rd","2","2","2",6.2,0,29,-1,24,21.4,0,2,-1,0,-1,1,0,0,"w1819","Motorized",4,"Tue","weekday"
"5324",2019-01-15,"Slate River Rd","2","2","2",6.2,0,29,-1,24,21.4,0,2,-1,0,-1,1,0,0,"w1819","Hybrid",4,"Tue","weekday"
"5325",2019-01-16,"Slate River Rd","4","4","3",6.3,0.1,29,0,26,21.7,-1,0,2,-1,-1,-1,1,0,"w1819","Non.motorized",3,"Wed","weekday"
"5326",2019-01-16,"Slate River Rd","4","4","3",6.3,0.1,29,0,26,21.7,-1,0,2,-1,-1,-1,1,0,"w1819","Mechanized",0,"Wed","weekday"
"5327",2019-01-16,"Slate River Rd","4","4","3",6.3,0.1,29,0,26,21.7,-1,0,2,-1,-1,-1,1,0,"w1819","Motorized",0,"Wed","weekday"
"5328",2019-01-16,"Slate River Rd","4","4","3",6.3,0.1,29,0,26,21.7,-1,0,2,-1,-1,-1,1,0,"w1819","Hybrid",0,"Wed","weekday"
"5329",2019-01-17,"Slate River Rd","3","3","2",7,0.7,38,9,28,18.4,0,-1,0,2,9,8,8,10,"w1819","Non.motorized",8,"Thu","weekday"
"5330",2019-01-17,"Slate River Rd","3","3","2",7,0.7,38,9,28,18.4,0,-1,0,2,9,8,8,10,"w1819","Mechanized",0,"Thu","weekday"
"5331",2019-01-17,"Slate River Rd","3","3","2",7,0.7,38,9,28,18.4,0,-1,0,2,9,8,8,10,"w1819","Motorized",4,"Thu","weekday"
"5332",2019-01-17,"Slate River Rd","3","3","2",7,0.7,38,9,28,18.4,0,-1,0,2,9,8,8,10,"w1819","Hybrid",3,"Thu","weekday"
"5333",2019-01-18,"Slate River Rd","4","4","4",7.5,0.5,41,3,22,18.3,9,0,-1,0,12,12,11,11,"w1819","Non.motorized",10,"Fri","weekday"
"5334",2019-01-18,"Slate River Rd","4","4","4",7.5,0.5,41,3,22,18.3,9,0,-1,0,12,12,11,11,"w1819","Mechanized",0,"Fri","weekday"
"5335",2019-01-18,"Slate River Rd","4","4","4",7.5,0.5,41,3,22,18.3,9,0,-1,0,12,12,11,11,"w1819","Motorized",1,"Fri","weekday"
"5336",2019-01-18,"Slate River Rd","4","4","4",7.5,0.5,41,3,22,18.3,9,0,-1,0,12,12,11,11,"w1819","Hybrid",1,"Fri","weekday"
"5337",2019-01-19,"Slate River Rd","3","3","3",7.8,0.3,43,2,20,18.1,3,9,0,-1,5,14,14,13,"w1819","Non.motorized",0,"Sat","weekend"
"5338",2019-01-19,"Slate River Rd","3","3","3",7.8,0.3,43,2,20,18.1,3,9,0,-1,5,14,14,13,"w1819","Mechanized",0,"Sat","weekend"
"5339",2019-01-19,"Slate River Rd","3","3","3",7.8,0.3,43,2,20,18.1,3,9,0,-1,5,14,14,13,"w1819","Motorized",0,"Sat","weekend"
"5340",2019-01-19,"Slate River Rd","3","3","3",7.8,0.3,43,2,20,18.1,3,9,0,-1,5,14,14,13,"w1819","Hybrid",0,"Sat","weekend"
"5341",2019-01-20,"Slate River Rd","3","3","3",7.9,0.1,41,-2,27,19.3,2,3,9,0,0,3,12,12,"w1819","Non.motorized",0,"Sun","weekend"
"5342",2019-01-20,"Slate River Rd","3","3","3",7.9,0.1,41,-2,27,19.3,2,3,9,0,0,3,12,12,"w1819","Mechanized",0,"Sun","weekend"
"5343",2019-01-20,"Slate River Rd","3","3","3",7.9,0.1,41,-2,27,19.3,2,3,9,0,0,3,12,12,"w1819","Motorized",0,"Sun","weekend"
"5344",2019-01-20,"Slate River Rd","3","3","3",7.9,0.1,41,-2,27,19.3,2,3,9,0,0,3,12,12,"w1819","Hybrid",0,"Sun","weekend"
"5345",2019-01-21,"Slate River Rd","3","3","3",7.9,0,39,-2,23,20.3,-2,2,3,9,-4,-2,1,10,"w1819","Non.motorized",1,"Mon","weekday"
"5346",2019-01-21,"Slate River Rd","3","3","3",7.9,0,39,-2,23,20.3,-2,2,3,9,-4,-2,1,10,"w1819","Mechanized",0,"Mon","weekday"
"5347",2019-01-21,"Slate River Rd","3","3","3",7.9,0,39,-2,23,20.3,-2,2,3,9,-4,-2,1,10,"w1819","Motorized",2,"Mon","weekday"
"5348",2019-01-21,"Slate River Rd","3","3","3",7.9,0,39,-2,23,20.3,-2,2,3,9,-4,-2,1,10,"w1819","Hybrid",0,"Mon","weekday"
"5349",2019-01-22,"Slate River Rd","3","3","3",8,0.1,41,2,12,19.5,-2,-2,2,3,0,-2,0,3,"w1819","Non.motorized",28,"Tue","weekday"
"5350",2019-01-22,"Slate River Rd","3","3","3",8,0.1,41,2,12,19.5,-2,-2,2,3,0,-2,0,3,"w1819","Mechanized",0,"Tue","weekday"
"5351",2019-01-22,"Slate River Rd","3","3","3",8,0.1,41,2,12,19.5,-2,-2,2,3,0,-2,0,3,"w1819","Motorized",4,"Tue","weekday"
"5352",2019-01-22,"Slate River Rd","3","3","3",8,0.1,41,2,12,19.5,-2,-2,2,3,0,-2,0,3,"w1819","Hybrid",0,"Tue","weekday"
"5353",2019-01-23,"Slate River Rd","3","3","2",8,0,40,-1,14,20,2,-2,-2,2,1,-1,-3,-1,"w1819","Non.motorized",9,"Wed","weekday"
"5354",2019-01-23,"Slate River Rd","3","3","2",8,0,40,-1,14,20,2,-2,-2,2,1,-1,-3,-1,"w1819","Mechanized",0,"Wed","weekday"
"5355",2019-01-23,"Slate River Rd","3","3","2",8,0,40,-1,14,20,2,-2,-2,2,1,-1,-3,-1,"w1819","Motorized",5,"Wed","weekday"
"5356",2019-01-23,"Slate River Rd","3","3","2",8,0,40,-1,14,20,2,-2,-2,2,1,-1,-3,-1,"w1819","Hybrid",0,"Wed","weekday"
"5357",2019-01-24,"Slate River Rd","3","3","2",8.2,0.2,40,0,17,20.5,-1,2,-2,-2,-1,1,-1,-3,"w1819","Non.motorized",21,"Thu","weekday"
"5358",2019-01-24,"Slate River Rd","3","3","2",8.2,0.2,40,0,17,20.5,-1,2,-2,-2,-1,1,-1,-3,"w1819","Mechanized",0,"Thu","weekday"
"5359",2019-01-24,"Slate River Rd","3","3","2",8.2,0.2,40,0,17,20.5,-1,2,-2,-2,-1,1,-1,-3,"w1819","Motorized",0,"Thu","weekday"
"5360",2019-01-24,"Slate River Rd","3","3","2",8.2,0.2,40,0,17,20.5,-1,2,-2,-2,-1,1,-1,-3,"w1819","Hybrid",0,"Thu","weekday"
"5361",2019-01-25,"Slate River Rd","3","3","2",8.3,0.1,40,0,15,20.8,0,-1,2,-2,0,-1,1,-1,"w1819","Non.motorized",28,"Fri","weekday"
"5362",2019-01-25,"Slate River Rd","3","3","2",8.3,0.1,40,0,15,20.8,0,-1,2,-2,0,-1,1,-1,"w1819","Mechanized",0,"Fri","weekday"
"5363",2019-01-25,"Slate River Rd","3","3","2",8.3,0.1,40,0,15,20.8,0,-1,2,-2,0,-1,1,-1,"w1819","Motorized",5,"Fri","weekday"
"5364",2019-01-25,"Slate River Rd","3","3","2",8.3,0.1,40,0,15,20.8,0,-1,2,-2,0,-1,1,-1,"w1819","Hybrid",0,"Fri","weekday"
"5365",2019-01-26,"Slate River Rd","3","3","2",8.3,0,39,-1,19,21.3,0,0,-1,2,-1,-1,-2,0,"w1819","Non.motorized",45,"Sat","weekend"
"5366",2019-01-26,"Slate River Rd","3","3","2",8.3,0,39,-1,19,21.3,0,0,-1,2,-1,-1,-2,0,"w1819","Mechanized",0,"Sat","weekend"
"5367",2019-01-26,"Slate River Rd","3","3","2",8.3,0,39,-1,19,21.3,0,0,-1,2,-1,-1,-2,0,"w1819","Motorized",13,"Sat","weekend"
"5368",2019-01-26,"Slate River Rd","3","3","2",8.3,0,39,-1,19,21.3,0,0,-1,2,-1,-1,-2,0,"w1819","Hybrid",13,"Sat","weekend"
"5369",2019-01-27,"Slate River Rd","3","3","2",8.3,0,38,-1,24,21.8,-1,0,0,-1,-2,-2,-2,-3,"w1819","Non.motorized",16,"Sun","weekend"
"5370",2019-01-27,"Slate River Rd","3","3","2",8.3,0,38,-1,24,21.8,-1,0,0,-1,-2,-2,-2,-3,"w1819","Mechanized",3,"Sun","weekend"
"5371",2019-01-27,"Slate River Rd","3","3","2",8.3,0,38,-1,24,21.8,-1,0,0,-1,-2,-2,-2,-3,"w1819","Motorized",5,"Sun","weekend"
"5372",2019-01-27,"Slate River Rd","3","3","2",8.3,0,38,-1,24,21.8,-1,0,0,-1,-2,-2,-2,-3,"w1819","Hybrid",5,"Sun","weekend"
"5373",2019-01-28,"Slate River Rd","2","2","2",8.3,0,38,0,17,21.8,-1,-1,0,0,-1,-2,-2,-2,"w1819","Non.motorized",2,"Mon","weekday"
"5374",2019-01-28,"Slate River Rd","2","2","2",8.3,0,38,0,17,21.8,-1,-1,0,0,-1,-2,-2,-2,"w1819","Mechanized",0,"Mon","weekday"
"5375",2019-01-28,"Slate River Rd","2","2","2",8.3,0,38,0,17,21.8,-1,-1,0,0,-1,-2,-2,-2,"w1819","Motorized",1,"Mon","weekday"
"5376",2019-01-28,"Slate River Rd","2","2","2",8.3,0,38,0,17,21.8,-1,-1,0,0,-1,-2,-2,-2,"w1819","Hybrid",1,"Mon","weekday"
"5377",2019-01-29,"Slate River Rd","2","2","2",8.3,0,38,0,16,21.8,0,-1,-1,0,0,-1,-2,-2,"w1819","Non.motorized",0,"Tue","weekday"
"5378",2019-01-29,"Slate River Rd","2","2","2",8.3,0,38,0,16,21.8,0,-1,-1,0,0,-1,-2,-2,"w1819","Mechanized",0,"Tue","weekday"
"5379",2019-01-29,"Slate River Rd","2","2","2",8.3,0,38,0,16,21.8,0,-1,-1,0,0,-1,-2,-2,"w1819","Motorized",0,"Tue","weekday"
"5380",2019-01-29,"Slate River Rd","2","2","2",8.3,0,38,0,16,21.8,0,-1,-1,0,0,-1,-2,-2,"w1819","Hybrid",0,"Tue","weekday"
"5381",2019-01-30,"Slate River Rd","2","2","1",8.3,0,37,-1,20,22.4,0,0,-1,-1,-1,-1,-2,-3,"w1819","Non.motorized",0,"Wed","weekday"
"5382",2019-01-30,"Slate River Rd","2","2","1",8.3,0,37,-1,20,22.4,0,0,-1,-1,-1,-1,-2,-3,"w1819","Mechanized",0,"Wed","weekday"
"5383",2019-01-30,"Slate River Rd","2","2","1",8.3,0,37,-1,20,22.4,0,0,-1,-1,-1,-1,-2,-3,"w1819","Motorized",0,"Wed","weekday"
"5384",2019-01-30,"Slate River Rd","2","2","1",8.3,0,37,-1,20,22.4,0,0,-1,-1,-1,-1,-2,-3,"w1819","Hybrid",0,"Wed","weekday"
"5385",2019-01-31,"Slate River Rd","2","2","1",8.3,0,36,-1,24,23.1,-1,0,0,-1,-2,-2,-2,-3,"w1819","Non.motorized",0,"Thu","weekday"
"5386",2019-01-31,"Slate River Rd","2","2","1",8.3,0,36,-1,24,23.1,-1,0,0,-1,-2,-2,-2,-3,"w1819","Mechanized",0,"Thu","weekday"
"5387",2019-01-31,"Slate River Rd","2","2","1",8.3,0,36,-1,24,23.1,-1,0,0,-1,-2,-2,-2,-3,"w1819","Motorized",0,"Thu","weekday"
"5388",2019-01-31,"Slate River Rd","2","2","1",8.3,0,36,-1,24,23.1,-1,0,0,-1,-2,-2,-2,-3,"w1819","Hybrid",0,"Thu","weekday"
"5389",2019-02-01,"Slate River Rd","2","2","1",8.3,0,36,0,25,23.1,-1,-1,0,0,-1,-2,-2,-2,"w1819","Non.motorized",12,"Fri","weekday"
"5390",2019-02-01,"Slate River Rd","2","2","1",8.3,0,36,0,25,23.1,-1,-1,0,0,-1,-2,-2,-2,"w1819","Mechanized",0,"Fri","weekday"
"5391",2019-02-01,"Slate River Rd","2","2","1",8.3,0,36,0,25,23.1,-1,-1,0,0,-1,-2,-2,-2,"w1819","Motorized",0,"Fri","weekday"
"5392",2019-02-01,"Slate River Rd","2","2","1",8.3,0,36,0,25,23.1,-1,-1,0,0,-1,-2,-2,-2,"w1819","Hybrid",0,"Fri","weekday"
"5393",2019-02-02,"Slate River Rd","2","2","1",8.3,0,36,0,26,23.1,0,-1,-1,0,0,-1,-2,-2,"w1819","Non.motorized",45,"Sat","weekend"
"5394",2019-02-02,"Slate River Rd","2","2","1",8.3,0,36,0,26,23.1,0,-1,-1,0,0,-1,-2,-2,"w1819","Mechanized",0,"Sat","weekend"
"5395",2019-02-02,"Slate River Rd","2","2","1",8.3,0,36,0,26,23.1,0,-1,-1,0,0,-1,-2,-2,"w1819","Motorized",15,"Sat","weekend"
"5396",2019-02-02,"Slate River Rd","2","2","1",8.3,0,36,0,26,23.1,0,-1,-1,0,0,-1,-2,-2,"w1819","Hybrid",11,"Sat","weekend"
"5397",2019-02-03,"Slate River Rd","3","3","2",8.4,0.1,36,0,28,23.3,0,0,-1,-1,0,0,-1,-2,"w1819","Non.motorized",11,"Sun","weekend"
"5398",2019-02-03,"Slate River Rd","3","3","2",8.4,0.1,36,0,28,23.3,0,0,-1,-1,0,0,-1,-2,"w1819","Mechanized",0,"Sun","weekend"
"5399",2019-02-03,"Slate River Rd","3","3","2",8.4,0.1,36,0,28,23.3,0,0,-1,-1,0,0,-1,-2,"w1819","Motorized",5,"Sun","weekend"
"5400",2019-02-03,"Slate River Rd","3","3","2",8.4,0.1,36,0,28,23.3,0,0,-1,-1,0,0,-1,-2,"w1819","Hybrid",5,"Sun","weekend"
"5401",2019-02-04,"Slate River Rd","3","3","2",8.8,0.4,39,3,28,22.6,0,0,0,-1,3,3,3,2,"w1819","Non.motorized",15,"Mon","weekday"
"5402",2019-02-04,"Slate River Rd","3","3","2",8.8,0.4,39,3,28,22.6,0,0,0,-1,3,3,3,2,"w1819","Mechanized",0,"Mon","weekday"
"5403",2019-02-04,"Slate River Rd","3","3","2",8.8,0.4,39,3,28,22.6,0,0,0,-1,3,3,3,2,"w1819","Motorized",3,"Mon","weekday"
"5404",2019-02-04,"Slate River Rd","3","3","2",8.8,0.4,39,3,28,22.6,0,0,0,-1,3,3,3,2,"w1819","Hybrid",3,"Mon","weekday"
"5405",2019-02-05,"Slate River Rd","3","2","2",9,0.2,40,1,26,22.5,3,0,0,0,4,4,4,4,"w1819","Non.motorized",15,"Tue","weekday"
"5406",2019-02-05,"Slate River Rd","3","2","2",9,0.2,40,1,26,22.5,3,0,0,0,4,4,4,4,"w1819","Mechanized",0,"Tue","weekday"
"5407",2019-02-05,"Slate River Rd","3","2","2",9,0.2,40,1,26,22.5,3,0,0,0,4,4,4,4,"w1819","Motorized",4,"Tue","weekday"
"5408",2019-02-05,"Slate River Rd","3","2","2",9,0.2,40,1,26,22.5,3,0,0,0,4,4,4,4,"w1819","Hybrid",4,"Tue","weekday"
"5409",2019-02-06,"Slate River Rd","4","4","3",9,0,40,0,16,22.5,1,3,0,0,1,4,4,4,"w1819","Non.motorized",3,"Wed","weekday"
"5410",2019-02-06,"Slate River Rd","4","4","3",9,0,40,0,16,22.5,1,3,0,0,1,4,4,4,"w1819","Mechanized",0,"Wed","weekday"
"5411",2019-02-06,"Slate River Rd","4","4","3",9,0,40,0,16,22.5,1,3,0,0,1,4,4,4,"w1819","Motorized",3,"Wed","weekday"
"5412",2019-02-06,"Slate River Rd","4","4","3",9,0,40,0,16,22.5,1,3,0,0,1,4,4,4,"w1819","Hybrid",3,"Wed","weekday"
"5413",2019-02-07,"Slate River Rd","3","3","2",9.2,0.2,43,3,4,21.4,0,1,3,0,3,4,7,7,"w1819","Non.motorized",0,"Thu","weekday"
"5414",2019-02-07,"Slate River Rd","3","3","2",9.2,0.2,43,3,4,21.4,0,1,3,0,3,4,7,7,"w1819","Mechanized",0,"Thu","weekday"
"5415",2019-02-07,"Slate River Rd","3","3","2",9.2,0.2,43,3,4,21.4,0,1,3,0,3,4,7,7,"w1819","Motorized",0,"Thu","weekday"
"5416",2019-02-07,"Slate River Rd","3","3","2",9.2,0.2,43,3,4,21.4,0,1,3,0,3,4,7,7,"w1819","Hybrid",0,"Thu","weekday"
"5417",2019-02-08,"Slate River Rd","3","2","2",9.2,0,42,-1,10,21.9,3,0,1,3,2,2,3,6,"w1819","Non.motorized",20,"Fri","weekday"
"5418",2019-02-08,"Slate River Rd","3","2","2",9.2,0,42,-1,10,21.9,3,0,1,3,2,2,3,6,"w1819","Mechanized",0,"Fri","weekday"
"5419",2019-02-08,"Slate River Rd","3","2","2",9.2,0,42,-1,10,21.9,3,0,1,3,2,2,3,6,"w1819","Motorized",4,"Fri","weekday"
"5420",2019-02-08,"Slate River Rd","3","2","2",9.2,0,42,-1,10,21.9,3,0,1,3,2,2,3,6,"w1819","Hybrid",4,"Fri","weekday"
"5421",2019-02-09,"Slate River Rd","3","2","2",9.2,0,41,-1,20,22.4,-1,3,0,1,-2,1,1,2,"w1819","Non.motorized",38,"Sat","weekend"
"5422",2019-02-09,"Slate River Rd","3","2","2",9.2,0,41,-1,20,22.4,-1,3,0,1,-2,1,1,2,"w1819","Mechanized",0,"Sat","weekend"
"5423",2019-02-09,"Slate River Rd","3","2","2",9.2,0,41,-1,20,22.4,-1,3,0,1,-2,1,1,2,"w1819","Motorized",13,"Sat","weekend"
"5424",2019-02-09,"Slate River Rd","3","2","2",9.2,0,41,-1,20,22.4,-1,3,0,1,-2,1,1,2,"w1819","Hybrid",10,"Sat","weekend"
"5425",2019-02-10,"Slate River Rd","2","2","2",9.3,0.1,40,-1,20,23.2,-1,-1,3,0,-2,-3,0,0,"w1819","Non.motorized",35,"Sun","weekend"
"5426",2019-02-10,"Slate River Rd","2","2","2",9.3,0.1,40,-1,20,23.2,-1,-1,3,0,-2,-3,0,0,"w1819","Mechanized",0,"Sun","weekend"
"5427",2019-02-10,"Slate River Rd","2","2","2",9.3,0.1,40,-1,20,23.2,-1,-1,3,0,-2,-3,0,0,"w1819","Motorized",19,"Sun","weekend"
"5428",2019-02-10,"Slate River Rd","2","2","2",9.3,0.1,40,-1,20,23.2,-1,-1,3,0,-2,-3,0,0,"w1819","Hybrid",17,"Sun","weekend"
"5429",2019-02-11,"Slate River Rd","2","2","1",9.3,0,40,0,15,23.2,-1,-1,-1,3,-1,-2,-3,0,"w1819","Non.motorized",13,"Mon","weekday"
"5430",2019-02-11,"Slate River Rd","2","2","1",9.3,0,40,0,15,23.2,-1,-1,-1,3,-1,-2,-3,0,"w1819","Mechanized",1,"Mon","weekday"
"5431",2019-02-11,"Slate River Rd","2","2","1",9.3,0,40,0,15,23.2,-1,-1,-1,3,-1,-2,-3,0,"w1819","Motorized",1,"Mon","weekday"
"5432",2019-02-11,"Slate River Rd","2","2","1",9.3,0,40,0,15,23.2,-1,-1,-1,3,-1,-2,-3,0,"w1819","Hybrid",1,"Mon","weekday"
"5433",2019-02-12,"Slate River Rd","2","2","1",9.3,0,40,0,18,23.2,0,-1,-1,-1,0,-1,-2,-3,"w1819","Non.motorized",18,"Tue","weekday"
"5434",2019-02-12,"Slate River Rd","2","2","1",9.3,0,40,0,18,23.2,0,-1,-1,-1,0,-1,-2,-3,"w1819","Mechanized",0,"Tue","weekday"
"5435",2019-02-12,"Slate River Rd","2","2","1",9.3,0,40,0,18,23.2,0,-1,-1,-1,0,-1,-2,-3,"w1819","Motorized",3,"Tue","weekday"
"5436",2019-02-12,"Slate River Rd","2","2","1",9.3,0,40,0,18,23.2,0,-1,-1,-1,0,-1,-2,-3,"w1819","Hybrid",0,"Tue","weekday"
"5437",2019-02-13,"Slate River Rd","2","2","1",9.4,0.1,40,0,26,23.5,0,0,-1,-1,0,0,-1,-2,"w1819","Non.motorized",21,"Wed","weekday"
"5438",2019-02-13,"Slate River Rd","2","2","1",9.4,0.1,40,0,26,23.5,0,0,-1,-1,0,0,-1,-2,"w1819","Mechanized",0,"Wed","weekday"
"5439",2019-02-13,"Slate River Rd","2","2","1",9.4,0.1,40,0,26,23.5,0,0,-1,-1,0,0,-1,-2,"w1819","Motorized",8,"Wed","weekday"
"5440",2019-02-13,"Slate River Rd","2","2","1",9.4,0.1,40,0,26,23.5,0,0,-1,-1,0,0,-1,-2,"w1819","Hybrid",0,"Wed","weekday"
"5441",2019-02-14,"Slate River Rd","3","2","2",9.7,0.3,41,1,29,23.7,0,0,0,-1,1,1,1,0,"w1819","Non.motorized",16,"Thu","weekday"
"5442",2019-02-14,"Slate River Rd","3","2","2",9.7,0.3,41,1,29,23.7,0,0,0,-1,1,1,1,0,"w1819","Mechanized",0,"Thu","weekday"
"5443",2019-02-14,"Slate River Rd","3","2","2",9.7,0.3,41,1,29,23.7,0,0,0,-1,1,1,1,0,"w1819","Motorized",3,"Thu","weekday"
"5444",2019-02-14,"Slate River Rd","3","2","2",9.7,0.3,41,1,29,23.7,0,0,0,-1,1,1,1,0,"w1819","Hybrid",0,"Thu","weekday"
"5445",2019-02-15,"Slate River Rd","4","4","3",10.8,1.1,51,10,27,21.2,1,0,0,0,11,11,11,11,"w1819","Non.motorized",6,"Fri","weekday"
"5446",2019-02-15,"Slate River Rd","4","4","3",10.8,1.1,51,10,27,21.2,1,0,0,0,11,11,11,11,"w1819","Mechanized",0,"Fri","weekday"
"5447",2019-02-15,"Slate River Rd","4","4","3",10.8,1.1,51,10,27,21.2,1,0,0,0,11,11,11,11,"w1819","Motorized",0,"Fri","weekday"
"5448",2019-02-15,"Slate River Rd","4","4","3",10.8,1.1,51,10,27,21.2,1,0,0,0,11,11,11,11,"w1819","Hybrid",0,"Fri","weekday"
"5449",2019-02-16,"Slate River Rd","3","3","3",11.1,0.3,52,1,14,21.3,10,1,0,0,11,12,12,12,"w1819","Non.motorized",0,"Sat","weekend"
"5450",2019-02-16,"Slate River Rd","3","3","3",11.1,0.3,52,1,14,21.3,10,1,0,0,11,12,12,12,"w1819","Mechanized",0,"Sat","weekend"
"5451",2019-02-16,"Slate River Rd","3","3","3",11.1,0.3,52,1,14,21.3,10,1,0,0,11,12,12,12,"w1819","Motorized",0,"Sat","weekend"
"5452",2019-02-16,"Slate River Rd","3","3","3",11.1,0.3,52,1,14,21.3,10,1,0,0,11,12,12,12,"w1819","Hybrid",0,"Sat","weekend"
"5453",2019-02-17,"Slate River Rd","3","3","3",11.3,0.2,55,3,10,20.5,1,10,1,0,4,14,15,15,"w1819","Non.motorized",0,"Sun","weekend"
"5454",2019-02-17,"Slate River Rd","3","3","3",11.3,0.2,55,3,10,20.5,1,10,1,0,4,14,15,15,"w1819","Mechanized",0,"Sun","weekend"
"5455",2019-02-17,"Slate River Rd","3","3","3",11.3,0.2,55,3,10,20.5,1,10,1,0,4,14,15,15,"w1819","Motorized",0,"Sun","weekend"
"5456",2019-02-17,"Slate River Rd","3","3","3",11.3,0.2,55,3,10,20.5,1,10,1,0,4,14,15,15,"w1819","Hybrid",0,"Sun","weekend"
"5457",2019-02-18,"Slate River Rd","3","3","2",11.4,0.1,53,-2,13,21.5,3,1,10,1,1,2,12,13,"w1819","Non.motorized",0,"Mon","weekday"
"5458",2019-02-18,"Slate River Rd","3","3","2",11.4,0.1,53,-2,13,21.5,3,1,10,1,1,2,12,13,"w1819","Mechanized",0,"Mon","weekday"
"5459",2019-02-18,"Slate River Rd","3","3","2",11.4,0.1,53,-2,13,21.5,3,1,10,1,1,2,12,13,"w1819","Motorized",0,"Mon","weekday"
"5460",2019-02-18,"Slate River Rd","3","3","2",11.4,0.1,53,-2,13,21.5,3,1,10,1,1,2,12,13,"w1819","Hybrid",0,"Mon","weekday"
"5461",2019-02-19,"Slate River Rd","3","3","2",11.5,0.1,53,0,11,21.7,-2,3,1,10,-2,1,2,12,"w1819","Non.motorized",0,"Tue","weekday"
"5462",2019-02-19,"Slate River Rd","3","3","2",11.5,0.1,53,0,11,21.7,-2,3,1,10,-2,1,2,12,"w1819","Mechanized",0,"Tue","weekday"
"5463",2019-02-19,"Slate River Rd","3","3","2",11.5,0.1,53,0,11,21.7,-2,3,1,10,-2,1,2,12,"w1819","Motorized",0,"Tue","weekday"
"5464",2019-02-19,"Slate River Rd","3","3","2",11.5,0.1,53,0,11,21.7,-2,3,1,10,-2,1,2,12,"w1819","Hybrid",0,"Tue","weekday"
"5465",2019-02-20,"Slate River Rd","3","3","2",11.6,0.1,53,0,7,21.9,0,-2,3,1,0,-2,1,2,"w1819","Non.motorized",0,"Wed","weekday"
"5466",2019-02-20,"Slate River Rd","3","3","2",11.6,0.1,53,0,7,21.9,0,-2,3,1,0,-2,1,2,"w1819","Mechanized",0,"Wed","weekday"
"5467",2019-02-20,"Slate River Rd","3","3","2",11.6,0.1,53,0,7,21.9,0,-2,3,1,0,-2,1,2,"w1819","Motorized",0,"Wed","weekday"
"5468",2019-02-20,"Slate River Rd","3","3","2",11.6,0.1,53,0,7,21.9,0,-2,3,1,0,-2,1,2,"w1819","Hybrid",0,"Wed","weekday"
"5469",2019-02-21,"Slate River Rd","3","3","3",11.6,0,52,-1,15,22.3,0,0,-2,3,-1,-1,-3,0,"w1819","Non.motorized",0,"Thu","weekday"
"5470",2019-02-21,"Slate River Rd","3","3","3",11.6,0,52,-1,15,22.3,0,0,-2,3,-1,-1,-3,0,"w1819","Mechanized",0,"Thu","weekday"
"5471",2019-02-21,"Slate River Rd","3","3","3",11.6,0,52,-1,15,22.3,0,0,-2,3,-1,-1,-3,0,"w1819","Motorized",0,"Thu","weekday"
"5472",2019-02-21,"Slate River Rd","3","3","3",11.6,0,52,-1,15,22.3,0,0,-2,3,-1,-1,-3,0,"w1819","Hybrid",0,"Thu","weekday"
"5473",2019-02-22,"Slate River Rd","3","3","3",11.8,0.2,52,0,20,22.7,-1,0,0,-2,-1,-1,-1,-3,"w1819","Non.motorized",3,"Fri","weekday"
"5474",2019-02-22,"Slate River Rd","3","3","3",11.8,0.2,52,0,20,22.7,-1,0,0,-2,-1,-1,-1,-3,"w1819","Mechanized",0,"Fri","weekday"
"5475",2019-02-22,"Slate River Rd","3","3","3",11.8,0.2,52,0,20,22.7,-1,0,0,-2,-1,-1,-1,-3,"w1819","Motorized",5,"Fri","weekday"
"5476",2019-02-22,"Slate River Rd","3","3","3",11.8,0.2,52,0,20,22.7,-1,0,0,-2,-1,-1,-1,-3,"w1819","Hybrid",5,"Fri","weekday"
"5477",2019-02-23,"Slate River Rd","3","3","3",12.1,0.3,53,1,13,22.8,0,-1,0,0,1,0,0,0,"w1819","Non.motorized",38,"Sat","weekend"
"5478",2019-02-23,"Slate River Rd","3","3","3",12.1,0.3,53,1,13,22.8,0,-1,0,0,1,0,0,0,"w1819","Mechanized",3,"Sat","weekend"
"5479",2019-02-23,"Slate River Rd","3","3","3",12.1,0.3,53,1,13,22.8,0,-1,0,0,1,0,0,0,"w1819","Motorized",9,"Sat","weekend"
"5480",2019-02-23,"Slate River Rd","3","3","3",12.1,0.3,53,1,13,22.8,0,-1,0,0,1,0,0,0,"w1819","Hybrid",9,"Sat","weekend"
"5481",2019-02-24,"Slate River Rd","3","3","2",12.1,0,52,-1,14,23.3,1,0,-1,0,0,0,-1,-1,"w1819","Non.motorized",22,"Sun","weekend"
"5482",2019-02-24,"Slate River Rd","3","3","2",12.1,0,52,-1,14,23.3,1,0,-1,0,0,0,-1,-1,"w1819","Mechanized",0,"Sun","weekend"
"5483",2019-02-24,"Slate River Rd","3","3","2",12.1,0,52,-1,14,23.3,1,0,-1,0,0,0,-1,-1,"w1819","Motorized",7,"Sun","weekend"
"5484",2019-02-24,"Slate River Rd","3","3","2",12.1,0,52,-1,14,23.3,1,0,-1,0,0,0,-1,-1,"w1819","Hybrid",7,"Sun","weekend"
"5485",2019-02-25,"Slate River Rd","3","3","2",12.1,0,51,-1,22,23.7,-1,1,0,-1,-2,-1,-1,-2,"w1819","Non.motorized",12,"Mon","weekday"
"5486",2019-02-25,"Slate River Rd","3","3","2",12.1,0,51,-1,22,23.7,-1,1,0,-1,-2,-1,-1,-2,"w1819","Mechanized",0,"Mon","weekday"
"5487",2019-02-25,"Slate River Rd","3","3","2",12.1,0,51,-1,22,23.7,-1,1,0,-1,-2,-1,-1,-2,"w1819","Motorized",0,"Mon","weekday"
"5488",2019-02-25,"Slate River Rd","3","3","2",12.1,0,51,-1,22,23.7,-1,1,0,-1,-2,-1,-1,-2,"w1819","Hybrid",0,"Mon","weekday"
"5489",2019-02-26,"Slate River Rd","2","2","2",12.1,0,50,-1,27,24.2,-1,-1,1,0,-2,-3,-2,-2,"w1819","Non.motorized",30,"Tue","weekday"
"5490",2019-02-26,"Slate River Rd","2","2","2",12.1,0,50,-1,27,24.2,-1,-1,1,0,-2,-3,-2,-2,"w1819","Mechanized",0,"Tue","weekday"
"5491",2019-02-26,"Slate River Rd","2","2","2",12.1,0,50,-1,27,24.2,-1,-1,1,0,-2,-3,-2,-2,"w1819","Motorized",8,"Tue","weekday"
"5492",2019-02-26,"Slate River Rd","2","2","2",12.1,0,50,-1,27,24.2,-1,-1,1,0,-2,-3,-2,-2,"w1819","Hybrid",7,"Tue","weekday"
"5493",2019-02-27,"Slate River Rd","2","2","2",12.1,0,50,0,30,24.2,-1,-1,-1,1,-1,-2,-3,-2,"w1819","Non.motorized",20,"Wed","weekday"
"5494",2019-02-27,"Slate River Rd","2","2","2",12.1,0,50,0,30,24.2,-1,-1,-1,1,-1,-2,-3,-2,"w1819","Mechanized",0,"Wed","weekday"
"5495",2019-02-27,"Slate River Rd","2","2","2",12.1,0,50,0,30,24.2,-1,-1,-1,1,-1,-2,-3,-2,"w1819","Motorized",4,"Wed","weekday"
"5496",2019-02-27,"Slate River Rd","2","2","2",12.1,0,50,0,30,24.2,-1,-1,-1,1,-1,-2,-3,-2,"w1819","Hybrid",4,"Wed","weekday"
"5497",2019-02-28,"Slate River Rd","2","2","2",12.2,0.1,49,-1,30,24.9,0,-1,-1,-1,-1,-2,-3,-4,"w1819","Non.motorized",20,"Thu","weekday"
"5498",2019-02-28,"Slate River Rd","2","2","2",12.2,0.1,49,-1,30,24.9,0,-1,-1,-1,-1,-2,-3,-4,"w1819","Mechanized",0,"Thu","weekday"
"5499",2019-02-28,"Slate River Rd","2","2","2",12.2,0.1,49,-1,30,24.9,0,-1,-1,-1,-1,-2,-3,-4,"w1819","Motorized",2,"Thu","weekday"
"5500",2019-02-28,"Slate River Rd","2","2","2",12.2,0.1,49,-1,30,24.9,0,-1,-1,-1,-1,-2,-3,-4,"w1819","Hybrid",2,"Thu","weekday"
"5501",2019-03-01,"Slate River Rd","2","2","1",12.3,0.1,49,0,29,25.1,-1,0,-1,-1,-1,-1,-2,-3,"w1819","Non.motorized",13,"Fri","weekday"
"5502",2019-03-01,"Slate River Rd","2","2","1",12.3,0.1,49,0,29,25.1,-1,0,-1,-1,-1,-1,-2,-3,"w1819","Mechanized",0,"Fri","weekday"
"5503",2019-03-01,"Slate River Rd","2","2","1",12.3,0.1,49,0,29,25.1,-1,0,-1,-1,-1,-1,-2,-3,"w1819","Motorized",1,"Fri","weekday"
"5504",2019-03-01,"Slate River Rd","2","2","1",12.3,0.1,49,0,29,25.1,-1,0,-1,-1,-1,-1,-2,-3,"w1819","Hybrid",0,"Fri","weekday"
"5505",2019-03-02,"Slate River Rd","3","3","2",13,0.7,58,9,30,22.4,0,-1,0,-1,9,8,8,7,"w1819","Non.motorized",11,"Sat","weekend"
"5506",2019-03-02,"Slate River Rd","3","3","2",13,0.7,58,9,30,22.4,0,-1,0,-1,9,8,8,7,"w1819","Mechanized",0,"Sat","weekend"
"5507",2019-03-02,"Slate River Rd","3","3","2",13,0.7,58,9,30,22.4,0,-1,0,-1,9,8,8,7,"w1819","Motorized",5,"Sat","weekend"
"5508",2019-03-02,"Slate River Rd","3","3","2",13,0.7,58,9,30,22.4,0,-1,0,-1,9,8,8,7,"w1819","Hybrid",4,"Sat","weekend"
"5509",2019-03-03,"Slate River Rd","3","3","3",13.7,0.7,64,6,27,21.4,9,0,-1,0,15,15,14,14,"w1819","Non.motorized",5,"Sun","weekend"
"5510",2019-03-03,"Slate River Rd","3","3","3",13.7,0.7,64,6,27,21.4,9,0,-1,0,15,15,14,14,"w1819","Mechanized",0,"Sun","weekend"
"5511",2019-03-03,"Slate River Rd","3","3","3",13.7,0.7,64,6,27,21.4,9,0,-1,0,15,15,14,14,"w1819","Motorized",0,"Sun","weekend"
"5512",2019-03-03,"Slate River Rd","3","3","3",13.7,0.7,64,6,27,21.4,9,0,-1,0,15,15,14,14,"w1819","Hybrid",0,"Sun","weekend"
"5513",2019-03-04,"Slate River Rd","3","3","3",14.4,0.7,66,2,23,21.8,6,9,0,-1,8,17,17,16,"w1819","Non.motorized",9,"Mon","weekday"
"5514",2019-03-04,"Slate River Rd","3","3","3",14.4,0.7,66,2,23,21.8,6,9,0,-1,8,17,17,16,"w1819","Mechanized",0,"Mon","weekday"
"5515",2019-03-04,"Slate River Rd","3","3","3",14.4,0.7,66,2,23,21.8,6,9,0,-1,8,17,17,16,"w1819","Motorized",0,"Mon","weekday"
"5516",2019-03-04,"Slate River Rd","3","3","3",14.4,0.7,66,2,23,21.8,6,9,0,-1,8,17,17,16,"w1819","Hybrid",0,"Mon","weekday"
"5517",2019-03-05,"Slate River Rd","3","3","3",14.4,0,64,-2,24,22.5,2,6,9,0,0,6,15,15,"w1819","Non.motorized",4,"Tue","weekday"
"5518",2019-03-05,"Slate River Rd","3","3","3",14.4,0,64,-2,24,22.5,2,6,9,0,0,6,15,15,"w1819","Mechanized",0,"Tue","weekday"
"5519",2019-03-05,"Slate River Rd","3","3","3",14.4,0,64,-2,24,22.5,2,6,9,0,0,6,15,15,"w1819","Motorized",0,"Tue","weekday"
"5520",2019-03-05,"Slate River Rd","3","3","3",14.4,0,64,-2,24,22.5,2,6,9,0,0,6,15,15,"w1819","Hybrid",0,"Tue","weekday"
"5521",2019-03-06,"Slate River Rd","3","3","2",14.5,0.1,62,-2,31,23.4,-2,2,6,9,-4,-2,4,13,"w1819","Non.motorized",5,"Wed","weekday"
"5522",2019-03-06,"Slate River Rd","3","3","2",14.5,0.1,62,-2,31,23.4,-2,2,6,9,-4,-2,4,13,"w1819","Mechanized",0,"Wed","weekday"
"5523",2019-03-06,"Slate River Rd","3","3","2",14.5,0.1,62,-2,31,23.4,-2,2,6,9,-4,-2,4,13,"w1819","Motorized",0,"Wed","weekday"
"5524",2019-03-06,"Slate River Rd","3","3","2",14.5,0.1,62,-2,31,23.4,-2,2,6,9,-4,-2,4,13,"w1819","Hybrid",0,"Wed","weekday"
"5525",2019-03-06,"Slate River Rd","4","4","3",14.5,0.1,62,-2,31,23.4,-2,2,6,9,-4,-2,4,13,"w1819","Non.motorized",5,"Wed","weekday"
"5526",2019-03-06,"Slate River Rd","4","4","3",14.5,0.1,62,-2,31,23.4,-2,2,6,9,-4,-2,4,13,"w1819","Mechanized",0,"Wed","weekday"
"5527",2019-03-06,"Slate River Rd","4","4","3",14.5,0.1,62,-2,31,23.4,-2,2,6,9,-4,-2,4,13,"w1819","Motorized",0,"Wed","weekday"
"5528",2019-03-06,"Slate River Rd","4","4","3",14.5,0.1,62,-2,31,23.4,-2,2,6,9,-4,-2,4,13,"w1819","Hybrid",0,"Wed","weekday"
"5529",2019-03-07,"Slate River Rd","4","4","3",16.2,1.7,71,9,30,22.8,-2,-2,2,6,7,5,7,13,"w1819","Non.motorized",5,"Thu","weekday"
"5530",2019-03-07,"Slate River Rd","4","4","3",16.2,1.7,71,9,30,22.8,-2,-2,2,6,7,5,7,13,"w1819","Mechanized",0,"Thu","weekday"
"5531",2019-03-07,"Slate River Rd","4","4","3",16.2,1.7,71,9,30,22.8,-2,-2,2,6,7,5,7,13,"w1819","Motorized",0,"Thu","weekday"
"5532",2019-03-07,"Slate River Rd","4","4","3",16.2,1.7,71,9,30,22.8,-2,-2,2,6,7,5,7,13,"w1819","Hybrid",0,"Thu","weekday"
"5533",2019-03-08,"Slate River Rd","3","3","3",16.6,0.4,71,0,27,23.4,9,-2,-2,2,9,7,5,7,"w1819","Non.motorized",3,"Fri","weekday"
"5534",2019-03-08,"Slate River Rd","3","3","3",16.6,0.4,71,0,27,23.4,9,-2,-2,2,9,7,5,7,"w1819","Mechanized",0,"Fri","weekday"
"5535",2019-03-08,"Slate River Rd","3","3","3",16.6,0.4,71,0,27,23.4,9,-2,-2,2,9,7,5,7,"w1819","Motorized",0,"Fri","weekday"
"5536",2019-03-08,"Slate River Rd","3","3","3",16.6,0.4,71,0,27,23.4,9,-2,-2,2,9,7,5,7,"w1819","Hybrid",0,"Fri","weekday"
"5537",2019-03-09,"Slate River Rd","4","4","3",17.2,0.6,76,5,22,22.6,0,9,-2,-2,5,14,12,10,"w1819","Non.motorized",12,"Sat","weekend"
"5538",2019-03-09,"Slate River Rd","4","4","3",17.2,0.6,76,5,22,22.6,0,9,-2,-2,5,14,12,10,"w1819","Mechanized",0,"Sat","weekend"
"5539",2019-03-09,"Slate River Rd","4","4","3",17.2,0.6,76,5,22,22.6,0,9,-2,-2,5,14,12,10,"w1819","Motorized",0,"Sat","weekend"
"5540",2019-03-09,"Slate River Rd","4","4","3",17.2,0.6,76,5,22,22.6,0,9,-2,-2,5,14,12,10,"w1819","Hybrid",0,"Sat","weekend"
"5541",2019-03-10,"Slate River Rd","3","3","3",17.3,0.1,73,-3,25,23.7,5,0,9,-2,2,2,11,9,"w1819","Non.motorized",18,"Sun","weekend"
"5542",2019-03-10,"Slate River Rd","3","3","3",17.3,0.1,73,-3,25,23.7,5,0,9,-2,2,2,11,9,"w1819","Mechanized",0,"Sun","weekend"
"5543",2019-03-10,"Slate River Rd","3","3","3",17.3,0.1,73,-3,25,23.7,5,0,9,-2,2,2,11,9,"w1819","Motorized",0,"Sun","weekend"
"5544",2019-03-10,"Slate River Rd","3","3","3",17.3,0.1,73,-3,25,23.7,5,0,9,-2,2,2,11,9,"w1819","Hybrid",0,"Sun","weekend"
"5545",2019-03-11,"Slate River Rd","3","3","2",17.3,0,71,-2,29,24.4,-3,5,0,9,-5,0,0,9,"w1819","Non.motorized",6,"Mon","weekday"
"5546",2019-03-11,"Slate River Rd","3","3","2",17.3,0,71,-2,29,24.4,-3,5,0,9,-5,0,0,9,"w1819","Mechanized",0,"Mon","weekday"
"5547",2019-03-11,"Slate River Rd","3","3","2",17.3,0,71,-2,29,24.4,-3,5,0,9,-5,0,0,9,"w1819","Motorized",0,"Mon","weekday"
"5548",2019-03-11,"Slate River Rd","3","3","2",17.3,0,71,-2,29,24.4,-3,5,0,9,-5,0,0,9,"w1819","Hybrid",0,"Mon","weekday"
"5549",2019-03-12,"Slate River Rd","3","3","3",17.4,0.1,70,-1,32,24.9,-2,-3,5,0,-3,-6,-1,-1,"w1819","Non.motorized",27,"Tue","weekday"
"5550",2019-03-12,"Slate River Rd","3","3","3",17.4,0.1,70,-1,32,24.9,-2,-3,5,0,-3,-6,-1,-1,"w1819","Mechanized",0,"Tue","weekday"
"5551",2019-03-12,"Slate River Rd","3","3","3",17.4,0.1,70,-1,32,24.9,-2,-3,5,0,-3,-6,-1,-1,"w1819","Motorized",3,"Tue","weekday"
"5552",2019-03-12,"Slate River Rd","3","3","3",17.4,0.1,70,-1,32,24.9,-2,-3,5,0,-3,-6,-1,-1,"w1819","Hybrid",0,"Tue","weekday"
"5553",2019-03-12,"Slate River Rd","4","4","4",17.4,0.1,70,-1,32,24.9,-2,-3,5,0,-3,-6,-1,-1,"w1819","Non.motorized",27,"Tue","weekday"
"5554",2019-03-12,"Slate River Rd","4","4","4",17.4,0.1,70,-1,32,24.9,-2,-3,5,0,-3,-6,-1,-1,"w1819","Mechanized",0,"Tue","weekday"
"5555",2019-03-12,"Slate River Rd","4","4","4",17.4,0.1,70,-1,32,24.9,-2,-3,5,0,-3,-6,-1,-1,"w1819","Motorized",3,"Tue","weekday"
"5556",2019-03-12,"Slate River Rd","4","4","4",17.4,0.1,70,-1,32,24.9,-2,-3,5,0,-3,-6,-1,-1,"w1819","Hybrid",0,"Tue","weekday"
"5557",2019-03-13,"Slate River Rd","4","4","3",18.1,0.7,74,4,24,24.5,-1,-2,-3,5,3,1,-2,3,"w1819","Non.motorized",0,"Wed","weekday"
"5558",2019-03-13,"Slate River Rd","4","4","3",18.1,0.7,74,4,24,24.5,-1,-2,-3,5,3,1,-2,3,"w1819","Mechanized",0,"Wed","weekday"
"5559",2019-03-13,"Slate River Rd","4","4","3",18.1,0.7,74,4,24,24.5,-1,-2,-3,5,3,1,-2,3,"w1819","Motorized",0,"Wed","weekday"
"5560",2019-03-13,"Slate River Rd","4","4","3",18.1,0.7,74,4,24,24.5,-1,-2,-3,5,3,1,-2,3,"w1819","Hybrid",0,"Wed","weekday"
"5561",2019-03-14,"Slate River Rd","4","4","3",18.1,0,74,0,17,24.5,4,-1,-2,-3,4,3,1,-2,"w1819","Non.motorized",5,"Thu","weekday"
"5562",2019-03-14,"Slate River Rd","4","4","3",18.1,0,74,0,17,24.5,4,-1,-2,-3,4,3,1,-2,"w1819","Mechanized",0,"Thu","weekday"
"5563",2019-03-14,"Slate River Rd","4","4","3",18.1,0,74,0,17,24.5,4,-1,-2,-3,4,3,1,-2,"w1819","Motorized",0,"Thu","weekday"
"5564",2019-03-14,"Slate River Rd","4","4","3",18.1,0,74,0,17,24.5,4,-1,-2,-3,4,3,1,-2,"w1819","Hybrid",0,"Thu","weekday"
"5565",2019-03-15,"Slate River Rd","3","3","2",18.1,0,72,-2,18,25.1,0,4,-1,-2,-2,2,1,-1,"w1819","Non.motorized",7,"Fri","weekday"
"5566",2019-03-15,"Slate River Rd","3","3","2",18.1,0,72,-2,18,25.1,0,4,-1,-2,-2,2,1,-1,"w1819","Mechanized",0,"Fri","weekday"
"5567",2019-03-15,"Slate River Rd","3","3","2",18.1,0,72,-2,18,25.1,0,4,-1,-2,-2,2,1,-1,"w1819","Motorized",1,"Fri","weekday"
"5568",2019-03-15,"Slate River Rd","3","3","2",18.1,0,72,-2,18,25.1,0,4,-1,-2,-2,2,1,-1,"w1819","Hybrid",0,"Fri","weekday"
"5569",2019-03-16,"Slate River Rd","3","3","2",18.2,0.1,70,-2,26,26,-2,0,4,-1,-4,-4,0,-1,"w1819","Non.motorized",33,"Sat","weekend"
"5570",2019-03-16,"Slate River Rd","3","3","2",18.2,0.1,70,-2,26,26,-2,0,4,-1,-4,-4,0,-1,"w1819","Mechanized",0,"Sat","weekend"
"5571",2019-03-16,"Slate River Rd","3","3","2",18.2,0.1,70,-2,26,26,-2,0,4,-1,-4,-4,0,-1,"w1819","Motorized",12,"Sat","weekend"
"5572",2019-03-16,"Slate River Rd","3","3","2",18.2,0.1,70,-2,26,26,-2,0,4,-1,-4,-4,0,-1,"w1819","Hybrid",0,"Sat","weekend"
"5573",2019-03-17,"Slate River Rd","3","3","2",18.2,0,69,-1,28,26.4,-2,-2,0,4,-3,-5,-5,-1,"w1819","Non.motorized",28,"Sun","weekend"
"5574",2019-03-17,"Slate River Rd","3","3","2",18.2,0,69,-1,28,26.4,-2,-2,0,4,-3,-5,-5,-1,"w1819","Mechanized",1,"Sun","weekend"
"5575",2019-03-17,"Slate River Rd","3","3","2",18.2,0,69,-1,28,26.4,-2,-2,0,4,-3,-5,-5,-1,"w1819","Motorized",6,"Sun","weekend"
"5576",2019-03-17,"Slate River Rd","3","3","2",18.2,0,69,-1,28,26.4,-2,-2,0,4,-3,-5,-5,-1,"w1819","Hybrid",0,"Sun","weekend"
"5577",2019-03-18,"Slate River Rd","2","2","2",18.3,0.1,68,-1,29,26.9,-1,-2,-2,0,-2,-4,-6,-6,"w1819","Non.motorized",17,"Mon","weekday"
"5578",2019-03-18,"Slate River Rd","2","2","2",18.3,0.1,68,-1,29,26.9,-1,-2,-2,0,-2,-4,-6,-6,"w1819","Mechanized",0,"Mon","weekday"
"5579",2019-03-18,"Slate River Rd","2","2","2",18.3,0.1,68,-1,29,26.9,-1,-2,-2,0,-2,-4,-6,-6,"w1819","Motorized",4,"Mon","weekday"
"5580",2019-03-18,"Slate River Rd","2","2","2",18.3,0.1,68,-1,29,26.9,-1,-2,-2,0,-2,-4,-6,-6,"w1819","Hybrid",0,"Mon","weekday"
"5581",2019-03-19,"Slate River Rd","2","2","2",18.3,0,67,-1,28,27.3,-1,-1,-2,-2,-2,-3,-5,-7,"w1819","Non.motorized",13,"Tue","weekday"
"5582",2019-03-19,"Slate River Rd","2","2","2",18.3,0,67,-1,28,27.3,-1,-1,-2,-2,-2,-3,-5,-7,"w1819","Mechanized",0,"Tue","weekday"
"5583",2019-03-19,"Slate River Rd","2","2","2",18.3,0,67,-1,28,27.3,-1,-1,-2,-2,-2,-3,-5,-7,"w1819","Motorized",0,"Tue","weekday"
"5584",2019-03-19,"Slate River Rd","2","2","2",18.3,0,67,-1,28,27.3,-1,-1,-2,-2,-2,-3,-5,-7,"w1819","Hybrid",0,"Tue","weekday"
"5585",2019-03-20,"Slate River Rd","2","2","2",18.3,0,66,-1,30,27.7,-1,-1,-1,-2,-2,-3,-4,-6,"w1819","Non.motorized",27,"Wed","weekday"
"5586",2019-03-20,"Slate River Rd","2","2","2",18.3,0,66,-1,30,27.7,-1,-1,-1,-2,-2,-3,-4,-6,"w1819","Mechanized",0,"Wed","weekday"
"5587",2019-03-20,"Slate River Rd","2","2","2",18.3,0,66,-1,30,27.7,-1,-1,-1,-2,-2,-3,-4,-6,"w1819","Motorized",1,"Wed","weekday"
"5588",2019-03-20,"Slate River Rd","2","2","2",18.3,0,66,-1,30,27.7,-1,-1,-1,-2,-2,-3,-4,-6,"w1819","Hybrid",0,"Wed","weekday"
"5589",2019-03-21,"Slate River Rd","2","2","2",18.4,0.1,65,-1,33,28.3,-1,-1,-1,-1,-2,-3,-4,-5,"w1819","Non.motorized",16,"Thu","weekday"
"5590",2019-03-21,"Slate River Rd","2","2","2",18.4,0.1,65,-1,33,28.3,-1,-1,-1,-1,-2,-3,-4,-5,"w1819","Mechanized",0,"Thu","weekday"
"5591",2019-03-21,"Slate River Rd","2","2","2",18.4,0.1,65,-1,33,28.3,-1,-1,-1,-1,-2,-3,-4,-5,"w1819","Motorized",0,"Thu","weekday"
"5592",2019-03-21,"Slate River Rd","2","2","2",18.4,0.1,65,-1,33,28.3,-1,-1,-1,-1,-2,-3,-4,-5,"w1819","Hybrid",0,"Thu","weekday"
"5593",2019-03-22,"Slate River Rd","3","3","2",18.4,0,64,-1,28,28.8,-1,-1,-1,-1,-2,-3,-4,-5,"w1819","Non.motorized",16,"Fri","weekday"
"5594",2019-03-22,"Slate River Rd","3","3","2",18.4,0,64,-1,28,28.8,-1,-1,-1,-1,-2,-3,-4,-5,"w1819","Mechanized",0,"Fri","weekday"
"5595",2019-03-22,"Slate River Rd","3","3","2",18.4,0,64,-1,28,28.8,-1,-1,-1,-1,-2,-3,-4,-5,"w1819","Motorized",1,"Fri","weekday"
"5596",2019-03-22,"Slate River Rd","3","3","2",18.4,0,64,-1,28,28.8,-1,-1,-1,-1,-2,-3,-4,-5,"w1819","Hybrid",1,"Fri","weekday"
"5597",2019-03-23,"Slate River Rd","2","2","1",18.4,0,65,1,28,28.3,-1,-1,-1,-1,0,-1,-2,-3,"w1819","Non.motorized",43,"Sat","weekend"
"5598",2019-03-23,"Slate River Rd","2","2","1",18.4,0,65,1,28,28.3,-1,-1,-1,-1,0,-1,-2,-3,"w1819","Mechanized",0,"Sat","weekend"
"5599",2019-03-23,"Slate River Rd","2","2","1",18.4,0,65,1,28,28.3,-1,-1,-1,-1,0,-1,-2,-3,"w1819","Motorized",6,"Sat","weekend"
"5600",2019-03-23,"Slate River Rd","2","2","1",18.4,0,65,1,28,28.3,-1,-1,-1,-1,0,-1,-2,-3,"w1819","Hybrid",6,"Sat","weekend"
"5601",2019-03-24,"Slate River Rd","2","2","1",18.4,0,64,-1,29,28.8,1,-1,-1,-1,0,-1,-2,-3,"w1819","Non.motorized",20,"Sun","weekend"
"5602",2019-03-24,"Slate River Rd","2","2","1",18.4,0,64,-1,29,28.8,1,-1,-1,-1,0,-1,-2,-3,"w1819","Mechanized",0,"Sun","weekend"
"5603",2019-03-24,"Slate River Rd","2","2","1",18.4,0,64,-1,29,28.8,1,-1,-1,-1,0,-1,-2,-3,"w1819","Motorized",7,"Sun","weekend"
"5604",2019-03-24,"Slate River Rd","2","2","1",18.4,0,64,-1,29,28.8,1,-1,-1,-1,0,-1,-2,-3,"w1819","Hybrid",7,"Sun","weekend"
"5605",2019-03-25,"Slate River Rd","2","2","2",18.6,0.2,64,0,31,29.1,-1,1,-1,-1,-1,0,-1,-2,"w1819","Non.motorized",28,"Mon","weekday"
"5606",2019-03-25,"Slate River Rd","2","2","2",18.6,0.2,64,0,31,29.1,-1,1,-1,-1,-1,0,-1,-2,"w1819","Mechanized",0,"Mon","weekday"
"5607",2019-03-25,"Slate River Rd","2","2","2",18.6,0.2,64,0,31,29.1,-1,1,-1,-1,-1,0,-1,-2,"w1819","Motorized",9,"Mon","weekday"
"5608",2019-03-25,"Slate River Rd","2","2","2",18.6,0.2,64,0,31,29.1,-1,1,-1,-1,-1,0,-1,-2,"w1819","Hybrid",7,"Mon","weekday"
"5609",2019-03-26,"Slate River Rd","2","2","2",18.9,0.3,63,-1,36,30,0,-1,1,-1,-1,-2,-1,-2,"w1819","Non.motorized",38,"Tue","weekday"
"5610",2019-03-26,"Slate River Rd","2","2","2",18.9,0.3,63,-1,36,30,0,-1,1,-1,-1,-2,-1,-2,"w1819","Mechanized",0,"Tue","weekday"
"5611",2019-03-26,"Slate River Rd","2","2","2",18.9,0.3,63,-1,36,30,0,-1,1,-1,-1,-2,-1,-2,"w1819","Motorized",8,"Tue","weekday"
"5612",2019-03-26,"Slate River Rd","2","2","2",18.9,0.3,63,-1,36,30,0,-1,1,-1,-1,-2,-1,-2,"w1819","Hybrid",0,"Tue","weekday"
"5613",2019-03-27,"Slate River Rd","1","2","2",18.9,0,62,-1,42,30.5,-1,0,-1,1,-2,-2,-3,-2,"w1819","Non.motorized",17,"Wed","weekday"
"5614",2019-03-27,"Slate River Rd","1","2","2",18.9,0,62,-1,42,30.5,-1,0,-1,1,-2,-2,-3,-2,"w1819","Mechanized",0,"Wed","weekday"
"5615",2019-03-27,"Slate River Rd","1","2","2",18.9,0,62,-1,42,30.5,-1,0,-1,1,-2,-2,-3,-2,"w1819","Motorized",0,"Wed","weekday"
"5616",2019-03-27,"Slate River Rd","1","2","2",18.9,0,62,-1,42,30.5,-1,0,-1,1,-2,-2,-3,-2,"w1819","Hybrid",0,"Wed","weekday"
"5617",2019-03-28,"Slate River Rd","1","2","2",18.9,0,60,-2,40,31.5,-1,-1,0,-1,-3,-4,-4,-5,"w1819","Non.motorized",13,"Thu","weekday"
"5618",2019-03-28,"Slate River Rd","1","2","2",18.9,0,60,-2,40,31.5,-1,-1,0,-1,-3,-4,-4,-5,"w1819","Mechanized",0,"Thu","weekday"
"5619",2019-03-28,"Slate River Rd","1","2","2",18.9,0,60,-2,40,31.5,-1,-1,0,-1,-3,-4,-4,-5,"w1819","Motorized",6,"Thu","weekday"
"5620",2019-03-28,"Slate River Rd","1","2","2",18.9,0,60,-2,40,31.5,-1,-1,0,-1,-3,-4,-4,-5,"w1819","Hybrid",0,"Thu","weekday"
"5621",2019-03-29,"Slate River Rd","1","1","1",19,0.1,58,-2,26,32.8,-2,-1,-1,0,-4,-5,-6,-6,"w1819","Non.motorized",34,"Fri","weekday"
"5622",2019-03-29,"Slate River Rd","1","1","1",19,0.1,58,-2,26,32.8,-2,-1,-1,0,-4,-5,-6,-6,"w1819","Mechanized",0,"Fri","weekday"
"5623",2019-03-29,"Slate River Rd","1","1","1",19,0.1,58,-2,26,32.8,-2,-1,-1,0,-4,-5,-6,-6,"w1819","Motorized",8,"Fri","weekday"
"5624",2019-03-29,"Slate River Rd","1","1","1",19,0.1,58,-2,26,32.8,-2,-1,-1,0,-4,-5,-6,-6,"w1819","Hybrid",0,"Fri","weekday"
"5625",2019-03-30,"Slate River Rd","1","1","1",19.1,0.1,61,3,24,31.3,-2,-2,-1,-1,1,-1,-2,-3,"w1819","Non.motorized",42,"Sat","weekend"
"5626",2019-03-30,"Slate River Rd","1","1","1",19.1,0.1,61,3,24,31.3,-2,-2,-1,-1,1,-1,-2,-3,"w1819","Mechanized",0,"Sat","weekend"
"5627",2019-03-30,"Slate River Rd","1","1","1",19.1,0.1,61,3,24,31.3,-2,-2,-1,-1,1,-1,-2,-3,"w1819","Motorized",18,"Sat","weekend"
"5628",2019-03-30,"Slate River Rd","1","1","1",19.1,0.1,61,3,24,31.3,-2,-2,-1,-1,1,-1,-2,-3,"w1819","Hybrid",17,"Sat","weekend"
"5629",2019-03-31,"Slate River Rd","1","1","1",19.1,0,59,-2,24,32.4,3,-2,-2,-1,1,-1,-3,-4,"w1819","Non.motorized",25,"Sun","weekend"
"5630",2019-03-31,"Slate River Rd","1","1","1",19.1,0,59,-2,24,32.4,3,-2,-2,-1,1,-1,-3,-4,"w1819","Mechanized",2,"Sun","weekend"
"5631",2019-03-31,"Slate River Rd","1","1","1",19.1,0,59,-2,24,32.4,3,-2,-2,-1,1,-1,-3,-4,"w1819","Motorized",4,"Sun","weekend"
"5632",2019-03-31,"Slate River Rd","1","1","1",19.1,0,59,-2,24,32.4,3,-2,-2,-1,1,-1,-3,-4,"w1819","Hybrid",4,"Sun","weekend"
"5633",2019-04-01,"Slate River Rd","2","1","1",19.1,0,58,-1,29,32.9,-2,3,-2,-2,-3,0,-2,-4,"w1819","Non.motorized",15,"Mon","weekday"
"5634",2019-04-01,"Slate River Rd","2","1","1",19.1,0,58,-1,29,32.9,-2,3,-2,-2,-3,0,-2,-4,"w1819","Mechanized",0,"Mon","weekday"
"5635",2019-04-01,"Slate River Rd","2","1","1",19.1,0,58,-1,29,32.9,-2,3,-2,-2,-3,0,-2,-4,"w1819","Motorized",10,"Mon","weekday"
"5636",2019-04-01,"Slate River Rd","2","1","1",19.1,0,58,-1,29,32.9,-2,3,-2,-2,-3,0,-2,-4,"w1819","Hybrid",10,"Mon","weekday"
"5637",2019-04-02,"Slate River Rd","1","1","1",19.1,0,58,0,33,32.9,-1,-2,3,-2,-1,-3,0,-2,"w1819","Non.motorized",10,"Tue","weekday"
"5638",2019-04-02,"Slate River Rd","1","1","1",19.1,0,58,0,33,32.9,-1,-2,3,-2,-1,-3,0,-2,"w1819","Mechanized",0,"Tue","weekday"
"5639",2019-04-02,"Slate River Rd","1","1","1",19.1,0,58,0,33,32.9,-1,-2,3,-2,-1,-3,0,-2,"w1819","Motorized",0,"Tue","weekday"
"5640",2019-04-02,"Slate River Rd","1","1","1",19.1,0,58,0,33,32.9,-1,-2,3,-2,-1,-3,0,-2,"w1819","Hybrid",0,"Tue","weekday"
"5641",2019-04-03,"Slate River Rd","2","1","1",19.2,0.1,58,0,31,33.1,0,-1,-2,3,0,-1,-3,0,"w1819","Non.motorized",12,"Wed","weekday"
"5642",2019-04-03,"Slate River Rd","2","1","1",19.2,0.1,58,0,31,33.1,0,-1,-2,3,0,-1,-3,0,"w1819","Mechanized",0,"Wed","weekday"
"5643",2019-04-03,"Slate River Rd","2","1","1",19.2,0.1,58,0,31,33.1,0,-1,-2,3,0,-1,-3,0,"w1819","Motorized",1,"Wed","weekday"
"5644",2019-04-03,"Slate River Rd","2","1","1",19.2,0.1,58,0,31,33.1,0,-1,-2,3,0,-1,-3,0,"w1819","Hybrid",0,"Wed","weekday"
"5645",2019-04-04,"Slate River Rd","2","1","1",19.4,0.2,59,1,35,32.9,0,0,-1,-2,1,1,0,-2,"w1819","Non.motorized",27,"Thu","weekday"
"5646",2019-04-04,"Slate River Rd","2","1","1",19.4,0.2,59,1,35,32.9,0,0,-1,-2,1,1,0,-2,"w1819","Mechanized",0,"Thu","weekday"
"5647",2019-04-04,"Slate River Rd","2","1","1",19.4,0.2,59,1,35,32.9,0,0,-1,-2,1,1,0,-2,"w1819","Motorized",5,"Thu","weekday"
"5648",2019-04-04,"Slate River Rd","2","1","1",19.4,0.2,59,1,35,32.9,0,0,-1,-2,1,1,0,-2,"w1819","Hybrid",4,"Thu","weekday"
"5649",2019-04-05,"Slate River Rd","1","1","1",19.4,0,57,-2,38,34,1,0,0,-1,-1,-1,-1,-2,"w1819","Non.motorized",20,"Fri","weekday"
"5650",2019-04-05,"Slate River Rd","1","1","1",19.4,0,57,-2,38,34,1,0,0,-1,-1,-1,-1,-2,"w1819","Mechanized",0,"Fri","weekday"
"5651",2019-04-05,"Slate River Rd","1","1","1",19.4,0,57,-2,38,34,1,0,0,-1,-1,-1,-1,-2,"w1819","Motorized",1,"Fri","weekday"
"5652",2019-04-05,"Slate River Rd","1","1","1",19.4,0,57,-2,38,34,1,0,0,-1,-1,-1,-1,-2,"w1819","Hybrid",1,"Fri","weekday"
"5653",2019-04-06,"Slate River Rd","1","1","1",19.3,-0.1,57,0,35,33.9,-2,1,0,0,-2,-1,-1,-1,"w1819","Non.motorized",17,"Sat","weekend"
"5654",2019-04-06,"Slate River Rd","1","1","1",19.3,-0.1,57,0,35,33.9,-2,1,0,0,-2,-1,-1,-1,"w1819","Mechanized",1,"Sat","weekend"
"5655",2019-04-06,"Slate River Rd","1","1","1",19.3,-0.1,57,0,35,33.9,-2,1,0,0,-2,-1,-1,-1,"w1819","Motorized",6,"Sat","weekend"
"5656",2019-04-06,"Slate River Rd","1","1","1",19.3,-0.1,57,0,35,33.9,-2,1,0,0,-2,-1,-1,-1,"w1819","Hybrid",4,"Sat","weekend"
"5657",2019-04-07,"Slate River Rd","1","1","1",19.1,-0.2,57,0,37,33.5,0,-2,1,0,0,-2,-1,-1,"w1819","Non.motorized",21,"Sun","weekend"
"5658",2019-04-07,"Slate River Rd","1","1","1",19.1,-0.2,57,0,37,33.5,0,-2,1,0,0,-2,-1,-1,"w1819","Mechanized",0,"Sun","weekend"
"5659",2019-04-07,"Slate River Rd","1","1","1",19.1,-0.2,57,0,37,33.5,0,-2,1,0,0,-2,-1,-1,"w1819","Motorized",15,"Sun","weekend"
"5660",2019-04-07,"Slate River Rd","1","1","1",19.1,-0.2,57,0,37,33.5,0,-2,1,0,0,-2,-1,-1,"w1819","Hybrid",7,"Sun","weekend"
"5661",2019-04-08,"Slate River Rd","1","2","2",19.3,0.2,54,-3,41,35.7,0,0,-2,1,-3,-3,-5,-4,"w1819","Non.motorized",7,"Mon","weekday"
"5662",2019-04-08,"Slate River Rd","1","2","2",19.3,0.2,54,-3,41,35.7,0,0,-2,1,-3,-3,-5,-4,"w1819","Mechanized",0,"Mon","weekday"
"5663",2019-04-08,"Slate River Rd","1","2","2",19.3,0.2,54,-3,41,35.7,0,0,-2,1,-3,-3,-5,-4,"w1819","Motorized",3,"Mon","weekday"
"5664",2019-04-08,"Slate River Rd","1","2","2",19.3,0.2,54,-3,41,35.7,0,0,-2,1,-3,-3,-5,-4,"w1819","Hybrid",3,"Mon","weekday"
"5665",2019-04-09,"Slate River Rd","1","2","2",19.3,0,53,-1,43,36.4,-3,0,0,-2,-4,-4,-4,-6,"w1819","Non.motorized",9,"Tue","weekday"
"5666",2019-04-09,"Slate River Rd","1","2","2",19.3,0,53,-1,43,36.4,-3,0,0,-2,-4,-4,-4,-6,"w1819","Mechanized",0,"Tue","weekday"
"5667",2019-04-09,"Slate River Rd","1","2","2",19.3,0,53,-1,43,36.4,-3,0,0,-2,-4,-4,-4,-6,"w1819","Motorized",5,"Tue","weekday"
"5668",2019-04-09,"Slate River Rd","1","2","2",19.3,0,53,-1,43,36.4,-3,0,0,-2,-4,-4,-4,-6,"w1819","Hybrid",2,"Tue","weekday"
"5669",2019-04-10,"Slate River Rd","2","2","1",19,-0.3,51,-2,30,37.3,-1,-3,0,0,-3,-6,-6,-6,"w1819","Non.motorized",9,"Wed","weekday"
"5670",2019-04-10,"Slate River Rd","2","2","1",19,-0.3,51,-2,30,37.3,-1,-3,0,0,-3,-6,-6,-6,"w1819","Mechanized",0,"Wed","weekday"
"5671",2019-04-10,"Slate River Rd","2","2","1",19,-0.3,51,-2,30,37.3,-1,-3,0,0,-3,-6,-6,-6,"w1819","Motorized",2,"Wed","weekday"
"5672",2019-04-10,"Slate River Rd","2","2","1",19,-0.3,51,-2,30,37.3,-1,-3,0,0,-3,-6,-6,-6,"w1819","Hybrid",2,"Wed","weekday"
"5673",2019-04-11,"Slate River Rd","3","3","2",18.9,-0.1,53,2,20,35.7,-2,-1,-3,0,0,-1,-4,-4,"w1819","Non.motorized",5,"Thu","weekday"
"5674",2019-04-11,"Slate River Rd","3","3","2",18.9,-0.1,53,2,20,35.7,-2,-1,-3,0,0,-1,-4,-4,"w1819","Mechanized",0,"Thu","weekday"
"5675",2019-04-11,"Slate River Rd","3","3","2",18.9,-0.1,53,2,20,35.7,-2,-1,-3,0,0,-1,-4,-4,"w1819","Motorized",2,"Thu","weekday"
"5676",2019-04-11,"Slate River Rd","3","3","2",18.9,-0.1,53,2,20,35.7,-2,-1,-3,0,0,-1,-4,-4,"w1819","Hybrid",1,"Thu","weekday"
"5677",2019-04-12,"Slate River Rd","2","2","1",18.7,-0.2,53,0,24,35.3,2,-2,-1,-3,2,0,-1,-4,"w1819","Non.motorized",13,"Fri","weekday"
"5678",2019-04-12,"Slate River Rd","2","2","1",18.7,-0.2,53,0,24,35.3,2,-2,-1,-3,2,0,-1,-4,"w1819","Mechanized",1,"Fri","weekday"
"5679",2019-04-12,"Slate River Rd","2","2","1",18.7,-0.2,53,0,24,35.3,2,-2,-1,-3,2,0,-1,-4,"w1819","Motorized",6,"Fri","weekday"
"5680",2019-04-12,"Slate River Rd","2","2","1",18.7,-0.2,53,0,24,35.3,2,-2,-1,-3,2,0,-1,-4,"w1819","Hybrid",4,"Fri","weekday"
"5681",2019-04-13,"Slate River Rd","1","1","1",18.8,0.1,52,-1,27,36.2,0,2,-2,-1,-1,1,-1,-2,"w1819","Non.motorized",17,"Sat","weekend"
"5682",2019-04-13,"Slate River Rd","1","1","1",18.8,0.1,52,-1,27,36.2,0,2,-2,-1,-1,1,-1,-2,"w1819","Mechanized",0,"Sat","weekend"
"5683",2019-04-13,"Slate River Rd","1","1","1",18.8,0.1,52,-1,27,36.2,0,2,-2,-1,-1,1,-1,-2,"w1819","Motorized",9,"Sat","weekend"
"5684",2019-04-13,"Slate River Rd","1","1","1",18.8,0.1,52,-1,27,36.2,0,2,-2,-1,-1,1,-1,-2,"w1819","Hybrid",8,"Sat","weekend"
"5685",2019-04-14,"Slate River Rd","1","1","1",18.7,-0.1,51,-1,35,36.7,-1,0,2,-2,-2,-2,0,-2,"w1819","Non.motorized",9,"Sun","weekend"
"5686",2019-04-14,"Slate River Rd","1","1","1",18.7,-0.1,51,-1,35,36.7,-1,0,2,-2,-2,-2,0,-2,"w1819","Mechanized",0,"Sun","weekend"
"5687",2019-04-14,"Slate River Rd","1","1","1",18.7,-0.1,51,-1,35,36.7,-1,0,2,-2,-2,-2,0,-2,"w1819","Motorized",5,"Sun","weekend"
"5688",2019-04-14,"Slate River Rd","1","1","1",18.7,-0.1,51,-1,35,36.7,-1,0,2,-2,-2,-2,0,-2,"w1819","Hybrid",5,"Sun","weekend"
"5689",2019-04-15,"Slate River Rd",NA,NA,NA,18.6,-0.1,50,-1,41,37.2,-1,-1,0,2,-2,-3,-3,-1,"w1819","Non.motorized",4,"Mon","weekday"
"5690",2019-04-15,"Slate River Rd",NA,NA,NA,18.6,-0.1,50,-1,41,37.2,-1,-1,0,2,-2,-3,-3,-1,"w1819","Mechanized",0,"Mon","weekday"
"5691",2019-04-15,"Slate River Rd",NA,NA,NA,18.6,-0.1,50,-1,41,37.2,-1,-1,0,2,-2,-3,-3,-1,"w1819","Motorized",4,"Mon","weekday"
"5692",2019-04-15,"Slate River Rd",NA,NA,NA,18.6,-0.1,50,-1,41,37.2,-1,-1,0,2,-2,-3,-3,-1,"w1819","Hybrid",4,"Mon","weekday"
"5693",2018-12-01,"Snodgrass","3","3","2",3.3,0.2,19,1,16,17.4,0,0,0,0,1,1,1,1,"w1819","Non.motorized",81,"Sat","weekend"
"5694",2018-12-01,"Snodgrass","3","3","2",3.3,0.2,19,1,16,17.4,0,0,0,0,1,1,1,1,"w1819","Mechanized",0,"Sat","weekend"
"5695",2018-12-01,"Snodgrass","3","3","2",3.3,0.2,19,1,16,17.4,0,0,0,0,1,1,1,1,"w1819","Motorized",0,"Sat","weekend"
"5696",2018-12-01,"Snodgrass","3","3","2",3.3,0.2,19,1,16,17.4,0,0,0,0,1,1,1,1,"w1819","Hybrid",0,"Sat","weekend"
"5697",2018-12-02,"Snodgrass","3","3","3",3.3,0,20,1,14,16.5,1,0,0,0,2,2,2,2,"w1819","Non.motorized",0,"Sun","weekend"
"5698",2018-12-02,"Snodgrass","3","3","3",3.3,0,20,1,14,16.5,1,0,0,0,2,2,2,2,"w1819","Mechanized",0,"Sun","weekend"
"5699",2018-12-02,"Snodgrass","3","3","3",3.3,0,20,1,14,16.5,1,0,0,0,2,2,2,2,"w1819","Motorized",0,"Sun","weekend"
"5700",2018-12-02,"Snodgrass","3","3","3",3.3,0,20,1,14,16.5,1,0,0,0,2,2,2,2,"w1819","Hybrid",0,"Sun","weekend"
"5701",2018-12-03,"Snodgrass","3","3","2",3.4,0.1,19,-1,13,17.9,1,1,0,0,0,1,1,1,"w1819","Non.motorized",0,"Mon","weekday"
"5702",2018-12-03,"Snodgrass","3","3","2",3.4,0.1,19,-1,13,17.9,1,1,0,0,0,1,1,1,"w1819","Mechanized",0,"Mon","weekday"
"5703",2018-12-03,"Snodgrass","3","3","2",3.4,0.1,19,-1,13,17.9,1,1,0,0,0,1,1,1,"w1819","Motorized",0,"Mon","weekday"
"5704",2018-12-03,"Snodgrass","3","3","2",3.4,0.1,19,-1,13,17.9,1,1,0,0,0,1,1,1,"w1819","Hybrid",0,"Mon","weekday"
"5705",2018-12-04,"Snodgrass","3","3","2",3.5,0.1,20,1,8,17.5,-1,1,1,0,0,1,2,2,"w1819","Non.motorized",0,"Tue","weekday"
"5706",2018-12-04,"Snodgrass","3","3","2",3.5,0.1,20,1,8,17.5,-1,1,1,0,0,1,2,2,"w1819","Mechanized",0,"Tue","weekday"
"5707",2018-12-04,"Snodgrass","3","3","2",3.5,0.1,20,1,8,17.5,-1,1,1,0,0,1,2,2,"w1819","Motorized",0,"Tue","weekday"
"5708",2018-12-04,"Snodgrass","3","3","2",3.5,0.1,20,1,8,17.5,-1,1,1,0,0,1,2,2,"w1819","Hybrid",0,"Tue","weekday"
"5709",2018-12-05,"Snodgrass","3","3","2",3.5,0,19,-1,21,18.4,1,-1,1,1,0,-1,0,1,"w1819","Non.motorized",0,"Wed","weekday"
"5710",2018-12-05,"Snodgrass","3","3","2",3.5,0,19,-1,21,18.4,1,-1,1,1,0,-1,0,1,"w1819","Mechanized",0,"Wed","weekday"
"5711",2018-12-05,"Snodgrass","3","3","2",3.5,0,19,-1,21,18.4,1,-1,1,1,0,-1,0,1,"w1819","Motorized",0,"Wed","weekday"
"5712",2018-12-05,"Snodgrass","3","3","2",3.5,0,19,-1,21,18.4,1,-1,1,1,0,-1,0,1,"w1819","Hybrid",0,"Wed","weekday"
"5713",2018-12-06,"Snodgrass","2","2","2",3.7,0.2,18,-1,25,20.6,-1,1,-1,1,-2,-1,-2,-1,"w1819","Non.motorized",0,"Thu","weekday"
"5714",2018-12-06,"Snodgrass","2","2","2",3.7,0.2,18,-1,25,20.6,-1,1,-1,1,-2,-1,-2,-1,"w1819","Mechanized",0,"Thu","weekday"
"5715",2018-12-06,"Snodgrass","2","2","2",3.7,0.2,18,-1,25,20.6,-1,1,-1,1,-2,-1,-2,-1,"w1819","Motorized",0,"Thu","weekday"
"5716",2018-12-06,"Snodgrass","2","2","2",3.7,0.2,18,-1,25,20.6,-1,1,-1,1,-2,-1,-2,-1,"w1819","Hybrid",0,"Thu","weekday"
"5717",2018-12-07,"Snodgrass","2","2","2",3.8,0.1,21,3,23,18.1,-1,-1,1,-1,2,1,2,1,"w1819","Non.motorized",0,"Fri","weekday"
"5718",2018-12-07,"Snodgrass","2","2","2",3.8,0.1,21,3,23,18.1,-1,-1,1,-1,2,1,2,1,"w1819","Mechanized",0,"Fri","weekday"
"5719",2018-12-07,"Snodgrass","2","2","2",3.8,0.1,21,3,23,18.1,-1,-1,1,-1,2,1,2,1,"w1819","Motorized",0,"Fri","weekday"
"5720",2018-12-07,"Snodgrass","2","2","2",3.8,0.1,21,3,23,18.1,-1,-1,1,-1,2,1,2,1,"w1819","Hybrid",0,"Fri","weekday"
"5721",2018-12-08,"Snodgrass","2","2","2",3.8,0,20,-1,23,19,3,-1,-1,1,2,1,0,1,"w1819","Non.motorized",0,"Sat","weekend"
"5722",2018-12-08,"Snodgrass","2","2","2",3.8,0,20,-1,23,19,3,-1,-1,1,2,1,0,1,"w1819","Mechanized",0,"Sat","weekend"
"5723",2018-12-08,"Snodgrass","2","2","2",3.8,0,20,-1,23,19,3,-1,-1,1,2,1,0,1,"w1819","Motorized",0,"Sat","weekend"
"5724",2018-12-08,"Snodgrass","2","2","2",3.8,0,20,-1,23,19,3,-1,-1,1,2,1,0,1,"w1819","Hybrid",0,"Sat","weekend"
"5725",2018-12-09,"Snodgrass","2","2","2",3.8,0,20,0,19,19,-1,3,-1,-1,-1,2,1,0,"w1819","Non.motorized",0,"Sun","weekend"
"5726",2018-12-09,"Snodgrass","2","2","2",3.8,0,20,0,19,19,-1,3,-1,-1,-1,2,1,0,"w1819","Mechanized",0,"Sun","weekend"
"5727",2018-12-09,"Snodgrass","2","2","2",3.8,0,20,0,19,19,-1,3,-1,-1,-1,2,1,0,"w1819","Motorized",0,"Sun","weekend"
"5728",2018-12-09,"Snodgrass","2","2","2",3.8,0,20,0,19,19,-1,3,-1,-1,-1,2,1,0,"w1819","Hybrid",0,"Sun","weekend"
"5729",2018-12-10,"Snodgrass","2","2","2",3.8,0,20,0,21,19,0,-1,3,-1,0,-1,2,1,"w1819","Non.motorized",0,"Mon","weekday"
"5730",2018-12-10,"Snodgrass","2","2","2",3.8,0,20,0,21,19,0,-1,3,-1,0,-1,2,1,"w1819","Mechanized",0,"Mon","weekday"
"5731",2018-12-10,"Snodgrass","2","2","2",3.8,0,20,0,21,19,0,-1,3,-1,0,-1,2,1,"w1819","Motorized",0,"Mon","weekday"
"5732",2018-12-10,"Snodgrass","2","2","2",3.8,0,20,0,21,19,0,-1,3,-1,0,-1,2,1,"w1819","Hybrid",0,"Mon","weekday"
"5733",2018-12-11,"Snodgrass","2","2","2",3.9,0.1,19,-1,27,20.5,0,0,-1,3,-1,-1,-2,1,"w1819","Non.motorized",0,"Tue","weekday"
"5734",2018-12-11,"Snodgrass","2","2","2",3.9,0.1,19,-1,27,20.5,0,0,-1,3,-1,-1,-2,1,"w1819","Mechanized",0,"Tue","weekday"
"5735",2018-12-11,"Snodgrass","2","2","2",3.9,0.1,19,-1,27,20.5,0,0,-1,3,-1,-1,-2,1,"w1819","Motorized",0,"Tue","weekday"
"5736",2018-12-11,"Snodgrass","2","2","2",3.9,0.1,19,-1,27,20.5,0,0,-1,3,-1,-1,-2,1,"w1819","Hybrid",0,"Tue","weekday"
"5737",2018-12-12,"Snodgrass","2","2","1",3.9,0,19,0,21,20.5,-1,0,0,-1,-1,-1,-1,-2,"w1819","Non.motorized",0,"Wed","weekday"
"5738",2018-12-12,"Snodgrass","2","2","1",3.9,0,19,0,21,20.5,-1,0,0,-1,-1,-1,-1,-2,"w1819","Mechanized",0,"Wed","weekday"
"5739",2018-12-12,"Snodgrass","2","2","1",3.9,0,19,0,21,20.5,-1,0,0,-1,-1,-1,-1,-2,"w1819","Motorized",0,"Wed","weekday"
"5740",2018-12-12,"Snodgrass","2","2","1",3.9,0,19,0,21,20.5,-1,0,0,-1,-1,-1,-1,-2,"w1819","Hybrid",0,"Wed","weekday"
"5741",2018-12-13,"Snodgrass","3","3","2",4,0.1,21,2,15,19,0,-1,0,0,2,1,1,1,"w1819","Non.motorized",0,"Thu","weekday"
"5742",2018-12-13,"Snodgrass","3","3","2",4,0.1,21,2,15,19,0,-1,0,0,2,1,1,1,"w1819","Mechanized",0,"Thu","weekday"
"5743",2018-12-13,"Snodgrass","3","3","2",4,0.1,21,2,15,19,0,-1,0,0,2,1,1,1,"w1819","Motorized",0,"Thu","weekday"
"5744",2018-12-13,"Snodgrass","3","3","2",4,0.1,21,2,15,19,0,-1,0,0,2,1,1,1,"w1819","Hybrid",0,"Thu","weekday"
"5745",2018-12-14,"Snodgrass","3","3","2",4,0,20,-1,24,20,2,0,-1,0,1,1,0,0,"w1819","Non.motorized",0,"Fri","weekday"
"5746",2018-12-14,"Snodgrass","3","3","2",4,0,20,-1,24,20,2,0,-1,0,1,1,0,0,"w1819","Mechanized",0,"Fri","weekday"
"5747",2018-12-14,"Snodgrass","3","3","2",4,0,20,-1,24,20,2,0,-1,0,1,1,0,0,"w1819","Motorized",0,"Fri","weekday"
"5748",2018-12-14,"Snodgrass","3","3","2",4,0,20,-1,24,20,2,0,-1,0,1,1,0,0,"w1819","Hybrid",0,"Fri","weekday"
"5749",2018-12-15,"Snodgrass","2","2","2",4,0,20,0,29,20,-1,2,0,-1,-1,1,1,0,"w1819","Non.motorized",0,"Sat","weekend"
"5750",2018-12-15,"Snodgrass","2","2","2",4,0,20,0,29,20,-1,2,0,-1,-1,1,1,0,"w1819","Mechanized",0,"Sat","weekend"
"5751",2018-12-15,"Snodgrass","2","2","2",4,0,20,0,29,20,-1,2,0,-1,-1,1,1,0,"w1819","Motorized",0,"Sat","weekend"
"5752",2018-12-15,"Snodgrass","2","2","2",4,0,20,0,29,20,-1,2,0,-1,-1,1,1,0,"w1819","Hybrid",0,"Sat","weekend"
"5753",2018-12-16,"Snodgrass","2","2","2",4.1,0.1,19,-1,28,21.6,0,-1,2,0,-1,-2,0,0,"w1819","Non.motorized",0,"Sun","weekend"
"5754",2018-12-16,"Snodgrass","2","2","2",4.1,0.1,19,-1,28,21.6,0,-1,2,0,-1,-2,0,0,"w1819","Mechanized",0,"Sun","weekend"
"5755",2018-12-16,"Snodgrass","2","2","2",4.1,0.1,19,-1,28,21.6,0,-1,2,0,-1,-2,0,0,"w1819","Motorized",0,"Sun","weekend"
"5756",2018-12-16,"Snodgrass","2","2","2",4.1,0.1,19,-1,28,21.6,0,-1,2,0,-1,-2,0,0,"w1819","Hybrid",0,"Sun","weekend"
"5757",2018-12-17,"Snodgrass","2","2","2",4.1,0,19,0,29,21.6,-1,0,-1,2,-1,-1,-2,0,"w1819","Non.motorized",0,"Mon","weekday"
"5758",2018-12-17,"Snodgrass","2","2","2",4.1,0,19,0,29,21.6,-1,0,-1,2,-1,-1,-2,0,"w1819","Mechanized",0,"Mon","weekday"
"5759",2018-12-17,"Snodgrass","2","2","2",4.1,0,19,0,29,21.6,-1,0,-1,2,-1,-1,-2,0,"w1819","Motorized",0,"Mon","weekday"
"5760",2018-12-17,"Snodgrass","2","2","2",4.1,0,19,0,29,21.6,-1,0,-1,2,-1,-1,-2,0,"w1819","Hybrid",0,"Mon","weekday"
"5761",2018-12-18,"Snodgrass","2","2","2",4.1,0,19,0,27,21.6,0,-1,0,-1,0,-1,-1,-2,"w1819","Non.motorized",0,"Tue","weekday"
"5762",2018-12-18,"Snodgrass","2","2","2",4.1,0,19,0,27,21.6,0,-1,0,-1,0,-1,-1,-2,"w1819","Mechanized",0,"Tue","weekday"
"5763",2018-12-18,"Snodgrass","2","2","2",4.1,0,19,0,27,21.6,0,-1,0,-1,0,-1,-1,-2,"w1819","Motorized",0,"Tue","weekday"
"5764",2018-12-18,"Snodgrass","2","2","2",4.1,0,19,0,27,21.6,0,-1,0,-1,0,-1,-1,-2,"w1819","Hybrid",0,"Tue","weekday"
"5765",2018-12-19,"Snodgrass","2","2","2",4.1,0,19,0,24,21.6,0,0,-1,0,0,0,-1,-1,"w1819","Non.motorized",0,"Wed","weekday"
"5766",2018-12-19,"Snodgrass","2","2","2",4.1,0,19,0,24,21.6,0,0,-1,0,0,0,-1,-1,"w1819","Mechanized",0,"Wed","weekday"
"5767",2018-12-19,"Snodgrass","2","2","2",4.1,0,19,0,24,21.6,0,0,-1,0,0,0,-1,-1,"w1819","Motorized",0,"Wed","weekday"
"5768",2018-12-19,"Snodgrass","2","2","2",4.1,0,19,0,24,21.6,0,0,-1,0,0,0,-1,-1,"w1819","Hybrid",0,"Wed","weekday"
"5769",2018-12-20,"Snodgrass","2","2","1",4.1,0,20,1,25,20.5,0,0,0,-1,1,1,1,0,"w1819","Non.motorized",0,"Thu","weekday"
"5770",2018-12-20,"Snodgrass","2","2","1",4.1,0,20,1,25,20.5,0,0,0,-1,1,1,1,0,"w1819","Mechanized",0,"Thu","weekday"
"5771",2018-12-20,"Snodgrass","2","2","1",4.1,0,20,1,25,20.5,0,0,0,-1,1,1,1,0,"w1819","Motorized",0,"Thu","weekday"
"5772",2018-12-20,"Snodgrass","2","2","1",4.1,0,20,1,25,20.5,0,0,0,-1,1,1,1,0,"w1819","Hybrid",0,"Thu","weekday"
"5773",2018-12-21,"Snodgrass","2","2","1",4.1,0,19,-1,28,21.6,1,0,0,0,0,0,0,0,"w1819","Non.motorized",0,"Fri","weekday"
"5774",2018-12-21,"Snodgrass","2","2","1",4.1,0,19,-1,28,21.6,1,0,0,0,0,0,0,0,"w1819","Mechanized",0,"Fri","weekday"
"5775",2018-12-21,"Snodgrass","2","2","1",4.1,0,19,-1,28,21.6,1,0,0,0,0,0,0,0,"w1819","Motorized",0,"Fri","weekday"
"5776",2018-12-21,"Snodgrass","2","2","1",4.1,0,19,-1,28,21.6,1,0,0,0,0,0,0,0,"w1819","Hybrid",0,"Fri","weekday"
"5777",2018-12-22,"Snodgrass","2","2","1",4.2,0.1,19,0,20,22.1,-1,1,0,0,-1,0,0,0,"w1819","Non.motorized",0,"Sat","weekend"
"5778",2018-12-22,"Snodgrass","2","2","1",4.2,0.1,19,0,20,22.1,-1,1,0,0,-1,0,0,0,"w1819","Mechanized",0,"Sat","weekend"
"5779",2018-12-22,"Snodgrass","2","2","1",4.2,0.1,19,0,20,22.1,-1,1,0,0,-1,0,0,0,"w1819","Motorized",0,"Sat","weekend"
"5780",2018-12-22,"Snodgrass","2","2","1",4.2,0.1,19,0,20,22.1,-1,1,0,0,-1,0,0,0,"w1819","Hybrid",0,"Sat","weekend"
"5781",2018-12-23,"Snodgrass","2","2","1",4.2,0,21,2,19,20,0,-1,1,0,2,1,2,2,"w1819","Non.motorized",0,"Sun","weekend"
"5782",2018-12-23,"Snodgrass","2","2","1",4.2,0,21,2,19,20,0,-1,1,0,2,1,2,2,"w1819","Mechanized",0,"Sun","weekend"
"5783",2018-12-23,"Snodgrass","2","2","1",4.2,0,21,2,19,20,0,-1,1,0,2,1,2,2,"w1819","Motorized",0,"Sun","weekend"
"5784",2018-12-23,"Snodgrass","2","2","1",4.2,0,21,2,19,20,0,-1,1,0,2,1,2,2,"w1819","Hybrid",0,"Sun","weekend"
"5785",2018-12-24,"Snodgrass","2","2","2",4.3,0.1,20,-1,21,21.5,2,0,-1,1,1,1,0,1,"w1819","Non.motorized",0,"Mon","weekday"
"5786",2018-12-24,"Snodgrass","2","2","2",4.3,0.1,20,-1,21,21.5,2,0,-1,1,1,1,0,1,"w1819","Mechanized",0,"Mon","weekday"
"5787",2018-12-24,"Snodgrass","2","2","2",4.3,0.1,20,-1,21,21.5,2,0,-1,1,1,1,0,1,"w1819","Motorized",0,"Mon","weekday"
"5788",2018-12-24,"Snodgrass","2","2","2",4.3,0.1,20,-1,21,21.5,2,0,-1,1,1,1,0,1,"w1819","Hybrid",0,"Mon","weekday"
"5789",2018-12-25,"Snodgrass","2","2","2",4.7,0.4,25,5,25,18.8,-1,2,0,-1,4,6,6,5,"w1819","Non.motorized",0,"Tue","weekday"
"5790",2018-12-25,"Snodgrass","2","2","2",4.7,0.4,25,5,25,18.8,-1,2,0,-1,4,6,6,5,"w1819","Mechanized",0,"Tue","weekday"
"5791",2018-12-25,"Snodgrass","2","2","2",4.7,0.4,25,5,25,18.8,-1,2,0,-1,4,6,6,5,"w1819","Motorized",0,"Tue","weekday"
"5792",2018-12-25,"Snodgrass","2","2","2",4.7,0.4,25,5,25,18.8,-1,2,0,-1,4,6,6,5,"w1819","Hybrid",0,"Tue","weekday"
"5793",2018-12-26,"Snodgrass","3","3","3",4.7,0,23,-2,24,20.4,5,-1,2,0,3,2,4,4,"w1819","Non.motorized",0,"Wed","weekday"
"5794",2018-12-26,"Snodgrass","3","3","3",4.7,0,23,-2,24,20.4,5,-1,2,0,3,2,4,4,"w1819","Mechanized",0,"Wed","weekday"
"5795",2018-12-26,"Snodgrass","3","3","3",4.7,0,23,-2,24,20.4,5,-1,2,0,3,2,4,4,"w1819","Motorized",0,"Wed","weekday"
"5796",2018-12-26,"Snodgrass","3","3","3",4.7,0,23,-2,24,20.4,5,-1,2,0,3,2,4,4,"w1819","Hybrid",0,"Wed","weekday"
"5797",2018-12-27,"Snodgrass","3","3","2",4.7,0,24,1,12,19.6,-2,5,-1,2,-1,4,3,5,"w1819","Non.motorized",0,"Thu","weekday"
"5798",2018-12-27,"Snodgrass","3","3","2",4.7,0,24,1,12,19.6,-2,5,-1,2,-1,4,3,5,"w1819","Mechanized",0,"Thu","weekday"
"5799",2018-12-27,"Snodgrass","3","3","2",4.7,0,24,1,12,19.6,-2,5,-1,2,-1,4,3,5,"w1819","Motorized",0,"Thu","weekday"
"5800",2018-12-27,"Snodgrass","3","3","2",4.7,0,24,1,12,19.6,-2,5,-1,2,-1,4,3,5,"w1819","Hybrid",0,"Thu","weekday"
"5801",2018-12-28,"Snodgrass","3","3","2",4.7,0,24,0,12,19.6,1,-2,5,-1,1,-1,4,3,"w1819","Non.motorized",0,"Fri","weekday"
"5802",2018-12-28,"Snodgrass","3","3","2",4.7,0,24,0,12,19.6,1,-2,5,-1,1,-1,4,3,"w1819","Mechanized",0,"Fri","weekday"
"5803",2018-12-28,"Snodgrass","3","3","2",4.7,0,24,0,12,19.6,1,-2,5,-1,1,-1,4,3,"w1819","Motorized",0,"Fri","weekday"
"5804",2018-12-28,"Snodgrass","3","3","2",4.7,0,24,0,12,19.6,1,-2,5,-1,1,-1,4,3,"w1819","Hybrid",0,"Fri","weekday"
"5805",2018-12-29,"Snodgrass","3","3","2",4.7,0,24,0,8,19.6,0,1,-2,5,0,1,-1,4,"w1819","Non.motorized",0,"Sat","weekend"
"5806",2018-12-29,"Snodgrass","3","3","2",4.7,0,24,0,8,19.6,0,1,-2,5,0,1,-1,4,"w1819","Mechanized",0,"Sat","weekend"
"5807",2018-12-29,"Snodgrass","3","3","2",4.7,0,24,0,8,19.6,0,1,-2,5,0,1,-1,4,"w1819","Motorized",0,"Sat","weekend"
"5808",2018-12-29,"Snodgrass","3","3","2",4.7,0,24,0,8,19.6,0,1,-2,5,0,1,-1,4,"w1819","Hybrid",0,"Sat","weekend"
"5809",2018-12-30,"Snodgrass","3","3","2",4.7,0,24,0,16,19.6,0,0,1,-2,0,0,1,-1,"w1819","Non.motorized",0,"Sun","weekend"
"5810",2018-12-30,"Snodgrass","3","3","2",4.7,0,24,0,16,19.6,0,0,1,-2,0,0,1,-1,"w1819","Mechanized",0,"Sun","weekend"
"5811",2018-12-30,"Snodgrass","3","3","2",4.7,0,24,0,16,19.6,0,0,1,-2,0,0,1,-1,"w1819","Motorized",0,"Sun","weekend"
"5812",2018-12-30,"Snodgrass","3","3","2",4.7,0,24,0,16,19.6,0,0,1,-2,0,0,1,-1,"w1819","Hybrid",0,"Sun","weekend"
"5813",2018-12-31,"Snodgrass","3","3","3",4.9,0.2,23,-1,14,21.3,0,0,0,1,-1,-1,-1,0,"w1819","Non.motorized",0,"Mon","weekday"
"5814",2018-12-31,"Snodgrass","3","3","3",4.9,0.2,23,-1,14,21.3,0,0,0,1,-1,-1,-1,0,"w1819","Mechanized",0,"Mon","weekday"
"5815",2018-12-31,"Snodgrass","3","3","3",4.9,0.2,23,-1,14,21.3,0,0,0,1,-1,-1,-1,0,"w1819","Motorized",0,"Mon","weekday"
"5816",2018-12-31,"Snodgrass","3","3","3",4.9,0.2,23,-1,14,21.3,0,0,0,1,-1,-1,-1,0,"w1819","Hybrid",0,"Mon","weekday"
"5817",2019-01-01,"Snodgrass","3","3","3",5.1,0.2,29,6,11,17.6,-1,0,0,0,5,5,5,5,"w1819","Non.motorized",0,"Tue","weekday"
"5818",2019-01-01,"Snodgrass","3","3","3",5.1,0.2,29,6,11,17.6,-1,0,0,0,5,5,5,5,"w1819","Mechanized",0,"Tue","weekday"
"5819",2019-01-01,"Snodgrass","3","3","3",5.1,0.2,29,6,11,17.6,-1,0,0,0,5,5,5,5,"w1819","Motorized",0,"Tue","weekday"
"5820",2019-01-01,"Snodgrass","3","3","3",5.1,0.2,29,6,11,17.6,-1,0,0,0,5,5,5,5,"w1819","Hybrid",0,"Tue","weekday"
"5821",2019-01-02,"Snodgrass","3","3","2",5.1,0,28,-1,10,18.2,6,-1,0,0,5,4,4,4,"w1819","Non.motorized",5,"Wed","weekday"
"5822",2019-01-02,"Snodgrass","3","3","2",5.1,0,28,-1,10,18.2,6,-1,0,0,5,4,4,4,"w1819","Mechanized",0,"Wed","weekday"
"5823",2019-01-02,"Snodgrass","3","3","2",5.1,0,28,-1,10,18.2,6,-1,0,0,5,4,4,4,"w1819","Motorized",1,"Wed","weekday"
"5824",2019-01-02,"Snodgrass","3","3","2",5.1,0,28,-1,10,18.2,6,-1,0,0,5,4,4,4,"w1819","Hybrid",0,"Wed","weekday"
"5825",2019-01-03,"Snodgrass","3","3","2",5.1,0,27,-1,22,18.9,-1,6,-1,0,-2,4,3,3,"w1819","Non.motorized",94,"Thu","weekday"
"5826",2019-01-03,"Snodgrass","3","3","2",5.1,0,27,-1,22,18.9,-1,6,-1,0,-2,4,3,3,"w1819","Mechanized",0,"Thu","weekday"
"5827",2019-01-03,"Snodgrass","3","3","2",5.1,0,27,-1,22,18.9,-1,6,-1,0,-2,4,3,3,"w1819","Motorized",7,"Thu","weekday"
"5828",2019-01-03,"Snodgrass","3","3","2",5.1,0,27,-1,22,18.9,-1,6,-1,0,-2,4,3,3,"w1819","Hybrid",0,"Thu","weekday"
"5829",2019-01-04,"Snodgrass","3","3","2",5.3,0.2,26,-1,29,20.4,-1,-1,6,-1,-2,-3,3,2,"w1819","Non.motorized",119,"Fri","weekday"
"5830",2019-01-04,"Snodgrass","3","3","2",5.3,0.2,26,-1,29,20.4,-1,-1,6,-1,-2,-3,3,2,"w1819","Mechanized",11,"Fri","weekday"
"5831",2019-01-04,"Snodgrass","3","3","2",5.3,0.2,26,-1,29,20.4,-1,-1,6,-1,-2,-3,3,2,"w1819","Motorized",9,"Fri","weekday"
"5832",2019-01-04,"Snodgrass","3","3","2",5.3,0.2,26,-1,29,20.4,-1,-1,6,-1,-2,-3,3,2,"w1819","Hybrid",0,"Fri","weekday"
"5833",2019-01-05,"Snodgrass","2","2","2",5.3,0,25,-1,30,21.2,-1,-1,-1,6,-2,-3,-4,2,"w1819","Non.motorized",123,"Sat","weekend"
"5834",2019-01-05,"Snodgrass","2","2","2",5.3,0,25,-1,30,21.2,-1,-1,-1,6,-2,-3,-4,2,"w1819","Mechanized",9,"Sat","weekend"
"5835",2019-01-05,"Snodgrass","2","2","2",5.3,0,25,-1,30,21.2,-1,-1,-1,6,-2,-3,-4,2,"w1819","Motorized",2,"Sat","weekend"
"5836",2019-01-05,"Snodgrass","2","2","2",5.3,0,25,-1,30,21.2,-1,-1,-1,6,-2,-3,-4,2,"w1819","Hybrid",0,"Sat","weekend"
"5837",2019-01-06,"Snodgrass","3","3","3",5.3,0,25,0,26,21.2,-1,-1,-1,-1,-1,-2,-3,-4,"w1819","Non.motorized",69,"Sun","weekend"
"5838",2019-01-06,"Snodgrass","3","3","3",5.3,0,25,0,26,21.2,-1,-1,-1,-1,-1,-2,-3,-4,"w1819","Mechanized",0,"Sun","weekend"
"5839",2019-01-06,"Snodgrass","3","3","3",5.3,0,25,0,26,21.2,-1,-1,-1,-1,-1,-2,-3,-4,"w1819","Motorized",1,"Sun","weekend"
"5840",2019-01-06,"Snodgrass","3","3","3",5.3,0,25,0,26,21.2,-1,-1,-1,-1,-1,-2,-3,-4,"w1819","Hybrid",0,"Sun","weekend"
"5841",2019-01-07,"Snodgrass","3","3","3",5.8,0.5,32,7,21,18.1,0,-1,-1,-1,7,6,5,4,"w1819","Non.motorized",0,"Mon","weekday"
"5842",2019-01-07,"Snodgrass","3","3","3",5.8,0.5,32,7,21,18.1,0,-1,-1,-1,7,6,5,4,"w1819","Mechanized",0,"Mon","weekday"
"5843",2019-01-07,"Snodgrass","3","3","3",5.8,0.5,32,7,21,18.1,0,-1,-1,-1,7,6,5,4,"w1819","Motorized",0,"Mon","weekday"
"5844",2019-01-07,"Snodgrass","3","3","3",5.8,0.5,32,7,21,18.1,0,-1,-1,-1,7,6,5,4,"w1819","Hybrid",0,"Mon","weekday"
"5845",2019-01-08,"Snodgrass","3","3","3",5.9,0.1,32,0,24,18.4,7,0,-1,-1,7,7,6,5,"w1819","Non.motorized",68,"Tue","weekday"
"5846",2019-01-08,"Snodgrass","3","3","3",5.9,0.1,32,0,24,18.4,7,0,-1,-1,7,7,6,5,"w1819","Mechanized",1,"Tue","weekday"
"5847",2019-01-08,"Snodgrass","3","3","3",5.9,0.1,32,0,24,18.4,7,0,-1,-1,7,7,6,5,"w1819","Motorized",0,"Tue","weekday"
"5848",2019-01-08,"Snodgrass","3","3","3",5.9,0.1,32,0,24,18.4,7,0,-1,-1,7,7,6,5,"w1819","Hybrid",0,"Tue","weekday"
"5849",2019-01-09,"Snodgrass","3","3","3",6,0.1,30,-2,29,20,0,7,0,-1,-2,5,5,4,"w1819","Non.motorized",62,"Wed","weekday"
"5850",2019-01-09,"Snodgrass","3","3","3",6,0.1,30,-2,29,20,0,7,0,-1,-2,5,5,4,"w1819","Mechanized",1,"Wed","weekday"
"5851",2019-01-09,"Snodgrass","3","3","3",6,0.1,30,-2,29,20,0,7,0,-1,-2,5,5,4,"w1819","Motorized",0,"Wed","weekday"
"5852",2019-01-09,"Snodgrass","3","3","3",6,0.1,30,-2,29,20,0,7,0,-1,-2,5,5,4,"w1819","Hybrid",0,"Wed","weekday"
"5853",2019-01-10,"Snodgrass","3","3","3",6,0,29,-1,29,20.7,-2,0,7,0,-3,-3,4,4,"w1819","Non.motorized",78,"Thu","weekday"
"5854",2019-01-10,"Snodgrass","3","3","3",6,0,29,-1,29,20.7,-2,0,7,0,-3,-3,4,4,"w1819","Mechanized",7,"Thu","weekday"
"5855",2019-01-10,"Snodgrass","3","3","3",6,0,29,-1,29,20.7,-2,0,7,0,-3,-3,4,4,"w1819","Motorized",0,"Thu","weekday"
"5856",2019-01-10,"Snodgrass","3","3","3",6,0,29,-1,29,20.7,-2,0,7,0,-3,-3,4,4,"w1819","Hybrid",0,"Thu","weekday"
"5857",2019-01-11,"Snodgrass","2","2","2",6.1,0.1,29,0,25,21,-1,-2,0,7,-1,-3,-3,4,"w1819","Non.motorized",47,"Fri","weekday"
"5858",2019-01-11,"Snodgrass","2","2","2",6.1,0.1,29,0,25,21,-1,-2,0,7,-1,-3,-3,4,"w1819","Mechanized",0,"Fri","weekday"
"5859",2019-01-11,"Snodgrass","2","2","2",6.1,0.1,29,0,25,21,-1,-2,0,7,-1,-3,-3,4,"w1819","Motorized",1,"Fri","weekday"
"5860",2019-01-11,"Snodgrass","2","2","2",6.1,0.1,29,0,25,21,-1,-2,0,7,-1,-3,-3,4,"w1819","Hybrid",0,"Fri","weekday"
"5861",2019-01-12,"Snodgrass","3","3","2",6.1,0,28,-1,21,21.8,0,-1,-2,0,-1,-2,-4,-4,"w1819","Non.motorized",88,"Sat","weekend"
"5862",2019-01-12,"Snodgrass","3","3","2",6.1,0,28,-1,21,21.8,0,-1,-2,0,-1,-2,-4,-4,"w1819","Mechanized",6,"Sat","weekend"
"5863",2019-01-12,"Snodgrass","3","3","2",6.1,0,28,-1,21,21.8,0,-1,-2,0,-1,-2,-4,-4,"w1819","Motorized",2,"Sat","weekend"
"5864",2019-01-12,"Snodgrass","3","3","2",6.1,0,28,-1,21,21.8,0,-1,-2,0,-1,-2,-4,-4,"w1819","Hybrid",0,"Sat","weekend"
"5865",2019-01-13,"Snodgrass","2","2","2",6.2,0.1,30,2,18,20.7,-1,0,-1,-2,1,1,0,-2,"w1819","Non.motorized",112,"Sun","weekend"
"5866",2019-01-13,"Snodgrass","2","2","2",6.2,0.1,30,2,18,20.7,-1,0,-1,-2,1,1,0,-2,"w1819","Mechanized",2,"Sun","weekend"
"5867",2019-01-13,"Snodgrass","2","2","2",6.2,0.1,30,2,18,20.7,-1,0,-1,-2,1,1,0,-2,"w1819","Motorized",4,"Sun","weekend"
"5868",2019-01-13,"Snodgrass","2","2","2",6.2,0.1,30,2,18,20.7,-1,0,-1,-2,1,1,0,-2,"w1819","Hybrid",0,"Sun","weekend"
"5869",2019-01-14,"Snodgrass","2","2","2",6.2,0,30,0,18,20.7,2,-1,0,-1,2,1,1,0,"w1819","Non.motorized",47,"Mon","weekday"
"5870",2019-01-14,"Snodgrass","2","2","2",6.2,0,30,0,18,20.7,2,-1,0,-1,2,1,1,0,"w1819","Mechanized",0,"Mon","weekday"
"5871",2019-01-14,"Snodgrass","2","2","2",6.2,0,30,0,18,20.7,2,-1,0,-1,2,1,1,0,"w1819","Motorized",1,"Mon","weekday"
"5872",2019-01-14,"Snodgrass","2","2","2",6.2,0,30,0,18,20.7,2,-1,0,-1,2,1,1,0,"w1819","Hybrid",0,"Mon","weekday"
"5873",2019-01-15,"Snodgrass","2","2","2",6.2,0,29,-1,24,21.4,0,2,-1,0,-1,1,0,0,"w1819","Non.motorized",41,"Tue","weekday"
"5874",2019-01-15,"Snodgrass","2","2","2",6.2,0,29,-1,24,21.4,0,2,-1,0,-1,1,0,0,"w1819","Mechanized",0,"Tue","weekday"
"5875",2019-01-15,"Snodgrass","2","2","2",6.2,0,29,-1,24,21.4,0,2,-1,0,-1,1,0,0,"w1819","Motorized",0,"Tue","weekday"
"5876",2019-01-15,"Snodgrass","2","2","2",6.2,0,29,-1,24,21.4,0,2,-1,0,-1,1,0,0,"w1819","Hybrid",0,"Tue","weekday"
"5877",2019-01-16,"Snodgrass","4","4","3",6.3,0.1,29,0,26,21.7,-1,0,2,-1,-1,-1,1,0,"w1819","Non.motorized",22,"Wed","weekday"
"5878",2019-01-16,"Snodgrass","4","4","3",6.3,0.1,29,0,26,21.7,-1,0,2,-1,-1,-1,1,0,"w1819","Mechanized",0,"Wed","weekday"
"5879",2019-01-16,"Snodgrass","4","4","3",6.3,0.1,29,0,26,21.7,-1,0,2,-1,-1,-1,1,0,"w1819","Motorized",0,"Wed","weekday"
"5880",2019-01-16,"Snodgrass","4","4","3",6.3,0.1,29,0,26,21.7,-1,0,2,-1,-1,-1,1,0,"w1819","Hybrid",0,"Wed","weekday"
"5881",2019-01-17,"Snodgrass","3","3","2",7,0.7,38,9,28,18.4,0,-1,0,2,9,8,8,10,"w1819","Non.motorized",35,"Thu","weekday"
"5882",2019-01-17,"Snodgrass","3","3","2",7,0.7,38,9,28,18.4,0,-1,0,2,9,8,8,10,"w1819","Mechanized",0,"Thu","weekday"
"5883",2019-01-17,"Snodgrass","3","3","2",7,0.7,38,9,28,18.4,0,-1,0,2,9,8,8,10,"w1819","Motorized",0,"Thu","weekday"
"5884",2019-01-17,"Snodgrass","3","3","2",7,0.7,38,9,28,18.4,0,-1,0,2,9,8,8,10,"w1819","Hybrid",0,"Thu","weekday"
"5885",2019-01-18,"Snodgrass","4","4","4",7.5,0.5,41,3,22,18.3,9,0,-1,0,12,12,11,11,"w1819","Non.motorized",4,"Fri","weekday"
"5886",2019-01-18,"Snodgrass","4","4","4",7.5,0.5,41,3,22,18.3,9,0,-1,0,12,12,11,11,"w1819","Mechanized",0,"Fri","weekday"
"5887",2019-01-18,"Snodgrass","4","4","4",7.5,0.5,41,3,22,18.3,9,0,-1,0,12,12,11,11,"w1819","Motorized",0,"Fri","weekday"
"5888",2019-01-18,"Snodgrass","4","4","4",7.5,0.5,41,3,22,18.3,9,0,-1,0,12,12,11,11,"w1819","Hybrid",0,"Fri","weekday"
"5889",2019-01-19,"Snodgrass","3","3","3",7.8,0.3,43,2,20,18.1,3,9,0,-1,5,14,14,13,"w1819","Non.motorized",0,"Sat","weekend"
"5890",2019-01-19,"Snodgrass","3","3","3",7.8,0.3,43,2,20,18.1,3,9,0,-1,5,14,14,13,"w1819","Mechanized",0,"Sat","weekend"
"5891",2019-01-19,"Snodgrass","3","3","3",7.8,0.3,43,2,20,18.1,3,9,0,-1,5,14,14,13,"w1819","Motorized",0,"Sat","weekend"
"5892",2019-01-19,"Snodgrass","3","3","3",7.8,0.3,43,2,20,18.1,3,9,0,-1,5,14,14,13,"w1819","Hybrid",0,"Sat","weekend"
"5893",2019-01-20,"Snodgrass","3","3","3",7.9,0.1,41,-2,27,19.3,2,3,9,0,0,3,12,12,"w1819","Non.motorized",0,"Sun","weekend"
"5894",2019-01-20,"Snodgrass","3","3","3",7.9,0.1,41,-2,27,19.3,2,3,9,0,0,3,12,12,"w1819","Mechanized",0,"Sun","weekend"
"5895",2019-01-20,"Snodgrass","3","3","3",7.9,0.1,41,-2,27,19.3,2,3,9,0,0,3,12,12,"w1819","Motorized",0,"Sun","weekend"
"5896",2019-01-20,"Snodgrass","3","3","3",7.9,0.1,41,-2,27,19.3,2,3,9,0,0,3,12,12,"w1819","Hybrid",0,"Sun","weekend"
"5897",2019-01-21,"Snodgrass","3","3","3",7.9,0,39,-2,23,20.3,-2,2,3,9,-4,-2,1,10,"w1819","Non.motorized",NA,"Mon","weekday"
"5898",2019-01-21,"Snodgrass","3","3","3",7.9,0,39,-2,23,20.3,-2,2,3,9,-4,-2,1,10,"w1819","Mechanized",NA,"Mon","weekday"
"5899",2019-01-21,"Snodgrass","3","3","3",7.9,0,39,-2,23,20.3,-2,2,3,9,-4,-2,1,10,"w1819","Motorized",NA,"Mon","weekday"
"5900",2019-01-21,"Snodgrass","3","3","3",7.9,0,39,-2,23,20.3,-2,2,3,9,-4,-2,1,10,"w1819","Hybrid",NA,"Mon","weekday"
"5901",2019-01-22,"Snodgrass","3","3","3",8,0.1,41,2,12,19.5,-2,-2,2,3,0,-2,0,3,"w1819","Non.motorized",47,"Tue","weekday"
"5902",2019-01-22,"Snodgrass","3","3","3",8,0.1,41,2,12,19.5,-2,-2,2,3,0,-2,0,3,"w1819","Mechanized",1,"Tue","weekday"
"5903",2019-01-22,"Snodgrass","3","3","3",8,0.1,41,2,12,19.5,-2,-2,2,3,0,-2,0,3,"w1819","Motorized",2,"Tue","weekday"
"5904",2019-01-22,"Snodgrass","3","3","3",8,0.1,41,2,12,19.5,-2,-2,2,3,0,-2,0,3,"w1819","Hybrid",0,"Tue","weekday"
"5905",2019-01-23,"Snodgrass","3","3","2",8,0,40,-1,14,20,2,-2,-2,2,1,-1,-3,-1,"w1819","Non.motorized",42,"Wed","weekday"
"5906",2019-01-23,"Snodgrass","3","3","2",8,0,40,-1,14,20,2,-2,-2,2,1,-1,-3,-1,"w1819","Mechanized",1,"Wed","weekday"
"5907",2019-01-23,"Snodgrass","3","3","2",8,0,40,-1,14,20,2,-2,-2,2,1,-1,-3,-1,"w1819","Motorized",0,"Wed","weekday"
"5908",2019-01-23,"Snodgrass","3","3","2",8,0,40,-1,14,20,2,-2,-2,2,1,-1,-3,-1,"w1819","Hybrid",0,"Wed","weekday"
"5909",2019-01-24,"Snodgrass","3","3","2",8.2,0.2,40,0,17,20.5,-1,2,-2,-2,-1,1,-1,-3,"w1819","Non.motorized",19,"Thu","weekday"
"5910",2019-01-24,"Snodgrass","3","3","2",8.2,0.2,40,0,17,20.5,-1,2,-2,-2,-1,1,-1,-3,"w1819","Mechanized",0,"Thu","weekday"
"5911",2019-01-24,"Snodgrass","3","3","2",8.2,0.2,40,0,17,20.5,-1,2,-2,-2,-1,1,-1,-3,"w1819","Motorized",1,"Thu","weekday"
"5912",2019-01-24,"Snodgrass","3","3","2",8.2,0.2,40,0,17,20.5,-1,2,-2,-2,-1,1,-1,-3,"w1819","Hybrid",0,"Thu","weekday"
"5913",2019-01-25,"Snodgrass","3","3","2",8.3,0.1,40,0,15,20.8,0,-1,2,-2,0,-1,1,-1,"w1819","Non.motorized",71,"Fri","weekday"
"5914",2019-01-25,"Snodgrass","3","3","2",8.3,0.1,40,0,15,20.8,0,-1,2,-2,0,-1,1,-1,"w1819","Mechanized",4,"Fri","weekday"
"5915",2019-01-25,"Snodgrass","3","3","2",8.3,0.1,40,0,15,20.8,0,-1,2,-2,0,-1,1,-1,"w1819","Motorized",9,"Fri","weekday"
"5916",2019-01-25,"Snodgrass","3","3","2",8.3,0.1,40,0,15,20.8,0,-1,2,-2,0,-1,1,-1,"w1819","Hybrid",0,"Fri","weekday"
"5917",2019-01-26,"Snodgrass","3","3","2",8.3,0,39,-1,19,21.3,0,0,-1,2,-1,-1,-2,0,"w1819","Non.motorized",102,"Sat","weekend"
"5918",2019-01-26,"Snodgrass","3","3","2",8.3,0,39,-1,19,21.3,0,0,-1,2,-1,-1,-2,0,"w1819","Mechanized",7,"Sat","weekend"
"5919",2019-01-26,"Snodgrass","3","3","2",8.3,0,39,-1,19,21.3,0,0,-1,2,-1,-1,-2,0,"w1819","Motorized",3,"Sat","weekend"
"5920",2019-01-26,"Snodgrass","3","3","2",8.3,0,39,-1,19,21.3,0,0,-1,2,-1,-1,-2,0,"w1819","Hybrid",0,"Sat","weekend"
"5921",2019-01-27,"Snodgrass","3","3","2",8.3,0,38,-1,24,21.8,-1,0,0,-1,-2,-2,-2,-3,"w1819","Non.motorized",85,"Sun","weekend"
"5922",2019-01-27,"Snodgrass","3","3","2",8.3,0,38,-1,24,21.8,-1,0,0,-1,-2,-2,-2,-3,"w1819","Mechanized",2,"Sun","weekend"
"5923",2019-01-27,"Snodgrass","3","3","2",8.3,0,38,-1,24,21.8,-1,0,0,-1,-2,-2,-2,-3,"w1819","Motorized",0,"Sun","weekend"
"5924",2019-01-27,"Snodgrass","3","3","2",8.3,0,38,-1,24,21.8,-1,0,0,-1,-2,-2,-2,-3,"w1819","Hybrid",0,"Sun","weekend"
"5925",2019-01-28,"Snodgrass","2","2","2",8.3,0,38,0,17,21.8,-1,-1,0,0,-1,-2,-2,-2,"w1819","Non.motorized",13,"Mon","weekday"
"5926",2019-01-28,"Snodgrass","2","2","2",8.3,0,38,0,17,21.8,-1,-1,0,0,-1,-2,-2,-2,"w1819","Mechanized",0,"Mon","weekday"
"5927",2019-01-28,"Snodgrass","2","2","2",8.3,0,38,0,17,21.8,-1,-1,0,0,-1,-2,-2,-2,"w1819","Motorized",0,"Mon","weekday"
"5928",2019-01-28,"Snodgrass","2","2","2",8.3,0,38,0,17,21.8,-1,-1,0,0,-1,-2,-2,-2,"w1819","Hybrid",0,"Mon","weekday"
"5929",2019-01-29,"Snodgrass","2","2","2",8.3,0,38,0,16,21.8,0,-1,-1,0,0,-1,-2,-2,"w1819","Non.motorized",39,"Tue","weekday"
"5930",2019-01-29,"Snodgrass","2","2","2",8.3,0,38,0,16,21.8,0,-1,-1,0,0,-1,-2,-2,"w1819","Mechanized",1,"Tue","weekday"
"5931",2019-01-29,"Snodgrass","2","2","2",8.3,0,38,0,16,21.8,0,-1,-1,0,0,-1,-2,-2,"w1819","Motorized",0,"Tue","weekday"
"5932",2019-01-29,"Snodgrass","2","2","2",8.3,0,38,0,16,21.8,0,-1,-1,0,0,-1,-2,-2,"w1819","Hybrid",0,"Tue","weekday"
"5933",2019-01-30,"Snodgrass","2","2","1",8.3,0,37,-1,20,22.4,0,0,-1,-1,-1,-1,-2,-3,"w1819","Non.motorized",41,"Wed","weekday"
"5934",2019-01-30,"Snodgrass","2","2","1",8.3,0,37,-1,20,22.4,0,0,-1,-1,-1,-1,-2,-3,"w1819","Mechanized",0,"Wed","weekday"
"5935",2019-01-30,"Snodgrass","2","2","1",8.3,0,37,-1,20,22.4,0,0,-1,-1,-1,-1,-2,-3,"w1819","Motorized",2,"Wed","weekday"
"5936",2019-01-30,"Snodgrass","2","2","1",8.3,0,37,-1,20,22.4,0,0,-1,-1,-1,-1,-2,-3,"w1819","Hybrid",0,"Wed","weekday"
"5937",2019-01-31,"Snodgrass","2","2","1",8.3,0,36,-1,24,23.1,-1,0,0,-1,-2,-2,-2,-3,"w1819","Non.motorized",49,"Thu","weekday"
"5938",2019-01-31,"Snodgrass","2","2","1",8.3,0,36,-1,24,23.1,-1,0,0,-1,-2,-2,-2,-3,"w1819","Mechanized",1,"Thu","weekday"
"5939",2019-01-31,"Snodgrass","2","2","1",8.3,0,36,-1,24,23.1,-1,0,0,-1,-2,-2,-2,-3,"w1819","Motorized",0,"Thu","weekday"
"5940",2019-01-31,"Snodgrass","2","2","1",8.3,0,36,-1,24,23.1,-1,0,0,-1,-2,-2,-2,-3,"w1819","Hybrid",0,"Thu","weekday"
"5941",2019-02-01,"Snodgrass","2","2","1",8.3,0,36,0,25,23.1,-1,-1,0,0,-1,-2,-2,-2,"w1819","Non.motorized",67,"Fri","weekday"
"5942",2019-02-01,"Snodgrass","2","2","1",8.3,0,36,0,25,23.1,-1,-1,0,0,-1,-2,-2,-2,"w1819","Mechanized",0,"Fri","weekday"
"5943",2019-02-01,"Snodgrass","2","2","1",8.3,0,36,0,25,23.1,-1,-1,0,0,-1,-2,-2,-2,"w1819","Motorized",0,"Fri","weekday"
"5944",2019-02-01,"Snodgrass","2","2","1",8.3,0,36,0,25,23.1,-1,-1,0,0,-1,-2,-2,-2,"w1819","Hybrid",0,"Fri","weekday"
"5945",2019-02-02,"Snodgrass","2","2","1",8.3,0,36,0,26,23.1,0,-1,-1,0,0,-1,-2,-2,"w1819","Non.motorized",141,"Sat","weekend"
"5946",2019-02-02,"Snodgrass","2","2","1",8.3,0,36,0,26,23.1,0,-1,-1,0,0,-1,-2,-2,"w1819","Mechanized",4,"Sat","weekend"
"5947",2019-02-02,"Snodgrass","2","2","1",8.3,0,36,0,26,23.1,0,-1,-1,0,0,-1,-2,-2,"w1819","Motorized",1,"Sat","weekend"
"5948",2019-02-02,"Snodgrass","2","2","1",8.3,0,36,0,26,23.1,0,-1,-1,0,0,-1,-2,-2,"w1819","Hybrid",0,"Sat","weekend"
"5949",2019-02-03,"Snodgrass","3","3","2",8.4,0.1,36,0,28,23.3,0,0,-1,-1,0,0,-1,-2,"w1819","Non.motorized",56,"Sun","weekend"
"5950",2019-02-03,"Snodgrass","3","3","2",8.4,0.1,36,0,28,23.3,0,0,-1,-1,0,0,-1,-2,"w1819","Mechanized",0,"Sun","weekend"
"5951",2019-02-03,"Snodgrass","3","3","2",8.4,0.1,36,0,28,23.3,0,0,-1,-1,0,0,-1,-2,"w1819","Motorized",0,"Sun","weekend"
"5952",2019-02-03,"Snodgrass","3","3","2",8.4,0.1,36,0,28,23.3,0,0,-1,-1,0,0,-1,-2,"w1819","Hybrid",0,"Sun","weekend"
"5953",2019-02-04,"Snodgrass","3","3","2",8.8,0.4,39,3,28,22.6,0,0,0,-1,3,3,3,2,"w1819","Non.motorized",51,"Mon","weekday"
"5954",2019-02-04,"Snodgrass","3","3","2",8.8,0.4,39,3,28,22.6,0,0,0,-1,3,3,3,2,"w1819","Mechanized",0,"Mon","weekday"
"5955",2019-02-04,"Snodgrass","3","3","2",8.8,0.4,39,3,28,22.6,0,0,0,-1,3,3,3,2,"w1819","Motorized",0,"Mon","weekday"
"5956",2019-02-04,"Snodgrass","3","3","2",8.8,0.4,39,3,28,22.6,0,0,0,-1,3,3,3,2,"w1819","Hybrid",0,"Mon","weekday"
"5957",2019-02-05,"Snodgrass","3","2","2",9,0.2,40,1,26,22.5,3,0,0,0,4,4,4,4,"w1819","Non.motorized",48,"Tue","weekday"
"5958",2019-02-05,"Snodgrass","3","2","2",9,0.2,40,1,26,22.5,3,0,0,0,4,4,4,4,"w1819","Mechanized",0,"Tue","weekday"
"5959",2019-02-05,"Snodgrass","3","2","2",9,0.2,40,1,26,22.5,3,0,0,0,4,4,4,4,"w1819","Motorized",0,"Tue","weekday"
"5960",2019-02-05,"Snodgrass","3","2","2",9,0.2,40,1,26,22.5,3,0,0,0,4,4,4,4,"w1819","Hybrid",0,"Tue","weekday"
"5961",2019-02-06,"Snodgrass","4","4","3",9,0,40,0,16,22.5,1,3,0,0,1,4,4,4,"w1819","Non.motorized",18,"Wed","weekday"
"5962",2019-02-06,"Snodgrass","4","4","3",9,0,40,0,16,22.5,1,3,0,0,1,4,4,4,"w1819","Mechanized",0,"Wed","weekday"
"5963",2019-02-06,"Snodgrass","4","4","3",9,0,40,0,16,22.5,1,3,0,0,1,4,4,4,"w1819","Motorized",0,"Wed","weekday"
"5964",2019-02-06,"Snodgrass","4","4","3",9,0,40,0,16,22.5,1,3,0,0,1,4,4,4,"w1819","Hybrid",0,"Wed","weekday"
"5965",2019-02-07,"Snodgrass","3","3","2",9.2,0.2,43,3,4,21.4,0,1,3,0,3,4,7,7,"w1819","Non.motorized",32,"Thu","weekday"
"5966",2019-02-07,"Snodgrass","3","3","2",9.2,0.2,43,3,4,21.4,0,1,3,0,3,4,7,7,"w1819","Mechanized",0,"Thu","weekday"
"5967",2019-02-07,"Snodgrass","3","3","2",9.2,0.2,43,3,4,21.4,0,1,3,0,3,4,7,7,"w1819","Motorized",0,"Thu","weekday"
"5968",2019-02-07,"Snodgrass","3","3","2",9.2,0.2,43,3,4,21.4,0,1,3,0,3,4,7,7,"w1819","Hybrid",0,"Thu","weekday"
"5969",2019-02-08,"Snodgrass","3","2","2",9.2,0,42,-1,10,21.9,3,0,1,3,2,2,3,6,"w1819","Non.motorized",59,"Fri","weekday"
"5970",2019-02-08,"Snodgrass","3","2","2",9.2,0,42,-1,10,21.9,3,0,1,3,2,2,3,6,"w1819","Mechanized",0,"Fri","weekday"
"5971",2019-02-08,"Snodgrass","3","2","2",9.2,0,42,-1,10,21.9,3,0,1,3,2,2,3,6,"w1819","Motorized",0,"Fri","weekday"
"5972",2019-02-08,"Snodgrass","3","2","2",9.2,0,42,-1,10,21.9,3,0,1,3,2,2,3,6,"w1819","Hybrid",0,"Fri","weekday"
"5973",2019-02-09,"Snodgrass","3","2","2",9.2,0,41,-1,20,22.4,-1,3,0,1,-2,1,1,2,"w1819","Non.motorized",108,"Sat","weekend"
"5974",2019-02-09,"Snodgrass","3","2","2",9.2,0,41,-1,20,22.4,-1,3,0,1,-2,1,1,2,"w1819","Mechanized",3,"Sat","weekend"
"5975",2019-02-09,"Snodgrass","3","2","2",9.2,0,41,-1,20,22.4,-1,3,0,1,-2,1,1,2,"w1819","Motorized",0,"Sat","weekend"
"5976",2019-02-09,"Snodgrass","3","2","2",9.2,0,41,-1,20,22.4,-1,3,0,1,-2,1,1,2,"w1819","Hybrid",0,"Sat","weekend"
"5977",2019-02-10,"Snodgrass","2","2","2",9.3,0.1,40,-1,20,23.2,-1,-1,3,0,-2,-3,0,0,"w1819","Non.motorized",99,"Sun","weekend"
"5978",2019-02-10,"Snodgrass","2","2","2",9.3,0.1,40,-1,20,23.2,-1,-1,3,0,-2,-3,0,0,"w1819","Mechanized",2,"Sun","weekend"
"5979",2019-02-10,"Snodgrass","2","2","2",9.3,0.1,40,-1,20,23.2,-1,-1,3,0,-2,-3,0,0,"w1819","Motorized",0,"Sun","weekend"
"5980",2019-02-10,"Snodgrass","2","2","2",9.3,0.1,40,-1,20,23.2,-1,-1,3,0,-2,-3,0,0,"w1819","Hybrid",0,"Sun","weekend"
"5981",2019-02-11,"Snodgrass","2","2","1",9.3,0,40,0,15,23.2,-1,-1,-1,3,-1,-2,-3,0,"w1819","Non.motorized",31,"Mon","weekday"
"5982",2019-02-11,"Snodgrass","2","2","1",9.3,0,40,0,15,23.2,-1,-1,-1,3,-1,-2,-3,0,"w1819","Mechanized",1,"Mon","weekday"
"5983",2019-02-11,"Snodgrass","2","2","1",9.3,0,40,0,15,23.2,-1,-1,-1,3,-1,-2,-3,0,"w1819","Motorized",0,"Mon","weekday"
"5984",2019-02-11,"Snodgrass","2","2","1",9.3,0,40,0,15,23.2,-1,-1,-1,3,-1,-2,-3,0,"w1819","Hybrid",0,"Mon","weekday"
"5985",2019-02-12,"Snodgrass","2","2","1",9.3,0,40,0,18,23.2,0,-1,-1,-1,0,-1,-2,-3,"w1819","Non.motorized",54,"Tue","weekday"
"5986",2019-02-12,"Snodgrass","2","2","1",9.3,0,40,0,18,23.2,0,-1,-1,-1,0,-1,-2,-3,"w1819","Mechanized",2,"Tue","weekday"
"5987",2019-02-12,"Snodgrass","2","2","1",9.3,0,40,0,18,23.2,0,-1,-1,-1,0,-1,-2,-3,"w1819","Motorized",0,"Tue","weekday"
"5988",2019-02-12,"Snodgrass","2","2","1",9.3,0,40,0,18,23.2,0,-1,-1,-1,0,-1,-2,-3,"w1819","Hybrid",0,"Tue","weekday"
"5989",2019-02-13,"Snodgrass","2","2","1",9.4,0.1,40,0,26,23.5,0,0,-1,-1,0,0,-1,-2,"w1819","Non.motorized",36,"Wed","weekday"
"5990",2019-02-13,"Snodgrass","2","2","1",9.4,0.1,40,0,26,23.5,0,0,-1,-1,0,0,-1,-2,"w1819","Mechanized",4,"Wed","weekday"
"5991",2019-02-13,"Snodgrass","2","2","1",9.4,0.1,40,0,26,23.5,0,0,-1,-1,0,0,-1,-2,"w1819","Motorized",0,"Wed","weekday"
"5992",2019-02-13,"Snodgrass","2","2","1",9.4,0.1,40,0,26,23.5,0,0,-1,-1,0,0,-1,-2,"w1819","Hybrid",0,"Wed","weekday"
"5993",2019-02-14,"Snodgrass","3","2","2",9.7,0.3,41,1,29,23.7,0,0,0,-1,1,1,1,0,"w1819","Non.motorized",15,"Thu","weekday"
"5994",2019-02-14,"Snodgrass","3","2","2",9.7,0.3,41,1,29,23.7,0,0,0,-1,1,1,1,0,"w1819","Mechanized",4,"Thu","weekday"
"5995",2019-02-14,"Snodgrass","3","2","2",9.7,0.3,41,1,29,23.7,0,0,0,-1,1,1,1,0,"w1819","Motorized",0,"Thu","weekday"
"5996",2019-02-14,"Snodgrass","3","2","2",9.7,0.3,41,1,29,23.7,0,0,0,-1,1,1,1,0,"w1819","Hybrid",0,"Thu","weekday"
"5997",2019-02-15,"Snodgrass","4","4","3",10.8,1.1,51,10,27,21.2,1,0,0,0,11,11,11,11,"w1819","Non.motorized",49,"Fri","weekday"
"5998",2019-02-15,"Snodgrass","4","4","3",10.8,1.1,51,10,27,21.2,1,0,0,0,11,11,11,11,"w1819","Mechanized",0,"Fri","weekday"
"5999",2019-02-15,"Snodgrass","4","4","3",10.8,1.1,51,10,27,21.2,1,0,0,0,11,11,11,11,"w1819","Motorized",1,"Fri","weekday"
"6000",2019-02-15,"Snodgrass","4","4","3",10.8,1.1,51,10,27,21.2,1,0,0,0,11,11,11,11,"w1819","Hybrid",0,"Fri","weekday"
"6001",2019-02-16,"Snodgrass","3","3","3",11.1,0.3,52,1,14,21.3,10,1,0,0,11,12,12,12,"w1819","Non.motorized",0,"Sat","weekend"
"6002",2019-02-16,"Snodgrass","3","3","3",11.1,0.3,52,1,14,21.3,10,1,0,0,11,12,12,12,"w1819","Mechanized",0,"Sat","weekend"
"6003",2019-02-16,"Snodgrass","3","3","3",11.1,0.3,52,1,14,21.3,10,1,0,0,11,12,12,12,"w1819","Motorized",0,"Sat","weekend"
"6004",2019-02-16,"Snodgrass","3","3","3",11.1,0.3,52,1,14,21.3,10,1,0,0,11,12,12,12,"w1819","Hybrid",0,"Sat","weekend"
"6005",2019-02-17,"Snodgrass","3","3","3",11.3,0.2,55,3,10,20.5,1,10,1,0,4,14,15,15,"w1819","Non.motorized",0,"Sun","weekend"
"6006",2019-02-17,"Snodgrass","3","3","3",11.3,0.2,55,3,10,20.5,1,10,1,0,4,14,15,15,"w1819","Mechanized",0,"Sun","weekend"
"6007",2019-02-17,"Snodgrass","3","3","3",11.3,0.2,55,3,10,20.5,1,10,1,0,4,14,15,15,"w1819","Motorized",0,"Sun","weekend"
"6008",2019-02-17,"Snodgrass","3","3","3",11.3,0.2,55,3,10,20.5,1,10,1,0,4,14,15,15,"w1819","Hybrid",0,"Sun","weekend"
"6009",2019-02-18,"Snodgrass","3","3","2",11.4,0.1,53,-2,13,21.5,3,1,10,1,1,2,12,13,"w1819","Non.motorized",0,"Mon","weekday"
"6010",2019-02-18,"Snodgrass","3","3","2",11.4,0.1,53,-2,13,21.5,3,1,10,1,1,2,12,13,"w1819","Mechanized",0,"Mon","weekday"
"6011",2019-02-18,"Snodgrass","3","3","2",11.4,0.1,53,-2,13,21.5,3,1,10,1,1,2,12,13,"w1819","Motorized",0,"Mon","weekday"
"6012",2019-02-18,"Snodgrass","3","3","2",11.4,0.1,53,-2,13,21.5,3,1,10,1,1,2,12,13,"w1819","Hybrid",0,"Mon","weekday"
"6013",2019-02-19,"Snodgrass","3","3","2",11.5,0.1,53,0,11,21.7,-2,3,1,10,-2,1,2,12,"w1819","Non.motorized",0,"Tue","weekday"
"6014",2019-02-19,"Snodgrass","3","3","2",11.5,0.1,53,0,11,21.7,-2,3,1,10,-2,1,2,12,"w1819","Mechanized",0,"Tue","weekday"
"6015",2019-02-19,"Snodgrass","3","3","2",11.5,0.1,53,0,11,21.7,-2,3,1,10,-2,1,2,12,"w1819","Motorized",0,"Tue","weekday"
"6016",2019-02-19,"Snodgrass","3","3","2",11.5,0.1,53,0,11,21.7,-2,3,1,10,-2,1,2,12,"w1819","Hybrid",0,"Tue","weekday"
"6017",2019-02-20,"Snodgrass","3","3","2",11.6,0.1,53,0,7,21.9,0,-2,3,1,0,-2,1,2,"w1819","Non.motorized",0,"Wed","weekday"
"6018",2019-02-20,"Snodgrass","3","3","2",11.6,0.1,53,0,7,21.9,0,-2,3,1,0,-2,1,2,"w1819","Mechanized",0,"Wed","weekday"
"6019",2019-02-20,"Snodgrass","3","3","2",11.6,0.1,53,0,7,21.9,0,-2,3,1,0,-2,1,2,"w1819","Motorized",0,"Wed","weekday"
"6020",2019-02-20,"Snodgrass","3","3","2",11.6,0.1,53,0,7,21.9,0,-2,3,1,0,-2,1,2,"w1819","Hybrid",0,"Wed","weekday"
"6021",2019-02-21,"Snodgrass","3","3","3",11.6,0,52,-1,15,22.3,0,0,-2,3,-1,-1,-3,0,"w1819","Non.motorized",0,"Thu","weekday"
"6022",2019-02-21,"Snodgrass","3","3","3",11.6,0,52,-1,15,22.3,0,0,-2,3,-1,-1,-3,0,"w1819","Mechanized",0,"Thu","weekday"
"6023",2019-02-21,"Snodgrass","3","3","3",11.6,0,52,-1,15,22.3,0,0,-2,3,-1,-1,-3,0,"w1819","Motorized",0,"Thu","weekday"
"6024",2019-02-21,"Snodgrass","3","3","3",11.6,0,52,-1,15,22.3,0,0,-2,3,-1,-1,-3,0,"w1819","Hybrid",0,"Thu","weekday"
"6025",2019-02-22,"Snodgrass","3","3","3",11.8,0.2,52,0,20,22.7,-1,0,0,-2,-1,-1,-1,-3,"w1819","Non.motorized",21,"Fri","weekday"
"6026",2019-02-22,"Snodgrass","3","3","3",11.8,0.2,52,0,20,22.7,-1,0,0,-2,-1,-1,-1,-3,"w1819","Mechanized",0,"Fri","weekday"
"6027",2019-02-22,"Snodgrass","3","3","3",11.8,0.2,52,0,20,22.7,-1,0,0,-2,-1,-1,-1,-3,"w1819","Motorized",0,"Fri","weekday"
"6028",2019-02-22,"Snodgrass","3","3","3",11.8,0.2,52,0,20,22.7,-1,0,0,-2,-1,-1,-1,-3,"w1819","Hybrid",0,"Fri","weekday"
"6029",2019-02-23,"Snodgrass","3","3","3",12.1,0.3,53,1,13,22.8,0,-1,0,0,1,0,0,0,"w1819","Non.motorized",218,"Sat","weekend"
"6030",2019-02-23,"Snodgrass","3","3","3",12.1,0.3,53,1,13,22.8,0,-1,0,0,1,0,0,0,"w1819","Mechanized",0,"Sat","weekend"
"6031",2019-02-23,"Snodgrass","3","3","3",12.1,0.3,53,1,13,22.8,0,-1,0,0,1,0,0,0,"w1819","Motorized",6,"Sat","weekend"
"6032",2019-02-23,"Snodgrass","3","3","3",12.1,0.3,53,1,13,22.8,0,-1,0,0,1,0,0,0,"w1819","Hybrid",0,"Sat","weekend"
"6033",2019-02-24,"Snodgrass","3","3","2",12.1,0,52,-1,14,23.3,1,0,-1,0,0,0,-1,-1,"w1819","Non.motorized",92,"Sun","weekend"
"6034",2019-02-24,"Snodgrass","3","3","2",12.1,0,52,-1,14,23.3,1,0,-1,0,0,0,-1,-1,"w1819","Mechanized",0,"Sun","weekend"
"6035",2019-02-24,"Snodgrass","3","3","2",12.1,0,52,-1,14,23.3,1,0,-1,0,0,0,-1,-1,"w1819","Motorized",0,"Sun","weekend"
"6036",2019-02-24,"Snodgrass","3","3","2",12.1,0,52,-1,14,23.3,1,0,-1,0,0,0,-1,-1,"w1819","Hybrid",0,"Sun","weekend"
"6037",2019-02-25,"Snodgrass","3","3","2",12.1,0,51,-1,22,23.7,-1,1,0,-1,-2,-1,-1,-2,"w1819","Non.motorized",45,"Mon","weekday"
"6038",2019-02-25,"Snodgrass","3","3","2",12.1,0,51,-1,22,23.7,-1,1,0,-1,-2,-1,-1,-2,"w1819","Mechanized",0,"Mon","weekday"
"6039",2019-02-25,"Snodgrass","3","3","2",12.1,0,51,-1,22,23.7,-1,1,0,-1,-2,-1,-1,-2,"w1819","Motorized",0,"Mon","weekday"
"6040",2019-02-25,"Snodgrass","3","3","2",12.1,0,51,-1,22,23.7,-1,1,0,-1,-2,-1,-1,-2,"w1819","Hybrid",0,"Mon","weekday"
"6041",2019-02-26,"Snodgrass","2","2","2",12.1,0,50,-1,27,24.2,-1,-1,1,0,-2,-3,-2,-2,"w1819","Non.motorized",54,"Tue","weekday"
"6042",2019-02-26,"Snodgrass","2","2","2",12.1,0,50,-1,27,24.2,-1,-1,1,0,-2,-3,-2,-2,"w1819","Mechanized",2,"Tue","weekday"
"6043",2019-02-26,"Snodgrass","2","2","2",12.1,0,50,-1,27,24.2,-1,-1,1,0,-2,-3,-2,-2,"w1819","Motorized",0,"Tue","weekday"
"6044",2019-02-26,"Snodgrass","2","2","2",12.1,0,50,-1,27,24.2,-1,-1,1,0,-2,-3,-2,-2,"w1819","Hybrid",0,"Tue","weekday"
"6045",2019-02-27,"Snodgrass","2","2","2",12.1,0,50,0,30,24.2,-1,-1,-1,1,-1,-2,-3,-2,"w1819","Non.motorized",43,"Wed","weekday"
"6046",2019-02-27,"Snodgrass","2","2","2",12.1,0,50,0,30,24.2,-1,-1,-1,1,-1,-2,-3,-2,"w1819","Mechanized",9,"Wed","weekday"
"6047",2019-02-27,"Snodgrass","2","2","2",12.1,0,50,0,30,24.2,-1,-1,-1,1,-1,-2,-3,-2,"w1819","Motorized",0,"Wed","weekday"
"6048",2019-02-27,"Snodgrass","2","2","2",12.1,0,50,0,30,24.2,-1,-1,-1,1,-1,-2,-3,-2,"w1819","Hybrid",0,"Wed","weekday"
"6049",2019-02-28,"Snodgrass","2","2","2",12.2,0.1,49,-1,30,24.9,0,-1,-1,-1,-1,-2,-3,-4,"w1819","Non.motorized",84,"Thu","weekday"
"6050",2019-02-28,"Snodgrass","2","2","2",12.2,0.1,49,-1,30,24.9,0,-1,-1,-1,-1,-2,-3,-4,"w1819","Mechanized",0,"Thu","weekday"
"6051",2019-02-28,"Snodgrass","2","2","2",12.2,0.1,49,-1,30,24.9,0,-1,-1,-1,-1,-2,-3,-4,"w1819","Motorized",0,"Thu","weekday"
"6052",2019-02-28,"Snodgrass","2","2","2",12.2,0.1,49,-1,30,24.9,0,-1,-1,-1,-1,-2,-3,-4,"w1819","Hybrid",0,"Thu","weekday"
"6053",2019-03-01,"Snodgrass","2","2","1",12.3,0.1,49,0,29,25.1,-1,0,-1,-1,-1,-1,-2,-3,"w1819","Non.motorized",22,"Fri","weekday"
"6054",2019-03-01,"Snodgrass","2","2","1",12.3,0.1,49,0,29,25.1,-1,0,-1,-1,-1,-1,-2,-3,"w1819","Mechanized",0,"Fri","weekday"
"6055",2019-03-01,"Snodgrass","2","2","1",12.3,0.1,49,0,29,25.1,-1,0,-1,-1,-1,-1,-2,-3,"w1819","Motorized",0,"Fri","weekday"
"6056",2019-03-01,"Snodgrass","2","2","1",12.3,0.1,49,0,29,25.1,-1,0,-1,-1,-1,-1,-2,-3,"w1819","Hybrid",0,"Fri","weekday"
"6057",2019-03-02,"Snodgrass","3","3","2",13,0.7,58,9,30,22.4,0,-1,0,-1,9,8,8,7,"w1819","Non.motorized",64,"Sat","weekend"
"6058",2019-03-02,"Snodgrass","3","3","2",13,0.7,58,9,30,22.4,0,-1,0,-1,9,8,8,7,"w1819","Mechanized",0,"Sat","weekend"
"6059",2019-03-02,"Snodgrass","3","3","2",13,0.7,58,9,30,22.4,0,-1,0,-1,9,8,8,7,"w1819","Motorized",0,"Sat","weekend"
"6060",2019-03-02,"Snodgrass","3","3","2",13,0.7,58,9,30,22.4,0,-1,0,-1,9,8,8,7,"w1819","Hybrid",0,"Sat","weekend"
"6061",2019-03-03,"Snodgrass","3","3","3",13.7,0.7,64,6,27,21.4,9,0,-1,0,15,15,14,14,"w1819","Non.motorized",8,"Sun","weekend"
"6062",2019-03-03,"Snodgrass","3","3","3",13.7,0.7,64,6,27,21.4,9,0,-1,0,15,15,14,14,"w1819","Mechanized",0,"Sun","weekend"
"6063",2019-03-03,"Snodgrass","3","3","3",13.7,0.7,64,6,27,21.4,9,0,-1,0,15,15,14,14,"w1819","Motorized",0,"Sun","weekend"
"6064",2019-03-03,"Snodgrass","3","3","3",13.7,0.7,64,6,27,21.4,9,0,-1,0,15,15,14,14,"w1819","Hybrid",0,"Sun","weekend"
"6065",2019-03-04,"Snodgrass","3","3","3",14.4,0.7,66,2,23,21.8,6,9,0,-1,8,17,17,16,"w1819","Non.motorized",10,"Mon","weekday"
"6066",2019-03-04,"Snodgrass","3","3","3",14.4,0.7,66,2,23,21.8,6,9,0,-1,8,17,17,16,"w1819","Mechanized",0,"Mon","weekday"
"6067",2019-03-04,"Snodgrass","3","3","3",14.4,0.7,66,2,23,21.8,6,9,0,-1,8,17,17,16,"w1819","Motorized",0,"Mon","weekday"
"6068",2019-03-04,"Snodgrass","3","3","3",14.4,0.7,66,2,23,21.8,6,9,0,-1,8,17,17,16,"w1819","Hybrid",0,"Mon","weekday"
"6069",2019-03-05,"Snodgrass","3","3","3",14.4,0,64,-2,24,22.5,2,6,9,0,0,6,15,15,"w1819","Non.motorized",42,"Tue","weekday"
"6070",2019-03-05,"Snodgrass","3","3","3",14.4,0,64,-2,24,22.5,2,6,9,0,0,6,15,15,"w1819","Mechanized",0,"Tue","weekday"
"6071",2019-03-05,"Snodgrass","3","3","3",14.4,0,64,-2,24,22.5,2,6,9,0,0,6,15,15,"w1819","Motorized",0,"Tue","weekday"
"6072",2019-03-05,"Snodgrass","3","3","3",14.4,0,64,-2,24,22.5,2,6,9,0,0,6,15,15,"w1819","Hybrid",0,"Tue","weekday"
"6073",2019-03-06,"Snodgrass","3","3","2",14.5,0.1,62,-2,31,23.4,-2,2,6,9,-4,-2,4,13,"w1819","Non.motorized",6,"Wed","weekday"
"6074",2019-03-06,"Snodgrass","3","3","2",14.5,0.1,62,-2,31,23.4,-2,2,6,9,-4,-2,4,13,"w1819","Mechanized",0,"Wed","weekday"
"6075",2019-03-06,"Snodgrass","3","3","2",14.5,0.1,62,-2,31,23.4,-2,2,6,9,-4,-2,4,13,"w1819","Motorized",0,"Wed","weekday"
"6076",2019-03-06,"Snodgrass","3","3","2",14.5,0.1,62,-2,31,23.4,-2,2,6,9,-4,-2,4,13,"w1819","Hybrid",0,"Wed","weekday"
"6077",2019-03-06,"Snodgrass","4","4","3",14.5,0.1,62,-2,31,23.4,-2,2,6,9,-4,-2,4,13,"w1819","Non.motorized",6,"Wed","weekday"
"6078",2019-03-06,"Snodgrass","4","4","3",14.5,0.1,62,-2,31,23.4,-2,2,6,9,-4,-2,4,13,"w1819","Mechanized",0,"Wed","weekday"
"6079",2019-03-06,"Snodgrass","4","4","3",14.5,0.1,62,-2,31,23.4,-2,2,6,9,-4,-2,4,13,"w1819","Motorized",0,"Wed","weekday"
"6080",2019-03-06,"Snodgrass","4","4","3",14.5,0.1,62,-2,31,23.4,-2,2,6,9,-4,-2,4,13,"w1819","Hybrid",0,"Wed","weekday"
"6081",2019-03-07,"Snodgrass","4","4","3",16.2,1.7,71,9,30,22.8,-2,-2,2,6,7,5,7,13,"w1819","Non.motorized",3,"Thu","weekday"
"6082",2019-03-07,"Snodgrass","4","4","3",16.2,1.7,71,9,30,22.8,-2,-2,2,6,7,5,7,13,"w1819","Mechanized",0,"Thu","weekday"
"6083",2019-03-07,"Snodgrass","4","4","3",16.2,1.7,71,9,30,22.8,-2,-2,2,6,7,5,7,13,"w1819","Motorized",0,"Thu","weekday"
"6084",2019-03-07,"Snodgrass","4","4","3",16.2,1.7,71,9,30,22.8,-2,-2,2,6,7,5,7,13,"w1819","Hybrid",0,"Thu","weekday"
"6085",2019-03-08,"Snodgrass","3","3","3",16.6,0.4,71,0,27,23.4,9,-2,-2,2,9,7,5,7,"w1819","Non.motorized",29,"Fri","weekday"
"6086",2019-03-08,"Snodgrass","3","3","3",16.6,0.4,71,0,27,23.4,9,-2,-2,2,9,7,5,7,"w1819","Mechanized",0,"Fri","weekday"
"6087",2019-03-08,"Snodgrass","3","3","3",16.6,0.4,71,0,27,23.4,9,-2,-2,2,9,7,5,7,"w1819","Motorized",0,"Fri","weekday"
"6088",2019-03-08,"Snodgrass","3","3","3",16.6,0.4,71,0,27,23.4,9,-2,-2,2,9,7,5,7,"w1819","Hybrid",0,"Fri","weekday"
"6089",2019-03-09,"Snodgrass","4","4","3",17.2,0.6,76,5,22,22.6,0,9,-2,-2,5,14,12,10,"w1819","Non.motorized",10,"Sat","weekend"
"6090",2019-03-09,"Snodgrass","4","4","3",17.2,0.6,76,5,22,22.6,0,9,-2,-2,5,14,12,10,"w1819","Mechanized",0,"Sat","weekend"
"6091",2019-03-09,"Snodgrass","4","4","3",17.2,0.6,76,5,22,22.6,0,9,-2,-2,5,14,12,10,"w1819","Motorized",0,"Sat","weekend"
"6092",2019-03-09,"Snodgrass","4","4","3",17.2,0.6,76,5,22,22.6,0,9,-2,-2,5,14,12,10,"w1819","Hybrid",0,"Sat","weekend"
"6093",2019-03-10,"Snodgrass","3","3","3",17.3,0.1,73,-3,25,23.7,5,0,9,-2,2,2,11,9,"w1819","Non.motorized",40,"Sun","weekend"
"6094",2019-03-10,"Snodgrass","3","3","3",17.3,0.1,73,-3,25,23.7,5,0,9,-2,2,2,11,9,"w1819","Mechanized",0,"Sun","weekend"
"6095",2019-03-10,"Snodgrass","3","3","3",17.3,0.1,73,-3,25,23.7,5,0,9,-2,2,2,11,9,"w1819","Motorized",0,"Sun","weekend"
"6096",2019-03-10,"Snodgrass","3","3","3",17.3,0.1,73,-3,25,23.7,5,0,9,-2,2,2,11,9,"w1819","Hybrid",0,"Sun","weekend"
"6097",2019-03-11,"Snodgrass","3","3","2",17.3,0,71,-2,29,24.4,-3,5,0,9,-5,0,0,9,"w1819","Non.motorized",41,"Mon","weekday"
"6098",2019-03-11,"Snodgrass","3","3","2",17.3,0,71,-2,29,24.4,-3,5,0,9,-5,0,0,9,"w1819","Mechanized",0,"Mon","weekday"
"6099",2019-03-11,"Snodgrass","3","3","2",17.3,0,71,-2,29,24.4,-3,5,0,9,-5,0,0,9,"w1819","Motorized",0,"Mon","weekday"
"6100",2019-03-11,"Snodgrass","3","3","2",17.3,0,71,-2,29,24.4,-3,5,0,9,-5,0,0,9,"w1819","Hybrid",0,"Mon","weekday"
"6101",2019-03-12,"Snodgrass","3","3","3",17.4,0.1,70,-1,32,24.9,-2,-3,5,0,-3,-6,-1,-1,"w1819","Non.motorized",35,"Tue","weekday"
"6102",2019-03-12,"Snodgrass","3","3","3",17.4,0.1,70,-1,32,24.9,-2,-3,5,0,-3,-6,-1,-1,"w1819","Mechanized",1,"Tue","weekday"
"6103",2019-03-12,"Snodgrass","3","3","3",17.4,0.1,70,-1,32,24.9,-2,-3,5,0,-3,-6,-1,-1,"w1819","Motorized",0,"Tue","weekday"
"6104",2019-03-12,"Snodgrass","3","3","3",17.4,0.1,70,-1,32,24.9,-2,-3,5,0,-3,-6,-1,-1,"w1819","Hybrid",0,"Tue","weekday"
"6105",2019-03-12,"Snodgrass","4","4","4",17.4,0.1,70,-1,32,24.9,-2,-3,5,0,-3,-6,-1,-1,"w1819","Non.motorized",35,"Tue","weekday"
"6106",2019-03-12,"Snodgrass","4","4","4",17.4,0.1,70,-1,32,24.9,-2,-3,5,0,-3,-6,-1,-1,"w1819","Mechanized",1,"Tue","weekday"
"6107",2019-03-12,"Snodgrass","4","4","4",17.4,0.1,70,-1,32,24.9,-2,-3,5,0,-3,-6,-1,-1,"w1819","Motorized",0,"Tue","weekday"
"6108",2019-03-12,"Snodgrass","4","4","4",17.4,0.1,70,-1,32,24.9,-2,-3,5,0,-3,-6,-1,-1,"w1819","Hybrid",0,"Tue","weekday"
"6109",2019-03-13,"Snodgrass","4","4","3",18.1,0.7,74,4,24,24.5,-1,-2,-3,5,3,1,-2,3,"w1819","Non.motorized",21,"Wed","weekday"
"6110",2019-03-13,"Snodgrass","4","4","3",18.1,0.7,74,4,24,24.5,-1,-2,-3,5,3,1,-2,3,"w1819","Mechanized",0,"Wed","weekday"
"6111",2019-03-13,"Snodgrass","4","4","3",18.1,0.7,74,4,24,24.5,-1,-2,-3,5,3,1,-2,3,"w1819","Motorized",0,"Wed","weekday"
"6112",2019-03-13,"Snodgrass","4","4","3",18.1,0.7,74,4,24,24.5,-1,-2,-3,5,3,1,-2,3,"w1819","Hybrid",0,"Wed","weekday"
"6113",2019-03-14,"Snodgrass","4","4","3",18.1,0,74,0,17,24.5,4,-1,-2,-3,4,3,1,-2,"w1819","Non.motorized",31,"Thu","weekday"
"6114",2019-03-14,"Snodgrass","4","4","3",18.1,0,74,0,17,24.5,4,-1,-2,-3,4,3,1,-2,"w1819","Mechanized",0,"Thu","weekday"
"6115",2019-03-14,"Snodgrass","4","4","3",18.1,0,74,0,17,24.5,4,-1,-2,-3,4,3,1,-2,"w1819","Motorized",3,"Thu","weekday"
"6116",2019-03-14,"Snodgrass","4","4","3",18.1,0,74,0,17,24.5,4,-1,-2,-3,4,3,1,-2,"w1819","Hybrid",0,"Thu","weekday"
"6117",2019-03-15,"Snodgrass","3","3","2",18.1,0,72,-2,18,25.1,0,4,-1,-2,-2,2,1,-1,"w1819","Non.motorized",65,"Fri","weekday"
"6118",2019-03-15,"Snodgrass","3","3","2",18.1,0,72,-2,18,25.1,0,4,-1,-2,-2,2,1,-1,"w1819","Mechanized",0,"Fri","weekday"
"6119",2019-03-15,"Snodgrass","3","3","2",18.1,0,72,-2,18,25.1,0,4,-1,-2,-2,2,1,-1,"w1819","Motorized",0,"Fri","weekday"
"6120",2019-03-15,"Snodgrass","3","3","2",18.1,0,72,-2,18,25.1,0,4,-1,-2,-2,2,1,-1,"w1819","Hybrid",0,"Fri","weekday"
"6121",2019-03-16,"Snodgrass","3","3","2",18.2,0.1,70,-2,26,26,-2,0,4,-1,-4,-4,0,-1,"w1819","Non.motorized",114,"Sat","weekend"
"6122",2019-03-16,"Snodgrass","3","3","2",18.2,0.1,70,-2,26,26,-2,0,4,-1,-4,-4,0,-1,"w1819","Mechanized",1,"Sat","weekend"
"6123",2019-03-16,"Snodgrass","3","3","2",18.2,0.1,70,-2,26,26,-2,0,4,-1,-4,-4,0,-1,"w1819","Motorized",4,"Sat","weekend"
"6124",2019-03-16,"Snodgrass","3","3","2",18.2,0.1,70,-2,26,26,-2,0,4,-1,-4,-4,0,-1,"w1819","Hybrid",0,"Sat","weekend"
"6125",2019-03-17,"Snodgrass","3","3","2",18.2,0,69,-1,28,26.4,-2,-2,0,4,-3,-5,-5,-1,"w1819","Non.motorized",106,"Sun","weekend"
"6126",2019-03-17,"Snodgrass","3","3","2",18.2,0,69,-1,28,26.4,-2,-2,0,4,-3,-5,-5,-1,"w1819","Mechanized",11,"Sun","weekend"
"6127",2019-03-17,"Snodgrass","3","3","2",18.2,0,69,-1,28,26.4,-2,-2,0,4,-3,-5,-5,-1,"w1819","Motorized",1,"Sun","weekend"
"6128",2019-03-17,"Snodgrass","3","3","2",18.2,0,69,-1,28,26.4,-2,-2,0,4,-3,-5,-5,-1,"w1819","Hybrid",0,"Sun","weekend"
"6129",2019-03-18,"Snodgrass","2","2","2",18.3,0.1,68,-1,29,26.9,-1,-2,-2,0,-2,-4,-6,-6,"w1819","Non.motorized",47,"Mon","weekday"
"6130",2019-03-18,"Snodgrass","2","2","2",18.3,0.1,68,-1,29,26.9,-1,-2,-2,0,-2,-4,-6,-6,"w1819","Mechanized",0,"Mon","weekday"
"6131",2019-03-18,"Snodgrass","2","2","2",18.3,0.1,68,-1,29,26.9,-1,-2,-2,0,-2,-4,-6,-6,"w1819","Motorized",0,"Mon","weekday"
"6132",2019-03-18,"Snodgrass","2","2","2",18.3,0.1,68,-1,29,26.9,-1,-2,-2,0,-2,-4,-6,-6,"w1819","Hybrid",0,"Mon","weekday"
"6133",2019-03-19,"Snodgrass","2","2","2",18.3,0,67,-1,28,27.3,-1,-1,-2,-2,-2,-3,-5,-7,"w1819","Non.motorized",39,"Tue","weekday"
"6134",2019-03-19,"Snodgrass","2","2","2",18.3,0,67,-1,28,27.3,-1,-1,-2,-2,-2,-3,-5,-7,"w1819","Mechanized",3,"Tue","weekday"
"6135",2019-03-19,"Snodgrass","2","2","2",18.3,0,67,-1,28,27.3,-1,-1,-2,-2,-2,-3,-5,-7,"w1819","Motorized",3,"Tue","weekday"
"6136",2019-03-19,"Snodgrass","2","2","2",18.3,0,67,-1,28,27.3,-1,-1,-2,-2,-2,-3,-5,-7,"w1819","Hybrid",0,"Tue","weekday"
"6137",2019-03-20,"Snodgrass","2","2","2",18.3,0,66,-1,30,27.7,-1,-1,-1,-2,-2,-3,-4,-6,"w1819","Non.motorized",65,"Wed","weekday"
"6138",2019-03-20,"Snodgrass","2","2","2",18.3,0,66,-1,30,27.7,-1,-1,-1,-2,-2,-3,-4,-6,"w1819","Mechanized",6,"Wed","weekday"
"6139",2019-03-20,"Snodgrass","2","2","2",18.3,0,66,-1,30,27.7,-1,-1,-1,-2,-2,-3,-4,-6,"w1819","Motorized",0,"Wed","weekday"
"6140",2019-03-20,"Snodgrass","2","2","2",18.3,0,66,-1,30,27.7,-1,-1,-1,-2,-2,-3,-4,-6,"w1819","Hybrid",0,"Wed","weekday"
"6141",2019-03-21,"Snodgrass","2","2","2",18.4,0.1,65,-1,33,28.3,-1,-1,-1,-1,-2,-3,-4,-5,"w1819","Non.motorized",73,"Thu","weekday"
"6142",2019-03-21,"Snodgrass","2","2","2",18.4,0.1,65,-1,33,28.3,-1,-1,-1,-1,-2,-3,-4,-5,"w1819","Mechanized",0,"Thu","weekday"
"6143",2019-03-21,"Snodgrass","2","2","2",18.4,0.1,65,-1,33,28.3,-1,-1,-1,-1,-2,-3,-4,-5,"w1819","Motorized",3,"Thu","weekday"
"6144",2019-03-21,"Snodgrass","2","2","2",18.4,0.1,65,-1,33,28.3,-1,-1,-1,-1,-2,-3,-4,-5,"w1819","Hybrid",0,"Thu","weekday"
"6145",2019-03-22,"Snodgrass","3","3","2",18.4,0,64,-1,28,28.8,-1,-1,-1,-1,-2,-3,-4,-5,"w1819","Non.motorized",51,"Fri","weekday"
"6146",2019-03-22,"Snodgrass","3","3","2",18.4,0,64,-1,28,28.8,-1,-1,-1,-1,-2,-3,-4,-5,"w1819","Mechanized",1,"Fri","weekday"
"6147",2019-03-22,"Snodgrass","3","3","2",18.4,0,64,-1,28,28.8,-1,-1,-1,-1,-2,-3,-4,-5,"w1819","Motorized",0,"Fri","weekday"
"6148",2019-03-22,"Snodgrass","3","3","2",18.4,0,64,-1,28,28.8,-1,-1,-1,-1,-2,-3,-4,-5,"w1819","Hybrid",0,"Fri","weekday"
"6149",2019-03-23,"Snodgrass","2","2","1",18.4,0,65,1,28,28.3,-1,-1,-1,-1,0,-1,-2,-3,"w1819","Non.motorized",94,"Sat","weekend"
"6150",2019-03-23,"Snodgrass","2","2","1",18.4,0,65,1,28,28.3,-1,-1,-1,-1,0,-1,-2,-3,"w1819","Mechanized",2,"Sat","weekend"
"6151",2019-03-23,"Snodgrass","2","2","1",18.4,0,65,1,28,28.3,-1,-1,-1,-1,0,-1,-2,-3,"w1819","Motorized",0,"Sat","weekend"
"6152",2019-03-23,"Snodgrass","2","2","1",18.4,0,65,1,28,28.3,-1,-1,-1,-1,0,-1,-2,-3,"w1819","Hybrid",0,"Sat","weekend"
"6153",2019-03-24,"Snodgrass","2","2","1",18.4,0,64,-1,29,28.8,1,-1,-1,-1,0,-1,-2,-3,"w1819","Non.motorized",53,"Sun","weekend"
"6154",2019-03-24,"Snodgrass","2","2","1",18.4,0,64,-1,29,28.8,1,-1,-1,-1,0,-1,-2,-3,"w1819","Mechanized",3,"Sun","weekend"
"6155",2019-03-24,"Snodgrass","2","2","1",18.4,0,64,-1,29,28.8,1,-1,-1,-1,0,-1,-2,-3,"w1819","Motorized",0,"Sun","weekend"
"6156",2019-03-24,"Snodgrass","2","2","1",18.4,0,64,-1,29,28.8,1,-1,-1,-1,0,-1,-2,-3,"w1819","Hybrid",0,"Sun","weekend"
"6157",2019-03-25,"Snodgrass","2","2","2",18.6,0.2,64,0,31,29.1,-1,1,-1,-1,-1,0,-1,-2,"w1819","Non.motorized",33,"Mon","weekday"
"6158",2019-03-25,"Snodgrass","2","2","2",18.6,0.2,64,0,31,29.1,-1,1,-1,-1,-1,0,-1,-2,"w1819","Mechanized",0,"Mon","weekday"
"6159",2019-03-25,"Snodgrass","2","2","2",18.6,0.2,64,0,31,29.1,-1,1,-1,-1,-1,0,-1,-2,"w1819","Motorized",1,"Mon","weekday"
"6160",2019-03-25,"Snodgrass","2","2","2",18.6,0.2,64,0,31,29.1,-1,1,-1,-1,-1,0,-1,-2,"w1819","Hybrid",0,"Mon","weekday"
"6161",2019-03-26,"Snodgrass","2","2","2",18.9,0.3,63,-1,36,30,0,-1,1,-1,-1,-2,-1,-2,"w1819","Non.motorized",70,"Tue","weekday"
"6162",2019-03-26,"Snodgrass","2","2","2",18.9,0.3,63,-1,36,30,0,-1,1,-1,-1,-2,-1,-2,"w1819","Mechanized",0,"Tue","weekday"
"6163",2019-03-26,"Snodgrass","2","2","2",18.9,0.3,63,-1,36,30,0,-1,1,-1,-1,-2,-1,-2,"w1819","Motorized",0,"Tue","weekday"
"6164",2019-03-26,"Snodgrass","2","2","2",18.9,0.3,63,-1,36,30,0,-1,1,-1,-1,-2,-1,-2,"w1819","Hybrid",0,"Tue","weekday"
"6165",2019-03-27,"Snodgrass","1","2","2",18.9,0,62,-1,42,30.5,-1,0,-1,1,-2,-2,-3,-2,"w1819","Non.motorized",64,"Wed","weekday"
"6166",2019-03-27,"Snodgrass","1","2","2",18.9,0,62,-1,42,30.5,-1,0,-1,1,-2,-2,-3,-2,"w1819","Mechanized",5,"Wed","weekday"
"6167",2019-03-27,"Snodgrass","1","2","2",18.9,0,62,-1,42,30.5,-1,0,-1,1,-2,-2,-3,-2,"w1819","Motorized",3,"Wed","weekday"
"6168",2019-03-27,"Snodgrass","1","2","2",18.9,0,62,-1,42,30.5,-1,0,-1,1,-2,-2,-3,-2,"w1819","Hybrid",0,"Wed","weekday"
"6169",2019-03-28,"Snodgrass","1","2","2",18.9,0,60,-2,40,31.5,-1,-1,0,-1,-3,-4,-4,-5,"w1819","Non.motorized",55,"Thu","weekday"
"6170",2019-03-28,"Snodgrass","1","2","2",18.9,0,60,-2,40,31.5,-1,-1,0,-1,-3,-4,-4,-5,"w1819","Mechanized",1,"Thu","weekday"
"6171",2019-03-28,"Snodgrass","1","2","2",18.9,0,60,-2,40,31.5,-1,-1,0,-1,-3,-4,-4,-5,"w1819","Motorized",0,"Thu","weekday"
"6172",2019-03-28,"Snodgrass","1","2","2",18.9,0,60,-2,40,31.5,-1,-1,0,-1,-3,-4,-4,-5,"w1819","Hybrid",0,"Thu","weekday"
"6173",2019-03-29,"Snodgrass","1","1","1",19,0.1,58,-2,26,32.8,-2,-1,-1,0,-4,-5,-6,-6,"w1819","Non.motorized",36,"Fri","weekday"
"6174",2019-03-29,"Snodgrass","1","1","1",19,0.1,58,-2,26,32.8,-2,-1,-1,0,-4,-5,-6,-6,"w1819","Mechanized",0,"Fri","weekday"
"6175",2019-03-29,"Snodgrass","1","1","1",19,0.1,58,-2,26,32.8,-2,-1,-1,0,-4,-5,-6,-6,"w1819","Motorized",0,"Fri","weekday"
"6176",2019-03-29,"Snodgrass","1","1","1",19,0.1,58,-2,26,32.8,-2,-1,-1,0,-4,-5,-6,-6,"w1819","Hybrid",0,"Fri","weekday"
"6177",2019-03-30,"Snodgrass","1","1","1",19.1,0.1,61,3,24,31.3,-2,-2,-1,-1,1,-1,-2,-3,"w1819","Non.motorized",100,"Sat","weekend"
"6178",2019-03-30,"Snodgrass","1","1","1",19.1,0.1,61,3,24,31.3,-2,-2,-1,-1,1,-1,-2,-3,"w1819","Mechanized",2,"Sat","weekend"
"6179",2019-03-30,"Snodgrass","1","1","1",19.1,0.1,61,3,24,31.3,-2,-2,-1,-1,1,-1,-2,-3,"w1819","Motorized",5,"Sat","weekend"
"6180",2019-03-30,"Snodgrass","1","1","1",19.1,0.1,61,3,24,31.3,-2,-2,-1,-1,1,-1,-2,-3,"w1819","Hybrid",0,"Sat","weekend"
"6181",2019-03-31,"Snodgrass","1","1","1",19.1,0,59,-2,24,32.4,3,-2,-2,-1,1,-1,-3,-4,"w1819","Non.motorized",41,"Sun","weekend"
"6182",2019-03-31,"Snodgrass","1","1","1",19.1,0,59,-2,24,32.4,3,-2,-2,-1,1,-1,-3,-4,"w1819","Mechanized",3,"Sun","weekend"
"6183",2019-03-31,"Snodgrass","1","1","1",19.1,0,59,-2,24,32.4,3,-2,-2,-1,1,-1,-3,-4,"w1819","Motorized",7,"Sun","weekend"
"6184",2019-03-31,"Snodgrass","1","1","1",19.1,0,59,-2,24,32.4,3,-2,-2,-1,1,-1,-3,-4,"w1819","Hybrid",0,"Sun","weekend"
"6185",2019-04-01,"Snodgrass","2","1","1",19.1,0,58,-1,29,32.9,-2,3,-2,-2,-3,0,-2,-4,"w1819","Non.motorized",37,"Mon","weekday"
"6186",2019-04-01,"Snodgrass","2","1","1",19.1,0,58,-1,29,32.9,-2,3,-2,-2,-3,0,-2,-4,"w1819","Mechanized",4,"Mon","weekday"
"6187",2019-04-01,"Snodgrass","2","1","1",19.1,0,58,-1,29,32.9,-2,3,-2,-2,-3,0,-2,-4,"w1819","Motorized",7,"Mon","weekday"
"6188",2019-04-01,"Snodgrass","2","1","1",19.1,0,58,-1,29,32.9,-2,3,-2,-2,-3,0,-2,-4,"w1819","Hybrid",0,"Mon","weekday"
"6189",2019-04-02,"Snodgrass","1","1","1",19.1,0,58,0,33,32.9,-1,-2,3,-2,-1,-3,0,-2,"w1819","Non.motorized",24,"Tue","weekday"
"6190",2019-04-02,"Snodgrass","1","1","1",19.1,0,58,0,33,32.9,-1,-2,3,-2,-1,-3,0,-2,"w1819","Mechanized",0,"Tue","weekday"
"6191",2019-04-02,"Snodgrass","1","1","1",19.1,0,58,0,33,32.9,-1,-2,3,-2,-1,-3,0,-2,"w1819","Motorized",0,"Tue","weekday"
"6192",2019-04-02,"Snodgrass","1","1","1",19.1,0,58,0,33,32.9,-1,-2,3,-2,-1,-3,0,-2,"w1819","Hybrid",0,"Tue","weekday"
"6193",2019-04-03,"Snodgrass","2","1","1",19.2,0.1,58,0,31,33.1,0,-1,-2,3,0,-1,-3,0,"w1819","Non.motorized",23,"Wed","weekday"
"6194",2019-04-03,"Snodgrass","2","1","1",19.2,0.1,58,0,31,33.1,0,-1,-2,3,0,-1,-3,0,"w1819","Mechanized",0,"Wed","weekday"
"6195",2019-04-03,"Snodgrass","2","1","1",19.2,0.1,58,0,31,33.1,0,-1,-2,3,0,-1,-3,0,"w1819","Motorized",2,"Wed","weekday"
"6196",2019-04-03,"Snodgrass","2","1","1",19.2,0.1,58,0,31,33.1,0,-1,-2,3,0,-1,-3,0,"w1819","Hybrid",0,"Wed","weekday"
"6197",2019-04-04,"Snodgrass","2","1","1",19.4,0.2,59,1,35,32.9,0,0,-1,-2,1,1,0,-2,"w1819","Non.motorized",43,"Thu","weekday"
"6198",2019-04-04,"Snodgrass","2","1","1",19.4,0.2,59,1,35,32.9,0,0,-1,-2,1,1,0,-2,"w1819","Mechanized",0,"Thu","weekday"
"6199",2019-04-04,"Snodgrass","2","1","1",19.4,0.2,59,1,35,32.9,0,0,-1,-2,1,1,0,-2,"w1819","Motorized",0,"Thu","weekday"
"6200",2019-04-04,"Snodgrass","2","1","1",19.4,0.2,59,1,35,32.9,0,0,-1,-2,1,1,0,-2,"w1819","Hybrid",0,"Thu","weekday"
"6201",2019-04-05,"Snodgrass","1","1","1",19.4,0,57,-2,38,34,1,0,0,-1,-1,-1,-1,-2,"w1819","Non.motorized",29,"Fri","weekday"
"6202",2019-04-05,"Snodgrass","1","1","1",19.4,0,57,-2,38,34,1,0,0,-1,-1,-1,-1,-2,"w1819","Mechanized",0,"Fri","weekday"
"6203",2019-04-05,"Snodgrass","1","1","1",19.4,0,57,-2,38,34,1,0,0,-1,-1,-1,-1,-2,"w1819","Motorized",1,"Fri","weekday"
"6204",2019-04-05,"Snodgrass","1","1","1",19.4,0,57,-2,38,34,1,0,0,-1,-1,-1,-1,-2,"w1819","Hybrid",0,"Fri","weekday"
"6205",2019-04-06,"Snodgrass","1","1","1",19.3,-0.1,57,0,35,33.9,-2,1,0,0,-2,-1,-1,-1,"w1819","Non.motorized",42,"Sat","weekend"
"6206",2019-04-06,"Snodgrass","1","1","1",19.3,-0.1,57,0,35,33.9,-2,1,0,0,-2,-1,-1,-1,"w1819","Mechanized",1,"Sat","weekend"
"6207",2019-04-06,"Snodgrass","1","1","1",19.3,-0.1,57,0,35,33.9,-2,1,0,0,-2,-1,-1,-1,"w1819","Motorized",4,"Sat","weekend"
"6208",2019-04-06,"Snodgrass","1","1","1",19.3,-0.1,57,0,35,33.9,-2,1,0,0,-2,-1,-1,-1,"w1819","Hybrid",0,"Sat","weekend"
"6209",2019-04-07,"Snodgrass","1","1","1",19.1,-0.2,57,0,37,33.5,0,-2,1,0,0,-2,-1,-1,"w1819","Non.motorized",37,"Sun","weekend"
"6210",2019-04-07,"Snodgrass","1","1","1",19.1,-0.2,57,0,37,33.5,0,-2,1,0,0,-2,-1,-1,"w1819","Mechanized",2,"Sun","weekend"
"6211",2019-04-07,"Snodgrass","1","1","1",19.1,-0.2,57,0,37,33.5,0,-2,1,0,0,-2,-1,-1,"w1819","Motorized",3,"Sun","weekend"
"6212",2019-04-07,"Snodgrass","1","1","1",19.1,-0.2,57,0,37,33.5,0,-2,1,0,0,-2,-1,-1,"w1819","Hybrid",0,"Sun","weekend"
"6213",2019-04-08,"Snodgrass","1","2","2",19.3,0.2,54,-3,41,35.7,0,0,-2,1,-3,-3,-5,-4,"w1819","Non.motorized",30,"Mon","weekday"
"6214",2019-04-08,"Snodgrass","1","2","2",19.3,0.2,54,-3,41,35.7,0,0,-2,1,-3,-3,-5,-4,"w1819","Mechanized",0,"Mon","weekday"
"6215",2019-04-08,"Snodgrass","1","2","2",19.3,0.2,54,-3,41,35.7,0,0,-2,1,-3,-3,-5,-4,"w1819","Motorized",9,"Mon","weekday"
"6216",2019-04-08,"Snodgrass","1","2","2",19.3,0.2,54,-3,41,35.7,0,0,-2,1,-3,-3,-5,-4,"w1819","Hybrid",4,"Mon","weekday"
"6217",2019-04-09,"Snodgrass","1","2","2",19.3,0,53,-1,43,36.4,-3,0,0,-2,-4,-4,-4,-6,"w1819","Non.motorized",6,"Tue","weekday"
"6218",2019-04-09,"Snodgrass","1","2","2",19.3,0,53,-1,43,36.4,-3,0,0,-2,-4,-4,-4,-6,"w1819","Mechanized",0,"Tue","weekday"
"6219",2019-04-09,"Snodgrass","1","2","2",19.3,0,53,-1,43,36.4,-3,0,0,-2,-4,-4,-4,-6,"w1819","Motorized",4,"Tue","weekday"
"6220",2019-04-09,"Snodgrass","1","2","2",19.3,0,53,-1,43,36.4,-3,0,0,-2,-4,-4,-4,-6,"w1819","Hybrid",4,"Tue","weekday"
"6221",2019-04-10,"Snodgrass","2","2","1",19,-0.3,51,-2,30,37.3,-1,-3,0,0,-3,-6,-6,-6,"w1819","Non.motorized",23,"Wed","weekday"
"6222",2019-04-10,"Snodgrass","2","2","1",19,-0.3,51,-2,30,37.3,-1,-3,0,0,-3,-6,-6,-6,"w1819","Mechanized",0,"Wed","weekday"
"6223",2019-04-10,"Snodgrass","2","2","1",19,-0.3,51,-2,30,37.3,-1,-3,0,0,-3,-6,-6,-6,"w1819","Motorized",4,"Wed","weekday"
"6224",2019-04-10,"Snodgrass","2","2","1",19,-0.3,51,-2,30,37.3,-1,-3,0,0,-3,-6,-6,-6,"w1819","Hybrid",0,"Wed","weekday"
"6225",2019-04-11,"Snodgrass","3","3","2",18.9,-0.1,53,2,20,35.7,-2,-1,-3,0,0,-1,-4,-4,"w1819","Non.motorized",20,"Thu","weekday"
"6226",2019-04-11,"Snodgrass","3","3","2",18.9,-0.1,53,2,20,35.7,-2,-1,-3,0,0,-1,-4,-4,"w1819","Mechanized",0,"Thu","weekday"
"6227",2019-04-11,"Snodgrass","3","3","2",18.9,-0.1,53,2,20,35.7,-2,-1,-3,0,0,-1,-4,-4,"w1819","Motorized",0,"Thu","weekday"
"6228",2019-04-11,"Snodgrass","3","3","2",18.9,-0.1,53,2,20,35.7,-2,-1,-3,0,0,-1,-4,-4,"w1819","Hybrid",0,"Thu","weekday"
"6229",2019-04-12,"Snodgrass","2","2","1",18.7,-0.2,53,0,24,35.3,2,-2,-1,-3,2,0,-1,-4,"w1819","Non.motorized",51,"Fri","weekday"
"6230",2019-04-12,"Snodgrass","2","2","1",18.7,-0.2,53,0,24,35.3,2,-2,-1,-3,2,0,-1,-4,"w1819","Mechanized",0,"Fri","weekday"
"6231",2019-04-12,"Snodgrass","2","2","1",18.7,-0.2,53,0,24,35.3,2,-2,-1,-3,2,0,-1,-4,"w1819","Motorized",0,"Fri","weekday"
"6232",2019-04-12,"Snodgrass","2","2","1",18.7,-0.2,53,0,24,35.3,2,-2,-1,-3,2,0,-1,-4,"w1819","Hybrid",0,"Fri","weekday"
"6233",2019-04-13,"Snodgrass","1","1","1",18.8,0.1,52,-1,27,36.2,0,2,-2,-1,-1,1,-1,-2,"w1819","Non.motorized",42,"Sat","weekend"
"6234",2019-04-13,"Snodgrass","1","1","1",18.8,0.1,52,-1,27,36.2,0,2,-2,-1,-1,1,-1,-2,"w1819","Mechanized",2,"Sat","weekend"
"6235",2019-04-13,"Snodgrass","1","1","1",18.8,0.1,52,-1,27,36.2,0,2,-2,-1,-1,1,-1,-2,"w1819","Motorized",4,"Sat","weekend"
"6236",2019-04-13,"Snodgrass","1","1","1",18.8,0.1,52,-1,27,36.2,0,2,-2,-1,-1,1,-1,-2,"w1819","Hybrid",0,"Sat","weekend"
"6237",2019-04-14,"Snodgrass","1","1","1",18.7,-0.1,51,-1,35,36.7,-1,0,2,-2,-2,-2,0,-2,"w1819","Non.motorized",29,"Sun","weekend"
"6238",2019-04-14,"Snodgrass","1","1","1",18.7,-0.1,51,-1,35,36.7,-1,0,2,-2,-2,-2,0,-2,"w1819","Mechanized",0,"Sun","weekend"
"6239",2019-04-14,"Snodgrass","1","1","1",18.7,-0.1,51,-1,35,36.7,-1,0,2,-2,-2,-2,0,-2,"w1819","Motorized",0,"Sun","weekend"
"6240",2019-04-14,"Snodgrass","1","1","1",18.7,-0.1,51,-1,35,36.7,-1,0,2,-2,-2,-2,0,-2,"w1819","Hybrid",0,"Sun","weekend"
"6241",2019-04-15,"Snodgrass",NA,NA,NA,18.6,-0.1,50,-1,41,37.2,-1,-1,0,2,-2,-3,-3,-1,"w1819","Non.motorized",13,"Mon","weekday"
"6242",2019-04-15,"Snodgrass",NA,NA,NA,18.6,-0.1,50,-1,41,37.2,-1,-1,0,2,-2,-3,-3,-1,"w1819","Mechanized",0,"Mon","weekday"
"6243",2019-04-15,"Snodgrass",NA,NA,NA,18.6,-0.1,50,-1,41,37.2,-1,-1,0,2,-2,-3,-3,-1,"w1819","Motorized",0,"Mon","weekday"
"6244",2019-04-15,"Snodgrass",NA,NA,NA,18.6,-0.1,50,-1,41,37.2,-1,-1,0,2,-2,-3,-3,-1,"w1819","Hybrid",0,"Mon","weekday"
"6245",2018-12-01,"Washington Gulch","3","3","2",3.3,0.2,19,1,16,17.4,0,0,0,0,1,1,1,1,"w1819","Non.motorized",25,"Sat","weekend"
"6246",2018-12-01,"Washington Gulch","3","3","2",3.3,0.2,19,1,16,17.4,0,0,0,0,1,1,1,1,"w1819","Mechanized",0,"Sat","weekend"
"6247",2018-12-01,"Washington Gulch","3","3","2",3.3,0.2,19,1,16,17.4,0,0,0,0,1,1,1,1,"w1819","Motorized",4,"Sat","weekend"
"6248",2018-12-01,"Washington Gulch","3","3","2",3.3,0.2,19,1,16,17.4,0,0,0,0,1,1,1,1,"w1819","Hybrid",0,"Sat","weekend"
"6249",2018-12-02,"Washington Gulch","3","3","3",3.3,0,20,1,14,16.5,1,0,0,0,2,2,2,2,"w1819","Non.motorized",33,"Sun","weekend"
"6250",2018-12-02,"Washington Gulch","3","3","3",3.3,0,20,1,14,16.5,1,0,0,0,2,2,2,2,"w1819","Mechanized",0,"Sun","weekend"
"6251",2018-12-02,"Washington Gulch","3","3","3",3.3,0,20,1,14,16.5,1,0,0,0,2,2,2,2,"w1819","Motorized",6,"Sun","weekend"
"6252",2018-12-02,"Washington Gulch","3","3","3",3.3,0,20,1,14,16.5,1,0,0,0,2,2,2,2,"w1819","Hybrid",2,"Sun","weekend"
"6253",2018-12-03,"Washington Gulch","3","3","2",3.4,0.1,19,-1,13,17.9,1,1,0,0,0,1,1,1,"w1819","Non.motorized",4,"Mon","weekday"
"6254",2018-12-03,"Washington Gulch","3","3","2",3.4,0.1,19,-1,13,17.9,1,1,0,0,0,1,1,1,"w1819","Mechanized",0,"Mon","weekday"
"6255",2018-12-03,"Washington Gulch","3","3","2",3.4,0.1,19,-1,13,17.9,1,1,0,0,0,1,1,1,"w1819","Motorized",2,"Mon","weekday"
"6256",2018-12-03,"Washington Gulch","3","3","2",3.4,0.1,19,-1,13,17.9,1,1,0,0,0,1,1,1,"w1819","Hybrid",2,"Mon","weekday"
"6257",2018-12-04,"Washington Gulch","3","3","2",3.5,0.1,20,1,8,17.5,-1,1,1,0,0,1,2,2,"w1819","Non.motorized",15,"Tue","weekday"
"6258",2018-12-04,"Washington Gulch","3","3","2",3.5,0.1,20,1,8,17.5,-1,1,1,0,0,1,2,2,"w1819","Mechanized",0,"Tue","weekday"
"6259",2018-12-04,"Washington Gulch","3","3","2",3.5,0.1,20,1,8,17.5,-1,1,1,0,0,1,2,2,"w1819","Motorized",6,"Tue","weekday"
"6260",2018-12-04,"Washington Gulch","3","3","2",3.5,0.1,20,1,8,17.5,-1,1,1,0,0,1,2,2,"w1819","Hybrid",1,"Tue","weekday"
"6261",2018-12-05,"Washington Gulch","3","3","2",3.5,0,19,-1,21,18.4,1,-1,1,1,0,-1,0,1,"w1819","Non.motorized",6,"Wed","weekday"
"6262",2018-12-05,"Washington Gulch","3","3","2",3.5,0,19,-1,21,18.4,1,-1,1,1,0,-1,0,1,"w1819","Mechanized",1,"Wed","weekday"
"6263",2018-12-05,"Washington Gulch","3","3","2",3.5,0,19,-1,21,18.4,1,-1,1,1,0,-1,0,1,"w1819","Motorized",0,"Wed","weekday"
"6264",2018-12-05,"Washington Gulch","3","3","2",3.5,0,19,-1,21,18.4,1,-1,1,1,0,-1,0,1,"w1819","Hybrid",0,"Wed","weekday"
"6265",2018-12-06,"Washington Gulch","2","2","2",3.7,0.2,18,-1,25,20.6,-1,1,-1,1,-2,-1,-2,-1,"w1819","Non.motorized",11,"Thu","weekday"
"6266",2018-12-06,"Washington Gulch","2","2","2",3.7,0.2,18,-1,25,20.6,-1,1,-1,1,-2,-1,-2,-1,"w1819","Mechanized",0,"Thu","weekday"
"6267",2018-12-06,"Washington Gulch","2","2","2",3.7,0.2,18,-1,25,20.6,-1,1,-1,1,-2,-1,-2,-1,"w1819","Motorized",2,"Thu","weekday"
"6268",2018-12-06,"Washington Gulch","2","2","2",3.7,0.2,18,-1,25,20.6,-1,1,-1,1,-2,-1,-2,-1,"w1819","Hybrid",2,"Thu","weekday"
"6269",2018-12-07,"Washington Gulch","2","2","2",3.8,0.1,21,3,23,18.1,-1,-1,1,-1,2,1,2,1,"w1819","Non.motorized",13,"Fri","weekday"
"6270",2018-12-07,"Washington Gulch","2","2","2",3.8,0.1,21,3,23,18.1,-1,-1,1,-1,2,1,2,1,"w1819","Mechanized",0,"Fri","weekday"
"6271",2018-12-07,"Washington Gulch","2","2","2",3.8,0.1,21,3,23,18.1,-1,-1,1,-1,2,1,2,1,"w1819","Motorized",5,"Fri","weekday"
"6272",2018-12-07,"Washington Gulch","2","2","2",3.8,0.1,21,3,23,18.1,-1,-1,1,-1,2,1,2,1,"w1819","Hybrid",3,"Fri","weekday"
"6273",2018-12-08,"Washington Gulch","2","2","2",3.8,0,20,-1,23,19,3,-1,-1,1,2,1,0,1,"w1819","Non.motorized",49,"Sat","weekend"
"6274",2018-12-08,"Washington Gulch","2","2","2",3.8,0,20,-1,23,19,3,-1,-1,1,2,1,0,1,"w1819","Mechanized",0,"Sat","weekend"
"6275",2018-12-08,"Washington Gulch","2","2","2",3.8,0,20,-1,23,19,3,-1,-1,1,2,1,0,1,"w1819","Motorized",3,"Sat","weekend"
"6276",2018-12-08,"Washington Gulch","2","2","2",3.8,0,20,-1,23,19,3,-1,-1,1,2,1,0,1,"w1819","Hybrid",0,"Sat","weekend"
"6277",2018-12-09,"Washington Gulch","2","2","2",3.8,0,20,0,19,19,-1,3,-1,-1,-1,2,1,0,"w1819","Non.motorized",63,"Sun","weekend"
"6278",2018-12-09,"Washington Gulch","2","2","2",3.8,0,20,0,19,19,-1,3,-1,-1,-1,2,1,0,"w1819","Mechanized",0,"Sun","weekend"
"6279",2018-12-09,"Washington Gulch","2","2","2",3.8,0,20,0,19,19,-1,3,-1,-1,-1,2,1,0,"w1819","Motorized",9,"Sun","weekend"
"6280",2018-12-09,"Washington Gulch","2","2","2",3.8,0,20,0,19,19,-1,3,-1,-1,-1,2,1,0,"w1819","Hybrid",7,"Sun","weekend"
"6281",2018-12-10,"Washington Gulch","2","2","2",3.8,0,20,0,21,19,0,-1,3,-1,0,-1,2,1,"w1819","Non.motorized",13,"Mon","weekday"
"6282",2018-12-10,"Washington Gulch","2","2","2",3.8,0,20,0,21,19,0,-1,3,-1,0,-1,2,1,"w1819","Mechanized",0,"Mon","weekday"
"6283",2018-12-10,"Washington Gulch","2","2","2",3.8,0,20,0,21,19,0,-1,3,-1,0,-1,2,1,"w1819","Motorized",4,"Mon","weekday"
"6284",2018-12-10,"Washington Gulch","2","2","2",3.8,0,20,0,21,19,0,-1,3,-1,0,-1,2,1,"w1819","Hybrid",2,"Mon","weekday"
"6285",2018-12-11,"Washington Gulch","2","2","2",3.9,0.1,19,-1,27,20.5,0,0,-1,3,-1,-1,-2,1,"w1819","Non.motorized",22,"Tue","weekday"
"6286",2018-12-11,"Washington Gulch","2","2","2",3.9,0.1,19,-1,27,20.5,0,0,-1,3,-1,-1,-2,1,"w1819","Mechanized",0,"Tue","weekday"
"6287",2018-12-11,"Washington Gulch","2","2","2",3.9,0.1,19,-1,27,20.5,0,0,-1,3,-1,-1,-2,1,"w1819","Motorized",6,"Tue","weekday"
"6288",2018-12-11,"Washington Gulch","2","2","2",3.9,0.1,19,-1,27,20.5,0,0,-1,3,-1,-1,-2,1,"w1819","Hybrid",2,"Tue","weekday"
"6289",2018-12-12,"Washington Gulch","2","2","1",3.9,0,19,0,21,20.5,-1,0,0,-1,-1,-1,-1,-2,"w1819","Non.motorized",9,"Wed","weekday"
"6290",2018-12-12,"Washington Gulch","2","2","1",3.9,0,19,0,21,20.5,-1,0,0,-1,-1,-1,-1,-2,"w1819","Mechanized",0,"Wed","weekday"
"6291",2018-12-12,"Washington Gulch","2","2","1",3.9,0,19,0,21,20.5,-1,0,0,-1,-1,-1,-1,-2,"w1819","Motorized",0,"Wed","weekday"
"6292",2018-12-12,"Washington Gulch","2","2","1",3.9,0,19,0,21,20.5,-1,0,0,-1,-1,-1,-1,-2,"w1819","Hybrid",0,"Wed","weekday"
"6293",2018-12-13,"Washington Gulch","3","3","2",4,0.1,21,2,15,19,0,-1,0,0,2,1,1,1,"w1819","Non.motorized",18,"Thu","weekday"
"6294",2018-12-13,"Washington Gulch","3","3","2",4,0.1,21,2,15,19,0,-1,0,0,2,1,1,1,"w1819","Mechanized",0,"Thu","weekday"
"6295",2018-12-13,"Washington Gulch","3","3","2",4,0.1,21,2,15,19,0,-1,0,0,2,1,1,1,"w1819","Motorized",3,"Thu","weekday"
"6296",2018-12-13,"Washington Gulch","3","3","2",4,0.1,21,2,15,19,0,-1,0,0,2,1,1,1,"w1819","Hybrid",1,"Thu","weekday"
"6297",2018-12-14,"Washington Gulch","3","3","2",4,0,20,-1,24,20,2,0,-1,0,1,1,0,0,"w1819","Non.motorized",34,"Fri","weekday"
"6298",2018-12-14,"Washington Gulch","3","3","2",4,0,20,-1,24,20,2,0,-1,0,1,1,0,0,"w1819","Mechanized",0,"Fri","weekday"
"6299",2018-12-14,"Washington Gulch","3","3","2",4,0,20,-1,24,20,2,0,-1,0,1,1,0,0,"w1819","Motorized",3,"Fri","weekday"
"6300",2018-12-14,"Washington Gulch","3","3","2",4,0,20,-1,24,20,2,0,-1,0,1,1,0,0,"w1819","Hybrid",3,"Fri","weekday"
"6301",2018-12-15,"Washington Gulch","2","2","2",4,0,20,0,29,20,-1,2,0,-1,-1,1,1,0,"w1819","Non.motorized",42,"Sat","weekend"
"6302",2018-12-15,"Washington Gulch","2","2","2",4,0,20,0,29,20,-1,2,0,-1,-1,1,1,0,"w1819","Mechanized",0,"Sat","weekend"
"6303",2018-12-15,"Washington Gulch","2","2","2",4,0,20,0,29,20,-1,2,0,-1,-1,1,1,0,"w1819","Motorized",3,"Sat","weekend"
"6304",2018-12-15,"Washington Gulch","2","2","2",4,0,20,0,29,20,-1,2,0,-1,-1,1,1,0,"w1819","Hybrid",0,"Sat","weekend"
"6305",2018-12-16,"Washington Gulch","2","2","2",4.1,0.1,19,-1,28,21.6,0,-1,2,0,-1,-2,0,0,"w1819","Non.motorized",74,"Sun","weekend"
"6306",2018-12-16,"Washington Gulch","2","2","2",4.1,0.1,19,-1,28,21.6,0,-1,2,0,-1,-2,0,0,"w1819","Mechanized",2,"Sun","weekend"
"6307",2018-12-16,"Washington Gulch","2","2","2",4.1,0.1,19,-1,28,21.6,0,-1,2,0,-1,-2,0,0,"w1819","Motorized",9,"Sun","weekend"
"6308",2018-12-16,"Washington Gulch","2","2","2",4.1,0.1,19,-1,28,21.6,0,-1,2,0,-1,-2,0,0,"w1819","Hybrid",5,"Sun","weekend"
"6309",2018-12-17,"Washington Gulch","2","2","2",4.1,0,19,0,29,21.6,-1,0,-1,2,-1,-1,-2,0,"w1819","Non.motorized",9,"Mon","weekday"
"6310",2018-12-17,"Washington Gulch","2","2","2",4.1,0,19,0,29,21.6,-1,0,-1,2,-1,-1,-2,0,"w1819","Mechanized",0,"Mon","weekday"
"6311",2018-12-17,"Washington Gulch","2","2","2",4.1,0,19,0,29,21.6,-1,0,-1,2,-1,-1,-2,0,"w1819","Motorized",6,"Mon","weekday"
"6312",2018-12-17,"Washington Gulch","2","2","2",4.1,0,19,0,29,21.6,-1,0,-1,2,-1,-1,-2,0,"w1819","Hybrid",6,"Mon","weekday"
"6313",2018-12-18,"Washington Gulch","2","2","2",4.1,0,19,0,27,21.6,0,-1,0,-1,0,-1,-1,-2,"w1819","Non.motorized",18,"Tue","weekday"
"6314",2018-12-18,"Washington Gulch","2","2","2",4.1,0,19,0,27,21.6,0,-1,0,-1,0,-1,-1,-2,"w1819","Mechanized",0,"Tue","weekday"
"6315",2018-12-18,"Washington Gulch","2","2","2",4.1,0,19,0,27,21.6,0,-1,0,-1,0,-1,-1,-2,"w1819","Motorized",8,"Tue","weekday"
"6316",2018-12-18,"Washington Gulch","2","2","2",4.1,0,19,0,27,21.6,0,-1,0,-1,0,-1,-1,-2,"w1819","Hybrid",6,"Tue","weekday"
"6317",2018-12-19,"Washington Gulch","2","2","2",4.1,0,19,0,24,21.6,0,0,-1,0,0,0,-1,-1,"w1819","Non.motorized",12,"Wed","weekday"
"6318",2018-12-19,"Washington Gulch","2","2","2",4.1,0,19,0,24,21.6,0,0,-1,0,0,0,-1,-1,"w1819","Mechanized",0,"Wed","weekday"
"6319",2018-12-19,"Washington Gulch","2","2","2",4.1,0,19,0,24,21.6,0,0,-1,0,0,0,-1,-1,"w1819","Motorized",1,"Wed","weekday"
"6320",2018-12-19,"Washington Gulch","2","2","2",4.1,0,19,0,24,21.6,0,0,-1,0,0,0,-1,-1,"w1819","Hybrid",1,"Wed","weekday"
"6321",2018-12-20,"Washington Gulch","2","2","1",4.1,0,20,1,25,20.5,0,0,0,-1,1,1,1,0,"w1819","Non.motorized",9,"Thu","weekday"
"6322",2018-12-20,"Washington Gulch","2","2","1",4.1,0,20,1,25,20.5,0,0,0,-1,1,1,1,0,"w1819","Mechanized",0,"Thu","weekday"
"6323",2018-12-20,"Washington Gulch","2","2","1",4.1,0,20,1,25,20.5,0,0,0,-1,1,1,1,0,"w1819","Motorized",10,"Thu","weekday"
"6324",2018-12-20,"Washington Gulch","2","2","1",4.1,0,20,1,25,20.5,0,0,0,-1,1,1,1,0,"w1819","Hybrid",9,"Thu","weekday"
"6325",2018-12-21,"Washington Gulch","2","2","1",4.1,0,19,-1,28,21.6,1,0,0,0,0,0,0,0,"w1819","Non.motorized",23,"Fri","weekday"
"6326",2018-12-21,"Washington Gulch","2","2","1",4.1,0,19,-1,28,21.6,1,0,0,0,0,0,0,0,"w1819","Mechanized",0,"Fri","weekday"
"6327",2018-12-21,"Washington Gulch","2","2","1",4.1,0,19,-1,28,21.6,1,0,0,0,0,0,0,0,"w1819","Motorized",0,"Fri","weekday"
"6328",2018-12-21,"Washington Gulch","2","2","1",4.1,0,19,-1,28,21.6,1,0,0,0,0,0,0,0,"w1819","Hybrid",0,"Fri","weekday"
"6329",2018-12-22,"Washington Gulch","2","2","1",4.2,0.1,19,0,20,22.1,-1,1,0,0,-1,0,0,0,"w1819","Non.motorized",39,"Sat","weekend"
"6330",2018-12-22,"Washington Gulch","2","2","1",4.2,0.1,19,0,20,22.1,-1,1,0,0,-1,0,0,0,"w1819","Mechanized",0,"Sat","weekend"
"6331",2018-12-22,"Washington Gulch","2","2","1",4.2,0.1,19,0,20,22.1,-1,1,0,0,-1,0,0,0,"w1819","Motorized",21,"Sat","weekend"
"6332",2018-12-22,"Washington Gulch","2","2","1",4.2,0.1,19,0,20,22.1,-1,1,0,0,-1,0,0,0,"w1819","Hybrid",2,"Sat","weekend"
"6333",2018-12-23,"Washington Gulch","2","2","1",4.2,0,21,2,19,20,0,-1,1,0,2,1,2,2,"w1819","Non.motorized",66,"Sun","weekend"
"6334",2018-12-23,"Washington Gulch","2","2","1",4.2,0,21,2,19,20,0,-1,1,0,2,1,2,2,"w1819","Mechanized",0,"Sun","weekend"
"6335",2018-12-23,"Washington Gulch","2","2","1",4.2,0,21,2,19,20,0,-1,1,0,2,1,2,2,"w1819","Motorized",13,"Sun","weekend"
"6336",2018-12-23,"Washington Gulch","2","2","1",4.2,0,21,2,19,20,0,-1,1,0,2,1,2,2,"w1819","Hybrid",3,"Sun","weekend"
"6337",2018-12-24,"Washington Gulch","2","2","2",4.3,0.1,20,-1,21,21.5,2,0,-1,1,1,1,0,1,"w1819","Non.motorized",28,"Mon","weekday"
"6338",2018-12-24,"Washington Gulch","2","2","2",4.3,0.1,20,-1,21,21.5,2,0,-1,1,1,1,0,1,"w1819","Mechanized",0,"Mon","weekday"
"6339",2018-12-24,"Washington Gulch","2","2","2",4.3,0.1,20,-1,21,21.5,2,0,-1,1,1,1,0,1,"w1819","Motorized",13,"Mon","weekday"
"6340",2018-12-24,"Washington Gulch","2","2","2",4.3,0.1,20,-1,21,21.5,2,0,-1,1,1,1,0,1,"w1819","Hybrid",4,"Mon","weekday"
"6341",2018-12-25,"Washington Gulch","2","2","2",4.7,0.4,25,5,25,18.8,-1,2,0,-1,4,6,6,5,"w1819","Non.motorized",57,"Tue","weekday"
"6342",2018-12-25,"Washington Gulch","2","2","2",4.7,0.4,25,5,25,18.8,-1,2,0,-1,4,6,6,5,"w1819","Mechanized",0,"Tue","weekday"
"6343",2018-12-25,"Washington Gulch","2","2","2",4.7,0.4,25,5,25,18.8,-1,2,0,-1,4,6,6,5,"w1819","Motorized",9,"Tue","weekday"
"6344",2018-12-25,"Washington Gulch","2","2","2",4.7,0.4,25,5,25,18.8,-1,2,0,-1,4,6,6,5,"w1819","Hybrid",7,"Tue","weekday"
"6345",2018-12-26,"Washington Gulch","3","3","3",4.7,0,23,-2,24,20.4,5,-1,2,0,3,2,4,4,"w1819","Non.motorized",54,"Wed","weekday"
"6346",2018-12-26,"Washington Gulch","3","3","3",4.7,0,23,-2,24,20.4,5,-1,2,0,3,2,4,4,"w1819","Mechanized",0,"Wed","weekday"
"6347",2018-12-26,"Washington Gulch","3","3","3",4.7,0,23,-2,24,20.4,5,-1,2,0,3,2,4,4,"w1819","Motorized",12,"Wed","weekday"
"6348",2018-12-26,"Washington Gulch","3","3","3",4.7,0,23,-2,24,20.4,5,-1,2,0,3,2,4,4,"w1819","Hybrid",8,"Wed","weekday"
"6349",2018-12-27,"Washington Gulch","3","3","2",4.7,0,24,1,12,19.6,-2,5,-1,2,-1,4,3,5,"w1819","Non.motorized",68,"Thu","weekday"
"6350",2018-12-27,"Washington Gulch","3","3","2",4.7,0,24,1,12,19.6,-2,5,-1,2,-1,4,3,5,"w1819","Mechanized",0,"Thu","weekday"
"6351",2018-12-27,"Washington Gulch","3","3","2",4.7,0,24,1,12,19.6,-2,5,-1,2,-1,4,3,5,"w1819","Motorized",6,"Thu","weekday"
"6352",2018-12-27,"Washington Gulch","3","3","2",4.7,0,24,1,12,19.6,-2,5,-1,2,-1,4,3,5,"w1819","Hybrid",6,"Thu","weekday"
"6353",2018-12-28,"Washington Gulch","3","3","2",4.7,0,24,0,12,19.6,1,-2,5,-1,1,-1,4,3,"w1819","Non.motorized",38,"Fri","weekday"
"6354",2018-12-28,"Washington Gulch","3","3","2",4.7,0,24,0,12,19.6,1,-2,5,-1,1,-1,4,3,"w1819","Mechanized",0,"Fri","weekday"
"6355",2018-12-28,"Washington Gulch","3","3","2",4.7,0,24,0,12,19.6,1,-2,5,-1,1,-1,4,3,"w1819","Motorized",4,"Fri","weekday"
"6356",2018-12-28,"Washington Gulch","3","3","2",4.7,0,24,0,12,19.6,1,-2,5,-1,1,-1,4,3,"w1819","Hybrid",2,"Fri","weekday"
"6357",2018-12-29,"Washington Gulch","3","3","2",4.7,0,24,0,8,19.6,0,1,-2,5,0,1,-1,4,"w1819","Non.motorized",72,"Sat","weekend"
"6358",2018-12-29,"Washington Gulch","3","3","2",4.7,0,24,0,8,19.6,0,1,-2,5,0,1,-1,4,"w1819","Mechanized",0,"Sat","weekend"
"6359",2018-12-29,"Washington Gulch","3","3","2",4.7,0,24,0,8,19.6,0,1,-2,5,0,1,-1,4,"w1819","Motorized",17,"Sat","weekend"
"6360",2018-12-29,"Washington Gulch","3","3","2",4.7,0,24,0,8,19.6,0,1,-2,5,0,1,-1,4,"w1819","Hybrid",3,"Sat","weekend"
"6361",2018-12-30,"Washington Gulch","3","3","2",4.7,0,24,0,16,19.6,0,0,1,-2,0,0,1,-1,"w1819","Non.motorized",85,"Sun","weekend"
"6362",2018-12-30,"Washington Gulch","3","3","2",4.7,0,24,0,16,19.6,0,0,1,-2,0,0,1,-1,"w1819","Mechanized",0,"Sun","weekend"
"6363",2018-12-30,"Washington Gulch","3","3","2",4.7,0,24,0,16,19.6,0,0,1,-2,0,0,1,-1,"w1819","Motorized",36,"Sun","weekend"
"6364",2018-12-30,"Washington Gulch","3","3","2",4.7,0,24,0,16,19.6,0,0,1,-2,0,0,1,-1,"w1819","Hybrid",5,"Sun","weekend"
"6365",2018-12-31,"Washington Gulch","3","3","3",4.9,0.2,23,-1,14,21.3,0,0,0,1,-1,-1,-1,0,"w1819","Non.motorized",53,"Mon","weekday"
"6366",2018-12-31,"Washington Gulch","3","3","3",4.9,0.2,23,-1,14,21.3,0,0,0,1,-1,-1,-1,0,"w1819","Mechanized",0,"Mon","weekday"
"6367",2018-12-31,"Washington Gulch","3","3","3",4.9,0.2,23,-1,14,21.3,0,0,0,1,-1,-1,-1,0,"w1819","Motorized",8,"Mon","weekday"
"6368",2018-12-31,"Washington Gulch","3","3","3",4.9,0.2,23,-1,14,21.3,0,0,0,1,-1,-1,-1,0,"w1819","Hybrid",2,"Mon","weekday"
"6369",2019-01-01,"Washington Gulch","3","3","3",5.1,0.2,29,6,11,17.6,-1,0,0,0,5,5,5,5,"w1819","Non.motorized",19,"Tue","weekday"
"6370",2019-01-01,"Washington Gulch","3","3","3",5.1,0.2,29,6,11,17.6,-1,0,0,0,5,5,5,5,"w1819","Mechanized",1,"Tue","weekday"
"6371",2019-01-01,"Washington Gulch","3","3","3",5.1,0.2,29,6,11,17.6,-1,0,0,0,5,5,5,5,"w1819","Motorized",0,"Tue","weekday"
"6372",2019-01-01,"Washington Gulch","3","3","3",5.1,0.2,29,6,11,17.6,-1,0,0,0,5,5,5,5,"w1819","Hybrid",0,"Tue","weekday"
"6373",2019-01-02,"Washington Gulch","3","3","2",5.1,0,28,-1,10,18.2,6,-1,0,0,5,4,4,4,"w1819","Non.motorized",2,"Wed","weekday"
"6374",2019-01-02,"Washington Gulch","3","3","2",5.1,0,28,-1,10,18.2,6,-1,0,0,5,4,4,4,"w1819","Mechanized",0,"Wed","weekday"
"6375",2019-01-02,"Washington Gulch","3","3","2",5.1,0,28,-1,10,18.2,6,-1,0,0,5,4,4,4,"w1819","Motorized",0,"Wed","weekday"
"6376",2019-01-02,"Washington Gulch","3","3","2",5.1,0,28,-1,10,18.2,6,-1,0,0,5,4,4,4,"w1819","Hybrid",0,"Wed","weekday"
"6377",2019-01-03,"Washington Gulch","3","3","2",5.1,0,27,-1,22,18.9,-1,6,-1,0,-2,4,3,3,"w1819","Non.motorized",8,"Thu","weekday"
"6378",2019-01-03,"Washington Gulch","3","3","2",5.1,0,27,-1,22,18.9,-1,6,-1,0,-2,4,3,3,"w1819","Mechanized",0,"Thu","weekday"
"6379",2019-01-03,"Washington Gulch","3","3","2",5.1,0,27,-1,22,18.9,-1,6,-1,0,-2,4,3,3,"w1819","Motorized",1,"Thu","weekday"
"6380",2019-01-03,"Washington Gulch","3","3","2",5.1,0,27,-1,22,18.9,-1,6,-1,0,-2,4,3,3,"w1819","Hybrid",0,"Thu","weekday"
"6381",2019-01-04,"Washington Gulch","3","3","2",5.3,0.2,26,-1,29,20.4,-1,-1,6,-1,-2,-3,3,2,"w1819","Non.motorized",3,"Fri","weekday"
"6382",2019-01-04,"Washington Gulch","3","3","2",5.3,0.2,26,-1,29,20.4,-1,-1,6,-1,-2,-3,3,2,"w1819","Mechanized",0,"Fri","weekday"
"6383",2019-01-04,"Washington Gulch","3","3","2",5.3,0.2,26,-1,29,20.4,-1,-1,6,-1,-2,-3,3,2,"w1819","Motorized",3,"Fri","weekday"
"6384",2019-01-04,"Washington Gulch","3","3","2",5.3,0.2,26,-1,29,20.4,-1,-1,6,-1,-2,-3,3,2,"w1819","Hybrid",3,"Fri","weekday"
"6385",2019-01-05,"Washington Gulch","2","2","2",5.3,0,25,-1,30,21.2,-1,-1,-1,6,-2,-3,-4,2,"w1819","Non.motorized",12,"Sat","weekend"
"6386",2019-01-05,"Washington Gulch","2","2","2",5.3,0,25,-1,30,21.2,-1,-1,-1,6,-2,-3,-4,2,"w1819","Mechanized",0,"Sat","weekend"
"6387",2019-01-05,"Washington Gulch","2","2","2",5.3,0,25,-1,30,21.2,-1,-1,-1,6,-2,-3,-4,2,"w1819","Motorized",3,"Sat","weekend"
"6388",2019-01-05,"Washington Gulch","2","2","2",5.3,0,25,-1,30,21.2,-1,-1,-1,6,-2,-3,-4,2,"w1819","Hybrid",3,"Sat","weekend"
"6389",2019-01-06,"Washington Gulch","3","3","3",5.3,0,25,0,26,21.2,-1,-1,-1,-1,-1,-2,-3,-4,"w1819","Non.motorized",NA,"Sun","weekend"
"6390",2019-01-06,"Washington Gulch","3","3","3",5.3,0,25,0,26,21.2,-1,-1,-1,-1,-1,-2,-3,-4,"w1819","Mechanized",NA,"Sun","weekend"
"6391",2019-01-06,"Washington Gulch","3","3","3",5.3,0,25,0,26,21.2,-1,-1,-1,-1,-1,-2,-3,-4,"w1819","Motorized",NA,"Sun","weekend"
"6392",2019-01-06,"Washington Gulch","3","3","3",5.3,0,25,0,26,21.2,-1,-1,-1,-1,-1,-2,-3,-4,"w1819","Hybrid",NA,"Sun","weekend"
"6393",2019-01-07,"Washington Gulch","3","3","3",5.8,0.5,32,7,21,18.1,0,-1,-1,-1,7,6,5,4,"w1819","Non.motorized",NA,"Mon","weekday"
"6394",2019-01-07,"Washington Gulch","3","3","3",5.8,0.5,32,7,21,18.1,0,-1,-1,-1,7,6,5,4,"w1819","Mechanized",NA,"Mon","weekday"
"6395",2019-01-07,"Washington Gulch","3","3","3",5.8,0.5,32,7,21,18.1,0,-1,-1,-1,7,6,5,4,"w1819","Motorized",NA,"Mon","weekday"
"6396",2019-01-07,"Washington Gulch","3","3","3",5.8,0.5,32,7,21,18.1,0,-1,-1,-1,7,6,5,4,"w1819","Hybrid",NA,"Mon","weekday"
"6397",2019-01-08,"Washington Gulch","3","3","3",5.9,0.1,32,0,24,18.4,7,0,-1,-1,7,7,6,5,"w1819","Non.motorized",2,"Tue","weekday"
"6398",2019-01-08,"Washington Gulch","3","3","3",5.9,0.1,32,0,24,18.4,7,0,-1,-1,7,7,6,5,"w1819","Mechanized",0,"Tue","weekday"
"6399",2019-01-08,"Washington Gulch","3","3","3",5.9,0.1,32,0,24,18.4,7,0,-1,-1,7,7,6,5,"w1819","Motorized",5,"Tue","weekday"
"6400",2019-01-08,"Washington Gulch","3","3","3",5.9,0.1,32,0,24,18.4,7,0,-1,-1,7,7,6,5,"w1819","Hybrid",4,"Tue","weekday"
"6401",2019-01-09,"Washington Gulch","3","3","3",6,0.1,30,-2,29,20,0,7,0,-1,-2,5,5,4,"w1819","Non.motorized",1,"Wed","weekday"
"6402",2019-01-09,"Washington Gulch","3","3","3",6,0.1,30,-2,29,20,0,7,0,-1,-2,5,5,4,"w1819","Mechanized",0,"Wed","weekday"
"6403",2019-01-09,"Washington Gulch","3","3","3",6,0.1,30,-2,29,20,0,7,0,-1,-2,5,5,4,"w1819","Motorized",5,"Wed","weekday"
"6404",2019-01-09,"Washington Gulch","3","3","3",6,0.1,30,-2,29,20,0,7,0,-1,-2,5,5,4,"w1819","Hybrid",2,"Wed","weekday"
"6405",2019-01-10,"Washington Gulch","3","3","3",6,0,29,-1,29,20.7,-2,0,7,0,-3,-3,4,4,"w1819","Non.motorized",5,"Thu","weekday"
"6406",2019-01-10,"Washington Gulch","3","3","3",6,0,29,-1,29,20.7,-2,0,7,0,-3,-3,4,4,"w1819","Mechanized",0,"Thu","weekday"
"6407",2019-01-10,"Washington Gulch","3","3","3",6,0,29,-1,29,20.7,-2,0,7,0,-3,-3,4,4,"w1819","Motorized",0,"Thu","weekday"
"6408",2019-01-10,"Washington Gulch","3","3","3",6,0,29,-1,29,20.7,-2,0,7,0,-3,-3,4,4,"w1819","Hybrid",0,"Thu","weekday"
"6409",2019-01-11,"Washington Gulch","2","2","2",6.1,0.1,29,0,25,21,-1,-2,0,7,-1,-3,-3,4,"w1819","Non.motorized",18,"Fri","weekday"
"6410",2019-01-11,"Washington Gulch","2","2","2",6.1,0.1,29,0,25,21,-1,-2,0,7,-1,-3,-3,4,"w1819","Mechanized",0,"Fri","weekday"
"6411",2019-01-11,"Washington Gulch","2","2","2",6.1,0.1,29,0,25,21,-1,-2,0,7,-1,-3,-3,4,"w1819","Motorized",3,"Fri","weekday"
"6412",2019-01-11,"Washington Gulch","2","2","2",6.1,0.1,29,0,25,21,-1,-2,0,7,-1,-3,-3,4,"w1819","Hybrid",2,"Fri","weekday"
"6413",2019-01-12,"Washington Gulch","3","3","2",6.1,0,28,-1,21,21.8,0,-1,-2,0,-1,-2,-4,-4,"w1819","Non.motorized",19,"Sat","weekend"
"6414",2019-01-12,"Washington Gulch","3","3","2",6.1,0,28,-1,21,21.8,0,-1,-2,0,-1,-2,-4,-4,"w1819","Mechanized",0,"Sat","weekend"
"6415",2019-01-12,"Washington Gulch","3","3","2",6.1,0,28,-1,21,21.8,0,-1,-2,0,-1,-2,-4,-4,"w1819","Motorized",3,"Sat","weekend"
"6416",2019-01-12,"Washington Gulch","3","3","2",6.1,0,28,-1,21,21.8,0,-1,-2,0,-1,-2,-4,-4,"w1819","Hybrid",0,"Sat","weekend"
"6417",2019-01-13,"Washington Gulch","2","2","2",6.2,0.1,30,2,18,20.7,-1,0,-1,-2,1,1,0,-2,"w1819","Non.motorized",29,"Sun","weekend"
"6418",2019-01-13,"Washington Gulch","2","2","2",6.2,0.1,30,2,18,20.7,-1,0,-1,-2,1,1,0,-2,"w1819","Mechanized",0,"Sun","weekend"
"6419",2019-01-13,"Washington Gulch","2","2","2",6.2,0.1,30,2,18,20.7,-1,0,-1,-2,1,1,0,-2,"w1819","Motorized",6,"Sun","weekend"
"6420",2019-01-13,"Washington Gulch","2","2","2",6.2,0.1,30,2,18,20.7,-1,0,-1,-2,1,1,0,-2,"w1819","Hybrid",6,"Sun","weekend"
"6421",2019-01-14,"Washington Gulch","2","2","2",6.2,0,30,0,18,20.7,2,-1,0,-1,2,1,1,0,"w1819","Non.motorized",8,"Mon","weekday"
"6422",2019-01-14,"Washington Gulch","2","2","2",6.2,0,30,0,18,20.7,2,-1,0,-1,2,1,1,0,"w1819","Mechanized",0,"Mon","weekday"
"6423",2019-01-14,"Washington Gulch","2","2","2",6.2,0,30,0,18,20.7,2,-1,0,-1,2,1,1,0,"w1819","Motorized",9,"Mon","weekday"
"6424",2019-01-14,"Washington Gulch","2","2","2",6.2,0,30,0,18,20.7,2,-1,0,-1,2,1,1,0,"w1819","Hybrid",2,"Mon","weekday"
"6425",2019-01-15,"Washington Gulch","2","2","2",6.2,0,29,-1,24,21.4,0,2,-1,0,-1,1,0,0,"w1819","Non.motorized",0,"Tue","weekday"
"6426",2019-01-15,"Washington Gulch","2","2","2",6.2,0,29,-1,24,21.4,0,2,-1,0,-1,1,0,0,"w1819","Mechanized",0,"Tue","weekday"
"6427",2019-01-15,"Washington Gulch","2","2","2",6.2,0,29,-1,24,21.4,0,2,-1,0,-1,1,0,0,"w1819","Motorized",0,"Tue","weekday"
"6428",2019-01-15,"Washington Gulch","2","2","2",6.2,0,29,-1,24,21.4,0,2,-1,0,-1,1,0,0,"w1819","Hybrid",0,"Tue","weekday"
"6429",2019-01-16,"Washington Gulch","4","4","3",6.3,0.1,29,0,26,21.7,-1,0,2,-1,-1,-1,1,0,"w1819","Non.motorized",0,"Wed","weekday"
"6430",2019-01-16,"Washington Gulch","4","4","3",6.3,0.1,29,0,26,21.7,-1,0,2,-1,-1,-1,1,0,"w1819","Mechanized",0,"Wed","weekday"
"6431",2019-01-16,"Washington Gulch","4","4","3",6.3,0.1,29,0,26,21.7,-1,0,2,-1,-1,-1,1,0,"w1819","Motorized",0,"Wed","weekday"
"6432",2019-01-16,"Washington Gulch","4","4","3",6.3,0.1,29,0,26,21.7,-1,0,2,-1,-1,-1,1,0,"w1819","Hybrid",0,"Wed","weekday"
"6433",2019-01-17,"Washington Gulch","3","3","2",7,0.7,38,9,28,18.4,0,-1,0,2,9,8,8,10,"w1819","Non.motorized",0,"Thu","weekday"
"6434",2019-01-17,"Washington Gulch","3","3","2",7,0.7,38,9,28,18.4,0,-1,0,2,9,8,8,10,"w1819","Mechanized",0,"Thu","weekday"
"6435",2019-01-17,"Washington Gulch","3","3","2",7,0.7,38,9,28,18.4,0,-1,0,2,9,8,8,10,"w1819","Motorized",0,"Thu","weekday"
"6436",2019-01-17,"Washington Gulch","3","3","2",7,0.7,38,9,28,18.4,0,-1,0,2,9,8,8,10,"w1819","Hybrid",0,"Thu","weekday"
"6437",2019-01-18,"Washington Gulch","4","4","4",7.5,0.5,41,3,22,18.3,9,0,-1,0,12,12,11,11,"w1819","Non.motorized",0,"Fri","weekday"
"6438",2019-01-18,"Washington Gulch","4","4","4",7.5,0.5,41,3,22,18.3,9,0,-1,0,12,12,11,11,"w1819","Mechanized",0,"Fri","weekday"
"6439",2019-01-18,"Washington Gulch","4","4","4",7.5,0.5,41,3,22,18.3,9,0,-1,0,12,12,11,11,"w1819","Motorized",0,"Fri","weekday"
"6440",2019-01-18,"Washington Gulch","4","4","4",7.5,0.5,41,3,22,18.3,9,0,-1,0,12,12,11,11,"w1819","Hybrid",0,"Fri","weekday"
"6441",2019-01-19,"Washington Gulch","3","3","3",7.8,0.3,43,2,20,18.1,3,9,0,-1,5,14,14,13,"w1819","Non.motorized",0,"Sat","weekend"
"6442",2019-01-19,"Washington Gulch","3","3","3",7.8,0.3,43,2,20,18.1,3,9,0,-1,5,14,14,13,"w1819","Mechanized",0,"Sat","weekend"
"6443",2019-01-19,"Washington Gulch","3","3","3",7.8,0.3,43,2,20,18.1,3,9,0,-1,5,14,14,13,"w1819","Motorized",0,"Sat","weekend"
"6444",2019-01-19,"Washington Gulch","3","3","3",7.8,0.3,43,2,20,18.1,3,9,0,-1,5,14,14,13,"w1819","Hybrid",0,"Sat","weekend"
"6445",2019-01-20,"Washington Gulch","3","3","3",7.9,0.1,41,-2,27,19.3,2,3,9,0,0,3,12,12,"w1819","Non.motorized",0,"Sun","weekend"
"6446",2019-01-20,"Washington Gulch","3","3","3",7.9,0.1,41,-2,27,19.3,2,3,9,0,0,3,12,12,"w1819","Mechanized",0,"Sun","weekend"
"6447",2019-01-20,"Washington Gulch","3","3","3",7.9,0.1,41,-2,27,19.3,2,3,9,0,0,3,12,12,"w1819","Motorized",0,"Sun","weekend"
"6448",2019-01-20,"Washington Gulch","3","3","3",7.9,0.1,41,-2,27,19.3,2,3,9,0,0,3,12,12,"w1819","Hybrid",0,"Sun","weekend"
"6449",2019-01-21,"Washington Gulch","3","3","3",7.9,0,39,-2,23,20.3,-2,2,3,9,-4,-2,1,10,"w1819","Non.motorized",NA,"Mon","weekday"
"6450",2019-01-21,"Washington Gulch","3","3","3",7.9,0,39,-2,23,20.3,-2,2,3,9,-4,-2,1,10,"w1819","Mechanized",NA,"Mon","weekday"
"6451",2019-01-21,"Washington Gulch","3","3","3",7.9,0,39,-2,23,20.3,-2,2,3,9,-4,-2,1,10,"w1819","Motorized",NA,"Mon","weekday"
"6452",2019-01-21,"Washington Gulch","3","3","3",7.9,0,39,-2,23,20.3,-2,2,3,9,-4,-2,1,10,"w1819","Hybrid",NA,"Mon","weekday"
"6453",2019-01-22,"Washington Gulch","3","3","3",8,0.1,41,2,12,19.5,-2,-2,2,3,0,-2,0,3,"w1819","Non.motorized",NA,"Tue","weekday"
"6454",2019-01-22,"Washington Gulch","3","3","3",8,0.1,41,2,12,19.5,-2,-2,2,3,0,-2,0,3,"w1819","Mechanized",NA,"Tue","weekday"
"6455",2019-01-22,"Washington Gulch","3","3","3",8,0.1,41,2,12,19.5,-2,-2,2,3,0,-2,0,3,"w1819","Motorized",NA,"Tue","weekday"
"6456",2019-01-22,"Washington Gulch","3","3","3",8,0.1,41,2,12,19.5,-2,-2,2,3,0,-2,0,3,"w1819","Hybrid",NA,"Tue","weekday"
"6457",2019-01-23,"Washington Gulch","3","3","2",8,0,40,-1,14,20,2,-2,-2,2,1,-1,-3,-1,"w1819","Non.motorized",NA,"Wed","weekday"
"6458",2019-01-23,"Washington Gulch","3","3","2",8,0,40,-1,14,20,2,-2,-2,2,1,-1,-3,-1,"w1819","Mechanized",NA,"Wed","weekday"
"6459",2019-01-23,"Washington Gulch","3","3","2",8,0,40,-1,14,20,2,-2,-2,2,1,-1,-3,-1,"w1819","Motorized",NA,"Wed","weekday"
"6460",2019-01-23,"Washington Gulch","3","3","2",8,0,40,-1,14,20,2,-2,-2,2,1,-1,-3,-1,"w1819","Hybrid",NA,"Wed","weekday"
"6461",2019-01-24,"Washington Gulch","3","3","2",8.2,0.2,40,0,17,20.5,-1,2,-2,-2,-1,1,-1,-3,"w1819","Non.motorized",1,"Thu","weekday"
"6462",2019-01-24,"Washington Gulch","3","3","2",8.2,0.2,40,0,17,20.5,-1,2,-2,-2,-1,1,-1,-3,"w1819","Mechanized",1,"Thu","weekday"
"6463",2019-01-24,"Washington Gulch","3","3","2",8.2,0.2,40,0,17,20.5,-1,2,-2,-2,-1,1,-1,-3,"w1819","Motorized",0,"Thu","weekday"
"6464",2019-01-24,"Washington Gulch","3","3","2",8.2,0.2,40,0,17,20.5,-1,2,-2,-2,-1,1,-1,-3,"w1819","Hybrid",0,"Thu","weekday"
"6465",2019-01-25,"Washington Gulch","3","3","2",8.3,0.1,40,0,15,20.8,0,-1,2,-2,0,-1,1,-1,"w1819","Non.motorized",0,"Fri","weekday"
"6466",2019-01-25,"Washington Gulch","3","3","2",8.3,0.1,40,0,15,20.8,0,-1,2,-2,0,-1,1,-1,"w1819","Mechanized",0,"Fri","weekday"
"6467",2019-01-25,"Washington Gulch","3","3","2",8.3,0.1,40,0,15,20.8,0,-1,2,-2,0,-1,1,-1,"w1819","Motorized",1,"Fri","weekday"
"6468",2019-01-25,"Washington Gulch","3","3","2",8.3,0.1,40,0,15,20.8,0,-1,2,-2,0,-1,1,-1,"w1819","Hybrid",0,"Fri","weekday"
"6469",2019-01-26,"Washington Gulch","3","3","2",8.3,0,39,-1,19,21.3,0,0,-1,2,-1,-1,-2,0,"w1819","Non.motorized",0,"Sat","weekend"
"6470",2019-01-26,"Washington Gulch","3","3","2",8.3,0,39,-1,19,21.3,0,0,-1,2,-1,-1,-2,0,"w1819","Mechanized",0,"Sat","weekend"
"6471",2019-01-26,"Washington Gulch","3","3","2",8.3,0,39,-1,19,21.3,0,0,-1,2,-1,-1,-2,0,"w1819","Motorized",0,"Sat","weekend"
"6472",2019-01-26,"Washington Gulch","3","3","2",8.3,0,39,-1,19,21.3,0,0,-1,2,-1,-1,-2,0,"w1819","Hybrid",0,"Sat","weekend"
"6473",2019-01-27,"Washington Gulch","3","3","2",8.3,0,38,-1,24,21.8,-1,0,0,-1,-2,-2,-2,-3,"w1819","Non.motorized",0,"Sun","weekend"
"6474",2019-01-27,"Washington Gulch","3","3","2",8.3,0,38,-1,24,21.8,-1,0,0,-1,-2,-2,-2,-3,"w1819","Mechanized",0,"Sun","weekend"
"6475",2019-01-27,"Washington Gulch","3","3","2",8.3,0,38,-1,24,21.8,-1,0,0,-1,-2,-2,-2,-3,"w1819","Motorized",0,"Sun","weekend"
"6476",2019-01-27,"Washington Gulch","3","3","2",8.3,0,38,-1,24,21.8,-1,0,0,-1,-2,-2,-2,-3,"w1819","Hybrid",0,"Sun","weekend"
"6477",2019-01-28,"Washington Gulch","2","2","2",8.3,0,38,0,17,21.8,-1,-1,0,0,-1,-2,-2,-2,"w1819","Non.motorized",0,"Mon","weekday"
"6478",2019-01-28,"Washington Gulch","2","2","2",8.3,0,38,0,17,21.8,-1,-1,0,0,-1,-2,-2,-2,"w1819","Mechanized",0,"Mon","weekday"
"6479",2019-01-28,"Washington Gulch","2","2","2",8.3,0,38,0,17,21.8,-1,-1,0,0,-1,-2,-2,-2,"w1819","Motorized",0,"Mon","weekday"
"6480",2019-01-28,"Washington Gulch","2","2","2",8.3,0,38,0,17,21.8,-1,-1,0,0,-1,-2,-2,-2,"w1819","Hybrid",0,"Mon","weekday"
"6481",2019-01-29,"Washington Gulch","2","2","2",8.3,0,38,0,16,21.8,0,-1,-1,0,0,-1,-2,-2,"w1819","Non.motorized",0,"Tue","weekday"
"6482",2019-01-29,"Washington Gulch","2","2","2",8.3,0,38,0,16,21.8,0,-1,-1,0,0,-1,-2,-2,"w1819","Mechanized",0,"Tue","weekday"
"6483",2019-01-29,"Washington Gulch","2","2","2",8.3,0,38,0,16,21.8,0,-1,-1,0,0,-1,-2,-2,"w1819","Motorized",0,"Tue","weekday"
"6484",2019-01-29,"Washington Gulch","2","2","2",8.3,0,38,0,16,21.8,0,-1,-1,0,0,-1,-2,-2,"w1819","Hybrid",0,"Tue","weekday"
"6485",2019-01-30,"Washington Gulch","2","2","1",8.3,0,37,-1,20,22.4,0,0,-1,-1,-1,-1,-2,-3,"w1819","Non.motorized",0,"Wed","weekday"
"6486",2019-01-30,"Washington Gulch","2","2","1",8.3,0,37,-1,20,22.4,0,0,-1,-1,-1,-1,-2,-3,"w1819","Mechanized",0,"Wed","weekday"
"6487",2019-01-30,"Washington Gulch","2","2","1",8.3,0,37,-1,20,22.4,0,0,-1,-1,-1,-1,-2,-3,"w1819","Motorized",0,"Wed","weekday"
"6488",2019-01-30,"Washington Gulch","2","2","1",8.3,0,37,-1,20,22.4,0,0,-1,-1,-1,-1,-2,-3,"w1819","Hybrid",0,"Wed","weekday"
"6489",2019-01-31,"Washington Gulch","2","2","1",8.3,0,36,-1,24,23.1,-1,0,0,-1,-2,-2,-2,-3,"w1819","Non.motorized",0,"Thu","weekday"
"6490",2019-01-31,"Washington Gulch","2","2","1",8.3,0,36,-1,24,23.1,-1,0,0,-1,-2,-2,-2,-3,"w1819","Mechanized",0,"Thu","weekday"
"6491",2019-01-31,"Washington Gulch","2","2","1",8.3,0,36,-1,24,23.1,-1,0,0,-1,-2,-2,-2,-3,"w1819","Motorized",0,"Thu","weekday"
"6492",2019-01-31,"Washington Gulch","2","2","1",8.3,0,36,-1,24,23.1,-1,0,0,-1,-2,-2,-2,-3,"w1819","Hybrid",0,"Thu","weekday"
"6493",2019-02-01,"Washington Gulch","2","2","1",8.3,0,36,0,25,23.1,-1,-1,0,0,-1,-2,-2,-2,"w1819","Non.motorized",0,"Fri","weekday"
"6494",2019-02-01,"Washington Gulch","2","2","1",8.3,0,36,0,25,23.1,-1,-1,0,0,-1,-2,-2,-2,"w1819","Mechanized",0,"Fri","weekday"
"6495",2019-02-01,"Washington Gulch","2","2","1",8.3,0,36,0,25,23.1,-1,-1,0,0,-1,-2,-2,-2,"w1819","Motorized",0,"Fri","weekday"
"6496",2019-02-01,"Washington Gulch","2","2","1",8.3,0,36,0,25,23.1,-1,-1,0,0,-1,-2,-2,-2,"w1819","Hybrid",0,"Fri","weekday"
"6497",2019-02-02,"Washington Gulch","2","2","1",8.3,0,36,0,26,23.1,0,-1,-1,0,0,-1,-2,-2,"w1819","Non.motorized",0,"Sat","weekend"
"6498",2019-02-02,"Washington Gulch","2","2","1",8.3,0,36,0,26,23.1,0,-1,-1,0,0,-1,-2,-2,"w1819","Mechanized",0,"Sat","weekend"
"6499",2019-02-02,"Washington Gulch","2","2","1",8.3,0,36,0,26,23.1,0,-1,-1,0,0,-1,-2,-2,"w1819","Motorized",0,"Sat","weekend"
"6500",2019-02-02,"Washington Gulch","2","2","1",8.3,0,36,0,26,23.1,0,-1,-1,0,0,-1,-2,-2,"w1819","Hybrid",0,"Sat","weekend"
"6501",2019-02-03,"Washington Gulch","3","3","2",8.4,0.1,36,0,28,23.3,0,0,-1,-1,0,0,-1,-2,"w1819","Non.motorized",0,"Sun","weekend"
"6502",2019-02-03,"Washington Gulch","3","3","2",8.4,0.1,36,0,28,23.3,0,0,-1,-1,0,0,-1,-2,"w1819","Mechanized",0,"Sun","weekend"
"6503",2019-02-03,"Washington Gulch","3","3","2",8.4,0.1,36,0,28,23.3,0,0,-1,-1,0,0,-1,-2,"w1819","Motorized",0,"Sun","weekend"
"6504",2019-02-03,"Washington Gulch","3","3","2",8.4,0.1,36,0,28,23.3,0,0,-1,-1,0,0,-1,-2,"w1819","Hybrid",0,"Sun","weekend"
"6505",2019-02-04,"Washington Gulch","3","3","2",8.8,0.4,39,3,28,22.6,0,0,0,-1,3,3,3,2,"w1819","Non.motorized",0,"Mon","weekday"
"6506",2019-02-04,"Washington Gulch","3","3","2",8.8,0.4,39,3,28,22.6,0,0,0,-1,3,3,3,2,"w1819","Mechanized",0,"Mon","weekday"
"6507",2019-02-04,"Washington Gulch","3","3","2",8.8,0.4,39,3,28,22.6,0,0,0,-1,3,3,3,2,"w1819","Motorized",0,"Mon","weekday"
"6508",2019-02-04,"Washington Gulch","3","3","2",8.8,0.4,39,3,28,22.6,0,0,0,-1,3,3,3,2,"w1819","Hybrid",0,"Mon","weekday"
"6509",2019-02-05,"Washington Gulch","3","2","2",9,0.2,40,1,26,22.5,3,0,0,0,4,4,4,4,"w1819","Non.motorized",2,"Tue","weekday"
"6510",2019-02-05,"Washington Gulch","3","2","2",9,0.2,40,1,26,22.5,3,0,0,0,4,4,4,4,"w1819","Mechanized",0,"Tue","weekday"
"6511",2019-02-05,"Washington Gulch","3","2","2",9,0.2,40,1,26,22.5,3,0,0,0,4,4,4,4,"w1819","Motorized",0,"Tue","weekday"
"6512",2019-02-05,"Washington Gulch","3","2","2",9,0.2,40,1,26,22.5,3,0,0,0,4,4,4,4,"w1819","Hybrid",0,"Tue","weekday"
"6513",2019-02-06,"Washington Gulch","4","4","3",9,0,40,0,16,22.5,1,3,0,0,1,4,4,4,"w1819","Non.motorized",3,"Wed","weekday"
"6514",2019-02-06,"Washington Gulch","4","4","3",9,0,40,0,16,22.5,1,3,0,0,1,4,4,4,"w1819","Mechanized",0,"Wed","weekday"
"6515",2019-02-06,"Washington Gulch","4","4","3",9,0,40,0,16,22.5,1,3,0,0,1,4,4,4,"w1819","Motorized",0,"Wed","weekday"
"6516",2019-02-06,"Washington Gulch","4","4","3",9,0,40,0,16,22.5,1,3,0,0,1,4,4,4,"w1819","Hybrid",0,"Wed","weekday"
"6517",2019-02-07,"Washington Gulch","3","3","2",9.2,0.2,43,3,4,21.4,0,1,3,0,3,4,7,7,"w1819","Non.motorized",19,"Thu","weekday"
"6518",2019-02-07,"Washington Gulch","3","3","2",9.2,0.2,43,3,4,21.4,0,1,3,0,3,4,7,7,"w1819","Mechanized",0,"Thu","weekday"
"6519",2019-02-07,"Washington Gulch","3","3","2",9.2,0.2,43,3,4,21.4,0,1,3,0,3,4,7,7,"w1819","Motorized",2,"Thu","weekday"
"6520",2019-02-07,"Washington Gulch","3","3","2",9.2,0.2,43,3,4,21.4,0,1,3,0,3,4,7,7,"w1819","Hybrid",2,"Thu","weekday"
"6521",2019-02-08,"Washington Gulch","3","2","2",9.2,0,42,-1,10,21.9,3,0,1,3,2,2,3,6,"w1819","Non.motorized",0,"Fri","weekday"
"6522",2019-02-08,"Washington Gulch","3","2","2",9.2,0,42,-1,10,21.9,3,0,1,3,2,2,3,6,"w1819","Mechanized",0,"Fri","weekday"
"6523",2019-02-08,"Washington Gulch","3","2","2",9.2,0,42,-1,10,21.9,3,0,1,3,2,2,3,6,"w1819","Motorized",0,"Fri","weekday"
"6524",2019-02-08,"Washington Gulch","3","2","2",9.2,0,42,-1,10,21.9,3,0,1,3,2,2,3,6,"w1819","Hybrid",0,"Fri","weekday"
"6525",2019-02-09,"Washington Gulch","3","2","2",9.2,0,41,-1,20,22.4,-1,3,0,1,-2,1,1,2,"w1819","Non.motorized",5,"Sat","weekend"
"6526",2019-02-09,"Washington Gulch","3","2","2",9.2,0,41,-1,20,22.4,-1,3,0,1,-2,1,1,2,"w1819","Mechanized",0,"Sat","weekend"
"6527",2019-02-09,"Washington Gulch","3","2","2",9.2,0,41,-1,20,22.4,-1,3,0,1,-2,1,1,2,"w1819","Motorized",0,"Sat","weekend"
"6528",2019-02-09,"Washington Gulch","3","2","2",9.2,0,41,-1,20,22.4,-1,3,0,1,-2,1,1,2,"w1819","Hybrid",0,"Sat","weekend"
"6529",2019-02-10,"Washington Gulch","2","2","2",9.3,0.1,40,-1,20,23.2,-1,-1,3,0,-2,-3,0,0,"w1819","Non.motorized",0,"Sun","weekend"
"6530",2019-02-10,"Washington Gulch","2","2","2",9.3,0.1,40,-1,20,23.2,-1,-1,3,0,-2,-3,0,0,"w1819","Mechanized",0,"Sun","weekend"
"6531",2019-02-10,"Washington Gulch","2","2","2",9.3,0.1,40,-1,20,23.2,-1,-1,3,0,-2,-3,0,0,"w1819","Motorized",0,"Sun","weekend"
"6532",2019-02-10,"Washington Gulch","2","2","2",9.3,0.1,40,-1,20,23.2,-1,-1,3,0,-2,-3,0,0,"w1819","Hybrid",0,"Sun","weekend"
"6533",2019-02-11,"Washington Gulch","2","2","1",9.3,0,40,0,15,23.2,-1,-1,-1,3,-1,-2,-3,0,"w1819","Non.motorized",0,"Mon","weekday"
"6534",2019-02-11,"Washington Gulch","2","2","1",9.3,0,40,0,15,23.2,-1,-1,-1,3,-1,-2,-3,0,"w1819","Mechanized",0,"Mon","weekday"
"6535",2019-02-11,"Washington Gulch","2","2","1",9.3,0,40,0,15,23.2,-1,-1,-1,3,-1,-2,-3,0,"w1819","Motorized",0,"Mon","weekday"
"6536",2019-02-11,"Washington Gulch","2","2","1",9.3,0,40,0,15,23.2,-1,-1,-1,3,-1,-2,-3,0,"w1819","Hybrid",0,"Mon","weekday"
"6537",2019-02-12,"Washington Gulch","2","2","1",9.3,0,40,0,18,23.2,0,-1,-1,-1,0,-1,-2,-3,"w1819","Non.motorized",0,"Tue","weekday"
"6538",2019-02-12,"Washington Gulch","2","2","1",9.3,0,40,0,18,23.2,0,-1,-1,-1,0,-1,-2,-3,"w1819","Mechanized",0,"Tue","weekday"
"6539",2019-02-12,"Washington Gulch","2","2","1",9.3,0,40,0,18,23.2,0,-1,-1,-1,0,-1,-2,-3,"w1819","Motorized",2,"Tue","weekday"
"6540",2019-02-12,"Washington Gulch","2","2","1",9.3,0,40,0,18,23.2,0,-1,-1,-1,0,-1,-2,-3,"w1819","Hybrid",0,"Tue","weekday"
"6541",2019-02-13,"Washington Gulch","2","2","1",9.4,0.1,40,0,26,23.5,0,0,-1,-1,0,0,-1,-2,"w1819","Non.motorized",NA,"Wed","weekday"
"6542",2019-02-13,"Washington Gulch","2","2","1",9.4,0.1,40,0,26,23.5,0,0,-1,-1,0,0,-1,-2,"w1819","Mechanized",NA,"Wed","weekday"
"6543",2019-02-13,"Washington Gulch","2","2","1",9.4,0.1,40,0,26,23.5,0,0,-1,-1,0,0,-1,-2,"w1819","Motorized",NA,"Wed","weekday"
"6544",2019-02-13,"Washington Gulch","2","2","1",9.4,0.1,40,0,26,23.5,0,0,-1,-1,0,0,-1,-2,"w1819","Hybrid",NA,"Wed","weekday"
"6545",2019-02-14,"Washington Gulch","3","2","2",9.7,0.3,41,1,29,23.7,0,0,0,-1,1,1,1,0,"w1819","Non.motorized",NA,"Thu","weekday"
"6546",2019-02-14,"Washington Gulch","3","2","2",9.7,0.3,41,1,29,23.7,0,0,0,-1,1,1,1,0,"w1819","Mechanized",NA,"Thu","weekday"
"6547",2019-02-14,"Washington Gulch","3","2","2",9.7,0.3,41,1,29,23.7,0,0,0,-1,1,1,1,0,"w1819","Motorized",NA,"Thu","weekday"
"6548",2019-02-14,"Washington Gulch","3","2","2",9.7,0.3,41,1,29,23.7,0,0,0,-1,1,1,1,0,"w1819","Hybrid",NA,"Thu","weekday"
"6549",2019-02-15,"Washington Gulch","4","4","3",10.8,1.1,51,10,27,21.2,1,0,0,0,11,11,11,11,"w1819","Non.motorized",1,"Fri","weekday"
"6550",2019-02-15,"Washington Gulch","4","4","3",10.8,1.1,51,10,27,21.2,1,0,0,0,11,11,11,11,"w1819","Mechanized",0,"Fri","weekday"
"6551",2019-02-15,"Washington Gulch","4","4","3",10.8,1.1,51,10,27,21.2,1,0,0,0,11,11,11,11,"w1819","Motorized",0,"Fri","weekday"
"6552",2019-02-15,"Washington Gulch","4","4","3",10.8,1.1,51,10,27,21.2,1,0,0,0,11,11,11,11,"w1819","Hybrid",0,"Fri","weekday"
"6553",2019-02-16,"Washington Gulch","3","3","3",11.1,0.3,52,1,14,21.3,10,1,0,0,11,12,12,12,"w1819","Non.motorized",0,"Sat","weekend"
"6554",2019-02-16,"Washington Gulch","3","3","3",11.1,0.3,52,1,14,21.3,10,1,0,0,11,12,12,12,"w1819","Mechanized",0,"Sat","weekend"
"6555",2019-02-16,"Washington Gulch","3","3","3",11.1,0.3,52,1,14,21.3,10,1,0,0,11,12,12,12,"w1819","Motorized",0,"Sat","weekend"
"6556",2019-02-16,"Washington Gulch","3","3","3",11.1,0.3,52,1,14,21.3,10,1,0,0,11,12,12,12,"w1819","Hybrid",0,"Sat","weekend"
"6557",2019-02-17,"Washington Gulch","3","3","3",11.3,0.2,55,3,10,20.5,1,10,1,0,4,14,15,15,"w1819","Non.motorized",0,"Sun","weekend"
"6558",2019-02-17,"Washington Gulch","3","3","3",11.3,0.2,55,3,10,20.5,1,10,1,0,4,14,15,15,"w1819","Mechanized",0,"Sun","weekend"
"6559",2019-02-17,"Washington Gulch","3","3","3",11.3,0.2,55,3,10,20.5,1,10,1,0,4,14,15,15,"w1819","Motorized",0,"Sun","weekend"
"6560",2019-02-17,"Washington Gulch","3","3","3",11.3,0.2,55,3,10,20.5,1,10,1,0,4,14,15,15,"w1819","Hybrid",0,"Sun","weekend"
"6561",2019-02-18,"Washington Gulch","3","3","2",11.4,0.1,53,-2,13,21.5,3,1,10,1,1,2,12,13,"w1819","Non.motorized",0,"Mon","weekday"
"6562",2019-02-18,"Washington Gulch","3","3","2",11.4,0.1,53,-2,13,21.5,3,1,10,1,1,2,12,13,"w1819","Mechanized",0,"Mon","weekday"
"6563",2019-02-18,"Washington Gulch","3","3","2",11.4,0.1,53,-2,13,21.5,3,1,10,1,1,2,12,13,"w1819","Motorized",0,"Mon","weekday"
"6564",2019-02-18,"Washington Gulch","3","3","2",11.4,0.1,53,-2,13,21.5,3,1,10,1,1,2,12,13,"w1819","Hybrid",0,"Mon","weekday"
"6565",2019-02-19,"Washington Gulch","3","3","2",11.5,0.1,53,0,11,21.7,-2,3,1,10,-2,1,2,12,"w1819","Non.motorized",0,"Tue","weekday"
"6566",2019-02-19,"Washington Gulch","3","3","2",11.5,0.1,53,0,11,21.7,-2,3,1,10,-2,1,2,12,"w1819","Mechanized",0,"Tue","weekday"
"6567",2019-02-19,"Washington Gulch","3","3","2",11.5,0.1,53,0,11,21.7,-2,3,1,10,-2,1,2,12,"w1819","Motorized",0,"Tue","weekday"
"6568",2019-02-19,"Washington Gulch","3","3","2",11.5,0.1,53,0,11,21.7,-2,3,1,10,-2,1,2,12,"w1819","Hybrid",0,"Tue","weekday"
"6569",2019-02-20,"Washington Gulch","3","3","2",11.6,0.1,53,0,7,21.9,0,-2,3,1,0,-2,1,2,"w1819","Non.motorized",0,"Wed","weekday"
"6570",2019-02-20,"Washington Gulch","3","3","2",11.6,0.1,53,0,7,21.9,0,-2,3,1,0,-2,1,2,"w1819","Mechanized",0,"Wed","weekday"
"6571",2019-02-20,"Washington Gulch","3","3","2",11.6,0.1,53,0,7,21.9,0,-2,3,1,0,-2,1,2,"w1819","Motorized",0,"Wed","weekday"
"6572",2019-02-20,"Washington Gulch","3","3","2",11.6,0.1,53,0,7,21.9,0,-2,3,1,0,-2,1,2,"w1819","Hybrid",0,"Wed","weekday"
"6573",2019-02-21,"Washington Gulch","3","3","3",11.6,0,52,-1,15,22.3,0,0,-2,3,-1,-1,-3,0,"w1819","Non.motorized",0,"Thu","weekday"
"6574",2019-02-21,"Washington Gulch","3","3","3",11.6,0,52,-1,15,22.3,0,0,-2,3,-1,-1,-3,0,"w1819","Mechanized",0,"Thu","weekday"
"6575",2019-02-21,"Washington Gulch","3","3","3",11.6,0,52,-1,15,22.3,0,0,-2,3,-1,-1,-3,0,"w1819","Motorized",0,"Thu","weekday"
"6576",2019-02-21,"Washington Gulch","3","3","3",11.6,0,52,-1,15,22.3,0,0,-2,3,-1,-1,-3,0,"w1819","Hybrid",0,"Thu","weekday"
"6577",2019-02-22,"Washington Gulch","3","3","3",11.8,0.2,52,0,20,22.7,-1,0,0,-2,-1,-1,-1,-3,"w1819","Non.motorized",0,"Fri","weekday"
"6578",2019-02-22,"Washington Gulch","3","3","3",11.8,0.2,52,0,20,22.7,-1,0,0,-2,-1,-1,-1,-3,"w1819","Mechanized",0,"Fri","weekday"
"6579",2019-02-22,"Washington Gulch","3","3","3",11.8,0.2,52,0,20,22.7,-1,0,0,-2,-1,-1,-1,-3,"w1819","Motorized",0,"Fri","weekday"
"6580",2019-02-22,"Washington Gulch","3","3","3",11.8,0.2,52,0,20,22.7,-1,0,0,-2,-1,-1,-1,-3,"w1819","Hybrid",0,"Fri","weekday"
"6581",2019-02-23,"Washington Gulch","3","3","3",12.1,0.3,53,1,13,22.8,0,-1,0,0,1,0,0,0,"w1819","Non.motorized",11,"Sat","weekend"
"6582",2019-02-23,"Washington Gulch","3","3","3",12.1,0.3,53,1,13,22.8,0,-1,0,0,1,0,0,0,"w1819","Mechanized",0,"Sat","weekend"
"6583",2019-02-23,"Washington Gulch","3","3","3",12.1,0.3,53,1,13,22.8,0,-1,0,0,1,0,0,0,"w1819","Motorized",13,"Sat","weekend"
"6584",2019-02-23,"Washington Gulch","3","3","3",12.1,0.3,53,1,13,22.8,0,-1,0,0,1,0,0,0,"w1819","Hybrid",6,"Sat","weekend"
"6585",2019-02-24,"Washington Gulch","3","3","2",12.1,0,52,-1,14,23.3,1,0,-1,0,0,0,-1,-1,"w1819","Non.motorized",24,"Sun","weekend"
"6586",2019-02-24,"Washington Gulch","3","3","2",12.1,0,52,-1,14,23.3,1,0,-1,0,0,0,-1,-1,"w1819","Mechanized",0,"Sun","weekend"
"6587",2019-02-24,"Washington Gulch","3","3","2",12.1,0,52,-1,14,23.3,1,0,-1,0,0,0,-1,-1,"w1819","Motorized",4,"Sun","weekend"
"6588",2019-02-24,"Washington Gulch","3","3","2",12.1,0,52,-1,14,23.3,1,0,-1,0,0,0,-1,-1,"w1819","Hybrid",2,"Sun","weekend"
"6589",2019-02-25,"Washington Gulch","3","3","2",12.1,0,51,-1,22,23.7,-1,1,0,-1,-2,-1,-1,-2,"w1819","Non.motorized",11,"Mon","weekday"
"6590",2019-02-25,"Washington Gulch","3","3","2",12.1,0,51,-1,22,23.7,-1,1,0,-1,-2,-1,-1,-2,"w1819","Mechanized",0,"Mon","weekday"
"6591",2019-02-25,"Washington Gulch","3","3","2",12.1,0,51,-1,22,23.7,-1,1,0,-1,-2,-1,-1,-2,"w1819","Motorized",3,"Mon","weekday"
"6592",2019-02-25,"Washington Gulch","3","3","2",12.1,0,51,-1,22,23.7,-1,1,0,-1,-2,-1,-1,-2,"w1819","Hybrid",0,"Mon","weekday"
"6593",2019-02-26,"Washington Gulch","2","2","2",12.1,0,50,-1,27,24.2,-1,-1,1,0,-2,-3,-2,-2,"w1819","Non.motorized",38,"Tue","weekday"
"6594",2019-02-26,"Washington Gulch","2","2","2",12.1,0,50,-1,27,24.2,-1,-1,1,0,-2,-3,-2,-2,"w1819","Mechanized",0,"Tue","weekday"
"6595",2019-02-26,"Washington Gulch","2","2","2",12.1,0,50,-1,27,24.2,-1,-1,1,0,-2,-3,-2,-2,"w1819","Motorized",7,"Tue","weekday"
"6596",2019-02-26,"Washington Gulch","2","2","2",12.1,0,50,-1,27,24.2,-1,-1,1,0,-2,-3,-2,-2,"w1819","Hybrid",1,"Tue","weekday"
"6597",2019-02-27,"Washington Gulch","2","2","2",12.1,0,50,0,30,24.2,-1,-1,-1,1,-1,-2,-3,-2,"w1819","Non.motorized",49,"Wed","weekday"
"6598",2019-02-27,"Washington Gulch","2","2","2",12.1,0,50,0,30,24.2,-1,-1,-1,1,-1,-2,-3,-2,"w1819","Mechanized",0,"Wed","weekday"
"6599",2019-02-27,"Washington Gulch","2","2","2",12.1,0,50,0,30,24.2,-1,-1,-1,1,-1,-2,-3,-2,"w1819","Motorized",0,"Wed","weekday"
"6600",2019-02-27,"Washington Gulch","2","2","2",12.1,0,50,0,30,24.2,-1,-1,-1,1,-1,-2,-3,-2,"w1819","Hybrid",0,"Wed","weekday"
"6601",2019-02-28,"Washington Gulch","2","2","2",12.2,0.1,49,-1,30,24.9,0,-1,-1,-1,-1,-2,-3,-4,"w1819","Non.motorized",8,"Thu","weekday"
"6602",2019-02-28,"Washington Gulch","2","2","2",12.2,0.1,49,-1,30,24.9,0,-1,-1,-1,-1,-2,-3,-4,"w1819","Mechanized",0,"Thu","weekday"
"6603",2019-02-28,"Washington Gulch","2","2","2",12.2,0.1,49,-1,30,24.9,0,-1,-1,-1,-1,-2,-3,-4,"w1819","Motorized",2,"Thu","weekday"
"6604",2019-02-28,"Washington Gulch","2","2","2",12.2,0.1,49,-1,30,24.9,0,-1,-1,-1,-1,-2,-3,-4,"w1819","Hybrid",2,"Thu","weekday"
"6605",2019-03-01,"Washington Gulch","2","2","1",12.3,0.1,49,0,29,25.1,-1,0,-1,-1,-1,-1,-2,-3,"w1819","Non.motorized",7,"Fri","weekday"
"6606",2019-03-01,"Washington Gulch","2","2","1",12.3,0.1,49,0,29,25.1,-1,0,-1,-1,-1,-1,-2,-3,"w1819","Mechanized",0,"Fri","weekday"
"6607",2019-03-01,"Washington Gulch","2","2","1",12.3,0.1,49,0,29,25.1,-1,0,-1,-1,-1,-1,-2,-3,"w1819","Motorized",0,"Fri","weekday"
"6608",2019-03-01,"Washington Gulch","2","2","1",12.3,0.1,49,0,29,25.1,-1,0,-1,-1,-1,-1,-2,-3,"w1819","Hybrid",0,"Fri","weekday"
"6609",2019-03-02,"Washington Gulch","3","3","2",13,0.7,58,9,30,22.4,0,-1,0,-1,9,8,8,7,"w1819","Non.motorized",0,"Sat","weekend"
"6610",2019-03-02,"Washington Gulch","3","3","2",13,0.7,58,9,30,22.4,0,-1,0,-1,9,8,8,7,"w1819","Mechanized",0,"Sat","weekend"
"6611",2019-03-02,"Washington Gulch","3","3","2",13,0.7,58,9,30,22.4,0,-1,0,-1,9,8,8,7,"w1819","Motorized",0,"Sat","weekend"
"6612",2019-03-02,"Washington Gulch","3","3","2",13,0.7,58,9,30,22.4,0,-1,0,-1,9,8,8,7,"w1819","Hybrid",0,"Sat","weekend"
"6613",2019-03-03,"Washington Gulch","3","3","3",13.7,0.7,64,6,27,21.4,9,0,-1,0,15,15,14,14,"w1819","Non.motorized",0,"Sun","weekend"
"6614",2019-03-03,"Washington Gulch","3","3","3",13.7,0.7,64,6,27,21.4,9,0,-1,0,15,15,14,14,"w1819","Mechanized",0,"Sun","weekend"
"6615",2019-03-03,"Washington Gulch","3","3","3",13.7,0.7,64,6,27,21.4,9,0,-1,0,15,15,14,14,"w1819","Motorized",0,"Sun","weekend"
"6616",2019-03-03,"Washington Gulch","3","3","3",13.7,0.7,64,6,27,21.4,9,0,-1,0,15,15,14,14,"w1819","Hybrid",0,"Sun","weekend"
"6617",2019-03-04,"Washington Gulch","3","3","3",14.4,0.7,66,2,23,21.8,6,9,0,-1,8,17,17,16,"w1819","Non.motorized",4,"Mon","weekday"
"6618",2019-03-04,"Washington Gulch","3","3","3",14.4,0.7,66,2,23,21.8,6,9,0,-1,8,17,17,16,"w1819","Mechanized",0,"Mon","weekday"
"6619",2019-03-04,"Washington Gulch","3","3","3",14.4,0.7,66,2,23,21.8,6,9,0,-1,8,17,17,16,"w1819","Motorized",0,"Mon","weekday"
"6620",2019-03-04,"Washington Gulch","3","3","3",14.4,0.7,66,2,23,21.8,6,9,0,-1,8,17,17,16,"w1819","Hybrid",0,"Mon","weekday"
"6621",2019-03-05,"Washington Gulch","3","3","3",14.4,0,64,-2,24,22.5,2,6,9,0,0,6,15,15,"w1819","Non.motorized",12,"Tue","weekday"
"6622",2019-03-05,"Washington Gulch","3","3","3",14.4,0,64,-2,24,22.5,2,6,9,0,0,6,15,15,"w1819","Mechanized",0,"Tue","weekday"
"6623",2019-03-05,"Washington Gulch","3","3","3",14.4,0,64,-2,24,22.5,2,6,9,0,0,6,15,15,"w1819","Motorized",14,"Tue","weekday"
"6624",2019-03-05,"Washington Gulch","3","3","3",14.4,0,64,-2,24,22.5,2,6,9,0,0,6,15,15,"w1819","Hybrid",8,"Tue","weekday"
"6625",2019-03-06,"Washington Gulch","3","3","2",14.5,0.1,62,-2,31,23.4,-2,2,6,9,-4,-2,4,13,"w1819","Non.motorized",12,"Wed","weekday"
"6626",2019-03-06,"Washington Gulch","3","3","2",14.5,0.1,62,-2,31,23.4,-2,2,6,9,-4,-2,4,13,"w1819","Mechanized",0,"Wed","weekday"
"6627",2019-03-06,"Washington Gulch","3","3","2",14.5,0.1,62,-2,31,23.4,-2,2,6,9,-4,-2,4,13,"w1819","Motorized",0,"Wed","weekday"
"6628",2019-03-06,"Washington Gulch","3","3","2",14.5,0.1,62,-2,31,23.4,-2,2,6,9,-4,-2,4,13,"w1819","Hybrid",0,"Wed","weekday"
"6629",2019-03-06,"Washington Gulch","4","4","3",14.5,0.1,62,-2,31,23.4,-2,2,6,9,-4,-2,4,13,"w1819","Non.motorized",12,"Wed","weekday"
"6630",2019-03-06,"Washington Gulch","4","4","3",14.5,0.1,62,-2,31,23.4,-2,2,6,9,-4,-2,4,13,"w1819","Mechanized",0,"Wed","weekday"
"6631",2019-03-06,"Washington Gulch","4","4","3",14.5,0.1,62,-2,31,23.4,-2,2,6,9,-4,-2,4,13,"w1819","Motorized",0,"Wed","weekday"
"6632",2019-03-06,"Washington Gulch","4","4","3",14.5,0.1,62,-2,31,23.4,-2,2,6,9,-4,-2,4,13,"w1819","Hybrid",0,"Wed","weekday"
"6633",2019-03-07,"Washington Gulch","4","4","3",16.2,1.7,71,9,30,22.8,-2,-2,2,6,7,5,7,13,"w1819","Non.motorized",0,"Thu","weekday"
"6634",2019-03-07,"Washington Gulch","4","4","3",16.2,1.7,71,9,30,22.8,-2,-2,2,6,7,5,7,13,"w1819","Mechanized",0,"Thu","weekday"
"6635",2019-03-07,"Washington Gulch","4","4","3",16.2,1.7,71,9,30,22.8,-2,-2,2,6,7,5,7,13,"w1819","Motorized",0,"Thu","weekday"
"6636",2019-03-07,"Washington Gulch","4","4","3",16.2,1.7,71,9,30,22.8,-2,-2,2,6,7,5,7,13,"w1819","Hybrid",0,"Thu","weekday"
"6637",2019-03-08,"Washington Gulch","3","3","3",16.6,0.4,71,0,27,23.4,9,-2,-2,2,9,7,5,7,"w1819","Non.motorized",0,"Fri","weekday"
"6638",2019-03-08,"Washington Gulch","3","3","3",16.6,0.4,71,0,27,23.4,9,-2,-2,2,9,7,5,7,"w1819","Mechanized",0,"Fri","weekday"
"6639",2019-03-08,"Washington Gulch","3","3","3",16.6,0.4,71,0,27,23.4,9,-2,-2,2,9,7,5,7,"w1819","Motorized",3,"Fri","weekday"
"6640",2019-03-08,"Washington Gulch","3","3","3",16.6,0.4,71,0,27,23.4,9,-2,-2,2,9,7,5,7,"w1819","Hybrid",1,"Fri","weekday"
"6641",2019-03-09,"Washington Gulch","4","4","3",17.2,0.6,76,5,22,22.6,0,9,-2,-2,5,14,12,10,"w1819","Non.motorized",37,"Sat","weekend"
"6642",2019-03-09,"Washington Gulch","4","4","3",17.2,0.6,76,5,22,22.6,0,9,-2,-2,5,14,12,10,"w1819","Mechanized",0,"Sat","weekend"
"6643",2019-03-09,"Washington Gulch","4","4","3",17.2,0.6,76,5,22,22.6,0,9,-2,-2,5,14,12,10,"w1819","Motorized",5,"Sat","weekend"
"6644",2019-03-09,"Washington Gulch","4","4","3",17.2,0.6,76,5,22,22.6,0,9,-2,-2,5,14,12,10,"w1819","Hybrid",0,"Sat","weekend"
"6645",2019-03-10,"Washington Gulch","3","3","3",17.3,0.1,73,-3,25,23.7,5,0,9,-2,2,2,11,9,"w1819","Non.motorized",44,"Sun","weekend"
"6646",2019-03-10,"Washington Gulch","3","3","3",17.3,0.1,73,-3,25,23.7,5,0,9,-2,2,2,11,9,"w1819","Mechanized",0,"Sun","weekend"
"6647",2019-03-10,"Washington Gulch","3","3","3",17.3,0.1,73,-3,25,23.7,5,0,9,-2,2,2,11,9,"w1819","Motorized",8,"Sun","weekend"
"6648",2019-03-10,"Washington Gulch","3","3","3",17.3,0.1,73,-3,25,23.7,5,0,9,-2,2,2,11,9,"w1819","Hybrid",2,"Sun","weekend"
"6649",2019-03-11,"Washington Gulch","3","3","2",17.3,0,71,-2,29,24.4,-3,5,0,9,-5,0,0,9,"w1819","Non.motorized",11,"Mon","weekday"
"6650",2019-03-11,"Washington Gulch","3","3","2",17.3,0,71,-2,29,24.4,-3,5,0,9,-5,0,0,9,"w1819","Mechanized",0,"Mon","weekday"
"6651",2019-03-11,"Washington Gulch","3","3","2",17.3,0,71,-2,29,24.4,-3,5,0,9,-5,0,0,9,"w1819","Motorized",0,"Mon","weekday"
"6652",2019-03-11,"Washington Gulch","3","3","2",17.3,0,71,-2,29,24.4,-3,5,0,9,-5,0,0,9,"w1819","Hybrid",0,"Mon","weekday"
"6653",2019-03-12,"Washington Gulch","3","3","3",17.4,0.1,70,-1,32,24.9,-2,-3,5,0,-3,-6,-1,-1,"w1819","Non.motorized",0,"Tue","weekday"
"6654",2019-03-12,"Washington Gulch","3","3","3",17.4,0.1,70,-1,32,24.9,-2,-3,5,0,-3,-6,-1,-1,"w1819","Mechanized",0,"Tue","weekday"
"6655",2019-03-12,"Washington Gulch","3","3","3",17.4,0.1,70,-1,32,24.9,-2,-3,5,0,-3,-6,-1,-1,"w1819","Motorized",0,"Tue","weekday"
"6656",2019-03-12,"Washington Gulch","3","3","3",17.4,0.1,70,-1,32,24.9,-2,-3,5,0,-3,-6,-1,-1,"w1819","Hybrid",0,"Tue","weekday"
"6657",2019-03-12,"Washington Gulch","4","4","4",17.4,0.1,70,-1,32,24.9,-2,-3,5,0,-3,-6,-1,-1,"w1819","Non.motorized",0,"Tue","weekday"
"6658",2019-03-12,"Washington Gulch","4","4","4",17.4,0.1,70,-1,32,24.9,-2,-3,5,0,-3,-6,-1,-1,"w1819","Mechanized",0,"Tue","weekday"
"6659",2019-03-12,"Washington Gulch","4","4","4",17.4,0.1,70,-1,32,24.9,-2,-3,5,0,-3,-6,-1,-1,"w1819","Motorized",0,"Tue","weekday"
"6660",2019-03-12,"Washington Gulch","4","4","4",17.4,0.1,70,-1,32,24.9,-2,-3,5,0,-3,-6,-1,-1,"w1819","Hybrid",0,"Tue","weekday"
"6661",2019-03-13,"Washington Gulch","4","4","3",18.1,0.7,74,4,24,24.5,-1,-2,-3,5,3,1,-2,3,"w1819","Non.motorized",0,"Wed","weekday"
"6662",2019-03-13,"Washington Gulch","4","4","3",18.1,0.7,74,4,24,24.5,-1,-2,-3,5,3,1,-2,3,"w1819","Mechanized",0,"Wed","weekday"
"6663",2019-03-13,"Washington Gulch","4","4","3",18.1,0.7,74,4,24,24.5,-1,-2,-3,5,3,1,-2,3,"w1819","Motorized",0,"Wed","weekday"
"6664",2019-03-13,"Washington Gulch","4","4","3",18.1,0.7,74,4,24,24.5,-1,-2,-3,5,3,1,-2,3,"w1819","Hybrid",0,"Wed","weekday"
"6665",2019-03-14,"Washington Gulch","4","4","3",18.1,0,74,0,17,24.5,4,-1,-2,-3,4,3,1,-2,"w1819","Non.motorized",0,"Thu","weekday"
"6666",2019-03-14,"Washington Gulch","4","4","3",18.1,0,74,0,17,24.5,4,-1,-2,-3,4,3,1,-2,"w1819","Mechanized",0,"Thu","weekday"
"6667",2019-03-14,"Washington Gulch","4","4","3",18.1,0,74,0,17,24.5,4,-1,-2,-3,4,3,1,-2,"w1819","Motorized",0,"Thu","weekday"
"6668",2019-03-14,"Washington Gulch","4","4","3",18.1,0,74,0,17,24.5,4,-1,-2,-3,4,3,1,-2,"w1819","Hybrid",0,"Thu","weekday"
"6669",2019-03-15,"Washington Gulch","3","3","2",18.1,0,72,-2,18,25.1,0,4,-1,-2,-2,2,1,-1,"w1819","Non.motorized",19,"Fri","weekday"
"6670",2019-03-15,"Washington Gulch","3","3","2",18.1,0,72,-2,18,25.1,0,4,-1,-2,-2,2,1,-1,"w1819","Mechanized",0,"Fri","weekday"
"6671",2019-03-15,"Washington Gulch","3","3","2",18.1,0,72,-2,18,25.1,0,4,-1,-2,-2,2,1,-1,"w1819","Motorized",13,"Fri","weekday"
"6672",2019-03-15,"Washington Gulch","3","3","2",18.1,0,72,-2,18,25.1,0,4,-1,-2,-2,2,1,-1,"w1819","Hybrid",0,"Fri","weekday"
"6673",2019-03-16,"Washington Gulch","3","3","2",18.2,0.1,70,-2,26,26,-2,0,4,-1,-4,-4,0,-1,"w1819","Non.motorized",60,"Sat","weekend"
"6674",2019-03-16,"Washington Gulch","3","3","2",18.2,0.1,70,-2,26,26,-2,0,4,-1,-4,-4,0,-1,"w1819","Mechanized",0,"Sat","weekend"
"6675",2019-03-16,"Washington Gulch","3","3","2",18.2,0.1,70,-2,26,26,-2,0,4,-1,-4,-4,0,-1,"w1819","Motorized",17,"Sat","weekend"
"6676",2019-03-16,"Washington Gulch","3","3","2",18.2,0.1,70,-2,26,26,-2,0,4,-1,-4,-4,0,-1,"w1819","Hybrid",0,"Sat","weekend"
"6677",2019-03-17,"Washington Gulch","3","3","2",18.2,0,69,-1,28,26.4,-2,-2,0,4,-3,-5,-5,-1,"w1819","Non.motorized",43,"Sun","weekend"
"6678",2019-03-17,"Washington Gulch","3","3","2",18.2,0,69,-1,28,26.4,-2,-2,0,4,-3,-5,-5,-1,"w1819","Mechanized",0,"Sun","weekend"
"6679",2019-03-17,"Washington Gulch","3","3","2",18.2,0,69,-1,28,26.4,-2,-2,0,4,-3,-5,-5,-1,"w1819","Motorized",24,"Sun","weekend"
"6680",2019-03-17,"Washington Gulch","3","3","2",18.2,0,69,-1,28,26.4,-2,-2,0,4,-3,-5,-5,-1,"w1819","Hybrid",0,"Sun","weekend"
"6681",2019-03-18,"Washington Gulch","2","2","2",18.3,0.1,68,-1,29,26.9,-1,-2,-2,0,-2,-4,-6,-6,"w1819","Non.motorized",19,"Mon","weekday"
"6682",2019-03-18,"Washington Gulch","2","2","2",18.3,0.1,68,-1,29,26.9,-1,-2,-2,0,-2,-4,-6,-6,"w1819","Mechanized",0,"Mon","weekday"
"6683",2019-03-18,"Washington Gulch","2","2","2",18.3,0.1,68,-1,29,26.9,-1,-2,-2,0,-2,-4,-6,-6,"w1819","Motorized",13,"Mon","weekday"
"6684",2019-03-18,"Washington Gulch","2","2","2",18.3,0.1,68,-1,29,26.9,-1,-2,-2,0,-2,-4,-6,-6,"w1819","Hybrid",0,"Mon","weekday"
"6685",2019-03-19,"Washington Gulch","2","2","2",18.3,0,67,-1,28,27.3,-1,-1,-2,-2,-2,-3,-5,-7,"w1819","Non.motorized",0,"Tue","weekday"
"6686",2019-03-19,"Washington Gulch","2","2","2",18.3,0,67,-1,28,27.3,-1,-1,-2,-2,-2,-3,-5,-7,"w1819","Mechanized",0,"Tue","weekday"
"6687",2019-03-19,"Washington Gulch","2","2","2",18.3,0,67,-1,28,27.3,-1,-1,-2,-2,-2,-3,-5,-7,"w1819","Motorized",0,"Tue","weekday"
"6688",2019-03-19,"Washington Gulch","2","2","2",18.3,0,67,-1,28,27.3,-1,-1,-2,-2,-2,-3,-5,-7,"w1819","Hybrid",0,"Tue","weekday"
"6689",2019-03-20,"Washington Gulch","2","2","2",18.3,0,66,-1,30,27.7,-1,-1,-1,-2,-2,-3,-4,-6,"w1819","Non.motorized",0,"Wed","weekday"
"6690",2019-03-20,"Washington Gulch","2","2","2",18.3,0,66,-1,30,27.7,-1,-1,-1,-2,-2,-3,-4,-6,"w1819","Mechanized",0,"Wed","weekday"
"6691",2019-03-20,"Washington Gulch","2","2","2",18.3,0,66,-1,30,27.7,-1,-1,-1,-2,-2,-3,-4,-6,"w1819","Motorized",0,"Wed","weekday"
"6692",2019-03-20,"Washington Gulch","2","2","2",18.3,0,66,-1,30,27.7,-1,-1,-1,-2,-2,-3,-4,-6,"w1819","Hybrid",0,"Wed","weekday"
"6693",2019-03-21,"Washington Gulch","2","2","2",18.4,0.1,65,-1,33,28.3,-1,-1,-1,-1,-2,-3,-4,-5,"w1819","Non.motorized",0,"Thu","weekday"
"6694",2019-03-21,"Washington Gulch","2","2","2",18.4,0.1,65,-1,33,28.3,-1,-1,-1,-1,-2,-3,-4,-5,"w1819","Mechanized",0,"Thu","weekday"
"6695",2019-03-21,"Washington Gulch","2","2","2",18.4,0.1,65,-1,33,28.3,-1,-1,-1,-1,-2,-3,-4,-5,"w1819","Motorized",0,"Thu","weekday"
"6696",2019-03-21,"Washington Gulch","2","2","2",18.4,0.1,65,-1,33,28.3,-1,-1,-1,-1,-2,-3,-4,-5,"w1819","Hybrid",0,"Thu","weekday"
"6697",2019-03-22,"Washington Gulch","3","3","2",18.4,0,64,-1,28,28.8,-1,-1,-1,-1,-2,-3,-4,-5,"w1819","Non.motorized",0,"Fri","weekday"
"6698",2019-03-22,"Washington Gulch","3","3","2",18.4,0,64,-1,28,28.8,-1,-1,-1,-1,-2,-3,-4,-5,"w1819","Mechanized",0,"Fri","weekday"
"6699",2019-03-22,"Washington Gulch","3","3","2",18.4,0,64,-1,28,28.8,-1,-1,-1,-1,-2,-3,-4,-5,"w1819","Motorized",0,"Fri","weekday"
"6700",2019-03-22,"Washington Gulch","3","3","2",18.4,0,64,-1,28,28.8,-1,-1,-1,-1,-2,-3,-4,-5,"w1819","Hybrid",0,"Fri","weekday"
"6701",2019-03-23,"Washington Gulch","2","2","1",18.4,0,65,1,28,28.3,-1,-1,-1,-1,0,-1,-2,-3,"w1819","Non.motorized",0,"Sat","weekend"
"6702",2019-03-23,"Washington Gulch","2","2","1",18.4,0,65,1,28,28.3,-1,-1,-1,-1,0,-1,-2,-3,"w1819","Mechanized",0,"Sat","weekend"
"6703",2019-03-23,"Washington Gulch","2","2","1",18.4,0,65,1,28,28.3,-1,-1,-1,-1,0,-1,-2,-3,"w1819","Motorized",0,"Sat","weekend"
"6704",2019-03-23,"Washington Gulch","2","2","1",18.4,0,65,1,28,28.3,-1,-1,-1,-1,0,-1,-2,-3,"w1819","Hybrid",0,"Sat","weekend"
"6705",2019-03-24,"Washington Gulch","2","2","1",18.4,0,64,-1,29,28.8,1,-1,-1,-1,0,-1,-2,-3,"w1819","Non.motorized",0,"Sun","weekend"
"6706",2019-03-24,"Washington Gulch","2","2","1",18.4,0,64,-1,29,28.8,1,-1,-1,-1,0,-1,-2,-3,"w1819","Mechanized",0,"Sun","weekend"
"6707",2019-03-24,"Washington Gulch","2","2","1",18.4,0,64,-1,29,28.8,1,-1,-1,-1,0,-1,-2,-3,"w1819","Motorized",0,"Sun","weekend"
"6708",2019-03-24,"Washington Gulch","2","2","1",18.4,0,64,-1,29,28.8,1,-1,-1,-1,0,-1,-2,-3,"w1819","Hybrid",0,"Sun","weekend"
"6709",2019-03-25,"Washington Gulch","2","2","2",18.6,0.2,64,0,31,29.1,-1,1,-1,-1,-1,0,-1,-2,"w1819","Non.motorized",4,"Mon","weekday"
"6710",2019-03-25,"Washington Gulch","2","2","2",18.6,0.2,64,0,31,29.1,-1,1,-1,-1,-1,0,-1,-2,"w1819","Mechanized",0,"Mon","weekday"
"6711",2019-03-25,"Washington Gulch","2","2","2",18.6,0.2,64,0,31,29.1,-1,1,-1,-1,-1,0,-1,-2,"w1819","Motorized",1,"Mon","weekday"
"6712",2019-03-25,"Washington Gulch","2","2","2",18.6,0.2,64,0,31,29.1,-1,1,-1,-1,-1,0,-1,-2,"w1819","Hybrid",0,"Mon","weekday"
"6713",2019-03-26,"Washington Gulch","2","2","2",18.9,0.3,63,-1,36,30,0,-1,1,-1,-1,-2,-1,-2,"w1819","Non.motorized",20,"Tue","weekday"
"6714",2019-03-26,"Washington Gulch","2","2","2",18.9,0.3,63,-1,36,30,0,-1,1,-1,-1,-2,-1,-2,"w1819","Mechanized",0,"Tue","weekday"
"6715",2019-03-26,"Washington Gulch","2","2","2",18.9,0.3,63,-1,36,30,0,-1,1,-1,-1,-2,-1,-2,"w1819","Motorized",0,"Tue","weekday"
"6716",2019-03-26,"Washington Gulch","2","2","2",18.9,0.3,63,-1,36,30,0,-1,1,-1,-1,-2,-1,-2,"w1819","Hybrid",0,"Tue","weekday"
"6717",2019-03-27,"Washington Gulch","1","2","2",18.9,0,62,-1,42,30.5,-1,0,-1,1,-2,-2,-3,-2,"w1819","Non.motorized",22,"Wed","weekday"
"6718",2019-03-27,"Washington Gulch","1","2","2",18.9,0,62,-1,42,30.5,-1,0,-1,1,-2,-2,-3,-2,"w1819","Mechanized",0,"Wed","weekday"
"6719",2019-03-27,"Washington Gulch","1","2","2",18.9,0,62,-1,42,30.5,-1,0,-1,1,-2,-2,-3,-2,"w1819","Motorized",2,"Wed","weekday"
"6720",2019-03-27,"Washington Gulch","1","2","2",18.9,0,62,-1,42,30.5,-1,0,-1,1,-2,-2,-3,-2,"w1819","Hybrid",0,"Wed","weekday"
"6721",2019-03-28,"Washington Gulch","1","2","2",18.9,0,60,-2,40,31.5,-1,-1,0,-1,-3,-4,-4,-5,"w1819","Non.motorized",13,"Thu","weekday"
"6722",2019-03-28,"Washington Gulch","1","2","2",18.9,0,60,-2,40,31.5,-1,-1,0,-1,-3,-4,-4,-5,"w1819","Mechanized",0,"Thu","weekday"
"6723",2019-03-28,"Washington Gulch","1","2","2",18.9,0,60,-2,40,31.5,-1,-1,0,-1,-3,-4,-4,-5,"w1819","Motorized",5,"Thu","weekday"
"6724",2019-03-28,"Washington Gulch","1","2","2",18.9,0,60,-2,40,31.5,-1,-1,0,-1,-3,-4,-4,-5,"w1819","Hybrid",0,"Thu","weekday"
"6725",2019-03-29,"Washington Gulch","1","1","1",19,0.1,58,-2,26,32.8,-2,-1,-1,0,-4,-5,-6,-6,"w1819","Non.motorized",15,"Fri","weekday"
"6726",2019-03-29,"Washington Gulch","1","1","1",19,0.1,58,-2,26,32.8,-2,-1,-1,0,-4,-5,-6,-6,"w1819","Mechanized",0,"Fri","weekday"
"6727",2019-03-29,"Washington Gulch","1","1","1",19,0.1,58,-2,26,32.8,-2,-1,-1,0,-4,-5,-6,-6,"w1819","Motorized",0,"Fri","weekday"
"6728",2019-03-29,"Washington Gulch","1","1","1",19,0.1,58,-2,26,32.8,-2,-1,-1,0,-4,-5,-6,-6,"w1819","Hybrid",0,"Fri","weekday"
"6729",2019-03-30,"Washington Gulch","1","1","1",19.1,0.1,61,3,24,31.3,-2,-2,-1,-1,1,-1,-2,-3,"w1819","Non.motorized",48,"Sat","weekend"
"6730",2019-03-30,"Washington Gulch","1","1","1",19.1,0.1,61,3,24,31.3,-2,-2,-1,-1,1,-1,-2,-3,"w1819","Mechanized",0,"Sat","weekend"
"6731",2019-03-30,"Washington Gulch","1","1","1",19.1,0.1,61,3,24,31.3,-2,-2,-1,-1,1,-1,-2,-3,"w1819","Motorized",2,"Sat","weekend"
"6732",2019-03-30,"Washington Gulch","1","1","1",19.1,0.1,61,3,24,31.3,-2,-2,-1,-1,1,-1,-2,-3,"w1819","Hybrid",1,"Sat","weekend"
"6733",2019-03-31,"Washington Gulch","1","1","1",19.1,0,59,-2,24,32.4,3,-2,-2,-1,1,-1,-3,-4,"w1819","Non.motorized",19,"Sun","weekend"
"6734",2019-03-31,"Washington Gulch","1","1","1",19.1,0,59,-2,24,32.4,3,-2,-2,-1,1,-1,-3,-4,"w1819","Mechanized",0,"Sun","weekend"
"6735",2019-03-31,"Washington Gulch","1","1","1",19.1,0,59,-2,24,32.4,3,-2,-2,-1,1,-1,-3,-4,"w1819","Motorized",0,"Sun","weekend"
"6736",2019-03-31,"Washington Gulch","1","1","1",19.1,0,59,-2,24,32.4,3,-2,-2,-1,1,-1,-3,-4,"w1819","Hybrid",0,"Sun","weekend"
"6737",2019-04-01,"Washington Gulch","2","1","1",19.1,0,58,-1,29,32.9,-2,3,-2,-2,-3,0,-2,-4,"w1819","Non.motorized",10,"Mon","weekday"
"6738",2019-04-01,"Washington Gulch","2","1","1",19.1,0,58,-1,29,32.9,-2,3,-2,-2,-3,0,-2,-4,"w1819","Mechanized",0,"Mon","weekday"
"6739",2019-04-01,"Washington Gulch","2","1","1",19.1,0,58,-1,29,32.9,-2,3,-2,-2,-3,0,-2,-4,"w1819","Motorized",5,"Mon","weekday"
"6740",2019-04-01,"Washington Gulch","2","1","1",19.1,0,58,-1,29,32.9,-2,3,-2,-2,-3,0,-2,-4,"w1819","Hybrid",1,"Mon","weekday"
"6741",2019-04-02,"Washington Gulch","1","1","1",19.1,0,58,0,33,32.9,-1,-2,3,-2,-1,-3,0,-2,"w1819","Non.motorized",13,"Tue","weekday"
"6742",2019-04-02,"Washington Gulch","1","1","1",19.1,0,58,0,33,32.9,-1,-2,3,-2,-1,-3,0,-2,"w1819","Mechanized",0,"Tue","weekday"
"6743",2019-04-02,"Washington Gulch","1","1","1",19.1,0,58,0,33,32.9,-1,-2,3,-2,-1,-3,0,-2,"w1819","Motorized",5,"Tue","weekday"
"6744",2019-04-02,"Washington Gulch","1","1","1",19.1,0,58,0,33,32.9,-1,-2,3,-2,-1,-3,0,-2,"w1819","Hybrid",0,"Tue","weekday"
"6745",2019-04-03,"Washington Gulch","2","1","1",19.2,0.1,58,0,31,33.1,0,-1,-2,3,0,-1,-3,0,"w1819","Non.motorized",5,"Wed","weekday"
"6746",2019-04-03,"Washington Gulch","2","1","1",19.2,0.1,58,0,31,33.1,0,-1,-2,3,0,-1,-3,0,"w1819","Mechanized",0,"Wed","weekday"
"6747",2019-04-03,"Washington Gulch","2","1","1",19.2,0.1,58,0,31,33.1,0,-1,-2,3,0,-1,-3,0,"w1819","Motorized",1,"Wed","weekday"
"6748",2019-04-03,"Washington Gulch","2","1","1",19.2,0.1,58,0,31,33.1,0,-1,-2,3,0,-1,-3,0,"w1819","Hybrid",1,"Wed","weekday"
"6749",2019-04-04,"Washington Gulch","2","1","1",19.4,0.2,59,1,35,32.9,0,0,-1,-2,1,1,0,-2,"w1819","Non.motorized",12,"Thu","weekday"
"6750",2019-04-04,"Washington Gulch","2","1","1",19.4,0.2,59,1,35,32.9,0,0,-1,-2,1,1,0,-2,"w1819","Mechanized",0,"Thu","weekday"
"6751",2019-04-04,"Washington Gulch","2","1","1",19.4,0.2,59,1,35,32.9,0,0,-1,-2,1,1,0,-2,"w1819","Motorized",3,"Thu","weekday"
"6752",2019-04-04,"Washington Gulch","2","1","1",19.4,0.2,59,1,35,32.9,0,0,-1,-2,1,1,0,-2,"w1819","Hybrid",3,"Thu","weekday"
"6753",2019-04-05,"Washington Gulch","1","1","1",19.4,0,57,-2,38,34,1,0,0,-1,-1,-1,-1,-2,"w1819","Non.motorized",8,"Fri","weekday"
"6754",2019-04-05,"Washington Gulch","1","1","1",19.4,0,57,-2,38,34,1,0,0,-1,-1,-1,-1,-2,"w1819","Mechanized",0,"Fri","weekday"
"6755",2019-04-05,"Washington Gulch","1","1","1",19.4,0,57,-2,38,34,1,0,0,-1,-1,-1,-1,-2,"w1819","Motorized",2,"Fri","weekday"
"6756",2019-04-05,"Washington Gulch","1","1","1",19.4,0,57,-2,38,34,1,0,0,-1,-1,-1,-1,-2,"w1819","Hybrid",2,"Fri","weekday"
"6757",2019-04-06,"Washington Gulch","1","1","1",19.3,-0.1,57,0,35,33.9,-2,1,0,0,-2,-1,-1,-1,"w1819","Non.motorized",0,"Sat","weekend"
"6758",2019-04-06,"Washington Gulch","1","1","1",19.3,-0.1,57,0,35,33.9,-2,1,0,0,-2,-1,-1,-1,"w1819","Mechanized",0,"Sat","weekend"
"6759",2019-04-06,"Washington Gulch","1","1","1",19.3,-0.1,57,0,35,33.9,-2,1,0,0,-2,-1,-1,-1,"w1819","Motorized",0,"Sat","weekend"
"6760",2019-04-06,"Washington Gulch","1","1","1",19.3,-0.1,57,0,35,33.9,-2,1,0,0,-2,-1,-1,-1,"w1819","Hybrid",0,"Sat","weekend"
"6761",2019-04-07,"Washington Gulch","1","1","1",19.1,-0.2,57,0,37,33.5,0,-2,1,0,0,-2,-1,-1,"w1819","Non.motorized",0,"Sun","weekend"
"6762",2019-04-07,"Washington Gulch","1","1","1",19.1,-0.2,57,0,37,33.5,0,-2,1,0,0,-2,-1,-1,"w1819","Mechanized",0,"Sun","weekend"
"6763",2019-04-07,"Washington Gulch","1","1","1",19.1,-0.2,57,0,37,33.5,0,-2,1,0,0,-2,-1,-1,"w1819","Motorized",0,"Sun","weekend"
"6764",2019-04-07,"Washington Gulch","1","1","1",19.1,-0.2,57,0,37,33.5,0,-2,1,0,0,-2,-1,-1,"w1819","Hybrid",0,"Sun","weekend"
"6765",2019-04-08,"Washington Gulch","1","2","2",19.3,0.2,54,-3,41,35.7,0,0,-2,1,-3,-3,-5,-4,"w1819","Non.motorized",9,"Mon","weekday"
"6766",2019-04-08,"Washington Gulch","1","2","2",19.3,0.2,54,-3,41,35.7,0,0,-2,1,-3,-3,-5,-4,"w1819","Mechanized",0,"Mon","weekday"
"6767",2019-04-08,"Washington Gulch","1","2","2",19.3,0.2,54,-3,41,35.7,0,0,-2,1,-3,-3,-5,-4,"w1819","Motorized",3,"Mon","weekday"
"6768",2019-04-08,"Washington Gulch","1","2","2",19.3,0.2,54,-3,41,35.7,0,0,-2,1,-3,-3,-5,-4,"w1819","Hybrid",1,"Mon","weekday"
"6769",2019-04-09,"Washington Gulch","1","2","2",19.3,0,53,-1,43,36.4,-3,0,0,-2,-4,-4,-4,-6,"w1819","Non.motorized",3,"Tue","weekday"
"6770",2019-04-09,"Washington Gulch","1","2","2",19.3,0,53,-1,43,36.4,-3,0,0,-2,-4,-4,-4,-6,"w1819","Mechanized",0,"Tue","weekday"
"6771",2019-04-09,"Washington Gulch","1","2","2",19.3,0,53,-1,43,36.4,-3,0,0,-2,-4,-4,-4,-6,"w1819","Motorized",3,"Tue","weekday"
"6772",2019-04-09,"Washington Gulch","1","2","2",19.3,0,53,-1,43,36.4,-3,0,0,-2,-4,-4,-4,-6,"w1819","Hybrid",0,"Tue","weekday"
"6773",2019-04-10,"Washington Gulch","2","2","1",19,-0.3,51,-2,30,37.3,-1,-3,0,0,-3,-6,-6,-6,"w1819","Non.motorized",4,"Wed","weekday"
"6774",2019-04-10,"Washington Gulch","2","2","1",19,-0.3,51,-2,30,37.3,-1,-3,0,0,-3,-6,-6,-6,"w1819","Mechanized",0,"Wed","weekday"
"6775",2019-04-10,"Washington Gulch","2","2","1",19,-0.3,51,-2,30,37.3,-1,-3,0,0,-3,-6,-6,-6,"w1819","Motorized",2,"Wed","weekday"
"6776",2019-04-10,"Washington Gulch","2","2","1",19,-0.3,51,-2,30,37.3,-1,-3,0,0,-3,-6,-6,-6,"w1819","Hybrid",2,"Wed","weekday"
"6777",2019-04-11,"Washington Gulch","3","3","2",18.9,-0.1,53,2,20,35.7,-2,-1,-3,0,0,-1,-4,-4,"w1819","Non.motorized",9,"Thu","weekday"
"6778",2019-04-11,"Washington Gulch","3","3","2",18.9,-0.1,53,2,20,35.7,-2,-1,-3,0,0,-1,-4,-4,"w1819","Mechanized",0,"Thu","weekday"
"6779",2019-04-11,"Washington Gulch","3","3","2",18.9,-0.1,53,2,20,35.7,-2,-1,-3,0,0,-1,-4,-4,"w1819","Motorized",1,"Thu","weekday"
"6780",2019-04-11,"Washington Gulch","3","3","2",18.9,-0.1,53,2,20,35.7,-2,-1,-3,0,0,-1,-4,-4,"w1819","Hybrid",1,"Thu","weekday"
"6781",2019-04-12,"Washington Gulch","2","2","1",18.7,-0.2,53,0,24,35.3,2,-2,-1,-3,2,0,-1,-4,"w1819","Non.motorized",11,"Fri","weekday"
"6782",2019-04-12,"Washington Gulch","2","2","1",18.7,-0.2,53,0,24,35.3,2,-2,-1,-3,2,0,-1,-4,"w1819","Mechanized",0,"Fri","weekday"
"6783",2019-04-12,"Washington Gulch","2","2","1",18.7,-0.2,53,0,24,35.3,2,-2,-1,-3,2,0,-1,-4,"w1819","Motorized",7,"Fri","weekday"
"6784",2019-04-12,"Washington Gulch","2","2","1",18.7,-0.2,53,0,24,35.3,2,-2,-1,-3,2,0,-1,-4,"w1819","Hybrid",0,"Fri","weekday"
"6785",2019-04-13,"Washington Gulch","1","1","1",18.8,0.1,52,-1,27,36.2,0,2,-2,-1,-1,1,-1,-2,"w1819","Non.motorized",0,"Sat","weekend"
"6786",2019-04-13,"Washington Gulch","1","1","1",18.8,0.1,52,-1,27,36.2,0,2,-2,-1,-1,1,-1,-2,"w1819","Mechanized",0,"Sat","weekend"
"6787",2019-04-13,"Washington Gulch","1","1","1",18.8,0.1,52,-1,27,36.2,0,2,-2,-1,-1,1,-1,-2,"w1819","Motorized",0,"Sat","weekend"
"6788",2019-04-13,"Washington Gulch","1","1","1",18.8,0.1,52,-1,27,36.2,0,2,-2,-1,-1,1,-1,-2,"w1819","Hybrid",0,"Sat","weekend"
"6789",2019-04-14,"Washington Gulch","1","1","1",18.7,-0.1,51,-1,35,36.7,-1,0,2,-2,-2,-2,0,-2,"w1819","Non.motorized",0,"Sun","weekend"
"6790",2019-04-14,"Washington Gulch","1","1","1",18.7,-0.1,51,-1,35,36.7,-1,0,2,-2,-2,-2,0,-2,"w1819","Mechanized",0,"Sun","weekend"
"6791",2019-04-14,"Washington Gulch","1","1","1",18.7,-0.1,51,-1,35,36.7,-1,0,2,-2,-2,-2,0,-2,"w1819","Motorized",0,"Sun","weekend"
"6792",2019-04-14,"Washington Gulch","1","1","1",18.7,-0.1,51,-1,35,36.7,-1,0,2,-2,-2,-2,0,-2,"w1819","Hybrid",0,"Sun","weekend"
"6793",2019-04-15,"Washington Gulch",NA,NA,NA,18.6,-0.1,50,-1,41,37.2,-1,-1,0,2,-2,-3,-3,-1,"w1819","Non.motorized",0,"Mon","weekday"
"6794",2019-04-15,"Washington Gulch",NA,NA,NA,18.6,-0.1,50,-1,41,37.2,-1,-1,0,2,-2,-3,-3,-1,"w1819","Mechanized",0,"Mon","weekday"
"6795",2019-04-15,"Washington Gulch",NA,NA,NA,18.6,-0.1,50,-1,41,37.2,-1,-1,0,2,-2,-3,-3,-1,"w1819","Motorized",0,"Mon","weekday"
"6796",2019-04-15,"Washington Gulch",NA,NA,NA,18.6,-0.1,50,-1,41,37.2,-1,-1,0,2,-2,-3,-3,-1,"w1819","Hybrid",0,"Mon","weekday"
"6797",2019-12-06,"Brush Creek Rd","2","2","1",2.9,0.4,19,5,24,15.3,0,0,0,0,5,5,5,5,"w1920","Non.motorized",10,"Fri","weekday"
"6798",2019-12-06,"Brush Creek Rd","2","2","1",2.9,0.4,19,5,24,15.3,0,0,0,0,5,5,5,5,"w1920","Mechanized",0,"Fri","weekday"
"6799",2019-12-06,"Brush Creek Rd","2","2","1",2.9,0.4,19,5,24,15.3,0,0,0,0,5,5,5,5,"w1920","Motorized",0,"Fri","weekday"
"6800",2019-12-06,"Brush Creek Rd","2","2","1",2.9,0.4,19,5,24,15.3,0,0,0,0,5,5,5,5,"w1920","Hybrid",0,"Fri","weekday"
"6801",2019-12-07,"Brush Creek Rd","2","2","1",3,0.1,18,-1,29,16.7,5,0,0,0,4,4,4,4,"w1920","Non.motorized",16,"Sat","weekend"
"6802",2019-12-07,"Brush Creek Rd","2","2","1",3,0.1,18,-1,29,16.7,5,0,0,0,4,4,4,4,"w1920","Mechanized",0,"Sat","weekend"
"6803",2019-12-07,"Brush Creek Rd","2","2","1",3,0.1,18,-1,29,16.7,5,0,0,0,4,4,4,4,"w1920","Motorized",0,"Sat","weekend"
"6804",2019-12-07,"Brush Creek Rd","2","2","1",3,0.1,18,-1,29,16.7,5,0,0,0,4,4,4,4,"w1920","Hybrid",0,"Sat","weekend"
"6805",2019-12-08,"Brush Creek Rd","2","2","1",3,0,17,-1,28,17.6,-1,5,0,0,-2,3,3,3,"w1920","Non.motorized",4,"Sun","weekend"
"6806",2019-12-08,"Brush Creek Rd","2","2","1",3,0,17,-1,28,17.6,-1,5,0,0,-2,3,3,3,"w1920","Mechanized",0,"Sun","weekend"
"6807",2019-12-08,"Brush Creek Rd","2","2","1",3,0,17,-1,28,17.6,-1,5,0,0,-2,3,3,3,"w1920","Motorized",0,"Sun","weekend"
"6808",2019-12-08,"Brush Creek Rd","2","2","1",3,0,17,-1,28,17.6,-1,5,0,0,-2,3,3,3,"w1920","Hybrid",0,"Sun","weekend"
"6809",2019-12-09,"Brush Creek Rd","3","3","2",3.4,0.4,22,5,21,15.5,-1,-1,5,0,4,3,8,8,"w1920","Non.motorized",2,"Mon","weekday"
"6810",2019-12-09,"Brush Creek Rd","3","3","2",3.4,0.4,22,5,21,15.5,-1,-1,5,0,4,3,8,8,"w1920","Mechanized",0,"Mon","weekday"
"6811",2019-12-09,"Brush Creek Rd","3","3","2",3.4,0.4,22,5,21,15.5,-1,-1,5,0,4,3,8,8,"w1920","Motorized",0,"Mon","weekday"
"6812",2019-12-09,"Brush Creek Rd","3","3","2",3.4,0.4,22,5,21,15.5,-1,-1,5,0,4,3,8,8,"w1920","Hybrid",0,"Mon","weekday"
"6813",2020-12-10,"Brush Creek Rd",NA,NA,NA,NA,NA,NA,NA,NA,NA,NA,NA,NA,NA,NA,NA,NA,NA,"w1920","Non.motorized",5,"Thu","weekday"
"6814",2020-12-10,"Brush Creek Rd",NA,NA,NA,NA,NA,NA,NA,NA,NA,NA,NA,NA,NA,NA,NA,NA,NA,"w1920","Mechanized",0,"Thu","weekday"
"6815",2020-12-10,"Brush Creek Rd",NA,NA,NA,NA,NA,NA,NA,NA,NA,NA,NA,NA,NA,NA,NA,NA,NA,"w1920","Motorized",0,"Thu","weekday"
"6816",2020-12-10,"Brush Creek Rd",NA,NA,NA,NA,NA,NA,NA,NA,NA,NA,NA,NA,NA,NA,NA,NA,NA,"w1920","Hybrid",0,"Thu","weekday"
"6817",2019-12-11,"Brush Creek Rd","2","2","2",3.4,0,20,-1,22,17,-1,5,-1,-1,-2,3,2,1,"w1920","Non.motorized",5,"Wed","weekday"
"6818",2019-12-11,"Brush Creek Rd","2","2","2",3.4,0,20,-1,22,17,-1,5,-1,-1,-2,3,2,1,"w1920","Mechanized",0,"Wed","weekday"
"6819",2019-12-11,"Brush Creek Rd","2","2","2",3.4,0,20,-1,22,17,-1,5,-1,-1,-2,3,2,1,"w1920","Motorized",0,"Wed","weekday"
"6820",2019-12-11,"Brush Creek Rd","2","2","2",3.4,0,20,-1,22,17,-1,5,-1,-1,-2,3,2,1,"w1920","Hybrid",0,"Wed","weekday"
"6821",2019-12-12,"Brush Creek Rd","2","2","2",3.4,0,19,-1,25,17.9,-1,-1,5,-1,-2,-3,2,1,"w1920","Non.motorized",4,"Thu","weekday"
"6822",2019-12-12,"Brush Creek Rd","2","2","2",3.4,0,19,-1,25,17.9,-1,-1,5,-1,-2,-3,2,1,"w1920","Mechanized",0,"Thu","weekday"
"6823",2019-12-12,"Brush Creek Rd","2","2","2",3.4,0,19,-1,25,17.9,-1,-1,5,-1,-2,-3,2,1,"w1920","Motorized",0,"Thu","weekday"
"6824",2019-12-12,"Brush Creek Rd","2","2","2",3.4,0,19,-1,25,17.9,-1,-1,5,-1,-2,-3,2,1,"w1920","Hybrid",0,"Thu","weekday"
"6825",2019-12-13,"Brush Creek Rd","2","2","2",3.8,0.4,21,2,24,18.1,-1,-1,-1,5,1,0,-1,4,"w1920","Non.motorized",4,"Fri","weekday"
"6826",2019-12-13,"Brush Creek Rd","2","2","2",3.8,0.4,21,2,24,18.1,-1,-1,-1,5,1,0,-1,4,"w1920","Mechanized",0,"Fri","weekday"
"6827",2019-12-13,"Brush Creek Rd","2","2","2",3.8,0.4,21,2,24,18.1,-1,-1,-1,5,1,0,-1,4,"w1920","Motorized",0,"Fri","weekday"
"6828",2019-12-13,"Brush Creek Rd","2","2","2",3.8,0.4,21,2,24,18.1,-1,-1,-1,5,1,0,-1,4,"w1920","Hybrid",0,"Fri","weekday"
"6829",2019-12-14,"Brush Creek Rd","3","3","3",4.2,0.4,27,6,25,15.6,2,-1,-1,-1,8,7,6,5,"w1920","Non.motorized",6,"Sat","weekend"
"6830",2019-12-14,"Brush Creek Rd","3","3","3",4.2,0.4,27,6,25,15.6,2,-1,-1,-1,8,7,6,5,"w1920","Mechanized",0,"Sat","weekend"
"6831",2019-12-14,"Brush Creek Rd","3","3","3",4.2,0.4,27,6,25,15.6,2,-1,-1,-1,8,7,6,5,"w1920","Motorized",0,"Sat","weekend"
"6832",2019-12-14,"Brush Creek Rd","3","3","3",4.2,0.4,27,6,25,15.6,2,-1,-1,-1,8,7,6,5,"w1920","Hybrid",0,"Sat","weekend"
"6833",2019-12-15,"Brush Creek Rd","3","3","2",4.8,0.6,31,4,17,15.5,6,2,-1,-1,10,12,11,10,"w1920","Non.motorized",4,"Sun","weekend"
"6834",2019-12-15,"Brush Creek Rd","3","3","2",4.8,0.6,31,4,17,15.5,6,2,-1,-1,10,12,11,10,"w1920","Mechanized",0,"Sun","weekend"
"6835",2019-12-15,"Brush Creek Rd","3","3","2",4.8,0.6,31,4,17,15.5,6,2,-1,-1,10,12,11,10,"w1920","Motorized",0,"Sun","weekend"
"6836",2019-12-15,"Brush Creek Rd","3","3","2",4.8,0.6,31,4,17,15.5,6,2,-1,-1,10,12,11,10,"w1920","Hybrid",0,"Sun","weekend"
"6837",2019-12-16,"Brush Creek Rd","3","3","2",4.8,0,29,-2,6,16.6,4,6,2,-1,2,8,10,9,"w1920","Non.motorized",4,"Mon","weekday"
"6838",2019-12-16,"Brush Creek Rd","3","3","2",4.8,0,29,-2,6,16.6,4,6,2,-1,2,8,10,9,"w1920","Mechanized",0,"Mon","weekday"
"6839",2019-12-16,"Brush Creek Rd","3","3","2",4.8,0,29,-2,6,16.6,4,6,2,-1,2,8,10,9,"w1920","Motorized",0,"Mon","weekday"
"6840",2019-12-16,"Brush Creek Rd","3","3","2",4.8,0,29,-2,6,16.6,4,6,2,-1,2,8,10,9,"w1920","Hybrid",0,"Mon","weekday"
"6841",2019-12-17,"Brush Creek Rd","2","2","1",4.8,0,27,-2,8,17.8,-2,4,6,2,-4,0,6,8,"w1920","Non.motorized",NA,"Tue","weekday"
"6842",2019-12-17,"Brush Creek Rd","2","2","1",4.8,0,27,-2,8,17.8,-2,4,6,2,-4,0,6,8,"w1920","Mechanized",NA,"Tue","weekday"
"6843",2019-12-17,"Brush Creek Rd","2","2","1",4.8,0,27,-2,8,17.8,-2,4,6,2,-4,0,6,8,"w1920","Motorized",NA,"Tue","weekday"
"6844",2019-12-17,"Brush Creek Rd","2","2","1",4.8,0,27,-2,8,17.8,-2,4,6,2,-4,0,6,8,"w1920","Hybrid",NA,"Tue","weekday"
"6845",2019-12-18,"Brush Creek Rd","2","2","1",4.8,0,26,-1,20,18.5,-2,-2,4,6,-3,-5,-1,5,"w1920","Non.motorized",2,"Wed","weekday"
"6846",2019-12-18,"Brush Creek Rd","2","2","1",4.8,0,26,-1,20,18.5,-2,-2,4,6,-3,-5,-1,5,"w1920","Mechanized",0,"Wed","weekday"
"6847",2019-12-18,"Brush Creek Rd","2","2","1",4.8,0,26,-1,20,18.5,-2,-2,4,6,-3,-5,-1,5,"w1920","Motorized",0,"Wed","weekday"
"6848",2019-12-18,"Brush Creek Rd","2","2","1",4.8,0,26,-1,20,18.5,-2,-2,4,6,-3,-5,-1,5,"w1920","Hybrid",0,"Wed","weekday"
"6849",2019-12-19,"Brush Creek Rd","2","2","1",4.9,0.1,25,-1,21,19.6,-1,-2,-2,4,-2,-4,-6,-2,"w1920","Non.motorized",4,"Thu","weekday"
"6850",2019-12-19,"Brush Creek Rd","2","2","1",4.9,0.1,25,-1,21,19.6,-1,-2,-2,4,-2,-4,-6,-2,"w1920","Mechanized",0,"Thu","weekday"
"6851",2019-12-19,"Brush Creek Rd","2","2","1",4.9,0.1,25,-1,21,19.6,-1,-2,-2,4,-2,-4,-6,-2,"w1920","Motorized",0,"Thu","weekday"
"6852",2019-12-19,"Brush Creek Rd","2","2","1",4.9,0.1,25,-1,21,19.6,-1,-2,-2,4,-2,-4,-6,-2,"w1920","Hybrid",0,"Thu","weekday"
"6853",2019-12-20,"Brush Creek Rd","2","2","1",4.9,0,24,-1,21,20.4,-1,-1,-2,-2,-2,-3,-5,-7,"w1920","Non.motorized",5,"Fri","weekday"
"6854",2019-12-20,"Brush Creek Rd","2","2","1",4.9,0,24,-1,21,20.4,-1,-1,-2,-2,-2,-3,-5,-7,"w1920","Mechanized",0,"Fri","weekday"
"6855",2019-12-20,"Brush Creek Rd","2","2","1",4.9,0,24,-1,21,20.4,-1,-1,-2,-2,-2,-3,-5,-7,"w1920","Motorized",0,"Fri","weekday"
"6856",2019-12-20,"Brush Creek Rd","2","2","1",4.9,0,24,-1,21,20.4,-1,-1,-2,-2,-2,-3,-5,-7,"w1920","Hybrid",0,"Fri","weekday"
"6857",2019-12-21,"Brush Creek Rd","2","2","1",4.9,0,24,0,27,20.4,-1,-1,-1,-2,-1,-2,-3,-5,"w1920","Non.motorized",12,"Sat","weekend"
"6858",2019-12-21,"Brush Creek Rd","2","2","1",4.9,0,24,0,27,20.4,-1,-1,-1,-2,-1,-2,-3,-5,"w1920","Mechanized",0,"Sat","weekend"
"6859",2019-12-21,"Brush Creek Rd","2","2","1",4.9,0,24,0,27,20.4,-1,-1,-1,-2,-1,-2,-3,-5,"w1920","Motorized",0,"Sat","weekend"
"6860",2019-12-21,"Brush Creek Rd","2","2","1",4.9,0,24,0,27,20.4,-1,-1,-1,-2,-1,-2,-3,-5,"w1920","Hybrid",0,"Sat","weekend"
"6861",2019-12-22,"Brush Creek Rd","2","2","1",5,0.1,23,-1,31,21.7,0,-1,-1,-1,-1,-2,-3,-4,"w1920","Non.motorized",13,"Sun","weekend"
"6862",2019-12-22,"Brush Creek Rd","2","2","1",5,0.1,23,-1,31,21.7,0,-1,-1,-1,-1,-2,-3,-4,"w1920","Mechanized",1,"Sun","weekend"
"6863",2019-12-22,"Brush Creek Rd","2","2","1",5,0.1,23,-1,31,21.7,0,-1,-1,-1,-1,-2,-3,-4,"w1920","Motorized",0,"Sun","weekend"
"6864",2019-12-22,"Brush Creek Rd","2","2","1",5,0.1,23,-1,31,21.7,0,-1,-1,-1,-1,-2,-3,-4,"w1920","Hybrid",0,"Sun","weekend"
"6865",2019-12-23,"Brush Creek Rd","2","1","1",5,0,23,0,34,21.7,-1,0,-1,-1,-1,-1,-2,-3,"w1920","Non.motorized",23,"Mon","weekday"
"6866",2019-12-23,"Brush Creek Rd","2","1","1",5,0,23,0,34,21.7,-1,0,-1,-1,-1,-1,-2,-3,"w1920","Mechanized",0,"Mon","weekday"
"6867",2019-12-23,"Brush Creek Rd","2","1","1",5,0,23,0,34,21.7,-1,0,-1,-1,-1,-1,-2,-3,"w1920","Motorized",0,"Mon","weekday"
"6868",2019-12-23,"Brush Creek Rd","2","1","1",5,0,23,0,34,21.7,-1,0,-1,-1,-1,-1,-2,-3,"w1920","Hybrid",0,"Mon","weekday"
"6869",2019-12-24,"Brush Creek Rd","2","1","1",5,0,22,-1,30,22.7,0,-1,0,-1,-1,-2,-2,-3,"w1920","Non.motorized",13,"Tue","weekday"
"6870",2019-12-24,"Brush Creek Rd","2","1","1",5,0,22,-1,30,22.7,0,-1,0,-1,-1,-2,-2,-3,"w1920","Mechanized",0,"Tue","weekday"
"6871",2019-12-24,"Brush Creek Rd","2","1","1",5,0,22,-1,30,22.7,0,-1,0,-1,-1,-2,-2,-3,"w1920","Motorized",0,"Tue","weekday"
"6872",2019-12-24,"Brush Creek Rd","2","1","1",5,0,22,-1,30,22.7,0,-1,0,-1,-1,-2,-2,-3,"w1920","Hybrid",0,"Tue","weekday"
"6873",2019-12-25,"Brush Creek Rd","2","2","2",5,0,23,1,22,21.7,-1,0,-1,0,0,0,-1,-1,"w1920","Non.motorized",14,"Wed","weekday"
"6874",2019-12-25,"Brush Creek Rd","2","2","2",5,0,23,1,22,21.7,-1,0,-1,0,0,0,-1,-1,"w1920","Mechanized",0,"Wed","weekday"
"6875",2019-12-25,"Brush Creek Rd","2","2","2",5,0,23,1,22,21.7,-1,0,-1,0,0,0,-1,-1,"w1920","Motorized",0,"Wed","weekday"
"6876",2019-12-25,"Brush Creek Rd","2","2","2",5,0,23,1,22,21.7,-1,0,-1,0,0,0,-1,-1,"w1920","Hybrid",0,"Wed","weekday"
"6877",2019-12-26,"Brush Creek Rd","2","2","1",5,0,23,0,17,21.7,1,-1,0,-1,1,0,0,-1,"w1920","Non.motorized",15,"Thu","weekday"
"6878",2019-12-26,"Brush Creek Rd","2","2","1",5,0,23,0,17,21.7,1,-1,0,-1,1,0,0,-1,"w1920","Mechanized",0,"Thu","weekday"
"6879",2019-12-26,"Brush Creek Rd","2","2","1",5,0,23,0,17,21.7,1,-1,0,-1,1,0,0,-1,"w1920","Motorized",0,"Thu","weekday"
"6880",2019-12-26,"Brush Creek Rd","2","2","1",5,0,23,0,17,21.7,1,-1,0,-1,1,0,0,-1,"w1920","Hybrid",0,"Thu","weekday"
"6881",2019-12-27,"Brush Creek Rd","3","3","2",5.1,0.1,24,1,22,21.2,0,1,-1,0,1,2,1,1,"w1920","Non.motorized",5,"Fri","weekday"
"6882",2019-12-27,"Brush Creek Rd","3","3","2",5.1,0.1,24,1,22,21.2,0,1,-1,0,1,2,1,1,"w1920","Mechanized",0,"Fri","weekday"
"6883",2019-12-27,"Brush Creek Rd","3","3","2",5.1,0.1,24,1,22,21.2,0,1,-1,0,1,2,1,1,"w1920","Motorized",0,"Fri","weekday"
"6884",2019-12-27,"Brush Creek Rd","3","3","2",5.1,0.1,24,1,22,21.2,0,1,-1,0,1,2,1,1,"w1920","Hybrid",0,"Fri","weekday"
"6885",2019-12-28,"Brush Creek Rd","3","3","2",5.6,0.5,30,6,16,18.7,1,0,1,-1,7,7,8,7,"w1920","Non.motorized",13,"Sat","weekend"
"6886",2019-12-28,"Brush Creek Rd","3","3","2",5.6,0.5,30,6,16,18.7,1,0,1,-1,7,7,8,7,"w1920","Mechanized",0,"Sat","weekend"
"6887",2019-12-28,"Brush Creek Rd","3","3","2",5.6,0.5,30,6,16,18.7,1,0,1,-1,7,7,8,7,"w1920","Motorized",0,"Sat","weekend"
"6888",2019-12-28,"Brush Creek Rd","3","3","2",5.6,0.5,30,6,16,18.7,1,0,1,-1,7,7,8,7,"w1920","Hybrid",0,"Sat","weekend"
"6889",2019-12-29,"Brush Creek Rd","3","3","2",5.6,0,29,-1,3,19.3,6,1,0,1,5,6,6,7,"w1920","Non.motorized",14,"Sun","weekend"
"6890",2019-12-29,"Brush Creek Rd","3","3","2",5.6,0,29,-1,3,19.3,6,1,0,1,5,6,6,7,"w1920","Mechanized",0,"Sun","weekend"
"6891",2019-12-29,"Brush Creek Rd","3","3","2",5.6,0,29,-1,3,19.3,6,1,0,1,5,6,6,7,"w1920","Motorized",0,"Sun","weekend"
"6892",2019-12-29,"Brush Creek Rd","3","3","2",5.6,0,29,-1,3,19.3,6,1,0,1,5,6,6,7,"w1920","Hybrid",0,"Sun","weekend"
"6893",2019-12-30,"Brush Creek Rd","3","3","2",5.6,0,28,-1,3,20,-1,6,1,0,-2,4,5,5,"w1920","Non.motorized",11,"Mon","weekday"
"6894",2019-12-30,"Brush Creek Rd","3","3","2",5.6,0,28,-1,3,20,-1,6,1,0,-2,4,5,5,"w1920","Mechanized",1,"Mon","weekday"
"6895",2019-12-30,"Brush Creek Rd","3","3","2",5.6,0,28,-1,3,20,-1,6,1,0,-2,4,5,5,"w1920","Motorized",0,"Mon","weekday"
"6896",2019-12-30,"Brush Creek Rd","3","3","2",5.6,0,28,-1,3,20,-1,6,1,0,-2,4,5,5,"w1920","Hybrid",0,"Mon","weekday"
"6897",2019-12-31,"Brush Creek Rd","2","2","1",5.6,0,28,0,13,20,-1,-1,6,1,-1,-2,4,5,"w1920","Non.motorized",9,"Tue","weekday"
"6898",2019-12-31,"Brush Creek Rd","2","2","1",5.6,0,28,0,13,20,-1,-1,6,1,-1,-2,4,5,"w1920","Mechanized",1,"Tue","weekday"
"6899",2019-12-31,"Brush Creek Rd","2","2","1",5.6,0,28,0,13,20,-1,-1,6,1,-1,-2,4,5,"w1920","Motorized",0,"Tue","weekday"
"6900",2019-12-31,"Brush Creek Rd","2","2","1",5.6,0,28,0,13,20,-1,-1,6,1,-1,-2,4,5,"w1920","Hybrid",0,"Tue","weekday"
"6901",2020-01-01,"Brush Creek Rd","2","1","1",5.6,0,27,-1,21,20.7,0,-1,-1,6,-1,-2,-3,3,"w1920","Non.motorized",16,"Wed","weekday"
"6902",2020-01-01,"Brush Creek Rd","2","1","1",5.6,0,27,-1,21,20.7,0,-1,-1,6,-1,-2,-3,3,"w1920","Mechanized",1,"Wed","weekday"
"6903",2020-01-01,"Brush Creek Rd","2","1","1",5.6,0,27,-1,21,20.7,0,-1,-1,6,-1,-2,-3,3,"w1920","Motorized",0,"Wed","weekday"
"6904",2020-01-01,"Brush Creek Rd","2","1","1",5.6,0,27,-1,21,20.7,0,-1,-1,6,-1,-2,-3,3,"w1920","Hybrid",0,"Wed","weekday"
"6905",2020-01-02,"Brush Creek Rd","3","3","2",5.9,0.3,29,2,16,20.3,-1,0,-1,-1,1,1,0,-1,"w1920","Non.motorized",10,"Thu","weekday"
"6906",2020-01-02,"Brush Creek Rd","3","3","2",5.9,0.3,29,2,16,20.3,-1,0,-1,-1,1,1,0,-1,"w1920","Mechanized",1,"Thu","weekday"
"6907",2020-01-02,"Brush Creek Rd","3","3","2",5.9,0.3,29,2,16,20.3,-1,0,-1,-1,1,1,0,-1,"w1920","Motorized",0,"Thu","weekday"
"6908",2020-01-02,"Brush Creek Rd","3","3","2",5.9,0.3,29,2,16,20.3,-1,0,-1,-1,1,1,0,-1,"w1920","Hybrid",0,"Thu","weekday"
"6909",2020-01-03,"Brush Creek Rd","3","2","1",5.9,0,31,2,19,19,2,-1,0,-1,4,3,3,2,"w1920","Non.motorized",19,"Fri","weekday"
"6910",2020-01-03,"Brush Creek Rd","3","2","1",5.9,0,31,2,19,19,2,-1,0,-1,4,3,3,2,"w1920","Mechanized",1,"Fri","weekday"
"6911",2020-01-03,"Brush Creek Rd","3","2","1",5.9,0,31,2,19,19,2,-1,0,-1,4,3,3,2,"w1920","Motorized",0,"Fri","weekday"
"6912",2020-01-03,"Brush Creek Rd","3","2","1",5.9,0,31,2,19,19,2,-1,0,-1,4,3,3,2,"w1920","Hybrid",0,"Fri","weekday"
"6913",2020-01-04,"Brush Creek Rd","2","2","1",5.9,0,30,-1,26,19.7,2,2,-1,0,1,3,2,2,"w1920","Non.motorized",14,"Sat","weekend"
"6914",2020-01-04,"Brush Creek Rd","2","2","1",5.9,0,30,-1,26,19.7,2,2,-1,0,1,3,2,2,"w1920","Mechanized",1,"Sat","weekend"
"6915",2020-01-04,"Brush Creek Rd","2","2","1",5.9,0,30,-1,26,19.7,2,2,-1,0,1,3,2,2,"w1920","Motorized",0,"Sat","weekend"
"6916",2020-01-04,"Brush Creek Rd","2","2","1",5.9,0,30,-1,26,19.7,2,2,-1,0,1,3,2,2,"w1920","Hybrid",0,"Sat","weekend"
"6917",2020-01-05,"Brush Creek Rd","2","2","1",5.9,0,28,-2,23,21.1,-1,2,2,-1,-3,-1,1,0,"w1920","Non.motorized",20,"Sun","weekend"
"6918",2020-01-05,"Brush Creek Rd","2","2","1",5.9,0,28,-2,23,21.1,-1,2,2,-1,-3,-1,1,0,"w1920","Mechanized",1,"Sun","weekend"
"6919",2020-01-05,"Brush Creek Rd","2","2","1",5.9,0,28,-2,23,21.1,-1,2,2,-1,-3,-1,1,0,"w1920","Motorized",0,"Sun","weekend"
"6920",2020-01-05,"Brush Creek Rd","2","2","1",5.9,0,28,-2,23,21.1,-1,2,2,-1,-3,-1,1,0,"w1920","Hybrid",0,"Sun","weekend"
"6921",2020-01-06,"Brush Creek Rd","2","2","1",5.9,0,28,0,15,21.1,-2,-1,2,2,-2,-3,-1,1,"w1920","Non.motorized",13,"Mon","weekday"
"6922",2020-01-06,"Brush Creek Rd","2","2","1",5.9,0,28,0,15,21.1,-2,-1,2,2,-2,-3,-1,1,"w1920","Mechanized",2,"Mon","weekday"
"6923",2020-01-06,"Brush Creek Rd","2","2","1",5.9,0,28,0,15,21.1,-2,-1,2,2,-2,-3,-1,1,"w1920","Motorized",0,"Mon","weekday"
"6924",2020-01-06,"Brush Creek Rd","2","2","1",5.9,0,28,0,15,21.1,-2,-1,2,2,-2,-3,-1,1,"w1920","Hybrid",0,"Mon","weekday"
"6925",2020-01-07,"Brush Creek Rd","2","1","1",5.9,0,28,0,22,21.1,0,-2,-1,2,0,-2,-3,-1,"w1920","Non.motorized",10,"Tue","weekday"
"6926",2020-01-07,"Brush Creek Rd","2","1","1",5.9,0,28,0,22,21.1,0,-2,-1,2,0,-2,-3,-1,"w1920","Mechanized",2,"Tue","weekday"
"6927",2020-01-07,"Brush Creek Rd","2","1","1",5.9,0,28,0,22,21.1,0,-2,-1,2,0,-2,-3,-1,"w1920","Motorized",0,"Tue","weekday"
"6928",2020-01-07,"Brush Creek Rd","2","1","1",5.9,0,28,0,22,21.1,0,-2,-1,2,0,-2,-3,-1,"w1920","Hybrid",0,"Tue","weekday"
"6929",2020-01-08,"Brush Creek Rd","2","1","1",6,0.1,28,0,23,21.4,0,0,-2,-1,0,0,-2,-3,"w1920","Non.motorized",10,"Wed","weekday"
"6930",2020-01-08,"Brush Creek Rd","2","1","1",6,0.1,28,0,23,21.4,0,0,-2,-1,0,0,-2,-3,"w1920","Mechanized",0,"Wed","weekday"
"6931",2020-01-08,"Brush Creek Rd","2","1","1",6,0.1,28,0,23,21.4,0,0,-2,-1,0,0,-2,-3,"w1920","Motorized",0,"Wed","weekday"
"6932",2020-01-08,"Brush Creek Rd","2","1","1",6,0.1,28,0,23,21.4,0,0,-2,-1,0,0,-2,-3,"w1920","Hybrid",0,"Wed","weekday"
"6933",2020-01-09,"Brush Creek Rd","2","1","1",6,0,27,-1,17,22.2,0,0,0,-2,-1,-1,-1,-3,"w1920","Non.motorized",5,"Thu","weekday"
"6934",2020-01-09,"Brush Creek Rd","2","1","1",6,0,27,-1,17,22.2,0,0,0,-2,-1,-1,-1,-3,"w1920","Mechanized",0,"Thu","weekday"
"6935",2020-01-09,"Brush Creek Rd","2","1","1",6,0,27,-1,17,22.2,0,0,0,-2,-1,-1,-1,-3,"w1920","Motorized",0,"Thu","weekday"
"6936",2020-01-09,"Brush Creek Rd","2","1","1",6,0,27,-1,17,22.2,0,0,0,-2,-1,-1,-1,-3,"w1920","Hybrid",0,"Thu","weekday"
"6937",2020-01-10,"Brush Creek Rd","2","1","1",6,0,29,2,11,20.7,-1,0,0,0,1,1,1,1,"w1920","Non.motorized",4,"Fri","weekday"
"6938",2020-01-10,"Brush Creek Rd","2","1","1",6,0,29,2,11,20.7,-1,0,0,0,1,1,1,1,"w1920","Mechanized",0,"Fri","weekday"
"6939",2020-01-10,"Brush Creek Rd","2","1","1",6,0,29,2,11,20.7,-1,0,0,0,1,1,1,1,"w1920","Motorized",0,"Fri","weekday"
"6940",2020-01-10,"Brush Creek Rd","2","1","1",6,0,29,2,11,20.7,-1,0,0,0,1,1,1,1,"w1920","Hybrid",0,"Fri","weekday"
"6941",2020-01-11,"Brush Creek Rd","2","1","1",6,0,29,0,12,20.7,2,-1,0,0,2,1,1,1,"w1920","Non.motorized",7,"Sat","weekend"
"6942",2020-01-11,"Brush Creek Rd","2","1","1",6,0,29,0,12,20.7,2,-1,0,0,2,1,1,1,"w1920","Mechanized",0,"Sat","weekend"
"6943",2020-01-11,"Brush Creek Rd","2","1","1",6,0,29,0,12,20.7,2,-1,0,0,2,1,1,1,"w1920","Motorized",0,"Sat","weekend"
"6944",2020-01-11,"Brush Creek Rd","2","1","1",6,0,29,0,12,20.7,2,-1,0,0,2,1,1,1,"w1920","Hybrid",0,"Sat","weekend"
"6945",2020-01-12,"Brush Creek Rd","2","1","1",6.1,0.1,29,0,13,21,0,2,-1,0,0,2,1,1,"w1920","Non.motorized",9,"Sun","weekend"
"6946",2020-01-12,"Brush Creek Rd","2","1","1",6.1,0.1,29,0,13,21,0,2,-1,0,0,2,1,1,"w1920","Mechanized",0,"Sun","weekend"
"6947",2020-01-12,"Brush Creek Rd","2","1","1",6.1,0.1,29,0,13,21,0,2,-1,0,0,2,1,1,"w1920","Motorized",0,"Sun","weekend"
"6948",2020-01-12,"Brush Creek Rd","2","1","1",6.1,0.1,29,0,13,21,0,2,-1,0,0,2,1,1,"w1920","Hybrid",0,"Sun","weekend"
"6949",2020-01-13,"Brush Creek Rd","2","2","1",6.2,0.1,29,0,16,21.4,0,0,2,-1,0,0,2,1,"w1920","Non.motorized",NA,"Mon","weekday"
"6950",2020-01-13,"Brush Creek Rd","2","2","1",6.2,0.1,29,0,16,21.4,0,0,2,-1,0,0,2,1,"w1920","Mechanized",NA,"Mon","weekday"
"6951",2020-01-13,"Brush Creek Rd","2","2","1",6.2,0.1,29,0,16,21.4,0,0,2,-1,0,0,2,1,"w1920","Motorized",NA,"Mon","weekday"
"6952",2020-01-13,"Brush Creek Rd","2","2","1",6.2,0.1,29,0,16,21.4,0,0,2,-1,0,0,2,1,"w1920","Hybrid",NA,"Mon","weekday"
"6953",2020-01-14,"Brush Creek Rd","3","2","1",6.6,0.4,34,5,23,19.4,0,0,0,2,5,5,5,7,"w1920","Non.motorized",5,"Tue","weekday"
"6954",2020-01-14,"Brush Creek Rd","3","2","1",6.6,0.4,34,5,23,19.4,0,0,0,2,5,5,5,7,"w1920","Mechanized",0,"Tue","weekday"
"6955",2020-01-14,"Brush Creek Rd","3","2","1",6.6,0.4,34,5,23,19.4,0,0,0,2,5,5,5,7,"w1920","Motorized",0,"Tue","weekday"
"6956",2020-01-14,"Brush Creek Rd","3","2","1",6.6,0.4,34,5,23,19.4,0,0,0,2,5,5,5,7,"w1920","Hybrid",0,"Tue","weekday"
"6957",2020-01-15,"Brush Creek Rd","3","2","1",6.7,0.1,32,-2,23,20.9,5,0,0,0,3,3,3,3,"w1920","Non.motorized",6,"Wed","weekday"
"6958",2020-01-15,"Brush Creek Rd","3","2","1",6.7,0.1,32,-2,23,20.9,5,0,0,0,3,3,3,3,"w1920","Mechanized",0,"Wed","weekday"
"6959",2020-01-15,"Brush Creek Rd","3","2","1",6.7,0.1,32,-2,23,20.9,5,0,0,0,3,3,3,3,"w1920","Motorized",0,"Wed","weekday"
"6960",2020-01-15,"Brush Creek Rd","3","2","1",6.7,0.1,32,-2,23,20.9,5,0,0,0,3,3,3,3,"w1920","Hybrid",0,"Wed","weekday"
"6961",2020-01-16,"Brush Creek Rd","2","2","1",6.7,0,31,-1,28,21.6,-2,5,0,0,-3,2,2,2,"w1920","Non.motorized",1,"Thu","weekday"
"6962",2020-01-16,"Brush Creek Rd","2","2","1",6.7,0,31,-1,28,21.6,-2,5,0,0,-3,2,2,2,"w1920","Mechanized",0,"Thu","weekday"
"6963",2020-01-16,"Brush Creek Rd","2","2","1",6.7,0,31,-1,28,21.6,-2,5,0,0,-3,2,2,2,"w1920","Motorized",0,"Thu","weekday"
"6964",2020-01-16,"Brush Creek Rd","2","2","1",6.7,0,31,-1,28,21.6,-2,5,0,0,-3,2,2,2,"w1920","Hybrid",0,"Thu","weekday"
"6965",2020-01-17,"Brush Creek Rd","2","2","1",6.8,0.1,29,-2,19,23.4,-1,-2,5,0,-3,-5,0,0,"w1920","Non.motorized",4,"Fri","weekday"
"6966",2020-01-17,"Brush Creek Rd","2","2","1",6.8,0.1,29,-2,19,23.4,-1,-2,5,0,-3,-5,0,0,"w1920","Mechanized",0,"Fri","weekday"
"6967",2020-01-17,"Brush Creek Rd","2","2","1",6.8,0.1,29,-2,19,23.4,-1,-2,5,0,-3,-5,0,0,"w1920","Motorized",0,"Fri","weekday"
"6968",2020-01-17,"Brush Creek Rd","2","2","1",6.8,0.1,29,-2,19,23.4,-1,-2,5,0,-3,-5,0,0,"w1920","Hybrid",0,"Fri","weekday"
"6969",2020-01-18,"Brush Creek Rd","2","2","2",7,0.2,34,5,16,20.6,-2,-1,-2,5,3,2,0,5,"w1920","Non.motorized",11,"Sat","weekend"
"6970",2020-01-18,"Brush Creek Rd","2","2","2",7,0.2,34,5,16,20.6,-2,-1,-2,5,3,2,0,5,"w1920","Mechanized",0,"Sat","weekend"
"6971",2020-01-18,"Brush Creek Rd","2","2","2",7,0.2,34,5,16,20.6,-2,-1,-2,5,3,2,0,5,"w1920","Motorized",0,"Sat","weekend"
"6972",2020-01-18,"Brush Creek Rd","2","2","2",7,0.2,34,5,16,20.6,-2,-1,-2,5,3,2,0,5,"w1920","Hybrid",0,"Sat","weekend"
"6973",2020-01-19,"Brush Creek Rd","2","2","1",7,0,33,-1,21,21.2,5,-2,-1,-2,4,2,1,-1,"w1920","Non.motorized",21,"Sun","weekend"
"6974",2020-01-19,"Brush Creek Rd","2","2","1",7,0,33,-1,21,21.2,5,-2,-1,-2,4,2,1,-1,"w1920","Mechanized",0,"Sun","weekend"
"6975",2020-01-19,"Brush Creek Rd","2","2","1",7,0,33,-1,21,21.2,5,-2,-1,-2,4,2,1,-1,"w1920","Motorized",0,"Sun","weekend"
"6976",2020-01-19,"Brush Creek Rd","2","2","1",7,0,33,-1,21,21.2,5,-2,-1,-2,4,2,1,-1,"w1920","Hybrid",0,"Sun","weekend"
"6977",2020-01-20,"Brush Creek Rd","2","2","1",7.1,0.1,32,-1,25,22.2,-1,5,-2,-1,-2,3,1,0,"w1920","Non.motorized",9,"Mon","weekday"
"6978",2020-01-20,"Brush Creek Rd","2","2","1",7.1,0.1,32,-1,25,22.2,-1,5,-2,-1,-2,3,1,0,"w1920","Mechanized",0,"Mon","weekday"
"6979",2020-01-20,"Brush Creek Rd","2","2","1",7.1,0.1,32,-1,25,22.2,-1,5,-2,-1,-2,3,1,0,"w1920","Motorized",0,"Mon","weekday"
"6980",2020-01-20,"Brush Creek Rd","2","2","1",7.1,0.1,32,-1,25,22.2,-1,5,-2,-1,-2,3,1,0,"w1920","Hybrid",0,"Mon","weekday"
"6981",2020-01-21,"Brush Creek Rd","2","2","1",7.1,0,31,-1,28,22.9,-1,-1,5,-2,-2,-3,2,0,"w1920","Non.motorized",2,"Tue","weekday"
"6982",2020-01-21,"Brush Creek Rd","2","2","1",7.1,0,31,-1,28,22.9,-1,-1,5,-2,-2,-3,2,0,"w1920","Mechanized",0,"Tue","weekday"
"6983",2020-01-21,"Brush Creek Rd","2","2","1",7.1,0,31,-1,28,22.9,-1,-1,5,-2,-2,-3,2,0,"w1920","Motorized",0,"Tue","weekday"
"6984",2020-01-21,"Brush Creek Rd","2","2","1",7.1,0,31,-1,28,22.9,-1,-1,5,-2,-2,-3,2,0,"w1920","Hybrid",0,"Tue","weekday"
"6985",2020-01-22,"Brush Creek Rd","2","2","2",7.3,0.2,32,1,25,22.8,-1,-1,-1,5,0,-1,-2,3,"w1920","Non.motorized",8,"Wed","weekday"
"6986",2020-01-22,"Brush Creek Rd","2","2","2",7.3,0.2,32,1,25,22.8,-1,-1,-1,5,0,-1,-2,3,"w1920","Mechanized",0,"Wed","weekday"
"6987",2020-01-22,"Brush Creek Rd","2","2","2",7.3,0.2,32,1,25,22.8,-1,-1,-1,5,0,-1,-2,3,"w1920","Motorized",0,"Wed","weekday"
"6988",2020-01-22,"Brush Creek Rd","2","2","2",7.3,0.2,32,1,25,22.8,-1,-1,-1,5,0,-1,-2,3,"w1920","Hybrid",0,"Wed","weekday"
"6989",2020-01-23,"Brush Creek Rd","3","2","2",7.3,0,34,2,23,21.5,1,-1,-1,-1,3,2,1,0,"w1920","Non.motorized",5,"Thu","weekday"
"6990",2020-01-23,"Brush Creek Rd","3","2","2",7.3,0,34,2,23,21.5,1,-1,-1,-1,3,2,1,0,"w1920","Mechanized",1,"Thu","weekday"
"6991",2020-01-23,"Brush Creek Rd","3","2","2",7.3,0,34,2,23,21.5,1,-1,-1,-1,3,2,1,0,"w1920","Motorized",0,"Thu","weekday"
"6992",2020-01-23,"Brush Creek Rd","3","2","2",7.3,0,34,2,23,21.5,1,-1,-1,-1,3,2,1,0,"w1920","Hybrid",0,"Thu","weekday"
"6993",2020-01-24,"Brush Creek Rd","2","2","1",7.3,0,33,-1,23,22.1,2,1,-1,-1,1,2,1,0,"w1920","Non.motorized",9,"Fri","weekday"
"6994",2020-01-24,"Brush Creek Rd","2","2","1",7.3,0,33,-1,23,22.1,2,1,-1,-1,1,2,1,0,"w1920","Mechanized",1,"Fri","weekday"
"6995",2020-01-24,"Brush Creek Rd","2","2","1",7.3,0,33,-1,23,22.1,2,1,-1,-1,1,2,1,0,"w1920","Motorized",0,"Fri","weekday"
"6996",2020-01-24,"Brush Creek Rd","2","2","1",7.3,0,33,-1,23,22.1,2,1,-1,-1,1,2,1,0,"w1920","Hybrid",0,"Fri","weekday"
"6997",2020-01-25,"Brush Creek Rd","2","2","1",7.4,0.1,32,-1,25,23.1,-1,2,1,-1,-2,0,1,0,"w1920","Non.motorized",17,"Sat","weekend"
"6998",2020-01-25,"Brush Creek Rd","2","2","1",7.4,0.1,32,-1,25,23.1,-1,2,1,-1,-2,0,1,0,"w1920","Mechanized",1,"Sat","weekend"
"6999",2020-01-25,"Brush Creek Rd","2","2","1",7.4,0.1,32,-1,25,23.1,-1,2,1,-1,-2,0,1,0,"w1920","Motorized",0,"Sat","weekend"
"7000",2020-01-25,"Brush Creek Rd","2","2","1",7.4,0.1,32,-1,25,23.1,-1,2,1,-1,-2,0,1,0,"w1920","Hybrid",0,"Sat","weekend"
"7001",2020-01-26,"Brush Creek Rd","2","1","1",7.4,0,32,0,28,23.1,-1,-1,2,1,-1,-2,0,1,"w1920","Non.motorized",23,"Sun","weekend"
"7002",2020-01-26,"Brush Creek Rd","2","1","1",7.4,0,32,0,28,23.1,-1,-1,2,1,-1,-2,0,1,"w1920","Mechanized",1,"Sun","weekend"
"7003",2020-01-26,"Brush Creek Rd","2","1","1",7.4,0,32,0,28,23.1,-1,-1,2,1,-1,-2,0,1,"w1920","Motorized",0,"Sun","weekend"
"7004",2020-01-26,"Brush Creek Rd","2","1","1",7.4,0,32,0,28,23.1,-1,-1,2,1,-1,-2,0,1,"w1920","Hybrid",0,"Sun","weekend"
"7005",2020-01-27,"Brush Creek Rd","2","1","1",7.4,0,32,0,24,23.1,0,-1,-1,2,0,-1,-2,0,"w1920","Non.motorized",4,"Mon","weekday"
"7006",2020-01-27,"Brush Creek Rd","2","1","1",7.4,0,32,0,24,23.1,0,-1,-1,2,0,-1,-2,0,"w1920","Mechanized",1,"Mon","weekday"
"7007",2020-01-27,"Brush Creek Rd","2","1","1",7.4,0,32,0,24,23.1,0,-1,-1,2,0,-1,-2,0,"w1920","Motorized",0,"Mon","weekday"
"7008",2020-01-27,"Brush Creek Rd","2","1","1",7.4,0,32,0,24,23.1,0,-1,-1,2,0,-1,-2,0,"w1920","Hybrid",0,"Mon","weekday"
"7009",2020-01-28,"Brush Creek Rd","3","2","2",7.4,0,32,0,19,23.1,0,0,-1,-1,0,0,-1,-2,"w1920","Non.motorized",3,"Tue","weekday"
"7010",2020-01-28,"Brush Creek Rd","3","2","2",7.4,0,32,0,19,23.1,0,0,-1,-1,0,0,-1,-2,"w1920","Mechanized",1,"Tue","weekday"
"7011",2020-01-28,"Brush Creek Rd","3","2","2",7.4,0,32,0,19,23.1,0,0,-1,-1,0,0,-1,-2,"w1920","Motorized",0,"Tue","weekday"
"7012",2020-01-28,"Brush Creek Rd","3","2","2",7.4,0,32,0,19,23.1,0,0,-1,-1,0,0,-1,-2,"w1920","Hybrid",0,"Tue","weekday"
"7013",2020-01-29,"Brush Creek Rd","2","2","1",7.4,0,31,-1,20,23.9,0,0,0,-1,-1,-1,-1,-2,"w1920","Non.motorized",5,"Wed","weekday"
"7014",2020-01-29,"Brush Creek Rd","2","2","1",7.4,0,31,-1,20,23.9,0,0,0,-1,-1,-1,-1,-2,"w1920","Mechanized",1,"Wed","weekday"
"7015",2020-01-29,"Brush Creek Rd","2","2","1",7.4,0,31,-1,20,23.9,0,0,0,-1,-1,-1,-1,-2,"w1920","Motorized",0,"Wed","weekday"
"7016",2020-01-29,"Brush Creek Rd","2","2","1",7.4,0,31,-1,20,23.9,0,0,0,-1,-1,-1,-1,-2,"w1920","Hybrid",0,"Wed","weekday"
"7017",2020-01-30,"Brush Creek Rd","2","2","1",7.4,0,31,0,17,23.9,-1,0,0,0,-1,-1,-1,-1,"w1920","Non.motorized",3,"Thu","weekday"
"7018",2020-01-30,"Brush Creek Rd","2","2","1",7.4,0,31,0,17,23.9,-1,0,0,0,-1,-1,-1,-1,"w1920","Mechanized",1,"Thu","weekday"
"7019",2020-01-30,"Brush Creek Rd","2","2","1",7.4,0,31,0,17,23.9,-1,0,0,0,-1,-1,-1,-1,"w1920","Motorized",0,"Thu","weekday"
"7020",2020-01-30,"Brush Creek Rd","2","2","1",7.4,0,31,0,17,23.9,-1,0,0,0,-1,-1,-1,-1,"w1920","Hybrid",0,"Thu","weekday"
"7021",2020-01-31,"Brush Creek Rd","2","1","1",7.4,0,31,0,20,23.9,0,-1,0,0,0,-1,-1,-1,"w1920","Non.motorized",2,"Fri","weekday"
"7022",2020-01-31,"Brush Creek Rd","2","1","1",7.4,0,31,0,20,23.9,0,-1,0,0,0,-1,-1,-1,"w1920","Mechanized",1,"Fri","weekday"
"7023",2020-01-31,"Brush Creek Rd","2","1","1",7.4,0,31,0,20,23.9,0,-1,0,0,0,-1,-1,-1,"w1920","Motorized",0,"Fri","weekday"
"7024",2020-01-31,"Brush Creek Rd","2","1","1",7.4,0,31,0,20,23.9,0,-1,0,0,0,-1,-1,-1,"w1920","Hybrid",0,"Fri","weekday"
"7025",2020-02-01,"Brush Creek Rd","2","1","1",7.4,0,31,0,28,23.9,0,0,-1,0,0,0,-1,-1,"w1920","Non.motorized",20,"Sat","weekend"
"7026",2020-02-01,"Brush Creek Rd","2","1","1",7.4,0,31,0,28,23.9,0,0,-1,0,0,0,-1,-1,"w1920","Mechanized",1,"Sat","weekend"
"7027",2020-02-01,"Brush Creek Rd","2","1","1",7.4,0,31,0,28,23.9,0,0,-1,0,0,0,-1,-1,"w1920","Motorized",0,"Sat","weekend"
"7028",2020-02-01,"Brush Creek Rd","2","1","1",7.4,0,31,0,28,23.9,0,0,-1,0,0,0,-1,-1,"w1920","Hybrid",0,"Sat","weekend"
"7029",2020-02-02,"Brush Creek Rd","1","1","1",7.4,0,31,0,33,23.9,0,0,0,-1,0,0,0,-1,"w1920","Non.motorized",15,"Sun","weekend"
"7030",2020-02-02,"Brush Creek Rd","1","1","1",7.4,0,31,0,33,23.9,0,0,0,-1,0,0,0,-1,"w1920","Mechanized",1,"Sun","weekend"
"7031",2020-02-02,"Brush Creek Rd","1","1","1",7.4,0,31,0,33,23.9,0,0,0,-1,0,0,0,-1,"w1920","Motorized",0,"Sun","weekend"
"7032",2020-02-02,"Brush Creek Rd","1","1","1",7.4,0,31,0,33,23.9,0,0,0,-1,0,0,0,-1,"w1920","Hybrid",0,"Sun","weekend"
"7033",2020-02-03,"Brush Creek Rd","2","2","1",7.4,0,31,0,24,23.9,0,0,0,0,0,0,0,0,"w1920","Non.motorized",1,"Mon","weekday"
"7034",2020-02-03,"Brush Creek Rd","2","2","1",7.4,0,31,0,24,23.9,0,0,0,0,0,0,0,0,"w1920","Mechanized",0,"Mon","weekday"
"7035",2020-02-03,"Brush Creek Rd","2","2","1",7.4,0,31,0,24,23.9,0,0,0,0,0,0,0,0,"w1920","Motorized",0,"Mon","weekday"
"7036",2020-02-03,"Brush Creek Rd","2","2","1",7.4,0,31,0,24,23.9,0,0,0,0,0,0,0,0,"w1920","Hybrid",0,"Mon","weekday"
"7037",2020-02-04,"Brush Creek Rd","2","2","2",7.4,0,33,2,5,22.4,0,0,0,0,2,2,2,2,"w1920","Non.motorized",5,"Tue","weekday"
"7038",2020-02-04,"Brush Creek Rd","2","2","2",7.4,0,33,2,5,22.4,0,0,0,0,2,2,2,2,"w1920","Mechanized",0,"Tue","weekday"
"7039",2020-02-04,"Brush Creek Rd","2","2","2",7.4,0,33,2,5,22.4,0,0,0,0,2,2,2,2,"w1920","Motorized",0,"Tue","weekday"
"7040",2020-02-04,"Brush Creek Rd","2","2","2",7.4,0,33,2,5,22.4,0,0,0,0,2,2,2,2,"w1920","Hybrid",0,"Tue","weekday"
"7041",2020-02-05,"Brush Creek Rd","2","2","1",7.4,0,33,0,2,22.4,2,0,0,0,2,2,2,2,"w1920","Non.motorized",0,"Wed","weekday"
"7042",2020-02-05,"Brush Creek Rd","2","2","1",7.4,0,33,0,2,22.4,2,0,0,0,2,2,2,2,"w1920","Mechanized",0,"Wed","weekday"
"7043",2020-02-05,"Brush Creek Rd","2","2","1",7.4,0,33,0,2,22.4,2,0,0,0,2,2,2,2,"w1920","Motorized",0,"Wed","weekday"
"7044",2020-02-05,"Brush Creek Rd","2","2","1",7.4,0,33,0,2,22.4,2,0,0,0,2,2,2,2,"w1920","Hybrid",0,"Wed","weekday"
"7045",2020-02-06,"Brush Creek Rd","2","2","1",7.5,0.1,32,-1,16,23.4,0,2,0,0,-1,1,1,1,"w1920","Non.motorized",2,"Thu","weekday"
"7046",2020-02-06,"Brush Creek Rd","2","2","1",7.5,0.1,32,-1,16,23.4,0,2,0,0,-1,1,1,1,"w1920","Mechanized",0,"Thu","weekday"
"7047",2020-02-06,"Brush Creek Rd","2","2","1",7.5,0.1,32,-1,16,23.4,0,2,0,0,-1,1,1,1,"w1920","Motorized",0,"Thu","weekday"
"7048",2020-02-06,"Brush Creek Rd","2","2","1",7.5,0.1,32,-1,16,23.4,0,2,0,0,-1,1,1,1,"w1920","Hybrid",0,"Thu","weekday"
"7049",2020-02-07,"Brush Creek Rd","3","3","3",7.9,0.4,37,5,26,21.4,-1,0,2,0,4,4,6,6,"w1920","Non.motorized",NA,"Fri","weekday"
"7050",2020-02-07,"Brush Creek Rd","3","3","3",7.9,0.4,37,5,26,21.4,-1,0,2,0,4,4,6,6,"w1920","Mechanized",NA,"Fri","weekday"
"7051",2020-02-07,"Brush Creek Rd","3","3","3",7.9,0.4,37,5,26,21.4,-1,0,2,0,4,4,6,6,"w1920","Motorized",NA,"Fri","weekday"
"7052",2020-02-07,"Brush Creek Rd","3","3","3",7.9,0.4,37,5,26,21.4,-1,0,2,0,4,4,6,6,"w1920","Hybrid",NA,"Fri","weekday"
"7053",2020-02-08,"Brush Creek Rd","3","3","2",8.3,0.4,39,2,30,21.3,5,-1,0,2,7,6,6,8,"w1920","Non.motorized",7,"Sat","weekend"
"7054",2020-02-08,"Brush Creek Rd","3","3","2",8.3,0.4,39,2,30,21.3,5,-1,0,2,7,6,6,8,"w1920","Mechanized",0,"Sat","weekend"
"7055",2020-02-08,"Brush Creek Rd","3","3","2",8.3,0.4,39,2,30,21.3,5,-1,0,2,7,6,6,8,"w1920","Motorized",0,"Sat","weekend"
"7056",2020-02-08,"Brush Creek Rd","3","3","2",8.3,0.4,39,2,30,21.3,5,-1,0,2,7,6,6,8,"w1920","Hybrid",0,"Sat","weekend"
"7057",2020-02-09,"Brush Creek Rd","3","2","2",8.4,0.1,38,-1,26,22.1,2,5,-1,0,1,6,5,5,"w1920","Non.motorized",11,"Sun","weekend"
"7058",2020-02-09,"Brush Creek Rd","3","2","2",8.4,0.1,38,-1,26,22.1,2,5,-1,0,1,6,5,5,"w1920","Mechanized",0,"Sun","weekend"
"7059",2020-02-09,"Brush Creek Rd","3","2","2",8.4,0.1,38,-1,26,22.1,2,5,-1,0,1,6,5,5,"w1920","Motorized",0,"Sun","weekend"
"7060",2020-02-09,"Brush Creek Rd","3","2","2",8.4,0.1,38,-1,26,22.1,2,5,-1,0,1,6,5,5,"w1920","Hybrid",0,"Sun","weekend"
"7061",2020-02-10,"Brush Creek Rd","2","2","1",8.4,0,38,0,22,22.1,-1,2,5,-1,-1,1,6,5,"w1920","Non.motorized",NA,"Mon","weekday"
"7062",2020-02-10,"Brush Creek Rd","2","2","1",8.4,0,38,0,22,22.1,-1,2,5,-1,-1,1,6,5,"w1920","Mechanized",NA,"Mon","weekday"
"7063",2020-02-10,"Brush Creek Rd","2","2","1",8.4,0,38,0,22,22.1,-1,2,5,-1,-1,1,6,5,"w1920","Motorized",NA,"Mon","weekday"
"7064",2020-02-10,"Brush Creek Rd","2","2","1",8.4,0,38,0,22,22.1,-1,2,5,-1,-1,1,6,5,"w1920","Hybrid",NA,"Mon","weekday"
"7065",2020-02-11,"Brush Creek Rd","2","2","2",8.5,0.1,40,2,16,21.2,0,-1,2,5,2,1,3,8,"w1920","Non.motorized",7,"Tue","weekday"
"7066",2020-02-11,"Brush Creek Rd","2","2","2",8.5,0.1,40,2,16,21.2,0,-1,2,5,2,1,3,8,"w1920","Mechanized",0,"Tue","weekday"
"7067",2020-02-11,"Brush Creek Rd","2","2","2",8.5,0.1,40,2,16,21.2,0,-1,2,5,2,1,3,8,"w1920","Motorized",0,"Tue","weekday"
"7068",2020-02-11,"Brush Creek Rd","2","2","2",8.5,0.1,40,2,16,21.2,0,-1,2,5,2,1,3,8,"w1920","Hybrid",0,"Tue","weekday"
"7069",2020-02-12,"Brush Creek Rd","2","2","2",8.5,0,39,-1,15,21.8,2,0,-1,2,1,1,0,2,"w1920","Non.motorized",9,"Wed","weekday"
"7070",2020-02-12,"Brush Creek Rd","2","2","2",8.5,0,39,-1,15,21.8,2,0,-1,2,1,1,0,2,"w1920","Mechanized",0,"Wed","weekday"
"7071",2020-02-12,"Brush Creek Rd","2","2","2",8.5,0,39,-1,15,21.8,2,0,-1,2,1,1,0,2,"w1920","Motorized",0,"Wed","weekday"
"7072",2020-02-12,"Brush Creek Rd","2","2","2",8.5,0,39,-1,15,21.8,2,0,-1,2,1,1,0,2,"w1920","Hybrid",0,"Wed","weekday"
"7073",2020-02-13,"Brush Creek Rd","2","2","1",8.5,0,39,0,18,21.8,-1,2,0,-1,-1,1,1,0,"w1920","Non.motorized",NA,"Thu","weekday"
"7074",2020-02-13,"Brush Creek Rd","2","2","1",8.5,0,39,0,18,21.8,-1,2,0,-1,-1,1,1,0,"w1920","Mechanized",NA,"Thu","weekday"
"7075",2020-02-13,"Brush Creek Rd","2","2","1",8.5,0,39,0,18,21.8,-1,2,0,-1,-1,1,1,0,"w1920","Motorized",NA,"Thu","weekday"
"7076",2020-02-13,"Brush Creek Rd","2","2","1",8.5,0,39,0,18,21.8,-1,2,0,-1,-1,1,1,0,"w1920","Hybrid",NA,"Thu","weekday"
"7077",2020-02-14,"Brush Creek Rd","2","1","1",8.6,0.1,38,-1,24,22.6,0,-1,2,0,-1,-2,0,0,"w1920","Non.motorized",10,"Fri","weekday"
"7078",2020-02-14,"Brush Creek Rd","2","1","1",8.6,0.1,38,-1,24,22.6,0,-1,2,0,-1,-2,0,0,"w1920","Mechanized",0,"Fri","weekday"
"7079",2020-02-14,"Brush Creek Rd","2","1","1",8.6,0.1,38,-1,24,22.6,0,-1,2,0,-1,-2,0,0,"w1920","Motorized",0,"Fri","weekday"
"7080",2020-02-14,"Brush Creek Rd","2","1","1",8.6,0.1,38,-1,24,22.6,0,-1,2,0,-1,-2,0,0,"w1920","Hybrid",0,"Fri","weekday"
"7081",2020-02-15,"Brush Creek Rd","1","1","1",8.6,0,38,0,26,22.6,-1,0,-1,2,-1,-1,-2,0,"w1920","Non.motorized",11,"Sat","weekend"
"7082",2020-02-15,"Brush Creek Rd","1","1","1",8.6,0,38,0,26,22.6,-1,0,-1,2,-1,-1,-2,0,"w1920","Mechanized",0,"Sat","weekend"
"7083",2020-02-15,"Brush Creek Rd","1","1","1",8.6,0,38,0,26,22.6,-1,0,-1,2,-1,-1,-2,0,"w1920","Motorized",0,"Sat","weekend"
"7084",2020-02-15,"Brush Creek Rd","1","1","1",8.6,0,38,0,26,22.6,-1,0,-1,2,-1,-1,-2,0,"w1920","Hybrid",0,"Sat","weekend"
"7085",2020-02-16,"Brush Creek Rd","1","1","1",8.8,0.2,37,-1,26,23.8,0,-1,0,-1,-1,-2,-2,-3,"w1920","Non.motorized",9,"Sun","weekend"
"7086",2020-02-16,"Brush Creek Rd","1","1","1",8.8,0.2,37,-1,26,23.8,0,-1,0,-1,-1,-2,-2,-3,"w1920","Mechanized",0,"Sun","weekend"
"7087",2020-02-16,"Brush Creek Rd","1","1","1",8.8,0.2,37,-1,26,23.8,0,-1,0,-1,-1,-2,-2,-3,"w1920","Motorized",0,"Sun","weekend"
"7088",2020-02-16,"Brush Creek Rd","1","1","1",8.8,0.2,37,-1,26,23.8,0,-1,0,-1,-1,-2,-2,-3,"w1920","Hybrid",0,"Sun","weekend"
"7089",2020-02-17,"Brush Creek Rd","2","1","1",9.2,0.4,43,6,25,21.4,-1,0,-1,0,5,5,4,4,"w1920","Non.motorized",10,"Mon","weekday"
"7090",2020-02-17,"Brush Creek Rd","2","1","1",9.2,0.4,43,6,25,21.4,-1,0,-1,0,5,5,4,4,"w1920","Mechanized",0,"Mon","weekday"
"7091",2020-02-17,"Brush Creek Rd","2","1","1",9.2,0.4,43,6,25,21.4,-1,0,-1,0,5,5,4,4,"w1920","Motorized",0,"Mon","weekday"
"7092",2020-02-17,"Brush Creek Rd","2","1","1",9.2,0.4,43,6,25,21.4,-1,0,-1,0,5,5,4,4,"w1920","Hybrid",0,"Mon","weekday"
"7093",2020-02-18,"Brush Creek Rd","1","1","1",9.3,0.1,42,-1,18,22.1,6,-1,0,-1,5,4,4,3,"w1920","Non.motorized",9,"Tue","weekday"
"7094",2020-02-18,"Brush Creek Rd","1","1","1",9.3,0.1,42,-1,18,22.1,6,-1,0,-1,5,4,4,3,"w1920","Mechanized",0,"Tue","weekday"
"7095",2020-02-18,"Brush Creek Rd","1","1","1",9.3,0.1,42,-1,18,22.1,6,-1,0,-1,5,4,4,3,"w1920","Motorized",0,"Tue","weekday"
"7096",2020-02-18,"Brush Creek Rd","1","1","1",9.3,0.1,42,-1,18,22.1,6,-1,0,-1,5,4,4,3,"w1920","Hybrid",0,"Tue","weekday"
"7097",2020-02-19,"Brush Creek Rd","1","1","1",9.3,0,41,-1,22,22.7,-1,6,-1,0,-2,4,3,3,"w1920","Non.motorized",3,"Wed","weekday"
"7098",2020-02-19,"Brush Creek Rd","1","1","1",9.3,0,41,-1,22,22.7,-1,6,-1,0,-2,4,3,3,"w1920","Mechanized",0,"Wed","weekday"
"7099",2020-02-19,"Brush Creek Rd","1","1","1",9.3,0,41,-1,22,22.7,-1,6,-1,0,-2,4,3,3,"w1920","Motorized",0,"Wed","weekday"
"7100",2020-02-19,"Brush Creek Rd","1","1","1",9.3,0,41,-1,22,22.7,-1,6,-1,0,-2,4,3,3,"w1920","Hybrid",0,"Wed","weekday"
"7101",2020-02-20,"Brush Creek Rd","1","1","1",9.3,0,41,0,18,22.7,-1,-1,6,-1,-1,-2,4,3,"w1920","Non.motorized",6,"Thu","weekday"
"7102",2020-02-20,"Brush Creek Rd","1","1","1",9.3,0,41,0,18,22.7,-1,-1,6,-1,-1,-2,4,3,"w1920","Mechanized",0,"Thu","weekday"
"7103",2020-02-20,"Brush Creek Rd","1","1","1",9.3,0,41,0,18,22.7,-1,-1,6,-1,-1,-2,4,3,"w1920","Motorized",0,"Thu","weekday"
"7104",2020-02-20,"Brush Creek Rd","1","1","1",9.3,0,41,0,18,22.7,-1,-1,6,-1,-1,-2,4,3,"w1920","Hybrid",0,"Thu","weekday"
"7105",2020-02-21,"Brush Creek Rd","1","1","1",9.3,0,40,-1,26,23.2,0,-1,-1,6,-1,-2,-3,3,"w1920","Non.motorized",7,"Fri","weekday"
"7106",2020-02-21,"Brush Creek Rd","1","1","1",9.3,0,40,-1,26,23.2,0,-1,-1,6,-1,-2,-3,3,"w1920","Mechanized",0,"Fri","weekday"
"7107",2020-02-21,"Brush Creek Rd","1","1","1",9.3,0,40,-1,26,23.2,0,-1,-1,6,-1,-2,-3,3,"w1920","Motorized",0,"Fri","weekday"
"7108",2020-02-21,"Brush Creek Rd","1","1","1",9.3,0,40,-1,26,23.2,0,-1,-1,6,-1,-2,-3,3,"w1920","Hybrid",0,"Fri","weekday"
"7109",2020-02-22,"Brush Creek Rd","1","1","1",9.4,0.1,39,-1,32,24.1,-1,0,-1,-1,-2,-2,-3,-4,"w1920","Non.motorized",15,"Sat","weekend"
"7110",2020-02-22,"Brush Creek Rd","1","1","1",9.4,0.1,39,-1,32,24.1,-1,0,-1,-1,-2,-2,-3,-4,"w1920","Mechanized",0,"Sat","weekend"
"7111",2020-02-22,"Brush Creek Rd","1","1","1",9.4,0.1,39,-1,32,24.1,-1,0,-1,-1,-2,-2,-3,-4,"w1920","Motorized",0,"Sat","weekend"
"7112",2020-02-22,"Brush Creek Rd","1","1","1",9.4,0.1,39,-1,32,24.1,-1,0,-1,-1,-2,-2,-3,-4,"w1920","Hybrid",0,"Sat","weekend"
"7113",2020-02-23,"Brush Creek Rd","2","2","2",9.5,0.1,40,1,27,23.8,-1,-1,0,-1,0,-1,-1,-2,"w1920","Non.motorized",7,"Sun","weekend"
"7114",2020-02-23,"Brush Creek Rd","2","2","2",9.5,0.1,40,1,27,23.8,-1,-1,0,-1,0,-1,-1,-2,"w1920","Mechanized",0,"Sun","weekend"
"7115",2020-02-23,"Brush Creek Rd","2","2","2",9.5,0.1,40,1,27,23.8,-1,-1,0,-1,0,-1,-1,-2,"w1920","Motorized",0,"Sun","weekend"
"7116",2020-02-23,"Brush Creek Rd","2","2","2",9.5,0.1,40,1,27,23.8,-1,-1,0,-1,0,-1,-1,-2,"w1920","Hybrid",0,"Sun","weekend"
"7117",2020-02-24,"Brush Creek Rd","3","3","2",9.8,0.3,43,3,17,22.8,1,-1,-1,0,4,3,2,2,"w1920","Non.motorized",1,"Mon","weekday"
"7118",2020-02-24,"Brush Creek Rd","3","3","2",9.8,0.3,43,3,17,22.8,1,-1,-1,0,4,3,2,2,"w1920","Mechanized",0,"Mon","weekday"
"7119",2020-02-24,"Brush Creek Rd","3","3","2",9.8,0.3,43,3,17,22.8,1,-1,-1,0,4,3,2,2,"w1920","Motorized",0,"Mon","weekday"
"7120",2020-02-24,"Brush Creek Rd","3","3","2",9.8,0.3,43,3,17,22.8,1,-1,-1,0,4,3,2,2,"w1920","Hybrid",0,"Mon","weekday"
"7121",2020-02-25,"Brush Creek Rd","2","2","1",9.8,0,43,0,8,22.8,3,1,-1,-1,3,4,3,2,"w1920","Non.motorized",0,"Tue","weekday"
"7122",2020-02-25,"Brush Creek Rd","2","2","1",9.8,0,43,0,8,22.8,3,1,-1,-1,3,4,3,2,"w1920","Mechanized",0,"Tue","weekday"
"7123",2020-02-25,"Brush Creek Rd","2","2","1",9.8,0,43,0,8,22.8,3,1,-1,-1,3,4,3,2,"w1920","Motorized",0,"Tue","weekday"
"7124",2020-02-25,"Brush Creek Rd","2","2","1",9.8,0,43,0,8,22.8,3,1,-1,-1,3,4,3,2,"w1920","Hybrid",0,"Tue","weekday"
"7125",2020-02-26,"Brush Creek Rd","2","2","1",9.8,0,42,-1,15,23.3,0,3,1,-1,-1,2,3,2,"w1920","Non.motorized",1,"Wed","weekday"
"7126",2020-02-26,"Brush Creek Rd","2","2","1",9.8,0,42,-1,15,23.3,0,3,1,-1,-1,2,3,2,"w1920","Mechanized",0,"Wed","weekday"
"7127",2020-02-26,"Brush Creek Rd","2","2","1",9.8,0,42,-1,15,23.3,0,3,1,-1,-1,2,3,2,"w1920","Motorized",0,"Wed","weekday"
"7128",2020-02-26,"Brush Creek Rd","2","2","1",9.8,0,42,-1,15,23.3,0,3,1,-1,-1,2,3,2,"w1920","Hybrid",0,"Wed","weekday"
"7129",2020-02-27,"Brush Creek Rd","2","2","1",9.9,0.1,41,-1,25,24.1,-1,0,3,1,-2,-2,1,2,"w1920","Non.motorized",22,"Thu","weekday"
"7130",2020-02-27,"Brush Creek Rd","2","2","1",9.9,0.1,41,-1,25,24.1,-1,0,3,1,-2,-2,1,2,"w1920","Mechanized",0,"Thu","weekday"
"7131",2020-02-27,"Brush Creek Rd","2","2","1",9.9,0.1,41,-1,25,24.1,-1,0,3,1,-2,-2,1,2,"w1920","Motorized",0,"Thu","weekday"
"7132",2020-02-27,"Brush Creek Rd","2","2","1",9.9,0.1,41,-1,25,24.1,-1,0,3,1,-2,-2,1,2,"w1920","Hybrid",0,"Thu","weekday"
"7133",2020-02-28,"Brush Creek Rd","2","1","1",9.9,0,41,0,28,24.1,-1,-1,0,3,-1,-2,-2,1,"w1920","Non.motorized",6,"Fri","weekday"
"7134",2020-02-28,"Brush Creek Rd","2","1","1",9.9,0,41,0,28,24.1,-1,-1,0,3,-1,-2,-2,1,"w1920","Mechanized",0,"Fri","weekday"
"7135",2020-02-28,"Brush Creek Rd","2","1","1",9.9,0,41,0,28,24.1,-1,-1,0,3,-1,-2,-2,1,"w1920","Motorized",0,"Fri","weekday"
"7136",2020-02-28,"Brush Creek Rd","2","1","1",9.9,0,41,0,28,24.1,-1,-1,0,3,-1,-2,-2,1,"w1920","Hybrid",0,"Fri","weekday"
"7137",2020-02-29,"Brush Creek Rd","1","1","1",9.9,0,40,-1,29,24.8,0,-1,-1,0,-1,-2,-3,-3,"w1920","Non.motorized",17,"Sat","weekend"
"7138",2020-02-29,"Brush Creek Rd","1","1","1",9.9,0,40,-1,29,24.8,0,-1,-1,0,-1,-2,-3,-3,"w1920","Mechanized",0,"Sat","weekend"
"7139",2020-02-29,"Brush Creek Rd","1","1","1",9.9,0,40,-1,29,24.8,0,-1,-1,0,-1,-2,-3,-3,"w1920","Motorized",0,"Sat","weekend"
"7140",2020-02-29,"Brush Creek Rd","1","1","1",9.9,0,40,-1,29,24.8,0,-1,-1,0,-1,-2,-3,-3,"w1920","Hybrid",0,"Sat","weekend"
"7141",2020-03-01,"Brush Creek Rd","1","1","1",10,0.1,40,0,28,25,-1,0,-1,-1,-1,-1,-2,-3,"w1920","Non.motorized",13,"Sun","weekend"
"7142",2020-03-01,"Brush Creek Rd","1","1","1",10,0.1,40,0,28,25,-1,0,-1,-1,-1,-1,-2,-3,"w1920","Mechanized",0,"Sun","weekend"
"7143",2020-03-01,"Brush Creek Rd","1","1","1",10,0.1,40,0,28,25,-1,0,-1,-1,-1,-1,-2,-3,"w1920","Motorized",0,"Sun","weekend"
"7144",2020-03-01,"Brush Creek Rd","1","1","1",10,0.1,40,0,28,25,-1,0,-1,-1,-1,-1,-2,-3,"w1920","Hybrid",0,"Sun","weekend"
"7145",2020-03-02,"Brush Creek Rd","2","2","1",10.4,0.4,45,5,25,23.1,0,-1,0,-1,5,4,4,3,"w1920","Non.motorized",0,"Mon","weekday"
"7146",2020-03-02,"Brush Creek Rd","2","2","1",10.4,0.4,45,5,25,23.1,0,-1,0,-1,5,4,4,3,"w1920","Mechanized",0,"Mon","weekday"
"7147",2020-03-02,"Brush Creek Rd","2","2","1",10.4,0.4,45,5,25,23.1,0,-1,0,-1,5,4,4,3,"w1920","Motorized",0,"Mon","weekday"
"7148",2020-03-02,"Brush Creek Rd","2","2","1",10.4,0.4,45,5,25,23.1,0,-1,0,-1,5,4,4,3,"w1920","Hybrid",0,"Mon","weekday"
"7149",2020-03-03,"Brush Creek Rd","2","1","1",10.9,0.5,50,5,25,21.8,5,0,-1,0,10,10,9,9,"w1920","Non.motorized",0,"Tue","weekday"
"7150",2020-03-03,"Brush Creek Rd","2","1","1",10.9,0.5,50,5,25,21.8,5,0,-1,0,10,10,9,9,"w1920","Mechanized",0,"Tue","weekday"
"7151",2020-03-03,"Brush Creek Rd","2","1","1",10.9,0.5,50,5,25,21.8,5,0,-1,0,10,10,9,9,"w1920","Motorized",0,"Tue","weekday"
"7152",2020-03-03,"Brush Creek Rd","2","1","1",10.9,0.5,50,5,25,21.8,5,0,-1,0,10,10,9,9,"w1920","Hybrid",0,"Tue","weekday"
"7153",2020-03-04,"Brush Creek Rd","2","1","1",10.9,0,48,-2,29,22.7,5,5,0,-1,3,8,8,7,"w1920","Non.motorized",1,"Wed","weekday"
"7154",2020-03-04,"Brush Creek Rd","2","1","1",10.9,0,48,-2,29,22.7,5,5,0,-1,3,8,8,7,"w1920","Mechanized",0,"Wed","weekday"
"7155",2020-03-04,"Brush Creek Rd","2","1","1",10.9,0,48,-2,29,22.7,5,5,0,-1,3,8,8,7,"w1920","Motorized",0,"Wed","weekday"
"7156",2020-03-04,"Brush Creek Rd","2","1","1",10.9,0,48,-2,29,22.7,5,5,0,-1,3,8,8,7,"w1920","Hybrid",0,"Wed","weekday"
"7157",2020-03-05,"Brush Creek Rd","2","1","1",10.9,0,46,-2,32,23.7,-2,5,5,0,-4,1,6,6,"w1920","Non.motorized",0,"Thu","weekday"
"7158",2020-03-05,"Brush Creek Rd","2","1","1",10.9,0,46,-2,32,23.7,-2,5,5,0,-4,1,6,6,"w1920","Mechanized",0,"Thu","weekday"
"7159",2020-03-05,"Brush Creek Rd","2","1","1",10.9,0,46,-2,32,23.7,-2,5,5,0,-4,1,6,6,"w1920","Motorized",0,"Thu","weekday"
"7160",2020-03-05,"Brush Creek Rd","2","1","1",10.9,0,46,-2,32,23.7,-2,5,5,0,-4,1,6,6,"w1920","Hybrid",0,"Thu","weekday"
"7161",2020-03-06,"Brush Creek Rd","1","1","1",10.9,0,45,-1,34,24.2,-2,-2,5,5,-3,-5,0,5,"w1920","Non.motorized",7,"Fri","weekday"
"7162",2020-03-06,"Brush Creek Rd","1","1","1",10.9,0,45,-1,34,24.2,-2,-2,5,5,-3,-5,0,5,"w1920","Mechanized",0,"Fri","weekday"
"7163",2020-03-06,"Brush Creek Rd","1","1","1",10.9,0,45,-1,34,24.2,-2,-2,5,5,-3,-5,0,5,"w1920","Motorized",0,"Fri","weekday"
"7164",2020-03-06,"Brush Creek Rd","1","1","1",10.9,0,45,-1,34,24.2,-2,-2,5,5,-3,-5,0,5,"w1920","Hybrid",0,"Fri","weekday"
"7165",2020-03-07,"Brush Creek Rd","1","1","2",10.9,0,44,-1,35,24.8,-1,-2,-2,5,-2,-4,-6,-1,"w1920","Non.motorized",11,"Sat","weekend"
"7166",2020-03-07,"Brush Creek Rd","1","1","2",10.9,0,44,-1,35,24.8,-1,-2,-2,5,-2,-4,-6,-1,"w1920","Mechanized",0,"Sat","weekend"
"7167",2020-03-07,"Brush Creek Rd","1","1","2",10.9,0,44,-1,35,24.8,-1,-2,-2,5,-2,-4,-6,-1,"w1920","Motorized",0,"Sat","weekend"
"7168",2020-03-07,"Brush Creek Rd","1","1","2",10.9,0,44,-1,35,24.8,-1,-2,-2,5,-2,-4,-6,-1,"w1920","Hybrid",0,"Sat","weekend"
"7169",2020-03-08,"Brush Creek Rd","1","1","1",11,0.1,43,-1,33,25.6,-1,-1,-2,-2,-2,-3,-5,-7,"w1920","Non.motorized",13,"Sun","weekend"
"7170",2020-03-08,"Brush Creek Rd","1","1","1",11,0.1,43,-1,33,25.6,-1,-1,-2,-2,-2,-3,-5,-7,"w1920","Mechanized",0,"Sun","weekend"
"7171",2020-03-08,"Brush Creek Rd","1","1","1",11,0.1,43,-1,33,25.6,-1,-1,-2,-2,-2,-3,-5,-7,"w1920","Motorized",0,"Sun","weekend"
"7172",2020-03-08,"Brush Creek Rd","1","1","1",11,0.1,43,-1,33,25.6,-1,-1,-2,-2,-2,-3,-5,-7,"w1920","Hybrid",0,"Sun","weekend"
"7173",2020-03-09,"Brush Creek Rd","1","1","1",11.1,0.1,42,-1,31,26.4,-1,-1,-1,-2,-2,-3,-4,-6,"w1920","Non.motorized",3,"Mon","weekday"
"7174",2020-03-09,"Brush Creek Rd","1","1","1",11.1,0.1,42,-1,31,26.4,-1,-1,-1,-2,-2,-3,-4,-6,"w1920","Mechanized",0,"Mon","weekday"
"7175",2020-03-09,"Brush Creek Rd","1","1","1",11.1,0.1,42,-1,31,26.4,-1,-1,-1,-2,-2,-3,-4,-6,"w1920","Motorized",0,"Mon","weekday"
"7176",2020-03-09,"Brush Creek Rd","1","1","1",11.1,0.1,42,-1,31,26.4,-1,-1,-1,-2,-2,-3,-4,-6,"w1920","Hybrid",0,"Mon","weekday"
"7177",2020-03-10,"Brush Creek Rd","1","1","2",11.2,0.1,44,2,31,25.5,-1,-1,-1,-1,1,0,-1,-2,"w1920","Non.motorized",0,"Tue","weekday"
"7178",2020-03-10,"Brush Creek Rd","1","1","2",11.2,0.1,44,2,31,25.5,-1,-1,-1,-1,1,0,-1,-2,"w1920","Mechanized",0,"Tue","weekday"
"7179",2020-03-10,"Brush Creek Rd","1","1","2",11.2,0.1,44,2,31,25.5,-1,-1,-1,-1,1,0,-1,-2,"w1920","Motorized",0,"Tue","weekday"
"7180",2020-03-10,"Brush Creek Rd","1","1","2",11.2,0.1,44,2,31,25.5,-1,-1,-1,-1,1,0,-1,-2,"w1920","Hybrid",0,"Tue","weekday"
"7181",2020-03-11,"Brush Creek Rd","2","2","1",11.2,0,44,0,32,25.5,2,-1,-1,-1,2,1,0,-1,"w1920","Non.motorized",9,"Wed","weekday"
"7182",2020-03-11,"Brush Creek Rd","2","2","1",11.2,0,44,0,32,25.5,2,-1,-1,-1,2,1,0,-1,"w1920","Mechanized",0,"Wed","weekday"
"7183",2020-03-11,"Brush Creek Rd","2","2","1",11.2,0,44,0,32,25.5,2,-1,-1,-1,2,1,0,-1,"w1920","Motorized",0,"Wed","weekday"
"7184",2020-03-11,"Brush Creek Rd","2","2","1",11.2,0,44,0,32,25.5,2,-1,-1,-1,2,1,0,-1,"w1920","Hybrid",0,"Wed","weekday"
"7185",2020-03-12,"Brush Creek Rd","2","2","2",11.4,0.2,42,-2,35,27.1,0,2,-1,-1,-2,0,-1,-2,"w1920","Non.motorized",4,"Thu","weekday"
"7186",2020-03-12,"Brush Creek Rd","2","2","2",11.4,0.2,42,-2,35,27.1,0,2,-1,-1,-2,0,-1,-2,"w1920","Mechanized",0,"Thu","weekday"
"7187",2020-03-12,"Brush Creek Rd","2","2","2",11.4,0.2,42,-2,35,27.1,0,2,-1,-1,-2,0,-1,-2,"w1920","Motorized",0,"Thu","weekday"
"7188",2020-03-12,"Brush Creek Rd","2","2","2",11.4,0.2,42,-2,35,27.1,0,2,-1,-1,-2,0,-1,-2,"w1920","Hybrid",0,"Thu","weekday"
"7189",2020-03-13,"Brush Creek Rd","3","3","2",11.5,0.1,44,2,31,26.1,-2,0,2,-1,0,0,2,1,"w1920","Non.motorized",10,"Fri","weekday"
"7190",2020-03-13,"Brush Creek Rd","3","3","2",11.5,0.1,44,2,31,26.1,-2,0,2,-1,0,0,2,1,"w1920","Mechanized",0,"Fri","weekday"
"7191",2020-03-13,"Brush Creek Rd","3","3","2",11.5,0.1,44,2,31,26.1,-2,0,2,-1,0,0,2,1,"w1920","Motorized",0,"Fri","weekday"
"7192",2020-03-13,"Brush Creek Rd","3","3","2",11.5,0.1,44,2,31,26.1,-2,0,2,-1,0,0,2,1,"w1920","Hybrid",0,"Fri","weekday"
"7193",2020-03-14,"Brush Creek Rd","3","3","3",11.7,0.2,44,0,31,26.6,2,-2,0,2,2,0,0,2,"w1920","Non.motorized",16,"Sat","weekend"
"7194",2020-03-14,"Brush Creek Rd","3","3","3",11.7,0.2,44,0,31,26.6,2,-2,0,2,2,0,0,2,"w1920","Mechanized",0,"Sat","weekend"
"7195",2020-03-14,"Brush Creek Rd","3","3","3",11.7,0.2,44,0,31,26.6,2,-2,0,2,2,0,0,2,"w1920","Motorized",0,"Sat","weekend"
"7196",2020-03-14,"Brush Creek Rd","3","3","3",11.7,0.2,44,0,31,26.6,2,-2,0,2,2,0,0,2,"w1920","Hybrid",0,"Sat","weekend"
"7197",2020-03-15,"Brush Creek Rd","2","2","2",11.7,0,45,1,33,26,0,2,-2,0,1,3,1,1,"w1920","Non.motorized",27,"Sun","weekend"
"7198",2020-03-15,"Brush Creek Rd","2","2","2",11.7,0,45,1,33,26,0,2,-2,0,1,3,1,1,"w1920","Mechanized",0,"Sun","weekend"
"7199",2020-03-15,"Brush Creek Rd","2","2","2",11.7,0,45,1,33,26,0,2,-2,0,1,3,1,1,"w1920","Motorized",0,"Sun","weekend"
"7200",2020-03-15,"Brush Creek Rd","2","2","2",11.7,0,45,1,33,26,0,2,-2,0,1,3,1,1,"w1920","Hybrid",0,"Sun","weekend"
"7201",2020-03-16,"Brush Creek Rd","2","2","2",11.7,0,45,0,35,26,1,0,2,-2,1,1,3,1,"w1920","Non.motorized",5,"Mon","weekday"
"7202",2020-03-16,"Brush Creek Rd","2","2","2",11.7,0,45,0,35,26,1,0,2,-2,1,1,3,1,"w1920","Mechanized",0,"Mon","weekday"
"7203",2020-03-16,"Brush Creek Rd","2","2","2",11.7,0,45,0,35,26,1,0,2,-2,1,1,3,1,"w1920","Motorized",0,"Mon","weekday"
"7204",2020-03-16,"Brush Creek Rd","2","2","2",11.7,0,45,0,35,26,1,0,2,-2,1,1,3,1,"w1920","Hybrid",0,"Mon","weekday"
"7205",2020-03-17,"Brush Creek Rd","2","2","2",11.7,0,44,-1,36,26.6,0,1,0,2,-1,0,0,2,"w1920","Non.motorized",11,"Tue","weekday"
"7206",2020-03-17,"Brush Creek Rd","2","2","2",11.7,0,44,-1,36,26.6,0,1,0,2,-1,0,0,2,"w1920","Mechanized",0,"Tue","weekday"
"7207",2020-03-17,"Brush Creek Rd","2","2","2",11.7,0,44,-1,36,26.6,0,1,0,2,-1,0,0,2,"w1920","Motorized",0,"Tue","weekday"
"7208",2020-03-17,"Brush Creek Rd","2","2","2",11.7,0,44,-1,36,26.6,0,1,0,2,-1,0,0,2,"w1920","Hybrid",0,"Tue","weekday"
"7209",2020-03-18,"Brush Creek Rd","2","2","2",11.7,0,43,-1,33,27.2,-1,0,1,0,-2,-2,-1,-1,"w1920","Non.motorized",12,"Wed","weekday"
"7210",2020-03-18,"Brush Creek Rd","2","2","2",11.7,0,43,-1,33,27.2,-1,0,1,0,-2,-2,-1,-1,"w1920","Mechanized",0,"Wed","weekday"
"7211",2020-03-18,"Brush Creek Rd","2","2","2",11.7,0,43,-1,33,27.2,-1,0,1,0,-2,-2,-1,-1,"w1920","Motorized",0,"Wed","weekday"
"7212",2020-03-18,"Brush Creek Rd","2","2","2",11.7,0,43,-1,33,27.2,-1,0,1,0,-2,-2,-1,-1,"w1920","Hybrid",0,"Wed","weekday"
"7213",2020-03-19,"Brush Creek Rd","3","3","3",11.8,0.1,43,0,27,27.4,-1,-1,0,1,-1,-2,-2,-1,"w1920","Non.motorized",5,"Thu","weekday"
"7214",2020-03-19,"Brush Creek Rd","3","3","3",11.8,0.1,43,0,27,27.4,-1,-1,0,1,-1,-2,-2,-1,"w1920","Mechanized",0,"Thu","weekday"
"7215",2020-03-19,"Brush Creek Rd","3","3","3",11.8,0.1,43,0,27,27.4,-1,-1,0,1,-1,-2,-2,-1,"w1920","Motorized",0,"Thu","weekday"
"7216",2020-03-19,"Brush Creek Rd","3","3","3",11.8,0.1,43,0,27,27.4,-1,-1,0,1,-1,-2,-2,-1,"w1920","Hybrid",0,"Thu","weekday"
"7217",2020-03-20,"Brush Creek Rd","3","3","2",12.7,0.9,52,9,26,24.4,0,-1,-1,0,9,8,7,7,"w1920","Non.motorized",12,"Fri","weekday"
"7218",2020-03-20,"Brush Creek Rd","3","3","2",12.7,0.9,52,9,26,24.4,0,-1,-1,0,9,8,7,7,"w1920","Mechanized",0,"Fri","weekday"
"7219",2020-03-20,"Brush Creek Rd","3","3","2",12.7,0.9,52,9,26,24.4,0,-1,-1,0,9,8,7,7,"w1920","Motorized",0,"Fri","weekday"
"7220",2020-03-20,"Brush Creek Rd","3","3","2",12.7,0.9,52,9,26,24.4,0,-1,-1,0,9,8,7,7,"w1920","Hybrid",0,"Fri","weekday"
"7221",2020-03-21,"Brush Creek Rd","3","3","2",12.8,0.1,54,2,26,23.7,9,0,-1,-1,11,11,10,9,"w1920","Non.motorized",12,"Sat","weekend"
"7222",2020-03-21,"Brush Creek Rd","3","3","2",12.8,0.1,54,2,26,23.7,9,0,-1,-1,11,11,10,9,"w1920","Mechanized",0,"Sat","weekend"
"7223",2020-03-21,"Brush Creek Rd","3","3","2",12.8,0.1,54,2,26,23.7,9,0,-1,-1,11,11,10,9,"w1920","Motorized",0,"Sat","weekend"
"7224",2020-03-21,"Brush Creek Rd","3","3","2",12.8,0.1,54,2,26,23.7,9,0,-1,-1,11,11,10,9,"w1920","Hybrid",0,"Sat","weekend"
"7225",2020-03-22,"Brush Creek Rd","2","2","2",13,0.2,53,-1,28,24.5,2,9,0,-1,1,10,10,9,"w1920","Non.motorized",22,"Sun","weekend"
"7226",2020-03-22,"Brush Creek Rd","2","2","2",13,0.2,53,-1,28,24.5,2,9,0,-1,1,10,10,9,"w1920","Mechanized",0,"Sun","weekend"
"7227",2020-03-22,"Brush Creek Rd","2","2","2",13,0.2,53,-1,28,24.5,2,9,0,-1,1,10,10,9,"w1920","Motorized",0,"Sun","weekend"
"7228",2020-03-22,"Brush Creek Rd","2","2","2",13,0.2,53,-1,28,24.5,2,9,0,-1,1,10,10,9,"w1920","Hybrid",0,"Sun","weekend"
"7229",2020-03-23,"Brush Creek Rd","2","2","2",13,0,53,0,28,24.5,-1,2,9,0,-1,1,10,10,"w1920","Non.motorized",10,"Mon","weekday"
"7230",2020-03-23,"Brush Creek Rd","2","2","2",13,0,53,0,28,24.5,-1,2,9,0,-1,1,10,10,"w1920","Mechanized",0,"Mon","weekday"
"7231",2020-03-23,"Brush Creek Rd","2","2","2",13,0,53,0,28,24.5,-1,2,9,0,-1,1,10,10,"w1920","Motorized",2,"Mon","weekday"
"7232",2020-03-23,"Brush Creek Rd","2","2","2",13,0,53,0,28,24.5,-1,2,9,0,-1,1,10,10,"w1920","Hybrid",0,"Mon","weekday"
"7233",2020-03-24,"Brush Creek Rd","2","2","2",13.2,0.2,53,0,32,24.9,0,-1,2,9,0,-1,1,10,"w1920","Non.motorized",NA,"Tue","weekday"
"7234",2020-03-24,"Brush Creek Rd","2","2","2",13.2,0.2,53,0,32,24.9,0,-1,2,9,0,-1,1,10,"w1920","Mechanized",NA,"Tue","weekday"
"7235",2020-03-24,"Brush Creek Rd","2","2","2",13.2,0.2,53,0,32,24.9,0,-1,2,9,0,-1,1,10,"w1920","Motorized",NA,"Tue","weekday"
"7236",2020-03-24,"Brush Creek Rd","2","2","2",13.2,0.2,53,0,32,24.9,0,-1,2,9,0,-1,1,10,"w1920","Hybrid",NA,"Tue","weekday"
"7237",2020-03-25,"Brush Creek Rd","2","2","2",13.3,0.1,51,-2,34,26.1,0,0,-1,2,-2,-2,-3,-1,"w1920","Non.motorized",NA,"Wed","weekday"
"7238",2020-03-25,"Brush Creek Rd","2","2","2",13.3,0.1,51,-2,34,26.1,0,0,-1,2,-2,-2,-3,-1,"w1920","Mechanized",NA,"Wed","weekday"
"7239",2020-03-25,"Brush Creek Rd","2","2","2",13.3,0.1,51,-2,34,26.1,0,0,-1,2,-2,-2,-3,-1,"w1920","Motorized",NA,"Wed","weekday"
"7240",2020-03-25,"Brush Creek Rd","2","2","2",13.3,0.1,51,-2,34,26.1,0,0,-1,2,-2,-2,-3,-1,"w1920","Hybrid",NA,"Wed","weekday"
"7241",2020-03-26,"Brush Creek Rd","2","2","2",13.3,0,50,-1,36,26.6,-2,0,0,-1,-3,-3,-3,-4,"w1920","Non.motorized",NA,"Thu","weekday"
"7242",2020-03-26,"Brush Creek Rd","2","2","2",13.3,0,50,-1,36,26.6,-2,0,0,-1,-3,-3,-3,-4,"w1920","Mechanized",NA,"Thu","weekday"
"7243",2020-03-26,"Brush Creek Rd","2","2","2",13.3,0,50,-1,36,26.6,-2,0,0,-1,-3,-3,-3,-4,"w1920","Motorized",NA,"Thu","weekday"
"7244",2020-03-26,"Brush Creek Rd","2","2","2",13.3,0,50,-1,36,26.6,-2,0,0,-1,-3,-3,-3,-4,"w1920","Hybrid",NA,"Thu","weekday"
"7245",2020-03-26,"Brush Creek Rd","3","3","2",13.3,0,50,-1,36,26.6,-2,0,0,-1,-3,-3,-3,-4,"w1920","Non.motorized",NA,"Thu","weekday"
"7246",2020-03-26,"Brush Creek Rd","3","3","2",13.3,0,50,-1,36,26.6,-2,0,0,-1,-3,-3,-3,-4,"w1920","Mechanized",NA,"Thu","weekday"
"7247",2020-03-26,"Brush Creek Rd","3","3","2",13.3,0,50,-1,36,26.6,-2,0,0,-1,-3,-3,-3,-4,"w1920","Motorized",NA,"Thu","weekday"
"7248",2020-03-26,"Brush Creek Rd","3","3","2",13.3,0,50,-1,36,26.6,-2,0,0,-1,-3,-3,-3,-4,"w1920","Hybrid",NA,"Thu","weekday"
"7249",2020-03-27,"Brush Creek Rd","3","3","2",13.3,0,50,0,23,26.6,-1,-2,0,0,-1,-3,-3,-3,"w1920","Non.motorized",NA,"Fri","weekday"
"7250",2020-03-27,"Brush Creek Rd","3","3","2",13.3,0,50,0,23,26.6,-1,-2,0,0,-1,-3,-3,-3,"w1920","Mechanized",NA,"Fri","weekday"
"7251",2020-03-27,"Brush Creek Rd","3","3","2",13.3,0,50,0,23,26.6,-1,-2,0,0,-1,-3,-3,-3,"w1920","Motorized",NA,"Fri","weekday"
"7252",2020-03-27,"Brush Creek Rd","3","3","2",13.3,0,50,0,23,26.6,-1,-2,0,0,-1,-3,-3,-3,"w1920","Hybrid",NA,"Fri","weekday"
"7253",2020-03-28,"Brush Creek Rd","3","3","3",13.3,0,50,0,18,26.6,0,-1,-2,0,0,-1,-3,-3,"w1920","Non.motorized",NA,"Sat","weekend"
"7254",2020-03-28,"Brush Creek Rd","3","3","3",13.3,0,50,0,18,26.6,0,-1,-2,0,0,-1,-3,-3,"w1920","Mechanized",NA,"Sat","weekend"
"7255",2020-03-28,"Brush Creek Rd","3","3","3",13.3,0,50,0,18,26.6,0,-1,-2,0,0,-1,-3,-3,"w1920","Motorized",NA,"Sat","weekend"
"7256",2020-03-28,"Brush Creek Rd","3","3","3",13.3,0,50,0,18,26.6,0,-1,-2,0,0,-1,-3,-3,"w1920","Hybrid",NA,"Sat","weekend"
"7257",2020-03-29,"Brush Creek Rd","2","2","2",13.3,0,49,-1,24,27.1,0,0,-1,-2,-1,-1,-2,-4,"w1920","Non.motorized",NA,"Sun","weekend"
"7258",2020-03-29,"Brush Creek Rd","2","2","2",13.3,0,49,-1,24,27.1,0,0,-1,-2,-1,-1,-2,-4,"w1920","Mechanized",NA,"Sun","weekend"
"7259",2020-03-29,"Brush Creek Rd","2","2","2",13.3,0,49,-1,24,27.1,0,0,-1,-2,-1,-1,-2,-4,"w1920","Motorized",NA,"Sun","weekend"
"7260",2020-03-29,"Brush Creek Rd","2","2","2",13.3,0,49,-1,24,27.1,0,0,-1,-2,-1,-1,-2,-4,"w1920","Hybrid",NA,"Sun","weekend"
"7261",2020-03-30,"Brush Creek Rd","2","2","2",13.4,0.1,49,0,29,27.3,-1,0,0,-1,-1,-1,-1,-2,"w1920","Non.motorized",NA,"Mon","weekday"
"7262",2020-03-30,"Brush Creek Rd","2","2","2",13.4,0.1,49,0,29,27.3,-1,0,0,-1,-1,-1,-1,-2,"w1920","Mechanized",NA,"Mon","weekday"
"7263",2020-03-30,"Brush Creek Rd","2","2","2",13.4,0.1,49,0,29,27.3,-1,0,0,-1,-1,-1,-1,-2,"w1920","Motorized",NA,"Mon","weekday"
"7264",2020-03-30,"Brush Creek Rd","2","2","2",13.4,0.1,49,0,29,27.3,-1,0,0,-1,-1,-1,-1,-2,"w1920","Hybrid",NA,"Mon","weekday"
"7265",2020-03-31,"Brush Creek Rd","2","2","2",13.6,0.2,51,2,35,26.7,0,-1,0,0,2,1,1,1,"w1920","Non.motorized",NA,"Tue","weekday"
"7266",2020-03-31,"Brush Creek Rd","2","2","2",13.6,0.2,51,2,35,26.7,0,-1,0,0,2,1,1,1,"w1920","Mechanized",NA,"Tue","weekday"
"7267",2020-03-31,"Brush Creek Rd","2","2","2",13.6,0.2,51,2,35,26.7,0,-1,0,0,2,1,1,1,"w1920","Motorized",NA,"Tue","weekday"
"7268",2020-03-31,"Brush Creek Rd","2","2","2",13.6,0.2,51,2,35,26.7,0,-1,0,0,2,1,1,1,"w1920","Hybrid",NA,"Tue","weekday"
"7269",2020-04-01,"Brush Creek Rd","2","2","2",13.6,0,47,-4,39,28.9,2,0,-1,0,-2,-2,-3,-3,"w1920","Non.motorized",NA,"Wed","weekday"
"7270",2020-04-01,"Brush Creek Rd","2","2","2",13.6,0,47,-4,39,28.9,2,0,-1,0,-2,-2,-3,-3,"w1920","Mechanized",NA,"Wed","weekday"
"7271",2020-04-01,"Brush Creek Rd","2","2","2",13.6,0,47,-4,39,28.9,2,0,-1,0,-2,-2,-3,-3,"w1920","Motorized",NA,"Wed","weekday"
"7272",2020-04-01,"Brush Creek Rd","2","2","2",13.6,0,47,-4,39,28.9,2,0,-1,0,-2,-2,-3,-3,"w1920","Hybrid",NA,"Wed","weekday"
"7273",2020-04-02,"Brush Creek Rd","2","2","2",13.6,0,46,-1,31,29.6,-4,2,0,-1,-5,-3,-3,-4,"w1920","Non.motorized",NA,"Thu","weekday"
"7274",2020-04-02,"Brush Creek Rd","2","2","2",13.6,0,46,-1,31,29.6,-4,2,0,-1,-5,-3,-3,-4,"w1920","Mechanized",NA,"Thu","weekday"
"7275",2020-04-02,"Brush Creek Rd","2","2","2",13.6,0,46,-1,31,29.6,-4,2,0,-1,-5,-3,-3,-4,"w1920","Motorized",NA,"Thu","weekday"
"7276",2020-04-02,"Brush Creek Rd","2","2","2",13.6,0,46,-1,31,29.6,-4,2,0,-1,-5,-3,-3,-4,"w1920","Hybrid",NA,"Thu","weekday"
"7277",2020-04-03,"Brush Creek Rd","2","2","2",13.6,0,46,0,28,29.6,-1,-4,2,0,-1,-5,-3,-3,"w1920","Non.motorized",NA,"Fri","weekday"
"7278",2020-04-03,"Brush Creek Rd","2","2","2",13.6,0,46,0,28,29.6,-1,-4,2,0,-1,-5,-3,-3,"w1920","Mechanized",NA,"Fri","weekday"
"7279",2020-04-03,"Brush Creek Rd","2","2","2",13.6,0,46,0,28,29.6,-1,-4,2,0,-1,-5,-3,-3,"w1920","Motorized",NA,"Fri","weekday"
"7280",2020-04-03,"Brush Creek Rd","2","2","2",13.6,0,46,0,28,29.6,-1,-4,2,0,-1,-5,-3,-3,"w1920","Hybrid",NA,"Fri","weekday"
"7281",2020-04-04,"Brush Creek Rd","2","2","2",13.6,0,45,-1,33,30.2,0,-1,-4,2,-1,-2,-6,-4,"w1920","Non.motorized",NA,"Sat","weekend"
"7282",2020-04-04,"Brush Creek Rd","2","2","2",13.6,0,45,-1,33,30.2,0,-1,-4,2,-1,-2,-6,-4,"w1920","Mechanized",NA,"Sat","weekend"
"7283",2020-04-04,"Brush Creek Rd","2","2","2",13.6,0,45,-1,33,30.2,0,-1,-4,2,-1,-2,-6,-4,"w1920","Motorized",NA,"Sat","weekend"
"7284",2020-04-04,"Brush Creek Rd","2","2","2",13.6,0,45,-1,33,30.2,0,-1,-4,2,-1,-2,-6,-4,"w1920","Hybrid",NA,"Sat","weekend"
"7285",2020-04-05,"Brush Creek Rd","2","2","3",13.6,0,45,0,38,30.2,-1,0,-1,-4,-1,-1,-2,-6,"w1920","Non.motorized",NA,"Sun","weekend"
"7286",2020-04-05,"Brush Creek Rd","2","2","3",13.6,0,45,0,38,30.2,-1,0,-1,-4,-1,-1,-2,-6,"w1920","Mechanized",NA,"Sun","weekend"
"7287",2020-04-05,"Brush Creek Rd","2","2","3",13.6,0,45,0,38,30.2,-1,0,-1,-4,-1,-1,-2,-6,"w1920","Motorized",NA,"Sun","weekend"
"7288",2020-04-05,"Brush Creek Rd","2","2","3",13.6,0,45,0,38,30.2,-1,0,-1,-4,-1,-1,-2,-6,"w1920","Hybrid",NA,"Sun","weekend"
"7289",2020-04-06,"Brush Creek Rd","2","2","3",13.6,0,44,-1,40,30.9,0,-1,0,-1,-1,-2,-2,-3,"w1920","Non.motorized",3,"Mon","weekday"
"7290",2020-04-06,"Brush Creek Rd","2","2","3",13.6,0,44,-1,40,30.9,0,-1,0,-1,-1,-2,-2,-3,"w1920","Mechanized",0,"Mon","weekday"
"7291",2020-04-06,"Brush Creek Rd","2","2","3",13.6,0,44,-1,40,30.9,0,-1,0,-1,-1,-2,-2,-3,"w1920","Motorized",0,"Mon","weekday"
"7292",2020-04-06,"Brush Creek Rd","2","2","3",13.6,0,44,-1,40,30.9,0,-1,0,-1,-1,-2,-2,-3,"w1920","Hybrid",0,"Mon","weekday"
"7293",2020-04-07,"Brush Creek Rd","2","2","3",13.4,-0.2,43,-1,39,31.2,-1,0,-1,0,-2,-2,-3,-3,"w1920","Non.motorized",3,"Tue","weekday"
"7294",2020-04-07,"Brush Creek Rd","2","2","3",13.4,-0.2,43,-1,39,31.2,-1,0,-1,0,-2,-2,-3,-3,"w1920","Mechanized",0,"Tue","weekday"
"7295",2020-04-07,"Brush Creek Rd","2","2","3",13.4,-0.2,43,-1,39,31.2,-1,0,-1,0,-2,-2,-3,-3,"w1920","Motorized",0,"Tue","weekday"
"7296",2020-04-07,"Brush Creek Rd","2","2","3",13.4,-0.2,43,-1,39,31.2,-1,0,-1,0,-2,-2,-3,-3,"w1920","Hybrid",0,"Tue","weekday"
"7297",2020-04-08,"Brush Creek Rd","2","3","3",13.3,-0.1,42,-1,40,31.7,-1,-1,0,-1,-2,-3,-3,-4,"w1920","Non.motorized",7,"Wed","weekday"
"7298",2020-04-08,"Brush Creek Rd","2","3","3",13.3,-0.1,42,-1,40,31.7,-1,-1,0,-1,-2,-3,-3,-4,"w1920","Mechanized",0,"Wed","weekday"
"7299",2020-04-08,"Brush Creek Rd","2","3","3",13.3,-0.1,42,-1,40,31.7,-1,-1,0,-1,-2,-3,-3,-4,"w1920","Motorized",0,"Wed","weekday"
"7300",2020-04-08,"Brush Creek Rd","2","3","3",13.3,-0.1,42,-1,40,31.7,-1,-1,0,-1,-2,-3,-3,-4,"w1920","Hybrid",0,"Wed","weekday"
"7301",2020-04-09,"Brush Creek Rd","2","3","3",13.1,-0.2,40,-2,42,32.8,-1,-1,-1,0,-3,-4,-5,-5,"w1920","Non.motorized",5,"Thu","weekday"
"7302",2020-04-09,"Brush Creek Rd","2","3","3",13.1,-0.2,40,-2,42,32.8,-1,-1,-1,0,-3,-4,-5,-5,"w1920","Mechanized",0,"Thu","weekday"
"7303",2020-04-09,"Brush Creek Rd","2","3","3",13.1,-0.2,40,-2,42,32.8,-1,-1,-1,0,-3,-4,-5,-5,"w1920","Motorized",0,"Thu","weekday"
"7304",2020-04-09,"Brush Creek Rd","2","3","3",13.1,-0.2,40,-2,42,32.8,-1,-1,-1,0,-3,-4,-5,-5,"w1920","Hybrid",0,"Thu","weekday"
"7305",2020-04-10,"Brush Creek Rd","3","3","3",12.9,-0.2,39,-1,38,33.1,-2,-1,-1,-1,-3,-4,-5,-6,"w1920","Non.motorized",2,"Fri","weekday"
"7306",2020-04-10,"Brush Creek Rd","3","3","3",12.9,-0.2,39,-1,38,33.1,-2,-1,-1,-1,-3,-4,-5,-6,"w1920","Mechanized",0,"Fri","weekday"
"7307",2020-04-10,"Brush Creek Rd","3","3","3",12.9,-0.2,39,-1,38,33.1,-2,-1,-1,-1,-3,-4,-5,-6,"w1920","Motorized",0,"Fri","weekday"
"7308",2020-04-10,"Brush Creek Rd","3","3","3",12.9,-0.2,39,-1,38,33.1,-2,-1,-1,-1,-3,-4,-5,-6,"w1920","Hybrid",0,"Fri","weekday"
"7309",2020-04-11,"Brush Creek Rd","2","3","3",12.9,0,39,0,36,33.1,-1,-2,-1,-1,-1,-3,-4,-5,"w1920","Non.motorized",6,"Sat","weekend"
"7310",2020-04-11,"Brush Creek Rd","2","3","3",12.9,0,39,0,36,33.1,-1,-2,-1,-1,-1,-3,-4,-5,"w1920","Mechanized",0,"Sat","weekend"
"7311",2020-04-11,"Brush Creek Rd","2","3","3",12.9,0,39,0,36,33.1,-1,-2,-1,-1,-1,-3,-4,-5,"w1920","Motorized",0,"Sat","weekend"
"7312",2020-04-11,"Brush Creek Rd","2","3","3",12.9,0,39,0,36,33.1,-1,-2,-1,-1,-1,-3,-4,-5,"w1920","Hybrid",0,"Sat","weekend"
"7313",2020-04-12,"Brush Creek Rd","2","2","2",12.8,-0.1,38,-1,29,33.7,0,-1,-2,-1,-1,-2,-4,-5,"w1920","Non.motorized",10,"Sun","weekend"
"7314",2020-04-12,"Brush Creek Rd","2","2","2",12.8,-0.1,38,-1,29,33.7,0,-1,-2,-1,-1,-2,-4,-5,"w1920","Mechanized",0,"Sun","weekend"
"7315",2020-04-12,"Brush Creek Rd","2","2","2",12.8,-0.1,38,-1,29,33.7,0,-1,-2,-1,-1,-2,-4,-5,"w1920","Motorized",0,"Sun","weekend"
"7316",2020-04-12,"Brush Creek Rd","2","2","2",12.8,-0.1,38,-1,29,33.7,0,-1,-2,-1,-1,-2,-4,-5,"w1920","Hybrid",0,"Sun","weekend"
"7317",2020-04-13,"Brush Creek Rd",NA,NA,NA,12.9,0.1,39,1,20,33.1,-1,0,-1,-2,0,0,-1,-3,"w1920","Non.motorized",6,"Mon","weekday"
"7318",2020-04-13,"Brush Creek Rd",NA,NA,NA,12.9,0.1,39,1,20,33.1,-1,0,-1,-2,0,0,-1,-3,"w1920","Mechanized",0,"Mon","weekday"
"7319",2020-04-13,"Brush Creek Rd",NA,NA,NA,12.9,0.1,39,1,20,33.1,-1,0,-1,-2,0,0,-1,-3,"w1920","Motorized",0,"Mon","weekday"
"7320",2020-04-13,"Brush Creek Rd",NA,NA,NA,12.9,0.1,39,1,20,33.1,-1,0,-1,-2,0,0,-1,-3,"w1920","Hybrid",0,"Mon","weekday"
"7321",2020-04-14,"Brush Creek Rd","2","2","2",13,0.1,39,0,18,33.3,1,-1,0,-1,1,0,0,-1,"w1920","Non.motorized",4,"Tue","weekday"
"7322",2020-04-14,"Brush Creek Rd","2","2","2",13,0.1,39,0,18,33.3,1,-1,0,-1,1,0,0,-1,"w1920","Mechanized",0,"Tue","weekday"
"7323",2020-04-14,"Brush Creek Rd","2","2","2",13,0.1,39,0,18,33.3,1,-1,0,-1,1,0,0,-1,"w1920","Motorized",0,"Tue","weekday"
"7324",2020-04-14,"Brush Creek Rd","2","2","2",13,0.1,39,0,18,33.3,1,-1,0,-1,1,0,0,-1,"w1920","Hybrid",0,"Tue","weekday"
"7325",2020-04-15,"Brush Creek Rd",NA,NA,NA,13.2,0.2,39,0,28,33.8,0,1,-1,0,0,1,0,0,"w1920","Non.motorized",2,"Wed","weekday"
"7326",2020-04-15,"Brush Creek Rd",NA,NA,NA,13.2,0.2,39,0,28,33.8,0,1,-1,0,0,1,0,0,"w1920","Mechanized",0,"Wed","weekday"
"7327",2020-04-15,"Brush Creek Rd",NA,NA,NA,13.2,0.2,39,0,28,33.8,0,1,-1,0,0,1,0,0,"w1920","Motorized",0,"Wed","weekday"
"7328",2020-04-15,"Brush Creek Rd",NA,NA,NA,13.2,0.2,39,0,28,33.8,0,1,-1,0,0,1,0,0,"w1920","Hybrid",0,"Wed","weekday"
"7329",2019-12-06,"Cement Creek","2","2","1",2.9,0.4,19,5,24,15.3,0,0,0,0,5,5,5,5,"w1920","Non.motorized",7,"Fri","weekday"
"7330",2019-12-06,"Cement Creek","2","2","1",2.9,0.4,19,5,24,15.3,0,0,0,0,5,5,5,5,"w1920","Mechanized",2,"Fri","weekday"
"7331",2019-12-06,"Cement Creek","2","2","1",2.9,0.4,19,5,24,15.3,0,0,0,0,5,5,5,5,"w1920","Motorized",3,"Fri","weekday"
"7332",2019-12-06,"Cement Creek","2","2","1",2.9,0.4,19,5,24,15.3,0,0,0,0,5,5,5,5,"w1920","Hybrid",NA,"Fri","weekday"
"7333",2019-12-07,"Cement Creek","2","2","1",3,0.1,18,-1,29,16.7,5,0,0,0,4,4,4,4,"w1920","Non.motorized",34,"Sat","weekend"
"7334",2019-12-07,"Cement Creek","2","2","1",3,0.1,18,-1,29,16.7,5,0,0,0,4,4,4,4,"w1920","Mechanized",2,"Sat","weekend"
"7335",2019-12-07,"Cement Creek","2","2","1",3,0.1,18,-1,29,16.7,5,0,0,0,4,4,4,4,"w1920","Motorized",9,"Sat","weekend"
"7336",2019-12-07,"Cement Creek","2","2","1",3,0.1,18,-1,29,16.7,5,0,0,0,4,4,4,4,"w1920","Hybrid",NA,"Sat","weekend"
"7337",2019-12-08,"Cement Creek","2","2","1",3,0,17,-1,28,17.6,-1,5,0,0,-2,3,3,3,"w1920","Non.motorized",33,"Sun","weekend"
"7338",2019-12-08,"Cement Creek","2","2","1",3,0,17,-1,28,17.6,-1,5,0,0,-2,3,3,3,"w1920","Mechanized",3,"Sun","weekend"
"7339",2019-12-08,"Cement Creek","2","2","1",3,0,17,-1,28,17.6,-1,5,0,0,-2,3,3,3,"w1920","Motorized",2,"Sun","weekend"
"7340",2019-12-08,"Cement Creek","2","2","1",3,0,17,-1,28,17.6,-1,5,0,0,-2,3,3,3,"w1920","Hybrid",NA,"Sun","weekend"
"7341",2019-12-09,"Cement Creek","3","3","2",3.4,0.4,22,5,21,15.5,-1,-1,5,0,4,3,8,8,"w1920","Non.motorized",3,"Mon","weekday"
"7342",2019-12-09,"Cement Creek","3","3","2",3.4,0.4,22,5,21,15.5,-1,-1,5,0,4,3,8,8,"w1920","Mechanized",0,"Mon","weekday"
"7343",2019-12-09,"Cement Creek","3","3","2",3.4,0.4,22,5,21,15.5,-1,-1,5,0,4,3,8,8,"w1920","Motorized",5,"Mon","weekday"
"7344",2019-12-09,"Cement Creek","3","3","2",3.4,0.4,22,5,21,15.5,-1,-1,5,0,4,3,8,8,"w1920","Hybrid",NA,"Mon","weekday"
"7345",2020-12-10,"Cement Creek",NA,NA,NA,NA,NA,NA,NA,NA,NA,NA,NA,NA,NA,NA,NA,NA,NA,"w1920","Non.motorized",11,"Thu","weekday"
"7346",2020-12-10,"Cement Creek",NA,NA,NA,NA,NA,NA,NA,NA,NA,NA,NA,NA,NA,NA,NA,NA,NA,"w1920","Mechanized",1,"Thu","weekday"
"7347",2020-12-10,"Cement Creek",NA,NA,NA,NA,NA,NA,NA,NA,NA,NA,NA,NA,NA,NA,NA,NA,NA,"w1920","Motorized",5,"Thu","weekday"
"7348",2020-12-10,"Cement Creek",NA,NA,NA,NA,NA,NA,NA,NA,NA,NA,NA,NA,NA,NA,NA,NA,NA,"w1920","Hybrid",1,"Thu","weekday"
"7349",2019-12-11,"Cement Creek","2","2","2",3.4,0,20,-1,22,17,-1,5,-1,-1,-2,3,2,1,"w1920","Non.motorized",12,"Wed","weekday"
"7350",2019-12-11,"Cement Creek","2","2","2",3.4,0,20,-1,22,17,-1,5,-1,-1,-2,3,2,1,"w1920","Mechanized",0,"Wed","weekday"
"7351",2019-12-11,"Cement Creek","2","2","2",3.4,0,20,-1,22,17,-1,5,-1,-1,-2,3,2,1,"w1920","Motorized",2,"Wed","weekday"
"7352",2019-12-11,"Cement Creek","2","2","2",3.4,0,20,-1,22,17,-1,5,-1,-1,-2,3,2,1,"w1920","Hybrid",NA,"Wed","weekday"
"7353",2019-12-12,"Cement Creek","2","2","2",3.4,0,19,-1,25,17.9,-1,-1,5,-1,-2,-3,2,1,"w1920","Non.motorized",9,"Thu","weekday"
"7354",2019-12-12,"Cement Creek","2","2","2",3.4,0,19,-1,25,17.9,-1,-1,5,-1,-2,-3,2,1,"w1920","Mechanized",0,"Thu","weekday"
"7355",2019-12-12,"Cement Creek","2","2","2",3.4,0,19,-1,25,17.9,-1,-1,5,-1,-2,-3,2,1,"w1920","Motorized",3,"Thu","weekday"
"7356",2019-12-12,"Cement Creek","2","2","2",3.4,0,19,-1,25,17.9,-1,-1,5,-1,-2,-3,2,1,"w1920","Hybrid",NA,"Thu","weekday"
"7357",2019-12-13,"Cement Creek","2","2","2",3.8,0.4,21,2,24,18.1,-1,-1,-1,5,1,0,-1,4,"w1920","Non.motorized",5,"Fri","weekday"
"7358",2019-12-13,"Cement Creek","2","2","2",3.8,0.4,21,2,24,18.1,-1,-1,-1,5,1,0,-1,4,"w1920","Mechanized",0,"Fri","weekday"
"7359",2019-12-13,"Cement Creek","2","2","2",3.8,0.4,21,2,24,18.1,-1,-1,-1,5,1,0,-1,4,"w1920","Motorized",5,"Fri","weekday"
"7360",2019-12-13,"Cement Creek","2","2","2",3.8,0.4,21,2,24,18.1,-1,-1,-1,5,1,0,-1,4,"w1920","Hybrid",1,"Fri","weekday"
"7361",2019-12-14,"Cement Creek","3","3","3",4.2,0.4,27,6,25,15.6,2,-1,-1,-1,8,7,6,5,"w1920","Non.motorized",12,"Sat","weekend"
"7362",2019-12-14,"Cement Creek","3","3","3",4.2,0.4,27,6,25,15.6,2,-1,-1,-1,8,7,6,5,"w1920","Mechanized",0,"Sat","weekend"
"7363",2019-12-14,"Cement Creek","3","3","3",4.2,0.4,27,6,25,15.6,2,-1,-1,-1,8,7,6,5,"w1920","Motorized",2,"Sat","weekend"
"7364",2019-12-14,"Cement Creek","3","3","3",4.2,0.4,27,6,25,15.6,2,-1,-1,-1,8,7,6,5,"w1920","Hybrid",2,"Sat","weekend"
"7365",2019-12-15,"Cement Creek","3","3","2",4.8,0.6,31,4,17,15.5,6,2,-1,-1,10,12,11,10,"w1920","Non.motorized",40,"Sun","weekend"
"7366",2019-12-15,"Cement Creek","3","3","2",4.8,0.6,31,4,17,15.5,6,2,-1,-1,10,12,11,10,"w1920","Mechanized",0,"Sun","weekend"
"7367",2019-12-15,"Cement Creek","3","3","2",4.8,0.6,31,4,17,15.5,6,2,-1,-1,10,12,11,10,"w1920","Motorized",4,"Sun","weekend"
"7368",2019-12-15,"Cement Creek","3","3","2",4.8,0.6,31,4,17,15.5,6,2,-1,-1,10,12,11,10,"w1920","Hybrid",NA,"Sun","weekend"
"7369",2019-12-16,"Cement Creek","3","3","2",4.8,0,29,-2,6,16.6,4,6,2,-1,2,8,10,9,"w1920","Non.motorized",9,"Mon","weekday"
"7370",2019-12-16,"Cement Creek","3","3","2",4.8,0,29,-2,6,16.6,4,6,2,-1,2,8,10,9,"w1920","Mechanized",2,"Mon","weekday"
"7371",2019-12-16,"Cement Creek","3","3","2",4.8,0,29,-2,6,16.6,4,6,2,-1,2,8,10,9,"w1920","Motorized",6,"Mon","weekday"
"7372",2019-12-16,"Cement Creek","3","3","2",4.8,0,29,-2,6,16.6,4,6,2,-1,2,8,10,9,"w1920","Hybrid",1,"Mon","weekday"
"7373",2019-12-17,"Cement Creek","2","2","1",4.8,0,27,-2,8,17.8,-2,4,6,2,-4,0,6,8,"w1920","Non.motorized",4,"Tue","weekday"
"7374",2019-12-17,"Cement Creek","2","2","1",4.8,0,27,-2,8,17.8,-2,4,6,2,-4,0,6,8,"w1920","Mechanized",1,"Tue","weekday"
"7375",2019-12-17,"Cement Creek","2","2","1",4.8,0,27,-2,8,17.8,-2,4,6,2,-4,0,6,8,"w1920","Motorized",2,"Tue","weekday"
"7376",2019-12-17,"Cement Creek","2","2","1",4.8,0,27,-2,8,17.8,-2,4,6,2,-4,0,6,8,"w1920","Hybrid",NA,"Tue","weekday"
"7377",2019-12-18,"Cement Creek","2","2","1",4.8,0,26,-1,20,18.5,-2,-2,4,6,-3,-5,-1,5,"w1920","Non.motorized",4,"Wed","weekday"
"7378",2019-12-18,"Cement Creek","2","2","1",4.8,0,26,-1,20,18.5,-2,-2,4,6,-3,-5,-1,5,"w1920","Mechanized",5,"Wed","weekday"
"7379",2019-12-18,"Cement Creek","2","2","1",4.8,0,26,-1,20,18.5,-2,-2,4,6,-3,-5,-1,5,"w1920","Motorized",2,"Wed","weekday"
"7380",2019-12-18,"Cement Creek","2","2","1",4.8,0,26,-1,20,18.5,-2,-2,4,6,-3,-5,-1,5,"w1920","Hybrid",NA,"Wed","weekday"
"7381",2019-12-19,"Cement Creek","2","2","1",4.9,0.1,25,-1,21,19.6,-1,-2,-2,4,-2,-4,-6,-2,"w1920","Non.motorized",5,"Thu","weekday"
"7382",2019-12-19,"Cement Creek","2","2","1",4.9,0.1,25,-1,21,19.6,-1,-2,-2,4,-2,-4,-6,-2,"w1920","Mechanized",0,"Thu","weekday"
"7383",2019-12-19,"Cement Creek","2","2","1",4.9,0.1,25,-1,21,19.6,-1,-2,-2,4,-2,-4,-6,-2,"w1920","Motorized",4,"Thu","weekday"
"7384",2019-12-19,"Cement Creek","2","2","1",4.9,0.1,25,-1,21,19.6,-1,-2,-2,4,-2,-4,-6,-2,"w1920","Hybrid",1,"Thu","weekday"
"7385",2019-12-20,"Cement Creek","2","2","1",4.9,0,24,-1,21,20.4,-1,-1,-2,-2,-2,-3,-5,-7,"w1920","Non.motorized",4,"Fri","weekday"
"7386",2019-12-20,"Cement Creek","2","2","1",4.9,0,24,-1,21,20.4,-1,-1,-2,-2,-2,-3,-5,-7,"w1920","Mechanized",0,"Fri","weekday"
"7387",2019-12-20,"Cement Creek","2","2","1",4.9,0,24,-1,21,20.4,-1,-1,-2,-2,-2,-3,-5,-7,"w1920","Motorized",7,"Fri","weekday"
"7388",2019-12-20,"Cement Creek","2","2","1",4.9,0,24,-1,21,20.4,-1,-1,-2,-2,-2,-3,-5,-7,"w1920","Hybrid",NA,"Fri","weekday"
"7389",2019-12-21,"Cement Creek","2","2","1",4.9,0,24,0,27,20.4,-1,-1,-1,-2,-1,-2,-3,-5,"w1920","Non.motorized",26,"Sat","weekend"
"7390",2019-12-21,"Cement Creek","2","2","1",4.9,0,24,0,27,20.4,-1,-1,-1,-2,-1,-2,-3,-5,"w1920","Mechanized",3,"Sat","weekend"
"7391",2019-12-21,"Cement Creek","2","2","1",4.9,0,24,0,27,20.4,-1,-1,-1,-2,-1,-2,-3,-5,"w1920","Motorized",3,"Sat","weekend"
"7392",2019-12-21,"Cement Creek","2","2","1",4.9,0,24,0,27,20.4,-1,-1,-1,-2,-1,-2,-3,-5,"w1920","Hybrid",NA,"Sat","weekend"
"7393",2019-12-22,"Cement Creek","2","2","1",5,0.1,23,-1,31,21.7,0,-1,-1,-1,-1,-2,-3,-4,"w1920","Non.motorized",31,"Sun","weekend"
"7394",2019-12-22,"Cement Creek","2","2","1",5,0.1,23,-1,31,21.7,0,-1,-1,-1,-1,-2,-3,-4,"w1920","Mechanized",3,"Sun","weekend"
"7395",2019-12-22,"Cement Creek","2","2","1",5,0.1,23,-1,31,21.7,0,-1,-1,-1,-1,-2,-3,-4,"w1920","Motorized",7,"Sun","weekend"
"7396",2019-12-22,"Cement Creek","2","2","1",5,0.1,23,-1,31,21.7,0,-1,-1,-1,-1,-2,-3,-4,"w1920","Hybrid",NA,"Sun","weekend"
"7397",2019-12-23,"Cement Creek","2","1","1",5,0,23,0,34,21.7,-1,0,-1,-1,-1,-1,-2,-3,"w1920","Non.motorized",21,"Mon","weekday"
"7398",2019-12-23,"Cement Creek","2","1","1",5,0,23,0,34,21.7,-1,0,-1,-1,-1,-1,-2,-3,"w1920","Mechanized",1,"Mon","weekday"
"7399",2019-12-23,"Cement Creek","2","1","1",5,0,23,0,34,21.7,-1,0,-1,-1,-1,-1,-2,-3,"w1920","Motorized",1,"Mon","weekday"
"7400",2019-12-23,"Cement Creek","2","1","1",5,0,23,0,34,21.7,-1,0,-1,-1,-1,-1,-2,-3,"w1920","Hybrid",NA,"Mon","weekday"
"7401",2019-12-24,"Cement Creek","2","1","1",5,0,22,-1,30,22.7,0,-1,0,-1,-1,-2,-2,-3,"w1920","Non.motorized",22,"Tue","weekday"
"7402",2019-12-24,"Cement Creek","2","1","1",5,0,22,-1,30,22.7,0,-1,0,-1,-1,-2,-2,-3,"w1920","Mechanized",6,"Tue","weekday"
"7403",2019-12-24,"Cement Creek","2","1","1",5,0,22,-1,30,22.7,0,-1,0,-1,-1,-2,-2,-3,"w1920","Motorized",8,"Tue","weekday"
"7404",2019-12-24,"Cement Creek","2","1","1",5,0,22,-1,30,22.7,0,-1,0,-1,-1,-2,-2,-3,"w1920","Hybrid",1,"Tue","weekday"
"7405",2019-12-25,"Cement Creek","2","2","2",5,0,23,1,22,21.7,-1,0,-1,0,0,0,-1,-1,"w1920","Non.motorized",30,"Wed","weekday"
"7406",2019-12-25,"Cement Creek","2","2","2",5,0,23,1,22,21.7,-1,0,-1,0,0,0,-1,-1,"w1920","Mechanized",2,"Wed","weekday"
"7407",2019-12-25,"Cement Creek","2","2","2",5,0,23,1,22,21.7,-1,0,-1,0,0,0,-1,-1,"w1920","Motorized",3,"Wed","weekday"
"7408",2019-12-25,"Cement Creek","2","2","2",5,0,23,1,22,21.7,-1,0,-1,0,0,0,-1,-1,"w1920","Hybrid",2,"Wed","weekday"
"7409",2019-12-26,"Cement Creek","2","2","1",5,0,23,0,17,21.7,1,-1,0,-1,1,0,0,-1,"w1920","Non.motorized",25,"Thu","weekday"
"7410",2019-12-26,"Cement Creek","2","2","1",5,0,23,0,17,21.7,1,-1,0,-1,1,0,0,-1,"w1920","Mechanized",1,"Thu","weekday"
"7411",2019-12-26,"Cement Creek","2","2","1",5,0,23,0,17,21.7,1,-1,0,-1,1,0,0,-1,"w1920","Motorized",7,"Thu","weekday"
"7412",2019-12-26,"Cement Creek","2","2","1",5,0,23,0,17,21.7,1,-1,0,-1,1,0,0,-1,"w1920","Hybrid",1,"Thu","weekday"
"7413",2019-12-27,"Cement Creek","3","3","2",5.1,0.1,24,1,22,21.2,0,1,-1,0,1,2,1,1,"w1920","Non.motorized",22,"Fri","weekday"
"7414",2019-12-27,"Cement Creek","3","3","2",5.1,0.1,24,1,22,21.2,0,1,-1,0,1,2,1,1,"w1920","Mechanized",1,"Fri","weekday"
"7415",2019-12-27,"Cement Creek","3","3","2",5.1,0.1,24,1,22,21.2,0,1,-1,0,1,2,1,1,"w1920","Motorized",5,"Fri","weekday"
"7416",2019-12-27,"Cement Creek","3","3","2",5.1,0.1,24,1,22,21.2,0,1,-1,0,1,2,1,1,"w1920","Hybrid",NA,"Fri","weekday"
"7417",2019-12-28,"Cement Creek","3","3","2",5.6,0.5,30,6,16,18.7,1,0,1,-1,7,7,8,7,"w1920","Non.motorized",34,"Sat","weekend"
"7418",2019-12-28,"Cement Creek","3","3","2",5.6,0.5,30,6,16,18.7,1,0,1,-1,7,7,8,7,"w1920","Mechanized",0,"Sat","weekend"
"7419",2019-12-28,"Cement Creek","3","3","2",5.6,0.5,30,6,16,18.7,1,0,1,-1,7,7,8,7,"w1920","Motorized",3,"Sat","weekend"
"7420",2019-12-28,"Cement Creek","3","3","2",5.6,0.5,30,6,16,18.7,1,0,1,-1,7,7,8,7,"w1920","Hybrid",NA,"Sat","weekend"
"7421",2019-12-29,"Cement Creek","3","3","2",5.6,0,29,-1,3,19.3,6,1,0,1,5,6,6,7,"w1920","Non.motorized",30,"Sun","weekend"
"7422",2019-12-29,"Cement Creek","3","3","2",5.6,0,29,-1,3,19.3,6,1,0,1,5,6,6,7,"w1920","Mechanized",0,"Sun","weekend"
"7423",2019-12-29,"Cement Creek","3","3","2",5.6,0,29,-1,3,19.3,6,1,0,1,5,6,6,7,"w1920","Motorized",6,"Sun","weekend"
"7424",2019-12-29,"Cement Creek","3","3","2",5.6,0,29,-1,3,19.3,6,1,0,1,5,6,6,7,"w1920","Hybrid",NA,"Sun","weekend"
"7425",2019-12-30,"Cement Creek","3","3","2",5.6,0,28,-1,3,20,-1,6,1,0,-2,4,5,5,"w1920","Non.motorized",18,"Mon","weekday"
"7426",2019-12-30,"Cement Creek","3","3","2",5.6,0,28,-1,3,20,-1,6,1,0,-2,4,5,5,"w1920","Mechanized",2,"Mon","weekday"
"7427",2019-12-30,"Cement Creek","3","3","2",5.6,0,28,-1,3,20,-1,6,1,0,-2,4,5,5,"w1920","Motorized",0,"Mon","weekday"
"7428",2019-12-30,"Cement Creek","3","3","2",5.6,0,28,-1,3,20,-1,6,1,0,-2,4,5,5,"w1920","Hybrid",NA,"Mon","weekday"
"7429",2019-12-31,"Cement Creek","2","2","1",5.6,0,28,0,13,20,-1,-1,6,1,-1,-2,4,5,"w1920","Non.motorized",5,"Tue","weekday"
"7430",2019-12-31,"Cement Creek","2","2","1",5.6,0,28,0,13,20,-1,-1,6,1,-1,-2,4,5,"w1920","Mechanized",1,"Tue","weekday"
"7431",2019-12-31,"Cement Creek","2","2","1",5.6,0,28,0,13,20,-1,-1,6,1,-1,-2,4,5,"w1920","Motorized",1,"Tue","weekday"
"7432",2019-12-31,"Cement Creek","2","2","1",5.6,0,28,0,13,20,-1,-1,6,1,-1,-2,4,5,"w1920","Hybrid",NA,"Tue","weekday"
"7433",2020-01-01,"Cement Creek","2","1","1",5.6,0,27,-1,21,20.7,0,-1,-1,6,-1,-2,-3,3,"w1920","Non.motorized",42,"Wed","weekday"
"7434",2020-01-01,"Cement Creek","2","1","1",5.6,0,27,-1,21,20.7,0,-1,-1,6,-1,-2,-3,3,"w1920","Mechanized",1,"Wed","weekday"
"7435",2020-01-01,"Cement Creek","2","1","1",5.6,0,27,-1,21,20.7,0,-1,-1,6,-1,-2,-3,3,"w1920","Motorized",3,"Wed","weekday"
"7436",2020-01-01,"Cement Creek","2","1","1",5.6,0,27,-1,21,20.7,0,-1,-1,6,-1,-2,-3,3,"w1920","Hybrid",NA,"Wed","weekday"
"7437",2020-01-02,"Cement Creek","3","3","2",5.9,0.3,29,2,16,20.3,-1,0,-1,-1,1,1,0,-1,"w1920","Non.motorized",19,"Thu","weekday"
"7438",2020-01-02,"Cement Creek","3","3","2",5.9,0.3,29,2,16,20.3,-1,0,-1,-1,1,1,0,-1,"w1920","Mechanized",0,"Thu","weekday"
"7439",2020-01-02,"Cement Creek","3","3","2",5.9,0.3,29,2,16,20.3,-1,0,-1,-1,1,1,0,-1,"w1920","Motorized",2,"Thu","weekday"
"7440",2020-01-02,"Cement Creek","3","3","2",5.9,0.3,29,2,16,20.3,-1,0,-1,-1,1,1,0,-1,"w1920","Hybrid",NA,"Thu","weekday"
"7441",2020-01-03,"Cement Creek","3","2","1",5.9,0,31,2,19,19,2,-1,0,-1,4,3,3,2,"w1920","Non.motorized",37,"Fri","weekday"
"7442",2020-01-03,"Cement Creek","3","2","1",5.9,0,31,2,19,19,2,-1,0,-1,4,3,3,2,"w1920","Mechanized",0,"Fri","weekday"
"7443",2020-01-03,"Cement Creek","3","2","1",5.9,0,31,2,19,19,2,-1,0,-1,4,3,3,2,"w1920","Motorized",3,"Fri","weekday"
"7444",2020-01-03,"Cement Creek","3","2","1",5.9,0,31,2,19,19,2,-1,0,-1,4,3,3,2,"w1920","Hybrid",NA,"Fri","weekday"
"7445",2020-01-04,"Cement Creek","2","2","1",5.9,0,30,-1,26,19.7,2,2,-1,0,1,3,2,2,"w1920","Non.motorized",36,"Sat","weekend"
"7446",2020-01-04,"Cement Creek","2","2","1",5.9,0,30,-1,26,19.7,2,2,-1,0,1,3,2,2,"w1920","Mechanized",2,"Sat","weekend"
"7447",2020-01-04,"Cement Creek","2","2","1",5.9,0,30,-1,26,19.7,2,2,-1,0,1,3,2,2,"w1920","Motorized",1,"Sat","weekend"
"7448",2020-01-04,"Cement Creek","2","2","1",5.9,0,30,-1,26,19.7,2,2,-1,0,1,3,2,2,"w1920","Hybrid",NA,"Sat","weekend"
"7449",2020-01-05,"Cement Creek","2","2","1",5.9,0,28,-2,23,21.1,-1,2,2,-1,-3,-1,1,0,"w1920","Non.motorized",24,"Sun","weekend"
"7450",2020-01-05,"Cement Creek","2","2","1",5.9,0,28,-2,23,21.1,-1,2,2,-1,-3,-1,1,0,"w1920","Mechanized",2,"Sun","weekend"
"7451",2020-01-05,"Cement Creek","2","2","1",5.9,0,28,-2,23,21.1,-1,2,2,-1,-3,-1,1,0,"w1920","Motorized",1,"Sun","weekend"
"7452",2020-01-05,"Cement Creek","2","2","1",5.9,0,28,-2,23,21.1,-1,2,2,-1,-3,-1,1,0,"w1920","Hybrid",NA,"Sun","weekend"
"7453",2020-01-06,"Cement Creek","2","2","1",5.9,0,28,0,15,21.1,-2,-1,2,2,-2,-3,-1,1,"w1920","Non.motorized",15,"Mon","weekday"
"7454",2020-01-06,"Cement Creek","2","2","1",5.9,0,28,0,15,21.1,-2,-1,2,2,-2,-3,-1,1,"w1920","Mechanized",1,"Mon","weekday"
"7455",2020-01-06,"Cement Creek","2","2","1",5.9,0,28,0,15,21.1,-2,-1,2,2,-2,-3,-1,1,"w1920","Motorized",4,"Mon","weekday"
"7456",2020-01-06,"Cement Creek","2","2","1",5.9,0,28,0,15,21.1,-2,-1,2,2,-2,-3,-1,1,"w1920","Hybrid",NA,"Mon","weekday"
"7457",2020-01-07,"Cement Creek","2","1","1",5.9,0,28,0,22,21.1,0,-2,-1,2,0,-2,-3,-1,"w1920","Non.motorized",8,"Tue","weekday"
"7458",2020-01-07,"Cement Creek","2","1","1",5.9,0,28,0,22,21.1,0,-2,-1,2,0,-2,-3,-1,"w1920","Mechanized",2,"Tue","weekday"
"7459",2020-01-07,"Cement Creek","2","1","1",5.9,0,28,0,22,21.1,0,-2,-1,2,0,-2,-3,-1,"w1920","Motorized",3,"Tue","weekday"
"7460",2020-01-07,"Cement Creek","2","1","1",5.9,0,28,0,22,21.1,0,-2,-1,2,0,-2,-3,-1,"w1920","Hybrid",NA,"Tue","weekday"
"7461",2020-01-08,"Cement Creek","2","1","1",6,0.1,28,0,23,21.4,0,0,-2,-1,0,0,-2,-3,"w1920","Non.motorized",14,"Wed","weekday"
"7462",2020-01-08,"Cement Creek","2","1","1",6,0.1,28,0,23,21.4,0,0,-2,-1,0,0,-2,-3,"w1920","Mechanized",1,"Wed","weekday"
"7463",2020-01-08,"Cement Creek","2","1","1",6,0.1,28,0,23,21.4,0,0,-2,-1,0,0,-2,-3,"w1920","Motorized",0,"Wed","weekday"
"7464",2020-01-08,"Cement Creek","2","1","1",6,0.1,28,0,23,21.4,0,0,-2,-1,0,0,-2,-3,"w1920","Hybrid",NA,"Wed","weekday"
"7465",2020-01-09,"Cement Creek","2","1","1",6,0,27,-1,17,22.2,0,0,0,-2,-1,-1,-1,-3,"w1920","Non.motorized",15,"Thu","weekday"
"7466",2020-01-09,"Cement Creek","2","1","1",6,0,27,-1,17,22.2,0,0,0,-2,-1,-1,-1,-3,"w1920","Mechanized",1,"Thu","weekday"
"7467",2020-01-09,"Cement Creek","2","1","1",6,0,27,-1,17,22.2,0,0,0,-2,-1,-1,-1,-3,"w1920","Motorized",0,"Thu","weekday"
"7468",2020-01-09,"Cement Creek","2","1","1",6,0,27,-1,17,22.2,0,0,0,-2,-1,-1,-1,-3,"w1920","Hybrid",NA,"Thu","weekday"
"7469",2020-01-10,"Cement Creek","2","1","1",6,0,29,2,11,20.7,-1,0,0,0,1,1,1,1,"w1920","Non.motorized",13,"Fri","weekday"
"7470",2020-01-10,"Cement Creek","2","1","1",6,0,29,2,11,20.7,-1,0,0,0,1,1,1,1,"w1920","Mechanized",2,"Fri","weekday"
"7471",2020-01-10,"Cement Creek","2","1","1",6,0,29,2,11,20.7,-1,0,0,0,1,1,1,1,"w1920","Motorized",2,"Fri","weekday"
"7472",2020-01-10,"Cement Creek","2","1","1",6,0,29,2,11,20.7,-1,0,0,0,1,1,1,1,"w1920","Hybrid",NA,"Fri","weekday"
"7473",2020-01-11,"Cement Creek","2","1","1",6,0,29,0,12,20.7,2,-1,0,0,2,1,1,1,"w1920","Non.motorized",13,"Sat","weekend"
"7474",2020-01-11,"Cement Creek","2","1","1",6,0,29,0,12,20.7,2,-1,0,0,2,1,1,1,"w1920","Mechanized",2,"Sat","weekend"
"7475",2020-01-11,"Cement Creek","2","1","1",6,0,29,0,12,20.7,2,-1,0,0,2,1,1,1,"w1920","Motorized",0,"Sat","weekend"
"7476",2020-01-11,"Cement Creek","2","1","1",6,0,29,0,12,20.7,2,-1,0,0,2,1,1,1,"w1920","Hybrid",NA,"Sat","weekend"
"7477",2020-01-12,"Cement Creek","2","1","1",6.1,0.1,29,0,13,21,0,2,-1,0,0,2,1,1,"w1920","Non.motorized",NA,"Sun","weekend"
"7478",2020-01-12,"Cement Creek","2","1","1",6.1,0.1,29,0,13,21,0,2,-1,0,0,2,1,1,"w1920","Mechanized",NA,"Sun","weekend"
"7479",2020-01-12,"Cement Creek","2","1","1",6.1,0.1,29,0,13,21,0,2,-1,0,0,2,1,1,"w1920","Motorized",NA,"Sun","weekend"
"7480",2020-01-12,"Cement Creek","2","1","1",6.1,0.1,29,0,13,21,0,2,-1,0,0,2,1,1,"w1920","Hybrid",NA,"Sun","weekend"
"7481",2020-01-13,"Cement Creek","2","2","1",6.2,0.1,29,0,16,21.4,0,0,2,-1,0,0,2,1,"w1920","Non.motorized",NA,"Mon","weekday"
"7482",2020-01-13,"Cement Creek","2","2","1",6.2,0.1,29,0,16,21.4,0,0,2,-1,0,0,2,1,"w1920","Mechanized",NA,"Mon","weekday"
"7483",2020-01-13,"Cement Creek","2","2","1",6.2,0.1,29,0,16,21.4,0,0,2,-1,0,0,2,1,"w1920","Motorized",NA,"Mon","weekday"
"7484",2020-01-13,"Cement Creek","2","2","1",6.2,0.1,29,0,16,21.4,0,0,2,-1,0,0,2,1,"w1920","Hybrid",NA,"Mon","weekday"
"7485",2020-01-14,"Cement Creek","3","2","1",6.6,0.4,34,5,23,19.4,0,0,0,2,5,5,5,7,"w1920","Non.motorized",NA,"Tue","weekday"
"7486",2020-01-14,"Cement Creek","3","2","1",6.6,0.4,34,5,23,19.4,0,0,0,2,5,5,5,7,"w1920","Mechanized",NA,"Tue","weekday"
"7487",2020-01-14,"Cement Creek","3","2","1",6.6,0.4,34,5,23,19.4,0,0,0,2,5,5,5,7,"w1920","Motorized",NA,"Tue","weekday"
"7488",2020-01-14,"Cement Creek","3","2","1",6.6,0.4,34,5,23,19.4,0,0,0,2,5,5,5,7,"w1920","Hybrid",NA,"Tue","weekday"
"7489",2020-01-15,"Cement Creek","3","2","1",6.7,0.1,32,-2,23,20.9,5,0,0,0,3,3,3,3,"w1920","Non.motorized",NA,"Wed","weekday"
"7490",2020-01-15,"Cement Creek","3","2","1",6.7,0.1,32,-2,23,20.9,5,0,0,0,3,3,3,3,"w1920","Mechanized",NA,"Wed","weekday"
"7491",2020-01-15,"Cement Creek","3","2","1",6.7,0.1,32,-2,23,20.9,5,0,0,0,3,3,3,3,"w1920","Motorized",NA,"Wed","weekday"
"7492",2020-01-15,"Cement Creek","3","2","1",6.7,0.1,32,-2,23,20.9,5,0,0,0,3,3,3,3,"w1920","Hybrid",NA,"Wed","weekday"
"7493",2020-01-16,"Cement Creek","2","2","1",6.7,0,31,-1,28,21.6,-2,5,0,0,-3,2,2,2,"w1920","Non.motorized",NA,"Thu","weekday"
"7494",2020-01-16,"Cement Creek","2","2","1",6.7,0,31,-1,28,21.6,-2,5,0,0,-3,2,2,2,"w1920","Mechanized",NA,"Thu","weekday"
"7495",2020-01-16,"Cement Creek","2","2","1",6.7,0,31,-1,28,21.6,-2,5,0,0,-3,2,2,2,"w1920","Motorized",NA,"Thu","weekday"
"7496",2020-01-16,"Cement Creek","2","2","1",6.7,0,31,-1,28,21.6,-2,5,0,0,-3,2,2,2,"w1920","Hybrid",NA,"Thu","weekday"
"7497",2020-01-17,"Cement Creek","2","2","1",6.8,0.1,29,-2,19,23.4,-1,-2,5,0,-3,-5,0,0,"w1920","Non.motorized",NA,"Fri","weekday"
"7498",2020-01-17,"Cement Creek","2","2","1",6.8,0.1,29,-2,19,23.4,-1,-2,5,0,-3,-5,0,0,"w1920","Mechanized",NA,"Fri","weekday"
"7499",2020-01-17,"Cement Creek","2","2","1",6.8,0.1,29,-2,19,23.4,-1,-2,5,0,-3,-5,0,0,"w1920","Motorized",NA,"Fri","weekday"
"7500",2020-01-17,"Cement Creek","2","2","1",6.8,0.1,29,-2,19,23.4,-1,-2,5,0,-3,-5,0,0,"w1920","Hybrid",NA,"Fri","weekday"
"7501",2020-01-18,"Cement Creek","2","2","2",7,0.2,34,5,16,20.6,-2,-1,-2,5,3,2,0,5,"w1920","Non.motorized",NA,"Sat","weekend"
"7502",2020-01-18,"Cement Creek","2","2","2",7,0.2,34,5,16,20.6,-2,-1,-2,5,3,2,0,5,"w1920","Mechanized",NA,"Sat","weekend"
"7503",2020-01-18,"Cement Creek","2","2","2",7,0.2,34,5,16,20.6,-2,-1,-2,5,3,2,0,5,"w1920","Motorized",NA,"Sat","weekend"
"7504",2020-01-18,"Cement Creek","2","2","2",7,0.2,34,5,16,20.6,-2,-1,-2,5,3,2,0,5,"w1920","Hybrid",NA,"Sat","weekend"
"7505",2020-01-19,"Cement Creek","2","2","1",7,0,33,-1,21,21.2,5,-2,-1,-2,4,2,1,-1,"w1920","Non.motorized",NA,"Sun","weekend"
"7506",2020-01-19,"Cement Creek","2","2","1",7,0,33,-1,21,21.2,5,-2,-1,-2,4,2,1,-1,"w1920","Mechanized",NA,"Sun","weekend"
"7507",2020-01-19,"Cement Creek","2","2","1",7,0,33,-1,21,21.2,5,-2,-1,-2,4,2,1,-1,"w1920","Motorized",NA,"Sun","weekend"
"7508",2020-01-19,"Cement Creek","2","2","1",7,0,33,-1,21,21.2,5,-2,-1,-2,4,2,1,-1,"w1920","Hybrid",NA,"Sun","weekend"
"7509",2020-01-20,"Cement Creek","2","2","1",7.1,0.1,32,-1,25,22.2,-1,5,-2,-1,-2,3,1,0,"w1920","Non.motorized",NA,"Mon","weekday"
"7510",2020-01-20,"Cement Creek","2","2","1",7.1,0.1,32,-1,25,22.2,-1,5,-2,-1,-2,3,1,0,"w1920","Mechanized",NA,"Mon","weekday"
"7511",2020-01-20,"Cement Creek","2","2","1",7.1,0.1,32,-1,25,22.2,-1,5,-2,-1,-2,3,1,0,"w1920","Motorized",NA,"Mon","weekday"
"7512",2020-01-20,"Cement Creek","2","2","1",7.1,0.1,32,-1,25,22.2,-1,5,-2,-1,-2,3,1,0,"w1920","Hybrid",NA,"Mon","weekday"
"7513",2020-01-21,"Cement Creek","2","2","1",7.1,0,31,-1,28,22.9,-1,-1,5,-2,-2,-3,2,0,"w1920","Non.motorized",NA,"Tue","weekday"
"7514",2020-01-21,"Cement Creek","2","2","1",7.1,0,31,-1,28,22.9,-1,-1,5,-2,-2,-3,2,0,"w1920","Mechanized",NA,"Tue","weekday"
"7515",2020-01-21,"Cement Creek","2","2","1",7.1,0,31,-1,28,22.9,-1,-1,5,-2,-2,-3,2,0,"w1920","Motorized",NA,"Tue","weekday"
"7516",2020-01-21,"Cement Creek","2","2","1",7.1,0,31,-1,28,22.9,-1,-1,5,-2,-2,-3,2,0,"w1920","Hybrid",NA,"Tue","weekday"
"7517",2020-01-22,"Cement Creek","2","2","2",7.3,0.2,32,1,25,22.8,-1,-1,-1,5,0,-1,-2,3,"w1920","Non.motorized",NA,"Wed","weekday"
"7518",2020-01-22,"Cement Creek","2","2","2",7.3,0.2,32,1,25,22.8,-1,-1,-1,5,0,-1,-2,3,"w1920","Mechanized",NA,"Wed","weekday"
"7519",2020-01-22,"Cement Creek","2","2","2",7.3,0.2,32,1,25,22.8,-1,-1,-1,5,0,-1,-2,3,"w1920","Motorized",NA,"Wed","weekday"
"7520",2020-01-22,"Cement Creek","2","2","2",7.3,0.2,32,1,25,22.8,-1,-1,-1,5,0,-1,-2,3,"w1920","Hybrid",NA,"Wed","weekday"
"7521",2020-01-23,"Cement Creek","3","2","2",7.3,0,34,2,23,21.5,1,-1,-1,-1,3,2,1,0,"w1920","Non.motorized",NA,"Thu","weekday"
"7522",2020-01-23,"Cement Creek","3","2","2",7.3,0,34,2,23,21.5,1,-1,-1,-1,3,2,1,0,"w1920","Mechanized",NA,"Thu","weekday"
"7523",2020-01-23,"Cement Creek","3","2","2",7.3,0,34,2,23,21.5,1,-1,-1,-1,3,2,1,0,"w1920","Motorized",NA,"Thu","weekday"
"7524",2020-01-23,"Cement Creek","3","2","2",7.3,0,34,2,23,21.5,1,-1,-1,-1,3,2,1,0,"w1920","Hybrid",NA,"Thu","weekday"
"7525",2020-01-24,"Cement Creek","2","2","1",7.3,0,33,-1,23,22.1,2,1,-1,-1,1,2,1,0,"w1920","Non.motorized",NA,"Fri","weekday"
"7526",2020-01-24,"Cement Creek","2","2","1",7.3,0,33,-1,23,22.1,2,1,-1,-1,1,2,1,0,"w1920","Mechanized",NA,"Fri","weekday"
"7527",2020-01-24,"Cement Creek","2","2","1",7.3,0,33,-1,23,22.1,2,1,-1,-1,1,2,1,0,"w1920","Motorized",NA,"Fri","weekday"
"7528",2020-01-24,"Cement Creek","2","2","1",7.3,0,33,-1,23,22.1,2,1,-1,-1,1,2,1,0,"w1920","Hybrid",NA,"Fri","weekday"
"7529",2020-01-25,"Cement Creek","2","2","1",7.4,0.1,32,-1,25,23.1,-1,2,1,-1,-2,0,1,0,"w1920","Non.motorized",NA,"Sat","weekend"
"7530",2020-01-25,"Cement Creek","2","2","1",7.4,0.1,32,-1,25,23.1,-1,2,1,-1,-2,0,1,0,"w1920","Mechanized",NA,"Sat","weekend"
"7531",2020-01-25,"Cement Creek","2","2","1",7.4,0.1,32,-1,25,23.1,-1,2,1,-1,-2,0,1,0,"w1920","Motorized",NA,"Sat","weekend"
"7532",2020-01-25,"Cement Creek","2","2","1",7.4,0.1,32,-1,25,23.1,-1,2,1,-1,-2,0,1,0,"w1920","Hybrid",NA,"Sat","weekend"
"7533",2020-01-26,"Cement Creek","2","1","1",7.4,0,32,0,28,23.1,-1,-1,2,1,-1,-2,0,1,"w1920","Non.motorized",NA,"Sun","weekend"
"7534",2020-01-26,"Cement Creek","2","1","1",7.4,0,32,0,28,23.1,-1,-1,2,1,-1,-2,0,1,"w1920","Mechanized",NA,"Sun","weekend"
"7535",2020-01-26,"Cement Creek","2","1","1",7.4,0,32,0,28,23.1,-1,-1,2,1,-1,-2,0,1,"w1920","Motorized",NA,"Sun","weekend"
"7536",2020-01-26,"Cement Creek","2","1","1",7.4,0,32,0,28,23.1,-1,-1,2,1,-1,-2,0,1,"w1920","Hybrid",NA,"Sun","weekend"
"7537",2020-01-27,"Cement Creek","2","1","1",7.4,0,32,0,24,23.1,0,-1,-1,2,0,-1,-2,0,"w1920","Non.motorized",NA,"Mon","weekday"
"7538",2020-01-27,"Cement Creek","2","1","1",7.4,0,32,0,24,23.1,0,-1,-1,2,0,-1,-2,0,"w1920","Mechanized",NA,"Mon","weekday"
"7539",2020-01-27,"Cement Creek","2","1","1",7.4,0,32,0,24,23.1,0,-1,-1,2,0,-1,-2,0,"w1920","Motorized",NA,"Mon","weekday"
"7540",2020-01-27,"Cement Creek","2","1","1",7.4,0,32,0,24,23.1,0,-1,-1,2,0,-1,-2,0,"w1920","Hybrid",NA,"Mon","weekday"
"7541",2020-01-28,"Cement Creek","3","2","2",7.4,0,32,0,19,23.1,0,0,-1,-1,0,0,-1,-2,"w1920","Non.motorized",NA,"Tue","weekday"
"7542",2020-01-28,"Cement Creek","3","2","2",7.4,0,32,0,19,23.1,0,0,-1,-1,0,0,-1,-2,"w1920","Mechanized",NA,"Tue","weekday"
"7543",2020-01-28,"Cement Creek","3","2","2",7.4,0,32,0,19,23.1,0,0,-1,-1,0,0,-1,-2,"w1920","Motorized",NA,"Tue","weekday"
"7544",2020-01-28,"Cement Creek","3","2","2",7.4,0,32,0,19,23.1,0,0,-1,-1,0,0,-1,-2,"w1920","Hybrid",NA,"Tue","weekday"
"7545",2020-01-29,"Cement Creek","2","2","1",7.4,0,31,-1,20,23.9,0,0,0,-1,-1,-1,-1,-2,"w1920","Non.motorized",NA,"Wed","weekday"
"7546",2020-01-29,"Cement Creek","2","2","1",7.4,0,31,-1,20,23.9,0,0,0,-1,-1,-1,-1,-2,"w1920","Mechanized",NA,"Wed","weekday"
"7547",2020-01-29,"Cement Creek","2","2","1",7.4,0,31,-1,20,23.9,0,0,0,-1,-1,-1,-1,-2,"w1920","Motorized",NA,"Wed","weekday"
"7548",2020-01-29,"Cement Creek","2","2","1",7.4,0,31,-1,20,23.9,0,0,0,-1,-1,-1,-1,-2,"w1920","Hybrid",NA,"Wed","weekday"
"7549",2020-01-30,"Cement Creek","2","2","1",7.4,0,31,0,17,23.9,-1,0,0,0,-1,-1,-1,-1,"w1920","Non.motorized",9,"Thu","weekday"
"7550",2020-01-30,"Cement Creek","2","2","1",7.4,0,31,0,17,23.9,-1,0,0,0,-1,-1,-1,-1,"w1920","Mechanized",1,"Thu","weekday"
"7551",2020-01-30,"Cement Creek","2","2","1",7.4,0,31,0,17,23.9,-1,0,0,0,-1,-1,-1,-1,"w1920","Motorized",1,"Thu","weekday"
"7552",2020-01-30,"Cement Creek","2","2","1",7.4,0,31,0,17,23.9,-1,0,0,0,-1,-1,-1,-1,"w1920","Hybrid",NA,"Thu","weekday"
"7553",2020-01-31,"Cement Creek","2","1","1",7.4,0,31,0,20,23.9,0,-1,0,0,0,-1,-1,-1,"w1920","Non.motorized",16,"Fri","weekday"
"7554",2020-01-31,"Cement Creek","2","1","1",7.4,0,31,0,20,23.9,0,-1,0,0,0,-1,-1,-1,"w1920","Mechanized",1,"Fri","weekday"
"7555",2020-01-31,"Cement Creek","2","1","1",7.4,0,31,0,20,23.9,0,-1,0,0,0,-1,-1,-1,"w1920","Motorized",2,"Fri","weekday"
"7556",2020-01-31,"Cement Creek","2","1","1",7.4,0,31,0,20,23.9,0,-1,0,0,0,-1,-1,-1,"w1920","Hybrid",NA,"Fri","weekday"
"7557",2020-02-01,"Cement Creek","2","1","1",7.4,0,31,0,28,23.9,0,0,-1,0,0,0,-1,-1,"w1920","Non.motorized",29,"Sat","weekend"
"7558",2020-02-01,"Cement Creek","2","1","1",7.4,0,31,0,28,23.9,0,0,-1,0,0,0,-1,-1,"w1920","Mechanized",2,"Sat","weekend"
"7559",2020-02-01,"Cement Creek","2","1","1",7.4,0,31,0,28,23.9,0,0,-1,0,0,0,-1,-1,"w1920","Motorized",4,"Sat","weekend"
"7560",2020-02-01,"Cement Creek","2","1","1",7.4,0,31,0,28,23.9,0,0,-1,0,0,0,-1,-1,"w1920","Hybrid",NA,"Sat","weekend"
"7561",2020-02-02,"Cement Creek","1","1","1",7.4,0,31,0,33,23.9,0,0,0,-1,0,0,0,-1,"w1920","Non.motorized",30,"Sun","weekend"
"7562",2020-02-02,"Cement Creek","1","1","1",7.4,0,31,0,33,23.9,0,0,0,-1,0,0,0,-1,"w1920","Mechanized",3,"Sun","weekend"
"7563",2020-02-02,"Cement Creek","1","1","1",7.4,0,31,0,33,23.9,0,0,0,-1,0,0,0,-1,"w1920","Motorized",3,"Sun","weekend"
"7564",2020-02-02,"Cement Creek","1","1","1",7.4,0,31,0,33,23.9,0,0,0,-1,0,0,0,-1,"w1920","Hybrid",NA,"Sun","weekend"
"7565",2020-02-03,"Cement Creek","2","2","1",7.4,0,31,0,24,23.9,0,0,0,0,0,0,0,0,"w1920","Non.motorized",5,"Mon","weekday"
"7566",2020-02-03,"Cement Creek","2","2","1",7.4,0,31,0,24,23.9,0,0,0,0,0,0,0,0,"w1920","Mechanized",0,"Mon","weekday"
"7567",2020-02-03,"Cement Creek","2","2","1",7.4,0,31,0,24,23.9,0,0,0,0,0,0,0,0,"w1920","Motorized",1,"Mon","weekday"
"7568",2020-02-03,"Cement Creek","2","2","1",7.4,0,31,0,24,23.9,0,0,0,0,0,0,0,0,"w1920","Hybrid",NA,"Mon","weekday"
"7569",2020-02-04,"Cement Creek","2","2","2",7.4,0,33,2,5,22.4,0,0,0,0,2,2,2,2,"w1920","Non.motorized",3,"Tue","weekday"
"7570",2020-02-04,"Cement Creek","2","2","2",7.4,0,33,2,5,22.4,0,0,0,0,2,2,2,2,"w1920","Mechanized",0,"Tue","weekday"
"7571",2020-02-04,"Cement Creek","2","2","2",7.4,0,33,2,5,22.4,0,0,0,0,2,2,2,2,"w1920","Motorized",0,"Tue","weekday"
"7572",2020-02-04,"Cement Creek","2","2","2",7.4,0,33,2,5,22.4,0,0,0,0,2,2,2,2,"w1920","Hybrid",NA,"Tue","weekday"
"7573",2020-02-05,"Cement Creek","2","2","1",7.4,0,33,0,2,22.4,2,0,0,0,2,2,2,2,"w1920","Non.motorized",10,"Wed","weekday"
"7574",2020-02-05,"Cement Creek","2","2","1",7.4,0,33,0,2,22.4,2,0,0,0,2,2,2,2,"w1920","Mechanized",1,"Wed","weekday"
"7575",2020-02-05,"Cement Creek","2","2","1",7.4,0,33,0,2,22.4,2,0,0,0,2,2,2,2,"w1920","Motorized",3,"Wed","weekday"
"7576",2020-02-05,"Cement Creek","2","2","1",7.4,0,33,0,2,22.4,2,0,0,0,2,2,2,2,"w1920","Hybrid",NA,"Wed","weekday"
"7577",2020-02-06,"Cement Creek","2","2","1",7.5,0.1,32,-1,16,23.4,0,2,0,0,-1,1,1,1,"w1920","Non.motorized",2,"Thu","weekday"
"7578",2020-02-06,"Cement Creek","2","2","1",7.5,0.1,32,-1,16,23.4,0,2,0,0,-1,1,1,1,"w1920","Mechanized",0,"Thu","weekday"
"7579",2020-02-06,"Cement Creek","2","2","1",7.5,0.1,32,-1,16,23.4,0,2,0,0,-1,1,1,1,"w1920","Motorized",1,"Thu","weekday"
"7580",2020-02-06,"Cement Creek","2","2","1",7.5,0.1,32,-1,16,23.4,0,2,0,0,-1,1,1,1,"w1920","Hybrid",NA,"Thu","weekday"
"7581",2020-02-07,"Cement Creek","3","3","3",7.9,0.4,37,5,26,21.4,-1,0,2,0,4,4,6,6,"w1920","Non.motorized",NA,"Fri","weekday"
"7582",2020-02-07,"Cement Creek","3","3","3",7.9,0.4,37,5,26,21.4,-1,0,2,0,4,4,6,6,"w1920","Mechanized",NA,"Fri","weekday"
"7583",2020-02-07,"Cement Creek","3","3","3",7.9,0.4,37,5,26,21.4,-1,0,2,0,4,4,6,6,"w1920","Motorized",NA,"Fri","weekday"
"7584",2020-02-07,"Cement Creek","3","3","3",7.9,0.4,37,5,26,21.4,-1,0,2,0,4,4,6,6,"w1920","Hybrid",NA,"Fri","weekday"
"7585",2020-02-08,"Cement Creek","3","3","2",8.3,0.4,39,2,30,21.3,5,-1,0,2,7,6,6,8,"w1920","Non.motorized",5,"Sat","weekend"
"7586",2020-02-08,"Cement Creek","3","3","2",8.3,0.4,39,2,30,21.3,5,-1,0,2,7,6,6,8,"w1920","Mechanized",0,"Sat","weekend"
"7587",2020-02-08,"Cement Creek","3","3","2",8.3,0.4,39,2,30,21.3,5,-1,0,2,7,6,6,8,"w1920","Motorized",1,"Sat","weekend"
"7588",2020-02-08,"Cement Creek","3","3","2",8.3,0.4,39,2,30,21.3,5,-1,0,2,7,6,6,8,"w1920","Hybrid",NA,"Sat","weekend"
"7589",2020-02-09,"Cement Creek","3","2","2",8.4,0.1,38,-1,26,22.1,2,5,-1,0,1,6,5,5,"w1920","Non.motorized",38,"Sun","weekend"
"7590",2020-02-09,"Cement Creek","3","2","2",8.4,0.1,38,-1,26,22.1,2,5,-1,0,1,6,5,5,"w1920","Mechanized",4,"Sun","weekend"
"7591",2020-02-09,"Cement Creek","3","2","2",8.4,0.1,38,-1,26,22.1,2,5,-1,0,1,6,5,5,"w1920","Motorized",1,"Sun","weekend"
"7592",2020-02-09,"Cement Creek","3","2","2",8.4,0.1,38,-1,26,22.1,2,5,-1,0,1,6,5,5,"w1920","Hybrid",NA,"Sun","weekend"
"7593",2020-02-10,"Cement Creek","2","2","1",8.4,0,38,0,22,22.1,-1,2,5,-1,-1,1,6,5,"w1920","Non.motorized",20,"Mon","weekday"
"7594",2020-02-10,"Cement Creek","2","2","1",8.4,0,38,0,22,22.1,-1,2,5,-1,-1,1,6,5,"w1920","Mechanized",1,"Mon","weekday"
"7595",2020-02-10,"Cement Creek","2","2","1",8.4,0,38,0,22,22.1,-1,2,5,-1,-1,1,6,5,"w1920","Motorized",2,"Mon","weekday"
"7596",2020-02-10,"Cement Creek","2","2","1",8.4,0,38,0,22,22.1,-1,2,5,-1,-1,1,6,5,"w1920","Hybrid",NA,"Mon","weekday"
"7597",2020-02-11,"Cement Creek","2","2","2",8.5,0.1,40,2,16,21.2,0,-1,2,5,2,1,3,8,"w1920","Non.motorized",10,"Tue","weekday"
"7598",2020-02-11,"Cement Creek","2","2","2",8.5,0.1,40,2,16,21.2,0,-1,2,5,2,1,3,8,"w1920","Mechanized",2,"Tue","weekday"
"7599",2020-02-11,"Cement Creek","2","2","2",8.5,0.1,40,2,16,21.2,0,-1,2,5,2,1,3,8,"w1920","Motorized",6,"Tue","weekday"
"7600",2020-02-11,"Cement Creek","2","2","2",8.5,0.1,40,2,16,21.2,0,-1,2,5,2,1,3,8,"w1920","Hybrid",NA,"Tue","weekday"
"7601",2020-02-12,"Cement Creek","2","2","2",8.5,0,39,-1,15,21.8,2,0,-1,2,1,1,0,2,"w1920","Non.motorized",4,"Wed","weekday"
"7602",2020-02-12,"Cement Creek","2","2","2",8.5,0,39,-1,15,21.8,2,0,-1,2,1,1,0,2,"w1920","Mechanized",1,"Wed","weekday"
"7603",2020-02-12,"Cement Creek","2","2","2",8.5,0,39,-1,15,21.8,2,0,-1,2,1,1,0,2,"w1920","Motorized",3,"Wed","weekday"
"7604",2020-02-12,"Cement Creek","2","2","2",8.5,0,39,-1,15,21.8,2,0,-1,2,1,1,0,2,"w1920","Hybrid",NA,"Wed","weekday"
"7605",2020-02-13,"Cement Creek","2","2","1",8.5,0,39,0,18,21.8,-1,2,0,-1,-1,1,1,0,"w1920","Non.motorized",11,"Thu","weekday"
"7606",2020-02-13,"Cement Creek","2","2","1",8.5,0,39,0,18,21.8,-1,2,0,-1,-1,1,1,0,"w1920","Mechanized",0,"Thu","weekday"
"7607",2020-02-13,"Cement Creek","2","2","1",8.5,0,39,0,18,21.8,-1,2,0,-1,-1,1,1,0,"w1920","Motorized",3,"Thu","weekday"
"7608",2020-02-13,"Cement Creek","2","2","1",8.5,0,39,0,18,21.8,-1,2,0,-1,-1,1,1,0,"w1920","Hybrid",NA,"Thu","weekday"
"7609",2020-02-14,"Cement Creek","2","1","1",8.6,0.1,38,-1,24,22.6,0,-1,2,0,-1,-2,0,0,"w1920","Non.motorized",17,"Fri","weekday"
"7610",2020-02-14,"Cement Creek","2","1","1",8.6,0.1,38,-1,24,22.6,0,-1,2,0,-1,-2,0,0,"w1920","Mechanized",1,"Fri","weekday"
"7611",2020-02-14,"Cement Creek","2","1","1",8.6,0.1,38,-1,24,22.6,0,-1,2,0,-1,-2,0,0,"w1920","Motorized",0,"Fri","weekday"
"7612",2020-02-14,"Cement Creek","2","1","1",8.6,0.1,38,-1,24,22.6,0,-1,2,0,-1,-2,0,0,"w1920","Hybrid",NA,"Fri","weekday"
"7613",2020-02-15,"Cement Creek","1","1","1",8.6,0,38,0,26,22.6,-1,0,-1,2,-1,-1,-2,0,"w1920","Non.motorized",64,"Sat","weekend"
"7614",2020-02-15,"Cement Creek","1","1","1",8.6,0,38,0,26,22.6,-1,0,-1,2,-1,-1,-2,0,"w1920","Mechanized",3,"Sat","weekend"
"7615",2020-02-15,"Cement Creek","1","1","1",8.6,0,38,0,26,22.6,-1,0,-1,2,-1,-1,-2,0,"w1920","Motorized",9,"Sat","weekend"
"7616",2020-02-15,"Cement Creek","1","1","1",8.6,0,38,0,26,22.6,-1,0,-1,2,-1,-1,-2,0,"w1920","Hybrid",NA,"Sat","weekend"
"7617",2020-02-16,"Cement Creek","1","1","1",8.8,0.2,37,-1,26,23.8,0,-1,0,-1,-1,-2,-2,-3,"w1920","Non.motorized",33,"Sun","weekend"
"7618",2020-02-16,"Cement Creek","1","1","1",8.8,0.2,37,-1,26,23.8,0,-1,0,-1,-1,-2,-2,-3,"w1920","Mechanized",0,"Sun","weekend"
"7619",2020-02-16,"Cement Creek","1","1","1",8.8,0.2,37,-1,26,23.8,0,-1,0,-1,-1,-2,-2,-3,"w1920","Motorized",3,"Sun","weekend"
"7620",2020-02-16,"Cement Creek","1","1","1",8.8,0.2,37,-1,26,23.8,0,-1,0,-1,-1,-2,-2,-3,"w1920","Hybrid",NA,"Sun","weekend"
"7621",2020-02-17,"Cement Creek","2","1","1",9.2,0.4,43,6,25,21.4,-1,0,-1,0,5,5,4,4,"w1920","Non.motorized",13,"Mon","weekday"
"7622",2020-02-17,"Cement Creek","2","1","1",9.2,0.4,43,6,25,21.4,-1,0,-1,0,5,5,4,4,"w1920","Mechanized",0,"Mon","weekday"
"7623",2020-02-17,"Cement Creek","2","1","1",9.2,0.4,43,6,25,21.4,-1,0,-1,0,5,5,4,4,"w1920","Motorized",3,"Mon","weekday"
"7624",2020-02-17,"Cement Creek","2","1","1",9.2,0.4,43,6,25,21.4,-1,0,-1,0,5,5,4,4,"w1920","Hybrid",NA,"Mon","weekday"
"7625",2020-02-18,"Cement Creek","1","1","1",9.3,0.1,42,-1,18,22.1,6,-1,0,-1,5,4,4,3,"w1920","Non.motorized",15,"Tue","weekday"
"7626",2020-02-18,"Cement Creek","1","1","1",9.3,0.1,42,-1,18,22.1,6,-1,0,-1,5,4,4,3,"w1920","Mechanized",0,"Tue","weekday"
"7627",2020-02-18,"Cement Creek","1","1","1",9.3,0.1,42,-1,18,22.1,6,-1,0,-1,5,4,4,3,"w1920","Motorized",0,"Tue","weekday"
"7628",2020-02-18,"Cement Creek","1","1","1",9.3,0.1,42,-1,18,22.1,6,-1,0,-1,5,4,4,3,"w1920","Hybrid",NA,"Tue","weekday"
"7629",2020-02-19,"Cement Creek","1","1","1",9.3,0,41,-1,22,22.7,-1,6,-1,0,-2,4,3,3,"w1920","Non.motorized",12,"Wed","weekday"
"7630",2020-02-19,"Cement Creek","1","1","1",9.3,0,41,-1,22,22.7,-1,6,-1,0,-2,4,3,3,"w1920","Mechanized",0,"Wed","weekday"
"7631",2020-02-19,"Cement Creek","1","1","1",9.3,0,41,-1,22,22.7,-1,6,-1,0,-2,4,3,3,"w1920","Motorized",2,"Wed","weekday"
"7632",2020-02-19,"Cement Creek","1","1","1",9.3,0,41,-1,22,22.7,-1,6,-1,0,-2,4,3,3,"w1920","Hybrid",NA,"Wed","weekday"
"7633",2020-02-20,"Cement Creek","1","1","1",9.3,0,41,0,18,22.7,-1,-1,6,-1,-1,-2,4,3,"w1920","Non.motorized",21,"Thu","weekday"
"7634",2020-02-20,"Cement Creek","1","1","1",9.3,0,41,0,18,22.7,-1,-1,6,-1,-1,-2,4,3,"w1920","Mechanized",0,"Thu","weekday"
"7635",2020-02-20,"Cement Creek","1","1","1",9.3,0,41,0,18,22.7,-1,-1,6,-1,-1,-2,4,3,"w1920","Motorized",3,"Thu","weekday"
"7636",2020-02-20,"Cement Creek","1","1","1",9.3,0,41,0,18,22.7,-1,-1,6,-1,-1,-2,4,3,"w1920","Hybrid",NA,"Thu","weekday"
"7637",2020-02-21,"Cement Creek","1","1","1",9.3,0,40,-1,26,23.2,0,-1,-1,6,-1,-2,-3,3,"w1920","Non.motorized",19,"Fri","weekday"
"7638",2020-02-21,"Cement Creek","1","1","1",9.3,0,40,-1,26,23.2,0,-1,-1,6,-1,-2,-3,3,"w1920","Mechanized",2,"Fri","weekday"
"7639",2020-02-21,"Cement Creek","1","1","1",9.3,0,40,-1,26,23.2,0,-1,-1,6,-1,-2,-3,3,"w1920","Motorized",3,"Fri","weekday"
"7640",2020-02-21,"Cement Creek","1","1","1",9.3,0,40,-1,26,23.2,0,-1,-1,6,-1,-2,-3,3,"w1920","Hybrid",NA,"Fri","weekday"
"7641",2020-02-22,"Cement Creek","1","1","1",9.4,0.1,39,-1,32,24.1,-1,0,-1,-1,-2,-2,-3,-4,"w1920","Non.motorized",36,"Sat","weekend"
"7642",2020-02-22,"Cement Creek","1","1","1",9.4,0.1,39,-1,32,24.1,-1,0,-1,-1,-2,-2,-3,-4,"w1920","Mechanized",0,"Sat","weekend"
"7643",2020-02-22,"Cement Creek","1","1","1",9.4,0.1,39,-1,32,24.1,-1,0,-1,-1,-2,-2,-3,-4,"w1920","Motorized",1,"Sat","weekend"
"7644",2020-02-22,"Cement Creek","1","1","1",9.4,0.1,39,-1,32,24.1,-1,0,-1,-1,-2,-2,-3,-4,"w1920","Hybrid",NA,"Sat","weekend"
"7645",2020-02-23,"Cement Creek","2","2","2",9.5,0.1,40,1,27,23.8,-1,-1,0,-1,0,-1,-1,-2,"w1920","Non.motorized",26,"Sun","weekend"
"7646",2020-02-23,"Cement Creek","2","2","2",9.5,0.1,40,1,27,23.8,-1,-1,0,-1,0,-1,-1,-2,"w1920","Mechanized",0,"Sun","weekend"
"7647",2020-02-23,"Cement Creek","2","2","2",9.5,0.1,40,1,27,23.8,-1,-1,0,-1,0,-1,-1,-2,"w1920","Motorized",3,"Sun","weekend"
"7648",2020-02-23,"Cement Creek","2","2","2",9.5,0.1,40,1,27,23.8,-1,-1,0,-1,0,-1,-1,-2,"w1920","Hybrid",NA,"Sun","weekend"
"7649",2020-02-24,"Cement Creek","3","3","2",9.8,0.3,43,3,17,22.8,1,-1,-1,0,4,3,2,2,"w1920","Non.motorized",3,"Mon","weekday"
"7650",2020-02-24,"Cement Creek","3","3","2",9.8,0.3,43,3,17,22.8,1,-1,-1,0,4,3,2,2,"w1920","Mechanized",0,"Mon","weekday"
"7651",2020-02-24,"Cement Creek","3","3","2",9.8,0.3,43,3,17,22.8,1,-1,-1,0,4,3,2,2,"w1920","Motorized",4,"Mon","weekday"
"7652",2020-02-24,"Cement Creek","3","3","2",9.8,0.3,43,3,17,22.8,1,-1,-1,0,4,3,2,2,"w1920","Hybrid",NA,"Mon","weekday"
"7653",2020-02-25,"Cement Creek","2","2","1",9.8,0,43,0,8,22.8,3,1,-1,-1,3,4,3,2,"w1920","Non.motorized",12,"Tue","weekday"
"7654",2020-02-25,"Cement Creek","2","2","1",9.8,0,43,0,8,22.8,3,1,-1,-1,3,4,3,2,"w1920","Mechanized",1,"Tue","weekday"
"7655",2020-02-25,"Cement Creek","2","2","1",9.8,0,43,0,8,22.8,3,1,-1,-1,3,4,3,2,"w1920","Motorized",4,"Tue","weekday"
"7656",2020-02-25,"Cement Creek","2","2","1",9.8,0,43,0,8,22.8,3,1,-1,-1,3,4,3,2,"w1920","Hybrid",NA,"Tue","weekday"
"7657",2020-02-26,"Cement Creek","2","2","1",9.8,0,42,-1,15,23.3,0,3,1,-1,-1,2,3,2,"w1920","Non.motorized",6,"Wed","weekday"
"7658",2020-02-26,"Cement Creek","2","2","1",9.8,0,42,-1,15,23.3,0,3,1,-1,-1,2,3,2,"w1920","Mechanized",0,"Wed","weekday"
"7659",2020-02-26,"Cement Creek","2","2","1",9.8,0,42,-1,15,23.3,0,3,1,-1,-1,2,3,2,"w1920","Motorized",2,"Wed","weekday"
"7660",2020-02-26,"Cement Creek","2","2","1",9.8,0,42,-1,15,23.3,0,3,1,-1,-1,2,3,2,"w1920","Hybrid",NA,"Wed","weekday"
"7661",2020-02-27,"Cement Creek","2","2","1",9.9,0.1,41,-1,25,24.1,-1,0,3,1,-2,-2,1,2,"w1920","Non.motorized",20,"Thu","weekday"
"7662",2020-02-27,"Cement Creek","2","2","1",9.9,0.1,41,-1,25,24.1,-1,0,3,1,-2,-2,1,2,"w1920","Mechanized",6,"Thu","weekday"
"7663",2020-02-27,"Cement Creek","2","2","1",9.9,0.1,41,-1,25,24.1,-1,0,3,1,-2,-2,1,2,"w1920","Motorized",3,"Thu","weekday"
"7664",2020-02-27,"Cement Creek","2","2","1",9.9,0.1,41,-1,25,24.1,-1,0,3,1,-2,-2,1,2,"w1920","Hybrid",NA,"Thu","weekday"
"7665",2020-02-28,"Cement Creek","2","1","1",9.9,0,41,0,28,24.1,-1,-1,0,3,-1,-2,-2,1,"w1920","Non.motorized",9,"Fri","weekday"
"7666",2020-02-28,"Cement Creek","2","1","1",9.9,0,41,0,28,24.1,-1,-1,0,3,-1,-2,-2,1,"w1920","Mechanized",0,"Fri","weekday"
"7667",2020-02-28,"Cement Creek","2","1","1",9.9,0,41,0,28,24.1,-1,-1,0,3,-1,-2,-2,1,"w1920","Motorized",7,"Fri","weekday"
"7668",2020-02-28,"Cement Creek","2","1","1",9.9,0,41,0,28,24.1,-1,-1,0,3,-1,-2,-2,1,"w1920","Hybrid",NA,"Fri","weekday"
"7669",2020-02-29,"Cement Creek","1","1","1",9.9,0,40,-1,29,24.8,0,-1,-1,0,-1,-2,-3,-3,"w1920","Non.motorized",46,"Sat","weekend"
"7670",2020-02-29,"Cement Creek","1","1","1",9.9,0,40,-1,29,24.8,0,-1,-1,0,-1,-2,-3,-3,"w1920","Mechanized",2,"Sat","weekend"
"7671",2020-02-29,"Cement Creek","1","1","1",9.9,0,40,-1,29,24.8,0,-1,-1,0,-1,-2,-3,-3,"w1920","Motorized",2,"Sat","weekend"
"7672",2020-02-29,"Cement Creek","1","1","1",9.9,0,40,-1,29,24.8,0,-1,-1,0,-1,-2,-3,-3,"w1920","Hybrid",NA,"Sat","weekend"
"7673",2020-03-01,"Cement Creek","1","1","1",10,0.1,40,0,28,25,-1,0,-1,-1,-1,-1,-2,-3,"w1920","Non.motorized",28,"Sun","weekend"
"7674",2020-03-01,"Cement Creek","1","1","1",10,0.1,40,0,28,25,-1,0,-1,-1,-1,-1,-2,-3,"w1920","Mechanized",3,"Sun","weekend"
"7675",2020-03-01,"Cement Creek","1","1","1",10,0.1,40,0,28,25,-1,0,-1,-1,-1,-1,-2,-3,"w1920","Motorized",8,"Sun","weekend"
"7676",2020-03-01,"Cement Creek","1","1","1",10,0.1,40,0,28,25,-1,0,-1,-1,-1,-1,-2,-3,"w1920","Hybrid",NA,"Sun","weekend"
"7677",2020-03-02,"Cement Creek","2","2","1",10.4,0.4,45,5,25,23.1,0,-1,0,-1,5,4,4,3,"w1920","Non.motorized",0,"Mon","weekday"
"7678",2020-03-02,"Cement Creek","2","2","1",10.4,0.4,45,5,25,23.1,0,-1,0,-1,5,4,4,3,"w1920","Mechanized",0,"Mon","weekday"
"7679",2020-03-02,"Cement Creek","2","2","1",10.4,0.4,45,5,25,23.1,0,-1,0,-1,5,4,4,3,"w1920","Motorized",0,"Mon","weekday"
"7680",2020-03-02,"Cement Creek","2","2","1",10.4,0.4,45,5,25,23.1,0,-1,0,-1,5,4,4,3,"w1920","Hybrid",NA,"Mon","weekday"
"7681",2020-03-03,"Cement Creek","2","1","1",10.9,0.5,50,5,25,21.8,5,0,-1,0,10,10,9,9,"w1920","Non.motorized",19,"Tue","weekday"
"7682",2020-03-03,"Cement Creek","2","1","1",10.9,0.5,50,5,25,21.8,5,0,-1,0,10,10,9,9,"w1920","Mechanized",1,"Tue","weekday"
"7683",2020-03-03,"Cement Creek","2","1","1",10.9,0.5,50,5,25,21.8,5,0,-1,0,10,10,9,9,"w1920","Motorized",5,"Tue","weekday"
"7684",2020-03-03,"Cement Creek","2","1","1",10.9,0.5,50,5,25,21.8,5,0,-1,0,10,10,9,9,"w1920","Hybrid",NA,"Tue","weekday"
"7685",2020-03-04,"Cement Creek","2","1","1",10.9,0,48,-2,29,22.7,5,5,0,-1,3,8,8,7,"w1920","Non.motorized",18,"Wed","weekday"
"7686",2020-03-04,"Cement Creek","2","1","1",10.9,0,48,-2,29,22.7,5,5,0,-1,3,8,8,7,"w1920","Mechanized",0,"Wed","weekday"
"7687",2020-03-04,"Cement Creek","2","1","1",10.9,0,48,-2,29,22.7,5,5,0,-1,3,8,8,7,"w1920","Motorized",4,"Wed","weekday"
"7688",2020-03-04,"Cement Creek","2","1","1",10.9,0,48,-2,29,22.7,5,5,0,-1,3,8,8,7,"w1920","Hybrid",1,"Wed","weekday"
"7689",2020-03-05,"Cement Creek","2","1","1",10.9,0,46,-2,32,23.7,-2,5,5,0,-4,1,6,6,"w1920","Non.motorized",10,"Thu","weekday"
"7690",2020-03-05,"Cement Creek","2","1","1",10.9,0,46,-2,32,23.7,-2,5,5,0,-4,1,6,6,"w1920","Mechanized",0,"Thu","weekday"
"7691",2020-03-05,"Cement Creek","2","1","1",10.9,0,46,-2,32,23.7,-2,5,5,0,-4,1,6,6,"w1920","Motorized",5,"Thu","weekday"
"7692",2020-03-05,"Cement Creek","2","1","1",10.9,0,46,-2,32,23.7,-2,5,5,0,-4,1,6,6,"w1920","Hybrid",NA,"Thu","weekday"
"7693",2020-03-06,"Cement Creek","1","1","1",10.9,0,45,-1,34,24.2,-2,-2,5,5,-3,-5,0,5,"w1920","Non.motorized",7,"Fri","weekday"
"7694",2020-03-06,"Cement Creek","1","1","1",10.9,0,45,-1,34,24.2,-2,-2,5,5,-3,-5,0,5,"w1920","Mechanized",0,"Fri","weekday"
"7695",2020-03-06,"Cement Creek","1","1","1",10.9,0,45,-1,34,24.2,-2,-2,5,5,-3,-5,0,5,"w1920","Motorized",5,"Fri","weekday"
"7696",2020-03-06,"Cement Creek","1","1","1",10.9,0,45,-1,34,24.2,-2,-2,5,5,-3,-5,0,5,"w1920","Hybrid",1,"Fri","weekday"
"7697",2020-03-07,"Cement Creek","1","1","2",10.9,0,44,-1,35,24.8,-1,-2,-2,5,-2,-4,-6,-1,"w1920","Non.motorized",26,"Sat","weekend"
"7698",2020-03-07,"Cement Creek","1","1","2",10.9,0,44,-1,35,24.8,-1,-2,-2,5,-2,-4,-6,-1,"w1920","Mechanized",0,"Sat","weekend"
"7699",2020-03-07,"Cement Creek","1","1","2",10.9,0,44,-1,35,24.8,-1,-2,-2,5,-2,-4,-6,-1,"w1920","Motorized",3,"Sat","weekend"
"7700",2020-03-07,"Cement Creek","1","1","2",10.9,0,44,-1,35,24.8,-1,-2,-2,5,-2,-4,-6,-1,"w1920","Hybrid",1,"Sat","weekend"
"7701",2020-03-08,"Cement Creek","1","1","1",11,0.1,43,-1,33,25.6,-1,-1,-2,-2,-2,-3,-5,-7,"w1920","Non.motorized",22,"Sun","weekend"
"7702",2020-03-08,"Cement Creek","1","1","1",11,0.1,43,-1,33,25.6,-1,-1,-2,-2,-2,-3,-5,-7,"w1920","Mechanized",0,"Sun","weekend"
"7703",2020-03-08,"Cement Creek","1","1","1",11,0.1,43,-1,33,25.6,-1,-1,-2,-2,-2,-3,-5,-7,"w1920","Motorized",5,"Sun","weekend"
"7704",2020-03-08,"Cement Creek","1","1","1",11,0.1,43,-1,33,25.6,-1,-1,-2,-2,-2,-3,-5,-7,"w1920","Hybrid",NA,"Sun","weekend"
"7705",2020-03-09,"Cement Creek","1","1","1",11.1,0.1,42,-1,31,26.4,-1,-1,-1,-2,-2,-3,-4,-6,"w1920","Non.motorized",4,"Mon","weekday"
"7706",2020-03-09,"Cement Creek","1","1","1",11.1,0.1,42,-1,31,26.4,-1,-1,-1,-2,-2,-3,-4,-6,"w1920","Mechanized",1,"Mon","weekday"
"7707",2020-03-09,"Cement Creek","1","1","1",11.1,0.1,42,-1,31,26.4,-1,-1,-1,-2,-2,-3,-4,-6,"w1920","Motorized",1,"Mon","weekday"
"7708",2020-03-09,"Cement Creek","1","1","1",11.1,0.1,42,-1,31,26.4,-1,-1,-1,-2,-2,-3,-4,-6,"w1920","Hybrid",NA,"Mon","weekday"
"7709",2020-03-10,"Cement Creek","1","1","2",11.2,0.1,44,2,31,25.5,-1,-1,-1,-1,1,0,-1,-2,"w1920","Non.motorized",8,"Tue","weekday"
"7710",2020-03-10,"Cement Creek","1","1","2",11.2,0.1,44,2,31,25.5,-1,-1,-1,-1,1,0,-1,-2,"w1920","Mechanized",2,"Tue","weekday"
"7711",2020-03-10,"Cement Creek","1","1","2",11.2,0.1,44,2,31,25.5,-1,-1,-1,-1,1,0,-1,-2,"w1920","Motorized",2,"Tue","weekday"
"7712",2020-03-10,"Cement Creek","1","1","2",11.2,0.1,44,2,31,25.5,-1,-1,-1,-1,1,0,-1,-2,"w1920","Hybrid",NA,"Tue","weekday"
"7713",2020-03-11,"Cement Creek","2","2","1",11.2,0,44,0,32,25.5,2,-1,-1,-1,2,1,0,-1,"w1920","Non.motorized",2,"Wed","weekday"
"7714",2020-03-11,"Cement Creek","2","2","1",11.2,0,44,0,32,25.5,2,-1,-1,-1,2,1,0,-1,"w1920","Mechanized",1,"Wed","weekday"
"7715",2020-03-11,"Cement Creek","2","2","1",11.2,0,44,0,32,25.5,2,-1,-1,-1,2,1,0,-1,"w1920","Motorized",1,"Wed","weekday"
"7716",2020-03-11,"Cement Creek","2","2","1",11.2,0,44,0,32,25.5,2,-1,-1,-1,2,1,0,-1,"w1920","Hybrid",1,"Wed","weekday"
"7717",2020-03-12,"Cement Creek","2","2","2",11.4,0.2,42,-2,35,27.1,0,2,-1,-1,-2,0,-1,-2,"w1920","Non.motorized",6,"Thu","weekday"
"7718",2020-03-12,"Cement Creek","2","2","2",11.4,0.2,42,-2,35,27.1,0,2,-1,-1,-2,0,-1,-2,"w1920","Mechanized",0,"Thu","weekday"
"7719",2020-03-12,"Cement Creek","2","2","2",11.4,0.2,42,-2,35,27.1,0,2,-1,-1,-2,0,-1,-2,"w1920","Motorized",5,"Thu","weekday"
"7720",2020-03-12,"Cement Creek","2","2","2",11.4,0.2,42,-2,35,27.1,0,2,-1,-1,-2,0,-1,-2,"w1920","Hybrid",NA,"Thu","weekday"
"7721",2020-03-13,"Cement Creek","3","3","2",11.5,0.1,44,2,31,26.1,-2,0,2,-1,0,0,2,1,"w1920","Non.motorized",8,"Fri","weekday"
"7722",2020-03-13,"Cement Creek","3","3","2",11.5,0.1,44,2,31,26.1,-2,0,2,-1,0,0,2,1,"w1920","Mechanized",1,"Fri","weekday"
"7723",2020-03-13,"Cement Creek","3","3","2",11.5,0.1,44,2,31,26.1,-2,0,2,-1,0,0,2,1,"w1920","Motorized",4,"Fri","weekday"
"7724",2020-03-13,"Cement Creek","3","3","2",11.5,0.1,44,2,31,26.1,-2,0,2,-1,0,0,2,1,"w1920","Hybrid",NA,"Fri","weekday"
"7725",2020-03-14,"Cement Creek","3","3","3",11.7,0.2,44,0,31,26.6,2,-2,0,2,2,0,0,2,"w1920","Non.motorized",23,"Sat","weekend"
"7726",2020-03-14,"Cement Creek","3","3","3",11.7,0.2,44,0,31,26.6,2,-2,0,2,2,0,0,2,"w1920","Mechanized",5,"Sat","weekend"
"7727",2020-03-14,"Cement Creek","3","3","3",11.7,0.2,44,0,31,26.6,2,-2,0,2,2,0,0,2,"w1920","Motorized",6,"Sat","weekend"
"7728",2020-03-14,"Cement Creek","3","3","3",11.7,0.2,44,0,31,26.6,2,-2,0,2,2,0,0,2,"w1920","Hybrid",1,"Sat","weekend"
"7729",2020-03-15,"Cement Creek","2","2","2",11.7,0,45,1,33,26,0,2,-2,0,1,3,1,1,"w1920","Non.motorized",41,"Sun","weekend"
"7730",2020-03-15,"Cement Creek","2","2","2",11.7,0,45,1,33,26,0,2,-2,0,1,3,1,1,"w1920","Mechanized",2,"Sun","weekend"
"7731",2020-03-15,"Cement Creek","2","2","2",11.7,0,45,1,33,26,0,2,-2,0,1,3,1,1,"w1920","Motorized",14,"Sun","weekend"
"7732",2020-03-15,"Cement Creek","2","2","2",11.7,0,45,1,33,26,0,2,-2,0,1,3,1,1,"w1920","Hybrid",NA,"Sun","weekend"
"7733",2020-03-16,"Cement Creek","2","2","2",11.7,0,45,0,35,26,1,0,2,-2,1,1,3,1,"w1920","Non.motorized",35,"Mon","weekday"
"7734",2020-03-16,"Cement Creek","2","2","2",11.7,0,45,0,35,26,1,0,2,-2,1,1,3,1,"w1920","Mechanized",0,"Mon","weekday"
"7735",2020-03-16,"Cement Creek","2","2","2",11.7,0,45,0,35,26,1,0,2,-2,1,1,3,1,"w1920","Motorized",4,"Mon","weekday"
"7736",2020-03-16,"Cement Creek","2","2","2",11.7,0,45,0,35,26,1,0,2,-2,1,1,3,1,"w1920","Hybrid",NA,"Mon","weekday"
"7737",2020-03-17,"Cement Creek","2","2","2",11.7,0,44,-1,36,26.6,0,1,0,2,-1,0,0,2,"w1920","Non.motorized",27,"Tue","weekday"
"7738",2020-03-17,"Cement Creek","2","2","2",11.7,0,44,-1,36,26.6,0,1,0,2,-1,0,0,2,"w1920","Mechanized",1,"Tue","weekday"
"7739",2020-03-17,"Cement Creek","2","2","2",11.7,0,44,-1,36,26.6,0,1,0,2,-1,0,0,2,"w1920","Motorized",6,"Tue","weekday"
"7740",2020-03-17,"Cement Creek","2","2","2",11.7,0,44,-1,36,26.6,0,1,0,2,-1,0,0,2,"w1920","Hybrid",2,"Tue","weekday"
"7741",2020-03-18,"Cement Creek","2","2","2",11.7,0,43,-1,33,27.2,-1,0,1,0,-2,-2,-1,-1,"w1920","Non.motorized",6,"Wed","weekday"
"7742",2020-03-18,"Cement Creek","2","2","2",11.7,0,43,-1,33,27.2,-1,0,1,0,-2,-2,-1,-1,"w1920","Mechanized",1,"Wed","weekday"
"7743",2020-03-18,"Cement Creek","2","2","2",11.7,0,43,-1,33,27.2,-1,0,1,0,-2,-2,-1,-1,"w1920","Motorized",0,"Wed","weekday"
"7744",2020-03-18,"Cement Creek","2","2","2",11.7,0,43,-1,33,27.2,-1,0,1,0,-2,-2,-1,-1,"w1920","Hybrid",NA,"Wed","weekday"
"7745",2020-03-19,"Cement Creek","3","3","3",11.8,0.1,43,0,27,27.4,-1,-1,0,1,-1,-2,-2,-1,"w1920","Non.motorized",2,"Thu","weekday"
"7746",2020-03-19,"Cement Creek","3","3","3",11.8,0.1,43,0,27,27.4,-1,-1,0,1,-1,-2,-2,-1,"w1920","Mechanized",0,"Thu","weekday"
"7747",2020-03-19,"Cement Creek","3","3","3",11.8,0.1,43,0,27,27.4,-1,-1,0,1,-1,-2,-2,-1,"w1920","Motorized",0,"Thu","weekday"
"7748",2020-03-19,"Cement Creek","3","3","3",11.8,0.1,43,0,27,27.4,-1,-1,0,1,-1,-2,-2,-1,"w1920","Hybrid",NA,"Thu","weekday"
"7749",2020-03-20,"Cement Creek","3","3","2",12.7,0.9,52,9,26,24.4,0,-1,-1,0,9,8,7,7,"w1920","Non.motorized",17,"Fri","weekday"
"7750",2020-03-20,"Cement Creek","3","3","2",12.7,0.9,52,9,26,24.4,0,-1,-1,0,9,8,7,7,"w1920","Mechanized",0,"Fri","weekday"
"7751",2020-03-20,"Cement Creek","3","3","2",12.7,0.9,52,9,26,24.4,0,-1,-1,0,9,8,7,7,"w1920","Motorized",4,"Fri","weekday"
"7752",2020-03-20,"Cement Creek","3","3","2",12.7,0.9,52,9,26,24.4,0,-1,-1,0,9,8,7,7,"w1920","Hybrid",2,"Fri","weekday"
"7753",2020-03-21,"Cement Creek","3","3","2",12.8,0.1,54,2,26,23.7,9,0,-1,-1,11,11,10,9,"w1920","Non.motorized",32,"Sat","weekend"
"7754",2020-03-21,"Cement Creek","3","3","2",12.8,0.1,54,2,26,23.7,9,0,-1,-1,11,11,10,9,"w1920","Mechanized",3,"Sat","weekend"
"7755",2020-03-21,"Cement Creek","3","3","2",12.8,0.1,54,2,26,23.7,9,0,-1,-1,11,11,10,9,"w1920","Motorized",3,"Sat","weekend"
"7756",2020-03-21,"Cement Creek","3","3","2",12.8,0.1,54,2,26,23.7,9,0,-1,-1,11,11,10,9,"w1920","Hybrid",NA,"Sat","weekend"
"7757",2020-03-22,"Cement Creek","2","2","2",13,0.2,53,-1,28,24.5,2,9,0,-1,1,10,10,9,"w1920","Non.motorized",8,"Sun","weekend"
"7758",2020-03-22,"Cement Creek","2","2","2",13,0.2,53,-1,28,24.5,2,9,0,-1,1,10,10,9,"w1920","Mechanized",0,"Sun","weekend"
"7759",2020-03-22,"Cement Creek","2","2","2",13,0.2,53,-1,28,24.5,2,9,0,-1,1,10,10,9,"w1920","Motorized",2,"Sun","weekend"
"7760",2020-03-22,"Cement Creek","2","2","2",13,0.2,53,-1,28,24.5,2,9,0,-1,1,10,10,9,"w1920","Hybrid",NA,"Sun","weekend"
"7761",2020-03-23,"Cement Creek","2","2","2",13,0,53,0,28,24.5,-1,2,9,0,-1,1,10,10,"w1920","Non.motorized",12,"Mon","weekday"
"7762",2020-03-23,"Cement Creek","2","2","2",13,0,53,0,28,24.5,-1,2,9,0,-1,1,10,10,"w1920","Mechanized",2,"Mon","weekday"
"7763",2020-03-23,"Cement Creek","2","2","2",13,0,53,0,28,24.5,-1,2,9,0,-1,1,10,10,"w1920","Motorized",3,"Mon","weekday"
"7764",2020-03-23,"Cement Creek","2","2","2",13,0,53,0,28,24.5,-1,2,9,0,-1,1,10,10,"w1920","Hybrid",1,"Mon","weekday"
"7765",2020-03-24,"Cement Creek","2","2","2",13.2,0.2,53,0,32,24.9,0,-1,2,9,0,-1,1,10,"w1920","Non.motorized",20,"Tue","weekday"
"7766",2020-03-24,"Cement Creek","2","2","2",13.2,0.2,53,0,32,24.9,0,-1,2,9,0,-1,1,10,"w1920","Mechanized",1,"Tue","weekday"
"7767",2020-03-24,"Cement Creek","2","2","2",13.2,0.2,53,0,32,24.9,0,-1,2,9,0,-1,1,10,"w1920","Motorized",5,"Tue","weekday"
"7768",2020-03-24,"Cement Creek","2","2","2",13.2,0.2,53,0,32,24.9,0,-1,2,9,0,-1,1,10,"w1920","Hybrid",1,"Tue","weekday"
"7769",2020-03-25,"Cement Creek","2","2","2",13.3,0.1,51,-2,34,26.1,0,0,-1,2,-2,-2,-3,-1,"w1920","Non.motorized",20,"Wed","weekday"
"7770",2020-03-25,"Cement Creek","2","2","2",13.3,0.1,51,-2,34,26.1,0,0,-1,2,-2,-2,-3,-1,"w1920","Mechanized",2,"Wed","weekday"
"7771",2020-03-25,"Cement Creek","2","2","2",13.3,0.1,51,-2,34,26.1,0,0,-1,2,-2,-2,-3,-1,"w1920","Motorized",2,"Wed","weekday"
"7772",2020-03-25,"Cement Creek","2","2","2",13.3,0.1,51,-2,34,26.1,0,0,-1,2,-2,-2,-3,-1,"w1920","Hybrid",NA,"Wed","weekday"
"7773",2020-03-26,"Cement Creek","2","2","2",13.3,0,50,-1,36,26.6,-2,0,0,-1,-3,-3,-3,-4,"w1920","Non.motorized",23,"Thu","weekday"
"7774",2020-03-26,"Cement Creek","2","2","2",13.3,0,50,-1,36,26.6,-2,0,0,-1,-3,-3,-3,-4,"w1920","Mechanized",0,"Thu","weekday"
"7775",2020-03-26,"Cement Creek","2","2","2",13.3,0,50,-1,36,26.6,-2,0,0,-1,-3,-3,-3,-4,"w1920","Motorized",2,"Thu","weekday"
"7776",2020-03-26,"Cement Creek","2","2","2",13.3,0,50,-1,36,26.6,-2,0,0,-1,-3,-3,-3,-4,"w1920","Hybrid",NA,"Thu","weekday"
"7777",2020-03-26,"Cement Creek","3","3","2",13.3,0,50,-1,36,26.6,-2,0,0,-1,-3,-3,-3,-4,"w1920","Non.motorized",23,"Thu","weekday"
"7778",2020-03-26,"Cement Creek","3","3","2",13.3,0,50,-1,36,26.6,-2,0,0,-1,-3,-3,-3,-4,"w1920","Mechanized",0,"Thu","weekday"
"7779",2020-03-26,"Cement Creek","3","3","2",13.3,0,50,-1,36,26.6,-2,0,0,-1,-3,-3,-3,-4,"w1920","Motorized",2,"Thu","weekday"
"7780",2020-03-26,"Cement Creek","3","3","2",13.3,0,50,-1,36,26.6,-2,0,0,-1,-3,-3,-3,-4,"w1920","Hybrid",NA,"Thu","weekday"
"7781",2020-03-27,"Cement Creek","3","3","2",13.3,0,50,0,23,26.6,-1,-2,0,0,-1,-3,-3,-3,"w1920","Non.motorized",8,"Fri","weekday"
"7782",2020-03-27,"Cement Creek","3","3","2",13.3,0,50,0,23,26.6,-1,-2,0,0,-1,-3,-3,-3,"w1920","Mechanized",0,"Fri","weekday"
"7783",2020-03-27,"Cement Creek","3","3","2",13.3,0,50,0,23,26.6,-1,-2,0,0,-1,-3,-3,-3,"w1920","Motorized",2,"Fri","weekday"
"7784",2020-03-27,"Cement Creek","3","3","2",13.3,0,50,0,23,26.6,-1,-2,0,0,-1,-3,-3,-3,"w1920","Hybrid",NA,"Fri","weekday"
"7785",2020-03-28,"Cement Creek","3","3","3",13.3,0,50,0,18,26.6,0,-1,-2,0,0,-1,-3,-3,"w1920","Non.motorized",28,"Sat","weekend"
"7786",2020-03-28,"Cement Creek","3","3","3",13.3,0,50,0,18,26.6,0,-1,-2,0,0,-1,-3,-3,"w1920","Mechanized",3,"Sat","weekend"
"7787",2020-03-28,"Cement Creek","3","3","3",13.3,0,50,0,18,26.6,0,-1,-2,0,0,-1,-3,-3,"w1920","Motorized",2,"Sat","weekend"
"7788",2020-03-28,"Cement Creek","3","3","3",13.3,0,50,0,18,26.6,0,-1,-2,0,0,-1,-3,-3,"w1920","Hybrid",1,"Sat","weekend"
"7789",2020-03-29,"Cement Creek","2","2","2",13.3,0,49,-1,24,27.1,0,0,-1,-2,-1,-1,-2,-4,"w1920","Non.motorized",25,"Sun","weekend"
"7790",2020-03-29,"Cement Creek","2","2","2",13.3,0,49,-1,24,27.1,0,0,-1,-2,-1,-1,-2,-4,"w1920","Mechanized",0,"Sun","weekend"
"7791",2020-03-29,"Cement Creek","2","2","2",13.3,0,49,-1,24,27.1,0,0,-1,-2,-1,-1,-2,-4,"w1920","Motorized",3,"Sun","weekend"
"7792",2020-03-29,"Cement Creek","2","2","2",13.3,0,49,-1,24,27.1,0,0,-1,-2,-1,-1,-2,-4,"w1920","Hybrid",NA,"Sun","weekend"
"7793",2020-03-30,"Cement Creek","2","2","2",13.4,0.1,49,0,29,27.3,-1,0,0,-1,-1,-1,-1,-2,"w1920","Non.motorized",13,"Mon","weekday"
"7794",2020-03-30,"Cement Creek","2","2","2",13.4,0.1,49,0,29,27.3,-1,0,0,-1,-1,-1,-1,-2,"w1920","Mechanized",1,"Mon","weekday"
"7795",2020-03-30,"Cement Creek","2","2","2",13.4,0.1,49,0,29,27.3,-1,0,0,-1,-1,-1,-1,-2,"w1920","Motorized",6,"Mon","weekday"
"7796",2020-03-30,"Cement Creek","2","2","2",13.4,0.1,49,0,29,27.3,-1,0,0,-1,-1,-1,-1,-2,"w1920","Hybrid",1,"Mon","weekday"
"7797",2020-03-31,"Cement Creek","2","2","2",13.6,0.2,51,2,35,26.7,0,-1,0,0,2,1,1,1,"w1920","Non.motorized",12,"Tue","weekday"
"7798",2020-03-31,"Cement Creek","2","2","2",13.6,0.2,51,2,35,26.7,0,-1,0,0,2,1,1,1,"w1920","Mechanized",0,"Tue","weekday"
"7799",2020-03-31,"Cement Creek","2","2","2",13.6,0.2,51,2,35,26.7,0,-1,0,0,2,1,1,1,"w1920","Motorized",2,"Tue","weekday"
"7800",2020-03-31,"Cement Creek","2","2","2",13.6,0.2,51,2,35,26.7,0,-1,0,0,2,1,1,1,"w1920","Hybrid",1,"Tue","weekday"
"7801",2020-04-01,"Cement Creek","2","2","2",13.6,0,47,-4,39,28.9,2,0,-1,0,-2,-2,-3,-3,"w1920","Non.motorized",6,"Wed","weekday"
"7802",2020-04-01,"Cement Creek","2","2","2",13.6,0,47,-4,39,28.9,2,0,-1,0,-2,-2,-3,-3,"w1920","Mechanized",0,"Wed","weekday"
"7803",2020-04-01,"Cement Creek","2","2","2",13.6,0,47,-4,39,28.9,2,0,-1,0,-2,-2,-3,-3,"w1920","Motorized",6,"Wed","weekday"
"7804",2020-04-01,"Cement Creek","2","2","2",13.6,0,47,-4,39,28.9,2,0,-1,0,-2,-2,-3,-3,"w1920","Hybrid",NA,"Wed","weekday"
"7805",2020-04-02,"Cement Creek","2","2","2",13.6,0,46,-1,31,29.6,-4,2,0,-1,-5,-3,-3,-4,"w1920","Non.motorized",5,"Thu","weekday"
"7806",2020-04-02,"Cement Creek","2","2","2",13.6,0,46,-1,31,29.6,-4,2,0,-1,-5,-3,-3,-4,"w1920","Mechanized",1,"Thu","weekday"
"7807",2020-04-02,"Cement Creek","2","2","2",13.6,0,46,-1,31,29.6,-4,2,0,-1,-5,-3,-3,-4,"w1920","Motorized",1,"Thu","weekday"
"7808",2020-04-02,"Cement Creek","2","2","2",13.6,0,46,-1,31,29.6,-4,2,0,-1,-5,-3,-3,-4,"w1920","Hybrid",1,"Thu","weekday"
"7809",2020-04-03,"Cement Creek","2","2","2",13.6,0,46,0,28,29.6,-1,-4,2,0,-1,-5,-3,-3,"w1920","Non.motorized",27,"Fri","weekday"
"7810",2020-04-03,"Cement Creek","2","2","2",13.6,0,46,0,28,29.6,-1,-4,2,0,-1,-5,-3,-3,"w1920","Mechanized",0,"Fri","weekday"
"7811",2020-04-03,"Cement Creek","2","2","2",13.6,0,46,0,28,29.6,-1,-4,2,0,-1,-5,-3,-3,"w1920","Motorized",1,"Fri","weekday"
"7812",2020-04-03,"Cement Creek","2","2","2",13.6,0,46,0,28,29.6,-1,-4,2,0,-1,-5,-3,-3,"w1920","Hybrid",NA,"Fri","weekday"
"7813",2020-04-04,"Cement Creek","2","2","2",13.6,0,45,-1,33,30.2,0,-1,-4,2,-1,-2,-6,-4,"w1920","Non.motorized",21,"Sat","weekend"
"7814",2020-04-04,"Cement Creek","2","2","2",13.6,0,45,-1,33,30.2,0,-1,-4,2,-1,-2,-6,-4,"w1920","Mechanized",0,"Sat","weekend"
"7815",2020-04-04,"Cement Creek","2","2","2",13.6,0,45,-1,33,30.2,0,-1,-4,2,-1,-2,-6,-4,"w1920","Motorized",6,"Sat","weekend"
"7816",2020-04-04,"Cement Creek","2","2","2",13.6,0,45,-1,33,30.2,0,-1,-4,2,-1,-2,-6,-4,"w1920","Hybrid",1,"Sat","weekend"
"7817",2020-04-05,"Cement Creek","2","2","3",13.6,0,45,0,38,30.2,-1,0,-1,-4,-1,-1,-2,-6,"w1920","Non.motorized",21,"Sun","weekend"
"7818",2020-04-05,"Cement Creek","2","2","3",13.6,0,45,0,38,30.2,-1,0,-1,-4,-1,-1,-2,-6,"w1920","Mechanized",1,"Sun","weekend"
"7819",2020-04-05,"Cement Creek","2","2","3",13.6,0,45,0,38,30.2,-1,0,-1,-4,-1,-1,-2,-6,"w1920","Motorized",4,"Sun","weekend"
"7820",2020-04-05,"Cement Creek","2","2","3",13.6,0,45,0,38,30.2,-1,0,-1,-4,-1,-1,-2,-6,"w1920","Hybrid",NA,"Sun","weekend"
"7821",2020-04-06,"Cement Creek","2","2","3",13.6,0,44,-1,40,30.9,0,-1,0,-1,-1,-2,-2,-3,"w1920","Non.motorized",11,"Mon","weekday"
"7822",2020-04-06,"Cement Creek","2","2","3",13.6,0,44,-1,40,30.9,0,-1,0,-1,-1,-2,-2,-3,"w1920","Mechanized",1,"Mon","weekday"
"7823",2020-04-06,"Cement Creek","2","2","3",13.6,0,44,-1,40,30.9,0,-1,0,-1,-1,-2,-2,-3,"w1920","Motorized",0,"Mon","weekday"
"7824",2020-04-06,"Cement Creek","2","2","3",13.6,0,44,-1,40,30.9,0,-1,0,-1,-1,-2,-2,-3,"w1920","Hybrid",NA,"Mon","weekday"
"7825",2020-04-07,"Cement Creek","2","2","3",13.4,-0.2,43,-1,39,31.2,-1,0,-1,0,-2,-2,-3,-3,"w1920","Non.motorized",12,"Tue","weekday"
"7826",2020-04-07,"Cement Creek","2","2","3",13.4,-0.2,43,-1,39,31.2,-1,0,-1,0,-2,-2,-3,-3,"w1920","Mechanized",1,"Tue","weekday"
"7827",2020-04-07,"Cement Creek","2","2","3",13.4,-0.2,43,-1,39,31.2,-1,0,-1,0,-2,-2,-3,-3,"w1920","Motorized",4,"Tue","weekday"
"7828",2020-04-07,"Cement Creek","2","2","3",13.4,-0.2,43,-1,39,31.2,-1,0,-1,0,-2,-2,-3,-3,"w1920","Hybrid",1,"Tue","weekday"
"7829",2020-04-08,"Cement Creek","2","3","3",13.3,-0.1,42,-1,40,31.7,-1,-1,0,-1,-2,-3,-3,-4,"w1920","Non.motorized",17,"Wed","weekday"
"7830",2020-04-08,"Cement Creek","2","3","3",13.3,-0.1,42,-1,40,31.7,-1,-1,0,-1,-2,-3,-3,-4,"w1920","Mechanized",0,"Wed","weekday"
"7831",2020-04-08,"Cement Creek","2","3","3",13.3,-0.1,42,-1,40,31.7,-1,-1,0,-1,-2,-3,-3,-4,"w1920","Motorized",0,"Wed","weekday"
"7832",2020-04-08,"Cement Creek","2","3","3",13.3,-0.1,42,-1,40,31.7,-1,-1,0,-1,-2,-3,-3,-4,"w1920","Hybrid",NA,"Wed","weekday"
"7833",2020-04-09,"Cement Creek","2","3","3",13.1,-0.2,40,-2,42,32.8,-1,-1,-1,0,-3,-4,-5,-5,"w1920","Non.motorized",9,"Thu","weekday"
"7834",2020-04-09,"Cement Creek","2","3","3",13.1,-0.2,40,-2,42,32.8,-1,-1,-1,0,-3,-4,-5,-5,"w1920","Mechanized",0,"Thu","weekday"
"7835",2020-04-09,"Cement Creek","2","3","3",13.1,-0.2,40,-2,42,32.8,-1,-1,-1,0,-3,-4,-5,-5,"w1920","Motorized",1,"Thu","weekday"
"7836",2020-04-09,"Cement Creek","2","3","3",13.1,-0.2,40,-2,42,32.8,-1,-1,-1,0,-3,-4,-5,-5,"w1920","Hybrid",1,"Thu","weekday"
"7837",2020-04-10,"Cement Creek","3","3","3",12.9,-0.2,39,-1,38,33.1,-2,-1,-1,-1,-3,-4,-5,-6,"w1920","Non.motorized",6,"Fri","weekday"
"7838",2020-04-10,"Cement Creek","3","3","3",12.9,-0.2,39,-1,38,33.1,-2,-1,-1,-1,-3,-4,-5,-6,"w1920","Mechanized",1,"Fri","weekday"
"7839",2020-04-10,"Cement Creek","3","3","3",12.9,-0.2,39,-1,38,33.1,-2,-1,-1,-1,-3,-4,-5,-6,"w1920","Motorized",0,"Fri","weekday"
"7840",2020-04-10,"Cement Creek","3","3","3",12.9,-0.2,39,-1,38,33.1,-2,-1,-1,-1,-3,-4,-5,-6,"w1920","Hybrid",NA,"Fri","weekday"
"7841",2020-04-11,"Cement Creek","2","3","3",12.9,0,39,0,36,33.1,-1,-2,-1,-1,-1,-3,-4,-5,"w1920","Non.motorized",17,"Sat","weekend"
"7842",2020-04-11,"Cement Creek","2","3","3",12.9,0,39,0,36,33.1,-1,-2,-1,-1,-1,-3,-4,-5,"w1920","Mechanized",1,"Sat","weekend"
"7843",2020-04-11,"Cement Creek","2","3","3",12.9,0,39,0,36,33.1,-1,-2,-1,-1,-1,-3,-4,-5,"w1920","Motorized",2,"Sat","weekend"
"7844",2020-04-11,"Cement Creek","2","3","3",12.9,0,39,0,36,33.1,-1,-2,-1,-1,-1,-3,-4,-5,"w1920","Hybrid",NA,"Sat","weekend"
"7845",2020-04-12,"Cement Creek","2","2","2",12.8,-0.1,38,-1,29,33.7,0,-1,-2,-1,-1,-2,-4,-5,"w1920","Non.motorized",16,"Sun","weekend"
"7846",2020-04-12,"Cement Creek","2","2","2",12.8,-0.1,38,-1,29,33.7,0,-1,-2,-1,-1,-2,-4,-5,"w1920","Mechanized",0,"Sun","weekend"
"7847",2020-04-12,"Cement Creek","2","2","2",12.8,-0.1,38,-1,29,33.7,0,-1,-2,-1,-1,-2,-4,-5,"w1920","Motorized",3,"Sun","weekend"
"7848",2020-04-12,"Cement Creek","2","2","2",12.8,-0.1,38,-1,29,33.7,0,-1,-2,-1,-1,-2,-4,-5,"w1920","Hybrid",NA,"Sun","weekend"
"7849",2020-04-13,"Cement Creek",NA,NA,NA,12.9,0.1,39,1,20,33.1,-1,0,-1,-2,0,0,-1,-3,"w1920","Non.motorized",2,"Mon","weekday"
"7850",2020-04-13,"Cement Creek",NA,NA,NA,12.9,0.1,39,1,20,33.1,-1,0,-1,-2,0,0,-1,-3,"w1920","Mechanized",0,"Mon","weekday"
"7851",2020-04-13,"Cement Creek",NA,NA,NA,12.9,0.1,39,1,20,33.1,-1,0,-1,-2,0,0,-1,-3,"w1920","Motorized",0,"Mon","weekday"
"7852",2020-04-13,"Cement Creek",NA,NA,NA,12.9,0.1,39,1,20,33.1,-1,0,-1,-2,0,0,-1,-3,"w1920","Hybrid",NA,"Mon","weekday"
"7853",2020-04-14,"Cement Creek","2","2","2",13,0.1,39,0,18,33.3,1,-1,0,-1,1,0,0,-1,"w1920","Non.motorized",4,"Tue","weekday"
"7854",2020-04-14,"Cement Creek","2","2","2",13,0.1,39,0,18,33.3,1,-1,0,-1,1,0,0,-1,"w1920","Mechanized",0,"Tue","weekday"
"7855",2020-04-14,"Cement Creek","2","2","2",13,0.1,39,0,18,33.3,1,-1,0,-1,1,0,0,-1,"w1920","Motorized",0,"Tue","weekday"
"7856",2020-04-14,"Cement Creek","2","2","2",13,0.1,39,0,18,33.3,1,-1,0,-1,1,0,0,-1,"w1920","Hybrid",NA,"Tue","weekday"
"7857",2020-04-15,"Cement Creek",NA,NA,NA,13.2,0.2,39,0,28,33.8,0,1,-1,0,0,1,0,0,"w1920","Non.motorized",6,"Wed","weekday"
"7858",2020-04-15,"Cement Creek",NA,NA,NA,13.2,0.2,39,0,28,33.8,0,1,-1,0,0,1,0,0,"w1920","Mechanized",0,"Wed","weekday"
"7859",2020-04-15,"Cement Creek",NA,NA,NA,13.2,0.2,39,0,28,33.8,0,1,-1,0,0,1,0,0,"w1920","Motorized",1,"Wed","weekday"
"7860",2020-04-15,"Cement Creek",NA,NA,NA,13.2,0.2,39,0,28,33.8,0,1,-1,0,0,1,0,0,"w1920","Hybrid",NA,"Wed","weekday"
"7861",2019-12-06,"Gothic Rd","2","2","1",2.9,0.4,19,5,24,15.3,0,0,0,0,5,5,5,5,"w1920","Non.motorized",14,"Fri","weekday"
"7862",2019-12-06,"Gothic Rd","2","2","1",2.9,0.4,19,5,24,15.3,0,0,0,0,5,5,5,5,"w1920","Mechanized",2,"Fri","weekday"
"7863",2019-12-06,"Gothic Rd","2","2","1",2.9,0.4,19,5,24,15.3,0,0,0,0,5,5,5,5,"w1920","Motorized",2,"Fri","weekday"
"7864",2019-12-06,"Gothic Rd","2","2","1",2.9,0.4,19,5,24,15.3,0,0,0,0,5,5,5,5,"w1920","Hybrid",0,"Fri","weekday"
"7865",2019-12-07,"Gothic Rd","2","2","1",3,0.1,18,-1,29,16.7,5,0,0,0,4,4,4,4,"w1920","Non.motorized",NA,"Sat","weekend"
"7866",2019-12-07,"Gothic Rd","2","2","1",3,0.1,18,-1,29,16.7,5,0,0,0,4,4,4,4,"w1920","Mechanized",NA,"Sat","weekend"
"7867",2019-12-07,"Gothic Rd","2","2","1",3,0.1,18,-1,29,16.7,5,0,0,0,4,4,4,4,"w1920","Motorized",NA,"Sat","weekend"
"7868",2019-12-07,"Gothic Rd","2","2","1",3,0.1,18,-1,29,16.7,5,0,0,0,4,4,4,4,"w1920","Hybrid",NA,"Sat","weekend"
"7869",2019-12-08,"Gothic Rd","2","2","1",3,0,17,-1,28,17.6,-1,5,0,0,-2,3,3,3,"w1920","Non.motorized",12,"Sun","weekend"
"7870",2019-12-08,"Gothic Rd","2","2","1",3,0,17,-1,28,17.6,-1,5,0,0,-2,3,3,3,"w1920","Mechanized",0,"Sun","weekend"
"7871",2019-12-08,"Gothic Rd","2","2","1",3,0,17,-1,28,17.6,-1,5,0,0,-2,3,3,3,"w1920","Motorized",2,"Sun","weekend"
"7872",2019-12-08,"Gothic Rd","2","2","1",3,0,17,-1,28,17.6,-1,5,0,0,-2,3,3,3,"w1920","Hybrid",0,"Sun","weekend"
"7873",2019-12-09,"Gothic Rd","3","3","2",3.4,0.4,22,5,21,15.5,-1,-1,5,0,4,3,8,8,"w1920","Non.motorized",3,"Mon","weekday"
"7874",2019-12-09,"Gothic Rd","3","3","2",3.4,0.4,22,5,21,15.5,-1,-1,5,0,4,3,8,8,"w1920","Mechanized",0,"Mon","weekday"
"7875",2019-12-09,"Gothic Rd","3","3","2",3.4,0.4,22,5,21,15.5,-1,-1,5,0,4,3,8,8,"w1920","Motorized",3,"Mon","weekday"
"7876",2019-12-09,"Gothic Rd","3","3","2",3.4,0.4,22,5,21,15.5,-1,-1,5,0,4,3,8,8,"w1920","Hybrid",0,"Mon","weekday"
"7877",2020-12-10,"Gothic Rd",NA,NA,NA,NA,NA,NA,NA,NA,NA,NA,NA,NA,NA,NA,NA,NA,NA,"w1920","Non.motorized",7,"Thu","weekday"
"7878",2020-12-10,"Gothic Rd",NA,NA,NA,NA,NA,NA,NA,NA,NA,NA,NA,NA,NA,NA,NA,NA,NA,"w1920","Mechanized",0,"Thu","weekday"
"7879",2020-12-10,"Gothic Rd",NA,NA,NA,NA,NA,NA,NA,NA,NA,NA,NA,NA,NA,NA,NA,NA,NA,"w1920","Motorized",2,"Thu","weekday"
"7880",2020-12-10,"Gothic Rd",NA,NA,NA,NA,NA,NA,NA,NA,NA,NA,NA,NA,NA,NA,NA,NA,NA,"w1920","Hybrid",0,"Thu","weekday"
"7881",2019-12-11,"Gothic Rd","2","2","2",3.4,0,20,-1,22,17,-1,5,-1,-1,-2,3,2,1,"w1920","Non.motorized",11,"Wed","weekday"
"7882",2019-12-11,"Gothic Rd","2","2","2",3.4,0,20,-1,22,17,-1,5,-1,-1,-2,3,2,1,"w1920","Mechanized",0,"Wed","weekday"
"7883",2019-12-11,"Gothic Rd","2","2","2",3.4,0,20,-1,22,17,-1,5,-1,-1,-2,3,2,1,"w1920","Motorized",1,"Wed","weekday"
"7884",2019-12-11,"Gothic Rd","2","2","2",3.4,0,20,-1,22,17,-1,5,-1,-1,-2,3,2,1,"w1920","Hybrid",0,"Wed","weekday"
"7885",2019-12-12,"Gothic Rd","2","2","2",3.4,0,19,-1,25,17.9,-1,-1,5,-1,-2,-3,2,1,"w1920","Non.motorized",15,"Thu","weekday"
"7886",2019-12-12,"Gothic Rd","2","2","2",3.4,0,19,-1,25,17.9,-1,-1,5,-1,-2,-3,2,1,"w1920","Mechanized",0,"Thu","weekday"
"7887",2019-12-12,"Gothic Rd","2","2","2",3.4,0,19,-1,25,17.9,-1,-1,5,-1,-2,-3,2,1,"w1920","Motorized",0,"Thu","weekday"
"7888",2019-12-12,"Gothic Rd","2","2","2",3.4,0,19,-1,25,17.9,-1,-1,5,-1,-2,-3,2,1,"w1920","Hybrid",0,"Thu","weekday"
"7889",2019-12-13,"Gothic Rd","2","2","2",3.8,0.4,21,2,24,18.1,-1,-1,-1,5,1,0,-1,4,"w1920","Non.motorized",11,"Fri","weekday"
"7890",2019-12-13,"Gothic Rd","2","2","2",3.8,0.4,21,2,24,18.1,-1,-1,-1,5,1,0,-1,4,"w1920","Mechanized",0,"Fri","weekday"
"7891",2019-12-13,"Gothic Rd","2","2","2",3.8,0.4,21,2,24,18.1,-1,-1,-1,5,1,0,-1,4,"w1920","Motorized",0,"Fri","weekday"
"7892",2019-12-13,"Gothic Rd","2","2","2",3.8,0.4,21,2,24,18.1,-1,-1,-1,5,1,0,-1,4,"w1920","Hybrid",0,"Fri","weekday"
"7893",2019-12-14,"Gothic Rd","3","3","3",4.2,0.4,27,6,25,15.6,2,-1,-1,-1,8,7,6,5,"w1920","Non.motorized",7,"Sat","weekend"
"7894",2019-12-14,"Gothic Rd","3","3","3",4.2,0.4,27,6,25,15.6,2,-1,-1,-1,8,7,6,5,"w1920","Mechanized",2,"Sat","weekend"
"7895",2019-12-14,"Gothic Rd","3","3","3",4.2,0.4,27,6,25,15.6,2,-1,-1,-1,8,7,6,5,"w1920","Motorized",0,"Sat","weekend"
"7896",2019-12-14,"Gothic Rd","3","3","3",4.2,0.4,27,6,25,15.6,2,-1,-1,-1,8,7,6,5,"w1920","Hybrid",0,"Sat","weekend"
"7897",2019-12-15,"Gothic Rd","3","3","2",4.8,0.6,31,4,17,15.5,6,2,-1,-1,10,12,11,10,"w1920","Non.motorized",13,"Sun","weekend"
"7898",2019-12-15,"Gothic Rd","3","3","2",4.8,0.6,31,4,17,15.5,6,2,-1,-1,10,12,11,10,"w1920","Mechanized",0,"Sun","weekend"
"7899",2019-12-15,"Gothic Rd","3","3","2",4.8,0.6,31,4,17,15.5,6,2,-1,-1,10,12,11,10,"w1920","Motorized",0,"Sun","weekend"
"7900",2019-12-15,"Gothic Rd","3","3","2",4.8,0.6,31,4,17,15.5,6,2,-1,-1,10,12,11,10,"w1920","Hybrid",0,"Sun","weekend"
"7901",2019-12-16,"Gothic Rd","3","3","2",4.8,0,29,-2,6,16.6,4,6,2,-1,2,8,10,9,"w1920","Non.motorized",7,"Mon","weekday"
"7902",2019-12-16,"Gothic Rd","3","3","2",4.8,0,29,-2,6,16.6,4,6,2,-1,2,8,10,9,"w1920","Mechanized",0,"Mon","weekday"
"7903",2019-12-16,"Gothic Rd","3","3","2",4.8,0,29,-2,6,16.6,4,6,2,-1,2,8,10,9,"w1920","Motorized",1,"Mon","weekday"
"7904",2019-12-16,"Gothic Rd","3","3","2",4.8,0,29,-2,6,16.6,4,6,2,-1,2,8,10,9,"w1920","Hybrid",0,"Mon","weekday"
"7905",2019-12-17,"Gothic Rd","2","2","1",4.8,0,27,-2,8,17.8,-2,4,6,2,-4,0,6,8,"w1920","Non.motorized",3,"Tue","weekday"
"7906",2019-12-17,"Gothic Rd","2","2","1",4.8,0,27,-2,8,17.8,-2,4,6,2,-4,0,6,8,"w1920","Mechanized",0,"Tue","weekday"
"7907",2019-12-17,"Gothic Rd","2","2","1",4.8,0,27,-2,8,17.8,-2,4,6,2,-4,0,6,8,"w1920","Motorized",0,"Tue","weekday"
"7908",2019-12-17,"Gothic Rd","2","2","1",4.8,0,27,-2,8,17.8,-2,4,6,2,-4,0,6,8,"w1920","Hybrid",0,"Tue","weekday"
"7909",2019-12-18,"Gothic Rd","2","2","1",4.8,0,26,-1,20,18.5,-2,-2,4,6,-3,-5,-1,5,"w1920","Non.motorized",10,"Wed","weekday"
"7910",2019-12-18,"Gothic Rd","2","2","1",4.8,0,26,-1,20,18.5,-2,-2,4,6,-3,-5,-1,5,"w1920","Mechanized",1,"Wed","weekday"
"7911",2019-12-18,"Gothic Rd","2","2","1",4.8,0,26,-1,20,18.5,-2,-2,4,6,-3,-5,-1,5,"w1920","Motorized",2,"Wed","weekday"
"7912",2019-12-18,"Gothic Rd","2","2","1",4.8,0,26,-1,20,18.5,-2,-2,4,6,-3,-5,-1,5,"w1920","Hybrid",0,"Wed","weekday"
"7913",2019-12-19,"Gothic Rd","2","2","1",4.9,0.1,25,-1,21,19.6,-1,-2,-2,4,-2,-4,-6,-2,"w1920","Non.motorized",13,"Thu","weekday"
"7914",2019-12-19,"Gothic Rd","2","2","1",4.9,0.1,25,-1,21,19.6,-1,-2,-2,4,-2,-4,-6,-2,"w1920","Mechanized",0,"Thu","weekday"
"7915",2019-12-19,"Gothic Rd","2","2","1",4.9,0.1,25,-1,21,19.6,-1,-2,-2,4,-2,-4,-6,-2,"w1920","Motorized",0,"Thu","weekday"
"7916",2019-12-19,"Gothic Rd","2","2","1",4.9,0.1,25,-1,21,19.6,-1,-2,-2,4,-2,-4,-6,-2,"w1920","Hybrid",0,"Thu","weekday"
"7917",2019-12-20,"Gothic Rd","2","2","1",4.9,0,24,-1,21,20.4,-1,-1,-2,-2,-2,-3,-5,-7,"w1920","Non.motorized",20,"Fri","weekday"
"7918",2019-12-20,"Gothic Rd","2","2","1",4.9,0,24,-1,21,20.4,-1,-1,-2,-2,-2,-3,-5,-7,"w1920","Mechanized",0,"Fri","weekday"
"7919",2019-12-20,"Gothic Rd","2","2","1",4.9,0,24,-1,21,20.4,-1,-1,-2,-2,-2,-3,-5,-7,"w1920","Motorized",0,"Fri","weekday"
"7920",2019-12-20,"Gothic Rd","2","2","1",4.9,0,24,-1,21,20.4,-1,-1,-2,-2,-2,-3,-5,-7,"w1920","Hybrid",0,"Fri","weekday"
"7921",2019-12-21,"Gothic Rd","2","2","1",4.9,0,24,0,27,20.4,-1,-1,-1,-2,-1,-2,-3,-5,"w1920","Non.motorized",33,"Sat","weekend"
"7922",2019-12-21,"Gothic Rd","2","2","1",4.9,0,24,0,27,20.4,-1,-1,-1,-2,-1,-2,-3,-5,"w1920","Mechanized",3,"Sat","weekend"
"7923",2019-12-21,"Gothic Rd","2","2","1",4.9,0,24,0,27,20.4,-1,-1,-1,-2,-1,-2,-3,-5,"w1920","Motorized",1,"Sat","weekend"
"7924",2019-12-21,"Gothic Rd","2","2","1",4.9,0,24,0,27,20.4,-1,-1,-1,-2,-1,-2,-3,-5,"w1920","Hybrid",0,"Sat","weekend"
"7925",2019-12-22,"Gothic Rd","2","2","1",5,0.1,23,-1,31,21.7,0,-1,-1,-1,-1,-2,-3,-4,"w1920","Non.motorized",25,"Sun","weekend"
"7926",2019-12-22,"Gothic Rd","2","2","1",5,0.1,23,-1,31,21.7,0,-1,-1,-1,-1,-2,-3,-4,"w1920","Mechanized",2,"Sun","weekend"
"7927",2019-12-22,"Gothic Rd","2","2","1",5,0.1,23,-1,31,21.7,0,-1,-1,-1,-1,-2,-3,-4,"w1920","Motorized",0,"Sun","weekend"
"7928",2019-12-22,"Gothic Rd","2","2","1",5,0.1,23,-1,31,21.7,0,-1,-1,-1,-1,-2,-3,-4,"w1920","Hybrid",0,"Sun","weekend"
"7929",2019-12-23,"Gothic Rd","2","1","1",5,0,23,0,34,21.7,-1,0,-1,-1,-1,-1,-2,-3,"w1920","Non.motorized",12,"Mon","weekday"
"7930",2019-12-23,"Gothic Rd","2","1","1",5,0,23,0,34,21.7,-1,0,-1,-1,-1,-1,-2,-3,"w1920","Mechanized",1,"Mon","weekday"
"7931",2019-12-23,"Gothic Rd","2","1","1",5,0,23,0,34,21.7,-1,0,-1,-1,-1,-1,-2,-3,"w1920","Motorized",0,"Mon","weekday"
"7932",2019-12-23,"Gothic Rd","2","1","1",5,0,23,0,34,21.7,-1,0,-1,-1,-1,-1,-2,-3,"w1920","Hybrid",0,"Mon","weekday"
"7933",2019-12-24,"Gothic Rd","2","1","1",5,0,22,-1,30,22.7,0,-1,0,-1,-1,-2,-2,-3,"w1920","Non.motorized",27,"Tue","weekday"
"7934",2019-12-24,"Gothic Rd","2","1","1",5,0,22,-1,30,22.7,0,-1,0,-1,-1,-2,-2,-3,"w1920","Mechanized",3,"Tue","weekday"
"7935",2019-12-24,"Gothic Rd","2","1","1",5,0,22,-1,30,22.7,0,-1,0,-1,-1,-2,-2,-3,"w1920","Motorized",0,"Tue","weekday"
"7936",2019-12-24,"Gothic Rd","2","1","1",5,0,22,-1,30,22.7,0,-1,0,-1,-1,-2,-2,-3,"w1920","Hybrid",0,"Tue","weekday"
"7937",2019-12-25,"Gothic Rd","2","2","2",5,0,23,1,22,21.7,-1,0,-1,0,0,0,-1,-1,"w1920","Non.motorized",39,"Wed","weekday"
"7938",2019-12-25,"Gothic Rd","2","2","2",5,0,23,1,22,21.7,-1,0,-1,0,0,0,-1,-1,"w1920","Mechanized",4,"Wed","weekday"
"7939",2019-12-25,"Gothic Rd","2","2","2",5,0,23,1,22,21.7,-1,0,-1,0,0,0,-1,-1,"w1920","Motorized",0,"Wed","weekday"
"7940",2019-12-25,"Gothic Rd","2","2","2",5,0,23,1,22,21.7,-1,0,-1,0,0,0,-1,-1,"w1920","Hybrid",0,"Wed","weekday"
"7941",2019-12-26,"Gothic Rd","2","2","1",5,0,23,0,17,21.7,1,-1,0,-1,1,0,0,-1,"w1920","Non.motorized",36,"Thu","weekday"
"7942",2019-12-26,"Gothic Rd","2","2","1",5,0,23,0,17,21.7,1,-1,0,-1,1,0,0,-1,"w1920","Mechanized",4,"Thu","weekday"
"7943",2019-12-26,"Gothic Rd","2","2","1",5,0,23,0,17,21.7,1,-1,0,-1,1,0,0,-1,"w1920","Motorized",0,"Thu","weekday"
"7944",2019-12-26,"Gothic Rd","2","2","1",5,0,23,0,17,21.7,1,-1,0,-1,1,0,0,-1,"w1920","Hybrid",0,"Thu","weekday"
"7945",2019-12-27,"Gothic Rd","3","3","2",5.1,0.1,24,1,22,21.2,0,1,-1,0,1,2,1,1,"w1920","Non.motorized",42,"Fri","weekday"
"7946",2019-12-27,"Gothic Rd","3","3","2",5.1,0.1,24,1,22,21.2,0,1,-1,0,1,2,1,1,"w1920","Mechanized",2,"Fri","weekday"
"7947",2019-12-27,"Gothic Rd","3","3","2",5.1,0.1,24,1,22,21.2,0,1,-1,0,1,2,1,1,"w1920","Motorized",0,"Fri","weekday"
"7948",2019-12-27,"Gothic Rd","3","3","2",5.1,0.1,24,1,22,21.2,0,1,-1,0,1,2,1,1,"w1920","Hybrid",0,"Fri","weekday"
"7949",2019-12-28,"Gothic Rd","3","3","2",5.6,0.5,30,6,16,18.7,1,0,1,-1,7,7,8,7,"w1920","Non.motorized",55,"Sat","weekend"
"7950",2019-12-28,"Gothic Rd","3","3","2",5.6,0.5,30,6,16,18.7,1,0,1,-1,7,7,8,7,"w1920","Mechanized",1,"Sat","weekend"
"7951",2019-12-28,"Gothic Rd","3","3","2",5.6,0.5,30,6,16,18.7,1,0,1,-1,7,7,8,7,"w1920","Motorized",0,"Sat","weekend"
"7952",2019-12-28,"Gothic Rd","3","3","2",5.6,0.5,30,6,16,18.7,1,0,1,-1,7,7,8,7,"w1920","Hybrid",0,"Sat","weekend"
"7953",2019-12-29,"Gothic Rd","3","3","2",5.6,0,29,-1,3,19.3,6,1,0,1,5,6,6,7,"w1920","Non.motorized",50,"Sun","weekend"
"7954",2019-12-29,"Gothic Rd","3","3","2",5.6,0,29,-1,3,19.3,6,1,0,1,5,6,6,7,"w1920","Mechanized",1,"Sun","weekend"
"7955",2019-12-29,"Gothic Rd","3","3","2",5.6,0,29,-1,3,19.3,6,1,0,1,5,6,6,7,"w1920","Motorized",0,"Sun","weekend"
"7956",2019-12-29,"Gothic Rd","3","3","2",5.6,0,29,-1,3,19.3,6,1,0,1,5,6,6,7,"w1920","Hybrid",0,"Sun","weekend"
"7957",2019-12-30,"Gothic Rd","3","3","2",5.6,0,28,-1,3,20,-1,6,1,0,-2,4,5,5,"w1920","Non.motorized",55,"Mon","weekday"
"7958",2019-12-30,"Gothic Rd","3","3","2",5.6,0,28,-1,3,20,-1,6,1,0,-2,4,5,5,"w1920","Mechanized",2,"Mon","weekday"
"7959",2019-12-30,"Gothic Rd","3","3","2",5.6,0,28,-1,3,20,-1,6,1,0,-2,4,5,5,"w1920","Motorized",0,"Mon","weekday"
"7960",2019-12-30,"Gothic Rd","3","3","2",5.6,0,28,-1,3,20,-1,6,1,0,-2,4,5,5,"w1920","Hybrid",0,"Mon","weekday"
"7961",2019-12-31,"Gothic Rd","2","2","1",5.6,0,28,0,13,20,-1,-1,6,1,-1,-2,4,5,"w1920","Non.motorized",39,"Tue","weekday"
"7962",2019-12-31,"Gothic Rd","2","2","1",5.6,0,28,0,13,20,-1,-1,6,1,-1,-2,4,5,"w1920","Mechanized",5,"Tue","weekday"
"7963",2019-12-31,"Gothic Rd","2","2","1",5.6,0,28,0,13,20,-1,-1,6,1,-1,-2,4,5,"w1920","Motorized",1,"Tue","weekday"
"7964",2019-12-31,"Gothic Rd","2","2","1",5.6,0,28,0,13,20,-1,-1,6,1,-1,-2,4,5,"w1920","Hybrid",0,"Tue","weekday"
"7965",2020-01-01,"Gothic Rd","2","1","1",5.6,0,27,-1,21,20.7,0,-1,-1,6,-1,-2,-3,3,"w1920","Non.motorized",49,"Wed","weekday"
"7966",2020-01-01,"Gothic Rd","2","1","1",5.6,0,27,-1,21,20.7,0,-1,-1,6,-1,-2,-3,3,"w1920","Mechanized",1,"Wed","weekday"
"7967",2020-01-01,"Gothic Rd","2","1","1",5.6,0,27,-1,21,20.7,0,-1,-1,6,-1,-2,-3,3,"w1920","Motorized",1,"Wed","weekday"
"7968",2020-01-01,"Gothic Rd","2","1","1",5.6,0,27,-1,21,20.7,0,-1,-1,6,-1,-2,-3,3,"w1920","Hybrid",0,"Wed","weekday"
"7969",2020-01-02,"Gothic Rd","3","3","2",5.9,0.3,29,2,16,20.3,-1,0,-1,-1,1,1,0,-1,"w1920","Non.motorized",33,"Thu","weekday"
"7970",2020-01-02,"Gothic Rd","3","3","2",5.9,0.3,29,2,16,20.3,-1,0,-1,-1,1,1,0,-1,"w1920","Mechanized",1,"Thu","weekday"
"7971",2020-01-02,"Gothic Rd","3","3","2",5.9,0.3,29,2,16,20.3,-1,0,-1,-1,1,1,0,-1,"w1920","Motorized",3,"Thu","weekday"
"7972",2020-01-02,"Gothic Rd","3","3","2",5.9,0.3,29,2,16,20.3,-1,0,-1,-1,1,1,0,-1,"w1920","Hybrid",0,"Thu","weekday"
"7973",2020-01-03,"Gothic Rd","3","2","1",5.9,0,31,2,19,19,2,-1,0,-1,4,3,3,2,"w1920","Non.motorized",36,"Fri","weekday"
"7974",2020-01-03,"Gothic Rd","3","2","1",5.9,0,31,2,19,19,2,-1,0,-1,4,3,3,2,"w1920","Mechanized",5,"Fri","weekday"
"7975",2020-01-03,"Gothic Rd","3","2","1",5.9,0,31,2,19,19,2,-1,0,-1,4,3,3,2,"w1920","Motorized",0,"Fri","weekday"
"7976",2020-01-03,"Gothic Rd","3","2","1",5.9,0,31,2,19,19,2,-1,0,-1,4,3,3,2,"w1920","Hybrid",0,"Fri","weekday"
"7977",2020-01-04,"Gothic Rd","2","2","1",5.9,0,30,-1,26,19.7,2,2,-1,0,1,3,2,2,"w1920","Non.motorized",34,"Sat","weekend"
"7978",2020-01-04,"Gothic Rd","2","2","1",5.9,0,30,-1,26,19.7,2,2,-1,0,1,3,2,2,"w1920","Mechanized",7,"Sat","weekend"
"7979",2020-01-04,"Gothic Rd","2","2","1",5.9,0,30,-1,26,19.7,2,2,-1,0,1,3,2,2,"w1920","Motorized",1,"Sat","weekend"
"7980",2020-01-04,"Gothic Rd","2","2","1",5.9,0,30,-1,26,19.7,2,2,-1,0,1,3,2,2,"w1920","Hybrid",0,"Sat","weekend"
"7981",2020-01-05,"Gothic Rd","2","2","1",5.9,0,28,-2,23,21.1,-1,2,2,-1,-3,-1,1,0,"w1920","Non.motorized",18,"Sun","weekend"
"7982",2020-01-05,"Gothic Rd","2","2","1",5.9,0,28,-2,23,21.1,-1,2,2,-1,-3,-1,1,0,"w1920","Mechanized",3,"Sun","weekend"
"7983",2020-01-05,"Gothic Rd","2","2","1",5.9,0,28,-2,23,21.1,-1,2,2,-1,-3,-1,1,0,"w1920","Motorized",0,"Sun","weekend"
"7984",2020-01-05,"Gothic Rd","2","2","1",5.9,0,28,-2,23,21.1,-1,2,2,-1,-3,-1,1,0,"w1920","Hybrid",0,"Sun","weekend"
"7985",2020-01-06,"Gothic Rd","2","2","1",5.9,0,28,0,15,21.1,-2,-1,2,2,-2,-3,-1,1,"w1920","Non.motorized",22,"Mon","weekday"
"7986",2020-01-06,"Gothic Rd","2","2","1",5.9,0,28,0,15,21.1,-2,-1,2,2,-2,-3,-1,1,"w1920","Mechanized",1,"Mon","weekday"
"7987",2020-01-06,"Gothic Rd","2","2","1",5.9,0,28,0,15,21.1,-2,-1,2,2,-2,-3,-1,1,"w1920","Motorized",2,"Mon","weekday"
"7988",2020-01-06,"Gothic Rd","2","2","1",5.9,0,28,0,15,21.1,-2,-1,2,2,-2,-3,-1,1,"w1920","Hybrid",0,"Mon","weekday"
"7989",2020-01-07,"Gothic Rd","2","1","1",5.9,0,28,0,22,21.1,0,-2,-1,2,0,-2,-3,-1,"w1920","Non.motorized",16,"Tue","weekday"
"7990",2020-01-07,"Gothic Rd","2","1","1",5.9,0,28,0,22,21.1,0,-2,-1,2,0,-2,-3,-1,"w1920","Mechanized",4,"Tue","weekday"
"7991",2020-01-07,"Gothic Rd","2","1","1",5.9,0,28,0,22,21.1,0,-2,-1,2,0,-2,-3,-1,"w1920","Motorized",0,"Tue","weekday"
"7992",2020-01-07,"Gothic Rd","2","1","1",5.9,0,28,0,22,21.1,0,-2,-1,2,0,-2,-3,-1,"w1920","Hybrid",0,"Tue","weekday"
"7993",2020-01-08,"Gothic Rd","2","1","1",6,0.1,28,0,23,21.4,0,0,-2,-1,0,0,-2,-3,"w1920","Non.motorized",21,"Wed","weekday"
"7994",2020-01-08,"Gothic Rd","2","1","1",6,0.1,28,0,23,21.4,0,0,-2,-1,0,0,-2,-3,"w1920","Mechanized",0,"Wed","weekday"
"7995",2020-01-08,"Gothic Rd","2","1","1",6,0.1,28,0,23,21.4,0,0,-2,-1,0,0,-2,-3,"w1920","Motorized",0,"Wed","weekday"
"7996",2020-01-08,"Gothic Rd","2","1","1",6,0.1,28,0,23,21.4,0,0,-2,-1,0,0,-2,-3,"w1920","Hybrid",0,"Wed","weekday"
"7997",2020-01-09,"Gothic Rd","2","1","1",6,0,27,-1,17,22.2,0,0,0,-2,-1,-1,-1,-3,"w1920","Non.motorized",19,"Thu","weekday"
"7998",2020-01-09,"Gothic Rd","2","1","1",6,0,27,-1,17,22.2,0,0,0,-2,-1,-1,-1,-3,"w1920","Mechanized",0,"Thu","weekday"
"7999",2020-01-09,"Gothic Rd","2","1","1",6,0,27,-1,17,22.2,0,0,0,-2,-1,-1,-1,-3,"w1920","Motorized",1,"Thu","weekday"
"8000",2020-01-09,"Gothic Rd","2","1","1",6,0,27,-1,17,22.2,0,0,0,-2,-1,-1,-1,-3,"w1920","Hybrid",0,"Thu","weekday"
"8001",2020-01-10,"Gothic Rd","2","1","1",6,0,29,2,11,20.7,-1,0,0,0,1,1,1,1,"w1920","Non.motorized",36,"Fri","weekday"
"8002",2020-01-10,"Gothic Rd","2","1","1",6,0,29,2,11,20.7,-1,0,0,0,1,1,1,1,"w1920","Mechanized",2,"Fri","weekday"
"8003",2020-01-10,"Gothic Rd","2","1","1",6,0,29,2,11,20.7,-1,0,0,0,1,1,1,1,"w1920","Motorized",3,"Fri","weekday"
"8004",2020-01-10,"Gothic Rd","2","1","1",6,0,29,2,11,20.7,-1,0,0,0,1,1,1,1,"w1920","Hybrid",0,"Fri","weekday"
"8005",2020-01-11,"Gothic Rd","2","1","1",6,0,29,0,12,20.7,2,-1,0,0,2,1,1,1,"w1920","Non.motorized",22,"Sat","weekend"
"8006",2020-01-11,"Gothic Rd","2","1","1",6,0,29,0,12,20.7,2,-1,0,0,2,1,1,1,"w1920","Mechanized",1,"Sat","weekend"
"8007",2020-01-11,"Gothic Rd","2","1","1",6,0,29,0,12,20.7,2,-1,0,0,2,1,1,1,"w1920","Motorized",1,"Sat","weekend"
"8008",2020-01-11,"Gothic Rd","2","1","1",6,0,29,0,12,20.7,2,-1,0,0,2,1,1,1,"w1920","Hybrid",0,"Sat","weekend"
"8009",2020-01-12,"Gothic Rd","2","1","1",6.1,0.1,29,0,13,21,0,2,-1,0,0,2,1,1,"w1920","Non.motorized",26,"Sun","weekend"
"8010",2020-01-12,"Gothic Rd","2","1","1",6.1,0.1,29,0,13,21,0,2,-1,0,0,2,1,1,"w1920","Mechanized",0,"Sun","weekend"
"8011",2020-01-12,"Gothic Rd","2","1","1",6.1,0.1,29,0,13,21,0,2,-1,0,0,2,1,1,"w1920","Motorized",0,"Sun","weekend"
"8012",2020-01-12,"Gothic Rd","2","1","1",6.1,0.1,29,0,13,21,0,2,-1,0,0,2,1,1,"w1920","Hybrid",0,"Sun","weekend"
"8013",2020-01-13,"Gothic Rd","2","2","1",6.2,0.1,29,0,16,21.4,0,0,2,-1,0,0,2,1,"w1920","Non.motorized",4,"Mon","weekday"
"8014",2020-01-13,"Gothic Rd","2","2","1",6.2,0.1,29,0,16,21.4,0,0,2,-1,0,0,2,1,"w1920","Mechanized",0,"Mon","weekday"
"8015",2020-01-13,"Gothic Rd","2","2","1",6.2,0.1,29,0,16,21.4,0,0,2,-1,0,0,2,1,"w1920","Motorized",0,"Mon","weekday"
"8016",2020-01-13,"Gothic Rd","2","2","1",6.2,0.1,29,0,16,21.4,0,0,2,-1,0,0,2,1,"w1920","Hybrid",0,"Mon","weekday"
"8017",2020-01-14,"Gothic Rd","3","2","1",6.6,0.4,34,5,23,19.4,0,0,0,2,5,5,5,7,"w1920","Non.motorized",9,"Tue","weekday"
"8018",2020-01-14,"Gothic Rd","3","2","1",6.6,0.4,34,5,23,19.4,0,0,0,2,5,5,5,7,"w1920","Mechanized",0,"Tue","weekday"
"8019",2020-01-14,"Gothic Rd","3","2","1",6.6,0.4,34,5,23,19.4,0,0,0,2,5,5,5,7,"w1920","Motorized",0,"Tue","weekday"
"8020",2020-01-14,"Gothic Rd","3","2","1",6.6,0.4,34,5,23,19.4,0,0,0,2,5,5,5,7,"w1920","Hybrid",0,"Tue","weekday"
"8021",2020-01-15,"Gothic Rd","3","2","1",6.7,0.1,32,-2,23,20.9,5,0,0,0,3,3,3,3,"w1920","Non.motorized",21,"Wed","weekday"
"8022",2020-01-15,"Gothic Rd","3","2","1",6.7,0.1,32,-2,23,20.9,5,0,0,0,3,3,3,3,"w1920","Mechanized",1,"Wed","weekday"
"8023",2020-01-15,"Gothic Rd","3","2","1",6.7,0.1,32,-2,23,20.9,5,0,0,0,3,3,3,3,"w1920","Motorized",2,"Wed","weekday"
"8024",2020-01-15,"Gothic Rd","3","2","1",6.7,0.1,32,-2,23,20.9,5,0,0,0,3,3,3,3,"w1920","Hybrid",0,"Wed","weekday"
"8025",2020-01-16,"Gothic Rd","2","2","1",6.7,0,31,-1,28,21.6,-2,5,0,0,-3,2,2,2,"w1920","Non.motorized",17,"Thu","weekday"
"8026",2020-01-16,"Gothic Rd","2","2","1",6.7,0,31,-1,28,21.6,-2,5,0,0,-3,2,2,2,"w1920","Mechanized",0,"Thu","weekday"
"8027",2020-01-16,"Gothic Rd","2","2","1",6.7,0,31,-1,28,21.6,-2,5,0,0,-3,2,2,2,"w1920","Motorized",0,"Thu","weekday"
"8028",2020-01-16,"Gothic Rd","2","2","1",6.7,0,31,-1,28,21.6,-2,5,0,0,-3,2,2,2,"w1920","Hybrid",0,"Thu","weekday"
"8029",2020-01-17,"Gothic Rd","2","2","1",6.8,0.1,29,-2,19,23.4,-1,-2,5,0,-3,-5,0,0,"w1920","Non.motorized",5,"Fri","weekday"
"8030",2020-01-17,"Gothic Rd","2","2","1",6.8,0.1,29,-2,19,23.4,-1,-2,5,0,-3,-5,0,0,"w1920","Mechanized",0,"Fri","weekday"
"8031",2020-01-17,"Gothic Rd","2","2","1",6.8,0.1,29,-2,19,23.4,-1,-2,5,0,-3,-5,0,0,"w1920","Motorized",0,"Fri","weekday"
"8032",2020-01-17,"Gothic Rd","2","2","1",6.8,0.1,29,-2,19,23.4,-1,-2,5,0,-3,-5,0,0,"w1920","Hybrid",0,"Fri","weekday"
"8033",2020-01-18,"Gothic Rd","2","2","2",7,0.2,34,5,16,20.6,-2,-1,-2,5,3,2,0,5,"w1920","Non.motorized",20,"Sat","weekend"
"8034",2020-01-18,"Gothic Rd","2","2","2",7,0.2,34,5,16,20.6,-2,-1,-2,5,3,2,0,5,"w1920","Mechanized",0,"Sat","weekend"
"8035",2020-01-18,"Gothic Rd","2","2","2",7,0.2,34,5,16,20.6,-2,-1,-2,5,3,2,0,5,"w1920","Motorized",0,"Sat","weekend"
"8036",2020-01-18,"Gothic Rd","2","2","2",7,0.2,34,5,16,20.6,-2,-1,-2,5,3,2,0,5,"w1920","Hybrid",0,"Sat","weekend"
"8037",2020-01-19,"Gothic Rd","2","2","1",7,0,33,-1,21,21.2,5,-2,-1,-2,4,2,1,-1,"w1920","Non.motorized",21,"Sun","weekend"
"8038",2020-01-19,"Gothic Rd","2","2","1",7,0,33,-1,21,21.2,5,-2,-1,-2,4,2,1,-1,"w1920","Mechanized",1,"Sun","weekend"
"8039",2020-01-19,"Gothic Rd","2","2","1",7,0,33,-1,21,21.2,5,-2,-1,-2,4,2,1,-1,"w1920","Motorized",1,"Sun","weekend"
"8040",2020-01-19,"Gothic Rd","2","2","1",7,0,33,-1,21,21.2,5,-2,-1,-2,4,2,1,-1,"w1920","Hybrid",0,"Sun","weekend"
"8041",2020-01-20,"Gothic Rd","2","2","1",7.1,0.1,32,-1,25,22.2,-1,5,-2,-1,-2,3,1,0,"w1920","Non.motorized",9,"Mon","weekday"
"8042",2020-01-20,"Gothic Rd","2","2","1",7.1,0.1,32,-1,25,22.2,-1,5,-2,-1,-2,3,1,0,"w1920","Mechanized",1,"Mon","weekday"
"8043",2020-01-20,"Gothic Rd","2","2","1",7.1,0.1,32,-1,25,22.2,-1,5,-2,-1,-2,3,1,0,"w1920","Motorized",0,"Mon","weekday"
"8044",2020-01-20,"Gothic Rd","2","2","1",7.1,0.1,32,-1,25,22.2,-1,5,-2,-1,-2,3,1,0,"w1920","Hybrid",0,"Mon","weekday"
"8045",2020-01-21,"Gothic Rd","2","2","1",7.1,0,31,-1,28,22.9,-1,-1,5,-2,-2,-3,2,0,"w1920","Non.motorized",4,"Tue","weekday"
"8046",2020-01-21,"Gothic Rd","2","2","1",7.1,0,31,-1,28,22.9,-1,-1,5,-2,-2,-3,2,0,"w1920","Mechanized",0,"Tue","weekday"
"8047",2020-01-21,"Gothic Rd","2","2","1",7.1,0,31,-1,28,22.9,-1,-1,5,-2,-2,-3,2,0,"w1920","Motorized",0,"Tue","weekday"
"8048",2020-01-21,"Gothic Rd","2","2","1",7.1,0,31,-1,28,22.9,-1,-1,5,-2,-2,-3,2,0,"w1920","Hybrid",0,"Tue","weekday"
"8049",2020-01-22,"Gothic Rd","2","2","2",7.3,0.2,32,1,25,22.8,-1,-1,-1,5,0,-1,-2,3,"w1920","Non.motorized",10,"Wed","weekday"
"8050",2020-01-22,"Gothic Rd","2","2","2",7.3,0.2,32,1,25,22.8,-1,-1,-1,5,0,-1,-2,3,"w1920","Mechanized",0,"Wed","weekday"
"8051",2020-01-22,"Gothic Rd","2","2","2",7.3,0.2,32,1,25,22.8,-1,-1,-1,5,0,-1,-2,3,"w1920","Motorized",1,"Wed","weekday"
"8052",2020-01-22,"Gothic Rd","2","2","2",7.3,0.2,32,1,25,22.8,-1,-1,-1,5,0,-1,-2,3,"w1920","Hybrid",0,"Wed","weekday"
"8053",2020-01-23,"Gothic Rd","3","2","2",7.3,0,34,2,23,21.5,1,-1,-1,-1,3,2,1,0,"w1920","Non.motorized",5,"Thu","weekday"
"8054",2020-01-23,"Gothic Rd","3","2","2",7.3,0,34,2,23,21.5,1,-1,-1,-1,3,2,1,0,"w1920","Mechanized",1,"Thu","weekday"
"8055",2020-01-23,"Gothic Rd","3","2","2",7.3,0,34,2,23,21.5,1,-1,-1,-1,3,2,1,0,"w1920","Motorized",2,"Thu","weekday"
"8056",2020-01-23,"Gothic Rd","3","2","2",7.3,0,34,2,23,21.5,1,-1,-1,-1,3,2,1,0,"w1920","Hybrid",0,"Thu","weekday"
"8057",2020-01-24,"Gothic Rd","2","2","1",7.3,0,33,-1,23,22.1,2,1,-1,-1,1,2,1,0,"w1920","Non.motorized",26,"Fri","weekday"
"8058",2020-01-24,"Gothic Rd","2","2","1",7.3,0,33,-1,23,22.1,2,1,-1,-1,1,2,1,0,"w1920","Mechanized",2,"Fri","weekday"
"8059",2020-01-24,"Gothic Rd","2","2","1",7.3,0,33,-1,23,22.1,2,1,-1,-1,1,2,1,0,"w1920","Motorized",0,"Fri","weekday"
"8060",2020-01-24,"Gothic Rd","2","2","1",7.3,0,33,-1,23,22.1,2,1,-1,-1,1,2,1,0,"w1920","Hybrid",0,"Fri","weekday"
"8061",2020-01-25,"Gothic Rd","2","2","1",7.4,0.1,32,-1,25,23.1,-1,2,1,-1,-2,0,1,0,"w1920","Non.motorized",23,"Sat","weekend"
"8062",2020-01-25,"Gothic Rd","2","2","1",7.4,0.1,32,-1,25,23.1,-1,2,1,-1,-2,0,1,0,"w1920","Mechanized",1,"Sat","weekend"
"8063",2020-01-25,"Gothic Rd","2","2","1",7.4,0.1,32,-1,25,23.1,-1,2,1,-1,-2,0,1,0,"w1920","Motorized",0,"Sat","weekend"
"8064",2020-01-25,"Gothic Rd","2","2","1",7.4,0.1,32,-1,25,23.1,-1,2,1,-1,-2,0,1,0,"w1920","Hybrid",0,"Sat","weekend"
"8065",2020-01-26,"Gothic Rd","2","1","1",7.4,0,32,0,28,23.1,-1,-1,2,1,-1,-2,0,1,"w1920","Non.motorized",20,"Sun","weekend"
"8066",2020-01-26,"Gothic Rd","2","1","1",7.4,0,32,0,28,23.1,-1,-1,2,1,-1,-2,0,1,"w1920","Mechanized",1,"Sun","weekend"
"8067",2020-01-26,"Gothic Rd","2","1","1",7.4,0,32,0,28,23.1,-1,-1,2,1,-1,-2,0,1,"w1920","Motorized",0,"Sun","weekend"
"8068",2020-01-26,"Gothic Rd","2","1","1",7.4,0,32,0,28,23.1,-1,-1,2,1,-1,-2,0,1,"w1920","Hybrid",0,"Sun","weekend"
"8069",2020-01-27,"Gothic Rd","2","1","1",7.4,0,32,0,24,23.1,0,-1,-1,2,0,-1,-2,0,"w1920","Non.motorized",14,"Mon","weekday"
"8070",2020-01-27,"Gothic Rd","2","1","1",7.4,0,32,0,24,23.1,0,-1,-1,2,0,-1,-2,0,"w1920","Mechanized",0,"Mon","weekday"
"8071",2020-01-27,"Gothic Rd","2","1","1",7.4,0,32,0,24,23.1,0,-1,-1,2,0,-1,-2,0,"w1920","Motorized",2,"Mon","weekday"
"8072",2020-01-27,"Gothic Rd","2","1","1",7.4,0,32,0,24,23.1,0,-1,-1,2,0,-1,-2,0,"w1920","Hybrid",0,"Mon","weekday"
"8073",2020-01-28,"Gothic Rd","3","2","2",7.4,0,32,0,19,23.1,0,0,-1,-1,0,0,-1,-2,"w1920","Non.motorized",16,"Tue","weekday"
"8074",2020-01-28,"Gothic Rd","3","2","2",7.4,0,32,0,19,23.1,0,0,-1,-1,0,0,-1,-2,"w1920","Mechanized",1,"Tue","weekday"
"8075",2020-01-28,"Gothic Rd","3","2","2",7.4,0,32,0,19,23.1,0,0,-1,-1,0,0,-1,-2,"w1920","Motorized",0,"Tue","weekday"
"8076",2020-01-28,"Gothic Rd","3","2","2",7.4,0,32,0,19,23.1,0,0,-1,-1,0,0,-1,-2,"w1920","Hybrid",0,"Tue","weekday"
"8077",2020-01-29,"Gothic Rd","2","2","1",7.4,0,31,-1,20,23.9,0,0,0,-1,-1,-1,-1,-2,"w1920","Non.motorized",4,"Wed","weekday"
"8078",2020-01-29,"Gothic Rd","2","2","1",7.4,0,31,-1,20,23.9,0,0,0,-1,-1,-1,-1,-2,"w1920","Mechanized",0,"Wed","weekday"
"8079",2020-01-29,"Gothic Rd","2","2","1",7.4,0,31,-1,20,23.9,0,0,0,-1,-1,-1,-1,-2,"w1920","Motorized",0,"Wed","weekday"
"8080",2020-01-29,"Gothic Rd","2","2","1",7.4,0,31,-1,20,23.9,0,0,0,-1,-1,-1,-1,-2,"w1920","Hybrid",0,"Wed","weekday"
"8081",2020-01-30,"Gothic Rd","2","2","1",7.4,0,31,0,17,23.9,-1,0,0,0,-1,-1,-1,-1,"w1920","Non.motorized",11,"Thu","weekday"
"8082",2020-01-30,"Gothic Rd","2","2","1",7.4,0,31,0,17,23.9,-1,0,0,0,-1,-1,-1,-1,"w1920","Mechanized",1,"Thu","weekday"
"8083",2020-01-30,"Gothic Rd","2","2","1",7.4,0,31,0,17,23.9,-1,0,0,0,-1,-1,-1,-1,"w1920","Motorized",0,"Thu","weekday"
"8084",2020-01-30,"Gothic Rd","2","2","1",7.4,0,31,0,17,23.9,-1,0,0,0,-1,-1,-1,-1,"w1920","Hybrid",0,"Thu","weekday"
"8085",2020-01-31,"Gothic Rd","2","1","1",7.4,0,31,0,20,23.9,0,-1,0,0,0,-1,-1,-1,"w1920","Non.motorized",27,"Fri","weekday"
"8086",2020-01-31,"Gothic Rd","2","1","1",7.4,0,31,0,20,23.9,0,-1,0,0,0,-1,-1,-1,"w1920","Mechanized",2,"Fri","weekday"
"8087",2020-01-31,"Gothic Rd","2","1","1",7.4,0,31,0,20,23.9,0,-1,0,0,0,-1,-1,-1,"w1920","Motorized",0,"Fri","weekday"
"8088",2020-01-31,"Gothic Rd","2","1","1",7.4,0,31,0,20,23.9,0,-1,0,0,0,-1,-1,-1,"w1920","Hybrid",0,"Fri","weekday"
"8089",2020-02-01,"Gothic Rd","2","1","1",7.4,0,31,0,28,23.9,0,0,-1,0,0,0,-1,-1,"w1920","Non.motorized",15,"Sat","weekend"
"8090",2020-02-01,"Gothic Rd","2","1","1",7.4,0,31,0,28,23.9,0,0,-1,0,0,0,-1,-1,"w1920","Mechanized",5,"Sat","weekend"
"8091",2020-02-01,"Gothic Rd","2","1","1",7.4,0,31,0,28,23.9,0,0,-1,0,0,0,-1,-1,"w1920","Motorized",0,"Sat","weekend"
"8092",2020-02-01,"Gothic Rd","2","1","1",7.4,0,31,0,28,23.9,0,0,-1,0,0,0,-1,-1,"w1920","Hybrid",0,"Sat","weekend"
"8093",2020-02-02,"Gothic Rd","1","1","1",7.4,0,31,0,33,23.9,0,0,0,-1,0,0,0,-1,"w1920","Non.motorized",27,"Sun","weekend"
"8094",2020-02-02,"Gothic Rd","1","1","1",7.4,0,31,0,33,23.9,0,0,0,-1,0,0,0,-1,"w1920","Mechanized",4,"Sun","weekend"
"8095",2020-02-02,"Gothic Rd","1","1","1",7.4,0,31,0,33,23.9,0,0,0,-1,0,0,0,-1,"w1920","Motorized",0,"Sun","weekend"
"8096",2020-02-02,"Gothic Rd","1","1","1",7.4,0,31,0,33,23.9,0,0,0,-1,0,0,0,-1,"w1920","Hybrid",0,"Sun","weekend"
"8097",2020-02-03,"Gothic Rd","2","2","1",7.4,0,31,0,24,23.9,0,0,0,0,0,0,0,0,"w1920","Non.motorized",8,"Mon","weekday"
"8098",2020-02-03,"Gothic Rd","2","2","1",7.4,0,31,0,24,23.9,0,0,0,0,0,0,0,0,"w1920","Mechanized",0,"Mon","weekday"
"8099",2020-02-03,"Gothic Rd","2","2","1",7.4,0,31,0,24,23.9,0,0,0,0,0,0,0,0,"w1920","Motorized",0,"Mon","weekday"
"8100",2020-02-03,"Gothic Rd","2","2","1",7.4,0,31,0,24,23.9,0,0,0,0,0,0,0,0,"w1920","Hybrid",0,"Mon","weekday"
"8101",2020-02-04,"Gothic Rd","2","2","2",7.4,0,33,2,5,22.4,0,0,0,0,2,2,2,2,"w1920","Non.motorized",21,"Tue","weekday"
"8102",2020-02-04,"Gothic Rd","2","2","2",7.4,0,33,2,5,22.4,0,0,0,0,2,2,2,2,"w1920","Mechanized",3,"Tue","weekday"
"8103",2020-02-04,"Gothic Rd","2","2","2",7.4,0,33,2,5,22.4,0,0,0,0,2,2,2,2,"w1920","Motorized",1,"Tue","weekday"
"8104",2020-02-04,"Gothic Rd","2","2","2",7.4,0,33,2,5,22.4,0,0,0,0,2,2,2,2,"w1920","Hybrid",0,"Tue","weekday"
"8105",2020-02-05,"Gothic Rd","2","2","1",7.4,0,33,0,2,22.4,2,0,0,0,2,2,2,2,"w1920","Non.motorized",10,"Wed","weekday"
"8106",2020-02-05,"Gothic Rd","2","2","1",7.4,0,33,0,2,22.4,2,0,0,0,2,2,2,2,"w1920","Mechanized",0,"Wed","weekday"
"8107",2020-02-05,"Gothic Rd","2","2","1",7.4,0,33,0,2,22.4,2,0,0,0,2,2,2,2,"w1920","Motorized",0,"Wed","weekday"
"8108",2020-02-05,"Gothic Rd","2","2","1",7.4,0,33,0,2,22.4,2,0,0,0,2,2,2,2,"w1920","Hybrid",0,"Wed","weekday"
"8109",2020-02-06,"Gothic Rd","2","2","1",7.5,0.1,32,-1,16,23.4,0,2,0,0,-1,1,1,1,"w1920","Non.motorized",9,"Thu","weekday"
"8110",2020-02-06,"Gothic Rd","2","2","1",7.5,0.1,32,-1,16,23.4,0,2,0,0,-1,1,1,1,"w1920","Mechanized",0,"Thu","weekday"
"8111",2020-02-06,"Gothic Rd","2","2","1",7.5,0.1,32,-1,16,23.4,0,2,0,0,-1,1,1,1,"w1920","Motorized",1,"Thu","weekday"
"8112",2020-02-06,"Gothic Rd","2","2","1",7.5,0.1,32,-1,16,23.4,0,2,0,0,-1,1,1,1,"w1920","Hybrid",0,"Thu","weekday"
"8113",2020-02-07,"Gothic Rd","3","3","3",7.9,0.4,37,5,26,21.4,-1,0,2,0,4,4,6,6,"w1920","Non.motorized",6,"Fri","weekday"
"8114",2020-02-07,"Gothic Rd","3","3","3",7.9,0.4,37,5,26,21.4,-1,0,2,0,4,4,6,6,"w1920","Mechanized",0,"Fri","weekday"
"8115",2020-02-07,"Gothic Rd","3","3","3",7.9,0.4,37,5,26,21.4,-1,0,2,0,4,4,6,6,"w1920","Motorized",3,"Fri","weekday"
"8116",2020-02-07,"Gothic Rd","3","3","3",7.9,0.4,37,5,26,21.4,-1,0,2,0,4,4,6,6,"w1920","Hybrid",0,"Fri","weekday"
"8117",2020-02-08,"Gothic Rd","3","3","2",8.3,0.4,39,2,30,21.3,5,-1,0,2,7,6,6,8,"w1920","Non.motorized",20,"Sat","weekend"
"8118",2020-02-08,"Gothic Rd","3","3","2",8.3,0.4,39,2,30,21.3,5,-1,0,2,7,6,6,8,"w1920","Mechanized",2,"Sat","weekend"
"8119",2020-02-08,"Gothic Rd","3","3","2",8.3,0.4,39,2,30,21.3,5,-1,0,2,7,6,6,8,"w1920","Motorized",3,"Sat","weekend"
"8120",2020-02-08,"Gothic Rd","3","3","2",8.3,0.4,39,2,30,21.3,5,-1,0,2,7,6,6,8,"w1920","Hybrid",0,"Sat","weekend"
"8121",2020-02-09,"Gothic Rd","3","2","2",8.4,0.1,38,-1,26,22.1,2,5,-1,0,1,6,5,5,"w1920","Non.motorized",7,"Sun","weekend"
"8122",2020-02-09,"Gothic Rd","3","2","2",8.4,0.1,38,-1,26,22.1,2,5,-1,0,1,6,5,5,"w1920","Mechanized",1,"Sun","weekend"
"8123",2020-02-09,"Gothic Rd","3","2","2",8.4,0.1,38,-1,26,22.1,2,5,-1,0,1,6,5,5,"w1920","Motorized",3,"Sun","weekend"
"8124",2020-02-09,"Gothic Rd","3","2","2",8.4,0.1,38,-1,26,22.1,2,5,-1,0,1,6,5,5,"w1920","Hybrid",0,"Sun","weekend"
"8125",2020-02-10,"Gothic Rd","2","2","1",8.4,0,38,0,22,22.1,-1,2,5,-1,-1,1,6,5,"w1920","Non.motorized",19,"Mon","weekday"
"8126",2020-02-10,"Gothic Rd","2","2","1",8.4,0,38,0,22,22.1,-1,2,5,-1,-1,1,6,5,"w1920","Mechanized",1,"Mon","weekday"
"8127",2020-02-10,"Gothic Rd","2","2","1",8.4,0,38,0,22,22.1,-1,2,5,-1,-1,1,6,5,"w1920","Motorized",1,"Mon","weekday"
"8128",2020-02-10,"Gothic Rd","2","2","1",8.4,0,38,0,22,22.1,-1,2,5,-1,-1,1,6,5,"w1920","Hybrid",0,"Mon","weekday"
"8129",2020-02-11,"Gothic Rd","2","2","2",8.5,0.1,40,2,16,21.2,0,-1,2,5,2,1,3,8,"w1920","Non.motorized",15,"Tue","weekday"
"8130",2020-02-11,"Gothic Rd","2","2","2",8.5,0.1,40,2,16,21.2,0,-1,2,5,2,1,3,8,"w1920","Mechanized",0,"Tue","weekday"
"8131",2020-02-11,"Gothic Rd","2","2","2",8.5,0.1,40,2,16,21.2,0,-1,2,5,2,1,3,8,"w1920","Motorized",2,"Tue","weekday"
"8132",2020-02-11,"Gothic Rd","2","2","2",8.5,0.1,40,2,16,21.2,0,-1,2,5,2,1,3,8,"w1920","Hybrid",0,"Tue","weekday"
"8133",2020-02-12,"Gothic Rd","2","2","2",8.5,0,39,-1,15,21.8,2,0,-1,2,1,1,0,2,"w1920","Non.motorized",10,"Wed","weekday"
"8134",2020-02-12,"Gothic Rd","2","2","2",8.5,0,39,-1,15,21.8,2,0,-1,2,1,1,0,2,"w1920","Mechanized",1,"Wed","weekday"
"8135",2020-02-12,"Gothic Rd","2","2","2",8.5,0,39,-1,15,21.8,2,0,-1,2,1,1,0,2,"w1920","Motorized",1,"Wed","weekday"
"8136",2020-02-12,"Gothic Rd","2","2","2",8.5,0,39,-1,15,21.8,2,0,-1,2,1,1,0,2,"w1920","Hybrid",0,"Wed","weekday"
"8137",2020-02-13,"Gothic Rd","2","2","1",8.5,0,39,0,18,21.8,-1,2,0,-1,-1,1,1,0,"w1920","Non.motorized",8,"Thu","weekday"
"8138",2020-02-13,"Gothic Rd","2","2","1",8.5,0,39,0,18,21.8,-1,2,0,-1,-1,1,1,0,"w1920","Mechanized",0,"Thu","weekday"
"8139",2020-02-13,"Gothic Rd","2","2","1",8.5,0,39,0,18,21.8,-1,2,0,-1,-1,1,1,0,"w1920","Motorized",0,"Thu","weekday"
"8140",2020-02-13,"Gothic Rd","2","2","1",8.5,0,39,0,18,21.8,-1,2,0,-1,-1,1,1,0,"w1920","Hybrid",0,"Thu","weekday"
"8141",2020-02-14,"Gothic Rd","2","1","1",8.6,0.1,38,-1,24,22.6,0,-1,2,0,-1,-2,0,0,"w1920","Non.motorized",21,"Fri","weekday"
"8142",2020-02-14,"Gothic Rd","2","1","1",8.6,0.1,38,-1,24,22.6,0,-1,2,0,-1,-2,0,0,"w1920","Mechanized",2,"Fri","weekday"
"8143",2020-02-14,"Gothic Rd","2","1","1",8.6,0.1,38,-1,24,22.6,0,-1,2,0,-1,-2,0,0,"w1920","Motorized",0,"Fri","weekday"
"8144",2020-02-14,"Gothic Rd","2","1","1",8.6,0.1,38,-1,24,22.6,0,-1,2,0,-1,-2,0,0,"w1920","Hybrid",0,"Fri","weekday"
"8145",2020-02-15,"Gothic Rd","1","1","1",8.6,0,38,0,26,22.6,-1,0,-1,2,-1,-1,-2,0,"w1920","Non.motorized",45,"Sat","weekend"
"8146",2020-02-15,"Gothic Rd","1","1","1",8.6,0,38,0,26,22.6,-1,0,-1,2,-1,-1,-2,0,"w1920","Mechanized",6,"Sat","weekend"
"8147",2020-02-15,"Gothic Rd","1","1","1",8.6,0,38,0,26,22.6,-1,0,-1,2,-1,-1,-2,0,"w1920","Motorized",0,"Sat","weekend"
"8148",2020-02-15,"Gothic Rd","1","1","1",8.6,0,38,0,26,22.6,-1,0,-1,2,-1,-1,-2,0,"w1920","Hybrid",0,"Sat","weekend"
"8149",2020-02-16,"Gothic Rd","1","1","1",8.8,0.2,37,-1,26,23.8,0,-1,0,-1,-1,-2,-2,-3,"w1920","Non.motorized",27,"Sun","weekend"
"8150",2020-02-16,"Gothic Rd","1","1","1",8.8,0.2,37,-1,26,23.8,0,-1,0,-1,-1,-2,-2,-3,"w1920","Mechanized",1,"Sun","weekend"
"8151",2020-02-16,"Gothic Rd","1","1","1",8.8,0.2,37,-1,26,23.8,0,-1,0,-1,-1,-2,-2,-3,"w1920","Motorized",0,"Sun","weekend"
"8152",2020-02-16,"Gothic Rd","1","1","1",8.8,0.2,37,-1,26,23.8,0,-1,0,-1,-1,-2,-2,-3,"w1920","Hybrid",0,"Sun","weekend"
"8153",2020-02-17,"Gothic Rd","2","1","1",9.2,0.4,43,6,25,21.4,-1,0,-1,0,5,5,4,4,"w1920","Non.motorized",42,"Mon","weekday"
"8154",2020-02-17,"Gothic Rd","2","1","1",9.2,0.4,43,6,25,21.4,-1,0,-1,0,5,5,4,4,"w1920","Mechanized",1,"Mon","weekday"
"8155",2020-02-17,"Gothic Rd","2","1","1",9.2,0.4,43,6,25,21.4,-1,0,-1,0,5,5,4,4,"w1920","Motorized",2,"Mon","weekday"
"8156",2020-02-17,"Gothic Rd","2","1","1",9.2,0.4,43,6,25,21.4,-1,0,-1,0,5,5,4,4,"w1920","Hybrid",0,"Mon","weekday"
"8157",2020-02-18,"Gothic Rd","1","1","1",9.3,0.1,42,-1,18,22.1,6,-1,0,-1,5,4,4,3,"w1920","Non.motorized",23,"Tue","weekday"
"8158",2020-02-18,"Gothic Rd","1","1","1",9.3,0.1,42,-1,18,22.1,6,-1,0,-1,5,4,4,3,"w1920","Mechanized",0,"Tue","weekday"
"8159",2020-02-18,"Gothic Rd","1","1","1",9.3,0.1,42,-1,18,22.1,6,-1,0,-1,5,4,4,3,"w1920","Motorized",0,"Tue","weekday"
"8160",2020-02-18,"Gothic Rd","1","1","1",9.3,0.1,42,-1,18,22.1,6,-1,0,-1,5,4,4,3,"w1920","Hybrid",0,"Tue","weekday"
"8161",2020-02-19,"Gothic Rd","1","1","1",9.3,0,41,-1,22,22.7,-1,6,-1,0,-2,4,3,3,"w1920","Non.motorized",31,"Wed","weekday"
"8162",2020-02-19,"Gothic Rd","1","1","1",9.3,0,41,-1,22,22.7,-1,6,-1,0,-2,4,3,3,"w1920","Mechanized",2,"Wed","weekday"
"8163",2020-02-19,"Gothic Rd","1","1","1",9.3,0,41,-1,22,22.7,-1,6,-1,0,-2,4,3,3,"w1920","Motorized",0,"Wed","weekday"
"8164",2020-02-19,"Gothic Rd","1","1","1",9.3,0,41,-1,22,22.7,-1,6,-1,0,-2,4,3,3,"w1920","Hybrid",0,"Wed","weekday"
"8165",2020-02-20,"Gothic Rd","1","1","1",9.3,0,41,0,18,22.7,-1,-1,6,-1,-1,-2,4,3,"w1920","Non.motorized",16,"Thu","weekday"
"8166",2020-02-20,"Gothic Rd","1","1","1",9.3,0,41,0,18,22.7,-1,-1,6,-1,-1,-2,4,3,"w1920","Mechanized",0,"Thu","weekday"
"8167",2020-02-20,"Gothic Rd","1","1","1",9.3,0,41,0,18,22.7,-1,-1,6,-1,-1,-2,4,3,"w1920","Motorized",0,"Thu","weekday"
"8168",2020-02-20,"Gothic Rd","1","1","1",9.3,0,41,0,18,22.7,-1,-1,6,-1,-1,-2,4,3,"w1920","Hybrid",0,"Thu","weekday"
"8169",2020-02-21,"Gothic Rd","1","1","1",9.3,0,40,-1,26,23.2,0,-1,-1,6,-1,-2,-3,3,"w1920","Non.motorized",33,"Fri","weekday"
"8170",2020-02-21,"Gothic Rd","1","1","1",9.3,0,40,-1,26,23.2,0,-1,-1,6,-1,-2,-3,3,"w1920","Mechanized",0,"Fri","weekday"
"8171",2020-02-21,"Gothic Rd","1","1","1",9.3,0,40,-1,26,23.2,0,-1,-1,6,-1,-2,-3,3,"w1920","Motorized",0,"Fri","weekday"
"8172",2020-02-21,"Gothic Rd","1","1","1",9.3,0,40,-1,26,23.2,0,-1,-1,6,-1,-2,-3,3,"w1920","Hybrid",0,"Fri","weekday"
"8173",2020-02-22,"Gothic Rd","1","1","1",9.4,0.1,39,-1,32,24.1,-1,0,-1,-1,-2,-2,-3,-4,"w1920","Non.motorized",NA,"Sat","weekend"
"8174",2020-02-22,"Gothic Rd","1","1","1",9.4,0.1,39,-1,32,24.1,-1,0,-1,-1,-2,-2,-3,-4,"w1920","Mechanized",NA,"Sat","weekend"
"8175",2020-02-22,"Gothic Rd","1","1","1",9.4,0.1,39,-1,32,24.1,-1,0,-1,-1,-2,-2,-3,-4,"w1920","Motorized",NA,"Sat","weekend"
"8176",2020-02-22,"Gothic Rd","1","1","1",9.4,0.1,39,-1,32,24.1,-1,0,-1,-1,-2,-2,-3,-4,"w1920","Hybrid",NA,"Sat","weekend"
"8177",2020-02-23,"Gothic Rd","2","2","2",9.5,0.1,40,1,27,23.8,-1,-1,0,-1,0,-1,-1,-2,"w1920","Non.motorized",NA,"Sun","weekend"
"8178",2020-02-23,"Gothic Rd","2","2","2",9.5,0.1,40,1,27,23.8,-1,-1,0,-1,0,-1,-1,-2,"w1920","Mechanized",NA,"Sun","weekend"
"8179",2020-02-23,"Gothic Rd","2","2","2",9.5,0.1,40,1,27,23.8,-1,-1,0,-1,0,-1,-1,-2,"w1920","Motorized",NA,"Sun","weekend"
"8180",2020-02-23,"Gothic Rd","2","2","2",9.5,0.1,40,1,27,23.8,-1,-1,0,-1,0,-1,-1,-2,"w1920","Hybrid",NA,"Sun","weekend"
"8181",2020-02-24,"Gothic Rd","3","3","2",9.8,0.3,43,3,17,22.8,1,-1,-1,0,4,3,2,2,"w1920","Non.motorized",NA,"Mon","weekday"
"8182",2020-02-24,"Gothic Rd","3","3","2",9.8,0.3,43,3,17,22.8,1,-1,-1,0,4,3,2,2,"w1920","Mechanized",NA,"Mon","weekday"
"8183",2020-02-24,"Gothic Rd","3","3","2",9.8,0.3,43,3,17,22.8,1,-1,-1,0,4,3,2,2,"w1920","Motorized",NA,"Mon","weekday"
"8184",2020-02-24,"Gothic Rd","3","3","2",9.8,0.3,43,3,17,22.8,1,-1,-1,0,4,3,2,2,"w1920","Hybrid",NA,"Mon","weekday"
"8185",2020-02-25,"Gothic Rd","2","2","1",9.8,0,43,0,8,22.8,3,1,-1,-1,3,4,3,2,"w1920","Non.motorized",NA,"Tue","weekday"
"8186",2020-02-25,"Gothic Rd","2","2","1",9.8,0,43,0,8,22.8,3,1,-1,-1,3,4,3,2,"w1920","Mechanized",NA,"Tue","weekday"
"8187",2020-02-25,"Gothic Rd","2","2","1",9.8,0,43,0,8,22.8,3,1,-1,-1,3,4,3,2,"w1920","Motorized",NA,"Tue","weekday"
"8188",2020-02-25,"Gothic Rd","2","2","1",9.8,0,43,0,8,22.8,3,1,-1,-1,3,4,3,2,"w1920","Hybrid",NA,"Tue","weekday"
"8189",2020-02-26,"Gothic Rd","2","2","1",9.8,0,42,-1,15,23.3,0,3,1,-1,-1,2,3,2,"w1920","Non.motorized",NA,"Wed","weekday"
"8190",2020-02-26,"Gothic Rd","2","2","1",9.8,0,42,-1,15,23.3,0,3,1,-1,-1,2,3,2,"w1920","Mechanized",NA,"Wed","weekday"
"8191",2020-02-26,"Gothic Rd","2","2","1",9.8,0,42,-1,15,23.3,0,3,1,-1,-1,2,3,2,"w1920","Motorized",NA,"Wed","weekday"
"8192",2020-02-26,"Gothic Rd","2","2","1",9.8,0,42,-1,15,23.3,0,3,1,-1,-1,2,3,2,"w1920","Hybrid",NA,"Wed","weekday"
"8193",2020-02-27,"Gothic Rd","2","2","1",9.9,0.1,41,-1,25,24.1,-1,0,3,1,-2,-2,1,2,"w1920","Non.motorized",17,"Thu","weekday"
"8194",2020-02-27,"Gothic Rd","2","2","1",9.9,0.1,41,-1,25,24.1,-1,0,3,1,-2,-2,1,2,"w1920","Mechanized",4,"Thu","weekday"
"8195",2020-02-27,"Gothic Rd","2","2","1",9.9,0.1,41,-1,25,24.1,-1,0,3,1,-2,-2,1,2,"w1920","Motorized",1,"Thu","weekday"
"8196",2020-02-27,"Gothic Rd","2","2","1",9.9,0.1,41,-1,25,24.1,-1,0,3,1,-2,-2,1,2,"w1920","Hybrid",0,"Thu","weekday"
"8197",2020-02-28,"Gothic Rd","2","1","1",9.9,0,41,0,28,24.1,-1,-1,0,3,-1,-2,-2,1,"w1920","Non.motorized",34,"Fri","weekday"
"8198",2020-02-28,"Gothic Rd","2","1","1",9.9,0,41,0,28,24.1,-1,-1,0,3,-1,-2,-2,1,"w1920","Mechanized",0,"Fri","weekday"
"8199",2020-02-28,"Gothic Rd","2","1","1",9.9,0,41,0,28,24.1,-1,-1,0,3,-1,-2,-2,1,"w1920","Motorized",0,"Fri","weekday"
"8200",2020-02-28,"Gothic Rd","2","1","1",9.9,0,41,0,28,24.1,-1,-1,0,3,-1,-2,-2,1,"w1920","Hybrid",0,"Fri","weekday"
"8201",2020-02-29,"Gothic Rd","1","1","1",9.9,0,40,-1,29,24.8,0,-1,-1,0,-1,-2,-3,-3,"w1920","Non.motorized",54,"Sat","weekend"
"8202",2020-02-29,"Gothic Rd","1","1","1",9.9,0,40,-1,29,24.8,0,-1,-1,0,-1,-2,-3,-3,"w1920","Mechanized",4,"Sat","weekend"
"8203",2020-02-29,"Gothic Rd","1","1","1",9.9,0,40,-1,29,24.8,0,-1,-1,0,-1,-2,-3,-3,"w1920","Motorized",2,"Sat","weekend"
"8204",2020-02-29,"Gothic Rd","1","1","1",9.9,0,40,-1,29,24.8,0,-1,-1,0,-1,-2,-3,-3,"w1920","Hybrid",0,"Sat","weekend"
"8205",2020-03-01,"Gothic Rd","1","1","1",10,0.1,40,0,28,25,-1,0,-1,-1,-1,-1,-2,-3,"w1920","Non.motorized",27,"Sun","weekend"
"8206",2020-03-01,"Gothic Rd","1","1","1",10,0.1,40,0,28,25,-1,0,-1,-1,-1,-1,-2,-3,"w1920","Mechanized",4,"Sun","weekend"
"8207",2020-03-01,"Gothic Rd","1","1","1",10,0.1,40,0,28,25,-1,0,-1,-1,-1,-1,-2,-3,"w1920","Motorized",0,"Sun","weekend"
"8208",2020-03-01,"Gothic Rd","1","1","1",10,0.1,40,0,28,25,-1,0,-1,-1,-1,-1,-2,-3,"w1920","Hybrid",0,"Sun","weekend"
"8209",2020-03-02,"Gothic Rd","2","2","1",10.4,0.4,45,5,25,23.1,0,-1,0,-1,5,4,4,3,"w1920","Non.motorized",27,"Mon","weekday"
"8210",2020-03-02,"Gothic Rd","2","2","1",10.4,0.4,45,5,25,23.1,0,-1,0,-1,5,4,4,3,"w1920","Mechanized",0,"Mon","weekday"
"8211",2020-03-02,"Gothic Rd","2","2","1",10.4,0.4,45,5,25,23.1,0,-1,0,-1,5,4,4,3,"w1920","Motorized",0,"Mon","weekday"
"8212",2020-03-02,"Gothic Rd","2","2","1",10.4,0.4,45,5,25,23.1,0,-1,0,-1,5,4,4,3,"w1920","Hybrid",0,"Mon","weekday"
"8213",2020-03-03,"Gothic Rd","2","1","1",10.9,0.5,50,5,25,21.8,5,0,-1,0,10,10,9,9,"w1920","Non.motorized",9,"Tue","weekday"
"8214",2020-03-03,"Gothic Rd","2","1","1",10.9,0.5,50,5,25,21.8,5,0,-1,0,10,10,9,9,"w1920","Mechanized",3,"Tue","weekday"
"8215",2020-03-03,"Gothic Rd","2","1","1",10.9,0.5,50,5,25,21.8,5,0,-1,0,10,10,9,9,"w1920","Motorized",1,"Tue","weekday"
"8216",2020-03-03,"Gothic Rd","2","1","1",10.9,0.5,50,5,25,21.8,5,0,-1,0,10,10,9,9,"w1920","Hybrid",0,"Tue","weekday"
"8217",2020-03-04,"Gothic Rd","2","1","1",10.9,0,48,-2,29,22.7,5,5,0,-1,3,8,8,7,"w1920","Non.motorized",22,"Wed","weekday"
"8218",2020-03-04,"Gothic Rd","2","1","1",10.9,0,48,-2,29,22.7,5,5,0,-1,3,8,8,7,"w1920","Mechanized",0,"Wed","weekday"
"8219",2020-03-04,"Gothic Rd","2","1","1",10.9,0,48,-2,29,22.7,5,5,0,-1,3,8,8,7,"w1920","Motorized",1,"Wed","weekday"
"8220",2020-03-04,"Gothic Rd","2","1","1",10.9,0,48,-2,29,22.7,5,5,0,-1,3,8,8,7,"w1920","Hybrid",0,"Wed","weekday"
"8221",2020-03-05,"Gothic Rd","2","1","1",10.9,0,46,-2,32,23.7,-2,5,5,0,-4,1,6,6,"w1920","Non.motorized",12,"Thu","weekday"
"8222",2020-03-05,"Gothic Rd","2","1","1",10.9,0,46,-2,32,23.7,-2,5,5,0,-4,1,6,6,"w1920","Mechanized",0,"Thu","weekday"
"8223",2020-03-05,"Gothic Rd","2","1","1",10.9,0,46,-2,32,23.7,-2,5,5,0,-4,1,6,6,"w1920","Motorized",0,"Thu","weekday"
"8224",2020-03-05,"Gothic Rd","2","1","1",10.9,0,46,-2,32,23.7,-2,5,5,0,-4,1,6,6,"w1920","Hybrid",0,"Thu","weekday"
"8225",2020-03-06,"Gothic Rd","1","1","1",10.9,0,45,-1,34,24.2,-2,-2,5,5,-3,-5,0,5,"w1920","Non.motorized",17,"Fri","weekday"
"8226",2020-03-06,"Gothic Rd","1","1","1",10.9,0,45,-1,34,24.2,-2,-2,5,5,-3,-5,0,5,"w1920","Mechanized",1,"Fri","weekday"
"8227",2020-03-06,"Gothic Rd","1","1","1",10.9,0,45,-1,34,24.2,-2,-2,5,5,-3,-5,0,5,"w1920","Motorized",1,"Fri","weekday"
"8228",2020-03-06,"Gothic Rd","1","1","1",10.9,0,45,-1,34,24.2,-2,-2,5,5,-3,-5,0,5,"w1920","Hybrid",0,"Fri","weekday"
"8229",2020-03-07,"Gothic Rd","1","1","2",10.9,0,44,-1,35,24.8,-1,-2,-2,5,-2,-4,-6,-1,"w1920","Non.motorized",16,"Sat","weekend"
"8230",2020-03-07,"Gothic Rd","1","1","2",10.9,0,44,-1,35,24.8,-1,-2,-2,5,-2,-4,-6,-1,"w1920","Mechanized",5,"Sat","weekend"
"8231",2020-03-07,"Gothic Rd","1","1","2",10.9,0,44,-1,35,24.8,-1,-2,-2,5,-2,-4,-6,-1,"w1920","Motorized",2,"Sat","weekend"
"8232",2020-03-07,"Gothic Rd","1","1","2",10.9,0,44,-1,35,24.8,-1,-2,-2,5,-2,-4,-6,-1,"w1920","Hybrid",0,"Sat","weekend"
"8233",2020-03-08,"Gothic Rd","1","1","1",11,0.1,43,-1,33,25.6,-1,-1,-2,-2,-2,-3,-5,-7,"w1920","Non.motorized",20,"Sun","weekend"
"8234",2020-03-08,"Gothic Rd","1","1","1",11,0.1,43,-1,33,25.6,-1,-1,-2,-2,-2,-3,-5,-7,"w1920","Mechanized",1,"Sun","weekend"
"8235",2020-03-08,"Gothic Rd","1","1","1",11,0.1,43,-1,33,25.6,-1,-1,-2,-2,-2,-3,-5,-7,"w1920","Motorized",2,"Sun","weekend"
"8236",2020-03-08,"Gothic Rd","1","1","1",11,0.1,43,-1,33,25.6,-1,-1,-2,-2,-2,-3,-5,-7,"w1920","Hybrid",0,"Sun","weekend"
"8237",2020-03-09,"Gothic Rd","1","1","1",11.1,0.1,42,-1,31,26.4,-1,-1,-1,-2,-2,-3,-4,-6,"w1920","Non.motorized",15,"Mon","weekday"
"8238",2020-03-09,"Gothic Rd","1","1","1",11.1,0.1,42,-1,31,26.4,-1,-1,-1,-2,-2,-3,-4,-6,"w1920","Mechanized",3,"Mon","weekday"
"8239",2020-03-09,"Gothic Rd","1","1","1",11.1,0.1,42,-1,31,26.4,-1,-1,-1,-2,-2,-3,-4,-6,"w1920","Motorized",0,"Mon","weekday"
"8240",2020-03-09,"Gothic Rd","1","1","1",11.1,0.1,42,-1,31,26.4,-1,-1,-1,-2,-2,-3,-4,-6,"w1920","Hybrid",0,"Mon","weekday"
"8241",2020-03-10,"Gothic Rd","1","1","2",11.2,0.1,44,2,31,25.5,-1,-1,-1,-1,1,0,-1,-2,"w1920","Non.motorized",15,"Tue","weekday"
"8242",2020-03-10,"Gothic Rd","1","1","2",11.2,0.1,44,2,31,25.5,-1,-1,-1,-1,1,0,-1,-2,"w1920","Mechanized",1,"Tue","weekday"
"8243",2020-03-10,"Gothic Rd","1","1","2",11.2,0.1,44,2,31,25.5,-1,-1,-1,-1,1,0,-1,-2,"w1920","Motorized",1,"Tue","weekday"
"8244",2020-03-10,"Gothic Rd","1","1","2",11.2,0.1,44,2,31,25.5,-1,-1,-1,-1,1,0,-1,-2,"w1920","Hybrid",0,"Tue","weekday"
"8245",2020-03-11,"Gothic Rd","2","2","1",11.2,0,44,0,32,25.5,2,-1,-1,-1,2,1,0,-1,"w1920","Non.motorized",5,"Wed","weekday"
"8246",2020-03-11,"Gothic Rd","2","2","1",11.2,0,44,0,32,25.5,2,-1,-1,-1,2,1,0,-1,"w1920","Mechanized",0,"Wed","weekday"
"8247",2020-03-11,"Gothic Rd","2","2","1",11.2,0,44,0,32,25.5,2,-1,-1,-1,2,1,0,-1,"w1920","Motorized",0,"Wed","weekday"
"8248",2020-03-11,"Gothic Rd","2","2","1",11.2,0,44,0,32,25.5,2,-1,-1,-1,2,1,0,-1,"w1920","Hybrid",0,"Wed","weekday"
"8249",2020-03-12,"Gothic Rd","2","2","2",11.4,0.2,42,-2,35,27.1,0,2,-1,-1,-2,0,-1,-2,"w1920","Non.motorized",19,"Thu","weekday"
"8250",2020-03-12,"Gothic Rd","2","2","2",11.4,0.2,42,-2,35,27.1,0,2,-1,-1,-2,0,-1,-2,"w1920","Mechanized",1,"Thu","weekday"
"8251",2020-03-12,"Gothic Rd","2","2","2",11.4,0.2,42,-2,35,27.1,0,2,-1,-1,-2,0,-1,-2,"w1920","Motorized",1,"Thu","weekday"
"8252",2020-03-12,"Gothic Rd","2","2","2",11.4,0.2,42,-2,35,27.1,0,2,-1,-1,-2,0,-1,-2,"w1920","Hybrid",0,"Thu","weekday"
"8253",2020-03-13,"Gothic Rd","3","3","2",11.5,0.1,44,2,31,26.1,-2,0,2,-1,0,0,2,1,"w1920","Non.motorized",13,"Fri","weekday"
"8254",2020-03-13,"Gothic Rd","3","3","2",11.5,0.1,44,2,31,26.1,-2,0,2,-1,0,0,2,1,"w1920","Mechanized",1,"Fri","weekday"
"8255",2020-03-13,"Gothic Rd","3","3","2",11.5,0.1,44,2,31,26.1,-2,0,2,-1,0,0,2,1,"w1920","Motorized",4,"Fri","weekday"
"8256",2020-03-13,"Gothic Rd","3","3","2",11.5,0.1,44,2,31,26.1,-2,0,2,-1,0,0,2,1,"w1920","Hybrid",0,"Fri","weekday"
"8257",2020-03-14,"Gothic Rd","3","3","3",11.7,0.2,44,0,31,26.6,2,-2,0,2,2,0,0,2,"w1920","Non.motorized",25,"Sat","weekend"
"8258",2020-03-14,"Gothic Rd","3","3","3",11.7,0.2,44,0,31,26.6,2,-2,0,2,2,0,0,2,"w1920","Mechanized",1,"Sat","weekend"
"8259",2020-03-14,"Gothic Rd","3","3","3",11.7,0.2,44,0,31,26.6,2,-2,0,2,2,0,0,2,"w1920","Motorized",1,"Sat","weekend"
"8260",2020-03-14,"Gothic Rd","3","3","3",11.7,0.2,44,0,31,26.6,2,-2,0,2,2,0,0,2,"w1920","Hybrid",0,"Sat","weekend"
"8261",2020-03-15,"Gothic Rd","2","2","2",11.7,0,45,1,33,26,0,2,-2,0,1,3,1,1,"w1920","Non.motorized",21,"Sun","weekend"
"8262",2020-03-15,"Gothic Rd","2","2","2",11.7,0,45,1,33,26,0,2,-2,0,1,3,1,1,"w1920","Mechanized",4,"Sun","weekend"
"8263",2020-03-15,"Gothic Rd","2","2","2",11.7,0,45,1,33,26,0,2,-2,0,1,3,1,1,"w1920","Motorized",7,"Sun","weekend"
"8264",2020-03-15,"Gothic Rd","2","2","2",11.7,0,45,1,33,26,0,2,-2,0,1,3,1,1,"w1920","Hybrid",0,"Sun","weekend"
"8265",2020-03-16,"Gothic Rd","2","2","2",11.7,0,45,0,35,26,1,0,2,-2,1,1,3,1,"w1920","Non.motorized",12,"Mon","weekday"
"8266",2020-03-16,"Gothic Rd","2","2","2",11.7,0,45,0,35,26,1,0,2,-2,1,1,3,1,"w1920","Mechanized",1,"Mon","weekday"
"8267",2020-03-16,"Gothic Rd","2","2","2",11.7,0,45,0,35,26,1,0,2,-2,1,1,3,1,"w1920","Motorized",0,"Mon","weekday"
"8268",2020-03-16,"Gothic Rd","2","2","2",11.7,0,45,0,35,26,1,0,2,-2,1,1,3,1,"w1920","Hybrid",0,"Mon","weekday"
"8269",2020-03-17,"Gothic Rd","2","2","2",11.7,0,44,-1,36,26.6,0,1,0,2,-1,0,0,2,"w1920","Non.motorized",7,"Tue","weekday"
"8270",2020-03-17,"Gothic Rd","2","2","2",11.7,0,44,-1,36,26.6,0,1,0,2,-1,0,0,2,"w1920","Mechanized",4,"Tue","weekday"
"8271",2020-03-17,"Gothic Rd","2","2","2",11.7,0,44,-1,36,26.6,0,1,0,2,-1,0,0,2,"w1920","Motorized",0,"Tue","weekday"
"8272",2020-03-17,"Gothic Rd","2","2","2",11.7,0,44,-1,36,26.6,0,1,0,2,-1,0,0,2,"w1920","Hybrid",0,"Tue","weekday"
"8273",2020-03-18,"Gothic Rd","2","2","2",11.7,0,43,-1,33,27.2,-1,0,1,0,-2,-2,-1,-1,"w1920","Non.motorized",4,"Wed","weekday"
"8274",2020-03-18,"Gothic Rd","2","2","2",11.7,0,43,-1,33,27.2,-1,0,1,0,-2,-2,-1,-1,"w1920","Mechanized",0,"Wed","weekday"
"8275",2020-03-18,"Gothic Rd","2","2","2",11.7,0,43,-1,33,27.2,-1,0,1,0,-2,-2,-1,-1,"w1920","Motorized",0,"Wed","weekday"
"8276",2020-03-18,"Gothic Rd","2","2","2",11.7,0,43,-1,33,27.2,-1,0,1,0,-2,-2,-1,-1,"w1920","Hybrid",0,"Wed","weekday"
"8277",2020-03-19,"Gothic Rd","3","3","3",11.8,0.1,43,0,27,27.4,-1,-1,0,1,-1,-2,-2,-1,"w1920","Non.motorized",8,"Thu","weekday"
"8278",2020-03-19,"Gothic Rd","3","3","3",11.8,0.1,43,0,27,27.4,-1,-1,0,1,-1,-2,-2,-1,"w1920","Mechanized",0,"Thu","weekday"
"8279",2020-03-19,"Gothic Rd","3","3","3",11.8,0.1,43,0,27,27.4,-1,-1,0,1,-1,-2,-2,-1,"w1920","Motorized",0,"Thu","weekday"
"8280",2020-03-19,"Gothic Rd","3","3","3",11.8,0.1,43,0,27,27.4,-1,-1,0,1,-1,-2,-2,-1,"w1920","Hybrid",0,"Thu","weekday"
"8281",2020-03-20,"Gothic Rd","3","3","2",12.7,0.9,52,9,26,24.4,0,-1,-1,0,9,8,7,7,"w1920","Non.motorized",7,"Fri","weekday"
"8282",2020-03-20,"Gothic Rd","3","3","2",12.7,0.9,52,9,26,24.4,0,-1,-1,0,9,8,7,7,"w1920","Mechanized",1,"Fri","weekday"
"8283",2020-03-20,"Gothic Rd","3","3","2",12.7,0.9,52,9,26,24.4,0,-1,-1,0,9,8,7,7,"w1920","Motorized",1,"Fri","weekday"
"8284",2020-03-20,"Gothic Rd","3","3","2",12.7,0.9,52,9,26,24.4,0,-1,-1,0,9,8,7,7,"w1920","Hybrid",0,"Fri","weekday"
"8285",2020-03-21,"Gothic Rd","3","3","2",12.8,0.1,54,2,26,23.7,9,0,-1,-1,11,11,10,9,"w1920","Non.motorized",21,"Sat","weekend"
"8286",2020-03-21,"Gothic Rd","3","3","2",12.8,0.1,54,2,26,23.7,9,0,-1,-1,11,11,10,9,"w1920","Mechanized",2,"Sat","weekend"
"8287",2020-03-21,"Gothic Rd","3","3","2",12.8,0.1,54,2,26,23.7,9,0,-1,-1,11,11,10,9,"w1920","Motorized",0,"Sat","weekend"
"8288",2020-03-21,"Gothic Rd","3","3","2",12.8,0.1,54,2,26,23.7,9,0,-1,-1,11,11,10,9,"w1920","Hybrid",0,"Sat","weekend"
"8289",2020-03-22,"Gothic Rd","2","2","2",13,0.2,53,-1,28,24.5,2,9,0,-1,1,10,10,9,"w1920","Non.motorized",27,"Sun","weekend"
"8290",2020-03-22,"Gothic Rd","2","2","2",13,0.2,53,-1,28,24.5,2,9,0,-1,1,10,10,9,"w1920","Mechanized",3,"Sun","weekend"
"8291",2020-03-22,"Gothic Rd","2","2","2",13,0.2,53,-1,28,24.5,2,9,0,-1,1,10,10,9,"w1920","Motorized",0,"Sun","weekend"
"8292",2020-03-22,"Gothic Rd","2","2","2",13,0.2,53,-1,28,24.5,2,9,0,-1,1,10,10,9,"w1920","Hybrid",0,"Sun","weekend"
"8293",2020-03-23,"Gothic Rd","2","2","2",13,0,53,0,28,24.5,-1,2,9,0,-1,1,10,10,"w1920","Non.motorized",13,"Mon","weekday"
"8294",2020-03-23,"Gothic Rd","2","2","2",13,0,53,0,28,24.5,-1,2,9,0,-1,1,10,10,"w1920","Mechanized",1,"Mon","weekday"
"8295",2020-03-23,"Gothic Rd","2","2","2",13,0,53,0,28,24.5,-1,2,9,0,-1,1,10,10,"w1920","Motorized",0,"Mon","weekday"
"8296",2020-03-23,"Gothic Rd","2","2","2",13,0,53,0,28,24.5,-1,2,9,0,-1,1,10,10,"w1920","Hybrid",0,"Mon","weekday"
"8297",2020-03-24,"Gothic Rd","2","2","2",13.2,0.2,53,0,32,24.9,0,-1,2,9,0,-1,1,10,"w1920","Non.motorized",15,"Tue","weekday"
"8298",2020-03-24,"Gothic Rd","2","2","2",13.2,0.2,53,0,32,24.9,0,-1,2,9,0,-1,1,10,"w1920","Mechanized",1,"Tue","weekday"
"8299",2020-03-24,"Gothic Rd","2","2","2",13.2,0.2,53,0,32,24.9,0,-1,2,9,0,-1,1,10,"w1920","Motorized",0,"Tue","weekday"
"8300",2020-03-24,"Gothic Rd","2","2","2",13.2,0.2,53,0,32,24.9,0,-1,2,9,0,-1,1,10,"w1920","Hybrid",0,"Tue","weekday"
"8301",2020-03-25,"Gothic Rd","2","2","2",13.3,0.1,51,-2,34,26.1,0,0,-1,2,-2,-2,-3,-1,"w1920","Non.motorized",11,"Wed","weekday"
"8302",2020-03-25,"Gothic Rd","2","2","2",13.3,0.1,51,-2,34,26.1,0,0,-1,2,-2,-2,-3,-1,"w1920","Mechanized",1,"Wed","weekday"
"8303",2020-03-25,"Gothic Rd","2","2","2",13.3,0.1,51,-2,34,26.1,0,0,-1,2,-2,-2,-3,-1,"w1920","Motorized",1,"Wed","weekday"
"8304",2020-03-25,"Gothic Rd","2","2","2",13.3,0.1,51,-2,34,26.1,0,0,-1,2,-2,-2,-3,-1,"w1920","Hybrid",0,"Wed","weekday"
"8305",2020-03-26,"Gothic Rd","2","2","2",13.3,0,50,-1,36,26.6,-2,0,0,-1,-3,-3,-3,-4,"w1920","Non.motorized",9,"Thu","weekday"
"8306",2020-03-26,"Gothic Rd","2","2","2",13.3,0,50,-1,36,26.6,-2,0,0,-1,-3,-3,-3,-4,"w1920","Mechanized",1,"Thu","weekday"
"8307",2020-03-26,"Gothic Rd","2","2","2",13.3,0,50,-1,36,26.6,-2,0,0,-1,-3,-3,-3,-4,"w1920","Motorized",1,"Thu","weekday"
"8308",2020-03-26,"Gothic Rd","2","2","2",13.3,0,50,-1,36,26.6,-2,0,0,-1,-3,-3,-3,-4,"w1920","Hybrid",0,"Thu","weekday"
"8309",2020-03-26,"Gothic Rd","3","3","2",13.3,0,50,-1,36,26.6,-2,0,0,-1,-3,-3,-3,-4,"w1920","Non.motorized",9,"Thu","weekday"
"8310",2020-03-26,"Gothic Rd","3","3","2",13.3,0,50,-1,36,26.6,-2,0,0,-1,-3,-3,-3,-4,"w1920","Mechanized",1,"Thu","weekday"
"8311",2020-03-26,"Gothic Rd","3","3","2",13.3,0,50,-1,36,26.6,-2,0,0,-1,-3,-3,-3,-4,"w1920","Motorized",1,"Thu","weekday"
"8312",2020-03-26,"Gothic Rd","3","3","2",13.3,0,50,-1,36,26.6,-2,0,0,-1,-3,-3,-3,-4,"w1920","Hybrid",0,"Thu","weekday"
"8313",2020-03-27,"Gothic Rd","3","3","2",13.3,0,50,0,23,26.6,-1,-2,0,0,-1,-3,-3,-3,"w1920","Non.motorized",NA,"Fri","weekday"
"8314",2020-03-27,"Gothic Rd","3","3","2",13.3,0,50,0,23,26.6,-1,-2,0,0,-1,-3,-3,-3,"w1920","Mechanized",NA,"Fri","weekday"
"8315",2020-03-27,"Gothic Rd","3","3","2",13.3,0,50,0,23,26.6,-1,-2,0,0,-1,-3,-3,-3,"w1920","Motorized",NA,"Fri","weekday"
"8316",2020-03-27,"Gothic Rd","3","3","2",13.3,0,50,0,23,26.6,-1,-2,0,0,-1,-3,-3,-3,"w1920","Hybrid",NA,"Fri","weekday"
"8317",2020-03-28,"Gothic Rd","3","3","3",13.3,0,50,0,18,26.6,0,-1,-2,0,0,-1,-3,-3,"w1920","Non.motorized",27,"Sat","weekend"
"8318",2020-03-28,"Gothic Rd","3","3","3",13.3,0,50,0,18,26.6,0,-1,-2,0,0,-1,-3,-3,"w1920","Mechanized",0,"Sat","weekend"
"8319",2020-03-28,"Gothic Rd","3","3","3",13.3,0,50,0,18,26.6,0,-1,-2,0,0,-1,-3,-3,"w1920","Motorized",0,"Sat","weekend"
"8320",2020-03-28,"Gothic Rd","3","3","3",13.3,0,50,0,18,26.6,0,-1,-2,0,0,-1,-3,-3,"w1920","Hybrid",0,"Sat","weekend"
"8321",2020-03-29,"Gothic Rd","2","2","2",13.3,0,49,-1,24,27.1,0,0,-1,-2,-1,-1,-2,-4,"w1920","Non.motorized",11,"Sun","weekend"
"8322",2020-03-29,"Gothic Rd","2","2","2",13.3,0,49,-1,24,27.1,0,0,-1,-2,-1,-1,-2,-4,"w1920","Mechanized",1,"Sun","weekend"
"8323",2020-03-29,"Gothic Rd","2","2","2",13.3,0,49,-1,24,27.1,0,0,-1,-2,-1,-1,-2,-4,"w1920","Motorized",0,"Sun","weekend"
"8324",2020-03-29,"Gothic Rd","2","2","2",13.3,0,49,-1,24,27.1,0,0,-1,-2,-1,-1,-2,-4,"w1920","Hybrid",0,"Sun","weekend"
"8325",2020-03-30,"Gothic Rd","2","2","2",13.4,0.1,49,0,29,27.3,-1,0,0,-1,-1,-1,-1,-2,"w1920","Non.motorized",8,"Mon","weekday"
"8326",2020-03-30,"Gothic Rd","2","2","2",13.4,0.1,49,0,29,27.3,-1,0,0,-1,-1,-1,-1,-2,"w1920","Mechanized",0,"Mon","weekday"
"8327",2020-03-30,"Gothic Rd","2","2","2",13.4,0.1,49,0,29,27.3,-1,0,0,-1,-1,-1,-1,-2,"w1920","Motorized",0,"Mon","weekday"
"8328",2020-03-30,"Gothic Rd","2","2","2",13.4,0.1,49,0,29,27.3,-1,0,0,-1,-1,-1,-1,-2,"w1920","Hybrid",0,"Mon","weekday"
"8329",2020-03-31,"Gothic Rd","2","2","2",13.6,0.2,51,2,35,26.7,0,-1,0,0,2,1,1,1,"w1920","Non.motorized",5,"Tue","weekday"
"8330",2020-03-31,"Gothic Rd","2","2","2",13.6,0.2,51,2,35,26.7,0,-1,0,0,2,1,1,1,"w1920","Mechanized",1,"Tue","weekday"
"8331",2020-03-31,"Gothic Rd","2","2","2",13.6,0.2,51,2,35,26.7,0,-1,0,0,2,1,1,1,"w1920","Motorized",1,"Tue","weekday"
"8332",2020-03-31,"Gothic Rd","2","2","2",13.6,0.2,51,2,35,26.7,0,-1,0,0,2,1,1,1,"w1920","Hybrid",0,"Tue","weekday"
"8333",2020-04-01,"Gothic Rd","2","2","2",13.6,0,47,-4,39,28.9,2,0,-1,0,-2,-2,-3,-3,"w1920","Non.motorized",6,"Wed","weekday"
"8334",2020-04-01,"Gothic Rd","2","2","2",13.6,0,47,-4,39,28.9,2,0,-1,0,-2,-2,-3,-3,"w1920","Mechanized",1,"Wed","weekday"
"8335",2020-04-01,"Gothic Rd","2","2","2",13.6,0,47,-4,39,28.9,2,0,-1,0,-2,-2,-3,-3,"w1920","Motorized",1,"Wed","weekday"
"8336",2020-04-01,"Gothic Rd","2","2","2",13.6,0,47,-4,39,28.9,2,0,-1,0,-2,-2,-3,-3,"w1920","Hybrid",0,"Wed","weekday"
"8337",2020-04-02,"Gothic Rd","2","2","2",13.6,0,46,-1,31,29.6,-4,2,0,-1,-5,-3,-3,-4,"w1920","Non.motorized",5,"Thu","weekday"
"8338",2020-04-02,"Gothic Rd","2","2","2",13.6,0,46,-1,31,29.6,-4,2,0,-1,-5,-3,-3,-4,"w1920","Mechanized",0,"Thu","weekday"
"8339",2020-04-02,"Gothic Rd","2","2","2",13.6,0,46,-1,31,29.6,-4,2,0,-1,-5,-3,-3,-4,"w1920","Motorized",1,"Thu","weekday"
"8340",2020-04-02,"Gothic Rd","2","2","2",13.6,0,46,-1,31,29.6,-4,2,0,-1,-5,-3,-3,-4,"w1920","Hybrid",0,"Thu","weekday"
"8341",2020-04-03,"Gothic Rd","2","2","2",13.6,0,46,0,28,29.6,-1,-4,2,0,-1,-5,-3,-3,"w1920","Non.motorized",5,"Fri","weekday"
"8342",2020-04-03,"Gothic Rd","2","2","2",13.6,0,46,0,28,29.6,-1,-4,2,0,-1,-5,-3,-3,"w1920","Mechanized",0,"Fri","weekday"
"8343",2020-04-03,"Gothic Rd","2","2","2",13.6,0,46,0,28,29.6,-1,-4,2,0,-1,-5,-3,-3,"w1920","Motorized",0,"Fri","weekday"
"8344",2020-04-03,"Gothic Rd","2","2","2",13.6,0,46,0,28,29.6,-1,-4,2,0,-1,-5,-3,-3,"w1920","Hybrid",0,"Fri","weekday"
"8345",2020-04-04,"Gothic Rd","2","2","2",13.6,0,45,-1,33,30.2,0,-1,-4,2,-1,-2,-6,-4,"w1920","Non.motorized",11,"Sat","weekend"
"8346",2020-04-04,"Gothic Rd","2","2","2",13.6,0,45,-1,33,30.2,0,-1,-4,2,-1,-2,-6,-4,"w1920","Mechanized",0,"Sat","weekend"
"8347",2020-04-04,"Gothic Rd","2","2","2",13.6,0,45,-1,33,30.2,0,-1,-4,2,-1,-2,-6,-4,"w1920","Motorized",1,"Sat","weekend"
"8348",2020-04-04,"Gothic Rd","2","2","2",13.6,0,45,-1,33,30.2,0,-1,-4,2,-1,-2,-6,-4,"w1920","Hybrid",0,"Sat","weekend"
"8349",2020-04-05,"Gothic Rd","2","2","3",13.6,0,45,0,38,30.2,-1,0,-1,-4,-1,-1,-2,-6,"w1920","Non.motorized",14,"Sun","weekend"
"8350",2020-04-05,"Gothic Rd","2","2","3",13.6,0,45,0,38,30.2,-1,0,-1,-4,-1,-1,-2,-6,"w1920","Mechanized",0,"Sun","weekend"
"8351",2020-04-05,"Gothic Rd","2","2","3",13.6,0,45,0,38,30.2,-1,0,-1,-4,-1,-1,-2,-6,"w1920","Motorized",0,"Sun","weekend"
"8352",2020-04-05,"Gothic Rd","2","2","3",13.6,0,45,0,38,30.2,-1,0,-1,-4,-1,-1,-2,-6,"w1920","Hybrid",0,"Sun","weekend"
"8353",2020-04-06,"Gothic Rd","2","2","3",13.6,0,44,-1,40,30.9,0,-1,0,-1,-1,-2,-2,-3,"w1920","Non.motorized",1,"Mon","weekday"
"8354",2020-04-06,"Gothic Rd","2","2","3",13.6,0,44,-1,40,30.9,0,-1,0,-1,-1,-2,-2,-3,"w1920","Mechanized",2,"Mon","weekday"
"8355",2020-04-06,"Gothic Rd","2","2","3",13.6,0,44,-1,40,30.9,0,-1,0,-1,-1,-2,-2,-3,"w1920","Motorized",0,"Mon","weekday"
"8356",2020-04-06,"Gothic Rd","2","2","3",13.6,0,44,-1,40,30.9,0,-1,0,-1,-1,-2,-2,-3,"w1920","Hybrid",0,"Mon","weekday"
"8357",2020-04-07,"Gothic Rd","2","2","3",13.4,-0.2,43,-1,39,31.2,-1,0,-1,0,-2,-2,-3,-3,"w1920","Non.motorized",NA,"Tue","weekday"
"8358",2020-04-07,"Gothic Rd","2","2","3",13.4,-0.2,43,-1,39,31.2,-1,0,-1,0,-2,-2,-3,-3,"w1920","Mechanized",NA,"Tue","weekday"
"8359",2020-04-07,"Gothic Rd","2","2","3",13.4,-0.2,43,-1,39,31.2,-1,0,-1,0,-2,-2,-3,-3,"w1920","Motorized",NA,"Tue","weekday"
"8360",2020-04-07,"Gothic Rd","2","2","3",13.4,-0.2,43,-1,39,31.2,-1,0,-1,0,-2,-2,-3,-3,"w1920","Hybrid",NA,"Tue","weekday"
"8361",2020-04-08,"Gothic Rd","2","3","3",13.3,-0.1,42,-1,40,31.7,-1,-1,0,-1,-2,-3,-3,-4,"w1920","Non.motorized",NA,"Wed","weekday"
"8362",2020-04-08,"Gothic Rd","2","3","3",13.3,-0.1,42,-1,40,31.7,-1,-1,0,-1,-2,-3,-3,-4,"w1920","Mechanized",NA,"Wed","weekday"
"8363",2020-04-08,"Gothic Rd","2","3","3",13.3,-0.1,42,-1,40,31.7,-1,-1,0,-1,-2,-3,-3,-4,"w1920","Motorized",NA,"Wed","weekday"
"8364",2020-04-08,"Gothic Rd","2","3","3",13.3,-0.1,42,-1,40,31.7,-1,-1,0,-1,-2,-3,-3,-4,"w1920","Hybrid",NA,"Wed","weekday"
"8365",2020-04-09,"Gothic Rd","2","3","3",13.1,-0.2,40,-2,42,32.8,-1,-1,-1,0,-3,-4,-5,-5,"w1920","Non.motorized",NA,"Thu","weekday"
"8366",2020-04-09,"Gothic Rd","2","3","3",13.1,-0.2,40,-2,42,32.8,-1,-1,-1,0,-3,-4,-5,-5,"w1920","Mechanized",NA,"Thu","weekday"
"8367",2020-04-09,"Gothic Rd","2","3","3",13.1,-0.2,40,-2,42,32.8,-1,-1,-1,0,-3,-4,-5,-5,"w1920","Motorized",NA,"Thu","weekday"
"8368",2020-04-09,"Gothic Rd","2","3","3",13.1,-0.2,40,-2,42,32.8,-1,-1,-1,0,-3,-4,-5,-5,"w1920","Hybrid",NA,"Thu","weekday"
"8369",2020-04-10,"Gothic Rd","3","3","3",12.9,-0.2,39,-1,38,33.1,-2,-1,-1,-1,-3,-4,-5,-6,"w1920","Non.motorized",NA,"Fri","weekday"
"8370",2020-04-10,"Gothic Rd","3","3","3",12.9,-0.2,39,-1,38,33.1,-2,-1,-1,-1,-3,-4,-5,-6,"w1920","Mechanized",NA,"Fri","weekday"
"8371",2020-04-10,"Gothic Rd","3","3","3",12.9,-0.2,39,-1,38,33.1,-2,-1,-1,-1,-3,-4,-5,-6,"w1920","Motorized",NA,"Fri","weekday"
"8372",2020-04-10,"Gothic Rd","3","3","3",12.9,-0.2,39,-1,38,33.1,-2,-1,-1,-1,-3,-4,-5,-6,"w1920","Hybrid",NA,"Fri","weekday"
"8373",2020-04-11,"Gothic Rd","2","3","3",12.9,0,39,0,36,33.1,-1,-2,-1,-1,-1,-3,-4,-5,"w1920","Non.motorized",NA,"Sat","weekend"
"8374",2020-04-11,"Gothic Rd","2","3","3",12.9,0,39,0,36,33.1,-1,-2,-1,-1,-1,-3,-4,-5,"w1920","Mechanized",NA,"Sat","weekend"
"8375",2020-04-11,"Gothic Rd","2","3","3",12.9,0,39,0,36,33.1,-1,-2,-1,-1,-1,-3,-4,-5,"w1920","Motorized",NA,"Sat","weekend"
"8376",2020-04-11,"Gothic Rd","2","3","3",12.9,0,39,0,36,33.1,-1,-2,-1,-1,-1,-3,-4,-5,"w1920","Hybrid",NA,"Sat","weekend"
"8377",2020-04-12,"Gothic Rd","2","2","2",12.8,-0.1,38,-1,29,33.7,0,-1,-2,-1,-1,-2,-4,-5,"w1920","Non.motorized",NA,"Sun","weekend"
"8378",2020-04-12,"Gothic Rd","2","2","2",12.8,-0.1,38,-1,29,33.7,0,-1,-2,-1,-1,-2,-4,-5,"w1920","Mechanized",NA,"Sun","weekend"
"8379",2020-04-12,"Gothic Rd","2","2","2",12.8,-0.1,38,-1,29,33.7,0,-1,-2,-1,-1,-2,-4,-5,"w1920","Motorized",NA,"Sun","weekend"
"8380",2020-04-12,"Gothic Rd","2","2","2",12.8,-0.1,38,-1,29,33.7,0,-1,-2,-1,-1,-2,-4,-5,"w1920","Hybrid",NA,"Sun","weekend"
"8381",2020-04-13,"Gothic Rd",NA,NA,NA,12.9,0.1,39,1,20,33.1,-1,0,-1,-2,0,0,-1,-3,"w1920","Non.motorized",NA,"Mon","weekday"
"8382",2020-04-13,"Gothic Rd",NA,NA,NA,12.9,0.1,39,1,20,33.1,-1,0,-1,-2,0,0,-1,-3,"w1920","Mechanized",NA,"Mon","weekday"
"8383",2020-04-13,"Gothic Rd",NA,NA,NA,12.9,0.1,39,1,20,33.1,-1,0,-1,-2,0,0,-1,-3,"w1920","Motorized",NA,"Mon","weekday"
"8384",2020-04-13,"Gothic Rd",NA,NA,NA,12.9,0.1,39,1,20,33.1,-1,0,-1,-2,0,0,-1,-3,"w1920","Hybrid",NA,"Mon","weekday"
"8385",2020-04-14,"Gothic Rd","2","2","2",13,0.1,39,0,18,33.3,1,-1,0,-1,1,0,0,-1,"w1920","Non.motorized",NA,"Tue","weekday"
"8386",2020-04-14,"Gothic Rd","2","2","2",13,0.1,39,0,18,33.3,1,-1,0,-1,1,0,0,-1,"w1920","Mechanized",NA,"Tue","weekday"
"8387",2020-04-14,"Gothic Rd","2","2","2",13,0.1,39,0,18,33.3,1,-1,0,-1,1,0,0,-1,"w1920","Motorized",NA,"Tue","weekday"
"8388",2020-04-14,"Gothic Rd","2","2","2",13,0.1,39,0,18,33.3,1,-1,0,-1,1,0,0,-1,"w1920","Hybrid",NA,"Tue","weekday"
"8389",2020-04-15,"Gothic Rd",NA,NA,NA,13.2,0.2,39,0,28,33.8,0,1,-1,0,0,1,0,0,"w1920","Non.motorized",NA,"Wed","weekday"
"8390",2020-04-15,"Gothic Rd",NA,NA,NA,13.2,0.2,39,0,28,33.8,0,1,-1,0,0,1,0,0,"w1920","Mechanized",NA,"Wed","weekday"
"8391",2020-04-15,"Gothic Rd",NA,NA,NA,13.2,0.2,39,0,28,33.8,0,1,-1,0,0,1,0,0,"w1920","Motorized",NA,"Wed","weekday"
"8392",2020-04-15,"Gothic Rd",NA,NA,NA,13.2,0.2,39,0,28,33.8,0,1,-1,0,0,1,0,0,"w1920","Hybrid",NA,"Wed","weekday"
"8393",2019-12-06,"Kebler","2","2","1",2.9,0.4,19,5,24,15.3,0,0,0,0,5,5,5,5,"w1920","Non.motorized",6,"Fri","weekday"
"8394",2019-12-06,"Kebler","2","2","1",2.9,0.4,19,5,24,15.3,0,0,0,0,5,5,5,5,"w1920","Mechanized",2,"Fri","weekday"
"8395",2019-12-06,"Kebler","2","2","1",2.9,0.4,19,5,24,15.3,0,0,0,0,5,5,5,5,"w1920","Motorized",8,"Fri","weekday"
"8396",2019-12-06,"Kebler","2","2","1",2.9,0.4,19,5,24,15.3,0,0,0,0,5,5,5,5,"w1920","Hybrid",NA,"Fri","weekday"
"8397",2019-12-07,"Kebler","2","2","1",3,0.1,18,-1,29,16.7,5,0,0,0,4,4,4,4,"w1920","Non.motorized",9,"Sat","weekend"
"8398",2019-12-07,"Kebler","2","2","1",3,0.1,18,-1,29,16.7,5,0,0,0,4,4,4,4,"w1920","Mechanized",0,"Sat","weekend"
"8399",2019-12-07,"Kebler","2","2","1",3,0.1,18,-1,29,16.7,5,0,0,0,4,4,4,4,"w1920","Motorized",38,"Sat","weekend"
"8400",2019-12-07,"Kebler","2","2","1",3,0.1,18,-1,29,16.7,5,0,0,0,4,4,4,4,"w1920","Hybrid",NA,"Sat","weekend"
"8401",2019-12-08,"Kebler","2","2","1",3,0,17,-1,28,17.6,-1,5,0,0,-2,3,3,3,"w1920","Non.motorized",8,"Sun","weekend"
"8402",2019-12-08,"Kebler","2","2","1",3,0,17,-1,28,17.6,-1,5,0,0,-2,3,3,3,"w1920","Mechanized",0,"Sun","weekend"
"8403",2019-12-08,"Kebler","2","2","1",3,0,17,-1,28,17.6,-1,5,0,0,-2,3,3,3,"w1920","Motorized",16,"Sun","weekend"
"8404",2019-12-08,"Kebler","2","2","1",3,0,17,-1,28,17.6,-1,5,0,0,-2,3,3,3,"w1920","Hybrid",NA,"Sun","weekend"
"8405",2019-12-09,"Kebler","3","3","2",3.4,0.4,22,5,21,15.5,-1,-1,5,0,4,3,8,8,"w1920","Non.motorized",13,"Mon","weekday"
"8406",2019-12-09,"Kebler","3","3","2",3.4,0.4,22,5,21,15.5,-1,-1,5,0,4,3,8,8,"w1920","Mechanized",0,"Mon","weekday"
"8407",2019-12-09,"Kebler","3","3","2",3.4,0.4,22,5,21,15.5,-1,-1,5,0,4,3,8,8,"w1920","Motorized",36,"Mon","weekday"
"8408",2019-12-09,"Kebler","3","3","2",3.4,0.4,22,5,21,15.5,-1,-1,5,0,4,3,8,8,"w1920","Hybrid",NA,"Mon","weekday"
"8409",2020-12-10,"Kebler",NA,NA,NA,NA,NA,NA,NA,NA,NA,NA,NA,NA,NA,NA,NA,NA,NA,"w1920","Non.motorized",16,"Thu","weekday"
"8410",2020-12-10,"Kebler",NA,NA,NA,NA,NA,NA,NA,NA,NA,NA,NA,NA,NA,NA,NA,NA,NA,"w1920","Mechanized",0,"Thu","weekday"
"8411",2020-12-10,"Kebler",NA,NA,NA,NA,NA,NA,NA,NA,NA,NA,NA,NA,NA,NA,NA,NA,NA,"w1920","Motorized",36,"Thu","weekday"
"8412",2020-12-10,"Kebler",NA,NA,NA,NA,NA,NA,NA,NA,NA,NA,NA,NA,NA,NA,NA,NA,NA,"w1920","Hybrid",NA,"Thu","weekday"
"8413",2019-12-11,"Kebler","2","2","2",3.4,0,20,-1,22,17,-1,5,-1,-1,-2,3,2,1,"w1920","Non.motorized",3,"Wed","weekday"
"8414",2019-12-11,"Kebler","2","2","2",3.4,0,20,-1,22,17,-1,5,-1,-1,-2,3,2,1,"w1920","Mechanized",0,"Wed","weekday"
"8415",2019-12-11,"Kebler","2","2","2",3.4,0,20,-1,22,17,-1,5,-1,-1,-2,3,2,1,"w1920","Motorized",39,"Wed","weekday"
"8416",2019-12-11,"Kebler","2","2","2",3.4,0,20,-1,22,17,-1,5,-1,-1,-2,3,2,1,"w1920","Hybrid",NA,"Wed","weekday"
"8417",2019-12-12,"Kebler","2","2","2",3.4,0,19,-1,25,17.9,-1,-1,5,-1,-2,-3,2,1,"w1920","Non.motorized",2,"Thu","weekday"
"8418",2019-12-12,"Kebler","2","2","2",3.4,0,19,-1,25,17.9,-1,-1,5,-1,-2,-3,2,1,"w1920","Mechanized",0,"Thu","weekday"
"8419",2019-12-12,"Kebler","2","2","2",3.4,0,19,-1,25,17.9,-1,-1,5,-1,-2,-3,2,1,"w1920","Motorized",29,"Thu","weekday"
"8420",2019-12-12,"Kebler","2","2","2",3.4,0,19,-1,25,17.9,-1,-1,5,-1,-2,-3,2,1,"w1920","Hybrid",NA,"Thu","weekday"
"8421",2019-12-13,"Kebler","2","2","2",3.8,0.4,21,2,24,18.1,-1,-1,-1,5,1,0,-1,4,"w1920","Non.motorized",10,"Fri","weekday"
"8422",2019-12-13,"Kebler","2","2","2",3.8,0.4,21,2,24,18.1,-1,-1,-1,5,1,0,-1,4,"w1920","Mechanized",0,"Fri","weekday"
"8423",2019-12-13,"Kebler","2","2","2",3.8,0.4,21,2,24,18.1,-1,-1,-1,5,1,0,-1,4,"w1920","Motorized",32,"Fri","weekday"
"8424",2019-12-13,"Kebler","2","2","2",3.8,0.4,21,2,24,18.1,-1,-1,-1,5,1,0,-1,4,"w1920","Hybrid",NA,"Fri","weekday"
"8425",2019-12-14,"Kebler","3","3","3",4.2,0.4,27,6,25,15.6,2,-1,-1,-1,8,7,6,5,"w1920","Non.motorized",3,"Sat","weekend"
"8426",2019-12-14,"Kebler","3","3","3",4.2,0.4,27,6,25,15.6,2,-1,-1,-1,8,7,6,5,"w1920","Mechanized",1,"Sat","weekend"
"8427",2019-12-14,"Kebler","3","3","3",4.2,0.4,27,6,25,15.6,2,-1,-1,-1,8,7,6,5,"w1920","Motorized",32,"Sat","weekend"
"8428",2019-12-14,"Kebler","3","3","3",4.2,0.4,27,6,25,15.6,2,-1,-1,-1,8,7,6,5,"w1920","Hybrid",NA,"Sat","weekend"
"8429",2019-12-15,"Kebler","3","3","2",4.8,0.6,31,4,17,15.5,6,2,-1,-1,10,12,11,10,"w1920","Non.motorized",20,"Sun","weekend"
"8430",2019-12-15,"Kebler","3","3","2",4.8,0.6,31,4,17,15.5,6,2,-1,-1,10,12,11,10,"w1920","Mechanized",1,"Sun","weekend"
"8431",2019-12-15,"Kebler","3","3","2",4.8,0.6,31,4,17,15.5,6,2,-1,-1,10,12,11,10,"w1920","Motorized",70,"Sun","weekend"
"8432",2019-12-15,"Kebler","3","3","2",4.8,0.6,31,4,17,15.5,6,2,-1,-1,10,12,11,10,"w1920","Hybrid",NA,"Sun","weekend"
"8433",2019-12-16,"Kebler","3","3","2",4.8,0,29,-2,6,16.6,4,6,2,-1,2,8,10,9,"w1920","Non.motorized",12,"Mon","weekday"
"8434",2019-12-16,"Kebler","3","3","2",4.8,0,29,-2,6,16.6,4,6,2,-1,2,8,10,9,"w1920","Mechanized",0,"Mon","weekday"
"8435",2019-12-16,"Kebler","3","3","2",4.8,0,29,-2,6,16.6,4,6,2,-1,2,8,10,9,"w1920","Motorized",68,"Mon","weekday"
"8436",2019-12-16,"Kebler","3","3","2",4.8,0,29,-2,6,16.6,4,6,2,-1,2,8,10,9,"w1920","Hybrid",NA,"Mon","weekday"
"8437",2019-12-17,"Kebler","2","2","1",4.8,0,27,-2,8,17.8,-2,4,6,2,-4,0,6,8,"w1920","Non.motorized",10,"Tue","weekday"
"8438",2019-12-17,"Kebler","2","2","1",4.8,0,27,-2,8,17.8,-2,4,6,2,-4,0,6,8,"w1920","Mechanized",3,"Tue","weekday"
"8439",2019-12-17,"Kebler","2","2","1",4.8,0,27,-2,8,17.8,-2,4,6,2,-4,0,6,8,"w1920","Motorized",36,"Tue","weekday"
"8440",2019-12-17,"Kebler","2","2","1",4.8,0,27,-2,8,17.8,-2,4,6,2,-4,0,6,8,"w1920","Hybrid",NA,"Tue","weekday"
"8441",2019-12-18,"Kebler","2","2","1",4.8,0,26,-1,20,18.5,-2,-2,4,6,-3,-5,-1,5,"w1920","Non.motorized",9,"Wed","weekday"
"8442",2019-12-18,"Kebler","2","2","1",4.8,0,26,-1,20,18.5,-2,-2,4,6,-3,-5,-1,5,"w1920","Mechanized",0,"Wed","weekday"
"8443",2019-12-18,"Kebler","2","2","1",4.8,0,26,-1,20,18.5,-2,-2,4,6,-3,-5,-1,5,"w1920","Motorized",52,"Wed","weekday"
"8444",2019-12-18,"Kebler","2","2","1",4.8,0,26,-1,20,18.5,-2,-2,4,6,-3,-5,-1,5,"w1920","Hybrid",NA,"Wed","weekday"
"8445",2019-12-19,"Kebler","2","2","1",4.9,0.1,25,-1,21,19.6,-1,-2,-2,4,-2,-4,-6,-2,"w1920","Non.motorized",12,"Thu","weekday"
"8446",2019-12-19,"Kebler","2","2","1",4.9,0.1,25,-1,21,19.6,-1,-2,-2,4,-2,-4,-6,-2,"w1920","Mechanized",1,"Thu","weekday"
"8447",2019-12-19,"Kebler","2","2","1",4.9,0.1,25,-1,21,19.6,-1,-2,-2,4,-2,-4,-6,-2,"w1920","Motorized",56,"Thu","weekday"
"8448",2019-12-19,"Kebler","2","2","1",4.9,0.1,25,-1,21,19.6,-1,-2,-2,4,-2,-4,-6,-2,"w1920","Hybrid",NA,"Thu","weekday"
"8449",2019-12-20,"Kebler","2","2","1",4.9,0,24,-1,21,20.4,-1,-1,-2,-2,-2,-3,-5,-7,"w1920","Non.motorized",9,"Fri","weekday"
"8450",2019-12-20,"Kebler","2","2","1",4.9,0,24,-1,21,20.4,-1,-1,-2,-2,-2,-3,-5,-7,"w1920","Mechanized",0,"Fri","weekday"
"8451",2019-12-20,"Kebler","2","2","1",4.9,0,24,-1,21,20.4,-1,-1,-2,-2,-2,-3,-5,-7,"w1920","Motorized",62,"Fri","weekday"
"8452",2019-12-20,"Kebler","2","2","1",4.9,0,24,-1,21,20.4,-1,-1,-2,-2,-2,-3,-5,-7,"w1920","Hybrid",NA,"Fri","weekday"
"8453",2019-12-21,"Kebler","2","2","1",4.9,0,24,0,27,20.4,-1,-1,-1,-2,-1,-2,-3,-5,"w1920","Non.motorized",7,"Sat","weekend"
"8454",2019-12-21,"Kebler","2","2","1",4.9,0,24,0,27,20.4,-1,-1,-1,-2,-1,-2,-3,-5,"w1920","Mechanized",0,"Sat","weekend"
"8455",2019-12-21,"Kebler","2","2","1",4.9,0,24,0,27,20.4,-1,-1,-1,-2,-1,-2,-3,-5,"w1920","Motorized",100,"Sat","weekend"
"8456",2019-12-21,"Kebler","2","2","1",4.9,0,24,0,27,20.4,-1,-1,-1,-2,-1,-2,-3,-5,"w1920","Hybrid",NA,"Sat","weekend"
"8457",2019-12-22,"Kebler","2","2","1",5,0.1,23,-1,31,21.7,0,-1,-1,-1,-1,-2,-3,-4,"w1920","Non.motorized",13,"Sun","weekend"
"8458",2019-12-22,"Kebler","2","2","1",5,0.1,23,-1,31,21.7,0,-1,-1,-1,-1,-2,-3,-4,"w1920","Mechanized",0,"Sun","weekend"
"8459",2019-12-22,"Kebler","2","2","1",5,0.1,23,-1,31,21.7,0,-1,-1,-1,-1,-2,-3,-4,"w1920","Motorized",16,"Sun","weekend"
"8460",2019-12-22,"Kebler","2","2","1",5,0.1,23,-1,31,21.7,0,-1,-1,-1,-1,-2,-3,-4,"w1920","Hybrid",NA,"Sun","weekend"
"8461",2019-12-23,"Kebler","2","1","1",5,0,23,0,34,21.7,-1,0,-1,-1,-1,-1,-2,-3,"w1920","Non.motorized",2,"Mon","weekday"
"8462",2019-12-23,"Kebler","2","1","1",5,0,23,0,34,21.7,-1,0,-1,-1,-1,-1,-2,-3,"w1920","Mechanized",1,"Mon","weekday"
"8463",2019-12-23,"Kebler","2","1","1",5,0,23,0,34,21.7,-1,0,-1,-1,-1,-1,-2,-3,"w1920","Motorized",124,"Mon","weekday"
"8464",2019-12-23,"Kebler","2","1","1",5,0,23,0,34,21.7,-1,0,-1,-1,-1,-1,-2,-3,"w1920","Hybrid",NA,"Mon","weekday"
"8465",2019-12-24,"Kebler","2","1","1",5,0,22,-1,30,22.7,0,-1,0,-1,-1,-2,-2,-3,"w1920","Non.motorized",6,"Tue","weekday"
"8466",2019-12-24,"Kebler","2","1","1",5,0,22,-1,30,22.7,0,-1,0,-1,-1,-2,-2,-3,"w1920","Mechanized",0,"Tue","weekday"
"8467",2019-12-24,"Kebler","2","1","1",5,0,22,-1,30,22.7,0,-1,0,-1,-1,-2,-2,-3,"w1920","Motorized",141,"Tue","weekday"
"8468",2019-12-24,"Kebler","2","1","1",5,0,22,-1,30,22.7,0,-1,0,-1,-1,-2,-2,-3,"w1920","Hybrid",NA,"Tue","weekday"
"8469",2019-12-25,"Kebler","2","2","2",5,0,23,1,22,21.7,-1,0,-1,0,0,0,-1,-1,"w1920","Non.motorized",2,"Wed","weekday"
"8470",2019-12-25,"Kebler","2","2","2",5,0,23,1,22,21.7,-1,0,-1,0,0,0,-1,-1,"w1920","Mechanized",0,"Wed","weekday"
"8471",2019-12-25,"Kebler","2","2","2",5,0,23,1,22,21.7,-1,0,-1,0,0,0,-1,-1,"w1920","Motorized",154,"Wed","weekday"
"8472",2019-12-25,"Kebler","2","2","2",5,0,23,1,22,21.7,-1,0,-1,0,0,0,-1,-1,"w1920","Hybrid",NA,"Wed","weekday"
"8473",2019-12-26,"Kebler","2","2","1",5,0,23,0,17,21.7,1,-1,0,-1,1,0,0,-1,"w1920","Non.motorized",10,"Thu","weekday"
"8474",2019-12-26,"Kebler","2","2","1",5,0,23,0,17,21.7,1,-1,0,-1,1,0,0,-1,"w1920","Mechanized",0,"Thu","weekday"
"8475",2019-12-26,"Kebler","2","2","1",5,0,23,0,17,21.7,1,-1,0,-1,1,0,0,-1,"w1920","Motorized",213,"Thu","weekday"
"8476",2019-12-26,"Kebler","2","2","1",5,0,23,0,17,21.7,1,-1,0,-1,1,0,0,-1,"w1920","Hybrid",NA,"Thu","weekday"
"8477",2019-12-27,"Kebler","3","3","2",5.1,0.1,24,1,22,21.2,0,1,-1,0,1,2,1,1,"w1920","Non.motorized",9,"Fri","weekday"
"8478",2019-12-27,"Kebler","3","3","2",5.1,0.1,24,1,22,21.2,0,1,-1,0,1,2,1,1,"w1920","Mechanized",0,"Fri","weekday"
"8479",2019-12-27,"Kebler","3","3","2",5.1,0.1,24,1,22,21.2,0,1,-1,0,1,2,1,1,"w1920","Motorized",159,"Fri","weekday"
"8480",2019-12-27,"Kebler","3","3","2",5.1,0.1,24,1,22,21.2,0,1,-1,0,1,2,1,1,"w1920","Hybrid",NA,"Fri","weekday"
"8481",2019-12-28,"Kebler","3","3","2",5.6,0.5,30,6,16,18.7,1,0,1,-1,7,7,8,7,"w1920","Non.motorized",23,"Sat","weekend"
"8482",2019-12-28,"Kebler","3","3","2",5.6,0.5,30,6,16,18.7,1,0,1,-1,7,7,8,7,"w1920","Mechanized",1,"Sat","weekend"
"8483",2019-12-28,"Kebler","3","3","2",5.6,0.5,30,6,16,18.7,1,0,1,-1,7,7,8,7,"w1920","Motorized",158,"Sat","weekend"
"8484",2019-12-28,"Kebler","3","3","2",5.6,0.5,30,6,16,18.7,1,0,1,-1,7,7,8,7,"w1920","Hybrid",NA,"Sat","weekend"
"8485",2019-12-29,"Kebler","3","3","2",5.6,0,29,-1,3,19.3,6,1,0,1,5,6,6,7,"w1920","Non.motorized",9,"Sun","weekend"
"8486",2019-12-29,"Kebler","3","3","2",5.6,0,29,-1,3,19.3,6,1,0,1,5,6,6,7,"w1920","Mechanized",0,"Sun","weekend"
"8487",2019-12-29,"Kebler","3","3","2",5.6,0,29,-1,3,19.3,6,1,0,1,5,6,6,7,"w1920","Motorized",146,"Sun","weekend"
"8488",2019-12-29,"Kebler","3","3","2",5.6,0,29,-1,3,19.3,6,1,0,1,5,6,6,7,"w1920","Hybrid",NA,"Sun","weekend"
"8489",2019-12-30,"Kebler","3","3","2",5.6,0,28,-1,3,20,-1,6,1,0,-2,4,5,5,"w1920","Non.motorized",5,"Mon","weekday"
"8490",2019-12-30,"Kebler","3","3","2",5.6,0,28,-1,3,20,-1,6,1,0,-2,4,5,5,"w1920","Mechanized",0,"Mon","weekday"
"8491",2019-12-30,"Kebler","3","3","2",5.6,0,28,-1,3,20,-1,6,1,0,-2,4,5,5,"w1920","Motorized",163,"Mon","weekday"
"8492",2019-12-30,"Kebler","3","3","2",5.6,0,28,-1,3,20,-1,6,1,0,-2,4,5,5,"w1920","Hybrid",NA,"Mon","weekday"
"8493",2019-12-31,"Kebler","2","2","1",5.6,0,28,0,13,20,-1,-1,6,1,-1,-2,4,5,"w1920","Non.motorized",21,"Tue","weekday"
"8494",2019-12-31,"Kebler","2","2","1",5.6,0,28,0,13,20,-1,-1,6,1,-1,-2,4,5,"w1920","Mechanized",0,"Tue","weekday"
"8495",2019-12-31,"Kebler","2","2","1",5.6,0,28,0,13,20,-1,-1,6,1,-1,-2,4,5,"w1920","Motorized",176,"Tue","weekday"
"8496",2019-12-31,"Kebler","2","2","1",5.6,0,28,0,13,20,-1,-1,6,1,-1,-2,4,5,"w1920","Hybrid",NA,"Tue","weekday"
"8497",2020-01-01,"Kebler","2","1","1",5.6,0,27,-1,21,20.7,0,-1,-1,6,-1,-2,-3,3,"w1920","Non.motorized",11,"Wed","weekday"
"8498",2020-01-01,"Kebler","2","1","1",5.6,0,27,-1,21,20.7,0,-1,-1,6,-1,-2,-3,3,"w1920","Mechanized",0,"Wed","weekday"
"8499",2020-01-01,"Kebler","2","1","1",5.6,0,27,-1,21,20.7,0,-1,-1,6,-1,-2,-3,3,"w1920","Motorized",92,"Wed","weekday"
"8500",2020-01-01,"Kebler","2","1","1",5.6,0,27,-1,21,20.7,0,-1,-1,6,-1,-2,-3,3,"w1920","Hybrid",NA,"Wed","weekday"
"8501",2020-01-02,"Kebler","3","3","2",5.9,0.3,29,2,16,20.3,-1,0,-1,-1,1,1,0,-1,"w1920","Non.motorized",12,"Thu","weekday"
"8502",2020-01-02,"Kebler","3","3","2",5.9,0.3,29,2,16,20.3,-1,0,-1,-1,1,1,0,-1,"w1920","Mechanized",0,"Thu","weekday"
"8503",2020-01-02,"Kebler","3","3","2",5.9,0.3,29,2,16,20.3,-1,0,-1,-1,1,1,0,-1,"w1920","Motorized",125,"Thu","weekday"
"8504",2020-01-02,"Kebler","3","3","2",5.9,0.3,29,2,16,20.3,-1,0,-1,-1,1,1,0,-1,"w1920","Hybrid",NA,"Thu","weekday"
"8505",2020-01-03,"Kebler","3","2","1",5.9,0,31,2,19,19,2,-1,0,-1,4,3,3,2,"w1920","Non.motorized",18,"Fri","weekday"
"8506",2020-01-03,"Kebler","3","2","1",5.9,0,31,2,19,19,2,-1,0,-1,4,3,3,2,"w1920","Mechanized",0,"Fri","weekday"
"8507",2020-01-03,"Kebler","3","2","1",5.9,0,31,2,19,19,2,-1,0,-1,4,3,3,2,"w1920","Motorized",140,"Fri","weekday"
"8508",2020-01-03,"Kebler","3","2","1",5.9,0,31,2,19,19,2,-1,0,-1,4,3,3,2,"w1920","Hybrid",NA,"Fri","weekday"
"8509",2020-01-04,"Kebler","2","2","1",5.9,0,30,-1,26,19.7,2,2,-1,0,1,3,2,2,"w1920","Non.motorized",15,"Sat","weekend"
"8510",2020-01-04,"Kebler","2","2","1",5.9,0,30,-1,26,19.7,2,2,-1,0,1,3,2,2,"w1920","Mechanized",1,"Sat","weekend"
"8511",2020-01-04,"Kebler","2","2","1",5.9,0,30,-1,26,19.7,2,2,-1,0,1,3,2,2,"w1920","Motorized",90,"Sat","weekend"
"8512",2020-01-04,"Kebler","2","2","1",5.9,0,30,-1,26,19.7,2,2,-1,0,1,3,2,2,"w1920","Hybrid",NA,"Sat","weekend"
"8513",2020-01-05,"Kebler","2","2","1",5.9,0,28,-2,23,21.1,-1,2,2,-1,-3,-1,1,0,"w1920","Non.motorized",7,"Sun","weekend"
"8514",2020-01-05,"Kebler","2","2","1",5.9,0,28,-2,23,21.1,-1,2,2,-1,-3,-1,1,0,"w1920","Mechanized",0,"Sun","weekend"
"8515",2020-01-05,"Kebler","2","2","1",5.9,0,28,-2,23,21.1,-1,2,2,-1,-3,-1,1,0,"w1920","Motorized",24,"Sun","weekend"
"8516",2020-01-05,"Kebler","2","2","1",5.9,0,28,-2,23,21.1,-1,2,2,-1,-3,-1,1,0,"w1920","Hybrid",NA,"Sun","weekend"
"8517",2020-01-06,"Kebler","2","2","1",5.9,0,28,0,15,21.1,-2,-1,2,2,-2,-3,-1,1,"w1920","Non.motorized",NA,"Mon","weekday"
"8518",2020-01-06,"Kebler","2","2","1",5.9,0,28,0,15,21.1,-2,-1,2,2,-2,-3,-1,1,"w1920","Mechanized",NA,"Mon","weekday"
"8519",2020-01-06,"Kebler","2","2","1",5.9,0,28,0,15,21.1,-2,-1,2,2,-2,-3,-1,1,"w1920","Motorized",NA,"Mon","weekday"
"8520",2020-01-06,"Kebler","2","2","1",5.9,0,28,0,15,21.1,-2,-1,2,2,-2,-3,-1,1,"w1920","Hybrid",NA,"Mon","weekday"
"8521",2020-01-07,"Kebler","2","1","1",5.9,0,28,0,22,21.1,0,-2,-1,2,0,-2,-3,-1,"w1920","Non.motorized",NA,"Tue","weekday"
"8522",2020-01-07,"Kebler","2","1","1",5.9,0,28,0,22,21.1,0,-2,-1,2,0,-2,-3,-1,"w1920","Mechanized",NA,"Tue","weekday"
"8523",2020-01-07,"Kebler","2","1","1",5.9,0,28,0,22,21.1,0,-2,-1,2,0,-2,-3,-1,"w1920","Motorized",NA,"Tue","weekday"
"8524",2020-01-07,"Kebler","2","1","1",5.9,0,28,0,22,21.1,0,-2,-1,2,0,-2,-3,-1,"w1920","Hybrid",NA,"Tue","weekday"
"8525",2020-01-08,"Kebler","2","1","1",6,0.1,28,0,23,21.4,0,0,-2,-1,0,0,-2,-3,"w1920","Non.motorized",NA,"Wed","weekday"
"8526",2020-01-08,"Kebler","2","1","1",6,0.1,28,0,23,21.4,0,0,-2,-1,0,0,-2,-3,"w1920","Mechanized",NA,"Wed","weekday"
"8527",2020-01-08,"Kebler","2","1","1",6,0.1,28,0,23,21.4,0,0,-2,-1,0,0,-2,-3,"w1920","Motorized",NA,"Wed","weekday"
"8528",2020-01-08,"Kebler","2","1","1",6,0.1,28,0,23,21.4,0,0,-2,-1,0,0,-2,-3,"w1920","Hybrid",NA,"Wed","weekday"
"8529",2020-01-09,"Kebler","2","1","1",6,0,27,-1,17,22.2,0,0,0,-2,-1,-1,-1,-3,"w1920","Non.motorized",NA,"Thu","weekday"
"8530",2020-01-09,"Kebler","2","1","1",6,0,27,-1,17,22.2,0,0,0,-2,-1,-1,-1,-3,"w1920","Mechanized",NA,"Thu","weekday"
"8531",2020-01-09,"Kebler","2","1","1",6,0,27,-1,17,22.2,0,0,0,-2,-1,-1,-1,-3,"w1920","Motorized",NA,"Thu","weekday"
"8532",2020-01-09,"Kebler","2","1","1",6,0,27,-1,17,22.2,0,0,0,-2,-1,-1,-1,-3,"w1920","Hybrid",NA,"Thu","weekday"
"8533",2020-01-10,"Kebler","2","1","1",6,0,29,2,11,20.7,-1,0,0,0,1,1,1,1,"w1920","Non.motorized",NA,"Fri","weekday"
"8534",2020-01-10,"Kebler","2","1","1",6,0,29,2,11,20.7,-1,0,0,0,1,1,1,1,"w1920","Mechanized",NA,"Fri","weekday"
"8535",2020-01-10,"Kebler","2","1","1",6,0,29,2,11,20.7,-1,0,0,0,1,1,1,1,"w1920","Motorized",NA,"Fri","weekday"
"8536",2020-01-10,"Kebler","2","1","1",6,0,29,2,11,20.7,-1,0,0,0,1,1,1,1,"w1920","Hybrid",NA,"Fri","weekday"
"8537",2020-01-11,"Kebler","2","1","1",6,0,29,0,12,20.7,2,-1,0,0,2,1,1,1,"w1920","Non.motorized",3,"Sat","weekend"
"8538",2020-01-11,"Kebler","2","1","1",6,0,29,0,12,20.7,2,-1,0,0,2,1,1,1,"w1920","Mechanized",0,"Sat","weekend"
"8539",2020-01-11,"Kebler","2","1","1",6,0,29,0,12,20.7,2,-1,0,0,2,1,1,1,"w1920","Motorized",23,"Sat","weekend"
"8540",2020-01-11,"Kebler","2","1","1",6,0,29,0,12,20.7,2,-1,0,0,2,1,1,1,"w1920","Hybrid",NA,"Sat","weekend"
"8541",2020-01-12,"Kebler","2","1","1",6.1,0.1,29,0,13,21,0,2,-1,0,0,2,1,1,"w1920","Non.motorized",3,"Sun","weekend"
"8542",2020-01-12,"Kebler","2","1","1",6.1,0.1,29,0,13,21,0,2,-1,0,0,2,1,1,"w1920","Mechanized",0,"Sun","weekend"
"8543",2020-01-12,"Kebler","2","1","1",6.1,0.1,29,0,13,21,0,2,-1,0,0,2,1,1,"w1920","Motorized",47,"Sun","weekend"
"8544",2020-01-12,"Kebler","2","1","1",6.1,0.1,29,0,13,21,0,2,-1,0,0,2,1,1,"w1920","Hybrid",NA,"Sun","weekend"
"8545",2020-01-13,"Kebler","2","2","1",6.2,0.1,29,0,16,21.4,0,0,2,-1,0,0,2,1,"w1920","Non.motorized",6,"Mon","weekday"
"8546",2020-01-13,"Kebler","2","2","1",6.2,0.1,29,0,16,21.4,0,0,2,-1,0,0,2,1,"w1920","Mechanized",0,"Mon","weekday"
"8547",2020-01-13,"Kebler","2","2","1",6.2,0.1,29,0,16,21.4,0,0,2,-1,0,0,2,1,"w1920","Motorized",38,"Mon","weekday"
"8548",2020-01-13,"Kebler","2","2","1",6.2,0.1,29,0,16,21.4,0,0,2,-1,0,0,2,1,"w1920","Hybrid",NA,"Mon","weekday"
"8549",2020-01-14,"Kebler","3","2","1",6.6,0.4,34,5,23,19.4,0,0,0,2,5,5,5,7,"w1920","Non.motorized",12,"Tue","weekday"
"8550",2020-01-14,"Kebler","3","2","1",6.6,0.4,34,5,23,19.4,0,0,0,2,5,5,5,7,"w1920","Mechanized",0,"Tue","weekday"
"8551",2020-01-14,"Kebler","3","2","1",6.6,0.4,34,5,23,19.4,0,0,0,2,5,5,5,7,"w1920","Motorized",37,"Tue","weekday"
"8552",2020-01-14,"Kebler","3","2","1",6.6,0.4,34,5,23,19.4,0,0,0,2,5,5,5,7,"w1920","Hybrid",NA,"Tue","weekday"
"8553",2020-01-15,"Kebler","3","2","1",6.7,0.1,32,-2,23,20.9,5,0,0,0,3,3,3,3,"w1920","Non.motorized",5,"Wed","weekday"
"8554",2020-01-15,"Kebler","3","2","1",6.7,0.1,32,-2,23,20.9,5,0,0,0,3,3,3,3,"w1920","Mechanized",0,"Wed","weekday"
"8555",2020-01-15,"Kebler","3","2","1",6.7,0.1,32,-2,23,20.9,5,0,0,0,3,3,3,3,"w1920","Motorized",27,"Wed","weekday"
"8556",2020-01-15,"Kebler","3","2","1",6.7,0.1,32,-2,23,20.9,5,0,0,0,3,3,3,3,"w1920","Hybrid",NA,"Wed","weekday"
"8557",2020-01-16,"Kebler","2","2","1",6.7,0,31,-1,28,21.6,-2,5,0,0,-3,2,2,2,"w1920","Non.motorized",1,"Thu","weekday"
"8558",2020-01-16,"Kebler","2","2","1",6.7,0,31,-1,28,21.6,-2,5,0,0,-3,2,2,2,"w1920","Mechanized",1,"Thu","weekday"
"8559",2020-01-16,"Kebler","2","2","1",6.7,0,31,-1,28,21.6,-2,5,0,0,-3,2,2,2,"w1920","Motorized",43,"Thu","weekday"
"8560",2020-01-16,"Kebler","2","2","1",6.7,0,31,-1,28,21.6,-2,5,0,0,-3,2,2,2,"w1920","Hybrid",NA,"Thu","weekday"
"8561",2020-01-17,"Kebler","2","2","1",6.8,0.1,29,-2,19,23.4,-1,-2,5,0,-3,-5,0,0,"w1920","Non.motorized",0,"Fri","weekday"
"8562",2020-01-17,"Kebler","2","2","1",6.8,0.1,29,-2,19,23.4,-1,-2,5,0,-3,-5,0,0,"w1920","Mechanized",0,"Fri","weekday"
"8563",2020-01-17,"Kebler","2","2","1",6.8,0.1,29,-2,19,23.4,-1,-2,5,0,-3,-5,0,0,"w1920","Motorized",6,"Fri","weekday"
"8564",2020-01-17,"Kebler","2","2","1",6.8,0.1,29,-2,19,23.4,-1,-2,5,0,-3,-5,0,0,"w1920","Hybrid",NA,"Fri","weekday"
"8565",2020-01-18,"Kebler","2","2","2",7,0.2,34,5,16,20.6,-2,-1,-2,5,3,2,0,5,"w1920","Non.motorized",5,"Sat","weekend"
"8566",2020-01-18,"Kebler","2","2","2",7,0.2,34,5,16,20.6,-2,-1,-2,5,3,2,0,5,"w1920","Mechanized",0,"Sat","weekend"
"8567",2020-01-18,"Kebler","2","2","2",7,0.2,34,5,16,20.6,-2,-1,-2,5,3,2,0,5,"w1920","Motorized",30,"Sat","weekend"
"8568",2020-01-18,"Kebler","2","2","2",7,0.2,34,5,16,20.6,-2,-1,-2,5,3,2,0,5,"w1920","Hybrid",NA,"Sat","weekend"
"8569",2020-01-19,"Kebler","2","2","1",7,0,33,-1,21,21.2,5,-2,-1,-2,4,2,1,-1,"w1920","Non.motorized",11,"Sun","weekend"
"8570",2020-01-19,"Kebler","2","2","1",7,0,33,-1,21,21.2,5,-2,-1,-2,4,2,1,-1,"w1920","Mechanized",0,"Sun","weekend"
"8571",2020-01-19,"Kebler","2","2","1",7,0,33,-1,21,21.2,5,-2,-1,-2,4,2,1,-1,"w1920","Motorized",65,"Sun","weekend"
"8572",2020-01-19,"Kebler","2","2","1",7,0,33,-1,21,21.2,5,-2,-1,-2,4,2,1,-1,"w1920","Hybrid",NA,"Sun","weekend"
"8573",2020-01-20,"Kebler","2","2","1",7.1,0.1,32,-1,25,22.2,-1,5,-2,-1,-2,3,1,0,"w1920","Non.motorized",2,"Mon","weekday"
"8574",2020-01-20,"Kebler","2","2","1",7.1,0.1,32,-1,25,22.2,-1,5,-2,-1,-2,3,1,0,"w1920","Mechanized",0,"Mon","weekday"
"8575",2020-01-20,"Kebler","2","2","1",7.1,0.1,32,-1,25,22.2,-1,5,-2,-1,-2,3,1,0,"w1920","Motorized",48,"Mon","weekday"
"8576",2020-01-20,"Kebler","2","2","1",7.1,0.1,32,-1,25,22.2,-1,5,-2,-1,-2,3,1,0,"w1920","Hybrid",NA,"Mon","weekday"
"8577",2020-01-21,"Kebler","2","2","1",7.1,0,31,-1,28,22.9,-1,-1,5,-2,-2,-3,2,0,"w1920","Non.motorized",4,"Tue","weekday"
"8578",2020-01-21,"Kebler","2","2","1",7.1,0,31,-1,28,22.9,-1,-1,5,-2,-2,-3,2,0,"w1920","Mechanized",1,"Tue","weekday"
"8579",2020-01-21,"Kebler","2","2","1",7.1,0,31,-1,28,22.9,-1,-1,5,-2,-2,-3,2,0,"w1920","Motorized",22,"Tue","weekday"
"8580",2020-01-21,"Kebler","2","2","1",7.1,0,31,-1,28,22.9,-1,-1,5,-2,-2,-3,2,0,"w1920","Hybrid",NA,"Tue","weekday"
"8581",2020-01-22,"Kebler","2","2","2",7.3,0.2,32,1,25,22.8,-1,-1,-1,5,0,-1,-2,3,"w1920","Non.motorized",6,"Wed","weekday"
"8582",2020-01-22,"Kebler","2","2","2",7.3,0.2,32,1,25,22.8,-1,-1,-1,5,0,-1,-2,3,"w1920","Mechanized",0,"Wed","weekday"
"8583",2020-01-22,"Kebler","2","2","2",7.3,0.2,32,1,25,22.8,-1,-1,-1,5,0,-1,-2,3,"w1920","Motorized",47,"Wed","weekday"
"8584",2020-01-22,"Kebler","2","2","2",7.3,0.2,32,1,25,22.8,-1,-1,-1,5,0,-1,-2,3,"w1920","Hybrid",NA,"Wed","weekday"
"8585",2020-01-23,"Kebler","3","2","2",7.3,0,34,2,23,21.5,1,-1,-1,-1,3,2,1,0,"w1920","Non.motorized",11,"Thu","weekday"
"8586",2020-01-23,"Kebler","3","2","2",7.3,0,34,2,23,21.5,1,-1,-1,-1,3,2,1,0,"w1920","Mechanized",0,"Thu","weekday"
"8587",2020-01-23,"Kebler","3","2","2",7.3,0,34,2,23,21.5,1,-1,-1,-1,3,2,1,0,"w1920","Motorized",37,"Thu","weekday"
"8588",2020-01-23,"Kebler","3","2","2",7.3,0,34,2,23,21.5,1,-1,-1,-1,3,2,1,0,"w1920","Hybrid",NA,"Thu","weekday"
"8589",2020-01-24,"Kebler","2","2","1",7.3,0,33,-1,23,22.1,2,1,-1,-1,1,2,1,0,"w1920","Non.motorized",2,"Fri","weekday"
"8590",2020-01-24,"Kebler","2","2","1",7.3,0,33,-1,23,22.1,2,1,-1,-1,1,2,1,0,"w1920","Mechanized",0,"Fri","weekday"
"8591",2020-01-24,"Kebler","2","2","1",7.3,0,33,-1,23,22.1,2,1,-1,-1,1,2,1,0,"w1920","Motorized",49,"Fri","weekday"
"8592",2020-01-24,"Kebler","2","2","1",7.3,0,33,-1,23,22.1,2,1,-1,-1,1,2,1,0,"w1920","Hybrid",NA,"Fri","weekday"
"8593",2020-01-25,"Kebler","2","2","1",7.4,0.1,32,-1,25,23.1,-1,2,1,-1,-2,0,1,0,"w1920","Non.motorized",6,"Sat","weekend"
"8594",2020-01-25,"Kebler","2","2","1",7.4,0.1,32,-1,25,23.1,-1,2,1,-1,-2,0,1,0,"w1920","Mechanized",0,"Sat","weekend"
"8595",2020-01-25,"Kebler","2","2","1",7.4,0.1,32,-1,25,23.1,-1,2,1,-1,-2,0,1,0,"w1920","Motorized",77,"Sat","weekend"
"8596",2020-01-25,"Kebler","2","2","1",7.4,0.1,32,-1,25,23.1,-1,2,1,-1,-2,0,1,0,"w1920","Hybrid",NA,"Sat","weekend"
"8597",2020-01-26,"Kebler","2","1","1",7.4,0,32,0,28,23.1,-1,-1,2,1,-1,-2,0,1,"w1920","Non.motorized",3,"Sun","weekend"
"8598",2020-01-26,"Kebler","2","1","1",7.4,0,32,0,28,23.1,-1,-1,2,1,-1,-2,0,1,"w1920","Mechanized",0,"Sun","weekend"
"8599",2020-01-26,"Kebler","2","1","1",7.4,0,32,0,28,23.1,-1,-1,2,1,-1,-2,0,1,"w1920","Motorized",68,"Sun","weekend"
"8600",2020-01-26,"Kebler","2","1","1",7.4,0,32,0,28,23.1,-1,-1,2,1,-1,-2,0,1,"w1920","Hybrid",NA,"Sun","weekend"
"8601",2020-01-27,"Kebler","2","1","1",7.4,0,32,0,24,23.1,0,-1,-1,2,0,-1,-2,0,"w1920","Non.motorized",3,"Mon","weekday"
"8602",2020-01-27,"Kebler","2","1","1",7.4,0,32,0,24,23.1,0,-1,-1,2,0,-1,-2,0,"w1920","Mechanized",0,"Mon","weekday"
"8603",2020-01-27,"Kebler","2","1","1",7.4,0,32,0,24,23.1,0,-1,-1,2,0,-1,-2,0,"w1920","Motorized",28,"Mon","weekday"
"8604",2020-01-27,"Kebler","2","1","1",7.4,0,32,0,24,23.1,0,-1,-1,2,0,-1,-2,0,"w1920","Hybrid",NA,"Mon","weekday"
"8605",2020-01-28,"Kebler","3","2","2",7.4,0,32,0,19,23.1,0,0,-1,-1,0,0,-1,-2,"w1920","Non.motorized",3,"Tue","weekday"
"8606",2020-01-28,"Kebler","3","2","2",7.4,0,32,0,19,23.1,0,0,-1,-1,0,0,-1,-2,"w1920","Mechanized",0,"Tue","weekday"
"8607",2020-01-28,"Kebler","3","2","2",7.4,0,32,0,19,23.1,0,0,-1,-1,0,0,-1,-2,"w1920","Motorized",53,"Tue","weekday"
"8608",2020-01-28,"Kebler","3","2","2",7.4,0,32,0,19,23.1,0,0,-1,-1,0,0,-1,-2,"w1920","Hybrid",NA,"Tue","weekday"
"8609",2020-01-29,"Kebler","2","2","1",7.4,0,31,-1,20,23.9,0,0,0,-1,-1,-1,-1,-2,"w1920","Non.motorized",4,"Wed","weekday"
"8610",2020-01-29,"Kebler","2","2","1",7.4,0,31,-1,20,23.9,0,0,0,-1,-1,-1,-1,-2,"w1920","Mechanized",0,"Wed","weekday"
"8611",2020-01-29,"Kebler","2","2","1",7.4,0,31,-1,20,23.9,0,0,0,-1,-1,-1,-1,-2,"w1920","Motorized",55,"Wed","weekday"
"8612",2020-01-29,"Kebler","2","2","1",7.4,0,31,-1,20,23.9,0,0,0,-1,-1,-1,-1,-2,"w1920","Hybrid",NA,"Wed","weekday"
"8613",2020-01-30,"Kebler","2","2","1",7.4,0,31,0,17,23.9,-1,0,0,0,-1,-1,-1,-1,"w1920","Non.motorized",1,"Thu","weekday"
"8614",2020-01-30,"Kebler","2","2","1",7.4,0,31,0,17,23.9,-1,0,0,0,-1,-1,-1,-1,"w1920","Mechanized",0,"Thu","weekday"
"8615",2020-01-30,"Kebler","2","2","1",7.4,0,31,0,17,23.9,-1,0,0,0,-1,-1,-1,-1,"w1920","Motorized",71,"Thu","weekday"
"8616",2020-01-30,"Kebler","2","2","1",7.4,0,31,0,17,23.9,-1,0,0,0,-1,-1,-1,-1,"w1920","Hybrid",NA,"Thu","weekday"
"8617",2020-01-31,"Kebler","2","1","1",7.4,0,31,0,20,23.9,0,-1,0,0,0,-1,-1,-1,"w1920","Non.motorized",10,"Fri","weekday"
"8618",2020-01-31,"Kebler","2","1","1",7.4,0,31,0,20,23.9,0,-1,0,0,0,-1,-1,-1,"w1920","Mechanized",0,"Fri","weekday"
"8619",2020-01-31,"Kebler","2","1","1",7.4,0,31,0,20,23.9,0,-1,0,0,0,-1,-1,-1,"w1920","Motorized",40,"Fri","weekday"
"8620",2020-01-31,"Kebler","2","1","1",7.4,0,31,0,20,23.9,0,-1,0,0,0,-1,-1,-1,"w1920","Hybrid",NA,"Fri","weekday"
"8621",2020-02-01,"Kebler","2","1","1",7.4,0,31,0,28,23.9,0,0,-1,0,0,0,-1,-1,"w1920","Non.motorized",7,"Sat","weekend"
"8622",2020-02-01,"Kebler","2","1","1",7.4,0,31,0,28,23.9,0,0,-1,0,0,0,-1,-1,"w1920","Mechanized",0,"Sat","weekend"
"8623",2020-02-01,"Kebler","2","1","1",7.4,0,31,0,28,23.9,0,0,-1,0,0,0,-1,-1,"w1920","Motorized",97,"Sat","weekend"
"8624",2020-02-01,"Kebler","2","1","1",7.4,0,31,0,28,23.9,0,0,-1,0,0,0,-1,-1,"w1920","Hybrid",NA,"Sat","weekend"
"8625",2020-02-02,"Kebler","1","1","1",7.4,0,31,0,33,23.9,0,0,0,-1,0,0,0,-1,"w1920","Non.motorized",11,"Sun","weekend"
"8626",2020-02-02,"Kebler","1","1","1",7.4,0,31,0,33,23.9,0,0,0,-1,0,0,0,-1,"w1920","Mechanized",0,"Sun","weekend"
"8627",2020-02-02,"Kebler","1","1","1",7.4,0,31,0,33,23.9,0,0,0,-1,0,0,0,-1,"w1920","Motorized",92,"Sun","weekend"
"8628",2020-02-02,"Kebler","1","1","1",7.4,0,31,0,33,23.9,0,0,0,-1,0,0,0,-1,"w1920","Hybrid",NA,"Sun","weekend"
"8629",2020-02-03,"Kebler","2","2","1",7.4,0,31,0,24,23.9,0,0,0,0,0,0,0,0,"w1920","Non.motorized",3,"Mon","weekday"
"8630",2020-02-03,"Kebler","2","2","1",7.4,0,31,0,24,23.9,0,0,0,0,0,0,0,0,"w1920","Mechanized",0,"Mon","weekday"
"8631",2020-02-03,"Kebler","2","2","1",7.4,0,31,0,24,23.9,0,0,0,0,0,0,0,0,"w1920","Motorized",47,"Mon","weekday"
"8632",2020-02-03,"Kebler","2","2","1",7.4,0,31,0,24,23.9,0,0,0,0,0,0,0,0,"w1920","Hybrid",NA,"Mon","weekday"
"8633",2020-02-04,"Kebler","2","2","2",7.4,0,33,2,5,22.4,0,0,0,0,2,2,2,2,"w1920","Non.motorized",1,"Tue","weekday"
"8634",2020-02-04,"Kebler","2","2","2",7.4,0,33,2,5,22.4,0,0,0,0,2,2,2,2,"w1920","Mechanized",0,"Tue","weekday"
"8635",2020-02-04,"Kebler","2","2","2",7.4,0,33,2,5,22.4,0,0,0,0,2,2,2,2,"w1920","Motorized",34,"Tue","weekday"
"8636",2020-02-04,"Kebler","2","2","2",7.4,0,33,2,5,22.4,0,0,0,0,2,2,2,2,"w1920","Hybrid",NA,"Tue","weekday"
"8637",2020-02-05,"Kebler","2","2","1",7.4,0,33,0,2,22.4,2,0,0,0,2,2,2,2,"w1920","Non.motorized",4,"Wed","weekday"
"8638",2020-02-05,"Kebler","2","2","1",7.4,0,33,0,2,22.4,2,0,0,0,2,2,2,2,"w1920","Mechanized",0,"Wed","weekday"
"8639",2020-02-05,"Kebler","2","2","1",7.4,0,33,0,2,22.4,2,0,0,0,2,2,2,2,"w1920","Motorized",42,"Wed","weekday"
"8640",2020-02-05,"Kebler","2","2","1",7.4,0,33,0,2,22.4,2,0,0,0,2,2,2,2,"w1920","Hybrid",NA,"Wed","weekday"
"8641",2020-02-06,"Kebler","2","2","1",7.5,0.1,32,-1,16,23.4,0,2,0,0,-1,1,1,1,"w1920","Non.motorized",3,"Thu","weekday"
"8642",2020-02-06,"Kebler","2","2","1",7.5,0.1,32,-1,16,23.4,0,2,0,0,-1,1,1,1,"w1920","Mechanized",0,"Thu","weekday"
"8643",2020-02-06,"Kebler","2","2","1",7.5,0.1,32,-1,16,23.4,0,2,0,0,-1,1,1,1,"w1920","Motorized",39,"Thu","weekday"
"8644",2020-02-06,"Kebler","2","2","1",7.5,0.1,32,-1,16,23.4,0,2,0,0,-1,1,1,1,"w1920","Hybrid",NA,"Thu","weekday"
"8645",2020-02-07,"Kebler","3","3","3",7.9,0.4,37,5,26,21.4,-1,0,2,0,4,4,6,6,"w1920","Non.motorized",NA,"Fri","weekday"
"8646",2020-02-07,"Kebler","3","3","3",7.9,0.4,37,5,26,21.4,-1,0,2,0,4,4,6,6,"w1920","Mechanized",NA,"Fri","weekday"
"8647",2020-02-07,"Kebler","3","3","3",7.9,0.4,37,5,26,21.4,-1,0,2,0,4,4,6,6,"w1920","Motorized",NA,"Fri","weekday"
"8648",2020-02-07,"Kebler","3","3","3",7.9,0.4,37,5,26,21.4,-1,0,2,0,4,4,6,6,"w1920","Hybrid",NA,"Fri","weekday"
"8649",2020-02-08,"Kebler","3","3","2",8.3,0.4,39,2,30,21.3,5,-1,0,2,7,6,6,8,"w1920","Non.motorized",3,"Sat","weekend"
"8650",2020-02-08,"Kebler","3","3","2",8.3,0.4,39,2,30,21.3,5,-1,0,2,7,6,6,8,"w1920","Mechanized",0,"Sat","weekend"
"8651",2020-02-08,"Kebler","3","3","2",8.3,0.4,39,2,30,21.3,5,-1,0,2,7,6,6,8,"w1920","Motorized",13,"Sat","weekend"
"8652",2020-02-08,"Kebler","3","3","2",8.3,0.4,39,2,30,21.3,5,-1,0,2,7,6,6,8,"w1920","Hybrid",NA,"Sat","weekend"
"8653",2020-02-09,"Kebler","3","2","2",8.4,0.1,38,-1,26,22.1,2,5,-1,0,1,6,5,5,"w1920","Non.motorized",13,"Sun","weekend"
"8654",2020-02-09,"Kebler","3","2","2",8.4,0.1,38,-1,26,22.1,2,5,-1,0,1,6,5,5,"w1920","Mechanized",0,"Sun","weekend"
"8655",2020-02-09,"Kebler","3","2","2",8.4,0.1,38,-1,26,22.1,2,5,-1,0,1,6,5,5,"w1920","Motorized",56,"Sun","weekend"
"8656",2020-02-09,"Kebler","3","2","2",8.4,0.1,38,-1,26,22.1,2,5,-1,0,1,6,5,5,"w1920","Hybrid",NA,"Sun","weekend"
"8657",2020-02-10,"Kebler","2","2","1",8.4,0,38,0,22,22.1,-1,2,5,-1,-1,1,6,5,"w1920","Non.motorized",17,"Mon","weekday"
"8658",2020-02-10,"Kebler","2","2","1",8.4,0,38,0,22,22.1,-1,2,5,-1,-1,1,6,5,"w1920","Mechanized",0,"Mon","weekday"
"8659",2020-02-10,"Kebler","2","2","1",8.4,0,38,0,22,22.1,-1,2,5,-1,-1,1,6,5,"w1920","Motorized",16,"Mon","weekday"
"8660",2020-02-10,"Kebler","2","2","1",8.4,0,38,0,22,22.1,-1,2,5,-1,-1,1,6,5,"w1920","Hybrid",NA,"Mon","weekday"
"8661",2020-02-11,"Kebler","2","2","2",8.5,0.1,40,2,16,21.2,0,-1,2,5,2,1,3,8,"w1920","Non.motorized",1,"Tue","weekday"
"8662",2020-02-11,"Kebler","2","2","2",8.5,0.1,40,2,16,21.2,0,-1,2,5,2,1,3,8,"w1920","Mechanized",0,"Tue","weekday"
"8663",2020-02-11,"Kebler","2","2","2",8.5,0.1,40,2,16,21.2,0,-1,2,5,2,1,3,8,"w1920","Motorized",36,"Tue","weekday"
"8664",2020-02-11,"Kebler","2","2","2",8.5,0.1,40,2,16,21.2,0,-1,2,5,2,1,3,8,"w1920","Hybrid",NA,"Tue","weekday"
"8665",2020-02-12,"Kebler","2","2","2",8.5,0,39,-1,15,21.8,2,0,-1,2,1,1,0,2,"w1920","Non.motorized",0,"Wed","weekday"
"8666",2020-02-12,"Kebler","2","2","2",8.5,0,39,-1,15,21.8,2,0,-1,2,1,1,0,2,"w1920","Mechanized",0,"Wed","weekday"
"8667",2020-02-12,"Kebler","2","2","2",8.5,0,39,-1,15,21.8,2,0,-1,2,1,1,0,2,"w1920","Motorized",23,"Wed","weekday"
"8668",2020-02-12,"Kebler","2","2","2",8.5,0,39,-1,15,21.8,2,0,-1,2,1,1,0,2,"w1920","Hybrid",NA,"Wed","weekday"
"8669",2020-02-13,"Kebler","2","2","1",8.5,0,39,0,18,21.8,-1,2,0,-1,-1,1,1,0,"w1920","Non.motorized",2,"Thu","weekday"
"8670",2020-02-13,"Kebler","2","2","1",8.5,0,39,0,18,21.8,-1,2,0,-1,-1,1,1,0,"w1920","Mechanized",0,"Thu","weekday"
"8671",2020-02-13,"Kebler","2","2","1",8.5,0,39,0,18,21.8,-1,2,0,-1,-1,1,1,0,"w1920","Motorized",28,"Thu","weekday"
"8672",2020-02-13,"Kebler","2","2","1",8.5,0,39,0,18,21.8,-1,2,0,-1,-1,1,1,0,"w1920","Hybrid",NA,"Thu","weekday"
"8673",2020-02-14,"Kebler","2","1","1",8.6,0.1,38,-1,24,22.6,0,-1,2,0,-1,-2,0,0,"w1920","Non.motorized",3,"Fri","weekday"
"8674",2020-02-14,"Kebler","2","1","1",8.6,0.1,38,-1,24,22.6,0,-1,2,0,-1,-2,0,0,"w1920","Mechanized",0,"Fri","weekday"
"8675",2020-02-14,"Kebler","2","1","1",8.6,0.1,38,-1,24,22.6,0,-1,2,0,-1,-2,0,0,"w1920","Motorized",33,"Fri","weekday"
"8676",2020-02-14,"Kebler","2","1","1",8.6,0.1,38,-1,24,22.6,0,-1,2,0,-1,-2,0,0,"w1920","Hybrid",NA,"Fri","weekday"
"8677",2020-02-15,"Kebler","1","1","1",8.6,0,38,0,26,22.6,-1,0,-1,2,-1,-1,-2,0,"w1920","Non.motorized",5,"Sat","weekend"
"8678",2020-02-15,"Kebler","1","1","1",8.6,0,38,0,26,22.6,-1,0,-1,2,-1,-1,-2,0,"w1920","Mechanized",0,"Sat","weekend"
"8679",2020-02-15,"Kebler","1","1","1",8.6,0,38,0,26,22.6,-1,0,-1,2,-1,-1,-2,0,"w1920","Motorized",35,"Sat","weekend"
"8680",2020-02-15,"Kebler","1","1","1",8.6,0,38,0,26,22.6,-1,0,-1,2,-1,-1,-2,0,"w1920","Hybrid",NA,"Sat","weekend"
"8681",2020-02-16,"Kebler","1","1","1",8.8,0.2,37,-1,26,23.8,0,-1,0,-1,-1,-2,-2,-3,"w1920","Non.motorized",1,"Sun","weekend"
"8682",2020-02-16,"Kebler","1","1","1",8.8,0.2,37,-1,26,23.8,0,-1,0,-1,-1,-2,-2,-3,"w1920","Mechanized",1,"Sun","weekend"
"8683",2020-02-16,"Kebler","1","1","1",8.8,0.2,37,-1,26,23.8,0,-1,0,-1,-1,-2,-2,-3,"w1920","Motorized",51,"Sun","weekend"
"8684",2020-02-16,"Kebler","1","1","1",8.8,0.2,37,-1,26,23.8,0,-1,0,-1,-1,-2,-2,-3,"w1920","Hybrid",NA,"Sun","weekend"
"8685",2020-02-17,"Kebler","2","1","1",9.2,0.4,43,6,25,21.4,-1,0,-1,0,5,5,4,4,"w1920","Non.motorized",3,"Mon","weekday"
"8686",2020-02-17,"Kebler","2","1","1",9.2,0.4,43,6,25,21.4,-1,0,-1,0,5,5,4,4,"w1920","Mechanized",0,"Mon","weekday"
"8687",2020-02-17,"Kebler","2","1","1",9.2,0.4,43,6,25,21.4,-1,0,-1,0,5,5,4,4,"w1920","Motorized",9,"Mon","weekday"
"8688",2020-02-17,"Kebler","2","1","1",9.2,0.4,43,6,25,21.4,-1,0,-1,0,5,5,4,4,"w1920","Hybrid",NA,"Mon","weekday"
"8689",2020-02-18,"Kebler","1","1","1",9.3,0.1,42,-1,18,22.1,6,-1,0,-1,5,4,4,3,"w1920","Non.motorized",0,"Tue","weekday"
"8690",2020-02-18,"Kebler","1","1","1",9.3,0.1,42,-1,18,22.1,6,-1,0,-1,5,4,4,3,"w1920","Mechanized",0,"Tue","weekday"
"8691",2020-02-18,"Kebler","1","1","1",9.3,0.1,42,-1,18,22.1,6,-1,0,-1,5,4,4,3,"w1920","Motorized",27,"Tue","weekday"
"8692",2020-02-18,"Kebler","1","1","1",9.3,0.1,42,-1,18,22.1,6,-1,0,-1,5,4,4,3,"w1920","Hybrid",NA,"Tue","weekday"
"8693",2020-02-19,"Kebler","1","1","1",9.3,0,41,-1,22,22.7,-1,6,-1,0,-2,4,3,3,"w1920","Non.motorized",2,"Wed","weekday"
"8694",2020-02-19,"Kebler","1","1","1",9.3,0,41,-1,22,22.7,-1,6,-1,0,-2,4,3,3,"w1920","Mechanized",0,"Wed","weekday"
"8695",2020-02-19,"Kebler","1","1","1",9.3,0,41,-1,22,22.7,-1,6,-1,0,-2,4,3,3,"w1920","Motorized",40,"Wed","weekday"
"8696",2020-02-19,"Kebler","1","1","1",9.3,0,41,-1,22,22.7,-1,6,-1,0,-2,4,3,3,"w1920","Hybrid",NA,"Wed","weekday"
"8697",2020-02-20,"Kebler","1","1","1",9.3,0,41,0,18,22.7,-1,-1,6,-1,-1,-2,4,3,"w1920","Non.motorized",3,"Thu","weekday"
"8698",2020-02-20,"Kebler","1","1","1",9.3,0,41,0,18,22.7,-1,-1,6,-1,-1,-2,4,3,"w1920","Mechanized",1,"Thu","weekday"
"8699",2020-02-20,"Kebler","1","1","1",9.3,0,41,0,18,22.7,-1,-1,6,-1,-1,-2,4,3,"w1920","Motorized",47,"Thu","weekday"
"8700",2020-02-20,"Kebler","1","1","1",9.3,0,41,0,18,22.7,-1,-1,6,-1,-1,-2,4,3,"w1920","Hybrid",NA,"Thu","weekday"
"8701",2020-02-21,"Kebler","1","1","1",9.3,0,40,-1,26,23.2,0,-1,-1,6,-1,-2,-3,3,"w1920","Non.motorized",4,"Fri","weekday"
"8702",2020-02-21,"Kebler","1","1","1",9.3,0,40,-1,26,23.2,0,-1,-1,6,-1,-2,-3,3,"w1920","Mechanized",0,"Fri","weekday"
"8703",2020-02-21,"Kebler","1","1","1",9.3,0,40,-1,26,23.2,0,-1,-1,6,-1,-2,-3,3,"w1920","Motorized",80,"Fri","weekday"
"8704",2020-02-21,"Kebler","1","1","1",9.3,0,40,-1,26,23.2,0,-1,-1,6,-1,-2,-3,3,"w1920","Hybrid",NA,"Fri","weekday"
"8705",2020-02-22,"Kebler","1","1","1",9.4,0.1,39,-1,32,24.1,-1,0,-1,-1,-2,-2,-3,-4,"w1920","Non.motorized",4,"Sat","weekend"
"8706",2020-02-22,"Kebler","1","1","1",9.4,0.1,39,-1,32,24.1,-1,0,-1,-1,-2,-2,-3,-4,"w1920","Mechanized",0,"Sat","weekend"
"8707",2020-02-22,"Kebler","1","1","1",9.4,0.1,39,-1,32,24.1,-1,0,-1,-1,-2,-2,-3,-4,"w1920","Motorized",86,"Sat","weekend"
"8708",2020-02-22,"Kebler","1","1","1",9.4,0.1,39,-1,32,24.1,-1,0,-1,-1,-2,-2,-3,-4,"w1920","Hybrid",NA,"Sat","weekend"
"8709",2020-02-23,"Kebler","2","2","2",9.5,0.1,40,1,27,23.8,-1,-1,0,-1,0,-1,-1,-2,"w1920","Non.motorized",1,"Sun","weekend"
"8710",2020-02-23,"Kebler","2","2","2",9.5,0.1,40,1,27,23.8,-1,-1,0,-1,0,-1,-1,-2,"w1920","Mechanized",0,"Sun","weekend"
"8711",2020-02-23,"Kebler","2","2","2",9.5,0.1,40,1,27,23.8,-1,-1,0,-1,0,-1,-1,-2,"w1920","Motorized",25,"Sun","weekend"
"8712",2020-02-23,"Kebler","2","2","2",9.5,0.1,40,1,27,23.8,-1,-1,0,-1,0,-1,-1,-2,"w1920","Hybrid",NA,"Sun","weekend"
"8713",2020-02-24,"Kebler","3","3","2",9.8,0.3,43,3,17,22.8,1,-1,-1,0,4,3,2,2,"w1920","Non.motorized",4,"Mon","weekday"
"8714",2020-02-24,"Kebler","3","3","2",9.8,0.3,43,3,17,22.8,1,-1,-1,0,4,3,2,2,"w1920","Mechanized",0,"Mon","weekday"
"8715",2020-02-24,"Kebler","3","3","2",9.8,0.3,43,3,17,22.8,1,-1,-1,0,4,3,2,2,"w1920","Motorized",10,"Mon","weekday"
"8716",2020-02-24,"Kebler","3","3","2",9.8,0.3,43,3,17,22.8,1,-1,-1,0,4,3,2,2,"w1920","Hybrid",NA,"Mon","weekday"
"8717",2020-02-25,"Kebler","2","2","1",9.8,0,43,0,8,22.8,3,1,-1,-1,3,4,3,2,"w1920","Non.motorized",2,"Tue","weekday"
"8718",2020-02-25,"Kebler","2","2","1",9.8,0,43,0,8,22.8,3,1,-1,-1,3,4,3,2,"w1920","Mechanized",0,"Tue","weekday"
"8719",2020-02-25,"Kebler","2","2","1",9.8,0,43,0,8,22.8,3,1,-1,-1,3,4,3,2,"w1920","Motorized",35,"Tue","weekday"
"8720",2020-02-25,"Kebler","2","2","1",9.8,0,43,0,8,22.8,3,1,-1,-1,3,4,3,2,"w1920","Hybrid",NA,"Tue","weekday"
"8721",2020-02-26,"Kebler","2","2","1",9.8,0,42,-1,15,23.3,0,3,1,-1,-1,2,3,2,"w1920","Non.motorized",1,"Wed","weekday"
"8722",2020-02-26,"Kebler","2","2","1",9.8,0,42,-1,15,23.3,0,3,1,-1,-1,2,3,2,"w1920","Mechanized",0,"Wed","weekday"
"8723",2020-02-26,"Kebler","2","2","1",9.8,0,42,-1,15,23.3,0,3,1,-1,-1,2,3,2,"w1920","Motorized",42,"Wed","weekday"
"8724",2020-02-26,"Kebler","2","2","1",9.8,0,42,-1,15,23.3,0,3,1,-1,-1,2,3,2,"w1920","Hybrid",NA,"Wed","weekday"
"8725",2020-02-27,"Kebler","2","2","1",9.9,0.1,41,-1,25,24.1,-1,0,3,1,-2,-2,1,2,"w1920","Non.motorized",12,"Thu","weekday"
"8726",2020-02-27,"Kebler","2","2","1",9.9,0.1,41,-1,25,24.1,-1,0,3,1,-2,-2,1,2,"w1920","Mechanized",1,"Thu","weekday"
"8727",2020-02-27,"Kebler","2","2","1",9.9,0.1,41,-1,25,24.1,-1,0,3,1,-2,-2,1,2,"w1920","Motorized",56,"Thu","weekday"
"8728",2020-02-27,"Kebler","2","2","1",9.9,0.1,41,-1,25,24.1,-1,0,3,1,-2,-2,1,2,"w1920","Hybrid",NA,"Thu","weekday"
"8729",2020-02-28,"Kebler","2","1","1",9.9,0,41,0,28,24.1,-1,-1,0,3,-1,-2,-2,1,"w1920","Non.motorized",6,"Fri","weekday"
"8730",2020-02-28,"Kebler","2","1","1",9.9,0,41,0,28,24.1,-1,-1,0,3,-1,-2,-2,1,"w1920","Mechanized",0,"Fri","weekday"
"8731",2020-02-28,"Kebler","2","1","1",9.9,0,41,0,28,24.1,-1,-1,0,3,-1,-2,-2,1,"w1920","Motorized",86,"Fri","weekday"
"8732",2020-02-28,"Kebler","2","1","1",9.9,0,41,0,28,24.1,-1,-1,0,3,-1,-2,-2,1,"w1920","Hybrid",NA,"Fri","weekday"
"8733",2020-02-29,"Kebler","1","1","1",9.9,0,40,-1,29,24.8,0,-1,-1,0,-1,-2,-3,-3,"w1920","Non.motorized",13,"Sat","weekend"
"8734",2020-02-29,"Kebler","1","1","1",9.9,0,40,-1,29,24.8,0,-1,-1,0,-1,-2,-3,-3,"w1920","Mechanized",1,"Sat","weekend"
"8735",2020-02-29,"Kebler","1","1","1",9.9,0,40,-1,29,24.8,0,-1,-1,0,-1,-2,-3,-3,"w1920","Motorized",147,"Sat","weekend"
"8736",2020-02-29,"Kebler","1","1","1",9.9,0,40,-1,29,24.8,0,-1,-1,0,-1,-2,-3,-3,"w1920","Hybrid",NA,"Sat","weekend"
"8737",2020-03-01,"Kebler","1","1","1",10,0.1,40,0,28,25,-1,0,-1,-1,-1,-1,-2,-3,"w1920","Non.motorized",3,"Sun","weekend"
"8738",2020-03-01,"Kebler","1","1","1",10,0.1,40,0,28,25,-1,0,-1,-1,-1,-1,-2,-3,"w1920","Mechanized",2,"Sun","weekend"
"8739",2020-03-01,"Kebler","1","1","1",10,0.1,40,0,28,25,-1,0,-1,-1,-1,-1,-2,-3,"w1920","Motorized",83,"Sun","weekend"
"8740",2020-03-01,"Kebler","1","1","1",10,0.1,40,0,28,25,-1,0,-1,-1,-1,-1,-2,-3,"w1920","Hybrid",NA,"Sun","weekend"
"8741",2020-03-02,"Kebler","2","2","1",10.4,0.4,45,5,25,23.1,0,-1,0,-1,5,4,4,3,"w1920","Non.motorized",8,"Mon","weekday"
"8742",2020-03-02,"Kebler","2","2","1",10.4,0.4,45,5,25,23.1,0,-1,0,-1,5,4,4,3,"w1920","Mechanized",1,"Mon","weekday"
"8743",2020-03-02,"Kebler","2","2","1",10.4,0.4,45,5,25,23.1,0,-1,0,-1,5,4,4,3,"w1920","Motorized",62,"Mon","weekday"
"8744",2020-03-02,"Kebler","2","2","1",10.4,0.4,45,5,25,23.1,0,-1,0,-1,5,4,4,3,"w1920","Hybrid",NA,"Mon","weekday"
"8745",2020-03-03,"Kebler","2","1","1",10.9,0.5,50,5,25,21.8,5,0,-1,0,10,10,9,9,"w1920","Non.motorized",0,"Tue","weekday"
"8746",2020-03-03,"Kebler","2","1","1",10.9,0.5,50,5,25,21.8,5,0,-1,0,10,10,9,9,"w1920","Mechanized",0,"Tue","weekday"
"8747",2020-03-03,"Kebler","2","1","1",10.9,0.5,50,5,25,21.8,5,0,-1,0,10,10,9,9,"w1920","Motorized",10,"Tue","weekday"
"8748",2020-03-03,"Kebler","2","1","1",10.9,0.5,50,5,25,21.8,5,0,-1,0,10,10,9,9,"w1920","Hybrid",NA,"Tue","weekday"
"8749",2020-03-04,"Kebler","2","1","1",10.9,0,48,-2,29,22.7,5,5,0,-1,3,8,8,7,"w1920","Non.motorized",2,"Wed","weekday"
"8750",2020-03-04,"Kebler","2","1","1",10.9,0,48,-2,29,22.7,5,5,0,-1,3,8,8,7,"w1920","Mechanized",0,"Wed","weekday"
"8751",2020-03-04,"Kebler","2","1","1",10.9,0,48,-2,29,22.7,5,5,0,-1,3,8,8,7,"w1920","Motorized",8,"Wed","weekday"
"8752",2020-03-04,"Kebler","2","1","1",10.9,0,48,-2,29,22.7,5,5,0,-1,3,8,8,7,"w1920","Hybrid",NA,"Wed","weekday"
"8753",2020-03-05,"Kebler","2","1","1",10.9,0,46,-2,32,23.7,-2,5,5,0,-4,1,6,6,"w1920","Non.motorized",1,"Thu","weekday"
"8754",2020-03-05,"Kebler","2","1","1",10.9,0,46,-2,32,23.7,-2,5,5,0,-4,1,6,6,"w1920","Mechanized",0,"Thu","weekday"
"8755",2020-03-05,"Kebler","2","1","1",10.9,0,46,-2,32,23.7,-2,5,5,0,-4,1,6,6,"w1920","Motorized",57,"Thu","weekday"
"8756",2020-03-05,"Kebler","2","1","1",10.9,0,46,-2,32,23.7,-2,5,5,0,-4,1,6,6,"w1920","Hybrid",NA,"Thu","weekday"
"8757",2020-03-06,"Kebler","1","1","1",10.9,0,45,-1,34,24.2,-2,-2,5,5,-3,-5,0,5,"w1920","Non.motorized",2,"Fri","weekday"
"8758",2020-03-06,"Kebler","1","1","1",10.9,0,45,-1,34,24.2,-2,-2,5,5,-3,-5,0,5,"w1920","Mechanized",0,"Fri","weekday"
"8759",2020-03-06,"Kebler","1","1","1",10.9,0,45,-1,34,24.2,-2,-2,5,5,-3,-5,0,5,"w1920","Motorized",87,"Fri","weekday"
"8760",2020-03-06,"Kebler","1","1","1",10.9,0,45,-1,34,24.2,-2,-2,5,5,-3,-5,0,5,"w1920","Hybrid",NA,"Fri","weekday"
"8761",2020-03-07,"Kebler","1","1","2",10.9,0,44,-1,35,24.8,-1,-2,-2,5,-2,-4,-6,-1,"w1920","Non.motorized",14,"Sat","weekend"
"8762",2020-03-07,"Kebler","1","1","2",10.9,0,44,-1,35,24.8,-1,-2,-2,5,-2,-4,-6,-1,"w1920","Mechanized",3,"Sat","weekend"
"8763",2020-03-07,"Kebler","1","1","2",10.9,0,44,-1,35,24.8,-1,-2,-2,5,-2,-4,-6,-1,"w1920","Motorized",92,"Sat","weekend"
"8764",2020-03-07,"Kebler","1","1","2",10.9,0,44,-1,35,24.8,-1,-2,-2,5,-2,-4,-6,-1,"w1920","Hybrid",NA,"Sat","weekend"
"8765",2020-03-08,"Kebler","1","1","1",11,0.1,43,-1,33,25.6,-1,-1,-2,-2,-2,-3,-5,-7,"w1920","Non.motorized",15,"Sun","weekend"
"8766",2020-03-08,"Kebler","1","1","1",11,0.1,43,-1,33,25.6,-1,-1,-2,-2,-2,-3,-5,-7,"w1920","Mechanized",0,"Sun","weekend"
"8767",2020-03-08,"Kebler","1","1","1",11,0.1,43,-1,33,25.6,-1,-1,-2,-2,-2,-3,-5,-7,"w1920","Motorized",60,"Sun","weekend"
"8768",2020-03-08,"Kebler","1","1","1",11,0.1,43,-1,33,25.6,-1,-1,-2,-2,-2,-3,-5,-7,"w1920","Hybrid",NA,"Sun","weekend"
"8769",2020-03-09,"Kebler","1","1","1",11.1,0.1,42,-1,31,26.4,-1,-1,-1,-2,-2,-3,-4,-6,"w1920","Non.motorized",1,"Mon","weekday"
"8770",2020-03-09,"Kebler","1","1","1",11.1,0.1,42,-1,31,26.4,-1,-1,-1,-2,-2,-3,-4,-6,"w1920","Mechanized",0,"Mon","weekday"
"8771",2020-03-09,"Kebler","1","1","1",11.1,0.1,42,-1,31,26.4,-1,-1,-1,-2,-2,-3,-4,-6,"w1920","Motorized",47,"Mon","weekday"
"8772",2020-03-09,"Kebler","1","1","1",11.1,0.1,42,-1,31,26.4,-1,-1,-1,-2,-2,-3,-4,-6,"w1920","Hybrid",NA,"Mon","weekday"
"8773",2020-03-10,"Kebler","1","1","2",11.2,0.1,44,2,31,25.5,-1,-1,-1,-1,1,0,-1,-2,"w1920","Non.motorized",13,"Tue","weekday"
"8774",2020-03-10,"Kebler","1","1","2",11.2,0.1,44,2,31,25.5,-1,-1,-1,-1,1,0,-1,-2,"w1920","Mechanized",0,"Tue","weekday"
"8775",2020-03-10,"Kebler","1","1","2",11.2,0.1,44,2,31,25.5,-1,-1,-1,-1,1,0,-1,-2,"w1920","Motorized",102,"Tue","weekday"
"8776",2020-03-10,"Kebler","1","1","2",11.2,0.1,44,2,31,25.5,-1,-1,-1,-1,1,0,-1,-2,"w1920","Hybrid",NA,"Tue","weekday"
"8777",2020-03-11,"Kebler","2","2","1",11.2,0,44,0,32,25.5,2,-1,-1,-1,2,1,0,-1,"w1920","Non.motorized",7,"Wed","weekday"
"8778",2020-03-11,"Kebler","2","2","1",11.2,0,44,0,32,25.5,2,-1,-1,-1,2,1,0,-1,"w1920","Mechanized",0,"Wed","weekday"
"8779",2020-03-11,"Kebler","2","2","1",11.2,0,44,0,32,25.5,2,-1,-1,-1,2,1,0,-1,"w1920","Motorized",136,"Wed","weekday"
"8780",2020-03-11,"Kebler","2","2","1",11.2,0,44,0,32,25.5,2,-1,-1,-1,2,1,0,-1,"w1920","Hybrid",NA,"Wed","weekday"
"8781",2020-03-12,"Kebler","2","2","2",11.4,0.2,42,-2,35,27.1,0,2,-1,-1,-2,0,-1,-2,"w1920","Non.motorized",9,"Thu","weekday"
"8782",2020-03-12,"Kebler","2","2","2",11.4,0.2,42,-2,35,27.1,0,2,-1,-1,-2,0,-1,-2,"w1920","Mechanized",0,"Thu","weekday"
"8783",2020-03-12,"Kebler","2","2","2",11.4,0.2,42,-2,35,27.1,0,2,-1,-1,-2,0,-1,-2,"w1920","Motorized",114,"Thu","weekday"
"8784",2020-03-12,"Kebler","2","2","2",11.4,0.2,42,-2,35,27.1,0,2,-1,-1,-2,0,-1,-2,"w1920","Hybrid",NA,"Thu","weekday"
"8785",2020-03-13,"Kebler","3","3","2",11.5,0.1,44,2,31,26.1,-2,0,2,-1,0,0,2,1,"w1920","Non.motorized",3,"Fri","weekday"
"8786",2020-03-13,"Kebler","3","3","2",11.5,0.1,44,2,31,26.1,-2,0,2,-1,0,0,2,1,"w1920","Mechanized",0,"Fri","weekday"
"8787",2020-03-13,"Kebler","3","3","2",11.5,0.1,44,2,31,26.1,-2,0,2,-1,0,0,2,1,"w1920","Motorized",62,"Fri","weekday"
"8788",2020-03-13,"Kebler","3","3","2",11.5,0.1,44,2,31,26.1,-2,0,2,-1,0,0,2,1,"w1920","Hybrid",NA,"Fri","weekday"
"8789",2020-03-14,"Kebler","3","3","3",11.7,0.2,44,0,31,26.6,2,-2,0,2,2,0,0,2,"w1920","Non.motorized",1,"Sat","weekend"
"8790",2020-03-14,"Kebler","3","3","3",11.7,0.2,44,0,31,26.6,2,-2,0,2,2,0,0,2,"w1920","Mechanized",0,"Sat","weekend"
"8791",2020-03-14,"Kebler","3","3","3",11.7,0.2,44,0,31,26.6,2,-2,0,2,2,0,0,2,"w1920","Motorized",26,"Sat","weekend"
"8792",2020-03-14,"Kebler","3","3","3",11.7,0.2,44,0,31,26.6,2,-2,0,2,2,0,0,2,"w1920","Hybrid",NA,"Sat","weekend"
"8793",2020-03-15,"Kebler","2","2","2",11.7,0,45,1,33,26,0,2,-2,0,1,3,1,1,"w1920","Non.motorized",5,"Sun","weekend"
"8794",2020-03-15,"Kebler","2","2","2",11.7,0,45,1,33,26,0,2,-2,0,1,3,1,1,"w1920","Mechanized",1,"Sun","weekend"
"8795",2020-03-15,"Kebler","2","2","2",11.7,0,45,1,33,26,0,2,-2,0,1,3,1,1,"w1920","Motorized",75,"Sun","weekend"
"8796",2020-03-15,"Kebler","2","2","2",11.7,0,45,1,33,26,0,2,-2,0,1,3,1,1,"w1920","Hybrid",NA,"Sun","weekend"
"8797",2020-03-16,"Kebler","2","2","2",11.7,0,45,0,35,26,1,0,2,-2,1,1,3,1,"w1920","Non.motorized",10,"Mon","weekday"
"8798",2020-03-16,"Kebler","2","2","2",11.7,0,45,0,35,26,1,0,2,-2,1,1,3,1,"w1920","Mechanized",1,"Mon","weekday"
"8799",2020-03-16,"Kebler","2","2","2",11.7,0,45,0,35,26,1,0,2,-2,1,1,3,1,"w1920","Motorized",199,"Mon","weekday"
"8800",2020-03-16,"Kebler","2","2","2",11.7,0,45,0,35,26,1,0,2,-2,1,1,3,1,"w1920","Hybrid",NA,"Mon","weekday"
"8801",2020-03-17,"Kebler","2","2","2",11.7,0,44,-1,36,26.6,0,1,0,2,-1,0,0,2,"w1920","Non.motorized",9,"Tue","weekday"
"8802",2020-03-17,"Kebler","2","2","2",11.7,0,44,-1,36,26.6,0,1,0,2,-1,0,0,2,"w1920","Mechanized",1,"Tue","weekday"
"8803",2020-03-17,"Kebler","2","2","2",11.7,0,44,-1,36,26.6,0,1,0,2,-1,0,0,2,"w1920","Motorized",169,"Tue","weekday"
"8804",2020-03-17,"Kebler","2","2","2",11.7,0,44,-1,36,26.6,0,1,0,2,-1,0,0,2,"w1920","Hybrid",NA,"Tue","weekday"
"8805",2020-03-18,"Kebler","2","2","2",11.7,0,43,-1,33,27.2,-1,0,1,0,-2,-2,-1,-1,"w1920","Non.motorized",13,"Wed","weekday"
"8806",2020-03-18,"Kebler","2","2","2",11.7,0,43,-1,33,27.2,-1,0,1,0,-2,-2,-1,-1,"w1920","Mechanized",0,"Wed","weekday"
"8807",2020-03-18,"Kebler","2","2","2",11.7,0,43,-1,33,27.2,-1,0,1,0,-2,-2,-1,-1,"w1920","Motorized",53,"Wed","weekday"
"8808",2020-03-18,"Kebler","2","2","2",11.7,0,43,-1,33,27.2,-1,0,1,0,-2,-2,-1,-1,"w1920","Hybrid",NA,"Wed","weekday"
"8809",2020-03-19,"Kebler","3","3","3",11.8,0.1,43,0,27,27.4,-1,-1,0,1,-1,-2,-2,-1,"w1920","Non.motorized",30,"Thu","weekday"
"8810",2020-03-19,"Kebler","3","3","3",11.8,0.1,43,0,27,27.4,-1,-1,0,1,-1,-2,-2,-1,"w1920","Mechanized",1,"Thu","weekday"
"8811",2020-03-19,"Kebler","3","3","3",11.8,0.1,43,0,27,27.4,-1,-1,0,1,-1,-2,-2,-1,"w1920","Motorized",44,"Thu","weekday"
"8812",2020-03-19,"Kebler","3","3","3",11.8,0.1,43,0,27,27.4,-1,-1,0,1,-1,-2,-2,-1,"w1920","Hybrid",NA,"Thu","weekday"
"8813",2020-03-20,"Kebler","3","3","2",12.7,0.9,52,9,26,24.4,0,-1,-1,0,9,8,7,7,"w1920","Non.motorized",26,"Fri","weekday"
"8814",2020-03-20,"Kebler","3","3","2",12.7,0.9,52,9,26,24.4,0,-1,-1,0,9,8,7,7,"w1920","Mechanized",2,"Fri","weekday"
"8815",2020-03-20,"Kebler","3","3","2",12.7,0.9,52,9,26,24.4,0,-1,-1,0,9,8,7,7,"w1920","Motorized",46,"Fri","weekday"
"8816",2020-03-20,"Kebler","3","3","2",12.7,0.9,52,9,26,24.4,0,-1,-1,0,9,8,7,7,"w1920","Hybrid",NA,"Fri","weekday"
"8817",2020-03-21,"Kebler","3","3","2",12.8,0.1,54,2,26,23.7,9,0,-1,-1,11,11,10,9,"w1920","Non.motorized",29,"Sat","weekend"
"8818",2020-03-21,"Kebler","3","3","2",12.8,0.1,54,2,26,23.7,9,0,-1,-1,11,11,10,9,"w1920","Mechanized",0,"Sat","weekend"
"8819",2020-03-21,"Kebler","3","3","2",12.8,0.1,54,2,26,23.7,9,0,-1,-1,11,11,10,9,"w1920","Motorized",49,"Sat","weekend"
"8820",2020-03-21,"Kebler","3","3","2",12.8,0.1,54,2,26,23.7,9,0,-1,-1,11,11,10,9,"w1920","Hybrid",NA,"Sat","weekend"
"8821",2020-03-22,"Kebler","2","2","2",13,0.2,53,-1,28,24.5,2,9,0,-1,1,10,10,9,"w1920","Non.motorized",10,"Sun","weekend"
"8822",2020-03-22,"Kebler","2","2","2",13,0.2,53,-1,28,24.5,2,9,0,-1,1,10,10,9,"w1920","Mechanized",0,"Sun","weekend"
"8823",2020-03-22,"Kebler","2","2","2",13,0.2,53,-1,28,24.5,2,9,0,-1,1,10,10,9,"w1920","Motorized",40,"Sun","weekend"
"8824",2020-03-22,"Kebler","2","2","2",13,0.2,53,-1,28,24.5,2,9,0,-1,1,10,10,9,"w1920","Hybrid",NA,"Sun","weekend"
"8825",2020-03-23,"Kebler","2","2","2",13,0,53,0,28,24.5,-1,2,9,0,-1,1,10,10,"w1920","Non.motorized",7,"Mon","weekday"
"8826",2020-03-23,"Kebler","2","2","2",13,0,53,0,28,24.5,-1,2,9,0,-1,1,10,10,"w1920","Mechanized",1,"Mon","weekday"
"8827",2020-03-23,"Kebler","2","2","2",13,0,53,0,28,24.5,-1,2,9,0,-1,1,10,10,"w1920","Motorized",40,"Mon","weekday"
"8828",2020-03-23,"Kebler","2","2","2",13,0,53,0,28,24.5,-1,2,9,0,-1,1,10,10,"w1920","Hybrid",NA,"Mon","weekday"
"8829",2020-03-24,"Kebler","2","2","2",13.2,0.2,53,0,32,24.9,0,-1,2,9,0,-1,1,10,"w1920","Non.motorized",5,"Tue","weekday"
"8830",2020-03-24,"Kebler","2","2","2",13.2,0.2,53,0,32,24.9,0,-1,2,9,0,-1,1,10,"w1920","Mechanized",3,"Tue","weekday"
"8831",2020-03-24,"Kebler","2","2","2",13.2,0.2,53,0,32,24.9,0,-1,2,9,0,-1,1,10,"w1920","Motorized",58,"Tue","weekday"
"8832",2020-03-24,"Kebler","2","2","2",13.2,0.2,53,0,32,24.9,0,-1,2,9,0,-1,1,10,"w1920","Hybrid",NA,"Tue","weekday"
"8833",2020-03-25,"Kebler","2","2","2",13.3,0.1,51,-2,34,26.1,0,0,-1,2,-2,-2,-3,-1,"w1920","Non.motorized",14,"Wed","weekday"
"8834",2020-03-25,"Kebler","2","2","2",13.3,0.1,51,-2,34,26.1,0,0,-1,2,-2,-2,-3,-1,"w1920","Mechanized",0,"Wed","weekday"
"8835",2020-03-25,"Kebler","2","2","2",13.3,0.1,51,-2,34,26.1,0,0,-1,2,-2,-2,-3,-1,"w1920","Motorized",68,"Wed","weekday"
"8836",2020-03-25,"Kebler","2","2","2",13.3,0.1,51,-2,34,26.1,0,0,-1,2,-2,-2,-3,-1,"w1920","Hybrid",NA,"Wed","weekday"
"8837",2020-03-26,"Kebler","2","2","2",13.3,0,50,-1,36,26.6,-2,0,0,-1,-3,-3,-3,-4,"w1920","Non.motorized",12,"Thu","weekday"
"8838",2020-03-26,"Kebler","2","2","2",13.3,0,50,-1,36,26.6,-2,0,0,-1,-3,-3,-3,-4,"w1920","Mechanized",0,"Thu","weekday"
"8839",2020-03-26,"Kebler","2","2","2",13.3,0,50,-1,36,26.6,-2,0,0,-1,-3,-3,-3,-4,"w1920","Motorized",95,"Thu","weekday"
"8840",2020-03-26,"Kebler","2","2","2",13.3,0,50,-1,36,26.6,-2,0,0,-1,-3,-3,-3,-4,"w1920","Hybrid",NA,"Thu","weekday"
"8841",2020-03-26,"Kebler","3","3","2",13.3,0,50,-1,36,26.6,-2,0,0,-1,-3,-3,-3,-4,"w1920","Non.motorized",12,"Thu","weekday"
"8842",2020-03-26,"Kebler","3","3","2",13.3,0,50,-1,36,26.6,-2,0,0,-1,-3,-3,-3,-4,"w1920","Mechanized",0,"Thu","weekday"
"8843",2020-03-26,"Kebler","3","3","2",13.3,0,50,-1,36,26.6,-2,0,0,-1,-3,-3,-3,-4,"w1920","Motorized",95,"Thu","weekday"
"8844",2020-03-26,"Kebler","3","3","2",13.3,0,50,-1,36,26.6,-2,0,0,-1,-3,-3,-3,-4,"w1920","Hybrid",NA,"Thu","weekday"
"8845",2020-03-27,"Kebler","3","3","2",13.3,0,50,0,23,26.6,-1,-2,0,0,-1,-3,-3,-3,"w1920","Non.motorized",11,"Fri","weekday"
"8846",2020-03-27,"Kebler","3","3","2",13.3,0,50,0,23,26.6,-1,-2,0,0,-1,-3,-3,-3,"w1920","Mechanized",0,"Fri","weekday"
"8847",2020-03-27,"Kebler","3","3","2",13.3,0,50,0,23,26.6,-1,-2,0,0,-1,-3,-3,-3,"w1920","Motorized",53,"Fri","weekday"
"8848",2020-03-27,"Kebler","3","3","2",13.3,0,50,0,23,26.6,-1,-2,0,0,-1,-3,-3,-3,"w1920","Hybrid",NA,"Fri","weekday"
"8849",2020-03-28,"Kebler","3","3","3",13.3,0,50,0,18,26.6,0,-1,-2,0,0,-1,-3,-3,"w1920","Non.motorized",4,"Sat","weekend"
"8850",2020-03-28,"Kebler","3","3","3",13.3,0,50,0,18,26.6,0,-1,-2,0,0,-1,-3,-3,"w1920","Mechanized",0,"Sat","weekend"
"8851",2020-03-28,"Kebler","3","3","3",13.3,0,50,0,18,26.6,0,-1,-2,0,0,-1,-3,-3,"w1920","Motorized",46,"Sat","weekend"
"8852",2020-03-28,"Kebler","3","3","3",13.3,0,50,0,18,26.6,0,-1,-2,0,0,-1,-3,-3,"w1920","Hybrid",NA,"Sat","weekend"
"8853",2020-03-29,"Kebler","2","2","2",13.3,0,49,-1,24,27.1,0,0,-1,-2,-1,-1,-2,-4,"w1920","Non.motorized",4,"Sun","weekend"
"8854",2020-03-29,"Kebler","2","2","2",13.3,0,49,-1,24,27.1,0,0,-1,-2,-1,-1,-2,-4,"w1920","Mechanized",0,"Sun","weekend"
"8855",2020-03-29,"Kebler","2","2","2",13.3,0,49,-1,24,27.1,0,0,-1,-2,-1,-1,-2,-4,"w1920","Motorized",11,"Sun","weekend"
"8856",2020-03-29,"Kebler","2","2","2",13.3,0,49,-1,24,27.1,0,0,-1,-2,-1,-1,-2,-4,"w1920","Hybrid",NA,"Sun","weekend"
"8857",2020-03-30,"Kebler","2","2","2",13.4,0.1,49,0,29,27.3,-1,0,0,-1,-1,-1,-1,-2,"w1920","Non.motorized",8,"Mon","weekday"
"8858",2020-03-30,"Kebler","2","2","2",13.4,0.1,49,0,29,27.3,-1,0,0,-1,-1,-1,-1,-2,"w1920","Mechanized",0,"Mon","weekday"
"8859",2020-03-30,"Kebler","2","2","2",13.4,0.1,49,0,29,27.3,-1,0,0,-1,-1,-1,-1,-2,"w1920","Motorized",49,"Mon","weekday"
"8860",2020-03-30,"Kebler","2","2","2",13.4,0.1,49,0,29,27.3,-1,0,0,-1,-1,-1,-1,-2,"w1920","Hybrid",NA,"Mon","weekday"
"8861",2020-03-31,"Kebler","2","2","2",13.6,0.2,51,2,35,26.7,0,-1,0,0,2,1,1,1,"w1920","Non.motorized",7,"Tue","weekday"
"8862",2020-03-31,"Kebler","2","2","2",13.6,0.2,51,2,35,26.7,0,-1,0,0,2,1,1,1,"w1920","Mechanized",0,"Tue","weekday"
"8863",2020-03-31,"Kebler","2","2","2",13.6,0.2,51,2,35,26.7,0,-1,0,0,2,1,1,1,"w1920","Motorized",20,"Tue","weekday"
"8864",2020-03-31,"Kebler","2","2","2",13.6,0.2,51,2,35,26.7,0,-1,0,0,2,1,1,1,"w1920","Hybrid",NA,"Tue","weekday"
"8865",2020-04-01,"Kebler","2","2","2",13.6,0,47,-4,39,28.9,2,0,-1,0,-2,-2,-3,-3,"w1920","Non.motorized",2,"Wed","weekday"
"8866",2020-04-01,"Kebler","2","2","2",13.6,0,47,-4,39,28.9,2,0,-1,0,-2,-2,-3,-3,"w1920","Mechanized",0,"Wed","weekday"
"8867",2020-04-01,"Kebler","2","2","2",13.6,0,47,-4,39,28.9,2,0,-1,0,-2,-2,-3,-3,"w1920","Motorized",23,"Wed","weekday"
"8868",2020-04-01,"Kebler","2","2","2",13.6,0,47,-4,39,28.9,2,0,-1,0,-2,-2,-3,-3,"w1920","Hybrid",NA,"Wed","weekday"
"8869",2020-04-02,"Kebler","2","2","2",13.6,0,46,-1,31,29.6,-4,2,0,-1,-5,-3,-3,-4,"w1920","Non.motorized",17,"Thu","weekday"
"8870",2020-04-02,"Kebler","2","2","2",13.6,0,46,-1,31,29.6,-4,2,0,-1,-5,-3,-3,-4,"w1920","Mechanized",0,"Thu","weekday"
"8871",2020-04-02,"Kebler","2","2","2",13.6,0,46,-1,31,29.6,-4,2,0,-1,-5,-3,-3,-4,"w1920","Motorized",37,"Thu","weekday"
"8872",2020-04-02,"Kebler","2","2","2",13.6,0,46,-1,31,29.6,-4,2,0,-1,-5,-3,-3,-4,"w1920","Hybrid",NA,"Thu","weekday"
"8873",2020-04-03,"Kebler","2","2","2",13.6,0,46,0,28,29.6,-1,-4,2,0,-1,-5,-3,-3,"w1920","Non.motorized",0,"Fri","weekday"
"8874",2020-04-03,"Kebler","2","2","2",13.6,0,46,0,28,29.6,-1,-4,2,0,-1,-5,-3,-3,"w1920","Mechanized",0,"Fri","weekday"
"8875",2020-04-03,"Kebler","2","2","2",13.6,0,46,0,28,29.6,-1,-4,2,0,-1,-5,-3,-3,"w1920","Motorized",3,"Fri","weekday"
"8876",2020-04-03,"Kebler","2","2","2",13.6,0,46,0,28,29.6,-1,-4,2,0,-1,-5,-3,-3,"w1920","Hybrid",NA,"Fri","weekday"
"8877",2020-04-04,"Kebler","2","2","2",13.6,0,45,-1,33,30.2,0,-1,-4,2,-1,-2,-6,-4,"w1920","Non.motorized",0,"Sat","weekend"
"8878",2020-04-04,"Kebler","2","2","2",13.6,0,45,-1,33,30.2,0,-1,-4,2,-1,-2,-6,-4,"w1920","Mechanized",0,"Sat","weekend"
"8879",2020-04-04,"Kebler","2","2","2",13.6,0,45,-1,33,30.2,0,-1,-4,2,-1,-2,-6,-4,"w1920","Motorized",4,"Sat","weekend"
"8880",2020-04-04,"Kebler","2","2","2",13.6,0,45,-1,33,30.2,0,-1,-4,2,-1,-2,-6,-4,"w1920","Hybrid",NA,"Sat","weekend"
"8881",2020-04-05,"Kebler","2","2","3",13.6,0,45,0,38,30.2,-1,0,-1,-4,-1,-1,-2,-6,"w1920","Non.motorized",2,"Sun","weekend"
"8882",2020-04-05,"Kebler","2","2","3",13.6,0,45,0,38,30.2,-1,0,-1,-4,-1,-1,-2,-6,"w1920","Mechanized",0,"Sun","weekend"
"8883",2020-04-05,"Kebler","2","2","3",13.6,0,45,0,38,30.2,-1,0,-1,-4,-1,-1,-2,-6,"w1920","Motorized",8,"Sun","weekend"
"8884",2020-04-05,"Kebler","2","2","3",13.6,0,45,0,38,30.2,-1,0,-1,-4,-1,-1,-2,-6,"w1920","Hybrid",NA,"Sun","weekend"
"8885",2020-04-06,"Kebler","2","2","3",13.6,0,44,-1,40,30.9,0,-1,0,-1,-1,-2,-2,-3,"w1920","Non.motorized",1,"Mon","weekday"
"8886",2020-04-06,"Kebler","2","2","3",13.6,0,44,-1,40,30.9,0,-1,0,-1,-1,-2,-2,-3,"w1920","Mechanized",0,"Mon","weekday"
"8887",2020-04-06,"Kebler","2","2","3",13.6,0,44,-1,40,30.9,0,-1,0,-1,-1,-2,-2,-3,"w1920","Motorized",7,"Mon","weekday"
"8888",2020-04-06,"Kebler","2","2","3",13.6,0,44,-1,40,30.9,0,-1,0,-1,-1,-2,-2,-3,"w1920","Hybrid",NA,"Mon","weekday"
"8889",2020-04-07,"Kebler","2","2","3",13.4,-0.2,43,-1,39,31.2,-1,0,-1,0,-2,-2,-3,-3,"w1920","Non.motorized",5,"Tue","weekday"
"8890",2020-04-07,"Kebler","2","2","3",13.4,-0.2,43,-1,39,31.2,-1,0,-1,0,-2,-2,-3,-3,"w1920","Mechanized",1,"Tue","weekday"
"8891",2020-04-07,"Kebler","2","2","3",13.4,-0.2,43,-1,39,31.2,-1,0,-1,0,-2,-2,-3,-3,"w1920","Motorized",12,"Tue","weekday"
"8892",2020-04-07,"Kebler","2","2","3",13.4,-0.2,43,-1,39,31.2,-1,0,-1,0,-2,-2,-3,-3,"w1920","Hybrid",NA,"Tue","weekday"
"8893",2020-04-08,"Kebler","2","3","3",13.3,-0.1,42,-1,40,31.7,-1,-1,0,-1,-2,-3,-3,-4,"w1920","Non.motorized",2,"Wed","weekday"
"8894",2020-04-08,"Kebler","2","3","3",13.3,-0.1,42,-1,40,31.7,-1,-1,0,-1,-2,-3,-3,-4,"w1920","Mechanized",0,"Wed","weekday"
"8895",2020-04-08,"Kebler","2","3","3",13.3,-0.1,42,-1,40,31.7,-1,-1,0,-1,-2,-3,-3,-4,"w1920","Motorized",32,"Wed","weekday"
"8896",2020-04-08,"Kebler","2","3","3",13.3,-0.1,42,-1,40,31.7,-1,-1,0,-1,-2,-3,-3,-4,"w1920","Hybrid",NA,"Wed","weekday"
"8897",2020-04-09,"Kebler","2","3","3",13.1,-0.2,40,-2,42,32.8,-1,-1,-1,0,-3,-4,-5,-5,"w1920","Non.motorized",4,"Thu","weekday"
"8898",2020-04-09,"Kebler","2","3","3",13.1,-0.2,40,-2,42,32.8,-1,-1,-1,0,-3,-4,-5,-5,"w1920","Mechanized",0,"Thu","weekday"
"8899",2020-04-09,"Kebler","2","3","3",13.1,-0.2,40,-2,42,32.8,-1,-1,-1,0,-3,-4,-5,-5,"w1920","Motorized",17,"Thu","weekday"
"8900",2020-04-09,"Kebler","2","3","3",13.1,-0.2,40,-2,42,32.8,-1,-1,-1,0,-3,-4,-5,-5,"w1920","Hybrid",NA,"Thu","weekday"
"8901",2020-04-10,"Kebler","3","3","3",12.9,-0.2,39,-1,38,33.1,-2,-1,-1,-1,-3,-4,-5,-6,"w1920","Non.motorized",2,"Fri","weekday"
"8902",2020-04-10,"Kebler","3","3","3",12.9,-0.2,39,-1,38,33.1,-2,-1,-1,-1,-3,-4,-5,-6,"w1920","Mechanized",0,"Fri","weekday"
"8903",2020-04-10,"Kebler","3","3","3",12.9,-0.2,39,-1,38,33.1,-2,-1,-1,-1,-3,-4,-5,-6,"w1920","Motorized",6,"Fri","weekday"
"8904",2020-04-10,"Kebler","3","3","3",12.9,-0.2,39,-1,38,33.1,-2,-1,-1,-1,-3,-4,-5,-6,"w1920","Hybrid",NA,"Fri","weekday"
"8905",2020-04-11,"Kebler","2","3","3",12.9,0,39,0,36,33.1,-1,-2,-1,-1,-1,-3,-4,-5,"w1920","Non.motorized",3,"Sat","weekend"
"8906",2020-04-11,"Kebler","2","3","3",12.9,0,39,0,36,33.1,-1,-2,-1,-1,-1,-3,-4,-5,"w1920","Mechanized",1,"Sat","weekend"
"8907",2020-04-11,"Kebler","2","3","3",12.9,0,39,0,36,33.1,-1,-2,-1,-1,-1,-3,-4,-5,"w1920","Motorized",47,"Sat","weekend"
"8908",2020-04-11,"Kebler","2","3","3",12.9,0,39,0,36,33.1,-1,-2,-1,-1,-1,-3,-4,-5,"w1920","Hybrid",NA,"Sat","weekend"
"8909",2020-04-12,"Kebler","2","2","2",12.8,-0.1,38,-1,29,33.7,0,-1,-2,-1,-1,-2,-4,-5,"w1920","Non.motorized",5,"Sun","weekend"
"8910",2020-04-12,"Kebler","2","2","2",12.8,-0.1,38,-1,29,33.7,0,-1,-2,-1,-1,-2,-4,-5,"w1920","Mechanized",1,"Sun","weekend"
"8911",2020-04-12,"Kebler","2","2","2",12.8,-0.1,38,-1,29,33.7,0,-1,-2,-1,-1,-2,-4,-5,"w1920","Motorized",30,"Sun","weekend"
"8912",2020-04-12,"Kebler","2","2","2",12.8,-0.1,38,-1,29,33.7,0,-1,-2,-1,-1,-2,-4,-5,"w1920","Hybrid",NA,"Sun","weekend"
"8913",2020-04-13,"Kebler",NA,NA,NA,12.9,0.1,39,1,20,33.1,-1,0,-1,-2,0,0,-1,-3,"w1920","Non.motorized",3,"Mon","weekday"
"8914",2020-04-13,"Kebler",NA,NA,NA,12.9,0.1,39,1,20,33.1,-1,0,-1,-2,0,0,-1,-3,"w1920","Mechanized",0,"Mon","weekday"
"8915",2020-04-13,"Kebler",NA,NA,NA,12.9,0.1,39,1,20,33.1,-1,0,-1,-2,0,0,-1,-3,"w1920","Motorized",28,"Mon","weekday"
"8916",2020-04-13,"Kebler",NA,NA,NA,12.9,0.1,39,1,20,33.1,-1,0,-1,-2,0,0,-1,-3,"w1920","Hybrid",NA,"Mon","weekday"
"8917",2020-04-14,"Kebler","2","2","2",13,0.1,39,0,18,33.3,1,-1,0,-1,1,0,0,-1,"w1920","Non.motorized",6,"Tue","weekday"
"8918",2020-04-14,"Kebler","2","2","2",13,0.1,39,0,18,33.3,1,-1,0,-1,1,0,0,-1,"w1920","Mechanized",0,"Tue","weekday"
"8919",2020-04-14,"Kebler","2","2","2",13,0.1,39,0,18,33.3,1,-1,0,-1,1,0,0,-1,"w1920","Motorized",25,"Tue","weekday"
"8920",2020-04-14,"Kebler","2","2","2",13,0.1,39,0,18,33.3,1,-1,0,-1,1,0,0,-1,"w1920","Hybrid",NA,"Tue","weekday"
"8921",2020-04-15,"Kebler",NA,NA,NA,13.2,0.2,39,0,28,33.8,0,1,-1,0,0,1,0,0,"w1920","Non.motorized",8,"Wed","weekday"
"8922",2020-04-15,"Kebler",NA,NA,NA,13.2,0.2,39,0,28,33.8,0,1,-1,0,0,1,0,0,"w1920","Mechanized",0,"Wed","weekday"
"8923",2020-04-15,"Kebler",NA,NA,NA,13.2,0.2,39,0,28,33.8,0,1,-1,0,0,1,0,0,"w1920","Motorized",19,"Wed","weekday"
"8924",2020-04-15,"Kebler",NA,NA,NA,13.2,0.2,39,0,28,33.8,0,1,-1,0,0,1,0,0,"w1920","Hybrid",NA,"Wed","weekday"
"8925",2019-12-06,"Slate River Rd","2","2","1",2.9,0.4,19,5,24,15.3,0,0,0,0,5,5,5,5,"w1920","Non.motorized",3,"Fri","weekday"
"8926",2019-12-06,"Slate River Rd","2","2","1",2.9,0.4,19,5,24,15.3,0,0,0,0,5,5,5,5,"w1920","Mechanized",0,"Fri","weekday"
"8927",2019-12-06,"Slate River Rd","2","2","1",2.9,0.4,19,5,24,15.3,0,0,0,0,5,5,5,5,"w1920","Motorized",5,"Fri","weekday"
"8928",2019-12-06,"Slate River Rd","2","2","1",2.9,0.4,19,5,24,15.3,0,0,0,0,5,5,5,5,"w1920","Hybrid",NA,"Fri","weekday"
"8929",2019-12-07,"Slate River Rd","2","2","1",3,0.1,18,-1,29,16.7,5,0,0,0,4,4,4,4,"w1920","Non.motorized",37,"Sat","weekend"
"8930",2019-12-07,"Slate River Rd","2","2","1",3,0.1,18,-1,29,16.7,5,0,0,0,4,4,4,4,"w1920","Mechanized",1,"Sat","weekend"
"8931",2019-12-07,"Slate River Rd","2","2","1",3,0.1,18,-1,29,16.7,5,0,0,0,4,4,4,4,"w1920","Motorized",8,"Sat","weekend"
"8932",2019-12-07,"Slate River Rd","2","2","1",3,0.1,18,-1,29,16.7,5,0,0,0,4,4,4,4,"w1920","Hybrid",NA,"Sat","weekend"
"8933",2019-12-08,"Slate River Rd","2","2","1",3,0,17,-1,28,17.6,-1,5,0,0,-2,3,3,3,"w1920","Non.motorized",8,"Sun","weekend"
"8934",2019-12-08,"Slate River Rd","2","2","1",3,0,17,-1,28,17.6,-1,5,0,0,-2,3,3,3,"w1920","Mechanized",1,"Sun","weekend"
"8935",2019-12-08,"Slate River Rd","2","2","1",3,0,17,-1,28,17.6,-1,5,0,0,-2,3,3,3,"w1920","Motorized",3,"Sun","weekend"
"8936",2019-12-08,"Slate River Rd","2","2","1",3,0,17,-1,28,17.6,-1,5,0,0,-2,3,3,3,"w1920","Hybrid",NA,"Sun","weekend"
"8937",2019-12-09,"Slate River Rd","3","3","2",3.4,0.4,22,5,21,15.5,-1,-1,5,0,4,3,8,8,"w1920","Non.motorized",13,"Mon","weekday"
"8938",2019-12-09,"Slate River Rd","3","3","2",3.4,0.4,22,5,21,15.5,-1,-1,5,0,4,3,8,8,"w1920","Mechanized",0,"Mon","weekday"
"8939",2019-12-09,"Slate River Rd","3","3","2",3.4,0.4,22,5,21,15.5,-1,-1,5,0,4,3,8,8,"w1920","Motorized",5,"Mon","weekday"
"8940",2019-12-09,"Slate River Rd","3","3","2",3.4,0.4,22,5,21,15.5,-1,-1,5,0,4,3,8,8,"w1920","Hybrid",NA,"Mon","weekday"
"8941",2019-12-10,"Slate River Rd","2","2","2",3.4,0,21,-1,19,16.2,5,-1,-1,5,4,3,2,7,"w1920","Non.motorized",21,"Tue","weekday"
"8942",2019-12-10,"Slate River Rd","2","2","2",3.4,0,21,-1,19,16.2,5,-1,-1,5,4,3,2,7,"w1920","Mechanized",0,"Tue","weekday"
"8943",2019-12-10,"Slate River Rd","2","2","2",3.4,0,21,-1,19,16.2,5,-1,-1,5,4,3,2,7,"w1920","Motorized",3,"Tue","weekday"
"8944",2019-12-10,"Slate River Rd","2","2","2",3.4,0,21,-1,19,16.2,5,-1,-1,5,4,3,2,7,"w1920","Hybrid",NA,"Tue","weekday"
"8945",2019-12-11,"Slate River Rd","2","2","2",3.4,0,20,-1,22,17,-1,5,-1,-1,-2,3,2,1,"w1920","Non.motorized",11,"Wed","weekday"
"8946",2019-12-11,"Slate River Rd","2","2","2",3.4,0,20,-1,22,17,-1,5,-1,-1,-2,3,2,1,"w1920","Mechanized",0,"Wed","weekday"
"8947",2019-12-11,"Slate River Rd","2","2","2",3.4,0,20,-1,22,17,-1,5,-1,-1,-2,3,2,1,"w1920","Motorized",5,"Wed","weekday"
"8948",2019-12-11,"Slate River Rd","2","2","2",3.4,0,20,-1,22,17,-1,5,-1,-1,-2,3,2,1,"w1920","Hybrid",NA,"Wed","weekday"
"8949",2019-12-12,"Slate River Rd","2","2","2",3.4,0,19,-1,25,17.9,-1,-1,5,-1,-2,-3,2,1,"w1920","Non.motorized",19,"Thu","weekday"
"8950",2019-12-12,"Slate River Rd","2","2","2",3.4,0,19,-1,25,17.9,-1,-1,5,-1,-2,-3,2,1,"w1920","Mechanized",0,"Thu","weekday"
"8951",2019-12-12,"Slate River Rd","2","2","2",3.4,0,19,-1,25,17.9,-1,-1,5,-1,-2,-3,2,1,"w1920","Motorized",4,"Thu","weekday"
"8952",2019-12-12,"Slate River Rd","2","2","2",3.4,0,19,-1,25,17.9,-1,-1,5,-1,-2,-3,2,1,"w1920","Hybrid",NA,"Thu","weekday"
"8953",2019-12-13,"Slate River Rd","2","2","2",3.8,0.4,21,2,24,18.1,-1,-1,-1,5,1,0,-1,4,"w1920","Non.motorized",3,"Fri","weekday"
"8954",2019-12-13,"Slate River Rd","2","2","2",3.8,0.4,21,2,24,18.1,-1,-1,-1,5,1,0,-1,4,"w1920","Mechanized",0,"Fri","weekday"
"8955",2019-12-13,"Slate River Rd","2","2","2",3.8,0.4,21,2,24,18.1,-1,-1,-1,5,1,0,-1,4,"w1920","Motorized",3,"Fri","weekday"
"8956",2019-12-13,"Slate River Rd","2","2","2",3.8,0.4,21,2,24,18.1,-1,-1,-1,5,1,0,-1,4,"w1920","Hybrid",NA,"Fri","weekday"
"8957",2019-12-14,"Slate River Rd","3","3","3",4.2,0.4,27,6,25,15.6,2,-1,-1,-1,8,7,6,5,"w1920","Non.motorized",13,"Sat","weekend"
"8958",2019-12-14,"Slate River Rd","3","3","3",4.2,0.4,27,6,25,15.6,2,-1,-1,-1,8,7,6,5,"w1920","Mechanized",0,"Sat","weekend"
"8959",2019-12-14,"Slate River Rd","3","3","3",4.2,0.4,27,6,25,15.6,2,-1,-1,-1,8,7,6,5,"w1920","Motorized",1,"Sat","weekend"
"8960",2019-12-14,"Slate River Rd","3","3","3",4.2,0.4,27,6,25,15.6,2,-1,-1,-1,8,7,6,5,"w1920","Hybrid",NA,"Sat","weekend"
"8961",2019-12-15,"Slate River Rd","3","3","2",4.8,0.6,31,4,17,15.5,6,2,-1,-1,10,12,11,10,"w1920","Non.motorized",16,"Sun","weekend"
"8962",2019-12-15,"Slate River Rd","3","3","2",4.8,0.6,31,4,17,15.5,6,2,-1,-1,10,12,11,10,"w1920","Mechanized",0,"Sun","weekend"
"8963",2019-12-15,"Slate River Rd","3","3","2",4.8,0.6,31,4,17,15.5,6,2,-1,-1,10,12,11,10,"w1920","Motorized",3,"Sun","weekend"
"8964",2019-12-15,"Slate River Rd","3","3","2",4.8,0.6,31,4,17,15.5,6,2,-1,-1,10,12,11,10,"w1920","Hybrid",NA,"Sun","weekend"
"8965",2019-12-16,"Slate River Rd","3","3","2",4.8,0,29,-2,6,16.6,4,6,2,-1,2,8,10,9,"w1920","Non.motorized",7,"Mon","weekday"
"8966",2019-12-16,"Slate River Rd","3","3","2",4.8,0,29,-2,6,16.6,4,6,2,-1,2,8,10,9,"w1920","Mechanized",0,"Mon","weekday"
"8967",2019-12-16,"Slate River Rd","3","3","2",4.8,0,29,-2,6,16.6,4,6,2,-1,2,8,10,9,"w1920","Motorized",5,"Mon","weekday"
"8968",2019-12-16,"Slate River Rd","3","3","2",4.8,0,29,-2,6,16.6,4,6,2,-1,2,8,10,9,"w1920","Hybrid",NA,"Mon","weekday"
"8969",2019-12-17,"Slate River Rd","2","2","1",4.8,0,27,-2,8,17.8,-2,4,6,2,-4,0,6,8,"w1920","Non.motorized",7,"Tue","weekday"
"8970",2019-12-17,"Slate River Rd","2","2","1",4.8,0,27,-2,8,17.8,-2,4,6,2,-4,0,6,8,"w1920","Mechanized",0,"Tue","weekday"
"8971",2019-12-17,"Slate River Rd","2","2","1",4.8,0,27,-2,8,17.8,-2,4,6,2,-4,0,6,8,"w1920","Motorized",1,"Tue","weekday"
"8972",2019-12-17,"Slate River Rd","2","2","1",4.8,0,27,-2,8,17.8,-2,4,6,2,-4,0,6,8,"w1920","Hybrid",NA,"Tue","weekday"
"8973",2019-12-18,"Slate River Rd","2","2","1",4.8,0,26,-1,20,18.5,-2,-2,4,6,-3,-5,-1,5,"w1920","Non.motorized",19,"Wed","weekday"
"8974",2019-12-18,"Slate River Rd","2","2","1",4.8,0,26,-1,20,18.5,-2,-2,4,6,-3,-5,-1,5,"w1920","Mechanized",0,"Wed","weekday"
"8975",2019-12-18,"Slate River Rd","2","2","1",4.8,0,26,-1,20,18.5,-2,-2,4,6,-3,-5,-1,5,"w1920","Motorized",8,"Wed","weekday"
"8976",2019-12-18,"Slate River Rd","2","2","1",4.8,0,26,-1,20,18.5,-2,-2,4,6,-3,-5,-1,5,"w1920","Hybrid",NA,"Wed","weekday"
"8977",2019-12-19,"Slate River Rd","2","2","1",4.9,0.1,25,-1,21,19.6,-1,-2,-2,4,-2,-4,-6,-2,"w1920","Non.motorized",16,"Thu","weekday"
"8978",2019-12-19,"Slate River Rd","2","2","1",4.9,0.1,25,-1,21,19.6,-1,-2,-2,4,-2,-4,-6,-2,"w1920","Mechanized",0,"Thu","weekday"
"8979",2019-12-19,"Slate River Rd","2","2","1",4.9,0.1,25,-1,21,19.6,-1,-2,-2,4,-2,-4,-6,-2,"w1920","Motorized",4,"Thu","weekday"
"8980",2019-12-19,"Slate River Rd","2","2","1",4.9,0.1,25,-1,21,19.6,-1,-2,-2,4,-2,-4,-6,-2,"w1920","Hybrid",NA,"Thu","weekday"
"8981",2019-12-20,"Slate River Rd","2","2","1",4.9,0,24,-1,21,20.4,-1,-1,-2,-2,-2,-3,-5,-7,"w1920","Non.motorized",13,"Fri","weekday"
"8982",2019-12-20,"Slate River Rd","2","2","1",4.9,0,24,-1,21,20.4,-1,-1,-2,-2,-2,-3,-5,-7,"w1920","Mechanized",1,"Fri","weekday"
"8983",2019-12-20,"Slate River Rd","2","2","1",4.9,0,24,-1,21,20.4,-1,-1,-2,-2,-2,-3,-5,-7,"w1920","Motorized",6,"Fri","weekday"
"8984",2019-12-20,"Slate River Rd","2","2","1",4.9,0,24,-1,21,20.4,-1,-1,-2,-2,-2,-3,-5,-7,"w1920","Hybrid",NA,"Fri","weekday"
"8985",2019-12-21,"Slate River Rd","2","2","1",4.9,0,24,0,27,20.4,-1,-1,-1,-2,-1,-2,-3,-5,"w1920","Non.motorized",26,"Sat","weekend"
"8986",2019-12-21,"Slate River Rd","2","2","1",4.9,0,24,0,27,20.4,-1,-1,-1,-2,-1,-2,-3,-5,"w1920","Mechanized",0,"Sat","weekend"
"8987",2019-12-21,"Slate River Rd","2","2","1",4.9,0,24,0,27,20.4,-1,-1,-1,-2,-1,-2,-3,-5,"w1920","Motorized",10,"Sat","weekend"
"8988",2019-12-21,"Slate River Rd","2","2","1",4.9,0,24,0,27,20.4,-1,-1,-1,-2,-1,-2,-3,-5,"w1920","Hybrid",NA,"Sat","weekend"
"8989",2019-12-22,"Slate River Rd","2","2","1",5,0.1,23,-1,31,21.7,0,-1,-1,-1,-1,-2,-3,-4,"w1920","Non.motorized",40,"Sun","weekend"
"8990",2019-12-22,"Slate River Rd","2","2","1",5,0.1,23,-1,31,21.7,0,-1,-1,-1,-1,-2,-3,-4,"w1920","Mechanized",0,"Sun","weekend"
"8991",2019-12-22,"Slate River Rd","2","2","1",5,0.1,23,-1,31,21.7,0,-1,-1,-1,-1,-2,-3,-4,"w1920","Motorized",18,"Sun","weekend"
"8992",2019-12-22,"Slate River Rd","2","2","1",5,0.1,23,-1,31,21.7,0,-1,-1,-1,-1,-2,-3,-4,"w1920","Hybrid",NA,"Sun","weekend"
"8993",2019-12-23,"Slate River Rd","2","1","1",5,0,23,0,34,21.7,-1,0,-1,-1,-1,-1,-2,-3,"w1920","Non.motorized",30,"Mon","weekday"
"8994",2019-12-23,"Slate River Rd","2","1","1",5,0,23,0,34,21.7,-1,0,-1,-1,-1,-1,-2,-3,"w1920","Mechanized",0,"Mon","weekday"
"8995",2019-12-23,"Slate River Rd","2","1","1",5,0,23,0,34,21.7,-1,0,-1,-1,-1,-1,-2,-3,"w1920","Motorized",3,"Mon","weekday"
"8996",2019-12-23,"Slate River Rd","2","1","1",5,0,23,0,34,21.7,-1,0,-1,-1,-1,-1,-2,-3,"w1920","Hybrid",NA,"Mon","weekday"
"8997",2019-12-24,"Slate River Rd","2","1","1",5,0,22,-1,30,22.7,0,-1,0,-1,-1,-2,-2,-3,"w1920","Non.motorized",35,"Tue","weekday"
"8998",2019-12-24,"Slate River Rd","2","1","1",5,0,22,-1,30,22.7,0,-1,0,-1,-1,-2,-2,-3,"w1920","Mechanized",1,"Tue","weekday"
"8999",2019-12-24,"Slate River Rd","2","1","1",5,0,22,-1,30,22.7,0,-1,0,-1,-1,-2,-2,-3,"w1920","Motorized",5,"Tue","weekday"
"9000",2019-12-24,"Slate River Rd","2","1","1",5,0,22,-1,30,22.7,0,-1,0,-1,-1,-2,-2,-3,"w1920","Hybrid",NA,"Tue","weekday"
"9001",2019-12-25,"Slate River Rd","2","2","2",5,0,23,1,22,21.7,-1,0,-1,0,0,0,-1,-1,"w1920","Non.motorized",38,"Wed","weekday"
"9002",2019-12-25,"Slate River Rd","2","2","2",5,0,23,1,22,21.7,-1,0,-1,0,0,0,-1,-1,"w1920","Mechanized",0,"Wed","weekday"
"9003",2019-12-25,"Slate River Rd","2","2","2",5,0,23,1,22,21.7,-1,0,-1,0,0,0,-1,-1,"w1920","Motorized",6,"Wed","weekday"
"9004",2019-12-25,"Slate River Rd","2","2","2",5,0,23,1,22,21.7,-1,0,-1,0,0,0,-1,-1,"w1920","Hybrid",NA,"Wed","weekday"
"9005",2019-12-26,"Slate River Rd","2","2","1",5,0,23,0,17,21.7,1,-1,0,-1,1,0,0,-1,"w1920","Non.motorized",41,"Thu","weekday"
"9006",2019-12-26,"Slate River Rd","2","2","1",5,0,23,0,17,21.7,1,-1,0,-1,1,0,0,-1,"w1920","Mechanized",0,"Thu","weekday"
"9007",2019-12-26,"Slate River Rd","2","2","1",5,0,23,0,17,21.7,1,-1,0,-1,1,0,0,-1,"w1920","Motorized",5,"Thu","weekday"
"9008",2019-12-26,"Slate River Rd","2","2","1",5,0,23,0,17,21.7,1,-1,0,-1,1,0,0,-1,"w1920","Hybrid",NA,"Thu","weekday"
"9009",2019-12-27,"Slate River Rd","3","3","2",5.1,0.1,24,1,22,21.2,0,1,-1,0,1,2,1,1,"w1920","Non.motorized",29,"Fri","weekday"
"9010",2019-12-27,"Slate River Rd","3","3","2",5.1,0.1,24,1,22,21.2,0,1,-1,0,1,2,1,1,"w1920","Mechanized",0,"Fri","weekday"
"9011",2019-12-27,"Slate River Rd","3","3","2",5.1,0.1,24,1,22,21.2,0,1,-1,0,1,2,1,1,"w1920","Motorized",5,"Fri","weekday"
"9012",2019-12-27,"Slate River Rd","3","3","2",5.1,0.1,24,1,22,21.2,0,1,-1,0,1,2,1,1,"w1920","Hybrid",NA,"Fri","weekday"
"9013",2019-12-28,"Slate River Rd","3","3","2",5.6,0.5,30,6,16,18.7,1,0,1,-1,7,7,8,7,"w1920","Non.motorized",22,"Sat","weekend"
"9014",2019-12-28,"Slate River Rd","3","3","2",5.6,0.5,30,6,16,18.7,1,0,1,-1,7,7,8,7,"w1920","Mechanized",0,"Sat","weekend"
"9015",2019-12-28,"Slate River Rd","3","3","2",5.6,0.5,30,6,16,18.7,1,0,1,-1,7,7,8,7,"w1920","Motorized",6,"Sat","weekend"
"9016",2019-12-28,"Slate River Rd","3","3","2",5.6,0.5,30,6,16,18.7,1,0,1,-1,7,7,8,7,"w1920","Hybrid",NA,"Sat","weekend"
"9017",2019-12-29,"Slate River Rd","3","3","2",5.6,0,29,-1,3,19.3,6,1,0,1,5,6,6,7,"w1920","Non.motorized",45,"Sun","weekend"
"9018",2019-12-29,"Slate River Rd","3","3","2",5.6,0,29,-1,3,19.3,6,1,0,1,5,6,6,7,"w1920","Mechanized",0,"Sun","weekend"
"9019",2019-12-29,"Slate River Rd","3","3","2",5.6,0,29,-1,3,19.3,6,1,0,1,5,6,6,7,"w1920","Motorized",16,"Sun","weekend"
"9020",2019-12-29,"Slate River Rd","3","3","2",5.6,0,29,-1,3,19.3,6,1,0,1,5,6,6,7,"w1920","Hybrid",NA,"Sun","weekend"
"9021",2019-12-30,"Slate River Rd","3","3","2",5.6,0,28,-1,3,20,-1,6,1,0,-2,4,5,5,"w1920","Non.motorized",NA,"Mon","weekday"
"9022",2019-12-30,"Slate River Rd","3","3","2",5.6,0,28,-1,3,20,-1,6,1,0,-2,4,5,5,"w1920","Mechanized",NA,"Mon","weekday"
"9023",2019-12-30,"Slate River Rd","3","3","2",5.6,0,28,-1,3,20,-1,6,1,0,-2,4,5,5,"w1920","Motorized",NA,"Mon","weekday"
"9024",2019-12-30,"Slate River Rd","3","3","2",5.6,0,28,-1,3,20,-1,6,1,0,-2,4,5,5,"w1920","Hybrid",NA,"Mon","weekday"
"9025",2019-12-31,"Slate River Rd","2","2","1",5.6,0,28,0,13,20,-1,-1,6,1,-1,-2,4,5,"w1920","Non.motorized",NA,"Tue","weekday"
"9026",2019-12-31,"Slate River Rd","2","2","1",5.6,0,28,0,13,20,-1,-1,6,1,-1,-2,4,5,"w1920","Mechanized",NA,"Tue","weekday"
"9027",2019-12-31,"Slate River Rd","2","2","1",5.6,0,28,0,13,20,-1,-1,6,1,-1,-2,4,5,"w1920","Motorized",NA,"Tue","weekday"
"9028",2019-12-31,"Slate River Rd","2","2","1",5.6,0,28,0,13,20,-1,-1,6,1,-1,-2,4,5,"w1920","Hybrid",NA,"Tue","weekday"
"9029",2020-01-01,"Slate River Rd","2","1","1",5.6,0,27,-1,21,20.7,0,-1,-1,6,-1,-2,-3,3,"w1920","Non.motorized",NA,"Wed","weekday"
"9030",2020-01-01,"Slate River Rd","2","1","1",5.6,0,27,-1,21,20.7,0,-1,-1,6,-1,-2,-3,3,"w1920","Mechanized",NA,"Wed","weekday"
"9031",2020-01-01,"Slate River Rd","2","1","1",5.6,0,27,-1,21,20.7,0,-1,-1,6,-1,-2,-3,3,"w1920","Motorized",NA,"Wed","weekday"
"9032",2020-01-01,"Slate River Rd","2","1","1",5.6,0,27,-1,21,20.7,0,-1,-1,6,-1,-2,-3,3,"w1920","Hybrid",NA,"Wed","weekday"
"9033",2020-01-02,"Slate River Rd","3","3","2",5.9,0.3,29,2,16,20.3,-1,0,-1,-1,1,1,0,-1,"w1920","Non.motorized",NA,"Thu","weekday"
"9034",2020-01-02,"Slate River Rd","3","3","2",5.9,0.3,29,2,16,20.3,-1,0,-1,-1,1,1,0,-1,"w1920","Mechanized",NA,"Thu","weekday"
"9035",2020-01-02,"Slate River Rd","3","3","2",5.9,0.3,29,2,16,20.3,-1,0,-1,-1,1,1,0,-1,"w1920","Motorized",NA,"Thu","weekday"
"9036",2020-01-02,"Slate River Rd","3","3","2",5.9,0.3,29,2,16,20.3,-1,0,-1,-1,1,1,0,-1,"w1920","Hybrid",NA,"Thu","weekday"
"9037",2020-01-03,"Slate River Rd","3","2","1",5.9,0,31,2,19,19,2,-1,0,-1,4,3,3,2,"w1920","Non.motorized",NA,"Fri","weekday"
"9038",2020-01-03,"Slate River Rd","3","2","1",5.9,0,31,2,19,19,2,-1,0,-1,4,3,3,2,"w1920","Mechanized",NA,"Fri","weekday"
"9039",2020-01-03,"Slate River Rd","3","2","1",5.9,0,31,2,19,19,2,-1,0,-1,4,3,3,2,"w1920","Motorized",NA,"Fri","weekday"
"9040",2020-01-03,"Slate River Rd","3","2","1",5.9,0,31,2,19,19,2,-1,0,-1,4,3,3,2,"w1920","Hybrid",NA,"Fri","weekday"
"9041",2020-01-04,"Slate River Rd","2","2","1",5.9,0,30,-1,26,19.7,2,2,-1,0,1,3,2,2,"w1920","Non.motorized",NA,"Sat","weekend"
"9042",2020-01-04,"Slate River Rd","2","2","1",5.9,0,30,-1,26,19.7,2,2,-1,0,1,3,2,2,"w1920","Mechanized",NA,"Sat","weekend"
"9043",2020-01-04,"Slate River Rd","2","2","1",5.9,0,30,-1,26,19.7,2,2,-1,0,1,3,2,2,"w1920","Motorized",NA,"Sat","weekend"
"9044",2020-01-04,"Slate River Rd","2","2","1",5.9,0,30,-1,26,19.7,2,2,-1,0,1,3,2,2,"w1920","Hybrid",NA,"Sat","weekend"
"9045",2020-01-05,"Slate River Rd","2","2","1",5.9,0,28,-2,23,21.1,-1,2,2,-1,-3,-1,1,0,"w1920","Non.motorized",NA,"Sun","weekend"
"9046",2020-01-05,"Slate River Rd","2","2","1",5.9,0,28,-2,23,21.1,-1,2,2,-1,-3,-1,1,0,"w1920","Mechanized",NA,"Sun","weekend"
"9047",2020-01-05,"Slate River Rd","2","2","1",5.9,0,28,-2,23,21.1,-1,2,2,-1,-3,-1,1,0,"w1920","Motorized",NA,"Sun","weekend"
"9048",2020-01-05,"Slate River Rd","2","2","1",5.9,0,28,-2,23,21.1,-1,2,2,-1,-3,-1,1,0,"w1920","Hybrid",NA,"Sun","weekend"
"9049",2020-01-06,"Slate River Rd","2","2","1",5.9,0,28,0,15,21.1,-2,-1,2,2,-2,-3,-1,1,"w1920","Non.motorized",NA,"Mon","weekday"
"9050",2020-01-06,"Slate River Rd","2","2","1",5.9,0,28,0,15,21.1,-2,-1,2,2,-2,-3,-1,1,"w1920","Mechanized",NA,"Mon","weekday"
"9051",2020-01-06,"Slate River Rd","2","2","1",5.9,0,28,0,15,21.1,-2,-1,2,2,-2,-3,-1,1,"w1920","Motorized",NA,"Mon","weekday"
"9052",2020-01-06,"Slate River Rd","2","2","1",5.9,0,28,0,15,21.1,-2,-1,2,2,-2,-3,-1,1,"w1920","Hybrid",NA,"Mon","weekday"
"9053",2020-01-07,"Slate River Rd","2","1","1",5.9,0,28,0,22,21.1,0,-2,-1,2,0,-2,-3,-1,"w1920","Non.motorized",NA,"Tue","weekday"
"9054",2020-01-07,"Slate River Rd","2","1","1",5.9,0,28,0,22,21.1,0,-2,-1,2,0,-2,-3,-1,"w1920","Mechanized",NA,"Tue","weekday"
"9055",2020-01-07,"Slate River Rd","2","1","1",5.9,0,28,0,22,21.1,0,-2,-1,2,0,-2,-3,-1,"w1920","Motorized",NA,"Tue","weekday"
"9056",2020-01-07,"Slate River Rd","2","1","1",5.9,0,28,0,22,21.1,0,-2,-1,2,0,-2,-3,-1,"w1920","Hybrid",NA,"Tue","weekday"
"9057",2020-01-08,"Slate River Rd","2","1","1",6,0.1,28,0,23,21.4,0,0,-2,-1,0,0,-2,-3,"w1920","Non.motorized",NA,"Wed","weekday"
"9058",2020-01-08,"Slate River Rd","2","1","1",6,0.1,28,0,23,21.4,0,0,-2,-1,0,0,-2,-3,"w1920","Mechanized",NA,"Wed","weekday"
"9059",2020-01-08,"Slate River Rd","2","1","1",6,0.1,28,0,23,21.4,0,0,-2,-1,0,0,-2,-3,"w1920","Motorized",NA,"Wed","weekday"
"9060",2020-01-08,"Slate River Rd","2","1","1",6,0.1,28,0,23,21.4,0,0,-2,-1,0,0,-2,-3,"w1920","Hybrid",NA,"Wed","weekday"
"9061",2020-01-09,"Slate River Rd","2","1","1",6,0,27,-1,17,22.2,0,0,0,-2,-1,-1,-1,-3,"w1920","Non.motorized",NA,"Thu","weekday"
"9062",2020-01-09,"Slate River Rd","2","1","1",6,0,27,-1,17,22.2,0,0,0,-2,-1,-1,-1,-3,"w1920","Mechanized",NA,"Thu","weekday"
"9063",2020-01-09,"Slate River Rd","2","1","1",6,0,27,-1,17,22.2,0,0,0,-2,-1,-1,-1,-3,"w1920","Motorized",NA,"Thu","weekday"
"9064",2020-01-09,"Slate River Rd","2","1","1",6,0,27,-1,17,22.2,0,0,0,-2,-1,-1,-1,-3,"w1920","Hybrid",NA,"Thu","weekday"
"9065",2020-01-10,"Slate River Rd","2","1","1",6,0,29,2,11,20.7,-1,0,0,0,1,1,1,1,"w1920","Non.motorized",NA,"Fri","weekday"
"9066",2020-01-10,"Slate River Rd","2","1","1",6,0,29,2,11,20.7,-1,0,0,0,1,1,1,1,"w1920","Mechanized",NA,"Fri","weekday"
"9067",2020-01-10,"Slate River Rd","2","1","1",6,0,29,2,11,20.7,-1,0,0,0,1,1,1,1,"w1920","Motorized",NA,"Fri","weekday"
"9068",2020-01-10,"Slate River Rd","2","1","1",6,0,29,2,11,20.7,-1,0,0,0,1,1,1,1,"w1920","Hybrid",NA,"Fri","weekday"
"9069",2020-01-11,"Slate River Rd","2","1","1",6,0,29,0,12,20.7,2,-1,0,0,2,1,1,1,"w1920","Non.motorized",13,"Sat","weekend"
"9070",2020-01-11,"Slate River Rd","2","1","1",6,0,29,0,12,20.7,2,-1,0,0,2,1,1,1,"w1920","Mechanized",0,"Sat","weekend"
"9071",2020-01-11,"Slate River Rd","2","1","1",6,0,29,0,12,20.7,2,-1,0,0,2,1,1,1,"w1920","Motorized",0,"Sat","weekend"
"9072",2020-01-11,"Slate River Rd","2","1","1",6,0,29,0,12,20.7,2,-1,0,0,2,1,1,1,"w1920","Hybrid",NA,"Sat","weekend"
"9073",2020-01-12,"Slate River Rd","2","1","1",6.1,0.1,29,0,13,21,0,2,-1,0,0,2,1,1,"w1920","Non.motorized",31,"Sun","weekend"
"9074",2020-01-12,"Slate River Rd","2","1","1",6.1,0.1,29,0,13,21,0,2,-1,0,0,2,1,1,"w1920","Mechanized",0,"Sun","weekend"
"9075",2020-01-12,"Slate River Rd","2","1","1",6.1,0.1,29,0,13,21,0,2,-1,0,0,2,1,1,"w1920","Motorized",27,"Sun","weekend"
"9076",2020-01-12,"Slate River Rd","2","1","1",6.1,0.1,29,0,13,21,0,2,-1,0,0,2,1,1,"w1920","Hybrid",NA,"Sun","weekend"
"9077",2020-01-13,"Slate River Rd","2","2","1",6.2,0.1,29,0,16,21.4,0,0,2,-1,0,0,2,1,"w1920","Non.motorized",0,"Mon","weekday"
"9078",2020-01-13,"Slate River Rd","2","2","1",6.2,0.1,29,0,16,21.4,0,0,2,-1,0,0,2,1,"w1920","Mechanized",0,"Mon","weekday"
"9079",2020-01-13,"Slate River Rd","2","2","1",6.2,0.1,29,0,16,21.4,0,0,2,-1,0,0,2,1,"w1920","Motorized",1,"Mon","weekday"
"9080",2020-01-13,"Slate River Rd","2","2","1",6.2,0.1,29,0,16,21.4,0,0,2,-1,0,0,2,1,"w1920","Hybrid",NA,"Mon","weekday"
"9081",2020-01-14,"Slate River Rd","3","2","1",6.6,0.4,34,5,23,19.4,0,0,0,2,5,5,5,7,"w1920","Non.motorized",5,"Tue","weekday"
"9082",2020-01-14,"Slate River Rd","3","2","1",6.6,0.4,34,5,23,19.4,0,0,0,2,5,5,5,7,"w1920","Mechanized",0,"Tue","weekday"
"9083",2020-01-14,"Slate River Rd","3","2","1",6.6,0.4,34,5,23,19.4,0,0,0,2,5,5,5,7,"w1920","Motorized",7,"Tue","weekday"
"9084",2020-01-14,"Slate River Rd","3","2","1",6.6,0.4,34,5,23,19.4,0,0,0,2,5,5,5,7,"w1920","Hybrid",NA,"Tue","weekday"
"9085",2020-01-15,"Slate River Rd","3","2","1",6.7,0.1,32,-2,23,20.9,5,0,0,0,3,3,3,3,"w1920","Non.motorized",16,"Wed","weekday"
"9086",2020-01-15,"Slate River Rd","3","2","1",6.7,0.1,32,-2,23,20.9,5,0,0,0,3,3,3,3,"w1920","Mechanized",0,"Wed","weekday"
"9087",2020-01-15,"Slate River Rd","3","2","1",6.7,0.1,32,-2,23,20.9,5,0,0,0,3,3,3,3,"w1920","Motorized",8,"Wed","weekday"
"9088",2020-01-15,"Slate River Rd","3","2","1",6.7,0.1,32,-2,23,20.9,5,0,0,0,3,3,3,3,"w1920","Hybrid",NA,"Wed","weekday"
"9089",2020-01-16,"Slate River Rd","2","2","1",6.7,0,31,-1,28,21.6,-2,5,0,0,-3,2,2,2,"w1920","Non.motorized",7,"Thu","weekday"
"9090",2020-01-16,"Slate River Rd","2","2","1",6.7,0,31,-1,28,21.6,-2,5,0,0,-3,2,2,2,"w1920","Mechanized",0,"Thu","weekday"
"9091",2020-01-16,"Slate River Rd","2","2","1",6.7,0,31,-1,28,21.6,-2,5,0,0,-3,2,2,2,"w1920","Motorized",6,"Thu","weekday"
"9092",2020-01-16,"Slate River Rd","2","2","1",6.7,0,31,-1,28,21.6,-2,5,0,0,-3,2,2,2,"w1920","Hybrid",NA,"Thu","weekday"
"9093",2020-01-17,"Slate River Rd","2","2","1",6.8,0.1,29,-2,19,23.4,-1,-2,5,0,-3,-5,0,0,"w1920","Non.motorized",NA,"Fri","weekday"
"9094",2020-01-17,"Slate River Rd","2","2","1",6.8,0.1,29,-2,19,23.4,-1,-2,5,0,-3,-5,0,0,"w1920","Mechanized",NA,"Fri","weekday"
"9095",2020-01-17,"Slate River Rd","2","2","1",6.8,0.1,29,-2,19,23.4,-1,-2,5,0,-3,-5,0,0,"w1920","Motorized",NA,"Fri","weekday"
"9096",2020-01-17,"Slate River Rd","2","2","1",6.8,0.1,29,-2,19,23.4,-1,-2,5,0,-3,-5,0,0,"w1920","Hybrid",NA,"Fri","weekday"
"9097",2020-01-18,"Slate River Rd","2","2","2",7,0.2,34,5,16,20.6,-2,-1,-2,5,3,2,0,5,"w1920","Non.motorized",NA,"Sat","weekend"
"9098",2020-01-18,"Slate River Rd","2","2","2",7,0.2,34,5,16,20.6,-2,-1,-2,5,3,2,0,5,"w1920","Mechanized",NA,"Sat","weekend"
"9099",2020-01-18,"Slate River Rd","2","2","2",7,0.2,34,5,16,20.6,-2,-1,-2,5,3,2,0,5,"w1920","Motorized",NA,"Sat","weekend"
"9100",2020-01-18,"Slate River Rd","2","2","2",7,0.2,34,5,16,20.6,-2,-1,-2,5,3,2,0,5,"w1920","Hybrid",NA,"Sat","weekend"
"9101",2020-01-19,"Slate River Rd","2","2","1",7,0,33,-1,21,21.2,5,-2,-1,-2,4,2,1,-1,"w1920","Non.motorized",30,"Sun","weekend"
"9102",2020-01-19,"Slate River Rd","2","2","1",7,0,33,-1,21,21.2,5,-2,-1,-2,4,2,1,-1,"w1920","Mechanized",2,"Sun","weekend"
"9103",2020-01-19,"Slate River Rd","2","2","1",7,0,33,-1,21,21.2,5,-2,-1,-2,4,2,1,-1,"w1920","Motorized",4,"Sun","weekend"
"9104",2020-01-19,"Slate River Rd","2","2","1",7,0,33,-1,21,21.2,5,-2,-1,-2,4,2,1,-1,"w1920","Hybrid",NA,"Sun","weekend"
"9105",2020-01-20,"Slate River Rd","2","2","1",7.1,0.1,32,-1,25,22.2,-1,5,-2,-1,-2,3,1,0,"w1920","Non.motorized",13,"Mon","weekday"
"9106",2020-01-20,"Slate River Rd","2","2","1",7.1,0.1,32,-1,25,22.2,-1,5,-2,-1,-2,3,1,0,"w1920","Mechanized",0,"Mon","weekday"
"9107",2020-01-20,"Slate River Rd","2","2","1",7.1,0.1,32,-1,25,22.2,-1,5,-2,-1,-2,3,1,0,"w1920","Motorized",8,"Mon","weekday"
"9108",2020-01-20,"Slate River Rd","2","2","1",7.1,0.1,32,-1,25,22.2,-1,5,-2,-1,-2,3,1,0,"w1920","Hybrid",NA,"Mon","weekday"
"9109",2020-01-21,"Slate River Rd","2","2","1",7.1,0,31,-1,28,22.9,-1,-1,5,-2,-2,-3,2,0,"w1920","Non.motorized",1,"Tue","weekday"
"9110",2020-01-21,"Slate River Rd","2","2","1",7.1,0,31,-1,28,22.9,-1,-1,5,-2,-2,-3,2,0,"w1920","Mechanized",0,"Tue","weekday"
"9111",2020-01-21,"Slate River Rd","2","2","1",7.1,0,31,-1,28,22.9,-1,-1,5,-2,-2,-3,2,0,"w1920","Motorized",11,"Tue","weekday"
"9112",2020-01-21,"Slate River Rd","2","2","1",7.1,0,31,-1,28,22.9,-1,-1,5,-2,-2,-3,2,0,"w1920","Hybrid",NA,"Tue","weekday"
"9113",2020-01-22,"Slate River Rd","2","2","2",7.3,0.2,32,1,25,22.8,-1,-1,-1,5,0,-1,-2,3,"w1920","Non.motorized",7,"Wed","weekday"
"9114",2020-01-22,"Slate River Rd","2","2","2",7.3,0.2,32,1,25,22.8,-1,-1,-1,5,0,-1,-2,3,"w1920","Mechanized",0,"Wed","weekday"
"9115",2020-01-22,"Slate River Rd","2","2","2",7.3,0.2,32,1,25,22.8,-1,-1,-1,5,0,-1,-2,3,"w1920","Motorized",3,"Wed","weekday"
"9116",2020-01-22,"Slate River Rd","2","2","2",7.3,0.2,32,1,25,22.8,-1,-1,-1,5,0,-1,-2,3,"w1920","Hybrid",NA,"Wed","weekday"
"9117",2020-01-23,"Slate River Rd","3","2","2",7.3,0,34,2,23,21.5,1,-1,-1,-1,3,2,1,0,"w1920","Non.motorized",7,"Thu","weekday"
"9118",2020-01-23,"Slate River Rd","3","2","2",7.3,0,34,2,23,21.5,1,-1,-1,-1,3,2,1,0,"w1920","Mechanized",0,"Thu","weekday"
"9119",2020-01-23,"Slate River Rd","3","2","2",7.3,0,34,2,23,21.5,1,-1,-1,-1,3,2,1,0,"w1920","Motorized",4,"Thu","weekday"
"9120",2020-01-23,"Slate River Rd","3","2","2",7.3,0,34,2,23,21.5,1,-1,-1,-1,3,2,1,0,"w1920","Hybrid",NA,"Thu","weekday"
"9121",2020-01-24,"Slate River Rd","2","2","1",7.3,0,33,-1,23,22.1,2,1,-1,-1,1,2,1,0,"w1920","Non.motorized",6,"Fri","weekday"
"9122",2020-01-24,"Slate River Rd","2","2","1",7.3,0,33,-1,23,22.1,2,1,-1,-1,1,2,1,0,"w1920","Mechanized",0,"Fri","weekday"
"9123",2020-01-24,"Slate River Rd","2","2","1",7.3,0,33,-1,23,22.1,2,1,-1,-1,1,2,1,0,"w1920","Motorized",7,"Fri","weekday"
"9124",2020-01-24,"Slate River Rd","2","2","1",7.3,0,33,-1,23,22.1,2,1,-1,-1,1,2,1,0,"w1920","Hybrid",NA,"Fri","weekday"
"9125",2020-01-25,"Slate River Rd","2","2","1",7.4,0.1,32,-1,25,23.1,-1,2,1,-1,-2,0,1,0,"w1920","Non.motorized",13,"Sat","weekend"
"9126",2020-01-25,"Slate River Rd","2","2","1",7.4,0.1,32,-1,25,23.1,-1,2,1,-1,-2,0,1,0,"w1920","Mechanized",1,"Sat","weekend"
"9127",2020-01-25,"Slate River Rd","2","2","1",7.4,0.1,32,-1,25,23.1,-1,2,1,-1,-2,0,1,0,"w1920","Motorized",16,"Sat","weekend"
"9128",2020-01-25,"Slate River Rd","2","2","1",7.4,0.1,32,-1,25,23.1,-1,2,1,-1,-2,0,1,0,"w1920","Hybrid",NA,"Sat","weekend"
"9129",2020-01-26,"Slate River Rd","2","1","1",7.4,0,32,0,28,23.1,-1,-1,2,1,-1,-2,0,1,"w1920","Non.motorized",24,"Sun","weekend"
"9130",2020-01-26,"Slate River Rd","2","1","1",7.4,0,32,0,28,23.1,-1,-1,2,1,-1,-2,0,1,"w1920","Mechanized",0,"Sun","weekend"
"9131",2020-01-26,"Slate River Rd","2","1","1",7.4,0,32,0,28,23.1,-1,-1,2,1,-1,-2,0,1,"w1920","Motorized",8,"Sun","weekend"
"9132",2020-01-26,"Slate River Rd","2","1","1",7.4,0,32,0,28,23.1,-1,-1,2,1,-1,-2,0,1,"w1920","Hybrid",NA,"Sun","weekend"
"9133",2020-01-27,"Slate River Rd","2","1","1",7.4,0,32,0,24,23.1,0,-1,-1,2,0,-1,-2,0,"w1920","Non.motorized",4,"Mon","weekday"
"9134",2020-01-27,"Slate River Rd","2","1","1",7.4,0,32,0,24,23.1,0,-1,-1,2,0,-1,-2,0,"w1920","Mechanized",0,"Mon","weekday"
"9135",2020-01-27,"Slate River Rd","2","1","1",7.4,0,32,0,24,23.1,0,-1,-1,2,0,-1,-2,0,"w1920","Motorized",3,"Mon","weekday"
"9136",2020-01-27,"Slate River Rd","2","1","1",7.4,0,32,0,24,23.1,0,-1,-1,2,0,-1,-2,0,"w1920","Hybrid",NA,"Mon","weekday"
"9137",2020-01-28,"Slate River Rd","3","2","2",7.4,0,32,0,19,23.1,0,0,-1,-1,0,0,-1,-2,"w1920","Non.motorized",10,"Tue","weekday"
"9138",2020-01-28,"Slate River Rd","3","2","2",7.4,0,32,0,19,23.1,0,0,-1,-1,0,0,-1,-2,"w1920","Mechanized",0,"Tue","weekday"
"9139",2020-01-28,"Slate River Rd","3","2","2",7.4,0,32,0,19,23.1,0,0,-1,-1,0,0,-1,-2,"w1920","Motorized",6,"Tue","weekday"
"9140",2020-01-28,"Slate River Rd","3","2","2",7.4,0,32,0,19,23.1,0,0,-1,-1,0,0,-1,-2,"w1920","Hybrid",NA,"Tue","weekday"
"9141",2020-01-29,"Slate River Rd","2","2","1",7.4,0,31,-1,20,23.9,0,0,0,-1,-1,-1,-1,-2,"w1920","Non.motorized",10,"Wed","weekday"
"9142",2020-01-29,"Slate River Rd","2","2","1",7.4,0,31,-1,20,23.9,0,0,0,-1,-1,-1,-1,-2,"w1920","Mechanized",0,"Wed","weekday"
"9143",2020-01-29,"Slate River Rd","2","2","1",7.4,0,31,-1,20,23.9,0,0,0,-1,-1,-1,-1,-2,"w1920","Motorized",7,"Wed","weekday"
"9144",2020-01-29,"Slate River Rd","2","2","1",7.4,0,31,-1,20,23.9,0,0,0,-1,-1,-1,-1,-2,"w1920","Hybrid",NA,"Wed","weekday"
"9145",2020-01-30,"Slate River Rd","2","2","1",7.4,0,31,0,17,23.9,-1,0,0,0,-1,-1,-1,-1,"w1920","Non.motorized",18,"Thu","weekday"
"9146",2020-01-30,"Slate River Rd","2","2","1",7.4,0,31,0,17,23.9,-1,0,0,0,-1,-1,-1,-1,"w1920","Mechanized",0,"Thu","weekday"
"9147",2020-01-30,"Slate River Rd","2","2","1",7.4,0,31,0,17,23.9,-1,0,0,0,-1,-1,-1,-1,"w1920","Motorized",12,"Thu","weekday"
"9148",2020-01-30,"Slate River Rd","2","2","1",7.4,0,31,0,17,23.9,-1,0,0,0,-1,-1,-1,-1,"w1920","Hybrid",NA,"Thu","weekday"
"9149",2020-01-31,"Slate River Rd","2","1","1",7.4,0,31,0,20,23.9,0,-1,0,0,0,-1,-1,-1,"w1920","Non.motorized",22,"Fri","weekday"
"9150",2020-01-31,"Slate River Rd","2","1","1",7.4,0,31,0,20,23.9,0,-1,0,0,0,-1,-1,-1,"w1920","Mechanized",0,"Fri","weekday"
"9151",2020-01-31,"Slate River Rd","2","1","1",7.4,0,31,0,20,23.9,0,-1,0,0,0,-1,-1,-1,"w1920","Motorized",16,"Fri","weekday"
"9152",2020-01-31,"Slate River Rd","2","1","1",7.4,0,31,0,20,23.9,0,-1,0,0,0,-1,-1,-1,"w1920","Hybrid",NA,"Fri","weekday"
"9153",2020-02-01,"Slate River Rd","2","1","1",7.4,0,31,0,28,23.9,0,0,-1,0,0,0,-1,-1,"w1920","Non.motorized",58,"Sat","weekend"
"9154",2020-02-01,"Slate River Rd","2","1","1",7.4,0,31,0,28,23.9,0,0,-1,0,0,0,-1,-1,"w1920","Mechanized",2,"Sat","weekend"
"9155",2020-02-01,"Slate River Rd","2","1","1",7.4,0,31,0,28,23.9,0,0,-1,0,0,0,-1,-1,"w1920","Motorized",4,"Sat","weekend"
"9156",2020-02-01,"Slate River Rd","2","1","1",7.4,0,31,0,28,23.9,0,0,-1,0,0,0,-1,-1,"w1920","Hybrid",NA,"Sat","weekend"
"9157",2020-02-02,"Slate River Rd","1","1","1",7.4,0,31,0,33,23.9,0,0,0,-1,0,0,0,-1,"w1920","Non.motorized",44,"Sun","weekend"
"9158",2020-02-02,"Slate River Rd","1","1","1",7.4,0,31,0,33,23.9,0,0,0,-1,0,0,0,-1,"w1920","Mechanized",0,"Sun","weekend"
"9159",2020-02-02,"Slate River Rd","1","1","1",7.4,0,31,0,33,23.9,0,0,0,-1,0,0,0,-1,"w1920","Motorized",4,"Sun","weekend"
"9160",2020-02-02,"Slate River Rd","1","1","1",7.4,0,31,0,33,23.9,0,0,0,-1,0,0,0,-1,"w1920","Hybrid",NA,"Sun","weekend"
"9161",2020-02-03,"Slate River Rd","2","2","1",7.4,0,31,0,24,23.9,0,0,0,0,0,0,0,0,"w1920","Non.motorized",14,"Mon","weekday"
"9162",2020-02-03,"Slate River Rd","2","2","1",7.4,0,31,0,24,23.9,0,0,0,0,0,0,0,0,"w1920","Mechanized",0,"Mon","weekday"
"9163",2020-02-03,"Slate River Rd","2","2","1",7.4,0,31,0,24,23.9,0,0,0,0,0,0,0,0,"w1920","Motorized",7,"Mon","weekday"
"9164",2020-02-03,"Slate River Rd","2","2","1",7.4,0,31,0,24,23.9,0,0,0,0,0,0,0,0,"w1920","Hybrid",NA,"Mon","weekday"
"9165",2020-02-04,"Slate River Rd","2","2","2",7.4,0,33,2,5,22.4,0,0,0,0,2,2,2,2,"w1920","Non.motorized",6,"Tue","weekday"
"9166",2020-02-04,"Slate River Rd","2","2","2",7.4,0,33,2,5,22.4,0,0,0,0,2,2,2,2,"w1920","Mechanized",0,"Tue","weekday"
"9167",2020-02-04,"Slate River Rd","2","2","2",7.4,0,33,2,5,22.4,0,0,0,0,2,2,2,2,"w1920","Motorized",5,"Tue","weekday"
"9168",2020-02-04,"Slate River Rd","2","2","2",7.4,0,33,2,5,22.4,0,0,0,0,2,2,2,2,"w1920","Hybrid",NA,"Tue","weekday"
"9169",2020-02-05,"Slate River Rd","2","2","1",7.4,0,33,0,2,22.4,2,0,0,0,2,2,2,2,"w1920","Non.motorized",12,"Wed","weekday"
"9170",2020-02-05,"Slate River Rd","2","2","1",7.4,0,33,0,2,22.4,2,0,0,0,2,2,2,2,"w1920","Mechanized",1,"Wed","weekday"
"9171",2020-02-05,"Slate River Rd","2","2","1",7.4,0,33,0,2,22.4,2,0,0,0,2,2,2,2,"w1920","Motorized",4,"Wed","weekday"
"9172",2020-02-05,"Slate River Rd","2","2","1",7.4,0,33,0,2,22.4,2,0,0,0,2,2,2,2,"w1920","Hybrid",NA,"Wed","weekday"
"9173",2020-02-06,"Slate River Rd","2","2","1",7.5,0.1,32,-1,16,23.4,0,2,0,0,-1,1,1,1,"w1920","Non.motorized",5,"Thu","weekday"
"9174",2020-02-06,"Slate River Rd","2","2","1",7.5,0.1,32,-1,16,23.4,0,2,0,0,-1,1,1,1,"w1920","Mechanized",0,"Thu","weekday"
"9175",2020-02-06,"Slate River Rd","2","2","1",7.5,0.1,32,-1,16,23.4,0,2,0,0,-1,1,1,1,"w1920","Motorized",3,"Thu","weekday"
"9176",2020-02-06,"Slate River Rd","2","2","1",7.5,0.1,32,-1,16,23.4,0,2,0,0,-1,1,1,1,"w1920","Hybrid",NA,"Thu","weekday"
"9177",2020-02-07,"Slate River Rd","3","3","3",7.9,0.4,37,5,26,21.4,-1,0,2,0,4,4,6,6,"w1920","Non.motorized",3,"Fri","weekday"
"9178",2020-02-07,"Slate River Rd","3","3","3",7.9,0.4,37,5,26,21.4,-1,0,2,0,4,4,6,6,"w1920","Mechanized",0,"Fri","weekday"
"9179",2020-02-07,"Slate River Rd","3","3","3",7.9,0.4,37,5,26,21.4,-1,0,2,0,4,4,6,6,"w1920","Motorized",0,"Fri","weekday"
"9180",2020-02-07,"Slate River Rd","3","3","3",7.9,0.4,37,5,26,21.4,-1,0,2,0,4,4,6,6,"w1920","Hybrid",NA,"Fri","weekday"
"9181",2020-02-08,"Slate River Rd","3","3","2",8.3,0.4,39,2,30,21.3,5,-1,0,2,7,6,6,8,"w1920","Non.motorized",20,"Sat","weekend"
"9182",2020-02-08,"Slate River Rd","3","3","2",8.3,0.4,39,2,30,21.3,5,-1,0,2,7,6,6,8,"w1920","Mechanized",0,"Sat","weekend"
"9183",2020-02-08,"Slate River Rd","3","3","2",8.3,0.4,39,2,30,21.3,5,-1,0,2,7,6,6,8,"w1920","Motorized",1,"Sat","weekend"
"9184",2020-02-08,"Slate River Rd","3","3","2",8.3,0.4,39,2,30,21.3,5,-1,0,2,7,6,6,8,"w1920","Hybrid",NA,"Sat","weekend"
"9185",2020-02-09,"Slate River Rd","3","2","2",8.4,0.1,38,-1,26,22.1,2,5,-1,0,1,6,5,5,"w1920","Non.motorized",17,"Sun","weekend"
"9186",2020-02-09,"Slate River Rd","3","2","2",8.4,0.1,38,-1,26,22.1,2,5,-1,0,1,6,5,5,"w1920","Mechanized",0,"Sun","weekend"
"9187",2020-02-09,"Slate River Rd","3","2","2",8.4,0.1,38,-1,26,22.1,2,5,-1,0,1,6,5,5,"w1920","Motorized",8,"Sun","weekend"
"9188",2020-02-09,"Slate River Rd","3","2","2",8.4,0.1,38,-1,26,22.1,2,5,-1,0,1,6,5,5,"w1920","Hybrid",NA,"Sun","weekend"
"9189",2020-02-10,"Slate River Rd","2","2","1",8.4,0,38,0,22,22.1,-1,2,5,-1,-1,1,6,5,"w1920","Non.motorized",14,"Mon","weekday"
"9190",2020-02-10,"Slate River Rd","2","2","1",8.4,0,38,0,22,22.1,-1,2,5,-1,-1,1,6,5,"w1920","Mechanized",0,"Mon","weekday"
"9191",2020-02-10,"Slate River Rd","2","2","1",8.4,0,38,0,22,22.1,-1,2,5,-1,-1,1,6,5,"w1920","Motorized",11,"Mon","weekday"
"9192",2020-02-10,"Slate River Rd","2","2","1",8.4,0,38,0,22,22.1,-1,2,5,-1,-1,1,6,5,"w1920","Hybrid",NA,"Mon","weekday"
"9193",2020-02-11,"Slate River Rd","2","2","2",8.5,0.1,40,2,16,21.2,0,-1,2,5,2,1,3,8,"w1920","Non.motorized",2,"Tue","weekday"
"9194",2020-02-11,"Slate River Rd","2","2","2",8.5,0.1,40,2,16,21.2,0,-1,2,5,2,1,3,8,"w1920","Mechanized",0,"Tue","weekday"
"9195",2020-02-11,"Slate River Rd","2","2","2",8.5,0.1,40,2,16,21.2,0,-1,2,5,2,1,3,8,"w1920","Motorized",7,"Tue","weekday"
"9196",2020-02-11,"Slate River Rd","2","2","2",8.5,0.1,40,2,16,21.2,0,-1,2,5,2,1,3,8,"w1920","Hybrid",NA,"Tue","weekday"
"9197",2020-02-12,"Slate River Rd","2","2","2",8.5,0,39,-1,15,21.8,2,0,-1,2,1,1,0,2,"w1920","Non.motorized",16,"Wed","weekday"
"9198",2020-02-12,"Slate River Rd","2","2","2",8.5,0,39,-1,15,21.8,2,0,-1,2,1,1,0,2,"w1920","Mechanized",0,"Wed","weekday"
"9199",2020-02-12,"Slate River Rd","2","2","2",8.5,0,39,-1,15,21.8,2,0,-1,2,1,1,0,2,"w1920","Motorized",5,"Wed","weekday"
"9200",2020-02-12,"Slate River Rd","2","2","2",8.5,0,39,-1,15,21.8,2,0,-1,2,1,1,0,2,"w1920","Hybrid",NA,"Wed","weekday"
"9201",2020-02-13,"Slate River Rd","2","2","1",8.5,0,39,0,18,21.8,-1,2,0,-1,-1,1,1,0,"w1920","Non.motorized",18,"Thu","weekday"
"9202",2020-02-13,"Slate River Rd","2","2","1",8.5,0,39,0,18,21.8,-1,2,0,-1,-1,1,1,0,"w1920","Mechanized",0,"Thu","weekday"
"9203",2020-02-13,"Slate River Rd","2","2","1",8.5,0,39,0,18,21.8,-1,2,0,-1,-1,1,1,0,"w1920","Motorized",13,"Thu","weekday"
"9204",2020-02-13,"Slate River Rd","2","2","1",8.5,0,39,0,18,21.8,-1,2,0,-1,-1,1,1,0,"w1920","Hybrid",NA,"Thu","weekday"
"9205",2020-02-14,"Slate River Rd","2","1","1",8.6,0.1,38,-1,24,22.6,0,-1,2,0,-1,-2,0,0,"w1920","Non.motorized",11,"Fri","weekday"
"9206",2020-02-14,"Slate River Rd","2","1","1",8.6,0.1,38,-1,24,22.6,0,-1,2,0,-1,-2,0,0,"w1920","Mechanized",0,"Fri","weekday"
"9207",2020-02-14,"Slate River Rd","2","1","1",8.6,0.1,38,-1,24,22.6,0,-1,2,0,-1,-2,0,0,"w1920","Motorized",6,"Fri","weekday"
"9208",2020-02-14,"Slate River Rd","2","1","1",8.6,0.1,38,-1,24,22.6,0,-1,2,0,-1,-2,0,0,"w1920","Hybrid",NA,"Fri","weekday"
"9209",2020-02-15,"Slate River Rd","1","1","1",8.6,0,38,0,26,22.6,-1,0,-1,2,-1,-1,-2,0,"w1920","Non.motorized",8,"Sat","weekend"
"9210",2020-02-15,"Slate River Rd","1","1","1",8.6,0,38,0,26,22.6,-1,0,-1,2,-1,-1,-2,0,"w1920","Mechanized",0,"Sat","weekend"
"9211",2020-02-15,"Slate River Rd","1","1","1",8.6,0,38,0,26,22.6,-1,0,-1,2,-1,-1,-2,0,"w1920","Motorized",17,"Sat","weekend"
"9212",2020-02-15,"Slate River Rd","1","1","1",8.6,0,38,0,26,22.6,-1,0,-1,2,-1,-1,-2,0,"w1920","Hybrid",NA,"Sat","weekend"
"9213",2020-02-16,"Slate River Rd","1","1","1",8.8,0.2,37,-1,26,23.8,0,-1,0,-1,-1,-2,-2,-3,"w1920","Non.motorized",7,"Sun","weekend"
"9214",2020-02-16,"Slate River Rd","1","1","1",8.8,0.2,37,-1,26,23.8,0,-1,0,-1,-1,-2,-2,-3,"w1920","Mechanized",0,"Sun","weekend"
"9215",2020-02-16,"Slate River Rd","1","1","1",8.8,0.2,37,-1,26,23.8,0,-1,0,-1,-1,-2,-2,-3,"w1920","Motorized",5,"Sun","weekend"
"9216",2020-02-16,"Slate River Rd","1","1","1",8.8,0.2,37,-1,26,23.8,0,-1,0,-1,-1,-2,-2,-3,"w1920","Hybrid",NA,"Sun","weekend"
"9217",2020-02-17,"Slate River Rd","2","1","1",9.2,0.4,43,6,25,21.4,-1,0,-1,0,5,5,4,4,"w1920","Non.motorized",17,"Mon","weekday"
"9218",2020-02-17,"Slate River Rd","2","1","1",9.2,0.4,43,6,25,21.4,-1,0,-1,0,5,5,4,4,"w1920","Mechanized",0,"Mon","weekday"
"9219",2020-02-17,"Slate River Rd","2","1","1",9.2,0.4,43,6,25,21.4,-1,0,-1,0,5,5,4,4,"w1920","Motorized",1,"Mon","weekday"
"9220",2020-02-17,"Slate River Rd","2","1","1",9.2,0.4,43,6,25,21.4,-1,0,-1,0,5,5,4,4,"w1920","Hybrid",NA,"Mon","weekday"
"9221",2020-02-18,"Slate River Rd","1","1","1",9.3,0.1,42,-1,18,22.1,6,-1,0,-1,5,4,4,3,"w1920","Non.motorized",16,"Tue","weekday"
"9222",2020-02-18,"Slate River Rd","1","1","1",9.3,0.1,42,-1,18,22.1,6,-1,0,-1,5,4,4,3,"w1920","Mechanized",0,"Tue","weekday"
"9223",2020-02-18,"Slate River Rd","1","1","1",9.3,0.1,42,-1,18,22.1,6,-1,0,-1,5,4,4,3,"w1920","Motorized",2,"Tue","weekday"
"9224",2020-02-18,"Slate River Rd","1","1","1",9.3,0.1,42,-1,18,22.1,6,-1,0,-1,5,4,4,3,"w1920","Hybrid",NA,"Tue","weekday"
"9225",2020-02-19,"Slate River Rd","1","1","1",9.3,0,41,-1,22,22.7,-1,6,-1,0,-2,4,3,3,"w1920","Non.motorized",26,"Wed","weekday"
"9226",2020-02-19,"Slate River Rd","1","1","1",9.3,0,41,-1,22,22.7,-1,6,-1,0,-2,4,3,3,"w1920","Mechanized",0,"Wed","weekday"
"9227",2020-02-19,"Slate River Rd","1","1","1",9.3,0,41,-1,22,22.7,-1,6,-1,0,-2,4,3,3,"w1920","Motorized",3,"Wed","weekday"
"9228",2020-02-19,"Slate River Rd","1","1","1",9.3,0,41,-1,22,22.7,-1,6,-1,0,-2,4,3,3,"w1920","Hybrid",NA,"Wed","weekday"
"9229",2020-02-20,"Slate River Rd","1","1","1",9.3,0,41,0,18,22.7,-1,-1,6,-1,-1,-2,4,3,"w1920","Non.motorized",16,"Thu","weekday"
"9230",2020-02-20,"Slate River Rd","1","1","1",9.3,0,41,0,18,22.7,-1,-1,6,-1,-1,-2,4,3,"w1920","Mechanized",0,"Thu","weekday"
"9231",2020-02-20,"Slate River Rd","1","1","1",9.3,0,41,0,18,22.7,-1,-1,6,-1,-1,-2,4,3,"w1920","Motorized",4,"Thu","weekday"
"9232",2020-02-20,"Slate River Rd","1","1","1",9.3,0,41,0,18,22.7,-1,-1,6,-1,-1,-2,4,3,"w1920","Hybrid",NA,"Thu","weekday"
"9233",2020-02-21,"Slate River Rd","1","1","1",9.3,0,40,-1,26,23.2,0,-1,-1,6,-1,-2,-3,3,"w1920","Non.motorized",12,"Fri","weekday"
"9234",2020-02-21,"Slate River Rd","1","1","1",9.3,0,40,-1,26,23.2,0,-1,-1,6,-1,-2,-3,3,"w1920","Mechanized",0,"Fri","weekday"
"9235",2020-02-21,"Slate River Rd","1","1","1",9.3,0,40,-1,26,23.2,0,-1,-1,6,-1,-2,-3,3,"w1920","Motorized",6,"Fri","weekday"
"9236",2020-02-21,"Slate River Rd","1","1","1",9.3,0,40,-1,26,23.2,0,-1,-1,6,-1,-2,-3,3,"w1920","Hybrid",NA,"Fri","weekday"
"9237",2020-02-22,"Slate River Rd","1","1","1",9.4,0.1,39,-1,32,24.1,-1,0,-1,-1,-2,-2,-3,-4,"w1920","Non.motorized",22,"Sat","weekend"
"9238",2020-02-22,"Slate River Rd","1","1","1",9.4,0.1,39,-1,32,24.1,-1,0,-1,-1,-2,-2,-3,-4,"w1920","Mechanized",0,"Sat","weekend"
"9239",2020-02-22,"Slate River Rd","1","1","1",9.4,0.1,39,-1,32,24.1,-1,0,-1,-1,-2,-2,-3,-4,"w1920","Motorized",9,"Sat","weekend"
"9240",2020-02-22,"Slate River Rd","1","1","1",9.4,0.1,39,-1,32,24.1,-1,0,-1,-1,-2,-2,-3,-4,"w1920","Hybrid",NA,"Sat","weekend"
"9241",2020-02-23,"Slate River Rd","2","2","2",9.5,0.1,40,1,27,23.8,-1,-1,0,-1,0,-1,-1,-2,"w1920","Non.motorized",14,"Sun","weekend"
"9242",2020-02-23,"Slate River Rd","2","2","2",9.5,0.1,40,1,27,23.8,-1,-1,0,-1,0,-1,-1,-2,"w1920","Mechanized",0,"Sun","weekend"
"9243",2020-02-23,"Slate River Rd","2","2","2",9.5,0.1,40,1,27,23.8,-1,-1,0,-1,0,-1,-1,-2,"w1920","Motorized",1,"Sun","weekend"
"9244",2020-02-23,"Slate River Rd","2","2","2",9.5,0.1,40,1,27,23.8,-1,-1,0,-1,0,-1,-1,-2,"w1920","Hybrid",NA,"Sun","weekend"
"9245",2020-02-24,"Slate River Rd","3","3","2",9.8,0.3,43,3,17,22.8,1,-1,-1,0,4,3,2,2,"w1920","Non.motorized",15,"Mon","weekday"
"9246",2020-02-24,"Slate River Rd","3","3","2",9.8,0.3,43,3,17,22.8,1,-1,-1,0,4,3,2,2,"w1920","Mechanized",0,"Mon","weekday"
"9247",2020-02-24,"Slate River Rd","3","3","2",9.8,0.3,43,3,17,22.8,1,-1,-1,0,4,3,2,2,"w1920","Motorized",1,"Mon","weekday"
"9248",2020-02-24,"Slate River Rd","3","3","2",9.8,0.3,43,3,17,22.8,1,-1,-1,0,4,3,2,2,"w1920","Hybrid",NA,"Mon","weekday"
"9249",2020-02-25,"Slate River Rd","2","2","1",9.8,0,43,0,8,22.8,3,1,-1,-1,3,4,3,2,"w1920","Non.motorized",28,"Tue","weekday"
"9250",2020-02-25,"Slate River Rd","2","2","1",9.8,0,43,0,8,22.8,3,1,-1,-1,3,4,3,2,"w1920","Mechanized",0,"Tue","weekday"
"9251",2020-02-25,"Slate River Rd","2","2","1",9.8,0,43,0,8,22.8,3,1,-1,-1,3,4,3,2,"w1920","Motorized",2,"Tue","weekday"
"9252",2020-02-25,"Slate River Rd","2","2","1",9.8,0,43,0,8,22.8,3,1,-1,-1,3,4,3,2,"w1920","Hybrid",NA,"Tue","weekday"
"9253",2020-02-26,"Slate River Rd","2","2","1",9.8,0,42,-1,15,23.3,0,3,1,-1,-1,2,3,2,"w1920","Non.motorized",2,"Wed","weekday"
"9254",2020-02-26,"Slate River Rd","2","2","1",9.8,0,42,-1,15,23.3,0,3,1,-1,-1,2,3,2,"w1920","Mechanized",0,"Wed","weekday"
"9255",2020-02-26,"Slate River Rd","2","2","1",9.8,0,42,-1,15,23.3,0,3,1,-1,-1,2,3,2,"w1920","Motorized",5,"Wed","weekday"
"9256",2020-02-26,"Slate River Rd","2","2","1",9.8,0,42,-1,15,23.3,0,3,1,-1,-1,2,3,2,"w1920","Hybrid",NA,"Wed","weekday"
"9257",2020-02-27,"Slate River Rd","2","2","1",9.9,0.1,41,-1,25,24.1,-1,0,3,1,-2,-2,1,2,"w1920","Non.motorized",4,"Thu","weekday"
"9258",2020-02-27,"Slate River Rd","2","2","1",9.9,0.1,41,-1,25,24.1,-1,0,3,1,-2,-2,1,2,"w1920","Mechanized",0,"Thu","weekday"
"9259",2020-02-27,"Slate River Rd","2","2","1",9.9,0.1,41,-1,25,24.1,-1,0,3,1,-2,-2,1,2,"w1920","Motorized",11,"Thu","weekday"
"9260",2020-02-27,"Slate River Rd","2","2","1",9.9,0.1,41,-1,25,24.1,-1,0,3,1,-2,-2,1,2,"w1920","Hybrid",NA,"Thu","weekday"
"9261",2020-02-28,"Slate River Rd","2","1","1",9.9,0,41,0,28,24.1,-1,-1,0,3,-1,-2,-2,1,"w1920","Non.motorized",11,"Fri","weekday"
"9262",2020-02-28,"Slate River Rd","2","1","1",9.9,0,41,0,28,24.1,-1,-1,0,3,-1,-2,-2,1,"w1920","Mechanized",0,"Fri","weekday"
"9263",2020-02-28,"Slate River Rd","2","1","1",9.9,0,41,0,28,24.1,-1,-1,0,3,-1,-2,-2,1,"w1920","Motorized",3,"Fri","weekday"
"9264",2020-02-28,"Slate River Rd","2","1","1",9.9,0,41,0,28,24.1,-1,-1,0,3,-1,-2,-2,1,"w1920","Hybrid",NA,"Fri","weekday"
"9265",2020-02-29,"Slate River Rd","1","1","1",9.9,0,40,-1,29,24.8,0,-1,-1,0,-1,-2,-3,-3,"w1920","Non.motorized",13,"Sat","weekend"
"9266",2020-02-29,"Slate River Rd","1","1","1",9.9,0,40,-1,29,24.8,0,-1,-1,0,-1,-2,-3,-3,"w1920","Mechanized",0,"Sat","weekend"
"9267",2020-02-29,"Slate River Rd","1","1","1",9.9,0,40,-1,29,24.8,0,-1,-1,0,-1,-2,-3,-3,"w1920","Motorized",0,"Sat","weekend"
"9268",2020-02-29,"Slate River Rd","1","1","1",9.9,0,40,-1,29,24.8,0,-1,-1,0,-1,-2,-3,-3,"w1920","Hybrid",NA,"Sat","weekend"
"9269",2020-03-01,"Slate River Rd","1","1","1",10,0.1,40,0,28,25,-1,0,-1,-1,-1,-1,-2,-3,"w1920","Non.motorized",14,"Sun","weekend"
"9270",2020-03-01,"Slate River Rd","1","1","1",10,0.1,40,0,28,25,-1,0,-1,-1,-1,-1,-2,-3,"w1920","Mechanized",0,"Sun","weekend"
"9271",2020-03-01,"Slate River Rd","1","1","1",10,0.1,40,0,28,25,-1,0,-1,-1,-1,-1,-2,-3,"w1920","Motorized",3,"Sun","weekend"
"9272",2020-03-01,"Slate River Rd","1","1","1",10,0.1,40,0,28,25,-1,0,-1,-1,-1,-1,-2,-3,"w1920","Hybrid",NA,"Sun","weekend"
"9273",2020-03-02,"Slate River Rd","2","2","1",10.4,0.4,45,5,25,23.1,0,-1,0,-1,5,4,4,3,"w1920","Non.motorized",13,"Mon","weekday"
"9274",2020-03-02,"Slate River Rd","2","2","1",10.4,0.4,45,5,25,23.1,0,-1,0,-1,5,4,4,3,"w1920","Mechanized",0,"Mon","weekday"
"9275",2020-03-02,"Slate River Rd","2","2","1",10.4,0.4,45,5,25,23.1,0,-1,0,-1,5,4,4,3,"w1920","Motorized",1,"Mon","weekday"
"9276",2020-03-02,"Slate River Rd","2","2","1",10.4,0.4,45,5,25,23.1,0,-1,0,-1,5,4,4,3,"w1920","Hybrid",NA,"Mon","weekday"
"9277",2020-03-03,"Slate River Rd","2","1","1",10.9,0.5,50,5,25,21.8,5,0,-1,0,10,10,9,9,"w1920","Non.motorized",35,"Tue","weekday"
"9278",2020-03-03,"Slate River Rd","2","1","1",10.9,0.5,50,5,25,21.8,5,0,-1,0,10,10,9,9,"w1920","Mechanized",4,"Tue","weekday"
"9279",2020-03-03,"Slate River Rd","2","1","1",10.9,0.5,50,5,25,21.8,5,0,-1,0,10,10,9,9,"w1920","Motorized",6,"Tue","weekday"
"9280",2020-03-03,"Slate River Rd","2","1","1",10.9,0.5,50,5,25,21.8,5,0,-1,0,10,10,9,9,"w1920","Hybrid",NA,"Tue","weekday"
"9281",2020-03-04,"Slate River Rd","2","1","1",10.9,0,48,-2,29,22.7,5,5,0,-1,3,8,8,7,"w1920","Non.motorized",28,"Wed","weekday"
"9282",2020-03-04,"Slate River Rd","2","1","1",10.9,0,48,-2,29,22.7,5,5,0,-1,3,8,8,7,"w1920","Mechanized",1,"Wed","weekday"
"9283",2020-03-04,"Slate River Rd","2","1","1",10.9,0,48,-2,29,22.7,5,5,0,-1,3,8,8,7,"w1920","Motorized",6,"Wed","weekday"
"9284",2020-03-04,"Slate River Rd","2","1","1",10.9,0,48,-2,29,22.7,5,5,0,-1,3,8,8,7,"w1920","Hybrid",NA,"Wed","weekday"
"9285",2020-03-05,"Slate River Rd","2","1","1",10.9,0,46,-2,32,23.7,-2,5,5,0,-4,1,6,6,"w1920","Non.motorized",6,"Thu","weekday"
"9286",2020-03-05,"Slate River Rd","2","1","1",10.9,0,46,-2,32,23.7,-2,5,5,0,-4,1,6,6,"w1920","Mechanized",0,"Thu","weekday"
"9287",2020-03-05,"Slate River Rd","2","1","1",10.9,0,46,-2,32,23.7,-2,5,5,0,-4,1,6,6,"w1920","Motorized",3,"Thu","weekday"
"9288",2020-03-05,"Slate River Rd","2","1","1",10.9,0,46,-2,32,23.7,-2,5,5,0,-4,1,6,6,"w1920","Hybrid",NA,"Thu","weekday"
"9289",2020-03-06,"Slate River Rd","1","1","1",10.9,0,45,-1,34,24.2,-2,-2,5,5,-3,-5,0,5,"w1920","Non.motorized",NA,"Fri","weekday"
"9290",2020-03-06,"Slate River Rd","1","1","1",10.9,0,45,-1,34,24.2,-2,-2,5,5,-3,-5,0,5,"w1920","Mechanized",NA,"Fri","weekday"
"9291",2020-03-06,"Slate River Rd","1","1","1",10.9,0,45,-1,34,24.2,-2,-2,5,5,-3,-5,0,5,"w1920","Motorized",NA,"Fri","weekday"
"9292",2020-03-06,"Slate River Rd","1","1","1",10.9,0,45,-1,34,24.2,-2,-2,5,5,-3,-5,0,5,"w1920","Hybrid",NA,"Fri","weekday"
"9293",2020-03-07,"Slate River Rd","1","1","2",10.9,0,44,-1,35,24.8,-1,-2,-2,5,-2,-4,-6,-1,"w1920","Non.motorized",22,"Sat","weekend"
"9294",2020-03-07,"Slate River Rd","1","1","2",10.9,0,44,-1,35,24.8,-1,-2,-2,5,-2,-4,-6,-1,"w1920","Mechanized",0,"Sat","weekend"
"9295",2020-03-07,"Slate River Rd","1","1","2",10.9,0,44,-1,35,24.8,-1,-2,-2,5,-2,-4,-6,-1,"w1920","Motorized",0,"Sat","weekend"
"9296",2020-03-07,"Slate River Rd","1","1","2",10.9,0,44,-1,35,24.8,-1,-2,-2,5,-2,-4,-6,-1,"w1920","Hybrid",NA,"Sat","weekend"
"9297",2020-03-08,"Slate River Rd","1","1","1",11,0.1,43,-1,33,25.6,-1,-1,-2,-2,-2,-3,-5,-7,"w1920","Non.motorized",NA,"Sun","weekend"
"9298",2020-03-08,"Slate River Rd","1","1","1",11,0.1,43,-1,33,25.6,-1,-1,-2,-2,-2,-3,-5,-7,"w1920","Mechanized",NA,"Sun","weekend"
"9299",2020-03-08,"Slate River Rd","1","1","1",11,0.1,43,-1,33,25.6,-1,-1,-2,-2,-2,-3,-5,-7,"w1920","Motorized",NA,"Sun","weekend"
"9300",2020-03-08,"Slate River Rd","1","1","1",11,0.1,43,-1,33,25.6,-1,-1,-2,-2,-2,-3,-5,-7,"w1920","Hybrid",NA,"Sun","weekend"
"9301",2020-03-09,"Slate River Rd","1","1","1",11.1,0.1,42,-1,31,26.4,-1,-1,-1,-2,-2,-3,-4,-6,"w1920","Non.motorized",NA,"Mon","weekday"
"9302",2020-03-09,"Slate River Rd","1","1","1",11.1,0.1,42,-1,31,26.4,-1,-1,-1,-2,-2,-3,-4,-6,"w1920","Mechanized",NA,"Mon","weekday"
"9303",2020-03-09,"Slate River Rd","1","1","1",11.1,0.1,42,-1,31,26.4,-1,-1,-1,-2,-2,-3,-4,-6,"w1920","Motorized",NA,"Mon","weekday"
"9304",2020-03-09,"Slate River Rd","1","1","1",11.1,0.1,42,-1,31,26.4,-1,-1,-1,-2,-2,-3,-4,-6,"w1920","Hybrid",NA,"Mon","weekday"
"9305",2020-03-10,"Slate River Rd","1","1","2",11.2,0.1,44,2,31,25.5,-1,-1,-1,-1,1,0,-1,-2,"w1920","Non.motorized",NA,"Tue","weekday"
"9306",2020-03-10,"Slate River Rd","1","1","2",11.2,0.1,44,2,31,25.5,-1,-1,-1,-1,1,0,-1,-2,"w1920","Mechanized",NA,"Tue","weekday"
"9307",2020-03-10,"Slate River Rd","1","1","2",11.2,0.1,44,2,31,25.5,-1,-1,-1,-1,1,0,-1,-2,"w1920","Motorized",NA,"Tue","weekday"
"9308",2020-03-10,"Slate River Rd","1","1","2",11.2,0.1,44,2,31,25.5,-1,-1,-1,-1,1,0,-1,-2,"w1920","Hybrid",NA,"Tue","weekday"
"9309",2020-03-11,"Slate River Rd","2","2","1",11.2,0,44,0,32,25.5,2,-1,-1,-1,2,1,0,-1,"w1920","Non.motorized",NA,"Wed","weekday"
"9310",2020-03-11,"Slate River Rd","2","2","1",11.2,0,44,0,32,25.5,2,-1,-1,-1,2,1,0,-1,"w1920","Mechanized",NA,"Wed","weekday"
"9311",2020-03-11,"Slate River Rd","2","2","1",11.2,0,44,0,32,25.5,2,-1,-1,-1,2,1,0,-1,"w1920","Motorized",NA,"Wed","weekday"
"9312",2020-03-11,"Slate River Rd","2","2","1",11.2,0,44,0,32,25.5,2,-1,-1,-1,2,1,0,-1,"w1920","Hybrid",NA,"Wed","weekday"
"9313",2020-03-12,"Slate River Rd","2","2","2",11.4,0.2,42,-2,35,27.1,0,2,-1,-1,-2,0,-1,-2,"w1920","Non.motorized",NA,"Thu","weekday"
"9314",2020-03-12,"Slate River Rd","2","2","2",11.4,0.2,42,-2,35,27.1,0,2,-1,-1,-2,0,-1,-2,"w1920","Mechanized",NA,"Thu","weekday"
"9315",2020-03-12,"Slate River Rd","2","2","2",11.4,0.2,42,-2,35,27.1,0,2,-1,-1,-2,0,-1,-2,"w1920","Motorized",NA,"Thu","weekday"
"9316",2020-03-12,"Slate River Rd","2","2","2",11.4,0.2,42,-2,35,27.1,0,2,-1,-1,-2,0,-1,-2,"w1920","Hybrid",NA,"Thu","weekday"
"9317",2020-03-13,"Slate River Rd","3","3","2",11.5,0.1,44,2,31,26.1,-2,0,2,-1,0,0,2,1,"w1920","Non.motorized",NA,"Fri","weekday"
"9318",2020-03-13,"Slate River Rd","3","3","2",11.5,0.1,44,2,31,26.1,-2,0,2,-1,0,0,2,1,"w1920","Mechanized",NA,"Fri","weekday"
"9319",2020-03-13,"Slate River Rd","3","3","2",11.5,0.1,44,2,31,26.1,-2,0,2,-1,0,0,2,1,"w1920","Motorized",NA,"Fri","weekday"
"9320",2020-03-13,"Slate River Rd","3","3","2",11.5,0.1,44,2,31,26.1,-2,0,2,-1,0,0,2,1,"w1920","Hybrid",NA,"Fri","weekday"
"9321",2020-03-14,"Slate River Rd","3","3","3",11.7,0.2,44,0,31,26.6,2,-2,0,2,2,0,0,2,"w1920","Non.motorized",NA,"Sat","weekend"
"9322",2020-03-14,"Slate River Rd","3","3","3",11.7,0.2,44,0,31,26.6,2,-2,0,2,2,0,0,2,"w1920","Mechanized",NA,"Sat","weekend"
"9323",2020-03-14,"Slate River Rd","3","3","3",11.7,0.2,44,0,31,26.6,2,-2,0,2,2,0,0,2,"w1920","Motorized",NA,"Sat","weekend"
"9324",2020-03-14,"Slate River Rd","3","3","3",11.7,0.2,44,0,31,26.6,2,-2,0,2,2,0,0,2,"w1920","Hybrid",NA,"Sat","weekend"
"9325",2020-03-15,"Slate River Rd","2","2","2",11.7,0,45,1,33,26,0,2,-2,0,1,3,1,1,"w1920","Non.motorized",NA,"Sun","weekend"
"9326",2020-03-15,"Slate River Rd","2","2","2",11.7,0,45,1,33,26,0,2,-2,0,1,3,1,1,"w1920","Mechanized",NA,"Sun","weekend"
"9327",2020-03-15,"Slate River Rd","2","2","2",11.7,0,45,1,33,26,0,2,-2,0,1,3,1,1,"w1920","Motorized",NA,"Sun","weekend"
"9328",2020-03-15,"Slate River Rd","2","2","2",11.7,0,45,1,33,26,0,2,-2,0,1,3,1,1,"w1920","Hybrid",NA,"Sun","weekend"
"9329",2020-03-16,"Slate River Rd","2","2","2",11.7,0,45,0,35,26,1,0,2,-2,1,1,3,1,"w1920","Non.motorized",NA,"Mon","weekday"
"9330",2020-03-16,"Slate River Rd","2","2","2",11.7,0,45,0,35,26,1,0,2,-2,1,1,3,1,"w1920","Mechanized",NA,"Mon","weekday"
"9331",2020-03-16,"Slate River Rd","2","2","2",11.7,0,45,0,35,26,1,0,2,-2,1,1,3,1,"w1920","Motorized",NA,"Mon","weekday"
"9332",2020-03-16,"Slate River Rd","2","2","2",11.7,0,45,0,35,26,1,0,2,-2,1,1,3,1,"w1920","Hybrid",NA,"Mon","weekday"
"9333",2020-03-17,"Slate River Rd","2","2","2",11.7,0,44,-1,36,26.6,0,1,0,2,-1,0,0,2,"w1920","Non.motorized",2,"Tue","weekday"
"9334",2020-03-17,"Slate River Rd","2","2","2",11.7,0,44,-1,36,26.6,0,1,0,2,-1,0,0,2,"w1920","Mechanized",0,"Tue","weekday"
"9335",2020-03-17,"Slate River Rd","2","2","2",11.7,0,44,-1,36,26.6,0,1,0,2,-1,0,0,2,"w1920","Motorized",3,"Tue","weekday"
"9336",2020-03-17,"Slate River Rd","2","2","2",11.7,0,44,-1,36,26.6,0,1,0,2,-1,0,0,2,"w1920","Hybrid",NA,"Tue","weekday"
"9337",2020-03-18,"Slate River Rd","2","2","2",11.7,0,43,-1,33,27.2,-1,0,1,0,-2,-2,-1,-1,"w1920","Non.motorized",15,"Wed","weekday"
"9338",2020-03-18,"Slate River Rd","2","2","2",11.7,0,43,-1,33,27.2,-1,0,1,0,-2,-2,-1,-1,"w1920","Mechanized",0,"Wed","weekday"
"9339",2020-03-18,"Slate River Rd","2","2","2",11.7,0,43,-1,33,27.2,-1,0,1,0,-2,-2,-1,-1,"w1920","Motorized",4,"Wed","weekday"
"9340",2020-03-18,"Slate River Rd","2","2","2",11.7,0,43,-1,33,27.2,-1,0,1,0,-2,-2,-1,-1,"w1920","Hybrid",NA,"Wed","weekday"
"9341",2020-03-19,"Slate River Rd","3","3","3",11.8,0.1,43,0,27,27.4,-1,-1,0,1,-1,-2,-2,-1,"w1920","Non.motorized",22,"Thu","weekday"
"9342",2020-03-19,"Slate River Rd","3","3","3",11.8,0.1,43,0,27,27.4,-1,-1,0,1,-1,-2,-2,-1,"w1920","Mechanized",0,"Thu","weekday"
"9343",2020-03-19,"Slate River Rd","3","3","3",11.8,0.1,43,0,27,27.4,-1,-1,0,1,-1,-2,-2,-1,"w1920","Motorized",11,"Thu","weekday"
"9344",2020-03-19,"Slate River Rd","3","3","3",11.8,0.1,43,0,27,27.4,-1,-1,0,1,-1,-2,-2,-1,"w1920","Hybrid",NA,"Thu","weekday"
"9345",2020-03-20,"Slate River Rd","3","3","2",12.7,0.9,52,9,26,24.4,0,-1,-1,0,9,8,7,7,"w1920","Non.motorized",33,"Fri","weekday"
"9346",2020-03-20,"Slate River Rd","3","3","2",12.7,0.9,52,9,26,24.4,0,-1,-1,0,9,8,7,7,"w1920","Mechanized",0,"Fri","weekday"
"9347",2020-03-20,"Slate River Rd","3","3","2",12.7,0.9,52,9,26,24.4,0,-1,-1,0,9,8,7,7,"w1920","Motorized",14,"Fri","weekday"
"9348",2020-03-20,"Slate River Rd","3","3","2",12.7,0.9,52,9,26,24.4,0,-1,-1,0,9,8,7,7,"w1920","Hybrid",NA,"Fri","weekday"
"9349",2020-03-21,"Slate River Rd","3","3","2",12.8,0.1,54,2,26,23.7,9,0,-1,-1,11,11,10,9,"w1920","Non.motorized",3,"Sat","weekend"
"9350",2020-03-21,"Slate River Rd","3","3","2",12.8,0.1,54,2,26,23.7,9,0,-1,-1,11,11,10,9,"w1920","Mechanized",0,"Sat","weekend"
"9351",2020-03-21,"Slate River Rd","3","3","2",12.8,0.1,54,2,26,23.7,9,0,-1,-1,11,11,10,9,"w1920","Motorized",6,"Sat","weekend"
"9352",2020-03-21,"Slate River Rd","3","3","2",12.8,0.1,54,2,26,23.7,9,0,-1,-1,11,11,10,9,"w1920","Hybrid",NA,"Sat","weekend"
"9353",2020-03-22,"Slate River Rd","2","2","2",13,0.2,53,-1,28,24.5,2,9,0,-1,1,10,10,9,"w1920","Non.motorized",16,"Sun","weekend"
"9354",2020-03-22,"Slate River Rd","2","2","2",13,0.2,53,-1,28,24.5,2,9,0,-1,1,10,10,9,"w1920","Mechanized",0,"Sun","weekend"
"9355",2020-03-22,"Slate River Rd","2","2","2",13,0.2,53,-1,28,24.5,2,9,0,-1,1,10,10,9,"w1920","Motorized",2,"Sun","weekend"
"9356",2020-03-22,"Slate River Rd","2","2","2",13,0.2,53,-1,28,24.5,2,9,0,-1,1,10,10,9,"w1920","Hybrid",NA,"Sun","weekend"
"9357",2020-03-23,"Slate River Rd","2","2","2",13,0,53,0,28,24.5,-1,2,9,0,-1,1,10,10,"w1920","Non.motorized",36,"Mon","weekday"
"9358",2020-03-23,"Slate River Rd","2","2","2",13,0,53,0,28,24.5,-1,2,9,0,-1,1,10,10,"w1920","Mechanized",1,"Mon","weekday"
"9359",2020-03-23,"Slate River Rd","2","2","2",13,0,53,0,28,24.5,-1,2,9,0,-1,1,10,10,"w1920","Motorized",1,"Mon","weekday"
"9360",2020-03-23,"Slate River Rd","2","2","2",13,0,53,0,28,24.5,-1,2,9,0,-1,1,10,10,"w1920","Hybrid",NA,"Mon","weekday"
"9361",2020-03-24,"Slate River Rd","2","2","2",13.2,0.2,53,0,32,24.9,0,-1,2,9,0,-1,1,10,"w1920","Non.motorized",32,"Tue","weekday"
"9362",2020-03-24,"Slate River Rd","2","2","2",13.2,0.2,53,0,32,24.9,0,-1,2,9,0,-1,1,10,"w1920","Mechanized",0,"Tue","weekday"
"9363",2020-03-24,"Slate River Rd","2","2","2",13.2,0.2,53,0,32,24.9,0,-1,2,9,0,-1,1,10,"w1920","Motorized",5,"Tue","weekday"
"9364",2020-03-24,"Slate River Rd","2","2","2",13.2,0.2,53,0,32,24.9,0,-1,2,9,0,-1,1,10,"w1920","Hybrid",NA,"Tue","weekday"
"9365",2020-03-25,"Slate River Rd","2","2","2",13.3,0.1,51,-2,34,26.1,0,0,-1,2,-2,-2,-3,-1,"w1920","Non.motorized",3,"Wed","weekday"
"9366",2020-03-25,"Slate River Rd","2","2","2",13.3,0.1,51,-2,34,26.1,0,0,-1,2,-2,-2,-3,-1,"w1920","Mechanized",1,"Wed","weekday"
"9367",2020-03-25,"Slate River Rd","2","2","2",13.3,0.1,51,-2,34,26.1,0,0,-1,2,-2,-2,-3,-1,"w1920","Motorized",6,"Wed","weekday"
"9368",2020-03-25,"Slate River Rd","2","2","2",13.3,0.1,51,-2,34,26.1,0,0,-1,2,-2,-2,-3,-1,"w1920","Hybrid",NA,"Wed","weekday"
"9369",2020-03-26,"Slate River Rd","2","2","2",13.3,0,50,-1,36,26.6,-2,0,0,-1,-3,-3,-3,-4,"w1920","Non.motorized",26,"Thu","weekday"
"9370",2020-03-26,"Slate River Rd","2","2","2",13.3,0,50,-1,36,26.6,-2,0,0,-1,-3,-3,-3,-4,"w1920","Mechanized",0,"Thu","weekday"
"9371",2020-03-26,"Slate River Rd","2","2","2",13.3,0,50,-1,36,26.6,-2,0,0,-1,-3,-3,-3,-4,"w1920","Motorized",2,"Thu","weekday"
"9372",2020-03-26,"Slate River Rd","2","2","2",13.3,0,50,-1,36,26.6,-2,0,0,-1,-3,-3,-3,-4,"w1920","Hybrid",NA,"Thu","weekday"
"9373",2020-03-26,"Slate River Rd","3","3","2",13.3,0,50,-1,36,26.6,-2,0,0,-1,-3,-3,-3,-4,"w1920","Non.motorized",26,"Thu","weekday"
"9374",2020-03-26,"Slate River Rd","3","3","2",13.3,0,50,-1,36,26.6,-2,0,0,-1,-3,-3,-3,-4,"w1920","Mechanized",0,"Thu","weekday"
"9375",2020-03-26,"Slate River Rd","3","3","2",13.3,0,50,-1,36,26.6,-2,0,0,-1,-3,-3,-3,-4,"w1920","Motorized",2,"Thu","weekday"
"9376",2020-03-26,"Slate River Rd","3","3","2",13.3,0,50,-1,36,26.6,-2,0,0,-1,-3,-3,-3,-4,"w1920","Hybrid",NA,"Thu","weekday"
"9377",2020-03-27,"Slate River Rd","3","3","2",13.3,0,50,0,23,26.6,-1,-2,0,0,-1,-3,-3,-3,"w1920","Non.motorized",11,"Fri","weekday"
"9378",2020-03-27,"Slate River Rd","3","3","2",13.3,0,50,0,23,26.6,-1,-2,0,0,-1,-3,-3,-3,"w1920","Mechanized",0,"Fri","weekday"
"9379",2020-03-27,"Slate River Rd","3","3","2",13.3,0,50,0,23,26.6,-1,-2,0,0,-1,-3,-3,-3,"w1920","Motorized",2,"Fri","weekday"
"9380",2020-03-27,"Slate River Rd","3","3","2",13.3,0,50,0,23,26.6,-1,-2,0,0,-1,-3,-3,-3,"w1920","Hybrid",NA,"Fri","weekday"
"9381",2020-03-28,"Slate River Rd","3","3","3",13.3,0,50,0,18,26.6,0,-1,-2,0,0,-1,-3,-3,"w1920","Non.motorized",14,"Sat","weekend"
"9382",2020-03-28,"Slate River Rd","3","3","3",13.3,0,50,0,18,26.6,0,-1,-2,0,0,-1,-3,-3,"w1920","Mechanized",0,"Sat","weekend"
"9383",2020-03-28,"Slate River Rd","3","3","3",13.3,0,50,0,18,26.6,0,-1,-2,0,0,-1,-3,-3,"w1920","Motorized",3,"Sat","weekend"
"9384",2020-03-28,"Slate River Rd","3","3","3",13.3,0,50,0,18,26.6,0,-1,-2,0,0,-1,-3,-3,"w1920","Hybrid",NA,"Sat","weekend"
"9385",2020-03-29,"Slate River Rd","2","2","2",13.3,0,49,-1,24,27.1,0,0,-1,-2,-1,-1,-2,-4,"w1920","Non.motorized",10,"Sun","weekend"
"9386",2020-03-29,"Slate River Rd","2","2","2",13.3,0,49,-1,24,27.1,0,0,-1,-2,-1,-1,-2,-4,"w1920","Mechanized",0,"Sun","weekend"
"9387",2020-03-29,"Slate River Rd","2","2","2",13.3,0,49,-1,24,27.1,0,0,-1,-2,-1,-1,-2,-4,"w1920","Motorized",7,"Sun","weekend"
"9388",2020-03-29,"Slate River Rd","2","2","2",13.3,0,49,-1,24,27.1,0,0,-1,-2,-1,-1,-2,-4,"w1920","Hybrid",NA,"Sun","weekend"
"9389",2020-03-30,"Slate River Rd","2","2","2",13.4,0.1,49,0,29,27.3,-1,0,0,-1,-1,-1,-1,-2,"w1920","Non.motorized",32,"Mon","weekday"
"9390",2020-03-30,"Slate River Rd","2","2","2",13.4,0.1,49,0,29,27.3,-1,0,0,-1,-1,-1,-1,-2,"w1920","Mechanized",2,"Mon","weekday"
"9391",2020-03-30,"Slate River Rd","2","2","2",13.4,0.1,49,0,29,27.3,-1,0,0,-1,-1,-1,-1,-2,"w1920","Motorized",7,"Mon","weekday"
"9392",2020-03-30,"Slate River Rd","2","2","2",13.4,0.1,49,0,29,27.3,-1,0,0,-1,-1,-1,-1,-2,"w1920","Hybrid",NA,"Mon","weekday"
"9393",2020-03-31,"Slate River Rd","2","2","2",13.6,0.2,51,2,35,26.7,0,-1,0,0,2,1,1,1,"w1920","Non.motorized",8,"Tue","weekday"
"9394",2020-03-31,"Slate River Rd","2","2","2",13.6,0.2,51,2,35,26.7,0,-1,0,0,2,1,1,1,"w1920","Mechanized",0,"Tue","weekday"
"9395",2020-03-31,"Slate River Rd","2","2","2",13.6,0.2,51,2,35,26.7,0,-1,0,0,2,1,1,1,"w1920","Motorized",9,"Tue","weekday"
"9396",2020-03-31,"Slate River Rd","2","2","2",13.6,0.2,51,2,35,26.7,0,-1,0,0,2,1,1,1,"w1920","Hybrid",NA,"Tue","weekday"
"9397",2020-04-01,"Slate River Rd","2","2","2",13.6,0,47,-4,39,28.9,2,0,-1,0,-2,-2,-3,-3,"w1920","Non.motorized",4,"Wed","weekday"
"9398",2020-04-01,"Slate River Rd","2","2","2",13.6,0,47,-4,39,28.9,2,0,-1,0,-2,-2,-3,-3,"w1920","Mechanized",0,"Wed","weekday"
"9399",2020-04-01,"Slate River Rd","2","2","2",13.6,0,47,-4,39,28.9,2,0,-1,0,-2,-2,-3,-3,"w1920","Motorized",3,"Wed","weekday"
"9400",2020-04-01,"Slate River Rd","2","2","2",13.6,0,47,-4,39,28.9,2,0,-1,0,-2,-2,-3,-3,"w1920","Hybrid",NA,"Wed","weekday"
"9401",2020-04-02,"Slate River Rd","2","2","2",13.6,0,46,-1,31,29.6,-4,2,0,-1,-5,-3,-3,-4,"w1920","Non.motorized",19,"Thu","weekday"
"9402",2020-04-02,"Slate River Rd","2","2","2",13.6,0,46,-1,31,29.6,-4,2,0,-1,-5,-3,-3,-4,"w1920","Mechanized",0,"Thu","weekday"
"9403",2020-04-02,"Slate River Rd","2","2","2",13.6,0,46,-1,31,29.6,-4,2,0,-1,-5,-3,-3,-4,"w1920","Motorized",0,"Thu","weekday"
"9404",2020-04-02,"Slate River Rd","2","2","2",13.6,0,46,-1,31,29.6,-4,2,0,-1,-5,-3,-3,-4,"w1920","Hybrid",NA,"Thu","weekday"
"9405",2020-04-03,"Slate River Rd","2","2","2",13.6,0,46,0,28,29.6,-1,-4,2,0,-1,-5,-3,-3,"w1920","Non.motorized",11,"Fri","weekday"
"9406",2020-04-03,"Slate River Rd","2","2","2",13.6,0,46,0,28,29.6,-1,-4,2,0,-1,-5,-3,-3,"w1920","Mechanized",0,"Fri","weekday"
"9407",2020-04-03,"Slate River Rd","2","2","2",13.6,0,46,0,28,29.6,-1,-4,2,0,-1,-5,-3,-3,"w1920","Motorized",7,"Fri","weekday"
"9408",2020-04-03,"Slate River Rd","2","2","2",13.6,0,46,0,28,29.6,-1,-4,2,0,-1,-5,-3,-3,"w1920","Hybrid",NA,"Fri","weekday"
"9409",2020-04-04,"Slate River Rd","2","2","2",13.6,0,45,-1,33,30.2,0,-1,-4,2,-1,-2,-6,-4,"w1920","Non.motorized",17,"Sat","weekend"
"9410",2020-04-04,"Slate River Rd","2","2","2",13.6,0,45,-1,33,30.2,0,-1,-4,2,-1,-2,-6,-4,"w1920","Mechanized",0,"Sat","weekend"
"9411",2020-04-04,"Slate River Rd","2","2","2",13.6,0,45,-1,33,30.2,0,-1,-4,2,-1,-2,-6,-4,"w1920","Motorized",12,"Sat","weekend"
"9412",2020-04-04,"Slate River Rd","2","2","2",13.6,0,45,-1,33,30.2,0,-1,-4,2,-1,-2,-6,-4,"w1920","Hybrid",NA,"Sat","weekend"
"9413",2020-04-05,"Slate River Rd","2","2","3",13.6,0,45,0,38,30.2,-1,0,-1,-4,-1,-1,-2,-6,"w1920","Non.motorized",13,"Sun","weekend"
"9414",2020-04-05,"Slate River Rd","2","2","3",13.6,0,45,0,38,30.2,-1,0,-1,-4,-1,-1,-2,-6,"w1920","Mechanized",1,"Sun","weekend"
"9415",2020-04-05,"Slate River Rd","2","2","3",13.6,0,45,0,38,30.2,-1,0,-1,-4,-1,-1,-2,-6,"w1920","Motorized",6,"Sun","weekend"
"9416",2020-04-05,"Slate River Rd","2","2","3",13.6,0,45,0,38,30.2,-1,0,-1,-4,-1,-1,-2,-6,"w1920","Hybrid",NA,"Sun","weekend"
"9417",2020-04-06,"Slate River Rd","2","2","3",13.6,0,44,-1,40,30.9,0,-1,0,-1,-1,-2,-2,-3,"w1920","Non.motorized",21,"Mon","weekday"
"9418",2020-04-06,"Slate River Rd","2","2","3",13.6,0,44,-1,40,30.9,0,-1,0,-1,-1,-2,-2,-3,"w1920","Mechanized",0,"Mon","weekday"
"9419",2020-04-06,"Slate River Rd","2","2","3",13.6,0,44,-1,40,30.9,0,-1,0,-1,-1,-2,-2,-3,"w1920","Motorized",7,"Mon","weekday"
"9420",2020-04-06,"Slate River Rd","2","2","3",13.6,0,44,-1,40,30.9,0,-1,0,-1,-1,-2,-2,-3,"w1920","Hybrid",NA,"Mon","weekday"
"9421",2020-04-07,"Slate River Rd","2","2","3",13.4,-0.2,43,-1,39,31.2,-1,0,-1,0,-2,-2,-3,-3,"w1920","Non.motorized",31,"Tue","weekday"
"9422",2020-04-07,"Slate River Rd","2","2","3",13.4,-0.2,43,-1,39,31.2,-1,0,-1,0,-2,-2,-3,-3,"w1920","Mechanized",0,"Tue","weekday"
"9423",2020-04-07,"Slate River Rd","2","2","3",13.4,-0.2,43,-1,39,31.2,-1,0,-1,0,-2,-2,-3,-3,"w1920","Motorized",1,"Tue","weekday"
"9424",2020-04-07,"Slate River Rd","2","2","3",13.4,-0.2,43,-1,39,31.2,-1,0,-1,0,-2,-2,-3,-3,"w1920","Hybrid",NA,"Tue","weekday"
"9425",2020-04-08,"Slate River Rd","2","3","3",13.3,-0.1,42,-1,40,31.7,-1,-1,0,-1,-2,-3,-3,-4,"w1920","Non.motorized",5,"Wed","weekday"
"9426",2020-04-08,"Slate River Rd","2","3","3",13.3,-0.1,42,-1,40,31.7,-1,-1,0,-1,-2,-3,-3,-4,"w1920","Mechanized",1,"Wed","weekday"
"9427",2020-04-08,"Slate River Rd","2","3","3",13.3,-0.1,42,-1,40,31.7,-1,-1,0,-1,-2,-3,-3,-4,"w1920","Motorized",2,"Wed","weekday"
"9428",2020-04-08,"Slate River Rd","2","3","3",13.3,-0.1,42,-1,40,31.7,-1,-1,0,-1,-2,-3,-3,-4,"w1920","Hybrid",NA,"Wed","weekday"
"9429",2020-04-09,"Slate River Rd","2","3","3",13.1,-0.2,40,-2,42,32.8,-1,-1,-1,0,-3,-4,-5,-5,"w1920","Non.motorized",NA,"Thu","weekday"
"9430",2020-04-09,"Slate River Rd","2","3","3",13.1,-0.2,40,-2,42,32.8,-1,-1,-1,0,-3,-4,-5,-5,"w1920","Mechanized",NA,"Thu","weekday"
"9431",2020-04-09,"Slate River Rd","2","3","3",13.1,-0.2,40,-2,42,32.8,-1,-1,-1,0,-3,-4,-5,-5,"w1920","Motorized",NA,"Thu","weekday"
"9432",2020-04-09,"Slate River Rd","2","3","3",13.1,-0.2,40,-2,42,32.8,-1,-1,-1,0,-3,-4,-5,-5,"w1920","Hybrid",NA,"Thu","weekday"
"9433",2020-04-10,"Slate River Rd","3","3","3",12.9,-0.2,39,-1,38,33.1,-2,-1,-1,-1,-3,-4,-5,-6,"w1920","Non.motorized",NA,"Fri","weekday"
"9434",2020-04-10,"Slate River Rd","3","3","3",12.9,-0.2,39,-1,38,33.1,-2,-1,-1,-1,-3,-4,-5,-6,"w1920","Mechanized",NA,"Fri","weekday"
"9435",2020-04-10,"Slate River Rd","3","3","3",12.9,-0.2,39,-1,38,33.1,-2,-1,-1,-1,-3,-4,-5,-6,"w1920","Motorized",NA,"Fri","weekday"
"9436",2020-04-10,"Slate River Rd","3","3","3",12.9,-0.2,39,-1,38,33.1,-2,-1,-1,-1,-3,-4,-5,-6,"w1920","Hybrid",NA,"Fri","weekday"
"9437",2020-04-11,"Slate River Rd","2","3","3",12.9,0,39,0,36,33.1,-1,-2,-1,-1,-1,-3,-4,-5,"w1920","Non.motorized",4,"Sat","weekend"
"9438",2020-04-11,"Slate River Rd","2","3","3",12.9,0,39,0,36,33.1,-1,-2,-1,-1,-1,-3,-4,-5,"w1920","Mechanized",0,"Sat","weekend"
"9439",2020-04-11,"Slate River Rd","2","3","3",12.9,0,39,0,36,33.1,-1,-2,-1,-1,-1,-3,-4,-5,"w1920","Motorized",6,"Sat","weekend"
"9440",2020-04-11,"Slate River Rd","2","3","3",12.9,0,39,0,36,33.1,-1,-2,-1,-1,-1,-3,-4,-5,"w1920","Hybrid",NA,"Sat","weekend"
"9441",2020-04-12,"Slate River Rd","2","2","2",12.8,-0.1,38,-1,29,33.7,0,-1,-2,-1,-1,-2,-4,-5,"w1920","Non.motorized",1,"Sun","weekend"
"9442",2020-04-12,"Slate River Rd","2","2","2",12.8,-0.1,38,-1,29,33.7,0,-1,-2,-1,-1,-2,-4,-5,"w1920","Mechanized",0,"Sun","weekend"
"9443",2020-04-12,"Slate River Rd","2","2","2",12.8,-0.1,38,-1,29,33.7,0,-1,-2,-1,-1,-2,-4,-5,"w1920","Motorized",1,"Sun","weekend"
"9444",2020-04-12,"Slate River Rd","2","2","2",12.8,-0.1,38,-1,29,33.7,0,-1,-2,-1,-1,-2,-4,-5,"w1920","Hybrid",NA,"Sun","weekend"
"9445",2020-04-13,"Slate River Rd",NA,NA,NA,12.9,0.1,39,1,20,33.1,-1,0,-1,-2,0,0,-1,-3,"w1920","Non.motorized",4,"Mon","weekday"
"9446",2020-04-13,"Slate River Rd",NA,NA,NA,12.9,0.1,39,1,20,33.1,-1,0,-1,-2,0,0,-1,-3,"w1920","Mechanized",0,"Mon","weekday"
"9447",2020-04-13,"Slate River Rd",NA,NA,NA,12.9,0.1,39,1,20,33.1,-1,0,-1,-2,0,0,-1,-3,"w1920","Motorized",5,"Mon","weekday"
"9448",2020-04-13,"Slate River Rd",NA,NA,NA,12.9,0.1,39,1,20,33.1,-1,0,-1,-2,0,0,-1,-3,"w1920","Hybrid",NA,"Mon","weekday"
"9449",2020-04-14,"Slate River Rd","2","2","2",13,0.1,39,0,18,33.3,1,-1,0,-1,1,0,0,-1,"w1920","Non.motorized",6,"Tue","weekday"
"9450",2020-04-14,"Slate River Rd","2","2","2",13,0.1,39,0,18,33.3,1,-1,0,-1,1,0,0,-1,"w1920","Mechanized",0,"Tue","weekday"
"9451",2020-04-14,"Slate River Rd","2","2","2",13,0.1,39,0,18,33.3,1,-1,0,-1,1,0,0,-1,"w1920","Motorized",9,"Tue","weekday"
"9452",2020-04-14,"Slate River Rd","2","2","2",13,0.1,39,0,18,33.3,1,-1,0,-1,1,0,0,-1,"w1920","Hybrid",NA,"Tue","weekday"
"9453",2020-04-15,"Slate River Rd",NA,NA,NA,13.2,0.2,39,0,28,33.8,0,1,-1,0,0,1,0,0,"w1920","Non.motorized",9,"Wed","weekday"
"9454",2020-04-15,"Slate River Rd",NA,NA,NA,13.2,0.2,39,0,28,33.8,0,1,-1,0,0,1,0,0,"w1920","Mechanized",0,"Wed","weekday"
"9455",2020-04-15,"Slate River Rd",NA,NA,NA,13.2,0.2,39,0,28,33.8,0,1,-1,0,0,1,0,0,"w1920","Motorized",8,"Wed","weekday"
"9456",2020-04-15,"Slate River Rd",NA,NA,NA,13.2,0.2,39,0,28,33.8,0,1,-1,0,0,1,0,0,"w1920","Hybrid",NA,"Wed","weekday"
"9457",2019-12-06,"Snodgrass","2","2","1",2.9,0.4,19,5,24,15.3,0,0,0,0,5,5,5,5,"w1920","Non.motorized",NA,"Fri","weekday"
"9458",2019-12-06,"Snodgrass","2","2","1",2.9,0.4,19,5,24,15.3,0,0,0,0,5,5,5,5,"w1920","Mechanized",NA,"Fri","weekday"
"9459",2019-12-06,"Snodgrass","2","2","1",2.9,0.4,19,5,24,15.3,0,0,0,0,5,5,5,5,"w1920","Motorized",NA,"Fri","weekday"
"9460",2019-12-06,"Snodgrass","2","2","1",2.9,0.4,19,5,24,15.3,0,0,0,0,5,5,5,5,"w1920","Hybrid",NA,"Fri","weekday"
"9461",2019-12-07,"Snodgrass","2","2","1",3,0.1,18,-1,29,16.7,5,0,0,0,4,4,4,4,"w1920","Non.motorized",NA,"Sat","weekend"
"9462",2019-12-07,"Snodgrass","2","2","1",3,0.1,18,-1,29,16.7,5,0,0,0,4,4,4,4,"w1920","Mechanized",NA,"Sat","weekend"
"9463",2019-12-07,"Snodgrass","2","2","1",3,0.1,18,-1,29,16.7,5,0,0,0,4,4,4,4,"w1920","Motorized",NA,"Sat","weekend"
"9464",2019-12-07,"Snodgrass","2","2","1",3,0.1,18,-1,29,16.7,5,0,0,0,4,4,4,4,"w1920","Hybrid",NA,"Sat","weekend"
"9465",2019-12-08,"Snodgrass","2","2","1",3,0,17,-1,28,17.6,-1,5,0,0,-2,3,3,3,"w1920","Non.motorized",NA,"Sun","weekend"
"9466",2019-12-08,"Snodgrass","2","2","1",3,0,17,-1,28,17.6,-1,5,0,0,-2,3,3,3,"w1920","Mechanized",NA,"Sun","weekend"
"9467",2019-12-08,"Snodgrass","2","2","1",3,0,17,-1,28,17.6,-1,5,0,0,-2,3,3,3,"w1920","Motorized",NA,"Sun","weekend"
"9468",2019-12-08,"Snodgrass","2","2","1",3,0,17,-1,28,17.6,-1,5,0,0,-2,3,3,3,"w1920","Hybrid",NA,"Sun","weekend"
"9469",2019-12-09,"Snodgrass","3","3","2",3.4,0.4,22,5,21,15.5,-1,-1,5,0,4,3,8,8,"w1920","Non.motorized",NA,"Mon","weekday"
"9470",2019-12-09,"Snodgrass","3","3","2",3.4,0.4,22,5,21,15.5,-1,-1,5,0,4,3,8,8,"w1920","Mechanized",NA,"Mon","weekday"
"9471",2019-12-09,"Snodgrass","3","3","2",3.4,0.4,22,5,21,15.5,-1,-1,5,0,4,3,8,8,"w1920","Motorized",NA,"Mon","weekday"
"9472",2019-12-09,"Snodgrass","3","3","2",3.4,0.4,22,5,21,15.5,-1,-1,5,0,4,3,8,8,"w1920","Hybrid",NA,"Mon","weekday"
"9473",2020-12-10,"Snodgrass",NA,NA,NA,NA,NA,NA,NA,NA,NA,NA,NA,NA,NA,NA,NA,NA,NA,"w1920","Non.motorized",NA,"Thu","weekday"
"9474",2020-12-10,"Snodgrass",NA,NA,NA,NA,NA,NA,NA,NA,NA,NA,NA,NA,NA,NA,NA,NA,NA,"w1920","Mechanized",NA,"Thu","weekday"
"9475",2020-12-10,"Snodgrass",NA,NA,NA,NA,NA,NA,NA,NA,NA,NA,NA,NA,NA,NA,NA,NA,NA,"w1920","Motorized",NA,"Thu","weekday"
"9476",2020-12-10,"Snodgrass",NA,NA,NA,NA,NA,NA,NA,NA,NA,NA,NA,NA,NA,NA,NA,NA,NA,"w1920","Hybrid",NA,"Thu","weekday"
"9477",2019-12-11,"Snodgrass","2","2","2",3.4,0,20,-1,22,17,-1,5,-1,-1,-2,3,2,1,"w1920","Non.motorized",NA,"Wed","weekday"
"9478",2019-12-11,"Snodgrass","2","2","2",3.4,0,20,-1,22,17,-1,5,-1,-1,-2,3,2,1,"w1920","Mechanized",NA,"Wed","weekday"
"9479",2019-12-11,"Snodgrass","2","2","2",3.4,0,20,-1,22,17,-1,5,-1,-1,-2,3,2,1,"w1920","Motorized",NA,"Wed","weekday"
"9480",2019-12-11,"Snodgrass","2","2","2",3.4,0,20,-1,22,17,-1,5,-1,-1,-2,3,2,1,"w1920","Hybrid",NA,"Wed","weekday"
"9481",2019-12-12,"Snodgrass","2","2","2",3.4,0,19,-1,25,17.9,-1,-1,5,-1,-2,-3,2,1,"w1920","Non.motorized",NA,"Thu","weekday"
"9482",2019-12-12,"Snodgrass","2","2","2",3.4,0,19,-1,25,17.9,-1,-1,5,-1,-2,-3,2,1,"w1920","Mechanized",NA,"Thu","weekday"
"9483",2019-12-12,"Snodgrass","2","2","2",3.4,0,19,-1,25,17.9,-1,-1,5,-1,-2,-3,2,1,"w1920","Motorized",NA,"Thu","weekday"
"9484",2019-12-12,"Snodgrass","2","2","2",3.4,0,19,-1,25,17.9,-1,-1,5,-1,-2,-3,2,1,"w1920","Hybrid",NA,"Thu","weekday"
"9485",2019-12-13,"Snodgrass","2","2","2",3.8,0.4,21,2,24,18.1,-1,-1,-1,5,1,0,-1,4,"w1920","Non.motorized",NA,"Fri","weekday"
"9486",2019-12-13,"Snodgrass","2","2","2",3.8,0.4,21,2,24,18.1,-1,-1,-1,5,1,0,-1,4,"w1920","Mechanized",NA,"Fri","weekday"
"9487",2019-12-13,"Snodgrass","2","2","2",3.8,0.4,21,2,24,18.1,-1,-1,-1,5,1,0,-1,4,"w1920","Motorized",NA,"Fri","weekday"
"9488",2019-12-13,"Snodgrass","2","2","2",3.8,0.4,21,2,24,18.1,-1,-1,-1,5,1,0,-1,4,"w1920","Hybrid",NA,"Fri","weekday"
"9489",2019-12-14,"Snodgrass","3","3","3",4.2,0.4,27,6,25,15.6,2,-1,-1,-1,8,7,6,5,"w1920","Non.motorized",NA,"Sat","weekend"
"9490",2019-12-14,"Snodgrass","3","3","3",4.2,0.4,27,6,25,15.6,2,-1,-1,-1,8,7,6,5,"w1920","Mechanized",NA,"Sat","weekend"
"9491",2019-12-14,"Snodgrass","3","3","3",4.2,0.4,27,6,25,15.6,2,-1,-1,-1,8,7,6,5,"w1920","Motorized",NA,"Sat","weekend"
"9492",2019-12-14,"Snodgrass","3","3","3",4.2,0.4,27,6,25,15.6,2,-1,-1,-1,8,7,6,5,"w1920","Hybrid",NA,"Sat","weekend"
"9493",2019-12-15,"Snodgrass","3","3","2",4.8,0.6,31,4,17,15.5,6,2,-1,-1,10,12,11,10,"w1920","Non.motorized",NA,"Sun","weekend"
"9494",2019-12-15,"Snodgrass","3","3","2",4.8,0.6,31,4,17,15.5,6,2,-1,-1,10,12,11,10,"w1920","Mechanized",NA,"Sun","weekend"
"9495",2019-12-15,"Snodgrass","3","3","2",4.8,0.6,31,4,17,15.5,6,2,-1,-1,10,12,11,10,"w1920","Motorized",NA,"Sun","weekend"
"9496",2019-12-15,"Snodgrass","3","3","2",4.8,0.6,31,4,17,15.5,6,2,-1,-1,10,12,11,10,"w1920","Hybrid",NA,"Sun","weekend"
"9497",2019-12-16,"Snodgrass","3","3","2",4.8,0,29,-2,6,16.6,4,6,2,-1,2,8,10,9,"w1920","Non.motorized",NA,"Mon","weekday"
"9498",2019-12-16,"Snodgrass","3","3","2",4.8,0,29,-2,6,16.6,4,6,2,-1,2,8,10,9,"w1920","Mechanized",NA,"Mon","weekday"
"9499",2019-12-16,"Snodgrass","3","3","2",4.8,0,29,-2,6,16.6,4,6,2,-1,2,8,10,9,"w1920","Motorized",NA,"Mon","weekday"
"9500",2019-12-16,"Snodgrass","3","3","2",4.8,0,29,-2,6,16.6,4,6,2,-1,2,8,10,9,"w1920","Hybrid",NA,"Mon","weekday"
"9501",2019-12-17,"Snodgrass","2","2","1",4.8,0,27,-2,8,17.8,-2,4,6,2,-4,0,6,8,"w1920","Non.motorized",NA,"Tue","weekday"
"9502",2019-12-17,"Snodgrass","2","2","1",4.8,0,27,-2,8,17.8,-2,4,6,2,-4,0,6,8,"w1920","Mechanized",NA,"Tue","weekday"
"9503",2019-12-17,"Snodgrass","2","2","1",4.8,0,27,-2,8,17.8,-2,4,6,2,-4,0,6,8,"w1920","Motorized",NA,"Tue","weekday"
"9504",2019-12-17,"Snodgrass","2","2","1",4.8,0,27,-2,8,17.8,-2,4,6,2,-4,0,6,8,"w1920","Hybrid",NA,"Tue","weekday"
"9505",2019-12-18,"Snodgrass","2","2","1",4.8,0,26,-1,20,18.5,-2,-2,4,6,-3,-5,-1,5,"w1920","Non.motorized",NA,"Wed","weekday"
"9506",2019-12-18,"Snodgrass","2","2","1",4.8,0,26,-1,20,18.5,-2,-2,4,6,-3,-5,-1,5,"w1920","Mechanized",NA,"Wed","weekday"
"9507",2019-12-18,"Snodgrass","2","2","1",4.8,0,26,-1,20,18.5,-2,-2,4,6,-3,-5,-1,5,"w1920","Motorized",NA,"Wed","weekday"
"9508",2019-12-18,"Snodgrass","2","2","1",4.8,0,26,-1,20,18.5,-2,-2,4,6,-3,-5,-1,5,"w1920","Hybrid",NA,"Wed","weekday"
"9509",2019-12-19,"Snodgrass","2","2","1",4.9,0.1,25,-1,21,19.6,-1,-2,-2,4,-2,-4,-6,-2,"w1920","Non.motorized",NA,"Thu","weekday"
"9510",2019-12-19,"Snodgrass","2","2","1",4.9,0.1,25,-1,21,19.6,-1,-2,-2,4,-2,-4,-6,-2,"w1920","Mechanized",NA,"Thu","weekday"
"9511",2019-12-19,"Snodgrass","2","2","1",4.9,0.1,25,-1,21,19.6,-1,-2,-2,4,-2,-4,-6,-2,"w1920","Motorized",NA,"Thu","weekday"
"9512",2019-12-19,"Snodgrass","2","2","1",4.9,0.1,25,-1,21,19.6,-1,-2,-2,4,-2,-4,-6,-2,"w1920","Hybrid",NA,"Thu","weekday"
"9513",2019-12-20,"Snodgrass","2","2","1",4.9,0,24,-1,21,20.4,-1,-1,-2,-2,-2,-3,-5,-7,"w1920","Non.motorized",NA,"Fri","weekday"
"9514",2019-12-20,"Snodgrass","2","2","1",4.9,0,24,-1,21,20.4,-1,-1,-2,-2,-2,-3,-5,-7,"w1920","Mechanized",NA,"Fri","weekday"
"9515",2019-12-20,"Snodgrass","2","2","1",4.9,0,24,-1,21,20.4,-1,-1,-2,-2,-2,-3,-5,-7,"w1920","Motorized",NA,"Fri","weekday"
"9516",2019-12-20,"Snodgrass","2","2","1",4.9,0,24,-1,21,20.4,-1,-1,-2,-2,-2,-3,-5,-7,"w1920","Hybrid",NA,"Fri","weekday"
"9517",2019-12-21,"Snodgrass","2","2","1",4.9,0,24,0,27,20.4,-1,-1,-1,-2,-1,-2,-3,-5,"w1920","Non.motorized",NA,"Sat","weekend"
"9518",2019-12-21,"Snodgrass","2","2","1",4.9,0,24,0,27,20.4,-1,-1,-1,-2,-1,-2,-3,-5,"w1920","Mechanized",NA,"Sat","weekend"
"9519",2019-12-21,"Snodgrass","2","2","1",4.9,0,24,0,27,20.4,-1,-1,-1,-2,-1,-2,-3,-5,"w1920","Motorized",NA,"Sat","weekend"
"9520",2019-12-21,"Snodgrass","2","2","1",4.9,0,24,0,27,20.4,-1,-1,-1,-2,-1,-2,-3,-5,"w1920","Hybrid",NA,"Sat","weekend"
"9521",2019-12-22,"Snodgrass","2","2","1",5,0.1,23,-1,31,21.7,0,-1,-1,-1,-1,-2,-3,-4,"w1920","Non.motorized",NA,"Sun","weekend"
"9522",2019-12-22,"Snodgrass","2","2","1",5,0.1,23,-1,31,21.7,0,-1,-1,-1,-1,-2,-3,-4,"w1920","Mechanized",NA,"Sun","weekend"
"9523",2019-12-22,"Snodgrass","2","2","1",5,0.1,23,-1,31,21.7,0,-1,-1,-1,-1,-2,-3,-4,"w1920","Motorized",NA,"Sun","weekend"
"9524",2019-12-22,"Snodgrass","2","2","1",5,0.1,23,-1,31,21.7,0,-1,-1,-1,-1,-2,-3,-4,"w1920","Hybrid",NA,"Sun","weekend"
"9525",2019-12-23,"Snodgrass","2","1","1",5,0,23,0,34,21.7,-1,0,-1,-1,-1,-1,-2,-3,"w1920","Non.motorized",NA,"Mon","weekday"
"9526",2019-12-23,"Snodgrass","2","1","1",5,0,23,0,34,21.7,-1,0,-1,-1,-1,-1,-2,-3,"w1920","Mechanized",NA,"Mon","weekday"
"9527",2019-12-23,"Snodgrass","2","1","1",5,0,23,0,34,21.7,-1,0,-1,-1,-1,-1,-2,-3,"w1920","Motorized",NA,"Mon","weekday"
"9528",2019-12-23,"Snodgrass","2","1","1",5,0,23,0,34,21.7,-1,0,-1,-1,-1,-1,-2,-3,"w1920","Hybrid",NA,"Mon","weekday"
"9529",2019-12-24,"Snodgrass","2","1","1",5,0,22,-1,30,22.7,0,-1,0,-1,-1,-2,-2,-3,"w1920","Non.motorized",NA,"Tue","weekday"
"9530",2019-12-24,"Snodgrass","2","1","1",5,0,22,-1,30,22.7,0,-1,0,-1,-1,-2,-2,-3,"w1920","Mechanized",NA,"Tue","weekday"
"9531",2019-12-24,"Snodgrass","2","1","1",5,0,22,-1,30,22.7,0,-1,0,-1,-1,-2,-2,-3,"w1920","Motorized",NA,"Tue","weekday"
"9532",2019-12-24,"Snodgrass","2","1","1",5,0,22,-1,30,22.7,0,-1,0,-1,-1,-2,-2,-3,"w1920","Hybrid",NA,"Tue","weekday"
"9533",2019-12-25,"Snodgrass","2","2","2",5,0,23,1,22,21.7,-1,0,-1,0,0,0,-1,-1,"w1920","Non.motorized",NA,"Wed","weekday"
"9534",2019-12-25,"Snodgrass","2","2","2",5,0,23,1,22,21.7,-1,0,-1,0,0,0,-1,-1,"w1920","Mechanized",NA,"Wed","weekday"
"9535",2019-12-25,"Snodgrass","2","2","2",5,0,23,1,22,21.7,-1,0,-1,0,0,0,-1,-1,"w1920","Motorized",NA,"Wed","weekday"
"9536",2019-12-25,"Snodgrass","2","2","2",5,0,23,1,22,21.7,-1,0,-1,0,0,0,-1,-1,"w1920","Hybrid",NA,"Wed","weekday"
"9537",2019-12-26,"Snodgrass","2","2","1",5,0,23,0,17,21.7,1,-1,0,-1,1,0,0,-1,"w1920","Non.motorized",NA,"Thu","weekday"
"9538",2019-12-26,"Snodgrass","2","2","1",5,0,23,0,17,21.7,1,-1,0,-1,1,0,0,-1,"w1920","Mechanized",NA,"Thu","weekday"
"9539",2019-12-26,"Snodgrass","2","2","1",5,0,23,0,17,21.7,1,-1,0,-1,1,0,0,-1,"w1920","Motorized",NA,"Thu","weekday"
"9540",2019-12-26,"Snodgrass","2","2","1",5,0,23,0,17,21.7,1,-1,0,-1,1,0,0,-1,"w1920","Hybrid",NA,"Thu","weekday"
"9541",2019-12-27,"Snodgrass","3","3","2",5.1,0.1,24,1,22,21.2,0,1,-1,0,1,2,1,1,"w1920","Non.motorized",NA,"Fri","weekday"
"9542",2019-12-27,"Snodgrass","3","3","2",5.1,0.1,24,1,22,21.2,0,1,-1,0,1,2,1,1,"w1920","Mechanized",NA,"Fri","weekday"
"9543",2019-12-27,"Snodgrass","3","3","2",5.1,0.1,24,1,22,21.2,0,1,-1,0,1,2,1,1,"w1920","Motorized",NA,"Fri","weekday"
"9544",2019-12-27,"Snodgrass","3","3","2",5.1,0.1,24,1,22,21.2,0,1,-1,0,1,2,1,1,"w1920","Hybrid",NA,"Fri","weekday"
"9545",2019-12-28,"Snodgrass","3","3","2",5.6,0.5,30,6,16,18.7,1,0,1,-1,7,7,8,7,"w1920","Non.motorized",NA,"Sat","weekend"
"9546",2019-12-28,"Snodgrass","3","3","2",5.6,0.5,30,6,16,18.7,1,0,1,-1,7,7,8,7,"w1920","Mechanized",NA,"Sat","weekend"
"9547",2019-12-28,"Snodgrass","3","3","2",5.6,0.5,30,6,16,18.7,1,0,1,-1,7,7,8,7,"w1920","Motorized",NA,"Sat","weekend"
"9548",2019-12-28,"Snodgrass","3","3","2",5.6,0.5,30,6,16,18.7,1,0,1,-1,7,7,8,7,"w1920","Hybrid",NA,"Sat","weekend"
"9549",2019-12-29,"Snodgrass","3","3","2",5.6,0,29,-1,3,19.3,6,1,0,1,5,6,6,7,"w1920","Non.motorized",NA,"Sun","weekend"
"9550",2019-12-29,"Snodgrass","3","3","2",5.6,0,29,-1,3,19.3,6,1,0,1,5,6,6,7,"w1920","Mechanized",NA,"Sun","weekend"
"9551",2019-12-29,"Snodgrass","3","3","2",5.6,0,29,-1,3,19.3,6,1,0,1,5,6,6,7,"w1920","Motorized",NA,"Sun","weekend"
"9552",2019-12-29,"Snodgrass","3","3","2",5.6,0,29,-1,3,19.3,6,1,0,1,5,6,6,7,"w1920","Hybrid",NA,"Sun","weekend"
"9553",2019-12-30,"Snodgrass","3","3","2",5.6,0,28,-1,3,20,-1,6,1,0,-2,4,5,5,"w1920","Non.motorized",NA,"Mon","weekday"
"9554",2019-12-30,"Snodgrass","3","3","2",5.6,0,28,-1,3,20,-1,6,1,0,-2,4,5,5,"w1920","Mechanized",NA,"Mon","weekday"
"9555",2019-12-30,"Snodgrass","3","3","2",5.6,0,28,-1,3,20,-1,6,1,0,-2,4,5,5,"w1920","Motorized",NA,"Mon","weekday"
"9556",2019-12-30,"Snodgrass","3","3","2",5.6,0,28,-1,3,20,-1,6,1,0,-2,4,5,5,"w1920","Hybrid",NA,"Mon","weekday"
"9557",2019-12-31,"Snodgrass","2","2","1",5.6,0,28,0,13,20,-1,-1,6,1,-1,-2,4,5,"w1920","Non.motorized",NA,"Tue","weekday"
"9558",2019-12-31,"Snodgrass","2","2","1",5.6,0,28,0,13,20,-1,-1,6,1,-1,-2,4,5,"w1920","Mechanized",NA,"Tue","weekday"
"9559",2019-12-31,"Snodgrass","2","2","1",5.6,0,28,0,13,20,-1,-1,6,1,-1,-2,4,5,"w1920","Motorized",NA,"Tue","weekday"
"9560",2019-12-31,"Snodgrass","2","2","1",5.6,0,28,0,13,20,-1,-1,6,1,-1,-2,4,5,"w1920","Hybrid",NA,"Tue","weekday"
"9561",2020-01-01,"Snodgrass","2","1","1",5.6,0,27,-1,21,20.7,0,-1,-1,6,-1,-2,-3,3,"w1920","Non.motorized",NA,"Wed","weekday"
"9562",2020-01-01,"Snodgrass","2","1","1",5.6,0,27,-1,21,20.7,0,-1,-1,6,-1,-2,-3,3,"w1920","Mechanized",NA,"Wed","weekday"
"9563",2020-01-01,"Snodgrass","2","1","1",5.6,0,27,-1,21,20.7,0,-1,-1,6,-1,-2,-3,3,"w1920","Motorized",NA,"Wed","weekday"
"9564",2020-01-01,"Snodgrass","2","1","1",5.6,0,27,-1,21,20.7,0,-1,-1,6,-1,-2,-3,3,"w1920","Hybrid",NA,"Wed","weekday"
"9565",2020-01-02,"Snodgrass","3","3","2",5.9,0.3,29,2,16,20.3,-1,0,-1,-1,1,1,0,-1,"w1920","Non.motorized",NA,"Thu","weekday"
"9566",2020-01-02,"Snodgrass","3","3","2",5.9,0.3,29,2,16,20.3,-1,0,-1,-1,1,1,0,-1,"w1920","Mechanized",NA,"Thu","weekday"
"9567",2020-01-02,"Snodgrass","3","3","2",5.9,0.3,29,2,16,20.3,-1,0,-1,-1,1,1,0,-1,"w1920","Motorized",NA,"Thu","weekday"
"9568",2020-01-02,"Snodgrass","3","3","2",5.9,0.3,29,2,16,20.3,-1,0,-1,-1,1,1,0,-1,"w1920","Hybrid",NA,"Thu","weekday"
"9569",2020-01-03,"Snodgrass","3","2","1",5.9,0,31,2,19,19,2,-1,0,-1,4,3,3,2,"w1920","Non.motorized",NA,"Fri","weekday"
"9570",2020-01-03,"Snodgrass","3","2","1",5.9,0,31,2,19,19,2,-1,0,-1,4,3,3,2,"w1920","Mechanized",NA,"Fri","weekday"
"9571",2020-01-03,"Snodgrass","3","2","1",5.9,0,31,2,19,19,2,-1,0,-1,4,3,3,2,"w1920","Motorized",NA,"Fri","weekday"
"9572",2020-01-03,"Snodgrass","3","2","1",5.9,0,31,2,19,19,2,-1,0,-1,4,3,3,2,"w1920","Hybrid",NA,"Fri","weekday"
"9573",2020-01-04,"Snodgrass","2","2","1",5.9,0,30,-1,26,19.7,2,2,-1,0,1,3,2,2,"w1920","Non.motorized",NA,"Sat","weekend"
"9574",2020-01-04,"Snodgrass","2","2","1",5.9,0,30,-1,26,19.7,2,2,-1,0,1,3,2,2,"w1920","Mechanized",NA,"Sat","weekend"
"9575",2020-01-04,"Snodgrass","2","2","1",5.9,0,30,-1,26,19.7,2,2,-1,0,1,3,2,2,"w1920","Motorized",NA,"Sat","weekend"
"9576",2020-01-04,"Snodgrass","2","2","1",5.9,0,30,-1,26,19.7,2,2,-1,0,1,3,2,2,"w1920","Hybrid",NA,"Sat","weekend"
"9577",2020-01-05,"Snodgrass","2","2","1",5.9,0,28,-2,23,21.1,-1,2,2,-1,-3,-1,1,0,"w1920","Non.motorized",NA,"Sun","weekend"
"9578",2020-01-05,"Snodgrass","2","2","1",5.9,0,28,-2,23,21.1,-1,2,2,-1,-3,-1,1,0,"w1920","Mechanized",NA,"Sun","weekend"
"9579",2020-01-05,"Snodgrass","2","2","1",5.9,0,28,-2,23,21.1,-1,2,2,-1,-3,-1,1,0,"w1920","Motorized",NA,"Sun","weekend"
"9580",2020-01-05,"Snodgrass","2","2","1",5.9,0,28,-2,23,21.1,-1,2,2,-1,-3,-1,1,0,"w1920","Hybrid",NA,"Sun","weekend"
"9581",2020-01-06,"Snodgrass","2","2","1",5.9,0,28,0,15,21.1,-2,-1,2,2,-2,-3,-1,1,"w1920","Non.motorized",NA,"Mon","weekday"
"9582",2020-01-06,"Snodgrass","2","2","1",5.9,0,28,0,15,21.1,-2,-1,2,2,-2,-3,-1,1,"w1920","Mechanized",NA,"Mon","weekday"
"9583",2020-01-06,"Snodgrass","2","2","1",5.9,0,28,0,15,21.1,-2,-1,2,2,-2,-3,-1,1,"w1920","Motorized",NA,"Mon","weekday"
"9584",2020-01-06,"Snodgrass","2","2","1",5.9,0,28,0,15,21.1,-2,-1,2,2,-2,-3,-1,1,"w1920","Hybrid",NA,"Mon","weekday"
"9585",2020-01-07,"Snodgrass","2","1","1",5.9,0,28,0,22,21.1,0,-2,-1,2,0,-2,-3,-1,"w1920","Non.motorized",NA,"Tue","weekday"
"9586",2020-01-07,"Snodgrass","2","1","1",5.9,0,28,0,22,21.1,0,-2,-1,2,0,-2,-3,-1,"w1920","Mechanized",NA,"Tue","weekday"
"9587",2020-01-07,"Snodgrass","2","1","1",5.9,0,28,0,22,21.1,0,-2,-1,2,0,-2,-3,-1,"w1920","Motorized",NA,"Tue","weekday"
"9588",2020-01-07,"Snodgrass","2","1","1",5.9,0,28,0,22,21.1,0,-2,-1,2,0,-2,-3,-1,"w1920","Hybrid",NA,"Tue","weekday"
"9589",2020-01-08,"Snodgrass","2","1","1",6,0.1,28,0,23,21.4,0,0,-2,-1,0,0,-2,-3,"w1920","Non.motorized",NA,"Wed","weekday"
"9590",2020-01-08,"Snodgrass","2","1","1",6,0.1,28,0,23,21.4,0,0,-2,-1,0,0,-2,-3,"w1920","Mechanized",NA,"Wed","weekday"
"9591",2020-01-08,"Snodgrass","2","1","1",6,0.1,28,0,23,21.4,0,0,-2,-1,0,0,-2,-3,"w1920","Motorized",NA,"Wed","weekday"
"9592",2020-01-08,"Snodgrass","2","1","1",6,0.1,28,0,23,21.4,0,0,-2,-1,0,0,-2,-3,"w1920","Hybrid",NA,"Wed","weekday"
"9593",2020-01-09,"Snodgrass","2","1","1",6,0,27,-1,17,22.2,0,0,0,-2,-1,-1,-1,-3,"w1920","Non.motorized",NA,"Thu","weekday"
"9594",2020-01-09,"Snodgrass","2","1","1",6,0,27,-1,17,22.2,0,0,0,-2,-1,-1,-1,-3,"w1920","Mechanized",NA,"Thu","weekday"
"9595",2020-01-09,"Snodgrass","2","1","1",6,0,27,-1,17,22.2,0,0,0,-2,-1,-1,-1,-3,"w1920","Motorized",NA,"Thu","weekday"
"9596",2020-01-09,"Snodgrass","2","1","1",6,0,27,-1,17,22.2,0,0,0,-2,-1,-1,-1,-3,"w1920","Hybrid",NA,"Thu","weekday"
"9597",2020-01-10,"Snodgrass","2","1","1",6,0,29,2,11,20.7,-1,0,0,0,1,1,1,1,"w1920","Non.motorized",NA,"Fri","weekday"
"9598",2020-01-10,"Snodgrass","2","1","1",6,0,29,2,11,20.7,-1,0,0,0,1,1,1,1,"w1920","Mechanized",NA,"Fri","weekday"
"9599",2020-01-10,"Snodgrass","2","1","1",6,0,29,2,11,20.7,-1,0,0,0,1,1,1,1,"w1920","Motorized",NA,"Fri","weekday"
"9600",2020-01-10,"Snodgrass","2","1","1",6,0,29,2,11,20.7,-1,0,0,0,1,1,1,1,"w1920","Hybrid",NA,"Fri","weekday"
"9601",2020-01-11,"Snodgrass","2","1","1",6,0,29,0,12,20.7,2,-1,0,0,2,1,1,1,"w1920","Non.motorized",10,"Sat","weekend"
"9602",2020-01-11,"Snodgrass","2","1","1",6,0,29,0,12,20.7,2,-1,0,0,2,1,1,1,"w1920","Mechanized",0,"Sat","weekend"
"9603",2020-01-11,"Snodgrass","2","1","1",6,0,29,0,12,20.7,2,-1,0,0,2,1,1,1,"w1920","Motorized",NA,"Sat","weekend"
"9604",2020-01-11,"Snodgrass","2","1","1",6,0,29,0,12,20.7,2,-1,0,0,2,1,1,1,"w1920","Hybrid",NA,"Sat","weekend"
"9605",2020-01-12,"Snodgrass","2","1","1",6.1,0.1,29,0,13,21,0,2,-1,0,0,2,1,1,"w1920","Non.motorized",96,"Sun","weekend"
"9606",2020-01-12,"Snodgrass","2","1","1",6.1,0.1,29,0,13,21,0,2,-1,0,0,2,1,1,"w1920","Mechanized",2,"Sun","weekend"
"9607",2020-01-12,"Snodgrass","2","1","1",6.1,0.1,29,0,13,21,0,2,-1,0,0,2,1,1,"w1920","Motorized",NA,"Sun","weekend"
"9608",2020-01-12,"Snodgrass","2","1","1",6.1,0.1,29,0,13,21,0,2,-1,0,0,2,1,1,"w1920","Hybrid",NA,"Sun","weekend"
"9609",2020-01-13,"Snodgrass","2","2","1",6.2,0.1,29,0,16,21.4,0,0,2,-1,0,0,2,1,"w1920","Non.motorized",2,"Mon","weekday"
"9610",2020-01-13,"Snodgrass","2","2","1",6.2,0.1,29,0,16,21.4,0,0,2,-1,0,0,2,1,"w1920","Mechanized",0,"Mon","weekday"
"9611",2020-01-13,"Snodgrass","2","2","1",6.2,0.1,29,0,16,21.4,0,0,2,-1,0,0,2,1,"w1920","Motorized",NA,"Mon","weekday"
"9612",2020-01-13,"Snodgrass","2","2","1",6.2,0.1,29,0,16,21.4,0,0,2,-1,0,0,2,1,"w1920","Hybrid",NA,"Mon","weekday"
"9613",2020-01-14,"Snodgrass","3","2","1",6.6,0.4,34,5,23,19.4,0,0,0,2,5,5,5,7,"w1920","Non.motorized",69,"Tue","weekday"
"9614",2020-01-14,"Snodgrass","3","2","1",6.6,0.4,34,5,23,19.4,0,0,0,2,5,5,5,7,"w1920","Mechanized",0,"Tue","weekday"
"9615",2020-01-14,"Snodgrass","3","2","1",6.6,0.4,34,5,23,19.4,0,0,0,2,5,5,5,7,"w1920","Motorized",NA,"Tue","weekday"
"9616",2020-01-14,"Snodgrass","3","2","1",6.6,0.4,34,5,23,19.4,0,0,0,2,5,5,5,7,"w1920","Hybrid",NA,"Tue","weekday"
"9617",2020-01-15,"Snodgrass","3","2","1",6.7,0.1,32,-2,23,20.9,5,0,0,0,3,3,3,3,"w1920","Non.motorized",46,"Wed","weekday"
"9618",2020-01-15,"Snodgrass","3","2","1",6.7,0.1,32,-2,23,20.9,5,0,0,0,3,3,3,3,"w1920","Mechanized",0,"Wed","weekday"
"9619",2020-01-15,"Snodgrass","3","2","1",6.7,0.1,32,-2,23,20.9,5,0,0,0,3,3,3,3,"w1920","Motorized",NA,"Wed","weekday"
"9620",2020-01-15,"Snodgrass","3","2","1",6.7,0.1,32,-2,23,20.9,5,0,0,0,3,3,3,3,"w1920","Hybrid",NA,"Wed","weekday"
"9621",2020-01-16,"Snodgrass","2","2","1",6.7,0,31,-1,28,21.6,-2,5,0,0,-3,2,2,2,"w1920","Non.motorized",39,"Thu","weekday"
"9622",2020-01-16,"Snodgrass","2","2","1",6.7,0,31,-1,28,21.6,-2,5,0,0,-3,2,2,2,"w1920","Mechanized",3,"Thu","weekday"
"9623",2020-01-16,"Snodgrass","2","2","1",6.7,0,31,-1,28,21.6,-2,5,0,0,-3,2,2,2,"w1920","Motorized",NA,"Thu","weekday"
"9624",2020-01-16,"Snodgrass","2","2","1",6.7,0,31,-1,28,21.6,-2,5,0,0,-3,2,2,2,"w1920","Hybrid",NA,"Thu","weekday"
"9625",2020-01-17,"Snodgrass","2","2","1",6.8,0.1,29,-2,19,23.4,-1,-2,5,0,-3,-5,0,0,"w1920","Non.motorized",25,"Fri","weekday"
"9626",2020-01-17,"Snodgrass","2","2","1",6.8,0.1,29,-2,19,23.4,-1,-2,5,0,-3,-5,0,0,"w1920","Mechanized",0,"Fri","weekday"
"9627",2020-01-17,"Snodgrass","2","2","1",6.8,0.1,29,-2,19,23.4,-1,-2,5,0,-3,-5,0,0,"w1920","Motorized",NA,"Fri","weekday"
"9628",2020-01-17,"Snodgrass","2","2","1",6.8,0.1,29,-2,19,23.4,-1,-2,5,0,-3,-5,0,0,"w1920","Hybrid",NA,"Fri","weekday"
"9629",2020-01-18,"Snodgrass","2","2","2",7,0.2,34,5,16,20.6,-2,-1,-2,5,3,2,0,5,"w1920","Non.motorized",88,"Sat","weekend"
"9630",2020-01-18,"Snodgrass","2","2","2",7,0.2,34,5,16,20.6,-2,-1,-2,5,3,2,0,5,"w1920","Mechanized",1,"Sat","weekend"
"9631",2020-01-18,"Snodgrass","2","2","2",7,0.2,34,5,16,20.6,-2,-1,-2,5,3,2,0,5,"w1920","Motorized",NA,"Sat","weekend"
"9632",2020-01-18,"Snodgrass","2","2","2",7,0.2,34,5,16,20.6,-2,-1,-2,5,3,2,0,5,"w1920","Hybrid",NA,"Sat","weekend"
"9633",2020-01-19,"Snodgrass","2","2","1",7,0,33,-1,21,21.2,5,-2,-1,-2,4,2,1,-1,"w1920","Non.motorized",50,"Sun","weekend"
"9634",2020-01-19,"Snodgrass","2","2","1",7,0,33,-1,21,21.2,5,-2,-1,-2,4,2,1,-1,"w1920","Mechanized",3,"Sun","weekend"
"9635",2020-01-19,"Snodgrass","2","2","1",7,0,33,-1,21,21.2,5,-2,-1,-2,4,2,1,-1,"w1920","Motorized",NA,"Sun","weekend"
"9636",2020-01-19,"Snodgrass","2","2","1",7,0,33,-1,21,21.2,5,-2,-1,-2,4,2,1,-1,"w1920","Hybrid",NA,"Sun","weekend"
"9637",2020-01-20,"Snodgrass","2","2","1",7.1,0.1,32,-1,25,22.2,-1,5,-2,-1,-2,3,1,0,"w1920","Non.motorized",39,"Mon","weekday"
"9638",2020-01-20,"Snodgrass","2","2","1",7.1,0.1,32,-1,25,22.2,-1,5,-2,-1,-2,3,1,0,"w1920","Mechanized",1,"Mon","weekday"
"9639",2020-01-20,"Snodgrass","2","2","1",7.1,0.1,32,-1,25,22.2,-1,5,-2,-1,-2,3,1,0,"w1920","Motorized",NA,"Mon","weekday"
"9640",2020-01-20,"Snodgrass","2","2","1",7.1,0.1,32,-1,25,22.2,-1,5,-2,-1,-2,3,1,0,"w1920","Hybrid",NA,"Mon","weekday"
"9641",2020-01-21,"Snodgrass","2","2","1",7.1,0,31,-1,28,22.9,-1,-1,5,-2,-2,-3,2,0,"w1920","Non.motorized",35,"Tue","weekday"
"9642",2020-01-21,"Snodgrass","2","2","1",7.1,0,31,-1,28,22.9,-1,-1,5,-2,-2,-3,2,0,"w1920","Mechanized",0,"Tue","weekday"
"9643",2020-01-21,"Snodgrass","2","2","1",7.1,0,31,-1,28,22.9,-1,-1,5,-2,-2,-3,2,0,"w1920","Motorized",NA,"Tue","weekday"
"9644",2020-01-21,"Snodgrass","2","2","1",7.1,0,31,-1,28,22.9,-1,-1,5,-2,-2,-3,2,0,"w1920","Hybrid",NA,"Tue","weekday"
"9645",2020-01-22,"Snodgrass","2","2","2",7.3,0.2,32,1,25,22.8,-1,-1,-1,5,0,-1,-2,3,"w1920","Non.motorized",36,"Wed","weekday"
"9646",2020-01-22,"Snodgrass","2","2","2",7.3,0.2,32,1,25,22.8,-1,-1,-1,5,0,-1,-2,3,"w1920","Mechanized",1,"Wed","weekday"
"9647",2020-01-22,"Snodgrass","2","2","2",7.3,0.2,32,1,25,22.8,-1,-1,-1,5,0,-1,-2,3,"w1920","Motorized",NA,"Wed","weekday"
"9648",2020-01-22,"Snodgrass","2","2","2",7.3,0.2,32,1,25,22.8,-1,-1,-1,5,0,-1,-2,3,"w1920","Hybrid",NA,"Wed","weekday"
"9649",2020-01-23,"Snodgrass","3","2","2",7.3,0,34,2,23,21.5,1,-1,-1,-1,3,2,1,0,"w1920","Non.motorized",36,"Thu","weekday"
"9650",2020-01-23,"Snodgrass","3","2","2",7.3,0,34,2,23,21.5,1,-1,-1,-1,3,2,1,0,"w1920","Mechanized",1,"Thu","weekday"
"9651",2020-01-23,"Snodgrass","3","2","2",7.3,0,34,2,23,21.5,1,-1,-1,-1,3,2,1,0,"w1920","Motorized",NA,"Thu","weekday"
"9652",2020-01-23,"Snodgrass","3","2","2",7.3,0,34,2,23,21.5,1,-1,-1,-1,3,2,1,0,"w1920","Hybrid",NA,"Thu","weekday"
"9653",2020-01-24,"Snodgrass","2","2","1",7.3,0,33,-1,23,22.1,2,1,-1,-1,1,2,1,0,"w1920","Non.motorized",74,"Fri","weekday"
"9654",2020-01-24,"Snodgrass","2","2","1",7.3,0,33,-1,23,22.1,2,1,-1,-1,1,2,1,0,"w1920","Mechanized",6,"Fri","weekday"
"9655",2020-01-24,"Snodgrass","2","2","1",7.3,0,33,-1,23,22.1,2,1,-1,-1,1,2,1,0,"w1920","Motorized",NA,"Fri","weekday"
"9656",2020-01-24,"Snodgrass","2","2","1",7.3,0,33,-1,23,22.1,2,1,-1,-1,1,2,1,0,"w1920","Hybrid",NA,"Fri","weekday"
"9657",2020-01-25,"Snodgrass","2","2","1",7.4,0.1,32,-1,25,23.1,-1,2,1,-1,-2,0,1,0,"w1920","Non.motorized",104,"Sat","weekend"
"9658",2020-01-25,"Snodgrass","2","2","1",7.4,0.1,32,-1,25,23.1,-1,2,1,-1,-2,0,1,0,"w1920","Mechanized",3,"Sat","weekend"
"9659",2020-01-25,"Snodgrass","2","2","1",7.4,0.1,32,-1,25,23.1,-1,2,1,-1,-2,0,1,0,"w1920","Motorized",NA,"Sat","weekend"
"9660",2020-01-25,"Snodgrass","2","2","1",7.4,0.1,32,-1,25,23.1,-1,2,1,-1,-2,0,1,0,"w1920","Hybrid",NA,"Sat","weekend"
"9661",2020-01-26,"Snodgrass","2","1","1",7.4,0,32,0,28,23.1,-1,-1,2,1,-1,-2,0,1,"w1920","Non.motorized",90,"Sun","weekend"
"9662",2020-01-26,"Snodgrass","2","1","1",7.4,0,32,0,28,23.1,-1,-1,2,1,-1,-2,0,1,"w1920","Mechanized",2,"Sun","weekend"
"9663",2020-01-26,"Snodgrass","2","1","1",7.4,0,32,0,28,23.1,-1,-1,2,1,-1,-2,0,1,"w1920","Motorized",NA,"Sun","weekend"
"9664",2020-01-26,"Snodgrass","2","1","1",7.4,0,32,0,28,23.1,-1,-1,2,1,-1,-2,0,1,"w1920","Hybrid",NA,"Sun","weekend"
"9665",2020-01-27,"Snodgrass","2","1","1",7.4,0,32,0,24,23.1,0,-1,-1,2,0,-1,-2,0,"w1920","Non.motorized",32,"Mon","weekday"
"9666",2020-01-27,"Snodgrass","2","1","1",7.4,0,32,0,24,23.1,0,-1,-1,2,0,-1,-2,0,"w1920","Mechanized",0,"Mon","weekday"
"9667",2020-01-27,"Snodgrass","2","1","1",7.4,0,32,0,24,23.1,0,-1,-1,2,0,-1,-2,0,"w1920","Motorized",NA,"Mon","weekday"
"9668",2020-01-27,"Snodgrass","2","1","1",7.4,0,32,0,24,23.1,0,-1,-1,2,0,-1,-2,0,"w1920","Hybrid",NA,"Mon","weekday"
"9669",2020-01-28,"Snodgrass","3","2","2",7.4,0,32,0,19,23.1,0,0,-1,-1,0,0,-1,-2,"w1920","Non.motorized",67,"Tue","weekday"
"9670",2020-01-28,"Snodgrass","3","2","2",7.4,0,32,0,19,23.1,0,0,-1,-1,0,0,-1,-2,"w1920","Mechanized",1,"Tue","weekday"
"9671",2020-01-28,"Snodgrass","3","2","2",7.4,0,32,0,19,23.1,0,0,-1,-1,0,0,-1,-2,"w1920","Motorized",NA,"Tue","weekday"
"9672",2020-01-28,"Snodgrass","3","2","2",7.4,0,32,0,19,23.1,0,0,-1,-1,0,0,-1,-2,"w1920","Hybrid",NA,"Tue","weekday"
"9673",2020-01-29,"Snodgrass","2","2","1",7.4,0,31,-1,20,23.9,0,0,0,-1,-1,-1,-1,-2,"w1920","Non.motorized",43,"Wed","weekday"
"9674",2020-01-29,"Snodgrass","2","2","1",7.4,0,31,-1,20,23.9,0,0,0,-1,-1,-1,-1,-2,"w1920","Mechanized",3,"Wed","weekday"
"9675",2020-01-29,"Snodgrass","2","2","1",7.4,0,31,-1,20,23.9,0,0,0,-1,-1,-1,-1,-2,"w1920","Motorized",NA,"Wed","weekday"
"9676",2020-01-29,"Snodgrass","2","2","1",7.4,0,31,-1,20,23.9,0,0,0,-1,-1,-1,-1,-2,"w1920","Hybrid",NA,"Wed","weekday"
"9677",2020-01-30,"Snodgrass","2","2","1",7.4,0,31,0,17,23.9,-1,0,0,0,-1,-1,-1,-1,"w1920","Non.motorized",33,"Thu","weekday"
"9678",2020-01-30,"Snodgrass","2","2","1",7.4,0,31,0,17,23.9,-1,0,0,0,-1,-1,-1,-1,"w1920","Mechanized",8,"Thu","weekday"
"9679",2020-01-30,"Snodgrass","2","2","1",7.4,0,31,0,17,23.9,-1,0,0,0,-1,-1,-1,-1,"w1920","Motorized",NA,"Thu","weekday"
"9680",2020-01-30,"Snodgrass","2","2","1",7.4,0,31,0,17,23.9,-1,0,0,0,-1,-1,-1,-1,"w1920","Hybrid",NA,"Thu","weekday"
"9681",2020-01-31,"Snodgrass","2","1","1",7.4,0,31,0,20,23.9,0,-1,0,0,0,-1,-1,-1,"w1920","Non.motorized",53,"Fri","weekday"
"9682",2020-01-31,"Snodgrass","2","1","1",7.4,0,31,0,20,23.9,0,-1,0,0,0,-1,-1,-1,"w1920","Mechanized",11,"Fri","weekday"
"9683",2020-01-31,"Snodgrass","2","1","1",7.4,0,31,0,20,23.9,0,-1,0,0,0,-1,-1,-1,"w1920","Motorized",NA,"Fri","weekday"
"9684",2020-01-31,"Snodgrass","2","1","1",7.4,0,31,0,20,23.9,0,-1,0,0,0,-1,-1,-1,"w1920","Hybrid",NA,"Fri","weekday"
"9685",2020-02-01,"Snodgrass","2","1","1",7.4,0,31,0,28,23.9,0,0,-1,0,0,0,-1,-1,"w1920","Non.motorized",125,"Sat","weekend"
"9686",2020-02-01,"Snodgrass","2","1","1",7.4,0,31,0,28,23.9,0,0,-1,0,0,0,-1,-1,"w1920","Mechanized",14,"Sat","weekend"
"9687",2020-02-01,"Snodgrass","2","1","1",7.4,0,31,0,28,23.9,0,0,-1,0,0,0,-1,-1,"w1920","Motorized",NA,"Sat","weekend"
"9688",2020-02-01,"Snodgrass","2","1","1",7.4,0,31,0,28,23.9,0,0,-1,0,0,0,-1,-1,"w1920","Hybrid",NA,"Sat","weekend"
"9689",2020-02-02,"Snodgrass","1","1","1",7.4,0,31,0,33,23.9,0,0,0,-1,0,0,0,-1,"w1920","Non.motorized",108,"Sun","weekend"
"9690",2020-02-02,"Snodgrass","1","1","1",7.4,0,31,0,33,23.9,0,0,0,-1,0,0,0,-1,"w1920","Mechanized",0,"Sun","weekend"
"9691",2020-02-02,"Snodgrass","1","1","1",7.4,0,31,0,33,23.9,0,0,0,-1,0,0,0,-1,"w1920","Motorized",NA,"Sun","weekend"
"9692",2020-02-02,"Snodgrass","1","1","1",7.4,0,31,0,33,23.9,0,0,0,-1,0,0,0,-1,"w1920","Hybrid",NA,"Sun","weekend"
"9693",2020-02-03,"Snodgrass","2","2","1",7.4,0,31,0,24,23.9,0,0,0,0,0,0,0,0,"w1920","Non.motorized",25,"Mon","weekday"
"9694",2020-02-03,"Snodgrass","2","2","1",7.4,0,31,0,24,23.9,0,0,0,0,0,0,0,0,"w1920","Mechanized",0,"Mon","weekday"
"9695",2020-02-03,"Snodgrass","2","2","1",7.4,0,31,0,24,23.9,0,0,0,0,0,0,0,0,"w1920","Motorized",NA,"Mon","weekday"
"9696",2020-02-03,"Snodgrass","2","2","1",7.4,0,31,0,24,23.9,0,0,0,0,0,0,0,0,"w1920","Hybrid",NA,"Mon","weekday"
"9697",2020-02-04,"Snodgrass","2","2","2",7.4,0,33,2,5,22.4,0,0,0,0,2,2,2,2,"w1920","Non.motorized",9,"Tue","weekday"
"9698",2020-02-04,"Snodgrass","2","2","2",7.4,0,33,2,5,22.4,0,0,0,0,2,2,2,2,"w1920","Mechanized",0,"Tue","weekday"
"9699",2020-02-04,"Snodgrass","2","2","2",7.4,0,33,2,5,22.4,0,0,0,0,2,2,2,2,"w1920","Motorized",NA,"Tue","weekday"
"9700",2020-02-04,"Snodgrass","2","2","2",7.4,0,33,2,5,22.4,0,0,0,0,2,2,2,2,"w1920","Hybrid",NA,"Tue","weekday"
"9701",2020-02-05,"Snodgrass","2","2","1",7.4,0,33,0,2,22.4,2,0,0,0,2,2,2,2,"w1920","Non.motorized",NA,"Wed","weekday"
"9702",2020-02-05,"Snodgrass","2","2","1",7.4,0,33,0,2,22.4,2,0,0,0,2,2,2,2,"w1920","Mechanized",NA,"Wed","weekday"
"9703",2020-02-05,"Snodgrass","2","2","1",7.4,0,33,0,2,22.4,2,0,0,0,2,2,2,2,"w1920","Motorized",NA,"Wed","weekday"
"9704",2020-02-05,"Snodgrass","2","2","1",7.4,0,33,0,2,22.4,2,0,0,0,2,2,2,2,"w1920","Hybrid",NA,"Wed","weekday"
"9705",2020-02-06,"Snodgrass","2","2","1",7.5,0.1,32,-1,16,23.4,0,2,0,0,-1,1,1,1,"w1920","Non.motorized",NA,"Thu","weekday"
"9706",2020-02-06,"Snodgrass","2","2","1",7.5,0.1,32,-1,16,23.4,0,2,0,0,-1,1,1,1,"w1920","Mechanized",NA,"Thu","weekday"
"9707",2020-02-06,"Snodgrass","2","2","1",7.5,0.1,32,-1,16,23.4,0,2,0,0,-1,1,1,1,"w1920","Motorized",NA,"Thu","weekday"
"9708",2020-02-06,"Snodgrass","2","2","1",7.5,0.1,32,-1,16,23.4,0,2,0,0,-1,1,1,1,"w1920","Hybrid",NA,"Thu","weekday"
"9709",2020-02-07,"Snodgrass","3","3","3",7.9,0.4,37,5,26,21.4,-1,0,2,0,4,4,6,6,"w1920","Non.motorized",NA,"Fri","weekday"
"9710",2020-02-07,"Snodgrass","3","3","3",7.9,0.4,37,5,26,21.4,-1,0,2,0,4,4,6,6,"w1920","Mechanized",NA,"Fri","weekday"
"9711",2020-02-07,"Snodgrass","3","3","3",7.9,0.4,37,5,26,21.4,-1,0,2,0,4,4,6,6,"w1920","Motorized",NA,"Fri","weekday"
"9712",2020-02-07,"Snodgrass","3","3","3",7.9,0.4,37,5,26,21.4,-1,0,2,0,4,4,6,6,"w1920","Hybrid",NA,"Fri","weekday"
"9713",2020-02-08,"Snodgrass","3","3","2",8.3,0.4,39,2,30,21.3,5,-1,0,2,7,6,6,8,"w1920","Non.motorized",NA,"Sat","weekend"
"9714",2020-02-08,"Snodgrass","3","3","2",8.3,0.4,39,2,30,21.3,5,-1,0,2,7,6,6,8,"w1920","Mechanized",NA,"Sat","weekend"
"9715",2020-02-08,"Snodgrass","3","3","2",8.3,0.4,39,2,30,21.3,5,-1,0,2,7,6,6,8,"w1920","Motorized",NA,"Sat","weekend"
"9716",2020-02-08,"Snodgrass","3","3","2",8.3,0.4,39,2,30,21.3,5,-1,0,2,7,6,6,8,"w1920","Hybrid",NA,"Sat","weekend"
"9717",2020-02-09,"Snodgrass","3","2","2",8.4,0.1,38,-1,26,22.1,2,5,-1,0,1,6,5,5,"w1920","Non.motorized",NA,"Sun","weekend"
"9718",2020-02-09,"Snodgrass","3","2","2",8.4,0.1,38,-1,26,22.1,2,5,-1,0,1,6,5,5,"w1920","Mechanized",NA,"Sun","weekend"
"9719",2020-02-09,"Snodgrass","3","2","2",8.4,0.1,38,-1,26,22.1,2,5,-1,0,1,6,5,5,"w1920","Motorized",NA,"Sun","weekend"
"9720",2020-02-09,"Snodgrass","3","2","2",8.4,0.1,38,-1,26,22.1,2,5,-1,0,1,6,5,5,"w1920","Hybrid",NA,"Sun","weekend"
"9721",2020-02-10,"Snodgrass","2","2","1",8.4,0,38,0,22,22.1,-1,2,5,-1,-1,1,6,5,"w1920","Non.motorized",NA,"Mon","weekday"
"9722",2020-02-10,"Snodgrass","2","2","1",8.4,0,38,0,22,22.1,-1,2,5,-1,-1,1,6,5,"w1920","Mechanized",NA,"Mon","weekday"
"9723",2020-02-10,"Snodgrass","2","2","1",8.4,0,38,0,22,22.1,-1,2,5,-1,-1,1,6,5,"w1920","Motorized",NA,"Mon","weekday"
"9724",2020-02-10,"Snodgrass","2","2","1",8.4,0,38,0,22,22.1,-1,2,5,-1,-1,1,6,5,"w1920","Hybrid",NA,"Mon","weekday"
"9725",2020-02-11,"Snodgrass","2","2","2",8.5,0.1,40,2,16,21.2,0,-1,2,5,2,1,3,8,"w1920","Non.motorized",16,"Tue","weekday"
"9726",2020-02-11,"Snodgrass","2","2","2",8.5,0.1,40,2,16,21.2,0,-1,2,5,2,1,3,8,"w1920","Mechanized",0,"Tue","weekday"
"9727",2020-02-11,"Snodgrass","2","2","2",8.5,0.1,40,2,16,21.2,0,-1,2,5,2,1,3,8,"w1920","Motorized",NA,"Tue","weekday"
"9728",2020-02-11,"Snodgrass","2","2","2",8.5,0.1,40,2,16,21.2,0,-1,2,5,2,1,3,8,"w1920","Hybrid",NA,"Tue","weekday"
"9729",2020-02-12,"Snodgrass","2","2","2",8.5,0,39,-1,15,21.8,2,0,-1,2,1,1,0,2,"w1920","Non.motorized",42,"Wed","weekday"
"9730",2020-02-12,"Snodgrass","2","2","2",8.5,0,39,-1,15,21.8,2,0,-1,2,1,1,0,2,"w1920","Mechanized",1,"Wed","weekday"
"9731",2020-02-12,"Snodgrass","2","2","2",8.5,0,39,-1,15,21.8,2,0,-1,2,1,1,0,2,"w1920","Motorized",NA,"Wed","weekday"
"9732",2020-02-12,"Snodgrass","2","2","2",8.5,0,39,-1,15,21.8,2,0,-1,2,1,1,0,2,"w1920","Hybrid",NA,"Wed","weekday"
"9733",2020-02-13,"Snodgrass","2","2","1",8.5,0,39,0,18,21.8,-1,2,0,-1,-1,1,1,0,"w1920","Non.motorized",26,"Thu","weekday"
"9734",2020-02-13,"Snodgrass","2","2","1",8.5,0,39,0,18,21.8,-1,2,0,-1,-1,1,1,0,"w1920","Mechanized",0,"Thu","weekday"
"9735",2020-02-13,"Snodgrass","2","2","1",8.5,0,39,0,18,21.8,-1,2,0,-1,-1,1,1,0,"w1920","Motorized",NA,"Thu","weekday"
"9736",2020-02-13,"Snodgrass","2","2","1",8.5,0,39,0,18,21.8,-1,2,0,-1,-1,1,1,0,"w1920","Hybrid",NA,"Thu","weekday"
"9737",2020-02-14,"Snodgrass","2","1","1",8.6,0.1,38,-1,24,22.6,0,-1,2,0,-1,-2,0,0,"w1920","Non.motorized",54,"Fri","weekday"
"9738",2020-02-14,"Snodgrass","2","1","1",8.6,0.1,38,-1,24,22.6,0,-1,2,0,-1,-2,0,0,"w1920","Mechanized",1,"Fri","weekday"
"9739",2020-02-14,"Snodgrass","2","1","1",8.6,0.1,38,-1,24,22.6,0,-1,2,0,-1,-2,0,0,"w1920","Motorized",NA,"Fri","weekday"
"9740",2020-02-14,"Snodgrass","2","1","1",8.6,0.1,38,-1,24,22.6,0,-1,2,0,-1,-2,0,0,"w1920","Hybrid",NA,"Fri","weekday"
"9741",2020-02-15,"Snodgrass","1","1","1",8.6,0,38,0,26,22.6,-1,0,-1,2,-1,-1,-2,0,"w1920","Non.motorized",79,"Sat","weekend"
"9742",2020-02-15,"Snodgrass","1","1","1",8.6,0,38,0,26,22.6,-1,0,-1,2,-1,-1,-2,0,"w1920","Mechanized",7,"Sat","weekend"
"9743",2020-02-15,"Snodgrass","1","1","1",8.6,0,38,0,26,22.6,-1,0,-1,2,-1,-1,-2,0,"w1920","Motorized",NA,"Sat","weekend"
"9744",2020-02-15,"Snodgrass","1","1","1",8.6,0,38,0,26,22.6,-1,0,-1,2,-1,-1,-2,0,"w1920","Hybrid",NA,"Sat","weekend"
"9745",2020-02-16,"Snodgrass","1","1","1",8.8,0.2,37,-1,26,23.8,0,-1,0,-1,-1,-2,-2,-3,"w1920","Non.motorized",46,"Sun","weekend"
"9746",2020-02-16,"Snodgrass","1","1","1",8.8,0.2,37,-1,26,23.8,0,-1,0,-1,-1,-2,-2,-3,"w1920","Mechanized",0,"Sun","weekend"
"9747",2020-02-16,"Snodgrass","1","1","1",8.8,0.2,37,-1,26,23.8,0,-1,0,-1,-1,-2,-2,-3,"w1920","Motorized",NA,"Sun","weekend"
"9748",2020-02-16,"Snodgrass","1","1","1",8.8,0.2,37,-1,26,23.8,0,-1,0,-1,-1,-2,-2,-3,"w1920","Hybrid",NA,"Sun","weekend"
"9749",2020-02-17,"Snodgrass","2","1","1",9.2,0.4,43,6,25,21.4,-1,0,-1,0,5,5,4,4,"w1920","Non.motorized",56,"Mon","weekday"
"9750",2020-02-17,"Snodgrass","2","1","1",9.2,0.4,43,6,25,21.4,-1,0,-1,0,5,5,4,4,"w1920","Mechanized",1,"Mon","weekday"
"9751",2020-02-17,"Snodgrass","2","1","1",9.2,0.4,43,6,25,21.4,-1,0,-1,0,5,5,4,4,"w1920","Motorized",NA,"Mon","weekday"
"9752",2020-02-17,"Snodgrass","2","1","1",9.2,0.4,43,6,25,21.4,-1,0,-1,0,5,5,4,4,"w1920","Hybrid",NA,"Mon","weekday"
"9753",2020-02-18,"Snodgrass","1","1","1",9.3,0.1,42,-1,18,22.1,6,-1,0,-1,5,4,4,3,"w1920","Non.motorized",29,"Tue","weekday"
"9754",2020-02-18,"Snodgrass","1","1","1",9.3,0.1,42,-1,18,22.1,6,-1,0,-1,5,4,4,3,"w1920","Mechanized",0,"Tue","weekday"
"9755",2020-02-18,"Snodgrass","1","1","1",9.3,0.1,42,-1,18,22.1,6,-1,0,-1,5,4,4,3,"w1920","Motorized",NA,"Tue","weekday"
"9756",2020-02-18,"Snodgrass","1","1","1",9.3,0.1,42,-1,18,22.1,6,-1,0,-1,5,4,4,3,"w1920","Hybrid",NA,"Tue","weekday"
"9757",2020-02-19,"Snodgrass","1","1","1",9.3,0,41,-1,22,22.7,-1,6,-1,0,-2,4,3,3,"w1920","Non.motorized",49,"Wed","weekday"
"9758",2020-02-19,"Snodgrass","1","1","1",9.3,0,41,-1,22,22.7,-1,6,-1,0,-2,4,3,3,"w1920","Mechanized",0,"Wed","weekday"
"9759",2020-02-19,"Snodgrass","1","1","1",9.3,0,41,-1,22,22.7,-1,6,-1,0,-2,4,3,3,"w1920","Motorized",NA,"Wed","weekday"
"9760",2020-02-19,"Snodgrass","1","1","1",9.3,0,41,-1,22,22.7,-1,6,-1,0,-2,4,3,3,"w1920","Hybrid",NA,"Wed","weekday"
"9761",2020-02-20,"Snodgrass","1","1","1",9.3,0,41,0,18,22.7,-1,-1,6,-1,-1,-2,4,3,"w1920","Non.motorized",52,"Thu","weekday"
"9762",2020-02-20,"Snodgrass","1","1","1",9.3,0,41,0,18,22.7,-1,-1,6,-1,-1,-2,4,3,"w1920","Mechanized",1,"Thu","weekday"
"9763",2020-02-20,"Snodgrass","1","1","1",9.3,0,41,0,18,22.7,-1,-1,6,-1,-1,-2,4,3,"w1920","Motorized",NA,"Thu","weekday"
"9764",2020-02-20,"Snodgrass","1","1","1",9.3,0,41,0,18,22.7,-1,-1,6,-1,-1,-2,4,3,"w1920","Hybrid",NA,"Thu","weekday"
"9765",2020-02-21,"Snodgrass","1","1","1",9.3,0,40,-1,26,23.2,0,-1,-1,6,-1,-2,-3,3,"w1920","Non.motorized",67,"Fri","weekday"
"9766",2020-02-21,"Snodgrass","1","1","1",9.3,0,40,-1,26,23.2,0,-1,-1,6,-1,-2,-3,3,"w1920","Mechanized",0,"Fri","weekday"
"9767",2020-02-21,"Snodgrass","1","1","1",9.3,0,40,-1,26,23.2,0,-1,-1,6,-1,-2,-3,3,"w1920","Motorized",NA,"Fri","weekday"
"9768",2020-02-21,"Snodgrass","1","1","1",9.3,0,40,-1,26,23.2,0,-1,-1,6,-1,-2,-3,3,"w1920","Hybrid",NA,"Fri","weekday"
"9769",2020-02-22,"Snodgrass","1","1","1",9.4,0.1,39,-1,32,24.1,-1,0,-1,-1,-2,-2,-3,-4,"w1920","Non.motorized",117,"Sat","weekend"
"9770",2020-02-22,"Snodgrass","1","1","1",9.4,0.1,39,-1,32,24.1,-1,0,-1,-1,-2,-2,-3,-4,"w1920","Mechanized",2,"Sat","weekend"
"9771",2020-02-22,"Snodgrass","1","1","1",9.4,0.1,39,-1,32,24.1,-1,0,-1,-1,-2,-2,-3,-4,"w1920","Motorized",NA,"Sat","weekend"
"9772",2020-02-22,"Snodgrass","1","1","1",9.4,0.1,39,-1,32,24.1,-1,0,-1,-1,-2,-2,-3,-4,"w1920","Hybrid",NA,"Sat","weekend"
"9773",2020-02-23,"Snodgrass","2","2","2",9.5,0.1,40,1,27,23.8,-1,-1,0,-1,0,-1,-1,-2,"w1920","Non.motorized",159,"Sun","weekend"
"9774",2020-02-23,"Snodgrass","2","2","2",9.5,0.1,40,1,27,23.8,-1,-1,0,-1,0,-1,-1,-2,"w1920","Mechanized",2,"Sun","weekend"
"9775",2020-02-23,"Snodgrass","2","2","2",9.5,0.1,40,1,27,23.8,-1,-1,0,-1,0,-1,-1,-2,"w1920","Motorized",NA,"Sun","weekend"
"9776",2020-02-23,"Snodgrass","2","2","2",9.5,0.1,40,1,27,23.8,-1,-1,0,-1,0,-1,-1,-2,"w1920","Hybrid",NA,"Sun","weekend"
"9777",2020-02-24,"Snodgrass","3","3","2",9.8,0.3,43,3,17,22.8,1,-1,-1,0,4,3,2,2,"w1920","Non.motorized",12,"Mon","weekday"
"9778",2020-02-24,"Snodgrass","3","3","2",9.8,0.3,43,3,17,22.8,1,-1,-1,0,4,3,2,2,"w1920","Mechanized",0,"Mon","weekday"
"9779",2020-02-24,"Snodgrass","3","3","2",9.8,0.3,43,3,17,22.8,1,-1,-1,0,4,3,2,2,"w1920","Motorized",NA,"Mon","weekday"
"9780",2020-02-24,"Snodgrass","3","3","2",9.8,0.3,43,3,17,22.8,1,-1,-1,0,4,3,2,2,"w1920","Hybrid",NA,"Mon","weekday"
"9781",2020-02-25,"Snodgrass","2","2","1",9.8,0,43,0,8,22.8,3,1,-1,-1,3,4,3,2,"w1920","Non.motorized",80,"Tue","weekday"
"9782",2020-02-25,"Snodgrass","2","2","1",9.8,0,43,0,8,22.8,3,1,-1,-1,3,4,3,2,"w1920","Mechanized",0,"Tue","weekday"
"9783",2020-02-25,"Snodgrass","2","2","1",9.8,0,43,0,8,22.8,3,1,-1,-1,3,4,3,2,"w1920","Motorized",NA,"Tue","weekday"
"9784",2020-02-25,"Snodgrass","2","2","1",9.8,0,43,0,8,22.8,3,1,-1,-1,3,4,3,2,"w1920","Hybrid",NA,"Tue","weekday"
"9785",2020-02-26,"Snodgrass","2","2","1",9.8,0,42,-1,15,23.3,0,3,1,-1,-1,2,3,2,"w1920","Non.motorized",59,"Wed","weekday"
"9786",2020-02-26,"Snodgrass","2","2","1",9.8,0,42,-1,15,23.3,0,3,1,-1,-1,2,3,2,"w1920","Mechanized",0,"Wed","weekday"
"9787",2020-02-26,"Snodgrass","2","2","1",9.8,0,42,-1,15,23.3,0,3,1,-1,-1,2,3,2,"w1920","Motorized",NA,"Wed","weekday"
"9788",2020-02-26,"Snodgrass","2","2","1",9.8,0,42,-1,15,23.3,0,3,1,-1,-1,2,3,2,"w1920","Hybrid",NA,"Wed","weekday"
"9789",2020-02-27,"Snodgrass","2","2","1",9.9,0.1,41,-1,25,24.1,-1,0,3,1,-2,-2,1,2,"w1920","Non.motorized",70,"Thu","weekday"
"9790",2020-02-27,"Snodgrass","2","2","1",9.9,0.1,41,-1,25,24.1,-1,0,3,1,-2,-2,1,2,"w1920","Mechanized",2,"Thu","weekday"
"9791",2020-02-27,"Snodgrass","2","2","1",9.9,0.1,41,-1,25,24.1,-1,0,3,1,-2,-2,1,2,"w1920","Motorized",NA,"Thu","weekday"
"9792",2020-02-27,"Snodgrass","2","2","1",9.9,0.1,41,-1,25,24.1,-1,0,3,1,-2,-2,1,2,"w1920","Hybrid",NA,"Thu","weekday"
"9793",2020-02-28,"Snodgrass","2","1","1",9.9,0,41,0,28,24.1,-1,-1,0,3,-1,-2,-2,1,"w1920","Non.motorized",92,"Fri","weekday"
"9794",2020-02-28,"Snodgrass","2","1","1",9.9,0,41,0,28,24.1,-1,-1,0,3,-1,-2,-2,1,"w1920","Mechanized",2,"Fri","weekday"
"9795",2020-02-28,"Snodgrass","2","1","1",9.9,0,41,0,28,24.1,-1,-1,0,3,-1,-2,-2,1,"w1920","Motorized",NA,"Fri","weekday"
"9796",2020-02-28,"Snodgrass","2","1","1",9.9,0,41,0,28,24.1,-1,-1,0,3,-1,-2,-2,1,"w1920","Hybrid",NA,"Fri","weekday"
"9797",2020-02-29,"Snodgrass","1","1","1",9.9,0,40,-1,29,24.8,0,-1,-1,0,-1,-2,-3,-3,"w1920","Non.motorized",150,"Sat","weekend"
"9798",2020-02-29,"Snodgrass","1","1","1",9.9,0,40,-1,29,24.8,0,-1,-1,0,-1,-2,-3,-3,"w1920","Mechanized",3,"Sat","weekend"
"9799",2020-02-29,"Snodgrass","1","1","1",9.9,0,40,-1,29,24.8,0,-1,-1,0,-1,-2,-3,-3,"w1920","Motorized",NA,"Sat","weekend"
"9800",2020-02-29,"Snodgrass","1","1","1",9.9,0,40,-1,29,24.8,0,-1,-1,0,-1,-2,-3,-3,"w1920","Hybrid",NA,"Sat","weekend"
"9801",2020-03-01,"Snodgrass","1","1","1",10,0.1,40,0,28,25,-1,0,-1,-1,-1,-1,-2,-3,"w1920","Non.motorized",71,"Sun","weekend"
"9802",2020-03-01,"Snodgrass","1","1","1",10,0.1,40,0,28,25,-1,0,-1,-1,-1,-1,-2,-3,"w1920","Mechanized",0,"Sun","weekend"
"9803",2020-03-01,"Snodgrass","1","1","1",10,0.1,40,0,28,25,-1,0,-1,-1,-1,-1,-2,-3,"w1920","Motorized",NA,"Sun","weekend"
"9804",2020-03-01,"Snodgrass","1","1","1",10,0.1,40,0,28,25,-1,0,-1,-1,-1,-1,-2,-3,"w1920","Hybrid",NA,"Sun","weekend"
"9805",2020-03-02,"Snodgrass","2","2","1",10.4,0.4,45,5,25,23.1,0,-1,0,-1,5,4,4,3,"w1920","Non.motorized",42,"Mon","weekday"
"9806",2020-03-02,"Snodgrass","2","2","1",10.4,0.4,45,5,25,23.1,0,-1,0,-1,5,4,4,3,"w1920","Mechanized",0,"Mon","weekday"
"9807",2020-03-02,"Snodgrass","2","2","1",10.4,0.4,45,5,25,23.1,0,-1,0,-1,5,4,4,3,"w1920","Motorized",NA,"Mon","weekday"
"9808",2020-03-02,"Snodgrass","2","2","1",10.4,0.4,45,5,25,23.1,0,-1,0,-1,5,4,4,3,"w1920","Hybrid",NA,"Mon","weekday"
"9809",2020-03-03,"Snodgrass","2","1","1",10.9,0.5,50,5,25,21.8,5,0,-1,0,10,10,9,9,"w1920","Non.motorized",NA,"Tue","weekday"
"9810",2020-03-03,"Snodgrass","2","1","1",10.9,0.5,50,5,25,21.8,5,0,-1,0,10,10,9,9,"w1920","Mechanized",NA,"Tue","weekday"
"9811",2020-03-03,"Snodgrass","2","1","1",10.9,0.5,50,5,25,21.8,5,0,-1,0,10,10,9,9,"w1920","Motorized",NA,"Tue","weekday"
"9812",2020-03-03,"Snodgrass","2","1","1",10.9,0.5,50,5,25,21.8,5,0,-1,0,10,10,9,9,"w1920","Hybrid",NA,"Tue","weekday"
"9813",2020-03-04,"Snodgrass","2","1","1",10.9,0,48,-2,29,22.7,5,5,0,-1,3,8,8,7,"w1920","Non.motorized",NA,"Wed","weekday"
"9814",2020-03-04,"Snodgrass","2","1","1",10.9,0,48,-2,29,22.7,5,5,0,-1,3,8,8,7,"w1920","Mechanized",NA,"Wed","weekday"
"9815",2020-03-04,"Snodgrass","2","1","1",10.9,0,48,-2,29,22.7,5,5,0,-1,3,8,8,7,"w1920","Motorized",NA,"Wed","weekday"
"9816",2020-03-04,"Snodgrass","2","1","1",10.9,0,48,-2,29,22.7,5,5,0,-1,3,8,8,7,"w1920","Hybrid",NA,"Wed","weekday"
"9817",2020-03-05,"Snodgrass","2","1","1",10.9,0,46,-2,32,23.7,-2,5,5,0,-4,1,6,6,"w1920","Non.motorized",63,"Thu","weekday"
"9818",2020-03-05,"Snodgrass","2","1","1",10.9,0,46,-2,32,23.7,-2,5,5,0,-4,1,6,6,"w1920","Mechanized",1,"Thu","weekday"
"9819",2020-03-05,"Snodgrass","2","1","1",10.9,0,46,-2,32,23.7,-2,5,5,0,-4,1,6,6,"w1920","Motorized",NA,"Thu","weekday"
"9820",2020-03-05,"Snodgrass","2","1","1",10.9,0,46,-2,32,23.7,-2,5,5,0,-4,1,6,6,"w1920","Hybrid",NA,"Thu","weekday"
"9821",2020-03-06,"Snodgrass","1","1","1",10.9,0,45,-1,34,24.2,-2,-2,5,5,-3,-5,0,5,"w1920","Non.motorized",68,"Fri","weekday"
"9822",2020-03-06,"Snodgrass","1","1","1",10.9,0,45,-1,34,24.2,-2,-2,5,5,-3,-5,0,5,"w1920","Mechanized",0,"Fri","weekday"
"9823",2020-03-06,"Snodgrass","1","1","1",10.9,0,45,-1,34,24.2,-2,-2,5,5,-3,-5,0,5,"w1920","Motorized",NA,"Fri","weekday"
"9824",2020-03-06,"Snodgrass","1","1","1",10.9,0,45,-1,34,24.2,-2,-2,5,5,-3,-5,0,5,"w1920","Hybrid",NA,"Fri","weekday"
"9825",2020-03-07,"Snodgrass","1","1","2",10.9,0,44,-1,35,24.8,-1,-2,-2,5,-2,-4,-6,-1,"w1920","Non.motorized",121,"Sat","weekend"
"9826",2020-03-07,"Snodgrass","1","1","2",10.9,0,44,-1,35,24.8,-1,-2,-2,5,-2,-4,-6,-1,"w1920","Mechanized",0,"Sat","weekend"
"9827",2020-03-07,"Snodgrass","1","1","2",10.9,0,44,-1,35,24.8,-1,-2,-2,5,-2,-4,-6,-1,"w1920","Motorized",NA,"Sat","weekend"
"9828",2020-03-07,"Snodgrass","1","1","2",10.9,0,44,-1,35,24.8,-1,-2,-2,5,-2,-4,-6,-1,"w1920","Hybrid",NA,"Sat","weekend"
"9829",2020-03-08,"Snodgrass","1","1","1",11,0.1,43,-1,33,25.6,-1,-1,-2,-2,-2,-3,-5,-7,"w1920","Non.motorized",86,"Sun","weekend"
"9830",2020-03-08,"Snodgrass","1","1","1",11,0.1,43,-1,33,25.6,-1,-1,-2,-2,-2,-3,-5,-7,"w1920","Mechanized",1,"Sun","weekend"
"9831",2020-03-08,"Snodgrass","1","1","1",11,0.1,43,-1,33,25.6,-1,-1,-2,-2,-2,-3,-5,-7,"w1920","Motorized",NA,"Sun","weekend"
"9832",2020-03-08,"Snodgrass","1","1","1",11,0.1,43,-1,33,25.6,-1,-1,-2,-2,-2,-3,-5,-7,"w1920","Hybrid",NA,"Sun","weekend"
"9833",2020-03-09,"Snodgrass","1","1","1",11.1,0.1,42,-1,31,26.4,-1,-1,-1,-2,-2,-3,-4,-6,"w1920","Non.motorized",42,"Mon","weekday"
"9834",2020-03-09,"Snodgrass","1","1","1",11.1,0.1,42,-1,31,26.4,-1,-1,-1,-2,-2,-3,-4,-6,"w1920","Mechanized",0,"Mon","weekday"
"9835",2020-03-09,"Snodgrass","1","1","1",11.1,0.1,42,-1,31,26.4,-1,-1,-1,-2,-2,-3,-4,-6,"w1920","Motorized",NA,"Mon","weekday"
"9836",2020-03-09,"Snodgrass","1","1","1",11.1,0.1,42,-1,31,26.4,-1,-1,-1,-2,-2,-3,-4,-6,"w1920","Hybrid",NA,"Mon","weekday"
"9837",2020-03-10,"Snodgrass","1","1","2",11.2,0.1,44,2,31,25.5,-1,-1,-1,-1,1,0,-1,-2,"w1920","Non.motorized",27,"Tue","weekday"
"9838",2020-03-10,"Snodgrass","1","1","2",11.2,0.1,44,2,31,25.5,-1,-1,-1,-1,1,0,-1,-2,"w1920","Mechanized",0,"Tue","weekday"
"9839",2020-03-10,"Snodgrass","1","1","2",11.2,0.1,44,2,31,25.5,-1,-1,-1,-1,1,0,-1,-2,"w1920","Motorized",NA,"Tue","weekday"
"9840",2020-03-10,"Snodgrass","1","1","2",11.2,0.1,44,2,31,25.5,-1,-1,-1,-1,1,0,-1,-2,"w1920","Hybrid",NA,"Tue","weekday"
"9841",2020-03-11,"Snodgrass","2","2","1",11.2,0,44,0,32,25.5,2,-1,-1,-1,2,1,0,-1,"w1920","Non.motorized",61,"Wed","weekday"
"9842",2020-03-11,"Snodgrass","2","2","1",11.2,0,44,0,32,25.5,2,-1,-1,-1,2,1,0,-1,"w1920","Mechanized",0,"Wed","weekday"
"9843",2020-03-11,"Snodgrass","2","2","1",11.2,0,44,0,32,25.5,2,-1,-1,-1,2,1,0,-1,"w1920","Motorized",NA,"Wed","weekday"
"9844",2020-03-11,"Snodgrass","2","2","1",11.2,0,44,0,32,25.5,2,-1,-1,-1,2,1,0,-1,"w1920","Hybrid",NA,"Wed","weekday"
"9845",2020-03-12,"Snodgrass","2","2","2",11.4,0.2,42,-2,35,27.1,0,2,-1,-1,-2,0,-1,-2,"w1920","Non.motorized",48,"Thu","weekday"
"9846",2020-03-12,"Snodgrass","2","2","2",11.4,0.2,42,-2,35,27.1,0,2,-1,-1,-2,0,-1,-2,"w1920","Mechanized",0,"Thu","weekday"
"9847",2020-03-12,"Snodgrass","2","2","2",11.4,0.2,42,-2,35,27.1,0,2,-1,-1,-2,0,-1,-2,"w1920","Motorized",NA,"Thu","weekday"
"9848",2020-03-12,"Snodgrass","2","2","2",11.4,0.2,42,-2,35,27.1,0,2,-1,-1,-2,0,-1,-2,"w1920","Hybrid",NA,"Thu","weekday"
"9849",2020-03-13,"Snodgrass","3","3","2",11.5,0.1,44,2,31,26.1,-2,0,2,-1,0,0,2,1,"w1920","Non.motorized",11,"Fri","weekday"
"9850",2020-03-13,"Snodgrass","3","3","2",11.5,0.1,44,2,31,26.1,-2,0,2,-1,0,0,2,1,"w1920","Mechanized",0,"Fri","weekday"
"9851",2020-03-13,"Snodgrass","3","3","2",11.5,0.1,44,2,31,26.1,-2,0,2,-1,0,0,2,1,"w1920","Motorized",NA,"Fri","weekday"
"9852",2020-03-13,"Snodgrass","3","3","2",11.5,0.1,44,2,31,26.1,-2,0,2,-1,0,0,2,1,"w1920","Hybrid",NA,"Fri","weekday"
"9853",2020-03-14,"Snodgrass","3","3","3",11.7,0.2,44,0,31,26.6,2,-2,0,2,2,0,0,2,"w1920","Non.motorized",75,"Sat","weekend"
"9854",2020-03-14,"Snodgrass","3","3","3",11.7,0.2,44,0,31,26.6,2,-2,0,2,2,0,0,2,"w1920","Mechanized",0,"Sat","weekend"
"9855",2020-03-14,"Snodgrass","3","3","3",11.7,0.2,44,0,31,26.6,2,-2,0,2,2,0,0,2,"w1920","Motorized",NA,"Sat","weekend"
"9856",2020-03-14,"Snodgrass","3","3","3",11.7,0.2,44,0,31,26.6,2,-2,0,2,2,0,0,2,"w1920","Hybrid",NA,"Sat","weekend"
"9857",2020-03-15,"Snodgrass","2","2","2",11.7,0,45,1,33,26,0,2,-2,0,1,3,1,1,"w1920","Non.motorized",166,"Sun","weekend"
"9858",2020-03-15,"Snodgrass","2","2","2",11.7,0,45,1,33,26,0,2,-2,0,1,3,1,1,"w1920","Mechanized",1,"Sun","weekend"
"9859",2020-03-15,"Snodgrass","2","2","2",11.7,0,45,1,33,26,0,2,-2,0,1,3,1,1,"w1920","Motorized",NA,"Sun","weekend"
"9860",2020-03-15,"Snodgrass","2","2","2",11.7,0,45,1,33,26,0,2,-2,0,1,3,1,1,"w1920","Hybrid",NA,"Sun","weekend"
"9861",2020-03-16,"Snodgrass","2","2","2",11.7,0,45,0,35,26,1,0,2,-2,1,1,3,1,"w1920","Non.motorized",104,"Mon","weekday"
"9862",2020-03-16,"Snodgrass","2","2","2",11.7,0,45,0,35,26,1,0,2,-2,1,1,3,1,"w1920","Mechanized",2,"Mon","weekday"
"9863",2020-03-16,"Snodgrass","2","2","2",11.7,0,45,0,35,26,1,0,2,-2,1,1,3,1,"w1920","Motorized",NA,"Mon","weekday"
"9864",2020-03-16,"Snodgrass","2","2","2",11.7,0,45,0,35,26,1,0,2,-2,1,1,3,1,"w1920","Hybrid",NA,"Mon","weekday"
"9865",2020-03-17,"Snodgrass","2","2","2",11.7,0,44,-1,36,26.6,0,1,0,2,-1,0,0,2,"w1920","Non.motorized",NA,"Tue","weekday"
"9866",2020-03-17,"Snodgrass","2","2","2",11.7,0,44,-1,36,26.6,0,1,0,2,-1,0,0,2,"w1920","Mechanized",NA,"Tue","weekday"
"9867",2020-03-17,"Snodgrass","2","2","2",11.7,0,44,-1,36,26.6,0,1,0,2,-1,0,0,2,"w1920","Motorized",NA,"Tue","weekday"
"9868",2020-03-17,"Snodgrass","2","2","2",11.7,0,44,-1,36,26.6,0,1,0,2,-1,0,0,2,"w1920","Hybrid",NA,"Tue","weekday"
"9869",2020-03-18,"Snodgrass","2","2","2",11.7,0,43,-1,33,27.2,-1,0,1,0,-2,-2,-1,-1,"w1920","Non.motorized",NA,"Wed","weekday"
"9870",2020-03-18,"Snodgrass","2","2","2",11.7,0,43,-1,33,27.2,-1,0,1,0,-2,-2,-1,-1,"w1920","Mechanized",NA,"Wed","weekday"
"9871",2020-03-18,"Snodgrass","2","2","2",11.7,0,43,-1,33,27.2,-1,0,1,0,-2,-2,-1,-1,"w1920","Motorized",NA,"Wed","weekday"
"9872",2020-03-18,"Snodgrass","2","2","2",11.7,0,43,-1,33,27.2,-1,0,1,0,-2,-2,-1,-1,"w1920","Hybrid",NA,"Wed","weekday"
"9873",2020-03-19,"Snodgrass","3","3","3",11.8,0.1,43,0,27,27.4,-1,-1,0,1,-1,-2,-2,-1,"w1920","Non.motorized",NA,"Thu","weekday"
"9874",2020-03-19,"Snodgrass","3","3","3",11.8,0.1,43,0,27,27.4,-1,-1,0,1,-1,-2,-2,-1,"w1920","Mechanized",NA,"Thu","weekday"
"9875",2020-03-19,"Snodgrass","3","3","3",11.8,0.1,43,0,27,27.4,-1,-1,0,1,-1,-2,-2,-1,"w1920","Motorized",NA,"Thu","weekday"
"9876",2020-03-19,"Snodgrass","3","3","3",11.8,0.1,43,0,27,27.4,-1,-1,0,1,-1,-2,-2,-1,"w1920","Hybrid",NA,"Thu","weekday"
"9877",2020-03-20,"Snodgrass","3","3","2",12.7,0.9,52,9,26,24.4,0,-1,-1,0,9,8,7,7,"w1920","Non.motorized",NA,"Fri","weekday"
"9878",2020-03-20,"Snodgrass","3","3","2",12.7,0.9,52,9,26,24.4,0,-1,-1,0,9,8,7,7,"w1920","Mechanized",NA,"Fri","weekday"
"9879",2020-03-20,"Snodgrass","3","3","2",12.7,0.9,52,9,26,24.4,0,-1,-1,0,9,8,7,7,"w1920","Motorized",NA,"Fri","weekday"
"9880",2020-03-20,"Snodgrass","3","3","2",12.7,0.9,52,9,26,24.4,0,-1,-1,0,9,8,7,7,"w1920","Hybrid",NA,"Fri","weekday"
"9881",2020-03-21,"Snodgrass","3","3","2",12.8,0.1,54,2,26,23.7,9,0,-1,-1,11,11,10,9,"w1920","Non.motorized",NA,"Sat","weekend"
"9882",2020-03-21,"Snodgrass","3","3","2",12.8,0.1,54,2,26,23.7,9,0,-1,-1,11,11,10,9,"w1920","Mechanized",NA,"Sat","weekend"
"9883",2020-03-21,"Snodgrass","3","3","2",12.8,0.1,54,2,26,23.7,9,0,-1,-1,11,11,10,9,"w1920","Motorized",NA,"Sat","weekend"
"9884",2020-03-21,"Snodgrass","3","3","2",12.8,0.1,54,2,26,23.7,9,0,-1,-1,11,11,10,9,"w1920","Hybrid",NA,"Sat","weekend"
"9885",2020-03-22,"Snodgrass","2","2","2",13,0.2,53,-1,28,24.5,2,9,0,-1,1,10,10,9,"w1920","Non.motorized",NA,"Sun","weekend"
"9886",2020-03-22,"Snodgrass","2","2","2",13,0.2,53,-1,28,24.5,2,9,0,-1,1,10,10,9,"w1920","Mechanized",NA,"Sun","weekend"
"9887",2020-03-22,"Snodgrass","2","2","2",13,0.2,53,-1,28,24.5,2,9,0,-1,1,10,10,9,"w1920","Motorized",NA,"Sun","weekend"
"9888",2020-03-22,"Snodgrass","2","2","2",13,0.2,53,-1,28,24.5,2,9,0,-1,1,10,10,9,"w1920","Hybrid",NA,"Sun","weekend"
"9889",2020-03-23,"Snodgrass","2","2","2",13,0,53,0,28,24.5,-1,2,9,0,-1,1,10,10,"w1920","Non.motorized",NA,"Mon","weekday"
"9890",2020-03-23,"Snodgrass","2","2","2",13,0,53,0,28,24.5,-1,2,9,0,-1,1,10,10,"w1920","Mechanized",NA,"Mon","weekday"
"9891",2020-03-23,"Snodgrass","2","2","2",13,0,53,0,28,24.5,-1,2,9,0,-1,1,10,10,"w1920","Motorized",NA,"Mon","weekday"
"9892",2020-03-23,"Snodgrass","2","2","2",13,0,53,0,28,24.5,-1,2,9,0,-1,1,10,10,"w1920","Hybrid",NA,"Mon","weekday"
"9893",2020-03-24,"Snodgrass","2","2","2",13.2,0.2,53,0,32,24.9,0,-1,2,9,0,-1,1,10,"w1920","Non.motorized",NA,"Tue","weekday"
"9894",2020-03-24,"Snodgrass","2","2","2",13.2,0.2,53,0,32,24.9,0,-1,2,9,0,-1,1,10,"w1920","Mechanized",NA,"Tue","weekday"
"9895",2020-03-24,"Snodgrass","2","2","2",13.2,0.2,53,0,32,24.9,0,-1,2,9,0,-1,1,10,"w1920","Motorized",NA,"Tue","weekday"
"9896",2020-03-24,"Snodgrass","2","2","2",13.2,0.2,53,0,32,24.9,0,-1,2,9,0,-1,1,10,"w1920","Hybrid",NA,"Tue","weekday"
"9897",2020-03-25,"Snodgrass","2","2","2",13.3,0.1,51,-2,34,26.1,0,0,-1,2,-2,-2,-3,-1,"w1920","Non.motorized",NA,"Wed","weekday"
"9898",2020-03-25,"Snodgrass","2","2","2",13.3,0.1,51,-2,34,26.1,0,0,-1,2,-2,-2,-3,-1,"w1920","Mechanized",NA,"Wed","weekday"
"9899",2020-03-25,"Snodgrass","2","2","2",13.3,0.1,51,-2,34,26.1,0,0,-1,2,-2,-2,-3,-1,"w1920","Motorized",NA,"Wed","weekday"
"9900",2020-03-25,"Snodgrass","2","2","2",13.3,0.1,51,-2,34,26.1,0,0,-1,2,-2,-2,-3,-1,"w1920","Hybrid",NA,"Wed","weekday"
"9901",2020-03-26,"Snodgrass","2","2","2",13.3,0,50,-1,36,26.6,-2,0,0,-1,-3,-3,-3,-4,"w1920","Non.motorized",NA,"Thu","weekday"
"9902",2020-03-26,"Snodgrass","2","2","2",13.3,0,50,-1,36,26.6,-2,0,0,-1,-3,-3,-3,-4,"w1920","Mechanized",NA,"Thu","weekday"
"9903",2020-03-26,"Snodgrass","2","2","2",13.3,0,50,-1,36,26.6,-2,0,0,-1,-3,-3,-3,-4,"w1920","Motorized",NA,"Thu","weekday"
"9904",2020-03-26,"Snodgrass","2","2","2",13.3,0,50,-1,36,26.6,-2,0,0,-1,-3,-3,-3,-4,"w1920","Hybrid",NA,"Thu","weekday"
"9905",2020-03-26,"Snodgrass","3","3","2",13.3,0,50,-1,36,26.6,-2,0,0,-1,-3,-3,-3,-4,"w1920","Non.motorized",NA,"Thu","weekday"
"9906",2020-03-26,"Snodgrass","3","3","2",13.3,0,50,-1,36,26.6,-2,0,0,-1,-3,-3,-3,-4,"w1920","Mechanized",NA,"Thu","weekday"
"9907",2020-03-26,"Snodgrass","3","3","2",13.3,0,50,-1,36,26.6,-2,0,0,-1,-3,-3,-3,-4,"w1920","Motorized",NA,"Thu","weekday"
"9908",2020-03-26,"Snodgrass","3","3","2",13.3,0,50,-1,36,26.6,-2,0,0,-1,-3,-3,-3,-4,"w1920","Hybrid",NA,"Thu","weekday"
"9909",2020-03-27,"Snodgrass","3","3","2",13.3,0,50,0,23,26.6,-1,-2,0,0,-1,-3,-3,-3,"w1920","Non.motorized",NA,"Fri","weekday"
"9910",2020-03-27,"Snodgrass","3","3","2",13.3,0,50,0,23,26.6,-1,-2,0,0,-1,-3,-3,-3,"w1920","Mechanized",NA,"Fri","weekday"
"9911",2020-03-27,"Snodgrass","3","3","2",13.3,0,50,0,23,26.6,-1,-2,0,0,-1,-3,-3,-3,"w1920","Motorized",NA,"Fri","weekday"
"9912",2020-03-27,"Snodgrass","3","3","2",13.3,0,50,0,23,26.6,-1,-2,0,0,-1,-3,-3,-3,"w1920","Hybrid",NA,"Fri","weekday"
"9913",2020-03-28,"Snodgrass","3","3","3",13.3,0,50,0,18,26.6,0,-1,-2,0,0,-1,-3,-3,"w1920","Non.motorized",NA,"Sat","weekend"
"9914",2020-03-28,"Snodgrass","3","3","3",13.3,0,50,0,18,26.6,0,-1,-2,0,0,-1,-3,-3,"w1920","Mechanized",NA,"Sat","weekend"
"9915",2020-03-28,"Snodgrass","3","3","3",13.3,0,50,0,18,26.6,0,-1,-2,0,0,-1,-3,-3,"w1920","Motorized",NA,"Sat","weekend"
"9916",2020-03-28,"Snodgrass","3","3","3",13.3,0,50,0,18,26.6,0,-1,-2,0,0,-1,-3,-3,"w1920","Hybrid",NA,"Sat","weekend"
"9917",2020-03-29,"Snodgrass","2","2","2",13.3,0,49,-1,24,27.1,0,0,-1,-2,-1,-1,-2,-4,"w1920","Non.motorized",NA,"Sun","weekend"
"9918",2020-03-29,"Snodgrass","2","2","2",13.3,0,49,-1,24,27.1,0,0,-1,-2,-1,-1,-2,-4,"w1920","Mechanized",NA,"Sun","weekend"
"9919",2020-03-29,"Snodgrass","2","2","2",13.3,0,49,-1,24,27.1,0,0,-1,-2,-1,-1,-2,-4,"w1920","Motorized",NA,"Sun","weekend"
"9920",2020-03-29,"Snodgrass","2","2","2",13.3,0,49,-1,24,27.1,0,0,-1,-2,-1,-1,-2,-4,"w1920","Hybrid",NA,"Sun","weekend"
"9921",2020-03-30,"Snodgrass","2","2","2",13.4,0.1,49,0,29,27.3,-1,0,0,-1,-1,-1,-1,-2,"w1920","Non.motorized",NA,"Mon","weekday"
"9922",2020-03-30,"Snodgrass","2","2","2",13.4,0.1,49,0,29,27.3,-1,0,0,-1,-1,-1,-1,-2,"w1920","Mechanized",NA,"Mon","weekday"
"9923",2020-03-30,"Snodgrass","2","2","2",13.4,0.1,49,0,29,27.3,-1,0,0,-1,-1,-1,-1,-2,"w1920","Motorized",NA,"Mon","weekday"
"9924",2020-03-30,"Snodgrass","2","2","2",13.4,0.1,49,0,29,27.3,-1,0,0,-1,-1,-1,-1,-2,"w1920","Hybrid",NA,"Mon","weekday"
"9925",2020-03-31,"Snodgrass","2","2","2",13.6,0.2,51,2,35,26.7,0,-1,0,0,2,1,1,1,"w1920","Non.motorized",NA,"Tue","weekday"
"9926",2020-03-31,"Snodgrass","2","2","2",13.6,0.2,51,2,35,26.7,0,-1,0,0,2,1,1,1,"w1920","Mechanized",NA,"Tue","weekday"
"9927",2020-03-31,"Snodgrass","2","2","2",13.6,0.2,51,2,35,26.7,0,-1,0,0,2,1,1,1,"w1920","Motorized",NA,"Tue","weekday"
"9928",2020-03-31,"Snodgrass","2","2","2",13.6,0.2,51,2,35,26.7,0,-1,0,0,2,1,1,1,"w1920","Hybrid",NA,"Tue","weekday"
"9929",2020-04-01,"Snodgrass","2","2","2",13.6,0,47,-4,39,28.9,2,0,-1,0,-2,-2,-3,-3,"w1920","Non.motorized",NA,"Wed","weekday"
"9930",2020-04-01,"Snodgrass","2","2","2",13.6,0,47,-4,39,28.9,2,0,-1,0,-2,-2,-3,-3,"w1920","Mechanized",NA,"Wed","weekday"
"9931",2020-04-01,"Snodgrass","2","2","2",13.6,0,47,-4,39,28.9,2,0,-1,0,-2,-2,-3,-3,"w1920","Motorized",NA,"Wed","weekday"
"9932",2020-04-01,"Snodgrass","2","2","2",13.6,0,47,-4,39,28.9,2,0,-1,0,-2,-2,-3,-3,"w1920","Hybrid",NA,"Wed","weekday"
"9933",2020-04-02,"Snodgrass","2","2","2",13.6,0,46,-1,31,29.6,-4,2,0,-1,-5,-3,-3,-4,"w1920","Non.motorized",NA,"Thu","weekday"
"9934",2020-04-02,"Snodgrass","2","2","2",13.6,0,46,-1,31,29.6,-4,2,0,-1,-5,-3,-3,-4,"w1920","Mechanized",NA,"Thu","weekday"
"9935",2020-04-02,"Snodgrass","2","2","2",13.6,0,46,-1,31,29.6,-4,2,0,-1,-5,-3,-3,-4,"w1920","Motorized",NA,"Thu","weekday"
"9936",2020-04-02,"Snodgrass","2","2","2",13.6,0,46,-1,31,29.6,-4,2,0,-1,-5,-3,-3,-4,"w1920","Hybrid",NA,"Thu","weekday"
"9937",2020-04-03,"Snodgrass","2","2","2",13.6,0,46,0,28,29.6,-1,-4,2,0,-1,-5,-3,-3,"w1920","Non.motorized",NA,"Fri","weekday"
"9938",2020-04-03,"Snodgrass","2","2","2",13.6,0,46,0,28,29.6,-1,-4,2,0,-1,-5,-3,-3,"w1920","Mechanized",NA,"Fri","weekday"
"9939",2020-04-03,"Snodgrass","2","2","2",13.6,0,46,0,28,29.6,-1,-4,2,0,-1,-5,-3,-3,"w1920","Motorized",NA,"Fri","weekday"
"9940",2020-04-03,"Snodgrass","2","2","2",13.6,0,46,0,28,29.6,-1,-4,2,0,-1,-5,-3,-3,"w1920","Hybrid",NA,"Fri","weekday"
"9941",2020-04-04,"Snodgrass","2","2","2",13.6,0,45,-1,33,30.2,0,-1,-4,2,-1,-2,-6,-4,"w1920","Non.motorized",NA,"Sat","weekend"
"9942",2020-04-04,"Snodgrass","2","2","2",13.6,0,45,-1,33,30.2,0,-1,-4,2,-1,-2,-6,-4,"w1920","Mechanized",NA,"Sat","weekend"
"9943",2020-04-04,"Snodgrass","2","2","2",13.6,0,45,-1,33,30.2,0,-1,-4,2,-1,-2,-6,-4,"w1920","Motorized",NA,"Sat","weekend"
"9944",2020-04-04,"Snodgrass","2","2","2",13.6,0,45,-1,33,30.2,0,-1,-4,2,-1,-2,-6,-4,"w1920","Hybrid",NA,"Sat","weekend"
"9945",2020-04-05,"Snodgrass","2","2","3",13.6,0,45,0,38,30.2,-1,0,-1,-4,-1,-1,-2,-6,"w1920","Non.motorized",NA,"Sun","weekend"
"9946",2020-04-05,"Snodgrass","2","2","3",13.6,0,45,0,38,30.2,-1,0,-1,-4,-1,-1,-2,-6,"w1920","Mechanized",NA,"Sun","weekend"
"9947",2020-04-05,"Snodgrass","2","2","3",13.6,0,45,0,38,30.2,-1,0,-1,-4,-1,-1,-2,-6,"w1920","Motorized",NA,"Sun","weekend"
"9948",2020-04-05,"Snodgrass","2","2","3",13.6,0,45,0,38,30.2,-1,0,-1,-4,-1,-1,-2,-6,"w1920","Hybrid",NA,"Sun","weekend"
"9949",2020-04-06,"Snodgrass","2","2","3",13.6,0,44,-1,40,30.9,0,-1,0,-1,-1,-2,-2,-3,"w1920","Non.motorized",NA,"Mon","weekday"
"9950",2020-04-06,"Snodgrass","2","2","3",13.6,0,44,-1,40,30.9,0,-1,0,-1,-1,-2,-2,-3,"w1920","Mechanized",NA,"Mon","weekday"
"9951",2020-04-06,"Snodgrass","2","2","3",13.6,0,44,-1,40,30.9,0,-1,0,-1,-1,-2,-2,-3,"w1920","Motorized",NA,"Mon","weekday"
"9952",2020-04-06,"Snodgrass","2","2","3",13.6,0,44,-1,40,30.9,0,-1,0,-1,-1,-2,-2,-3,"w1920","Hybrid",NA,"Mon","weekday"
"9953",2020-04-07,"Snodgrass","2","2","3",13.4,-0.2,43,-1,39,31.2,-1,0,-1,0,-2,-2,-3,-3,"w1920","Non.motorized",NA,"Tue","weekday"
"9954",2020-04-07,"Snodgrass","2","2","3",13.4,-0.2,43,-1,39,31.2,-1,0,-1,0,-2,-2,-3,-3,"w1920","Mechanized",NA,"Tue","weekday"
"9955",2020-04-07,"Snodgrass","2","2","3",13.4,-0.2,43,-1,39,31.2,-1,0,-1,0,-2,-2,-3,-3,"w1920","Motorized",NA,"Tue","weekday"
"9956",2020-04-07,"Snodgrass","2","2","3",13.4,-0.2,43,-1,39,31.2,-1,0,-1,0,-2,-2,-3,-3,"w1920","Hybrid",NA,"Tue","weekday"
"9957",2020-04-08,"Snodgrass","2","3","3",13.3,-0.1,42,-1,40,31.7,-1,-1,0,-1,-2,-3,-3,-4,"w1920","Non.motorized",NA,"Wed","weekday"
"9958",2020-04-08,"Snodgrass","2","3","3",13.3,-0.1,42,-1,40,31.7,-1,-1,0,-1,-2,-3,-3,-4,"w1920","Mechanized",NA,"Wed","weekday"
"9959",2020-04-08,"Snodgrass","2","3","3",13.3,-0.1,42,-1,40,31.7,-1,-1,0,-1,-2,-3,-3,-4,"w1920","Motorized",NA,"Wed","weekday"
"9960",2020-04-08,"Snodgrass","2","3","3",13.3,-0.1,42,-1,40,31.7,-1,-1,0,-1,-2,-3,-3,-4,"w1920","Hybrid",NA,"Wed","weekday"
"9961",2020-04-09,"Snodgrass","2","3","3",13.1,-0.2,40,-2,42,32.8,-1,-1,-1,0,-3,-4,-5,-5,"w1920","Non.motorized",NA,"Thu","weekday"
"9962",2020-04-09,"Snodgrass","2","3","3",13.1,-0.2,40,-2,42,32.8,-1,-1,-1,0,-3,-4,-5,-5,"w1920","Mechanized",NA,"Thu","weekday"
"9963",2020-04-09,"Snodgrass","2","3","3",13.1,-0.2,40,-2,42,32.8,-1,-1,-1,0,-3,-4,-5,-5,"w1920","Motorized",NA,"Thu","weekday"
"9964",2020-04-09,"Snodgrass","2","3","3",13.1,-0.2,40,-2,42,32.8,-1,-1,-1,0,-3,-4,-5,-5,"w1920","Hybrid",NA,"Thu","weekday"
"9965",2020-04-10,"Snodgrass","3","3","3",12.9,-0.2,39,-1,38,33.1,-2,-1,-1,-1,-3,-4,-5,-6,"w1920","Non.motorized",NA,"Fri","weekday"
"9966",2020-04-10,"Snodgrass","3","3","3",12.9,-0.2,39,-1,38,33.1,-2,-1,-1,-1,-3,-4,-5,-6,"w1920","Mechanized",NA,"Fri","weekday"
"9967",2020-04-10,"Snodgrass","3","3","3",12.9,-0.2,39,-1,38,33.1,-2,-1,-1,-1,-3,-4,-5,-6,"w1920","Motorized",NA,"Fri","weekday"
"9968",2020-04-10,"Snodgrass","3","3","3",12.9,-0.2,39,-1,38,33.1,-2,-1,-1,-1,-3,-4,-5,-6,"w1920","Hybrid",NA,"Fri","weekday"
"9969",2020-04-11,"Snodgrass","2","3","3",12.9,0,39,0,36,33.1,-1,-2,-1,-1,-1,-3,-4,-5,"w1920","Non.motorized",NA,"Sat","weekend"
"9970",2020-04-11,"Snodgrass","2","3","3",12.9,0,39,0,36,33.1,-1,-2,-1,-1,-1,-3,-4,-5,"w1920","Mechanized",NA,"Sat","weekend"
"9971",2020-04-11,"Snodgrass","2","3","3",12.9,0,39,0,36,33.1,-1,-2,-1,-1,-1,-3,-4,-5,"w1920","Motorized",NA,"Sat","weekend"
"9972",2020-04-11,"Snodgrass","2","3","3",12.9,0,39,0,36,33.1,-1,-2,-1,-1,-1,-3,-4,-5,"w1920","Hybrid",NA,"Sat","weekend"
"9973",2020-04-12,"Snodgrass","2","2","2",12.8,-0.1,38,-1,29,33.7,0,-1,-2,-1,-1,-2,-4,-5,"w1920","Non.motorized",NA,"Sun","weekend"
"9974",2020-04-12,"Snodgrass","2","2","2",12.8,-0.1,38,-1,29,33.7,0,-1,-2,-1,-1,-2,-4,-5,"w1920","Mechanized",NA,"Sun","weekend"
"9975",2020-04-12,"Snodgrass","2","2","2",12.8,-0.1,38,-1,29,33.7,0,-1,-2,-1,-1,-2,-4,-5,"w1920","Motorized",NA,"Sun","weekend"
"9976",2020-04-12,"Snodgrass","2","2","2",12.8,-0.1,38,-1,29,33.7,0,-1,-2,-1,-1,-2,-4,-5,"w1920","Hybrid",NA,"Sun","weekend"
"9977",2020-04-13,"Snodgrass",NA,NA,NA,12.9,0.1,39,1,20,33.1,-1,0,-1,-2,0,0,-1,-3,"w1920","Non.motorized",NA,"Mon","weekday"
"9978",2020-04-13,"Snodgrass",NA,NA,NA,12.9,0.1,39,1,20,33.1,-1,0,-1,-2,0,0,-1,-3,"w1920","Mechanized",NA,"Mon","weekday"
"9979",2020-04-13,"Snodgrass",NA,NA,NA,12.9,0.1,39,1,20,33.1,-1,0,-1,-2,0,0,-1,-3,"w1920","Motorized",NA,"Mon","weekday"
"9980",2020-04-13,"Snodgrass",NA,NA,NA,12.9,0.1,39,1,20,33.1,-1,0,-1,-2,0,0,-1,-3,"w1920","Hybrid",NA,"Mon","weekday"
"9981",2020-04-14,"Snodgrass","2","2","2",13,0.1,39,0,18,33.3,1,-1,0,-1,1,0,0,-1,"w1920","Non.motorized",NA,"Tue","weekday"
"9982",2020-04-14,"Snodgrass","2","2","2",13,0.1,39,0,18,33.3,1,-1,0,-1,1,0,0,-1,"w1920","Mechanized",NA,"Tue","weekday"
"9983",2020-04-14,"Snodgrass","2","2","2",13,0.1,39,0,18,33.3,1,-1,0,-1,1,0,0,-1,"w1920","Motorized",NA,"Tue","weekday"
"9984",2020-04-14,"Snodgrass","2","2","2",13,0.1,39,0,18,33.3,1,-1,0,-1,1,0,0,-1,"w1920","Hybrid",NA,"Tue","weekday"
"9985",2020-04-15,"Snodgrass",NA,NA,NA,13.2,0.2,39,0,28,33.8,0,1,-1,0,0,1,0,0,"w1920","Non.motorized",NA,"Wed","weekday"
"9986",2020-04-15,"Snodgrass",NA,NA,NA,13.2,0.2,39,0,28,33.8,0,1,-1,0,0,1,0,0,"w1920","Mechanized",NA,"Wed","weekday"
"9987",2020-04-15,"Snodgrass",NA,NA,NA,13.2,0.2,39,0,28,33.8,0,1,-1,0,0,1,0,0,"w1920","Motorized",NA,"Wed","weekday"
"9988",2020-04-15,"Snodgrass",NA,NA,NA,13.2,0.2,39,0,28,33.8,0,1,-1,0,0,1,0,0,"w1920","Hybrid",NA,"Wed","weekday"
"9989",2019-12-06,"Washington Gulch","2","2","1",2.9,0.4,19,5,24,15.3,0,0,0,0,5,5,5,5,"w1920","Non.motorized",2,"Fri","weekday"
"9990",2019-12-06,"Washington Gulch","2","2","1",2.9,0.4,19,5,24,15.3,0,0,0,0,5,5,5,5,"w1920","Mechanized",0,"Fri","weekday"
"9991",2019-12-06,"Washington Gulch","2","2","1",2.9,0.4,19,5,24,15.3,0,0,0,0,5,5,5,5,"w1920","Motorized",1,"Fri","weekday"
"9992",2019-12-06,"Washington Gulch","2","2","1",2.9,0.4,19,5,24,15.3,0,0,0,0,5,5,5,5,"w1920","Hybrid",0,"Fri","weekday"
"9993",2019-12-07,"Washington Gulch","2","2","1",3,0.1,18,-1,29,16.7,5,0,0,0,4,4,4,4,"w1920","Non.motorized",19,"Sat","weekend"
"9994",2019-12-07,"Washington Gulch","2","2","1",3,0.1,18,-1,29,16.7,5,0,0,0,4,4,4,4,"w1920","Mechanized",0,"Sat","weekend"
"9995",2019-12-07,"Washington Gulch","2","2","1",3,0.1,18,-1,29,16.7,5,0,0,0,4,4,4,4,"w1920","Motorized",9,"Sat","weekend"
"9996",2019-12-07,"Washington Gulch","2","2","1",3,0.1,18,-1,29,16.7,5,0,0,0,4,4,4,4,"w1920","Hybrid",0,"Sat","weekend"
"9997",2019-12-08,"Washington Gulch","2","2","1",3,0,17,-1,28,17.6,-1,5,0,0,-2,3,3,3,"w1920","Non.motorized",34,"Sun","weekend"
"9998",2019-12-08,"Washington Gulch","2","2","1",3,0,17,-1,28,17.6,-1,5,0,0,-2,3,3,3,"w1920","Mechanized",0,"Sun","weekend"
"9999",2019-12-08,"Washington Gulch","2","2","1",3,0,17,-1,28,17.6,-1,5,0,0,-2,3,3,3,"w1920","Motorized",4,"Sun","weekend"
"10000",2019-12-08,"Washington Gulch","2","2","1",3,0,17,-1,28,17.6,-1,5,0,0,-2,3,3,3,"w1920","Hybrid",0,"Sun","weekend"
"10001",2019-12-09,"Washington Gulch","3","3","2",3.4,0.4,22,5,21,15.5,-1,-1,5,0,4,3,8,8,"w1920","Non.motorized",3,"Mon","weekday"
"10002",2019-12-09,"Washington Gulch","3","3","2",3.4,0.4,22,5,21,15.5,-1,-1,5,0,4,3,8,8,"w1920","Mechanized",0,"Mon","weekday"
"10003",2019-12-09,"Washington Gulch","3","3","2",3.4,0.4,22,5,21,15.5,-1,-1,5,0,4,3,8,8,"w1920","Motorized",3,"Mon","weekday"
"10004",2019-12-09,"Washington Gulch","3","3","2",3.4,0.4,22,5,21,15.5,-1,-1,5,0,4,3,8,8,"w1920","Hybrid",0,"Mon","weekday"
"10005",2020-12-10,"Washington Gulch",NA,NA,NA,NA,NA,NA,NA,NA,NA,NA,NA,NA,NA,NA,NA,NA,NA,"w1920","Non.motorized",5,"Thu","weekday"
"10006",2020-12-10,"Washington Gulch",NA,NA,NA,NA,NA,NA,NA,NA,NA,NA,NA,NA,NA,NA,NA,NA,NA,"w1920","Mechanized",0,"Thu","weekday"
"10007",2020-12-10,"Washington Gulch",NA,NA,NA,NA,NA,NA,NA,NA,NA,NA,NA,NA,NA,NA,NA,NA,NA,"w1920","Motorized",0,"Thu","weekday"
"10008",2020-12-10,"Washington Gulch",NA,NA,NA,NA,NA,NA,NA,NA,NA,NA,NA,NA,NA,NA,NA,NA,NA,"w1920","Hybrid",0,"Thu","weekday"
"10009",2019-12-11,"Washington Gulch","2","2","2",3.4,0,20,-1,22,17,-1,5,-1,-1,-2,3,2,1,"w1920","Non.motorized",14,"Wed","weekday"
"10010",2019-12-11,"Washington Gulch","2","2","2",3.4,0,20,-1,22,17,-1,5,-1,-1,-2,3,2,1,"w1920","Mechanized",1,"Wed","weekday"
"10011",2019-12-11,"Washington Gulch","2","2","2",3.4,0,20,-1,22,17,-1,5,-1,-1,-2,3,2,1,"w1920","Motorized",3,"Wed","weekday"
"10012",2019-12-11,"Washington Gulch","2","2","2",3.4,0,20,-1,22,17,-1,5,-1,-1,-2,3,2,1,"w1920","Hybrid",0,"Wed","weekday"
"10013",2019-12-12,"Washington Gulch","2","2","2",3.4,0,19,-1,25,17.9,-1,-1,5,-1,-2,-3,2,1,"w1920","Non.motorized",NA,"Thu","weekday"
"10014",2019-12-12,"Washington Gulch","2","2","2",3.4,0,19,-1,25,17.9,-1,-1,5,-1,-2,-3,2,1,"w1920","Mechanized",NA,"Thu","weekday"
"10015",2019-12-12,"Washington Gulch","2","2","2",3.4,0,19,-1,25,17.9,-1,-1,5,-1,-2,-3,2,1,"w1920","Motorized",NA,"Thu","weekday"
"10016",2019-12-12,"Washington Gulch","2","2","2",3.4,0,19,-1,25,17.9,-1,-1,5,-1,-2,-3,2,1,"w1920","Hybrid",NA,"Thu","weekday"
"10017",2019-12-13,"Washington Gulch","2","2","2",3.8,0.4,21,2,24,18.1,-1,-1,-1,5,1,0,-1,4,"w1920","Non.motorized",NA,"Fri","weekday"
"10018",2019-12-13,"Washington Gulch","2","2","2",3.8,0.4,21,2,24,18.1,-1,-1,-1,5,1,0,-1,4,"w1920","Mechanized",NA,"Fri","weekday"
"10019",2019-12-13,"Washington Gulch","2","2","2",3.8,0.4,21,2,24,18.1,-1,-1,-1,5,1,0,-1,4,"w1920","Motorized",NA,"Fri","weekday"
"10020",2019-12-13,"Washington Gulch","2","2","2",3.8,0.4,21,2,24,18.1,-1,-1,-1,5,1,0,-1,4,"w1920","Hybrid",NA,"Fri","weekday"
"10021",2019-12-14,"Washington Gulch","3","3","3",4.2,0.4,27,6,25,15.6,2,-1,-1,-1,8,7,6,5,"w1920","Non.motorized",NA,"Sat","weekend"
"10022",2019-12-14,"Washington Gulch","3","3","3",4.2,0.4,27,6,25,15.6,2,-1,-1,-1,8,7,6,5,"w1920","Mechanized",NA,"Sat","weekend"
"10023",2019-12-14,"Washington Gulch","3","3","3",4.2,0.4,27,6,25,15.6,2,-1,-1,-1,8,7,6,5,"w1920","Motorized",NA,"Sat","weekend"
"10024",2019-12-14,"Washington Gulch","3","3","3",4.2,0.4,27,6,25,15.6,2,-1,-1,-1,8,7,6,5,"w1920","Hybrid",NA,"Sat","weekend"
"10025",2019-12-15,"Washington Gulch","3","3","2",4.8,0.6,31,4,17,15.5,6,2,-1,-1,10,12,11,10,"w1920","Non.motorized",NA,"Sun","weekend"
"10026",2019-12-15,"Washington Gulch","3","3","2",4.8,0.6,31,4,17,15.5,6,2,-1,-1,10,12,11,10,"w1920","Mechanized",NA,"Sun","weekend"
"10027",2019-12-15,"Washington Gulch","3","3","2",4.8,0.6,31,4,17,15.5,6,2,-1,-1,10,12,11,10,"w1920","Motorized",NA,"Sun","weekend"
"10028",2019-12-15,"Washington Gulch","3","3","2",4.8,0.6,31,4,17,15.5,6,2,-1,-1,10,12,11,10,"w1920","Hybrid",NA,"Sun","weekend"
"10029",2019-12-16,"Washington Gulch","3","3","2",4.8,0,29,-2,6,16.6,4,6,2,-1,2,8,10,9,"w1920","Non.motorized",NA,"Mon","weekday"
"10030",2019-12-16,"Washington Gulch","3","3","2",4.8,0,29,-2,6,16.6,4,6,2,-1,2,8,10,9,"w1920","Mechanized",NA,"Mon","weekday"
"10031",2019-12-16,"Washington Gulch","3","3","2",4.8,0,29,-2,6,16.6,4,6,2,-1,2,8,10,9,"w1920","Motorized",NA,"Mon","weekday"
"10032",2019-12-16,"Washington Gulch","3","3","2",4.8,0,29,-2,6,16.6,4,6,2,-1,2,8,10,9,"w1920","Hybrid",NA,"Mon","weekday"
"10033",2019-12-17,"Washington Gulch","2","2","1",4.8,0,27,-2,8,17.8,-2,4,6,2,-4,0,6,8,"w1920","Non.motorized",NA,"Tue","weekday"
"10034",2019-12-17,"Washington Gulch","2","2","1",4.8,0,27,-2,8,17.8,-2,4,6,2,-4,0,6,8,"w1920","Mechanized",NA,"Tue","weekday"
"10035",2019-12-17,"Washington Gulch","2","2","1",4.8,0,27,-2,8,17.8,-2,4,6,2,-4,0,6,8,"w1920","Motorized",NA,"Tue","weekday"
"10036",2019-12-17,"Washington Gulch","2","2","1",4.8,0,27,-2,8,17.8,-2,4,6,2,-4,0,6,8,"w1920","Hybrid",NA,"Tue","weekday"
"10037",2019-12-18,"Washington Gulch","2","2","1",4.8,0,26,-1,20,18.5,-2,-2,4,6,-3,-5,-1,5,"w1920","Non.motorized",NA,"Wed","weekday"
"10038",2019-12-18,"Washington Gulch","2","2","1",4.8,0,26,-1,20,18.5,-2,-2,4,6,-3,-5,-1,5,"w1920","Mechanized",NA,"Wed","weekday"
"10039",2019-12-18,"Washington Gulch","2","2","1",4.8,0,26,-1,20,18.5,-2,-2,4,6,-3,-5,-1,5,"w1920","Motorized",NA,"Wed","weekday"
"10040",2019-12-18,"Washington Gulch","2","2","1",4.8,0,26,-1,20,18.5,-2,-2,4,6,-3,-5,-1,5,"w1920","Hybrid",NA,"Wed","weekday"
"10041",2019-12-19,"Washington Gulch","2","2","1",4.9,0.1,25,-1,21,19.6,-1,-2,-2,4,-2,-4,-6,-2,"w1920","Non.motorized",NA,"Thu","weekday"
"10042",2019-12-19,"Washington Gulch","2","2","1",4.9,0.1,25,-1,21,19.6,-1,-2,-2,4,-2,-4,-6,-2,"w1920","Mechanized",NA,"Thu","weekday"
"10043",2019-12-19,"Washington Gulch","2","2","1",4.9,0.1,25,-1,21,19.6,-1,-2,-2,4,-2,-4,-6,-2,"w1920","Motorized",NA,"Thu","weekday"
"10044",2019-12-19,"Washington Gulch","2","2","1",4.9,0.1,25,-1,21,19.6,-1,-2,-2,4,-2,-4,-6,-2,"w1920","Hybrid",NA,"Thu","weekday"
"10045",2019-12-20,"Washington Gulch","2","2","1",4.9,0,24,-1,21,20.4,-1,-1,-2,-2,-2,-3,-5,-7,"w1920","Non.motorized",NA,"Fri","weekday"
"10046",2019-12-20,"Washington Gulch","2","2","1",4.9,0,24,-1,21,20.4,-1,-1,-2,-2,-2,-3,-5,-7,"w1920","Mechanized",NA,"Fri","weekday"
"10047",2019-12-20,"Washington Gulch","2","2","1",4.9,0,24,-1,21,20.4,-1,-1,-2,-2,-2,-3,-5,-7,"w1920","Motorized",NA,"Fri","weekday"
"10048",2019-12-20,"Washington Gulch","2","2","1",4.9,0,24,-1,21,20.4,-1,-1,-2,-2,-2,-3,-5,-7,"w1920","Hybrid",NA,"Fri","weekday"
"10049",2019-12-21,"Washington Gulch","2","2","1",4.9,0,24,0,27,20.4,-1,-1,-1,-2,-1,-2,-3,-5,"w1920","Non.motorized",3,"Sat","weekend"
"10050",2019-12-21,"Washington Gulch","2","2","1",4.9,0,24,0,27,20.4,-1,-1,-1,-2,-1,-2,-3,-5,"w1920","Mechanized",0,"Sat","weekend"
"10051",2019-12-21,"Washington Gulch","2","2","1",4.9,0,24,0,27,20.4,-1,-1,-1,-2,-1,-2,-3,-5,"w1920","Motorized",0,"Sat","weekend"
"10052",2019-12-21,"Washington Gulch","2","2","1",4.9,0,24,0,27,20.4,-1,-1,-1,-2,-1,-2,-3,-5,"w1920","Hybrid",0,"Sat","weekend"
"10053",2019-12-22,"Washington Gulch","2","2","1",5,0.1,23,-1,31,21.7,0,-1,-1,-1,-1,-2,-3,-4,"w1920","Non.motorized",NA,"Sun","weekend"
"10054",2019-12-22,"Washington Gulch","2","2","1",5,0.1,23,-1,31,21.7,0,-1,-1,-1,-1,-2,-3,-4,"w1920","Mechanized",NA,"Sun","weekend"
"10055",2019-12-22,"Washington Gulch","2","2","1",5,0.1,23,-1,31,21.7,0,-1,-1,-1,-1,-2,-3,-4,"w1920","Motorized",NA,"Sun","weekend"
"10056",2019-12-22,"Washington Gulch","2","2","1",5,0.1,23,-1,31,21.7,0,-1,-1,-1,-1,-2,-3,-4,"w1920","Hybrid",NA,"Sun","weekend"
"10057",2019-12-23,"Washington Gulch","2","1","1",5,0,23,0,34,21.7,-1,0,-1,-1,-1,-1,-2,-3,"w1920","Non.motorized",0,"Mon","weekday"
"10058",2019-12-23,"Washington Gulch","2","1","1",5,0,23,0,34,21.7,-1,0,-1,-1,-1,-1,-2,-3,"w1920","Mechanized",0,"Mon","weekday"
"10059",2019-12-23,"Washington Gulch","2","1","1",5,0,23,0,34,21.7,-1,0,-1,-1,-1,-1,-2,-3,"w1920","Motorized",0,"Mon","weekday"
"10060",2019-12-23,"Washington Gulch","2","1","1",5,0,23,0,34,21.7,-1,0,-1,-1,-1,-1,-2,-3,"w1920","Hybrid",0,"Mon","weekday"
"10061",2019-12-24,"Washington Gulch","2","1","1",5,0,22,-1,30,22.7,0,-1,0,-1,-1,-2,-2,-3,"w1920","Non.motorized",NA,"Tue","weekday"
"10062",2019-12-24,"Washington Gulch","2","1","1",5,0,22,-1,30,22.7,0,-1,0,-1,-1,-2,-2,-3,"w1920","Mechanized",NA,"Tue","weekday"
"10063",2019-12-24,"Washington Gulch","2","1","1",5,0,22,-1,30,22.7,0,-1,0,-1,-1,-2,-2,-3,"w1920","Motorized",NA,"Tue","weekday"
"10064",2019-12-24,"Washington Gulch","2","1","1",5,0,22,-1,30,22.7,0,-1,0,-1,-1,-2,-2,-3,"w1920","Hybrid",NA,"Tue","weekday"
"10065",2019-12-25,"Washington Gulch","2","2","2",5,0,23,1,22,21.7,-1,0,-1,0,0,0,-1,-1,"w1920","Non.motorized",3,"Wed","weekday"
"10066",2019-12-25,"Washington Gulch","2","2","2",5,0,23,1,22,21.7,-1,0,-1,0,0,0,-1,-1,"w1920","Mechanized",0,"Wed","weekday"
"10067",2019-12-25,"Washington Gulch","2","2","2",5,0,23,1,22,21.7,-1,0,-1,0,0,0,-1,-1,"w1920","Motorized",0,"Wed","weekday"
"10068",2019-12-25,"Washington Gulch","2","2","2",5,0,23,1,22,21.7,-1,0,-1,0,0,0,-1,-1,"w1920","Hybrid",0,"Wed","weekday"
"10069",2019-12-26,"Washington Gulch","2","2","1",5,0,23,0,17,21.7,1,-1,0,-1,1,0,0,-1,"w1920","Non.motorized",10,"Thu","weekday"
"10070",2019-12-26,"Washington Gulch","2","2","1",5,0,23,0,17,21.7,1,-1,0,-1,1,0,0,-1,"w1920","Mechanized",0,"Thu","weekday"
"10071",2019-12-26,"Washington Gulch","2","2","1",5,0,23,0,17,21.7,1,-1,0,-1,1,0,0,-1,"w1920","Motorized",0,"Thu","weekday"
"10072",2019-12-26,"Washington Gulch","2","2","1",5,0,23,0,17,21.7,1,-1,0,-1,1,0,0,-1,"w1920","Hybrid",0,"Thu","weekday"
"10073",2019-12-27,"Washington Gulch","3","3","2",5.1,0.1,24,1,22,21.2,0,1,-1,0,1,2,1,1,"w1920","Non.motorized",7,"Fri","weekday"
"10074",2019-12-27,"Washington Gulch","3","3","2",5.1,0.1,24,1,22,21.2,0,1,-1,0,1,2,1,1,"w1920","Mechanized",0,"Fri","weekday"
"10075",2019-12-27,"Washington Gulch","3","3","2",5.1,0.1,24,1,22,21.2,0,1,-1,0,1,2,1,1,"w1920","Motorized",0,"Fri","weekday"
"10076",2019-12-27,"Washington Gulch","3","3","2",5.1,0.1,24,1,22,21.2,0,1,-1,0,1,2,1,1,"w1920","Hybrid",0,"Fri","weekday"
"10077",2019-12-28,"Washington Gulch","3","3","2",5.6,0.5,30,6,16,18.7,1,0,1,-1,7,7,8,7,"w1920","Non.motorized",NA,"Sat","weekend"
"10078",2019-12-28,"Washington Gulch","3","3","2",5.6,0.5,30,6,16,18.7,1,0,1,-1,7,7,8,7,"w1920","Mechanized",NA,"Sat","weekend"
"10079",2019-12-28,"Washington Gulch","3","3","2",5.6,0.5,30,6,16,18.7,1,0,1,-1,7,7,8,7,"w1920","Motorized",NA,"Sat","weekend"
"10080",2019-12-28,"Washington Gulch","3","3","2",5.6,0.5,30,6,16,18.7,1,0,1,-1,7,7,8,7,"w1920","Hybrid",NA,"Sat","weekend"
"10081",2019-12-29,"Washington Gulch","3","3","2",5.6,0,29,-1,3,19.3,6,1,0,1,5,6,6,7,"w1920","Non.motorized",NA,"Sun","weekend"
"10082",2019-12-29,"Washington Gulch","3","3","2",5.6,0,29,-1,3,19.3,6,1,0,1,5,6,6,7,"w1920","Mechanized",NA,"Sun","weekend"
"10083",2019-12-29,"Washington Gulch","3","3","2",5.6,0,29,-1,3,19.3,6,1,0,1,5,6,6,7,"w1920","Motorized",NA,"Sun","weekend"
"10084",2019-12-29,"Washington Gulch","3","3","2",5.6,0,29,-1,3,19.3,6,1,0,1,5,6,6,7,"w1920","Hybrid",NA,"Sun","weekend"
"10085",2019-12-30,"Washington Gulch","3","3","2",5.6,0,28,-1,3,20,-1,6,1,0,-2,4,5,5,"w1920","Non.motorized",4,"Mon","weekday"
"10086",2019-12-30,"Washington Gulch","3","3","2",5.6,0,28,-1,3,20,-1,6,1,0,-2,4,5,5,"w1920","Mechanized",0,"Mon","weekday"
"10087",2019-12-30,"Washington Gulch","3","3","2",5.6,0,28,-1,3,20,-1,6,1,0,-2,4,5,5,"w1920","Motorized",1,"Mon","weekday"
"10088",2019-12-30,"Washington Gulch","3","3","2",5.6,0,28,-1,3,20,-1,6,1,0,-2,4,5,5,"w1920","Hybrid",0,"Mon","weekday"
"10089",2019-12-31,"Washington Gulch","2","2","1",5.6,0,28,0,13,20,-1,-1,6,1,-1,-2,4,5,"w1920","Non.motorized",5,"Tue","weekday"
"10090",2019-12-31,"Washington Gulch","2","2","1",5.6,0,28,0,13,20,-1,-1,6,1,-1,-2,4,5,"w1920","Mechanized",0,"Tue","weekday"
"10091",2019-12-31,"Washington Gulch","2","2","1",5.6,0,28,0,13,20,-1,-1,6,1,-1,-2,4,5,"w1920","Motorized",2,"Tue","weekday"
"10092",2019-12-31,"Washington Gulch","2","2","1",5.6,0,28,0,13,20,-1,-1,6,1,-1,-2,4,5,"w1920","Hybrid",0,"Tue","weekday"
"10093",2020-01-01,"Washington Gulch","2","1","1",5.6,0,27,-1,21,20.7,0,-1,-1,6,-1,-2,-3,3,"w1920","Non.motorized",NA,"Wed","weekday"
"10094",2020-01-01,"Washington Gulch","2","1","1",5.6,0,27,-1,21,20.7,0,-1,-1,6,-1,-2,-3,3,"w1920","Mechanized",NA,"Wed","weekday"
"10095",2020-01-01,"Washington Gulch","2","1","1",5.6,0,27,-1,21,20.7,0,-1,-1,6,-1,-2,-3,3,"w1920","Motorized",NA,"Wed","weekday"
"10096",2020-01-01,"Washington Gulch","2","1","1",5.6,0,27,-1,21,20.7,0,-1,-1,6,-1,-2,-3,3,"w1920","Hybrid",NA,"Wed","weekday"
"10097",2020-01-02,"Washington Gulch","3","3","2",5.9,0.3,29,2,16,20.3,-1,0,-1,-1,1,1,0,-1,"w1920","Non.motorized",NA,"Thu","weekday"
"10098",2020-01-02,"Washington Gulch","3","3","2",5.9,0.3,29,2,16,20.3,-1,0,-1,-1,1,1,0,-1,"w1920","Mechanized",NA,"Thu","weekday"
"10099",2020-01-02,"Washington Gulch","3","3","2",5.9,0.3,29,2,16,20.3,-1,0,-1,-1,1,1,0,-1,"w1920","Motorized",NA,"Thu","weekday"
"10100",2020-01-02,"Washington Gulch","3","3","2",5.9,0.3,29,2,16,20.3,-1,0,-1,-1,1,1,0,-1,"w1920","Hybrid",NA,"Thu","weekday"
"10101",2020-01-03,"Washington Gulch","3","2","1",5.9,0,31,2,19,19,2,-1,0,-1,4,3,3,2,"w1920","Non.motorized",NA,"Fri","weekday"
"10102",2020-01-03,"Washington Gulch","3","2","1",5.9,0,31,2,19,19,2,-1,0,-1,4,3,3,2,"w1920","Mechanized",NA,"Fri","weekday"
"10103",2020-01-03,"Washington Gulch","3","2","1",5.9,0,31,2,19,19,2,-1,0,-1,4,3,3,2,"w1920","Motorized",NA,"Fri","weekday"
"10104",2020-01-03,"Washington Gulch","3","2","1",5.9,0,31,2,19,19,2,-1,0,-1,4,3,3,2,"w1920","Hybrid",NA,"Fri","weekday"
"10105",2020-01-04,"Washington Gulch","2","2","1",5.9,0,30,-1,26,19.7,2,2,-1,0,1,3,2,2,"w1920","Non.motorized",2,"Sat","weekend"
"10106",2020-01-04,"Washington Gulch","2","2","1",5.9,0,30,-1,26,19.7,2,2,-1,0,1,3,2,2,"w1920","Mechanized",0,"Sat","weekend"
"10107",2020-01-04,"Washington Gulch","2","2","1",5.9,0,30,-1,26,19.7,2,2,-1,0,1,3,2,2,"w1920","Motorized",0,"Sat","weekend"
"10108",2020-01-04,"Washington Gulch","2","2","1",5.9,0,30,-1,26,19.7,2,2,-1,0,1,3,2,2,"w1920","Hybrid",0,"Sat","weekend"
"10109",2020-01-05,"Washington Gulch","2","2","1",5.9,0,28,-2,23,21.1,-1,2,2,-1,-3,-1,1,0,"w1920","Non.motorized",2,"Sun","weekend"
"10110",2020-01-05,"Washington Gulch","2","2","1",5.9,0,28,-2,23,21.1,-1,2,2,-1,-3,-1,1,0,"w1920","Mechanized",0,"Sun","weekend"
"10111",2020-01-05,"Washington Gulch","2","2","1",5.9,0,28,-2,23,21.1,-1,2,2,-1,-3,-1,1,0,"w1920","Motorized",0,"Sun","weekend"
"10112",2020-01-05,"Washington Gulch","2","2","1",5.9,0,28,-2,23,21.1,-1,2,2,-1,-3,-1,1,0,"w1920","Hybrid",0,"Sun","weekend"
"10113",2020-01-06,"Washington Gulch","2","2","1",5.9,0,28,0,15,21.1,-2,-1,2,2,-2,-3,-1,1,"w1920","Non.motorized",NA,"Mon","weekday"
"10114",2020-01-06,"Washington Gulch","2","2","1",5.9,0,28,0,15,21.1,-2,-1,2,2,-2,-3,-1,1,"w1920","Mechanized",NA,"Mon","weekday"
"10115",2020-01-06,"Washington Gulch","2","2","1",5.9,0,28,0,15,21.1,-2,-1,2,2,-2,-3,-1,1,"w1920","Motorized",NA,"Mon","weekday"
"10116",2020-01-06,"Washington Gulch","2","2","1",5.9,0,28,0,15,21.1,-2,-1,2,2,-2,-3,-1,1,"w1920","Hybrid",NA,"Mon","weekday"
"10117",2020-01-07,"Washington Gulch","2","1","1",5.9,0,28,0,22,21.1,0,-2,-1,2,0,-2,-3,-1,"w1920","Non.motorized",1,"Tue","weekday"
"10118",2020-01-07,"Washington Gulch","2","1","1",5.9,0,28,0,22,21.1,0,-2,-1,2,0,-2,-3,-1,"w1920","Mechanized",0,"Tue","weekday"
"10119",2020-01-07,"Washington Gulch","2","1","1",5.9,0,28,0,22,21.1,0,-2,-1,2,0,-2,-3,-1,"w1920","Motorized",0,"Tue","weekday"
"10120",2020-01-07,"Washington Gulch","2","1","1",5.9,0,28,0,22,21.1,0,-2,-1,2,0,-2,-3,-1,"w1920","Hybrid",0,"Tue","weekday"
"10121",2020-01-08,"Washington Gulch","2","1","1",6,0.1,28,0,23,21.4,0,0,-2,-1,0,0,-2,-3,"w1920","Non.motorized",3,"Wed","weekday"
"10122",2020-01-08,"Washington Gulch","2","1","1",6,0.1,28,0,23,21.4,0,0,-2,-1,0,0,-2,-3,"w1920","Mechanized",0,"Wed","weekday"
"10123",2020-01-08,"Washington Gulch","2","1","1",6,0.1,28,0,23,21.4,0,0,-2,-1,0,0,-2,-3,"w1920","Motorized",0,"Wed","weekday"
"10124",2020-01-08,"Washington Gulch","2","1","1",6,0.1,28,0,23,21.4,0,0,-2,-1,0,0,-2,-3,"w1920","Hybrid",0,"Wed","weekday"
"10125",2020-01-09,"Washington Gulch","2","1","1",6,0,27,-1,17,22.2,0,0,0,-2,-1,-1,-1,-3,"w1920","Non.motorized",NA,"Thu","weekday"
"10126",2020-01-09,"Washington Gulch","2","1","1",6,0,27,-1,17,22.2,0,0,0,-2,-1,-1,-1,-3,"w1920","Mechanized",NA,"Thu","weekday"
"10127",2020-01-09,"Washington Gulch","2","1","1",6,0,27,-1,17,22.2,0,0,0,-2,-1,-1,-1,-3,"w1920","Motorized",NA,"Thu","weekday"
"10128",2020-01-09,"Washington Gulch","2","1","1",6,0,27,-1,17,22.2,0,0,0,-2,-1,-1,-1,-3,"w1920","Hybrid",NA,"Thu","weekday"
"10129",2020-01-10,"Washington Gulch","2","1","1",6,0,29,2,11,20.7,-1,0,0,0,1,1,1,1,"w1920","Non.motorized",1,"Fri","weekday"
"10130",2020-01-10,"Washington Gulch","2","1","1",6,0,29,2,11,20.7,-1,0,0,0,1,1,1,1,"w1920","Mechanized",0,"Fri","weekday"
"10131",2020-01-10,"Washington Gulch","2","1","1",6,0,29,2,11,20.7,-1,0,0,0,1,1,1,1,"w1920","Motorized",0,"Fri","weekday"
"10132",2020-01-10,"Washington Gulch","2","1","1",6,0,29,2,11,20.7,-1,0,0,0,1,1,1,1,"w1920","Hybrid",0,"Fri","weekday"
"10133",2020-01-11,"Washington Gulch","2","1","1",6,0,29,0,12,20.7,2,-1,0,0,2,1,1,1,"w1920","Non.motorized",1,"Sat","weekend"
"10134",2020-01-11,"Washington Gulch","2","1","1",6,0,29,0,12,20.7,2,-1,0,0,2,1,1,1,"w1920","Mechanized",0,"Sat","weekend"
"10135",2020-01-11,"Washington Gulch","2","1","1",6,0,29,0,12,20.7,2,-1,0,0,2,1,1,1,"w1920","Motorized",0,"Sat","weekend"
"10136",2020-01-11,"Washington Gulch","2","1","1",6,0,29,0,12,20.7,2,-1,0,0,2,1,1,1,"w1920","Hybrid",0,"Sat","weekend"
"10137",2020-01-12,"Washington Gulch","2","1","1",6.1,0.1,29,0,13,21,0,2,-1,0,0,2,1,1,"w1920","Non.motorized",NA,"Sun","weekend"
"10138",2020-01-12,"Washington Gulch","2","1","1",6.1,0.1,29,0,13,21,0,2,-1,0,0,2,1,1,"w1920","Mechanized",NA,"Sun","weekend"
"10139",2020-01-12,"Washington Gulch","2","1","1",6.1,0.1,29,0,13,21,0,2,-1,0,0,2,1,1,"w1920","Motorized",NA,"Sun","weekend"
"10140",2020-01-12,"Washington Gulch","2","1","1",6.1,0.1,29,0,13,21,0,2,-1,0,0,2,1,1,"w1920","Hybrid",NA,"Sun","weekend"
"10141",2020-01-13,"Washington Gulch","2","2","1",6.2,0.1,29,0,16,21.4,0,0,2,-1,0,0,2,1,"w1920","Non.motorized",NA,"Mon","weekday"
"10142",2020-01-13,"Washington Gulch","2","2","1",6.2,0.1,29,0,16,21.4,0,0,2,-1,0,0,2,1,"w1920","Mechanized",NA,"Mon","weekday"
"10143",2020-01-13,"Washington Gulch","2","2","1",6.2,0.1,29,0,16,21.4,0,0,2,-1,0,0,2,1,"w1920","Motorized",NA,"Mon","weekday"
"10144",2020-01-13,"Washington Gulch","2","2","1",6.2,0.1,29,0,16,21.4,0,0,2,-1,0,0,2,1,"w1920","Hybrid",NA,"Mon","weekday"
"10145",2020-01-14,"Washington Gulch","3","2","1",6.6,0.4,34,5,23,19.4,0,0,0,2,5,5,5,7,"w1920","Non.motorized",NA,"Tue","weekday"
"10146",2020-01-14,"Washington Gulch","3","2","1",6.6,0.4,34,5,23,19.4,0,0,0,2,5,5,5,7,"w1920","Mechanized",NA,"Tue","weekday"
"10147",2020-01-14,"Washington Gulch","3","2","1",6.6,0.4,34,5,23,19.4,0,0,0,2,5,5,5,7,"w1920","Motorized",NA,"Tue","weekday"
"10148",2020-01-14,"Washington Gulch","3","2","1",6.6,0.4,34,5,23,19.4,0,0,0,2,5,5,5,7,"w1920","Hybrid",NA,"Tue","weekday"
"10149",2020-01-15,"Washington Gulch","3","2","1",6.7,0.1,32,-2,23,20.9,5,0,0,0,3,3,3,3,"w1920","Non.motorized",NA,"Wed","weekday"
"10150",2020-01-15,"Washington Gulch","3","2","1",6.7,0.1,32,-2,23,20.9,5,0,0,0,3,3,3,3,"w1920","Mechanized",NA,"Wed","weekday"
"10151",2020-01-15,"Washington Gulch","3","2","1",6.7,0.1,32,-2,23,20.9,5,0,0,0,3,3,3,3,"w1920","Motorized",NA,"Wed","weekday"
"10152",2020-01-15,"Washington Gulch","3","2","1",6.7,0.1,32,-2,23,20.9,5,0,0,0,3,3,3,3,"w1920","Hybrid",NA,"Wed","weekday"
"10153",2020-01-16,"Washington Gulch","2","2","1",6.7,0,31,-1,28,21.6,-2,5,0,0,-3,2,2,2,"w1920","Non.motorized",NA,"Thu","weekday"
"10154",2020-01-16,"Washington Gulch","2","2","1",6.7,0,31,-1,28,21.6,-2,5,0,0,-3,2,2,2,"w1920","Mechanized",NA,"Thu","weekday"
"10155",2020-01-16,"Washington Gulch","2","2","1",6.7,0,31,-1,28,21.6,-2,5,0,0,-3,2,2,2,"w1920","Motorized",NA,"Thu","weekday"
"10156",2020-01-16,"Washington Gulch","2","2","1",6.7,0,31,-1,28,21.6,-2,5,0,0,-3,2,2,2,"w1920","Hybrid",NA,"Thu","weekday"
"10157",2020-01-17,"Washington Gulch","2","2","1",6.8,0.1,29,-2,19,23.4,-1,-2,5,0,-3,-5,0,0,"w1920","Non.motorized",NA,"Fri","weekday"
"10158",2020-01-17,"Washington Gulch","2","2","1",6.8,0.1,29,-2,19,23.4,-1,-2,5,0,-3,-5,0,0,"w1920","Mechanized",NA,"Fri","weekday"
"10159",2020-01-17,"Washington Gulch","2","2","1",6.8,0.1,29,-2,19,23.4,-1,-2,5,0,-3,-5,0,0,"w1920","Motorized",NA,"Fri","weekday"
"10160",2020-01-17,"Washington Gulch","2","2","1",6.8,0.1,29,-2,19,23.4,-1,-2,5,0,-3,-5,0,0,"w1920","Hybrid",NA,"Fri","weekday"
"10161",2020-01-18,"Washington Gulch","2","2","2",7,0.2,34,5,16,20.6,-2,-1,-2,5,3,2,0,5,"w1920","Non.motorized",NA,"Sat","weekend"
"10162",2020-01-18,"Washington Gulch","2","2","2",7,0.2,34,5,16,20.6,-2,-1,-2,5,3,2,0,5,"w1920","Mechanized",NA,"Sat","weekend"
"10163",2020-01-18,"Washington Gulch","2","2","2",7,0.2,34,5,16,20.6,-2,-1,-2,5,3,2,0,5,"w1920","Motorized",NA,"Sat","weekend"
"10164",2020-01-18,"Washington Gulch","2","2","2",7,0.2,34,5,16,20.6,-2,-1,-2,5,3,2,0,5,"w1920","Hybrid",NA,"Sat","weekend"
"10165",2020-01-19,"Washington Gulch","2","2","1",7,0,33,-1,21,21.2,5,-2,-1,-2,4,2,1,-1,"w1920","Non.motorized",NA,"Sun","weekend"
"10166",2020-01-19,"Washington Gulch","2","2","1",7,0,33,-1,21,21.2,5,-2,-1,-2,4,2,1,-1,"w1920","Mechanized",NA,"Sun","weekend"
"10167",2020-01-19,"Washington Gulch","2","2","1",7,0,33,-1,21,21.2,5,-2,-1,-2,4,2,1,-1,"w1920","Motorized",NA,"Sun","weekend"
"10168",2020-01-19,"Washington Gulch","2","2","1",7,0,33,-1,21,21.2,5,-2,-1,-2,4,2,1,-1,"w1920","Hybrid",NA,"Sun","weekend"
"10169",2020-01-20,"Washington Gulch","2","2","1",7.1,0.1,32,-1,25,22.2,-1,5,-2,-1,-2,3,1,0,"w1920","Non.motorized",NA,"Mon","weekday"
"10170",2020-01-20,"Washington Gulch","2","2","1",7.1,0.1,32,-1,25,22.2,-1,5,-2,-1,-2,3,1,0,"w1920","Mechanized",NA,"Mon","weekday"
"10171",2020-01-20,"Washington Gulch","2","2","1",7.1,0.1,32,-1,25,22.2,-1,5,-2,-1,-2,3,1,0,"w1920","Motorized",NA,"Mon","weekday"
"10172",2020-01-20,"Washington Gulch","2","2","1",7.1,0.1,32,-1,25,22.2,-1,5,-2,-1,-2,3,1,0,"w1920","Hybrid",NA,"Mon","weekday"
"10173",2020-01-21,"Washington Gulch","2","2","1",7.1,0,31,-1,28,22.9,-1,-1,5,-2,-2,-3,2,0,"w1920","Non.motorized",NA,"Tue","weekday"
"10174",2020-01-21,"Washington Gulch","2","2","1",7.1,0,31,-1,28,22.9,-1,-1,5,-2,-2,-3,2,0,"w1920","Mechanized",NA,"Tue","weekday"
"10175",2020-01-21,"Washington Gulch","2","2","1",7.1,0,31,-1,28,22.9,-1,-1,5,-2,-2,-3,2,0,"w1920","Motorized",NA,"Tue","weekday"
"10176",2020-01-21,"Washington Gulch","2","2","1",7.1,0,31,-1,28,22.9,-1,-1,5,-2,-2,-3,2,0,"w1920","Hybrid",NA,"Tue","weekday"
"10177",2020-01-22,"Washington Gulch","2","2","2",7.3,0.2,32,1,25,22.8,-1,-1,-1,5,0,-1,-2,3,"w1920","Non.motorized",NA,"Wed","weekday"
"10178",2020-01-22,"Washington Gulch","2","2","2",7.3,0.2,32,1,25,22.8,-1,-1,-1,5,0,-1,-2,3,"w1920","Mechanized",NA,"Wed","weekday"
"10179",2020-01-22,"Washington Gulch","2","2","2",7.3,0.2,32,1,25,22.8,-1,-1,-1,5,0,-1,-2,3,"w1920","Motorized",NA,"Wed","weekday"
"10180",2020-01-22,"Washington Gulch","2","2","2",7.3,0.2,32,1,25,22.8,-1,-1,-1,5,0,-1,-2,3,"w1920","Hybrid",NA,"Wed","weekday"
"10181",2020-01-23,"Washington Gulch","3","2","2",7.3,0,34,2,23,21.5,1,-1,-1,-1,3,2,1,0,"w1920","Non.motorized",NA,"Thu","weekday"
"10182",2020-01-23,"Washington Gulch","3","2","2",7.3,0,34,2,23,21.5,1,-1,-1,-1,3,2,1,0,"w1920","Mechanized",NA,"Thu","weekday"
"10183",2020-01-23,"Washington Gulch","3","2","2",7.3,0,34,2,23,21.5,1,-1,-1,-1,3,2,1,0,"w1920","Motorized",NA,"Thu","weekday"
"10184",2020-01-23,"Washington Gulch","3","2","2",7.3,0,34,2,23,21.5,1,-1,-1,-1,3,2,1,0,"w1920","Hybrid",NA,"Thu","weekday"
"10185",2020-01-24,"Washington Gulch","2","2","1",7.3,0,33,-1,23,22.1,2,1,-1,-1,1,2,1,0,"w1920","Non.motorized",NA,"Fri","weekday"
"10186",2020-01-24,"Washington Gulch","2","2","1",7.3,0,33,-1,23,22.1,2,1,-1,-1,1,2,1,0,"w1920","Mechanized",NA,"Fri","weekday"
"10187",2020-01-24,"Washington Gulch","2","2","1",7.3,0,33,-1,23,22.1,2,1,-1,-1,1,2,1,0,"w1920","Motorized",NA,"Fri","weekday"
"10188",2020-01-24,"Washington Gulch","2","2","1",7.3,0,33,-1,23,22.1,2,1,-1,-1,1,2,1,0,"w1920","Hybrid",NA,"Fri","weekday"
"10189",2020-01-25,"Washington Gulch","2","2","1",7.4,0.1,32,-1,25,23.1,-1,2,1,-1,-2,0,1,0,"w1920","Non.motorized",NA,"Sat","weekend"
"10190",2020-01-25,"Washington Gulch","2","2","1",7.4,0.1,32,-1,25,23.1,-1,2,1,-1,-2,0,1,0,"w1920","Mechanized",NA,"Sat","weekend"
"10191",2020-01-25,"Washington Gulch","2","2","1",7.4,0.1,32,-1,25,23.1,-1,2,1,-1,-2,0,1,0,"w1920","Motorized",NA,"Sat","weekend"
"10192",2020-01-25,"Washington Gulch","2","2","1",7.4,0.1,32,-1,25,23.1,-1,2,1,-1,-2,0,1,0,"w1920","Hybrid",NA,"Sat","weekend"
"10193",2020-01-26,"Washington Gulch","2","1","1",7.4,0,32,0,28,23.1,-1,-1,2,1,-1,-2,0,1,"w1920","Non.motorized",NA,"Sun","weekend"
"10194",2020-01-26,"Washington Gulch","2","1","1",7.4,0,32,0,28,23.1,-1,-1,2,1,-1,-2,0,1,"w1920","Mechanized",NA,"Sun","weekend"
"10195",2020-01-26,"Washington Gulch","2","1","1",7.4,0,32,0,28,23.1,-1,-1,2,1,-1,-2,0,1,"w1920","Motorized",NA,"Sun","weekend"
"10196",2020-01-26,"Washington Gulch","2","1","1",7.4,0,32,0,28,23.1,-1,-1,2,1,-1,-2,0,1,"w1920","Hybrid",NA,"Sun","weekend"
"10197",2020-01-27,"Washington Gulch","2","1","1",7.4,0,32,0,24,23.1,0,-1,-1,2,0,-1,-2,0,"w1920","Non.motorized",NA,"Mon","weekday"
"10198",2020-01-27,"Washington Gulch","2","1","1",7.4,0,32,0,24,23.1,0,-1,-1,2,0,-1,-2,0,"w1920","Mechanized",NA,"Mon","weekday"
"10199",2020-01-27,"Washington Gulch","2","1","1",7.4,0,32,0,24,23.1,0,-1,-1,2,0,-1,-2,0,"w1920","Motorized",NA,"Mon","weekday"
"10200",2020-01-27,"Washington Gulch","2","1","1",7.4,0,32,0,24,23.1,0,-1,-1,2,0,-1,-2,0,"w1920","Hybrid",NA,"Mon","weekday"
"10201",2020-01-28,"Washington Gulch","3","2","2",7.4,0,32,0,19,23.1,0,0,-1,-1,0,0,-1,-2,"w1920","Non.motorized",NA,"Tue","weekday"
"10202",2020-01-28,"Washington Gulch","3","2","2",7.4,0,32,0,19,23.1,0,0,-1,-1,0,0,-1,-2,"w1920","Mechanized",NA,"Tue","weekday"
"10203",2020-01-28,"Washington Gulch","3","2","2",7.4,0,32,0,19,23.1,0,0,-1,-1,0,0,-1,-2,"w1920","Motorized",NA,"Tue","weekday"
"10204",2020-01-28,"Washington Gulch","3","2","2",7.4,0,32,0,19,23.1,0,0,-1,-1,0,0,-1,-2,"w1920","Hybrid",NA,"Tue","weekday"
"10205",2020-01-29,"Washington Gulch","2","2","1",7.4,0,31,-1,20,23.9,0,0,0,-1,-1,-1,-1,-2,"w1920","Non.motorized",NA,"Wed","weekday"
"10206",2020-01-29,"Washington Gulch","2","2","1",7.4,0,31,-1,20,23.9,0,0,0,-1,-1,-1,-1,-2,"w1920","Mechanized",NA,"Wed","weekday"
"10207",2020-01-29,"Washington Gulch","2","2","1",7.4,0,31,-1,20,23.9,0,0,0,-1,-1,-1,-1,-2,"w1920","Motorized",NA,"Wed","weekday"
"10208",2020-01-29,"Washington Gulch","2","2","1",7.4,0,31,-1,20,23.9,0,0,0,-1,-1,-1,-1,-2,"w1920","Hybrid",NA,"Wed","weekday"
"10209",2020-01-30,"Washington Gulch","2","2","1",7.4,0,31,0,17,23.9,-1,0,0,0,-1,-1,-1,-1,"w1920","Non.motorized",2,"Thu","weekday"
"10210",2020-01-30,"Washington Gulch","2","2","1",7.4,0,31,0,17,23.9,-1,0,0,0,-1,-1,-1,-1,"w1920","Mechanized",0,"Thu","weekday"
"10211",2020-01-30,"Washington Gulch","2","2","1",7.4,0,31,0,17,23.9,-1,0,0,0,-1,-1,-1,-1,"w1920","Motorized",3,"Thu","weekday"
"10212",2020-01-30,"Washington Gulch","2","2","1",7.4,0,31,0,17,23.9,-1,0,0,0,-1,-1,-1,-1,"w1920","Hybrid",0,"Thu","weekday"
"10213",2020-01-31,"Washington Gulch","2","1","1",7.4,0,31,0,20,23.9,0,-1,0,0,0,-1,-1,-1,"w1920","Non.motorized",25,"Fri","weekday"
"10214",2020-01-31,"Washington Gulch","2","1","1",7.4,0,31,0,20,23.9,0,-1,0,0,0,-1,-1,-1,"w1920","Mechanized",0,"Fri","weekday"
"10215",2020-01-31,"Washington Gulch","2","1","1",7.4,0,31,0,20,23.9,0,-1,0,0,0,-1,-1,-1,"w1920","Motorized",2,"Fri","weekday"
"10216",2020-01-31,"Washington Gulch","2","1","1",7.4,0,31,0,20,23.9,0,-1,0,0,0,-1,-1,-1,"w1920","Hybrid",0,"Fri","weekday"
"10217",2020-02-01,"Washington Gulch","2","1","1",7.4,0,31,0,28,23.9,0,0,-1,0,0,0,-1,-1,"w1920","Non.motorized",45,"Sat","weekend"
"10218",2020-02-01,"Washington Gulch","2","1","1",7.4,0,31,0,28,23.9,0,0,-1,0,0,0,-1,-1,"w1920","Mechanized",0,"Sat","weekend"
"10219",2020-02-01,"Washington Gulch","2","1","1",7.4,0,31,0,28,23.9,0,0,-1,0,0,0,-1,-1,"w1920","Motorized",23,"Sat","weekend"
"10220",2020-02-01,"Washington Gulch","2","1","1",7.4,0,31,0,28,23.9,0,0,-1,0,0,0,-1,-1,"w1920","Hybrid",0,"Sat","weekend"
"10221",2020-02-02,"Washington Gulch","1","1","1",7.4,0,31,0,33,23.9,0,0,0,-1,0,0,0,-1,"w1920","Non.motorized",73,"Sun","weekend"
"10222",2020-02-02,"Washington Gulch","1","1","1",7.4,0,31,0,33,23.9,0,0,0,-1,0,0,0,-1,"w1920","Mechanized",1,"Sun","weekend"
"10223",2020-02-02,"Washington Gulch","1","1","1",7.4,0,31,0,33,23.9,0,0,0,-1,0,0,0,-1,"w1920","Motorized",5,"Sun","weekend"
"10224",2020-02-02,"Washington Gulch","1","1","1",7.4,0,31,0,33,23.9,0,0,0,-1,0,0,0,-1,"w1920","Hybrid",0,"Sun","weekend"
"10225",2020-02-03,"Washington Gulch","2","2","1",7.4,0,31,0,24,23.9,0,0,0,0,0,0,0,0,"w1920","Non.motorized",13,"Mon","weekday"
"10226",2020-02-03,"Washington Gulch","2","2","1",7.4,0,31,0,24,23.9,0,0,0,0,0,0,0,0,"w1920","Mechanized",0,"Mon","weekday"
"10227",2020-02-03,"Washington Gulch","2","2","1",7.4,0,31,0,24,23.9,0,0,0,0,0,0,0,0,"w1920","Motorized",0,"Mon","weekday"
"10228",2020-02-03,"Washington Gulch","2","2","1",7.4,0,31,0,24,23.9,0,0,0,0,0,0,0,0,"w1920","Hybrid",0,"Mon","weekday"
"10229",2020-02-04,"Washington Gulch","2","2","2",7.4,0,33,2,5,22.4,0,0,0,0,2,2,2,2,"w1920","Non.motorized",13,"Tue","weekday"
"10230",2020-02-04,"Washington Gulch","2","2","2",7.4,0,33,2,5,22.4,0,0,0,0,2,2,2,2,"w1920","Mechanized",0,"Tue","weekday"
"10231",2020-02-04,"Washington Gulch","2","2","2",7.4,0,33,2,5,22.4,0,0,0,0,2,2,2,2,"w1920","Motorized",2,"Tue","weekday"
"10232",2020-02-04,"Washington Gulch","2","2","2",7.4,0,33,2,5,22.4,0,0,0,0,2,2,2,2,"w1920","Hybrid",0,"Tue","weekday"
"10233",2020-02-05,"Washington Gulch","2","2","1",7.4,0,33,0,2,22.4,2,0,0,0,2,2,2,2,"w1920","Non.motorized",8,"Wed","weekday"
"10234",2020-02-05,"Washington Gulch","2","2","1",7.4,0,33,0,2,22.4,2,0,0,0,2,2,2,2,"w1920","Mechanized",1,"Wed","weekday"
"10235",2020-02-05,"Washington Gulch","2","2","1",7.4,0,33,0,2,22.4,2,0,0,0,2,2,2,2,"w1920","Motorized",5,"Wed","weekday"
"10236",2020-02-05,"Washington Gulch","2","2","1",7.4,0,33,0,2,22.4,2,0,0,0,2,2,2,2,"w1920","Hybrid",0,"Wed","weekday"
"10237",2020-02-06,"Washington Gulch","2","2","1",7.5,0.1,32,-1,16,23.4,0,2,0,0,-1,1,1,1,"w1920","Non.motorized",4,"Thu","weekday"
"10238",2020-02-06,"Washington Gulch","2","2","1",7.5,0.1,32,-1,16,23.4,0,2,0,0,-1,1,1,1,"w1920","Mechanized",0,"Thu","weekday"
"10239",2020-02-06,"Washington Gulch","2","2","1",7.5,0.1,32,-1,16,23.4,0,2,0,0,-1,1,1,1,"w1920","Motorized",2,"Thu","weekday"
"10240",2020-02-06,"Washington Gulch","2","2","1",7.5,0.1,32,-1,16,23.4,0,2,0,0,-1,1,1,1,"w1920","Hybrid",0,"Thu","weekday"
"10241",2020-02-07,"Washington Gulch","3","3","3",7.9,0.4,37,5,26,21.4,-1,0,2,0,4,4,6,6,"w1920","Non.motorized",NA,"Fri","weekday"
"10242",2020-02-07,"Washington Gulch","3","3","3",7.9,0.4,37,5,26,21.4,-1,0,2,0,4,4,6,6,"w1920","Mechanized",NA,"Fri","weekday"
"10243",2020-02-07,"Washington Gulch","3","3","3",7.9,0.4,37,5,26,21.4,-1,0,2,0,4,4,6,6,"w1920","Motorized",NA,"Fri","weekday"
"10244",2020-02-07,"Washington Gulch","3","3","3",7.9,0.4,37,5,26,21.4,-1,0,2,0,4,4,6,6,"w1920","Hybrid",NA,"Fri","weekday"
"10245",2020-02-08,"Washington Gulch","3","3","2",8.3,0.4,39,2,30,21.3,5,-1,0,2,7,6,6,8,"w1920","Non.motorized",38,"Sat","weekend"
"10246",2020-02-08,"Washington Gulch","3","3","2",8.3,0.4,39,2,30,21.3,5,-1,0,2,7,6,6,8,"w1920","Mechanized",0,"Sat","weekend"
"10247",2020-02-08,"Washington Gulch","3","3","2",8.3,0.4,39,2,30,21.3,5,-1,0,2,7,6,6,8,"w1920","Motorized",6,"Sat","weekend"
"10248",2020-02-08,"Washington Gulch","3","3","2",8.3,0.4,39,2,30,21.3,5,-1,0,2,7,6,6,8,"w1920","Hybrid",0,"Sat","weekend"
"10249",2020-02-09,"Washington Gulch","3","2","2",8.4,0.1,38,-1,26,22.1,2,5,-1,0,1,6,5,5,"w1920","Non.motorized",34,"Sun","weekend"
"10250",2020-02-09,"Washington Gulch","3","2","2",8.4,0.1,38,-1,26,22.1,2,5,-1,0,1,6,5,5,"w1920","Mechanized",0,"Sun","weekend"
"10251",2020-02-09,"Washington Gulch","3","2","2",8.4,0.1,38,-1,26,22.1,2,5,-1,0,1,6,5,5,"w1920","Motorized",4,"Sun","weekend"
"10252",2020-02-09,"Washington Gulch","3","2","2",8.4,0.1,38,-1,26,22.1,2,5,-1,0,1,6,5,5,"w1920","Hybrid",0,"Sun","weekend"
"10253",2020-02-10,"Washington Gulch","2","2","1",8.4,0,38,0,22,22.1,-1,2,5,-1,-1,1,6,5,"w1920","Non.motorized",15,"Mon","weekday"
"10254",2020-02-10,"Washington Gulch","2","2","1",8.4,0,38,0,22,22.1,-1,2,5,-1,-1,1,6,5,"w1920","Mechanized",0,"Mon","weekday"
"10255",2020-02-10,"Washington Gulch","2","2","1",8.4,0,38,0,22,22.1,-1,2,5,-1,-1,1,6,5,"w1920","Motorized",0,"Mon","weekday"
"10256",2020-02-10,"Washington Gulch","2","2","1",8.4,0,38,0,22,22.1,-1,2,5,-1,-1,1,6,5,"w1920","Hybrid",0,"Mon","weekday"
"10257",2020-02-11,"Washington Gulch","2","2","2",8.5,0.1,40,2,16,21.2,0,-1,2,5,2,1,3,8,"w1920","Non.motorized",12,"Tue","weekday"
"10258",2020-02-11,"Washington Gulch","2","2","2",8.5,0.1,40,2,16,21.2,0,-1,2,5,2,1,3,8,"w1920","Mechanized",0,"Tue","weekday"
"10259",2020-02-11,"Washington Gulch","2","2","2",8.5,0.1,40,2,16,21.2,0,-1,2,5,2,1,3,8,"w1920","Motorized",7,"Tue","weekday"
"10260",2020-02-11,"Washington Gulch","2","2","2",8.5,0.1,40,2,16,21.2,0,-1,2,5,2,1,3,8,"w1920","Hybrid",0,"Tue","weekday"
"10261",2020-02-12,"Washington Gulch","2","2","2",8.5,0,39,-1,15,21.8,2,0,-1,2,1,1,0,2,"w1920","Non.motorized",14,"Wed","weekday"
"10262",2020-02-12,"Washington Gulch","2","2","2",8.5,0,39,-1,15,21.8,2,0,-1,2,1,1,0,2,"w1920","Mechanized",0,"Wed","weekday"
"10263",2020-02-12,"Washington Gulch","2","2","2",8.5,0,39,-1,15,21.8,2,0,-1,2,1,1,0,2,"w1920","Motorized",4,"Wed","weekday"
"10264",2020-02-12,"Washington Gulch","2","2","2",8.5,0,39,-1,15,21.8,2,0,-1,2,1,1,0,2,"w1920","Hybrid",0,"Wed","weekday"
"10265",2020-02-13,"Washington Gulch","2","2","1",8.5,0,39,0,18,21.8,-1,2,0,-1,-1,1,1,0,"w1920","Non.motorized",12,"Thu","weekday"
"10266",2020-02-13,"Washington Gulch","2","2","1",8.5,0,39,0,18,21.8,-1,2,0,-1,-1,1,1,0,"w1920","Mechanized",0,"Thu","weekday"
"10267",2020-02-13,"Washington Gulch","2","2","1",8.5,0,39,0,18,21.8,-1,2,0,-1,-1,1,1,0,"w1920","Motorized",0,"Thu","weekday"
"10268",2020-02-13,"Washington Gulch","2","2","1",8.5,0,39,0,18,21.8,-1,2,0,-1,-1,1,1,0,"w1920","Hybrid",0,"Thu","weekday"
"10269",2020-02-14,"Washington Gulch","2","1","1",8.6,0.1,38,-1,24,22.6,0,-1,2,0,-1,-2,0,0,"w1920","Non.motorized",24,"Fri","weekday"
"10270",2020-02-14,"Washington Gulch","2","1","1",8.6,0.1,38,-1,24,22.6,0,-1,2,0,-1,-2,0,0,"w1920","Mechanized",0,"Fri","weekday"
"10271",2020-02-14,"Washington Gulch","2","1","1",8.6,0.1,38,-1,24,22.6,0,-1,2,0,-1,-2,0,0,"w1920","Motorized",10,"Fri","weekday"
"10272",2020-02-14,"Washington Gulch","2","1","1",8.6,0.1,38,-1,24,22.6,0,-1,2,0,-1,-2,0,0,"w1920","Hybrid",0,"Fri","weekday"
"10273",2020-02-15,"Washington Gulch","1","1","1",8.6,0,38,0,26,22.6,-1,0,-1,2,-1,-1,-2,0,"w1920","Non.motorized",57,"Sat","weekend"
"10274",2020-02-15,"Washington Gulch","1","1","1",8.6,0,38,0,26,22.6,-1,0,-1,2,-1,-1,-2,0,"w1920","Mechanized",0,"Sat","weekend"
"10275",2020-02-15,"Washington Gulch","1","1","1",8.6,0,38,0,26,22.6,-1,0,-1,2,-1,-1,-2,0,"w1920","Motorized",4,"Sat","weekend"
"10276",2020-02-15,"Washington Gulch","1","1","1",8.6,0,38,0,26,22.6,-1,0,-1,2,-1,-1,-2,0,"w1920","Hybrid",0,"Sat","weekend"
"10277",2020-02-16,"Washington Gulch","1","1","1",8.8,0.2,37,-1,26,23.8,0,-1,0,-1,-1,-2,-2,-3,"w1920","Non.motorized",50,"Sun","weekend"
"10278",2020-02-16,"Washington Gulch","1","1","1",8.8,0.2,37,-1,26,23.8,0,-1,0,-1,-1,-2,-2,-3,"w1920","Mechanized",0,"Sun","weekend"
"10279",2020-02-16,"Washington Gulch","1","1","1",8.8,0.2,37,-1,26,23.8,0,-1,0,-1,-1,-2,-2,-3,"w1920","Motorized",0,"Sun","weekend"
"10280",2020-02-16,"Washington Gulch","1","1","1",8.8,0.2,37,-1,26,23.8,0,-1,0,-1,-1,-2,-2,-3,"w1920","Hybrid",0,"Sun","weekend"
"10281",2020-02-17,"Washington Gulch","2","1","1",9.2,0.4,43,6,25,21.4,-1,0,-1,0,5,5,4,4,"w1920","Non.motorized",16,"Mon","weekday"
"10282",2020-02-17,"Washington Gulch","2","1","1",9.2,0.4,43,6,25,21.4,-1,0,-1,0,5,5,4,4,"w1920","Mechanized",0,"Mon","weekday"
"10283",2020-02-17,"Washington Gulch","2","1","1",9.2,0.4,43,6,25,21.4,-1,0,-1,0,5,5,4,4,"w1920","Motorized",2,"Mon","weekday"
"10284",2020-02-17,"Washington Gulch","2","1","1",9.2,0.4,43,6,25,21.4,-1,0,-1,0,5,5,4,4,"w1920","Hybrid",0,"Mon","weekday"
"10285",2020-02-18,"Washington Gulch","1","1","1",9.3,0.1,42,-1,18,22.1,6,-1,0,-1,5,4,4,3,"w1920","Non.motorized",46,"Tue","weekday"
"10286",2020-02-18,"Washington Gulch","1","1","1",9.3,0.1,42,-1,18,22.1,6,-1,0,-1,5,4,4,3,"w1920","Mechanized",0,"Tue","weekday"
"10287",2020-02-18,"Washington Gulch","1","1","1",9.3,0.1,42,-1,18,22.1,6,-1,0,-1,5,4,4,3,"w1920","Motorized",3,"Tue","weekday"
"10288",2020-02-18,"Washington Gulch","1","1","1",9.3,0.1,42,-1,18,22.1,6,-1,0,-1,5,4,4,3,"w1920","Hybrid",0,"Tue","weekday"
"10289",2020-02-19,"Washington Gulch","1","1","1",9.3,0,41,-1,22,22.7,-1,6,-1,0,-2,4,3,3,"w1920","Non.motorized",20,"Wed","weekday"
"10290",2020-02-19,"Washington Gulch","1","1","1",9.3,0,41,-1,22,22.7,-1,6,-1,0,-2,4,3,3,"w1920","Mechanized",1,"Wed","weekday"
"10291",2020-02-19,"Washington Gulch","1","1","1",9.3,0,41,-1,22,22.7,-1,6,-1,0,-2,4,3,3,"w1920","Motorized",2,"Wed","weekday"
"10292",2020-02-19,"Washington Gulch","1","1","1",9.3,0,41,-1,22,22.7,-1,6,-1,0,-2,4,3,3,"w1920","Hybrid",0,"Wed","weekday"
"10293",2020-02-20,"Washington Gulch","1","1","1",9.3,0,41,0,18,22.7,-1,-1,6,-1,-1,-2,4,3,"w1920","Non.motorized",36,"Thu","weekday"
"10294",2020-02-20,"Washington Gulch","1","1","1",9.3,0,41,0,18,22.7,-1,-1,6,-1,-1,-2,4,3,"w1920","Mechanized",0,"Thu","weekday"
"10295",2020-02-20,"Washington Gulch","1","1","1",9.3,0,41,0,18,22.7,-1,-1,6,-1,-1,-2,4,3,"w1920","Motorized",1,"Thu","weekday"
"10296",2020-02-20,"Washington Gulch","1","1","1",9.3,0,41,0,18,22.7,-1,-1,6,-1,-1,-2,4,3,"w1920","Hybrid",0,"Thu","weekday"
"10297",2020-02-21,"Washington Gulch","1","1","1",9.3,0,40,-1,26,23.2,0,-1,-1,6,-1,-2,-3,3,"w1920","Non.motorized",38,"Fri","weekday"
"10298",2020-02-21,"Washington Gulch","1","1","1",9.3,0,40,-1,26,23.2,0,-1,-1,6,-1,-2,-3,3,"w1920","Mechanized",0,"Fri","weekday"
"10299",2020-02-21,"Washington Gulch","1","1","1",9.3,0,40,-1,26,23.2,0,-1,-1,6,-1,-2,-3,3,"w1920","Motorized",13,"Fri","weekday"
"10300",2020-02-21,"Washington Gulch","1","1","1",9.3,0,40,-1,26,23.2,0,-1,-1,6,-1,-2,-3,3,"w1920","Hybrid",0,"Fri","weekday"
"10301",2020-02-22,"Washington Gulch","1","1","1",9.4,0.1,39,-1,32,24.1,-1,0,-1,-1,-2,-2,-3,-4,"w1920","Non.motorized",62,"Sat","weekend"
"10302",2020-02-22,"Washington Gulch","1","1","1",9.4,0.1,39,-1,32,24.1,-1,0,-1,-1,-2,-2,-3,-4,"w1920","Mechanized",0,"Sat","weekend"
"10303",2020-02-22,"Washington Gulch","1","1","1",9.4,0.1,39,-1,32,24.1,-1,0,-1,-1,-2,-2,-3,-4,"w1920","Motorized",9,"Sat","weekend"
"10304",2020-02-22,"Washington Gulch","1","1","1",9.4,0.1,39,-1,32,24.1,-1,0,-1,-1,-2,-2,-3,-4,"w1920","Hybrid",0,"Sat","weekend"
"10305",2020-02-23,"Washington Gulch","2","2","2",9.5,0.1,40,1,27,23.8,-1,-1,0,-1,0,-1,-1,-2,"w1920","Non.motorized",28,"Sun","weekend"
"10306",2020-02-23,"Washington Gulch","2","2","2",9.5,0.1,40,1,27,23.8,-1,-1,0,-1,0,-1,-1,-2,"w1920","Mechanized",0,"Sun","weekend"
"10307",2020-02-23,"Washington Gulch","2","2","2",9.5,0.1,40,1,27,23.8,-1,-1,0,-1,0,-1,-1,-2,"w1920","Motorized",0,"Sun","weekend"
"10308",2020-02-23,"Washington Gulch","2","2","2",9.5,0.1,40,1,27,23.8,-1,-1,0,-1,0,-1,-1,-2,"w1920","Hybrid",0,"Sun","weekend"
"10309",2020-02-24,"Washington Gulch","3","3","2",9.8,0.3,43,3,17,22.8,1,-1,-1,0,4,3,2,2,"w1920","Non.motorized",12,"Mon","weekday"
"10310",2020-02-24,"Washington Gulch","3","3","2",9.8,0.3,43,3,17,22.8,1,-1,-1,0,4,3,2,2,"w1920","Mechanized",0,"Mon","weekday"
"10311",2020-02-24,"Washington Gulch","3","3","2",9.8,0.3,43,3,17,22.8,1,-1,-1,0,4,3,2,2,"w1920","Motorized",2,"Mon","weekday"
"10312",2020-02-24,"Washington Gulch","3","3","2",9.8,0.3,43,3,17,22.8,1,-1,-1,0,4,3,2,2,"w1920","Hybrid",0,"Mon","weekday"
"10313",2020-02-25,"Washington Gulch","2","2","1",9.8,0,43,0,8,22.8,3,1,-1,-1,3,4,3,2,"w1920","Non.motorized",23,"Tue","weekday"
"10314",2020-02-25,"Washington Gulch","2","2","1",9.8,0,43,0,8,22.8,3,1,-1,-1,3,4,3,2,"w1920","Mechanized",0,"Tue","weekday"
"10315",2020-02-25,"Washington Gulch","2","2","1",9.8,0,43,0,8,22.8,3,1,-1,-1,3,4,3,2,"w1920","Motorized",2,"Tue","weekday"
"10316",2020-02-25,"Washington Gulch","2","2","1",9.8,0,43,0,8,22.8,3,1,-1,-1,3,4,3,2,"w1920","Hybrid",0,"Tue","weekday"
"10317",2020-02-26,"Washington Gulch","2","2","1",9.8,0,42,-1,15,23.3,0,3,1,-1,-1,2,3,2,"w1920","Non.motorized",30,"Wed","weekday"
"10318",2020-02-26,"Washington Gulch","2","2","1",9.8,0,42,-1,15,23.3,0,3,1,-1,-1,2,3,2,"w1920","Mechanized",0,"Wed","weekday"
"10319",2020-02-26,"Washington Gulch","2","2","1",9.8,0,42,-1,15,23.3,0,3,1,-1,-1,2,3,2,"w1920","Motorized",5,"Wed","weekday"
"10320",2020-02-26,"Washington Gulch","2","2","1",9.8,0,42,-1,15,23.3,0,3,1,-1,-1,2,3,2,"w1920","Hybrid",0,"Wed","weekday"
"10321",2020-02-27,"Washington Gulch","2","2","1",9.9,0.1,41,-1,25,24.1,-1,0,3,1,-2,-2,1,2,"w1920","Non.motorized",25,"Thu","weekday"
"10322",2020-02-27,"Washington Gulch","2","2","1",9.9,0.1,41,-1,25,24.1,-1,0,3,1,-2,-2,1,2,"w1920","Mechanized",1,"Thu","weekday"
"10323",2020-02-27,"Washington Gulch","2","2","1",9.9,0.1,41,-1,25,24.1,-1,0,3,1,-2,-2,1,2,"w1920","Motorized",4,"Thu","weekday"
"10324",2020-02-27,"Washington Gulch","2","2","1",9.9,0.1,41,-1,25,24.1,-1,0,3,1,-2,-2,1,2,"w1920","Hybrid",0,"Thu","weekday"
"10325",2020-02-28,"Washington Gulch","2","1","1",9.9,0,41,0,28,24.1,-1,-1,0,3,-1,-2,-2,1,"w1920","Non.motorized",20,"Fri","weekday"
"10326",2020-02-28,"Washington Gulch","2","1","1",9.9,0,41,0,28,24.1,-1,-1,0,3,-1,-2,-2,1,"w1920","Mechanized",3,"Fri","weekday"
"10327",2020-02-28,"Washington Gulch","2","1","1",9.9,0,41,0,28,24.1,-1,-1,0,3,-1,-2,-2,1,"w1920","Motorized",7,"Fri","weekday"
"10328",2020-02-28,"Washington Gulch","2","1","1",9.9,0,41,0,28,24.1,-1,-1,0,3,-1,-2,-2,1,"w1920","Hybrid",0,"Fri","weekday"
"10329",2020-02-29,"Washington Gulch","1","1","1",9.9,0,40,-1,29,24.8,0,-1,-1,0,-1,-2,-3,-3,"w1920","Non.motorized",32,"Sat","weekend"
"10330",2020-02-29,"Washington Gulch","1","1","1",9.9,0,40,-1,29,24.8,0,-1,-1,0,-1,-2,-3,-3,"w1920","Mechanized",1,"Sat","weekend"
"10331",2020-02-29,"Washington Gulch","1","1","1",9.9,0,40,-1,29,24.8,0,-1,-1,0,-1,-2,-3,-3,"w1920","Motorized",10,"Sat","weekend"
"10332",2020-02-29,"Washington Gulch","1","1","1",9.9,0,40,-1,29,24.8,0,-1,-1,0,-1,-2,-3,-3,"w1920","Hybrid",0,"Sat","weekend"
"10333",2020-03-01,"Washington Gulch","1","1","1",10,0.1,40,0,28,25,-1,0,-1,-1,-1,-1,-2,-3,"w1920","Non.motorized",39,"Sun","weekend"
"10334",2020-03-01,"Washington Gulch","1","1","1",10,0.1,40,0,28,25,-1,0,-1,-1,-1,-1,-2,-3,"w1920","Mechanized",1,"Sun","weekend"
"10335",2020-03-01,"Washington Gulch","1","1","1",10,0.1,40,0,28,25,-1,0,-1,-1,-1,-1,-2,-3,"w1920","Motorized",3,"Sun","weekend"
"10336",2020-03-01,"Washington Gulch","1","1","1",10,0.1,40,0,28,25,-1,0,-1,-1,-1,-1,-2,-3,"w1920","Hybrid",0,"Sun","weekend"
"10337",2020-03-02,"Washington Gulch","2","2","1",10.4,0.4,45,5,25,23.1,0,-1,0,-1,5,4,4,3,"w1920","Non.motorized",6,"Mon","weekday"
"10338",2020-03-02,"Washington Gulch","2","2","1",10.4,0.4,45,5,25,23.1,0,-1,0,-1,5,4,4,3,"w1920","Mechanized",0,"Mon","weekday"
"10339",2020-03-02,"Washington Gulch","2","2","1",10.4,0.4,45,5,25,23.1,0,-1,0,-1,5,4,4,3,"w1920","Motorized",3,"Mon","weekday"
"10340",2020-03-02,"Washington Gulch","2","2","1",10.4,0.4,45,5,25,23.1,0,-1,0,-1,5,4,4,3,"w1920","Hybrid",0,"Mon","weekday"
"10341",2020-03-03,"Washington Gulch","2","1","1",10.9,0.5,50,5,25,21.8,5,0,-1,0,10,10,9,9,"w1920","Non.motorized",12,"Tue","weekday"
"10342",2020-03-03,"Washington Gulch","2","1","1",10.9,0.5,50,5,25,21.8,5,0,-1,0,10,10,9,9,"w1920","Mechanized",0,"Tue","weekday"
"10343",2020-03-03,"Washington Gulch","2","1","1",10.9,0.5,50,5,25,21.8,5,0,-1,0,10,10,9,9,"w1920","Motorized",4,"Tue","weekday"
"10344",2020-03-03,"Washington Gulch","2","1","1",10.9,0.5,50,5,25,21.8,5,0,-1,0,10,10,9,9,"w1920","Hybrid",0,"Tue","weekday"
"10345",2020-03-04,"Washington Gulch","2","1","1",10.9,0,48,-2,29,22.7,5,5,0,-1,3,8,8,7,"w1920","Non.motorized",16,"Wed","weekday"
"10346",2020-03-04,"Washington Gulch","2","1","1",10.9,0,48,-2,29,22.7,5,5,0,-1,3,8,8,7,"w1920","Mechanized",0,"Wed","weekday"
"10347",2020-03-04,"Washington Gulch","2","1","1",10.9,0,48,-2,29,22.7,5,5,0,-1,3,8,8,7,"w1920","Motorized",3,"Wed","weekday"
"10348",2020-03-04,"Washington Gulch","2","1","1",10.9,0,48,-2,29,22.7,5,5,0,-1,3,8,8,7,"w1920","Hybrid",0,"Wed","weekday"
"10349",2020-03-05,"Washington Gulch","2","1","1",10.9,0,46,-2,32,23.7,-2,5,5,0,-4,1,6,6,"w1920","Non.motorized",14,"Thu","weekday"
"10350",2020-03-05,"Washington Gulch","2","1","1",10.9,0,46,-2,32,23.7,-2,5,5,0,-4,1,6,6,"w1920","Mechanized",1,"Thu","weekday"
"10351",2020-03-05,"Washington Gulch","2","1","1",10.9,0,46,-2,32,23.7,-2,5,5,0,-4,1,6,6,"w1920","Motorized",3,"Thu","weekday"
"10352",2020-03-05,"Washington Gulch","2","1","1",10.9,0,46,-2,32,23.7,-2,5,5,0,-4,1,6,6,"w1920","Hybrid",0,"Thu","weekday"
"10353",2020-03-06,"Washington Gulch","1","1","1",10.9,0,45,-1,34,24.2,-2,-2,5,5,-3,-5,0,5,"w1920","Non.motorized",25,"Fri","weekday"
"10354",2020-03-06,"Washington Gulch","1","1","1",10.9,0,45,-1,34,24.2,-2,-2,5,5,-3,-5,0,5,"w1920","Mechanized",0,"Fri","weekday"
"10355",2020-03-06,"Washington Gulch","1","1","1",10.9,0,45,-1,34,24.2,-2,-2,5,5,-3,-5,0,5,"w1920","Motorized",0,"Fri","weekday"
"10356",2020-03-06,"Washington Gulch","1","1","1",10.9,0,45,-1,34,24.2,-2,-2,5,5,-3,-5,0,5,"w1920","Hybrid",0,"Fri","weekday"
"10357",2020-03-07,"Washington Gulch","1","1","2",10.9,0,44,-1,35,24.8,-1,-2,-2,5,-2,-4,-6,-1,"w1920","Non.motorized",30,"Sat","weekend"
"10358",2020-03-07,"Washington Gulch","1","1","2",10.9,0,44,-1,35,24.8,-1,-2,-2,5,-2,-4,-6,-1,"w1920","Mechanized",0,"Sat","weekend"
"10359",2020-03-07,"Washington Gulch","1","1","2",10.9,0,44,-1,35,24.8,-1,-2,-2,5,-2,-4,-6,-1,"w1920","Motorized",3,"Sat","weekend"
"10360",2020-03-07,"Washington Gulch","1","1","2",10.9,0,44,-1,35,24.8,-1,-2,-2,5,-2,-4,-6,-1,"w1920","Hybrid",0,"Sat","weekend"
"10361",2020-03-08,"Washington Gulch","1","1","1",11,0.1,43,-1,33,25.6,-1,-1,-2,-2,-2,-3,-5,-7,"w1920","Non.motorized",25,"Sun","weekend"
"10362",2020-03-08,"Washington Gulch","1","1","1",11,0.1,43,-1,33,25.6,-1,-1,-2,-2,-2,-3,-5,-7,"w1920","Mechanized",0,"Sun","weekend"
"10363",2020-03-08,"Washington Gulch","1","1","1",11,0.1,43,-1,33,25.6,-1,-1,-2,-2,-2,-3,-5,-7,"w1920","Motorized",15,"Sun","weekend"
"10364",2020-03-08,"Washington Gulch","1","1","1",11,0.1,43,-1,33,25.6,-1,-1,-2,-2,-2,-3,-5,-7,"w1920","Hybrid",0,"Sun","weekend"
"10365",2020-03-09,"Washington Gulch","1","1","1",11.1,0.1,42,-1,31,26.4,-1,-1,-1,-2,-2,-3,-4,-6,"w1920","Non.motorized",18,"Mon","weekday"
"10366",2020-03-09,"Washington Gulch","1","1","1",11.1,0.1,42,-1,31,26.4,-1,-1,-1,-2,-2,-3,-4,-6,"w1920","Mechanized",1,"Mon","weekday"
"10367",2020-03-09,"Washington Gulch","1","1","1",11.1,0.1,42,-1,31,26.4,-1,-1,-1,-2,-2,-3,-4,-6,"w1920","Motorized",3,"Mon","weekday"
"10368",2020-03-09,"Washington Gulch","1","1","1",11.1,0.1,42,-1,31,26.4,-1,-1,-1,-2,-2,-3,-4,-6,"w1920","Hybrid",0,"Mon","weekday"
"10369",2020-03-10,"Washington Gulch","1","1","2",11.2,0.1,44,2,31,25.5,-1,-1,-1,-1,1,0,-1,-2,"w1920","Non.motorized",14,"Tue","weekday"
"10370",2020-03-10,"Washington Gulch","1","1","2",11.2,0.1,44,2,31,25.5,-1,-1,-1,-1,1,0,-1,-2,"w1920","Mechanized",0,"Tue","weekday"
"10371",2020-03-10,"Washington Gulch","1","1","2",11.2,0.1,44,2,31,25.5,-1,-1,-1,-1,1,0,-1,-2,"w1920","Motorized",8,"Tue","weekday"
"10372",2020-03-10,"Washington Gulch","1","1","2",11.2,0.1,44,2,31,25.5,-1,-1,-1,-1,1,0,-1,-2,"w1920","Hybrid",0,"Tue","weekday"
"10373",2020-03-11,"Washington Gulch","2","2","1",11.2,0,44,0,32,25.5,2,-1,-1,-1,2,1,0,-1,"w1920","Non.motorized",8,"Wed","weekday"
"10374",2020-03-11,"Washington Gulch","2","2","1",11.2,0,44,0,32,25.5,2,-1,-1,-1,2,1,0,-1,"w1920","Mechanized",0,"Wed","weekday"
"10375",2020-03-11,"Washington Gulch","2","2","1",11.2,0,44,0,32,25.5,2,-1,-1,-1,2,1,0,-1,"w1920","Motorized",4,"Wed","weekday"
"10376",2020-03-11,"Washington Gulch","2","2","1",11.2,0,44,0,32,25.5,2,-1,-1,-1,2,1,0,-1,"w1920","Hybrid",0,"Wed","weekday"
"10377",2020-03-12,"Washington Gulch","2","2","2",11.4,0.2,42,-2,35,27.1,0,2,-1,-1,-2,0,-1,-2,"w1920","Non.motorized",7,"Thu","weekday"
"10378",2020-03-12,"Washington Gulch","2","2","2",11.4,0.2,42,-2,35,27.1,0,2,-1,-1,-2,0,-1,-2,"w1920","Mechanized",0,"Thu","weekday"
"10379",2020-03-12,"Washington Gulch","2","2","2",11.4,0.2,42,-2,35,27.1,0,2,-1,-1,-2,0,-1,-2,"w1920","Motorized",10,"Thu","weekday"
"10380",2020-03-12,"Washington Gulch","2","2","2",11.4,0.2,42,-2,35,27.1,0,2,-1,-1,-2,0,-1,-2,"w1920","Hybrid",0,"Thu","weekday"
"10381",2020-03-13,"Washington Gulch","3","3","2",11.5,0.1,44,2,31,26.1,-2,0,2,-1,0,0,2,1,"w1920","Non.motorized",25,"Fri","weekday"
"10382",2020-03-13,"Washington Gulch","3","3","2",11.5,0.1,44,2,31,26.1,-2,0,2,-1,0,0,2,1,"w1920","Mechanized",0,"Fri","weekday"
"10383",2020-03-13,"Washington Gulch","3","3","2",11.5,0.1,44,2,31,26.1,-2,0,2,-1,0,0,2,1,"w1920","Motorized",8,"Fri","weekday"
"10384",2020-03-13,"Washington Gulch","3","3","2",11.5,0.1,44,2,31,26.1,-2,0,2,-1,0,0,2,1,"w1920","Hybrid",0,"Fri","weekday"
"10385",2020-03-14,"Washington Gulch","3","3","3",11.7,0.2,44,0,31,26.6,2,-2,0,2,2,0,0,2,"w1920","Non.motorized",58,"Sat","weekend"
"10386",2020-03-14,"Washington Gulch","3","3","3",11.7,0.2,44,0,31,26.6,2,-2,0,2,2,0,0,2,"w1920","Mechanized",0,"Sat","weekend"
"10387",2020-03-14,"Washington Gulch","3","3","3",11.7,0.2,44,0,31,26.6,2,-2,0,2,2,0,0,2,"w1920","Motorized",14,"Sat","weekend"
"10388",2020-03-14,"Washington Gulch","3","3","3",11.7,0.2,44,0,31,26.6,2,-2,0,2,2,0,0,2,"w1920","Hybrid",0,"Sat","weekend"
"10389",2020-03-15,"Washington Gulch","2","2","2",11.7,0,45,1,33,26,0,2,-2,0,1,3,1,1,"w1920","Non.motorized",82,"Sun","weekend"
"10390",2020-03-15,"Washington Gulch","2","2","2",11.7,0,45,1,33,26,0,2,-2,0,1,3,1,1,"w1920","Mechanized",0,"Sun","weekend"
"10391",2020-03-15,"Washington Gulch","2","2","2",11.7,0,45,1,33,26,0,2,-2,0,1,3,1,1,"w1920","Motorized",18,"Sun","weekend"
"10392",2020-03-15,"Washington Gulch","2","2","2",11.7,0,45,1,33,26,0,2,-2,0,1,3,1,1,"w1920","Hybrid",0,"Sun","weekend"
"10393",2020-03-16,"Washington Gulch","2","2","2",11.7,0,45,0,35,26,1,0,2,-2,1,1,3,1,"w1920","Non.motorized",42,"Mon","weekday"
"10394",2020-03-16,"Washington Gulch","2","2","2",11.7,0,45,0,35,26,1,0,2,-2,1,1,3,1,"w1920","Mechanized",0,"Mon","weekday"
"10395",2020-03-16,"Washington Gulch","2","2","2",11.7,0,45,0,35,26,1,0,2,-2,1,1,3,1,"w1920","Motorized",5,"Mon","weekday"
"10396",2020-03-16,"Washington Gulch","2","2","2",11.7,0,45,0,35,26,1,0,2,-2,1,1,3,1,"w1920","Hybrid",0,"Mon","weekday"
"10397",2020-03-17,"Washington Gulch","2","2","2",11.7,0,44,-1,36,26.6,0,1,0,2,-1,0,0,2,"w1920","Non.motorized",26,"Tue","weekday"
"10398",2020-03-17,"Washington Gulch","2","2","2",11.7,0,44,-1,36,26.6,0,1,0,2,-1,0,0,2,"w1920","Mechanized",0,"Tue","weekday"
"10399",2020-03-17,"Washington Gulch","2","2","2",11.7,0,44,-1,36,26.6,0,1,0,2,-1,0,0,2,"w1920","Motorized",7,"Tue","weekday"
"10400",2020-03-17,"Washington Gulch","2","2","2",11.7,0,44,-1,36,26.6,0,1,0,2,-1,0,0,2,"w1920","Hybrid",0,"Tue","weekday"
"10401",2020-03-18,"Washington Gulch","2","2","2",11.7,0,43,-1,33,27.2,-1,0,1,0,-2,-2,-1,-1,"w1920","Non.motorized",16,"Wed","weekday"
"10402",2020-03-18,"Washington Gulch","2","2","2",11.7,0,43,-1,33,27.2,-1,0,1,0,-2,-2,-1,-1,"w1920","Mechanized",1,"Wed","weekday"
"10403",2020-03-18,"Washington Gulch","2","2","2",11.7,0,43,-1,33,27.2,-1,0,1,0,-2,-2,-1,-1,"w1920","Motorized",9,"Wed","weekday"
"10404",2020-03-18,"Washington Gulch","2","2","2",11.7,0,43,-1,33,27.2,-1,0,1,0,-2,-2,-1,-1,"w1920","Hybrid",0,"Wed","weekday"
"10405",2020-03-19,"Washington Gulch","3","3","3",11.8,0.1,43,0,27,27.4,-1,-1,0,1,-1,-2,-2,-1,"w1920","Non.motorized",8,"Thu","weekday"
"10406",2020-03-19,"Washington Gulch","3","3","3",11.8,0.1,43,0,27,27.4,-1,-1,0,1,-1,-2,-2,-1,"w1920","Mechanized",0,"Thu","weekday"
"10407",2020-03-19,"Washington Gulch","3","3","3",11.8,0.1,43,0,27,27.4,-1,-1,0,1,-1,-2,-2,-1,"w1920","Motorized",3,"Thu","weekday"
"10408",2020-03-19,"Washington Gulch","3","3","3",11.8,0.1,43,0,27,27.4,-1,-1,0,1,-1,-2,-2,-1,"w1920","Hybrid",0,"Thu","weekday"
"10409",2020-03-20,"Washington Gulch","3","3","2",12.7,0.9,52,9,26,24.4,0,-1,-1,0,9,8,7,7,"w1920","Non.motorized",47,"Fri","weekday"
"10410",2020-03-20,"Washington Gulch","3","3","2",12.7,0.9,52,9,26,24.4,0,-1,-1,0,9,8,7,7,"w1920","Mechanized",0,"Fri","weekday"
"10411",2020-03-20,"Washington Gulch","3","3","2",12.7,0.9,52,9,26,24.4,0,-1,-1,0,9,8,7,7,"w1920","Motorized",4,"Fri","weekday"
"10412",2020-03-20,"Washington Gulch","3","3","2",12.7,0.9,52,9,26,24.4,0,-1,-1,0,9,8,7,7,"w1920","Hybrid",0,"Fri","weekday"
"10413",2020-03-21,"Washington Gulch","3","3","2",12.8,0.1,54,2,26,23.7,9,0,-1,-1,11,11,10,9,"w1920","Non.motorized",61,"Sat","weekend"
"10414",2020-03-21,"Washington Gulch","3","3","2",12.8,0.1,54,2,26,23.7,9,0,-1,-1,11,11,10,9,"w1920","Mechanized",0,"Sat","weekend"
"10415",2020-03-21,"Washington Gulch","3","3","2",12.8,0.1,54,2,26,23.7,9,0,-1,-1,11,11,10,9,"w1920","Motorized",10,"Sat","weekend"
"10416",2020-03-21,"Washington Gulch","3","3","2",12.8,0.1,54,2,26,23.7,9,0,-1,-1,11,11,10,9,"w1920","Hybrid",0,"Sat","weekend"
"10417",2020-03-22,"Washington Gulch","2","2","2",13,0.2,53,-1,28,24.5,2,9,0,-1,1,10,10,9,"w1920","Non.motorized",25,"Sun","weekend"
"10418",2020-03-22,"Washington Gulch","2","2","2",13,0.2,53,-1,28,24.5,2,9,0,-1,1,10,10,9,"w1920","Mechanized",1,"Sun","weekend"
"10419",2020-03-22,"Washington Gulch","2","2","2",13,0.2,53,-1,28,24.5,2,9,0,-1,1,10,10,9,"w1920","Motorized",19,"Sun","weekend"
"10420",2020-03-22,"Washington Gulch","2","2","2",13,0.2,53,-1,28,24.5,2,9,0,-1,1,10,10,9,"w1920","Hybrid",0,"Sun","weekend"
"10421",2020-03-23,"Washington Gulch","2","2","2",13,0,53,0,28,24.5,-1,2,9,0,-1,1,10,10,"w1920","Non.motorized",31,"Mon","weekday"
"10422",2020-03-23,"Washington Gulch","2","2","2",13,0,53,0,28,24.5,-1,2,9,0,-1,1,10,10,"w1920","Mechanized",0,"Mon","weekday"
"10423",2020-03-23,"Washington Gulch","2","2","2",13,0,53,0,28,24.5,-1,2,9,0,-1,1,10,10,"w1920","Motorized",8,"Mon","weekday"
"10424",2020-03-23,"Washington Gulch","2","2","2",13,0,53,0,28,24.5,-1,2,9,0,-1,1,10,10,"w1920","Hybrid",0,"Mon","weekday"
"10425",2020-03-24,"Washington Gulch","2","2","2",13.2,0.2,53,0,32,24.9,0,-1,2,9,0,-1,1,10,"w1920","Non.motorized",38,"Tue","weekday"
"10426",2020-03-24,"Washington Gulch","2","2","2",13.2,0.2,53,0,32,24.9,0,-1,2,9,0,-1,1,10,"w1920","Mechanized",1,"Tue","weekday"
"10427",2020-03-24,"Washington Gulch","2","2","2",13.2,0.2,53,0,32,24.9,0,-1,2,9,0,-1,1,10,"w1920","Motorized",6,"Tue","weekday"
"10428",2020-03-24,"Washington Gulch","2","2","2",13.2,0.2,53,0,32,24.9,0,-1,2,9,0,-1,1,10,"w1920","Hybrid",0,"Tue","weekday"
"10429",2020-03-25,"Washington Gulch","2","2","2",13.3,0.1,51,-2,34,26.1,0,0,-1,2,-2,-2,-3,-1,"w1920","Non.motorized",17,"Wed","weekday"
"10430",2020-03-25,"Washington Gulch","2","2","2",13.3,0.1,51,-2,34,26.1,0,0,-1,2,-2,-2,-3,-1,"w1920","Mechanized",1,"Wed","weekday"
"10431",2020-03-25,"Washington Gulch","2","2","2",13.3,0.1,51,-2,34,26.1,0,0,-1,2,-2,-2,-3,-1,"w1920","Motorized",4,"Wed","weekday"
"10432",2020-03-25,"Washington Gulch","2","2","2",13.3,0.1,51,-2,34,26.1,0,0,-1,2,-2,-2,-3,-1,"w1920","Hybrid",0,"Wed","weekday"
"10433",2020-03-26,"Washington Gulch","2","2","2",13.3,0,50,-1,36,26.6,-2,0,0,-1,-3,-3,-3,-4,"w1920","Non.motorized",12,"Thu","weekday"
"10434",2020-03-26,"Washington Gulch","2","2","2",13.3,0,50,-1,36,26.6,-2,0,0,-1,-3,-3,-3,-4,"w1920","Mechanized",0,"Thu","weekday"
"10435",2020-03-26,"Washington Gulch","2","2","2",13.3,0,50,-1,36,26.6,-2,0,0,-1,-3,-3,-3,-4,"w1920","Motorized",7,"Thu","weekday"
"10436",2020-03-26,"Washington Gulch","2","2","2",13.3,0,50,-1,36,26.6,-2,0,0,-1,-3,-3,-3,-4,"w1920","Hybrid",0,"Thu","weekday"
"10437",2020-03-26,"Washington Gulch","3","3","2",13.3,0,50,-1,36,26.6,-2,0,0,-1,-3,-3,-3,-4,"w1920","Non.motorized",12,"Thu","weekday"
"10438",2020-03-26,"Washington Gulch","3","3","2",13.3,0,50,-1,36,26.6,-2,0,0,-1,-3,-3,-3,-4,"w1920","Mechanized",0,"Thu","weekday"
"10439",2020-03-26,"Washington Gulch","3","3","2",13.3,0,50,-1,36,26.6,-2,0,0,-1,-3,-3,-3,-4,"w1920","Motorized",7,"Thu","weekday"
"10440",2020-03-26,"Washington Gulch","3","3","2",13.3,0,50,-1,36,26.6,-2,0,0,-1,-3,-3,-3,-4,"w1920","Hybrid",0,"Thu","weekday"
"10441",2020-03-27,"Washington Gulch","3","3","2",13.3,0,50,0,23,26.6,-1,-2,0,0,-1,-3,-3,-3,"w1920","Non.motorized",31,"Fri","weekday"
"10442",2020-03-27,"Washington Gulch","3","3","2",13.3,0,50,0,23,26.6,-1,-2,0,0,-1,-3,-3,-3,"w1920","Mechanized",0,"Fri","weekday"
"10443",2020-03-27,"Washington Gulch","3","3","2",13.3,0,50,0,23,26.6,-1,-2,0,0,-1,-3,-3,-3,"w1920","Motorized",0,"Fri","weekday"
"10444",2020-03-27,"Washington Gulch","3","3","2",13.3,0,50,0,23,26.6,-1,-2,0,0,-1,-3,-3,-3,"w1920","Hybrid",0,"Fri","weekday"
"10445",2020-03-28,"Washington Gulch","3","3","3",13.3,0,50,0,18,26.6,0,-1,-2,0,0,-1,-3,-3,"w1920","Non.motorized",17,"Sat","weekend"
"10446",2020-03-28,"Washington Gulch","3","3","3",13.3,0,50,0,18,26.6,0,-1,-2,0,0,-1,-3,-3,"w1920","Mechanized",1,"Sat","weekend"
"10447",2020-03-28,"Washington Gulch","3","3","3",13.3,0,50,0,18,26.6,0,-1,-2,0,0,-1,-3,-3,"w1920","Motorized",5,"Sat","weekend"
"10448",2020-03-28,"Washington Gulch","3","3","3",13.3,0,50,0,18,26.6,0,-1,-2,0,0,-1,-3,-3,"w1920","Hybrid",0,"Sat","weekend"
"10449",2020-03-29,"Washington Gulch","2","2","2",13.3,0,49,-1,24,27.1,0,0,-1,-2,-1,-1,-2,-4,"w1920","Non.motorized",33,"Sun","weekend"
"10450",2020-03-29,"Washington Gulch","2","2","2",13.3,0,49,-1,24,27.1,0,0,-1,-2,-1,-1,-2,-4,"w1920","Mechanized",0,"Sun","weekend"
"10451",2020-03-29,"Washington Gulch","2","2","2",13.3,0,49,-1,24,27.1,0,0,-1,-2,-1,-1,-2,-4,"w1920","Motorized",10,"Sun","weekend"
"10452",2020-03-29,"Washington Gulch","2","2","2",13.3,0,49,-1,24,27.1,0,0,-1,-2,-1,-1,-2,-4,"w1920","Hybrid",0,"Sun","weekend"
"10453",2020-03-30,"Washington Gulch","2","2","2",13.4,0.1,49,0,29,27.3,-1,0,0,-1,-1,-1,-1,-2,"w1920","Non.motorized",10,"Mon","weekday"
"10454",2020-03-30,"Washington Gulch","2","2","2",13.4,0.1,49,0,29,27.3,-1,0,0,-1,-1,-1,-1,-2,"w1920","Mechanized",0,"Mon","weekday"
"10455",2020-03-30,"Washington Gulch","2","2","2",13.4,0.1,49,0,29,27.3,-1,0,0,-1,-1,-1,-1,-2,"w1920","Motorized",2,"Mon","weekday"
"10456",2020-03-30,"Washington Gulch","2","2","2",13.4,0.1,49,0,29,27.3,-1,0,0,-1,-1,-1,-1,-2,"w1920","Hybrid",0,"Mon","weekday"
"10457",2020-03-31,"Washington Gulch","2","2","2",13.6,0.2,51,2,35,26.7,0,-1,0,0,2,1,1,1,"w1920","Non.motorized",20,"Tue","weekday"
"10458",2020-03-31,"Washington Gulch","2","2","2",13.6,0.2,51,2,35,26.7,0,-1,0,0,2,1,1,1,"w1920","Mechanized",0,"Tue","weekday"
"10459",2020-03-31,"Washington Gulch","2","2","2",13.6,0.2,51,2,35,26.7,0,-1,0,0,2,1,1,1,"w1920","Motorized",9,"Tue","weekday"
"10460",2020-03-31,"Washington Gulch","2","2","2",13.6,0.2,51,2,35,26.7,0,-1,0,0,2,1,1,1,"w1920","Hybrid",0,"Tue","weekday"
"10461",2020-04-01,"Washington Gulch","2","2","2",13.6,0,47,-4,39,28.9,2,0,-1,0,-2,-2,-3,-3,"w1920","Non.motorized",16,"Wed","weekday"
"10462",2020-04-01,"Washington Gulch","2","2","2",13.6,0,47,-4,39,28.9,2,0,-1,0,-2,-2,-3,-3,"w1920","Mechanized",0,"Wed","weekday"
"10463",2020-04-01,"Washington Gulch","2","2","2",13.6,0,47,-4,39,28.9,2,0,-1,0,-2,-2,-3,-3,"w1920","Motorized",7,"Wed","weekday"
"10464",2020-04-01,"Washington Gulch","2","2","2",13.6,0,47,-4,39,28.9,2,0,-1,0,-2,-2,-3,-3,"w1920","Hybrid",0,"Wed","weekday"
"10465",2020-04-02,"Washington Gulch","2","2","2",13.6,0,46,-1,31,29.6,-4,2,0,-1,-5,-3,-3,-4,"w1920","Non.motorized",19,"Thu","weekday"
"10466",2020-04-02,"Washington Gulch","2","2","2",13.6,0,46,-1,31,29.6,-4,2,0,-1,-5,-3,-3,-4,"w1920","Mechanized",0,"Thu","weekday"
"10467",2020-04-02,"Washington Gulch","2","2","2",13.6,0,46,-1,31,29.6,-4,2,0,-1,-5,-3,-3,-4,"w1920","Motorized",4,"Thu","weekday"
"10468",2020-04-02,"Washington Gulch","2","2","2",13.6,0,46,-1,31,29.6,-4,2,0,-1,-5,-3,-3,-4,"w1920","Hybrid",0,"Thu","weekday"
"10469",2020-04-03,"Washington Gulch","2","2","2",13.6,0,46,0,28,29.6,-1,-4,2,0,-1,-5,-3,-3,"w1920","Non.motorized",7,"Fri","weekday"
"10470",2020-04-03,"Washington Gulch","2","2","2",13.6,0,46,0,28,29.6,-1,-4,2,0,-1,-5,-3,-3,"w1920","Mechanized",0,"Fri","weekday"
"10471",2020-04-03,"Washington Gulch","2","2","2",13.6,0,46,0,28,29.6,-1,-4,2,0,-1,-5,-3,-3,"w1920","Motorized",7,"Fri","weekday"
"10472",2020-04-03,"Washington Gulch","2","2","2",13.6,0,46,0,28,29.6,-1,-4,2,0,-1,-5,-3,-3,"w1920","Hybrid",0,"Fri","weekday"
"10473",2020-04-04,"Washington Gulch","2","2","2",13.6,0,45,-1,33,30.2,0,-1,-4,2,-1,-2,-6,-4,"w1920","Non.motorized",10,"Sat","weekend"
"10474",2020-04-04,"Washington Gulch","2","2","2",13.6,0,45,-1,33,30.2,0,-1,-4,2,-1,-2,-6,-4,"w1920","Mechanized",0,"Sat","weekend"
"10475",2020-04-04,"Washington Gulch","2","2","2",13.6,0,45,-1,33,30.2,0,-1,-4,2,-1,-2,-6,-4,"w1920","Motorized",8,"Sat","weekend"
"10476",2020-04-04,"Washington Gulch","2","2","2",13.6,0,45,-1,33,30.2,0,-1,-4,2,-1,-2,-6,-4,"w1920","Hybrid",0,"Sat","weekend"
"10477",2020-04-05,"Washington Gulch","2","2","3",13.6,0,45,0,38,30.2,-1,0,-1,-4,-1,-1,-2,-6,"w1920","Non.motorized",18,"Sun","weekend"
"10478",2020-04-05,"Washington Gulch","2","2","3",13.6,0,45,0,38,30.2,-1,0,-1,-4,-1,-1,-2,-6,"w1920","Mechanized",0,"Sun","weekend"
"10479",2020-04-05,"Washington Gulch","2","2","3",13.6,0,45,0,38,30.2,-1,0,-1,-4,-1,-1,-2,-6,"w1920","Motorized",10,"Sun","weekend"
"10480",2020-04-05,"Washington Gulch","2","2","3",13.6,0,45,0,38,30.2,-1,0,-1,-4,-1,-1,-2,-6,"w1920","Hybrid",0,"Sun","weekend"
"10481",2020-04-06,"Washington Gulch","2","2","3",13.6,0,44,-1,40,30.9,0,-1,0,-1,-1,-2,-2,-3,"w1920","Non.motorized",38,"Mon","weekday"
"10482",2020-04-06,"Washington Gulch","2","2","3",13.6,0,44,-1,40,30.9,0,-1,0,-1,-1,-2,-2,-3,"w1920","Mechanized",0,"Mon","weekday"
"10483",2020-04-06,"Washington Gulch","2","2","3",13.6,0,44,-1,40,30.9,0,-1,0,-1,-1,-2,-2,-3,"w1920","Motorized",8,"Mon","weekday"
"10484",2020-04-06,"Washington Gulch","2","2","3",13.6,0,44,-1,40,30.9,0,-1,0,-1,-1,-2,-2,-3,"w1920","Hybrid",0,"Mon","weekday"
"10485",2020-04-07,"Washington Gulch","2","2","3",13.4,-0.2,43,-1,39,31.2,-1,0,-1,0,-2,-2,-3,-3,"w1920","Non.motorized",11,"Tue","weekday"
"10486",2020-04-07,"Washington Gulch","2","2","3",13.4,-0.2,43,-1,39,31.2,-1,0,-1,0,-2,-2,-3,-3,"w1920","Mechanized",0,"Tue","weekday"
"10487",2020-04-07,"Washington Gulch","2","2","3",13.4,-0.2,43,-1,39,31.2,-1,0,-1,0,-2,-2,-3,-3,"w1920","Motorized",5,"Tue","weekday"
"10488",2020-04-07,"Washington Gulch","2","2","3",13.4,-0.2,43,-1,39,31.2,-1,0,-1,0,-2,-2,-3,-3,"w1920","Hybrid",0,"Tue","weekday"
"10489",2020-04-08,"Washington Gulch","2","3","3",13.3,-0.1,42,-1,40,31.7,-1,-1,0,-1,-2,-3,-3,-4,"w1920","Non.motorized",8,"Wed","weekday"
"10490",2020-04-08,"Washington Gulch","2","3","3",13.3,-0.1,42,-1,40,31.7,-1,-1,0,-1,-2,-3,-3,-4,"w1920","Mechanized",0,"Wed","weekday"
"10491",2020-04-08,"Washington Gulch","2","3","3",13.3,-0.1,42,-1,40,31.7,-1,-1,0,-1,-2,-3,-3,-4,"w1920","Motorized",2,"Wed","weekday"
"10492",2020-04-08,"Washington Gulch","2","3","3",13.3,-0.1,42,-1,40,31.7,-1,-1,0,-1,-2,-3,-3,-4,"w1920","Hybrid",0,"Wed","weekday"
"10493",2020-04-09,"Washington Gulch","2","3","3",13.1,-0.2,40,-2,42,32.8,-1,-1,-1,0,-3,-4,-5,-5,"w1920","Non.motorized",9,"Thu","weekday"
"10494",2020-04-09,"Washington Gulch","2","3","3",13.1,-0.2,40,-2,42,32.8,-1,-1,-1,0,-3,-4,-5,-5,"w1920","Mechanized",2,"Thu","weekday"
"10495",2020-04-09,"Washington Gulch","2","3","3",13.1,-0.2,40,-2,42,32.8,-1,-1,-1,0,-3,-4,-5,-5,"w1920","Motorized",5,"Thu","weekday"
"10496",2020-04-09,"Washington Gulch","2","3","3",13.1,-0.2,40,-2,42,32.8,-1,-1,-1,0,-3,-4,-5,-5,"w1920","Hybrid",0,"Thu","weekday"
"10497",2020-04-10,"Washington Gulch","3","3","3",12.9,-0.2,39,-1,38,33.1,-2,-1,-1,-1,-3,-4,-5,-6,"w1920","Non.motorized",16,"Fri","weekday"
"10498",2020-04-10,"Washington Gulch","3","3","3",12.9,-0.2,39,-1,38,33.1,-2,-1,-1,-1,-3,-4,-5,-6,"w1920","Mechanized",0,"Fri","weekday"
"10499",2020-04-10,"Washington Gulch","3","3","3",12.9,-0.2,39,-1,38,33.1,-2,-1,-1,-1,-3,-4,-5,-6,"w1920","Motorized",9,"Fri","weekday"
"10500",2020-04-10,"Washington Gulch","3","3","3",12.9,-0.2,39,-1,38,33.1,-2,-1,-1,-1,-3,-4,-5,-6,"w1920","Hybrid",0,"Fri","weekday"
"10501",2020-04-11,"Washington Gulch","2","3","3",12.9,0,39,0,36,33.1,-1,-2,-1,-1,-1,-3,-4,-5,"w1920","Non.motorized",4,"Sat","weekend"
"10502",2020-04-11,"Washington Gulch","2","3","3",12.9,0,39,0,36,33.1,-1,-2,-1,-1,-1,-3,-4,-5,"w1920","Mechanized",0,"Sat","weekend"
"10503",2020-04-11,"Washington Gulch","2","3","3",12.9,0,39,0,36,33.1,-1,-2,-1,-1,-1,-3,-4,-5,"w1920","Motorized",0,"Sat","weekend"
"10504",2020-04-11,"Washington Gulch","2","3","3",12.9,0,39,0,36,33.1,-1,-2,-1,-1,-1,-3,-4,-5,"w1920","Hybrid",0,"Sat","weekend"
"10505",2020-04-12,"Washington Gulch","2","2","2",12.8,-0.1,38,-1,29,33.7,0,-1,-2,-1,-1,-2,-4,-5,"w1920","Non.motorized",3,"Sun","weekend"
"10506",2020-04-12,"Washington Gulch","2","2","2",12.8,-0.1,38,-1,29,33.7,0,-1,-2,-1,-1,-2,-4,-5,"w1920","Mechanized",0,"Sun","weekend"
"10507",2020-04-12,"Washington Gulch","2","2","2",12.8,-0.1,38,-1,29,33.7,0,-1,-2,-1,-1,-2,-4,-5,"w1920","Motorized",0,"Sun","weekend"
"10508",2020-04-12,"Washington Gulch","2","2","2",12.8,-0.1,38,-1,29,33.7,0,-1,-2,-1,-1,-2,-4,-5,"w1920","Hybrid",0,"Sun","weekend"
"10509",2020-04-13,"Washington Gulch",NA,NA,NA,12.9,0.1,39,1,20,33.1,-1,0,-1,-2,0,0,-1,-3,"w1920","Non.motorized",2,"Mon","weekday"
"10510",2020-04-13,"Washington Gulch",NA,NA,NA,12.9,0.1,39,1,20,33.1,-1,0,-1,-2,0,0,-1,-3,"w1920","Mechanized",0,"Mon","weekday"
"10511",2020-04-13,"Washington Gulch",NA,NA,NA,12.9,0.1,39,1,20,33.1,-1,0,-1,-2,0,0,-1,-3,"w1920","Motorized",0,"Mon","weekday"
"10512",2020-04-13,"Washington Gulch",NA,NA,NA,12.9,0.1,39,1,20,33.1,-1,0,-1,-2,0,0,-1,-3,"w1920","Hybrid",0,"Mon","weekday"
"10513",2020-04-14,"Washington Gulch","2","2","2",13,0.1,39,0,18,33.3,1,-1,0,-1,1,0,0,-1,"w1920","Non.motorized",NA,"Tue","weekday"
"10514",2020-04-14,"Washington Gulch","2","2","2",13,0.1,39,0,18,33.3,1,-1,0,-1,1,0,0,-1,"w1920","Mechanized",NA,"Tue","weekday"
"10515",2020-04-14,"Washington Gulch","2","2","2",13,0.1,39,0,18,33.3,1,-1,0,-1,1,0,0,-1,"w1920","Motorized",NA,"Tue","weekday"
"10516",2020-04-14,"Washington Gulch","2","2","2",13,0.1,39,0,18,33.3,1,-1,0,-1,1,0,0,-1,"w1920","Hybrid",NA,"Tue","weekday"
"10517",2020-04-15,"Washington Gulch",NA,NA,NA,13.2,0.2,39,0,28,33.8,0,1,-1,0,0,1,0,0,"w1920","Non.motorized",0,"Wed","weekday"
"10518",2020-04-15,"Washington Gulch",NA,NA,NA,13.2,0.2,39,0,28,33.8,0,1,-1,0,0,1,0,0,"w1920","Mechanized",0,"Wed","weekday"
"10519",2020-04-15,"Washington Gulch",NA,NA,NA,13.2,0.2,39,0,28,33.8,0,1,-1,0,0,1,0,0,"w1920","Motorized",0,"Wed","weekday"
"10520",2020-04-15,"Washington Gulch",NA,NA,NA,13.2,0.2,39,0,28,33.8,0,1,-1,0,0,1,0,0,"w1920","Hybrid",0,"Wed","weekday"
