"","date","Trailhead","year","modality","user.count","week","weekend","has_sled","rating_above","rating_near","rating_below","swe","change_swe","snow_depth","change_depth","air_temp","snow_density","lag1snow","lag2snow","lag3snow","lag4snow","past2snow","past3snow","past4snow","past5snow"
"1",2017-12-22,"Brush Creek Trailhead","w1718","Non.motorized",14,"Fri","weekday","no_sled","2","2","1",2,0,11,3,17,18.2,0,0,0,0,3,3,3,3
"2",2017-12-22,"Brush Creek Trailhead","w1718","Mechanized",1,"Fri","weekday","no_sled","2","2","1",2,0,11,3,17,18.2,0,0,0,0,3,3,3,3
"3",2017-12-22,"Brush Creek Trailhead","w1718","Motorized",0,"Fri","weekday","sled","2","2","1",2,0,11,3,17,18.2,0,0,0,0,3,3,3,3
"4",2017-12-22,"Brush Creek Trailhead","w1718","Hybrid",NA,"Fri","weekday","sled","2","2","1",2,0,11,3,17,18.2,0,0,0,0,3,3,3,3
"5",2017-12-23,"Brush Creek Trailhead","w1718","Non.motorized",11,"Sat","weekend","no_sled","2","1","1",2.1,0.1,10,-1,21,21,3,0,0,0,2,2,2,2
"6",2017-12-23,"Brush Creek Trailhead","w1718","Mechanized",0,"Sat","weekend","no_sled","2","1","1",2.1,0.1,10,-1,21,21,3,0,0,0,2,2,2,2
"7",2017-12-23,"Brush Creek Trailhead","w1718","Motorized",0,"Sat","weekend","sled","2","1","1",2.1,0.1,10,-1,21,21,3,0,0,0,2,2,2,2
"8",2017-12-23,"Brush Creek Trailhead","w1718","Hybrid",NA,"Sat","weekend","sled","2","1","1",2.1,0.1,10,-1,21,21,3,0,0,0,2,2,2,2
"9",2017-12-24,"Brush Creek Trailhead","w1718","Non.motorized",28,"Sun","weekend","no_sled","1","1","1",2.4,0.3,14,4,19,17.1,-1,3,0,0,3,6,6,6
"10",2017-12-24,"Brush Creek Trailhead","w1718","Mechanized",0,"Sun","weekend","no_sled","1","1","1",2.4,0.3,14,4,19,17.1,-1,3,0,0,3,6,6,6
"11",2017-12-24,"Brush Creek Trailhead","w1718","Motorized",0,"Sun","weekend","sled","1","1","1",2.4,0.3,14,4,19,17.1,-1,3,0,0,3,6,6,6
"12",2017-12-24,"Brush Creek Trailhead","w1718","Hybrid",NA,"Sun","weekend","sled","1","1","1",2.4,0.3,14,4,19,17.1,-1,3,0,0,3,6,6,6
"13",2017-12-25,"Brush Creek Trailhead","w1718","Non.motorized",14,"Mon","weekday","no_sled","2","1","1",2.6,0.2,14,0,25,18.6,4,-1,3,0,4,3,6,6
"14",2017-12-25,"Brush Creek Trailhead","w1718","Mechanized",0,"Mon","weekday","no_sled","2","1","1",2.6,0.2,14,0,25,18.6,4,-1,3,0,4,3,6,6
"15",2017-12-25,"Brush Creek Trailhead","w1718","Motorized",0,"Mon","weekday","sled","2","1","1",2.6,0.2,14,0,25,18.6,4,-1,3,0,4,3,6,6
"16",2017-12-25,"Brush Creek Trailhead","w1718","Hybrid",NA,"Mon","weekday","sled","2","1","1",2.6,0.2,14,0,25,18.6,4,-1,3,0,4,3,6,6
"17",2017-12-26,"Brush Creek Trailhead","w1718","Non.motorized",27,"Tue","weekday","no_sled","1","1","1",3.1,0.5,20,6,25,15.5,0,4,-1,3,6,10,9,12
"18",2017-12-26,"Brush Creek Trailhead","w1718","Mechanized",0,"Tue","weekday","no_sled","1","1","1",3.1,0.5,20,6,25,15.5,0,4,-1,3,6,10,9,12
"19",2017-12-26,"Brush Creek Trailhead","w1718","Motorized",0,"Tue","weekday","sled","1","1","1",3.1,0.5,20,6,25,15.5,0,4,-1,3,6,10,9,12
"20",2017-12-26,"Brush Creek Trailhead","w1718","Hybrid",NA,"Tue","weekday","sled","1","1","1",3.1,0.5,20,6,25,15.5,0,4,-1,3,6,10,9,12
"21",2017-12-27,"Brush Creek Trailhead","w1718","Non.motorized",24,"Wed","weekday","no_sled","1","1","1",3.1,0,18,-2,27,17.2,6,0,4,-1,4,4,8,7
"22",2017-12-27,"Brush Creek Trailhead","w1718","Mechanized",0,"Wed","weekday","no_sled","1","1","1",3.1,0,18,-2,27,17.2,6,0,4,-1,4,4,8,7
"23",2017-12-27,"Brush Creek Trailhead","w1718","Motorized",0,"Wed","weekday","sled","1","1","1",3.1,0,18,-2,27,17.2,6,0,4,-1,4,4,8,7
"24",2017-12-27,"Brush Creek Trailhead","w1718","Hybrid",NA,"Wed","weekday","sled","1","1","1",3.1,0,18,-2,27,17.2,6,0,4,-1,4,4,8,7
"25",2017-12-28,"Brush Creek Trailhead","w1718","Non.motorized",37,"Thu","weekday","no_sled","1","1","1",3.2,0.1,17,-1,31,18.8,-2,6,0,4,-3,3,3,7
"26",2017-12-28,"Brush Creek Trailhead","w1718","Mechanized",0,"Thu","weekday","no_sled","1","1","1",3.2,0.1,17,-1,31,18.8,-2,6,0,4,-3,3,3,7
"27",2017-12-28,"Brush Creek Trailhead","w1718","Motorized",0,"Thu","weekday","sled","1","1","1",3.2,0.1,17,-1,31,18.8,-2,6,0,4,-3,3,3,7
"28",2017-12-28,"Brush Creek Trailhead","w1718","Hybrid",NA,"Thu","weekday","sled","1","1","1",3.2,0.1,17,-1,31,18.8,-2,6,0,4,-3,3,3,7
"29",2017-12-29,"Brush Creek Trailhead","w1718","Non.motorized",27,"Fri","weekday","no_sled","1","1","1",3.2,0,17,0,36,18.8,-1,-2,6,0,-1,-3,3,3
"30",2017-12-29,"Brush Creek Trailhead","w1718","Mechanized",0,"Fri","weekday","no_sled","1","1","1",3.2,0,17,0,36,18.8,-1,-2,6,0,-1,-3,3,3
"31",2017-12-29,"Brush Creek Trailhead","w1718","Motorized",0,"Fri","weekday","sled","1","1","1",3.2,0,17,0,36,18.8,-1,-2,6,0,-1,-3,3,3
"32",2017-12-29,"Brush Creek Trailhead","w1718","Hybrid",NA,"Fri","weekday","sled","1","1","1",3.2,0,17,0,36,18.8,-1,-2,6,0,-1,-3,3,3
"33",2017-12-30,"Brush Creek Trailhead","w1718","Non.motorized",44,"Sat","weekend","no_sled","1","1","1",3.2,0,15,-2,37,21.3,0,-1,-2,6,-2,-3,-5,1
"34",2017-12-30,"Brush Creek Trailhead","w1718","Mechanized",0,"Sat","weekend","no_sled","1","1","1",3.2,0,15,-2,37,21.3,0,-1,-2,6,-2,-3,-5,1
"35",2017-12-30,"Brush Creek Trailhead","w1718","Motorized",0,"Sat","weekend","sled","1","1","1",3.2,0,15,-2,37,21.3,0,-1,-2,6,-2,-3,-5,1
"36",2017-12-30,"Brush Creek Trailhead","w1718","Hybrid",NA,"Sat","weekend","sled","1","1","1",3.2,0,15,-2,37,21.3,0,-1,-2,6,-2,-3,-5,1
"37",2017-12-31,"Brush Creek Trailhead","w1718","Non.motorized",33,"Sun","weekend","no_sled","1","1","1",3.2,0,15,0,31,21.3,-2,0,-1,-2,-2,-2,-3,-5
"38",2017-12-31,"Brush Creek Trailhead","w1718","Mechanized",1,"Sun","weekend","no_sled","1","1","1",3.2,0,15,0,31,21.3,-2,0,-1,-2,-2,-2,-3,-5
"39",2017-12-31,"Brush Creek Trailhead","w1718","Motorized",0,"Sun","weekend","sled","1","1","1",3.2,0,15,0,31,21.3,-2,0,-1,-2,-2,-2,-3,-5
"40",2017-12-31,"Brush Creek Trailhead","w1718","Hybrid",NA,"Sun","weekend","sled","1","1","1",3.2,0,15,0,31,21.3,-2,0,-1,-2,-2,-2,-3,-5
"41",2018-01-01,"Brush Creek Trailhead","w1718","Non.motorized",44,"Mon","weekday","no_sled","1","1","1",3.2,0,15,0,27,21.3,0,-2,0,-1,0,-2,-2,-3
"42",2018-01-01,"Brush Creek Trailhead","w1718","Mechanized",1,"Mon","weekday","no_sled","1","1","1",3.2,0,15,0,27,21.3,0,-2,0,-1,0,-2,-2,-3
"43",2018-01-01,"Brush Creek Trailhead","w1718","Motorized",0,"Mon","weekday","sled","1","1","1",3.2,0,15,0,27,21.3,0,-2,0,-1,0,-2,-2,-3
"44",2018-01-01,"Brush Creek Trailhead","w1718","Hybrid",NA,"Mon","weekday","sled","1","1","1",3.2,0,15,0,27,21.3,0,-2,0,-1,0,-2,-2,-3
"45",2018-01-02,"Brush Creek Trailhead","w1718","Non.motorized",13,"Tue","weekday","no_sled","1","1","1",3.2,0,15,0,22,21.3,0,0,-2,0,0,0,-2,-2
"46",2018-01-02,"Brush Creek Trailhead","w1718","Mechanized",1,"Tue","weekday","no_sled","1","1","1",3.2,0,15,0,22,21.3,0,0,-2,0,0,0,-2,-2
"47",2018-01-02,"Brush Creek Trailhead","w1718","Motorized",0,"Tue","weekday","sled","1","1","1",3.2,0,15,0,22,21.3,0,0,-2,0,0,0,-2,-2
"48",2018-01-02,"Brush Creek Trailhead","w1718","Hybrid",NA,"Tue","weekday","sled","1","1","1",3.2,0,15,0,22,21.3,0,0,-2,0,0,0,-2,-2
"49",2018-01-03,"Brush Creek Trailhead","w1718","Non.motorized",24,"Wed","weekday","no_sled","1","1","1",3.2,0,15,0,27,21.3,0,0,0,-2,0,0,0,-2
"50",2018-01-03,"Brush Creek Trailhead","w1718","Mechanized",0,"Wed","weekday","no_sled","1","1","1",3.2,0,15,0,27,21.3,0,0,0,-2,0,0,0,-2
"51",2018-01-03,"Brush Creek Trailhead","w1718","Motorized",0,"Wed","weekday","sled","1","1","1",3.2,0,15,0,27,21.3,0,0,0,-2,0,0,0,-2
"52",2018-01-03,"Brush Creek Trailhead","w1718","Hybrid",NA,"Wed","weekday","sled","1","1","1",3.2,0,15,0,27,21.3,0,0,0,-2,0,0,0,-2
"53",2018-01-04,"Brush Creek Trailhead","w1718","Non.motorized",15,"Thu","weekday","no_sled","1","1","1",3.2,0,15,0,29,21.3,0,0,0,0,0,0,0,0
"54",2018-01-04,"Brush Creek Trailhead","w1718","Mechanized",0,"Thu","weekday","no_sled","1","1","1",3.2,0,15,0,29,21.3,0,0,0,0,0,0,0,0
"55",2018-01-04,"Brush Creek Trailhead","w1718","Motorized",0,"Thu","weekday","sled","1","1","1",3.2,0,15,0,29,21.3,0,0,0,0,0,0,0,0
"56",2018-01-04,"Brush Creek Trailhead","w1718","Hybrid",NA,"Thu","weekday","sled","1","1","1",3.2,0,15,0,29,21.3,0,0,0,0,0,0,0,0
"57",2018-01-05,"Brush Creek Trailhead","w1718","Non.motorized",14,"Fri","weekday","no_sled","1","1","1",3.2,0,14,-1,32,22.9,0,0,0,0,-1,-1,-1,-1
"58",2018-01-05,"Brush Creek Trailhead","w1718","Mechanized",0,"Fri","weekday","no_sled","1","1","1",3.2,0,14,-1,32,22.9,0,0,0,0,-1,-1,-1,-1
"59",2018-01-05,"Brush Creek Trailhead","w1718","Motorized",0,"Fri","weekday","sled","1","1","1",3.2,0,14,-1,32,22.9,0,0,0,0,-1,-1,-1,-1
"60",2018-01-05,"Brush Creek Trailhead","w1718","Hybrid",NA,"Fri","weekday","sled","1","1","1",3.2,0,14,-1,32,22.9,0,0,0,0,-1,-1,-1,-1
"61",2018-01-06,"Brush Creek Trailhead","w1718","Non.motorized",16,"Sat","weekend","no_sled","1","1","1",3.2,0,14,0,30,22.9,-1,0,0,0,-1,-1,-1,-1
"62",2018-01-06,"Brush Creek Trailhead","w1718","Mechanized",0,"Sat","weekend","no_sled","1","1","1",3.2,0,14,0,30,22.9,-1,0,0,0,-1,-1,-1,-1
"63",2018-01-06,"Brush Creek Trailhead","w1718","Motorized",0,"Sat","weekend","sled","1","1","1",3.2,0,14,0,30,22.9,-1,0,0,0,-1,-1,-1,-1
"64",2018-01-06,"Brush Creek Trailhead","w1718","Hybrid",NA,"Sat","weekend","sled","1","1","1",3.2,0,14,0,30,22.9,-1,0,0,0,-1,-1,-1,-1
"65",2018-01-07,"Brush Creek Trailhead","w1718","Non.motorized",24,"Sun","weekend","no_sled","2","2","2",3.5,0.3,18,4,25,19.4,0,-1,0,0,4,3,3,3
"66",2018-01-07,"Brush Creek Trailhead","w1718","Mechanized",0,"Sun","weekend","no_sled","2","2","2",3.5,0.3,18,4,25,19.4,0,-1,0,0,4,3,3,3
"67",2018-01-07,"Brush Creek Trailhead","w1718","Motorized",0,"Sun","weekend","sled","2","2","2",3.5,0.3,18,4,25,19.4,0,-1,0,0,4,3,3,3
"68",2018-01-07,"Brush Creek Trailhead","w1718","Hybrid",NA,"Sun","weekend","sled","2","2","2",3.5,0.3,18,4,25,19.4,0,-1,0,0,4,3,3,3
"69",2018-01-08,"Brush Creek Trailhead","w1718","Non.motorized",9,"Mon","weekday","no_sled","2","2","1",3.7,0.2,20,2,29,18.5,4,0,-1,0,6,6,5,5
"70",2018-01-08,"Brush Creek Trailhead","w1718","Mechanized",0,"Mon","weekday","no_sled","2","2","1",3.7,0.2,20,2,29,18.5,4,0,-1,0,6,6,5,5
"71",2018-01-08,"Brush Creek Trailhead","w1718","Motorized",0,"Mon","weekday","sled","2","2","1",3.7,0.2,20,2,29,18.5,4,0,-1,0,6,6,5,5
"72",2018-01-08,"Brush Creek Trailhead","w1718","Hybrid",NA,"Mon","weekday","sled","2","2","1",3.7,0.2,20,2,29,18.5,4,0,-1,0,6,6,5,5
"73",2018-01-09,"Brush Creek Trailhead","w1718","Non.motorized",14,"Tue","weekday","no_sled","2","2","1",3.8,0.1,21,1,34,18.1,2,4,0,-1,3,7,7,6
"74",2018-01-09,"Brush Creek Trailhead","w1718","Mechanized",0,"Tue","weekday","no_sled","2","2","1",3.8,0.1,21,1,34,18.1,2,4,0,-1,3,7,7,6
"75",2018-01-09,"Brush Creek Trailhead","w1718","Motorized",0,"Tue","weekday","sled","2","2","1",3.8,0.1,21,1,34,18.1,2,4,0,-1,3,7,7,6
"76",2018-01-09,"Brush Creek Trailhead","w1718","Hybrid",NA,"Tue","weekday","sled","2","2","1",3.8,0.1,21,1,34,18.1,2,4,0,-1,3,7,7,6
"77",2018-01-10,"Brush Creek Trailhead","w1718","Non.motorized",1,"Wed","weekday","no_sled","3","3","3",4,0.2,21,0,28,19,1,2,4,0,1,3,7,7
"78",2018-01-10,"Brush Creek Trailhead","w1718","Mechanized",0,"Wed","weekday","no_sled","3","3","3",4,0.2,21,0,28,19,1,2,4,0,1,3,7,7
"79",2018-01-10,"Brush Creek Trailhead","w1718","Motorized",0,"Wed","weekday","sled","3","3","3",4,0.2,21,0,28,19,1,2,4,0,1,3,7,7
"80",2018-01-10,"Brush Creek Trailhead","w1718","Hybrid",NA,"Wed","weekday","sled","3","3","3",4,0.2,21,0,28,19,1,2,4,0,1,3,7,7
"81",2018-01-11,"Brush Creek Trailhead","w1718","Non.motorized",9,"Thu","weekday","no_sled","3","3","3",4.1,0.1,26,5,17,15.8,0,1,2,4,5,6,8,12
"82",2018-01-11,"Brush Creek Trailhead","w1718","Mechanized",0,"Thu","weekday","no_sled","3","3","3",4.1,0.1,26,5,17,15.8,0,1,2,4,5,6,8,12
"83",2018-01-11,"Brush Creek Trailhead","w1718","Motorized",0,"Thu","weekday","sled","3","3","3",4.1,0.1,26,5,17,15.8,0,1,2,4,5,6,8,12
"84",2018-01-11,"Brush Creek Trailhead","w1718","Hybrid",NA,"Thu","weekday","sled","3","3","3",4.1,0.1,26,5,17,15.8,0,1,2,4,5,6,8,12
"85",2018-01-12,"Brush Creek Trailhead","w1718","Non.motorized",1,"Fri","weekday","no_sled","3","3","3",4.3,0.2,24,-2,22,17.9,5,0,1,2,3,3,4,6
"86",2018-01-12,"Brush Creek Trailhead","w1718","Mechanized",0,"Fri","weekday","no_sled","3","3","3",4.3,0.2,24,-2,22,17.9,5,0,1,2,3,3,4,6
"87",2018-01-12,"Brush Creek Trailhead","w1718","Motorized",0,"Fri","weekday","sled","3","3","3",4.3,0.2,24,-2,22,17.9,5,0,1,2,3,3,4,6
"88",2018-01-12,"Brush Creek Trailhead","w1718","Hybrid",NA,"Fri","weekday","sled","3","3","3",4.3,0.2,24,-2,22,17.9,5,0,1,2,3,3,4,6
"89",2018-01-13,"Brush Creek Trailhead","w1718","Non.motorized",8,"Sat","weekend","no_sled","3","3","3",4.4,0.1,24,0,24,18.3,-2,5,0,1,-2,3,3,4
"90",2018-01-13,"Brush Creek Trailhead","w1718","Mechanized",0,"Sat","weekend","no_sled","3","3","3",4.4,0.1,24,0,24,18.3,-2,5,0,1,-2,3,3,4
"91",2018-01-13,"Brush Creek Trailhead","w1718","Motorized",0,"Sat","weekend","sled","3","3","3",4.4,0.1,24,0,24,18.3,-2,5,0,1,-2,3,3,4
"92",2018-01-13,"Brush Creek Trailhead","w1718","Hybrid",NA,"Sat","weekend","sled","3","3","3",4.4,0.1,24,0,24,18.3,-2,5,0,1,-2,3,3,4
"93",2018-01-14,"Brush Creek Trailhead","w1718","Non.motorized",19,"Sun","weekend","no_sled","3","3","2",4.4,0,24,0,27,18.3,0,-2,5,0,0,-2,3,3
"94",2018-01-14,"Brush Creek Trailhead","w1718","Mechanized",0,"Sun","weekend","no_sled","3","3","2",4.4,0,24,0,27,18.3,0,-2,5,0,0,-2,3,3
"95",2018-01-14,"Brush Creek Trailhead","w1718","Motorized",0,"Sun","weekend","sled","3","3","2",4.4,0,24,0,27,18.3,0,-2,5,0,0,-2,3,3
"96",2018-01-14,"Brush Creek Trailhead","w1718","Hybrid",NA,"Sun","weekend","sled","3","3","2",4.4,0,24,0,27,18.3,0,-2,5,0,0,-2,3,3
"97",2018-01-15,"Brush Creek Trailhead","w1718","Non.motorized",23,"Mon","weekday","no_sled","3","3","2",4.4,0,23,-1,27,19.1,0,0,-2,5,-1,-1,-3,2
"98",2018-01-15,"Brush Creek Trailhead","w1718","Mechanized",0,"Mon","weekday","no_sled","3","3","2",4.4,0,23,-1,27,19.1,0,0,-2,5,-1,-1,-3,2
"99",2018-01-15,"Brush Creek Trailhead","w1718","Motorized",0,"Mon","weekday","sled","3","3","2",4.4,0,23,-1,27,19.1,0,0,-2,5,-1,-1,-3,2
"100",2018-01-15,"Brush Creek Trailhead","w1718","Hybrid",NA,"Mon","weekday","sled","3","3","2",4.4,0,23,-1,27,19.1,0,0,-2,5,-1,-1,-3,2
"101",2018-01-16,"Brush Creek Trailhead","w1718","Non.motorized",6,"Tue","weekday","no_sled","3","3","2",4.4,0,22,-1,20,20,-1,0,0,-2,-2,-2,-2,-4
"102",2018-01-16,"Brush Creek Trailhead","w1718","Mechanized",0,"Tue","weekday","no_sled","3","3","2",4.4,0,22,-1,20,20,-1,0,0,-2,-2,-2,-2,-4
"103",2018-01-16,"Brush Creek Trailhead","w1718","Motorized",0,"Tue","weekday","sled","3","3","2",4.4,0,22,-1,20,20,-1,0,0,-2,-2,-2,-2,-4
"104",2018-01-16,"Brush Creek Trailhead","w1718","Hybrid",NA,"Tue","weekday","sled","3","3","2",4.4,0,22,-1,20,20,-1,0,0,-2,-2,-2,-2,-4
"105",2018-01-17,"Brush Creek Trailhead","w1718","Non.motorized",6,"Wed","weekday","no_sled","2","2","2",4.4,0,22,0,24,20,-1,-1,0,0,-1,-2,-2,-2
"106",2018-01-17,"Brush Creek Trailhead","w1718","Mechanized",0,"Wed","weekday","no_sled","2","2","2",4.4,0,22,0,24,20,-1,-1,0,0,-1,-2,-2,-2
"107",2018-01-17,"Brush Creek Trailhead","w1718","Motorized",0,"Wed","weekday","sled","2","2","2",4.4,0,22,0,24,20,-1,-1,0,0,-1,-2,-2,-2
"108",2018-01-17,"Brush Creek Trailhead","w1718","Hybrid",NA,"Wed","weekday","sled","2","2","2",4.4,0,22,0,24,20,-1,-1,0,0,-1,-2,-2,-2
"109",2018-01-18,"Brush Creek Trailhead","w1718","Non.motorized",4,"Thu","weekday","no_sled","2","2","2",4.4,0,21,-1,29,21,0,-1,-1,0,-1,-2,-3,-3
"110",2018-01-18,"Brush Creek Trailhead","w1718","Mechanized",0,"Thu","weekday","no_sled","2","2","2",4.4,0,21,-1,29,21,0,-1,-1,0,-1,-2,-3,-3
"111",2018-01-18,"Brush Creek Trailhead","w1718","Motorized",0,"Thu","weekday","sled","2","2","2",4.4,0,21,-1,29,21,0,-1,-1,0,-1,-2,-3,-3
"112",2018-01-18,"Brush Creek Trailhead","w1718","Hybrid",NA,"Thu","weekday","sled","2","2","2",4.4,0,21,-1,29,21,0,-1,-1,0,-1,-2,-3,-3
"113",2018-01-19,"Brush Creek Trailhead","w1718","Non.motorized",7,"Fri","weekday","no_sled","2","2","2",4.5,0.1,21,0,34,21.4,-1,0,-1,-1,-1,-1,-2,-3
"114",2018-01-19,"Brush Creek Trailhead","w1718","Mechanized",1,"Fri","weekday","no_sled","2","2","2",4.5,0.1,21,0,34,21.4,-1,0,-1,-1,-1,-1,-2,-3
"115",2018-01-19,"Brush Creek Trailhead","w1718","Motorized",0,"Fri","weekday","sled","2","2","2",4.5,0.1,21,0,34,21.4,-1,0,-1,-1,-1,-1,-2,-3
"116",2018-01-19,"Brush Creek Trailhead","w1718","Hybrid",NA,"Fri","weekday","sled","2","2","2",4.5,0.1,21,0,34,21.4,-1,0,-1,-1,-1,-1,-2,-3
"117",2018-01-20,"Brush Creek Trailhead","w1718","Non.motorized",16,"Sat","weekend","no_sled","2","2","2",4.5,0,21,0,32,21.4,0,-1,0,-1,0,-1,-1,-2
"118",2018-01-20,"Brush Creek Trailhead","w1718","Mechanized",1,"Sat","weekend","no_sled","2","2","2",4.5,0,21,0,32,21.4,0,-1,0,-1,0,-1,-1,-2
"119",2018-01-20,"Brush Creek Trailhead","w1718","Motorized",0,"Sat","weekend","sled","2","2","2",4.5,0,21,0,32,21.4,0,-1,0,-1,0,-1,-1,-2
"120",2018-01-20,"Brush Creek Trailhead","w1718","Hybrid",NA,"Sat","weekend","sled","2","2","2",4.5,0,21,0,32,21.4,0,-1,0,-1,0,-1,-1,-2
"121",2018-01-21,"Brush Creek Trailhead","w1718","Non.motorized",12,"Sun","weekend","no_sled","3","3","3",4.6,0.1,23,2,15,20,0,0,-1,0,2,2,1,1
"122",2018-01-21,"Brush Creek Trailhead","w1718","Mechanized",0,"Sun","weekend","no_sled","3","3","3",4.6,0.1,23,2,15,20,0,0,-1,0,2,2,1,1
"123",2018-01-21,"Brush Creek Trailhead","w1718","Motorized",0,"Sun","weekend","sled","3","3","3",4.6,0.1,23,2,15,20,0,0,-1,0,2,2,1,1
"124",2018-01-21,"Brush Creek Trailhead","w1718","Hybrid",NA,"Sun","weekend","sled","3","3","3",4.6,0.1,23,2,15,20,0,0,-1,0,2,2,1,1
"125",2018-01-22,"Brush Creek Trailhead","w1718","Non.motorized",10,"Mon","weekday","no_sled","3","3","3",4.6,0,21,-2,12,21.9,2,0,0,-1,0,0,0,-1
"126",2018-01-22,"Brush Creek Trailhead","w1718","Mechanized",0,"Mon","weekday","no_sled","3","3","3",4.6,0,21,-2,12,21.9,2,0,0,-1,0,0,0,-1
"127",2018-01-22,"Brush Creek Trailhead","w1718","Motorized",0,"Mon","weekday","sled","3","3","3",4.6,0,21,-2,12,21.9,2,0,0,-1,0,0,0,-1
"128",2018-01-22,"Brush Creek Trailhead","w1718","Hybrid",NA,"Mon","weekday","sled","3","3","3",4.6,0,21,-2,12,21.9,2,0,0,-1,0,0,0,-1
"129",2018-01-23,"Brush Creek Trailhead","w1718","Non.motorized",8,"Tue","weekday","no_sled","3","3","3",4.6,0,22,1,16,20.9,-2,2,0,0,-1,1,1,1
"130",2018-01-23,"Brush Creek Trailhead","w1718","Mechanized",0,"Tue","weekday","no_sled","3","3","3",4.6,0,22,1,16,20.9,-2,2,0,0,-1,1,1,1
"131",2018-01-23,"Brush Creek Trailhead","w1718","Motorized",0,"Tue","weekday","sled","3","3","3",4.6,0,22,1,16,20.9,-2,2,0,0,-1,1,1,1
"132",2018-01-23,"Brush Creek Trailhead","w1718","Hybrid",NA,"Tue","weekday","sled","3","3","3",4.6,0,22,1,16,20.9,-2,2,0,0,-1,1,1,1
"133",2018-01-24,"Brush Creek Trailhead","w1718","Non.motorized",16,"Wed","weekday","no_sled","2","2","2",4.6,0,22,0,22,20.9,1,-2,2,0,1,-1,1,1
"134",2018-01-24,"Brush Creek Trailhead","w1718","Mechanized",0,"Wed","weekday","no_sled","2","2","2",4.6,0,22,0,22,20.9,1,-2,2,0,1,-1,1,1
"135",2018-01-24,"Brush Creek Trailhead","w1718","Motorized",0,"Wed","weekday","sled","2","2","2",4.6,0,22,0,22,20.9,1,-2,2,0,1,-1,1,1
"136",2018-01-24,"Brush Creek Trailhead","w1718","Hybrid",NA,"Wed","weekday","sled","2","2","2",4.6,0,22,0,22,20.9,1,-2,2,0,1,-1,1,1
"137",2018-01-25,"Brush Creek Trailhead","w1718","Non.motorized",19,"Thu","weekday","no_sled","2","2","2",4.6,0,22,0,28,20.9,0,1,-2,2,0,1,-1,1
"138",2018-01-25,"Brush Creek Trailhead","w1718","Mechanized",0,"Thu","weekday","no_sled","2","2","2",4.6,0,22,0,28,20.9,0,1,-2,2,0,1,-1,1
"139",2018-01-25,"Brush Creek Trailhead","w1718","Motorized",0,"Thu","weekday","sled","2","2","2",4.6,0,22,0,28,20.9,0,1,-2,2,0,1,-1,1
"140",2018-01-25,"Brush Creek Trailhead","w1718","Hybrid",NA,"Thu","weekday","sled","2","2","2",4.6,0,22,0,28,20.9,0,1,-2,2,0,1,-1,1
"141",2018-01-26,"Brush Creek Trailhead","w1718","Non.motorized",11,"Fri","weekday","no_sled","2","2","2",4.7,0.1,22,0,15,21.4,0,0,1,-2,0,0,1,-1
"142",2018-01-26,"Brush Creek Trailhead","w1718","Mechanized",3,"Fri","weekday","no_sled","2","2","2",4.7,0.1,22,0,15,21.4,0,0,1,-2,0,0,1,-1
"143",2018-01-26,"Brush Creek Trailhead","w1718","Motorized",0,"Fri","weekday","sled","2","2","2",4.7,0.1,22,0,15,21.4,0,0,1,-2,0,0,1,-1
"144",2018-01-26,"Brush Creek Trailhead","w1718","Hybrid",NA,"Fri","weekday","sled","2","2","2",4.7,0.1,22,0,15,21.4,0,0,1,-2,0,0,1,-1
"145",2018-01-27,"Brush Creek Trailhead","w1718","Non.motorized",21,"Sat","weekend","no_sled","2","2","2",4.7,0,23,1,16,20.4,0,0,0,1,1,1,1,2
"146",2018-01-27,"Brush Creek Trailhead","w1718","Mechanized",0,"Sat","weekend","no_sled","2","2","2",4.7,0,23,1,16,20.4,0,0,0,1,1,1,1,2
"147",2018-01-27,"Brush Creek Trailhead","w1718","Motorized",0,"Sat","weekend","sled","2","2","2",4.7,0,23,1,16,20.4,0,0,0,1,1,1,1,2
"148",2018-01-27,"Brush Creek Trailhead","w1718","Hybrid",NA,"Sat","weekend","sled","2","2","2",4.7,0,23,1,16,20.4,0,0,0,1,1,1,1,2
"149",2018-01-28,"Brush Creek Trailhead","w1718","Non.motorized",18,"Sun","weekend","no_sled","2","2","2",4.7,0,23,0,25,20.4,1,0,0,0,1,1,1,1
"150",2018-01-28,"Brush Creek Trailhead","w1718","Mechanized",0,"Sun","weekend","no_sled","2","2","2",4.7,0,23,0,25,20.4,1,0,0,0,1,1,1,1
"151",2018-01-28,"Brush Creek Trailhead","w1718","Motorized",0,"Sun","weekend","sled","2","2","2",4.7,0,23,0,25,20.4,1,0,0,0,1,1,1,1
"152",2018-01-28,"Brush Creek Trailhead","w1718","Hybrid",NA,"Sun","weekend","sled","2","2","2",4.7,0,23,0,25,20.4,1,0,0,0,1,1,1,1
"153",2018-01-29,"Brush Creek Trailhead","w1718","Non.motorized",22,"Mon","weekday","no_sled","2","2","2",4.8,0.1,22,-1,30,21.8,0,1,0,0,-1,0,0,0
"154",2018-01-29,"Brush Creek Trailhead","w1718","Mechanized",0,"Mon","weekday","no_sled","2","2","2",4.8,0.1,22,-1,30,21.8,0,1,0,0,-1,0,0,0
"155",2018-01-29,"Brush Creek Trailhead","w1718","Motorized",0,"Mon","weekday","sled","2","2","2",4.8,0.1,22,-1,30,21.8,0,1,0,0,-1,0,0,0
"156",2018-01-29,"Brush Creek Trailhead","w1718","Hybrid",NA,"Mon","weekday","sled","2","2","2",4.8,0.1,22,-1,30,21.8,0,1,0,0,-1,0,0,0
"157",2018-01-30,"Brush Creek Trailhead","w1718","Non.motorized",17,"Tue","weekday","no_sled","2","2","2",4.8,0,22,0,34,21.8,-1,0,1,0,-1,-1,0,0
"158",2018-01-30,"Brush Creek Trailhead","w1718","Mechanized",0,"Tue","weekday","no_sled","2","2","2",4.8,0,22,0,34,21.8,-1,0,1,0,-1,-1,0,0
"159",2018-01-30,"Brush Creek Trailhead","w1718","Motorized",0,"Tue","weekday","sled","2","2","2",4.8,0,22,0,34,21.8,-1,0,1,0,-1,-1,0,0
"160",2018-01-30,"Brush Creek Trailhead","w1718","Hybrid",NA,"Tue","weekday","sled","2","2","2",4.8,0,22,0,34,21.8,-1,0,1,0,-1,-1,0,0
"161",2018-01-31,"Brush Creek Trailhead","w1718","Non.motorized",25,"Wed","weekday","no_sled","2","2","2",4.8,0,22,0,34,21.8,0,-1,0,1,0,-1,-1,0
"162",2018-01-31,"Brush Creek Trailhead","w1718","Mechanized",0,"Wed","weekday","no_sled","2","2","2",4.8,0,22,0,34,21.8,0,-1,0,1,0,-1,-1,0
"163",2018-01-31,"Brush Creek Trailhead","w1718","Motorized",0,"Wed","weekday","sled","2","2","2",4.8,0,22,0,34,21.8,0,-1,0,1,0,-1,-1,0
"164",2018-01-31,"Brush Creek Trailhead","w1718","Hybrid",NA,"Wed","weekday","sled","2","2","2",4.8,0,22,0,34,21.8,0,-1,0,1,0,-1,-1,0
"165",2018-02-01,"Brush Creek Trailhead","w1718","Non.motorized",11,"Thu","weekday","no_sled","2","2","2",4.9,0.1,21,-1,32,23.3,0,0,-1,0,-1,-1,-2,-2
"166",2018-02-01,"Brush Creek Trailhead","w1718","Mechanized",0,"Thu","weekday","no_sled","2","2","2",4.9,0.1,21,-1,32,23.3,0,0,-1,0,-1,-1,-2,-2
"167",2018-02-01,"Brush Creek Trailhead","w1718","Motorized",0,"Thu","weekday","sled","2","2","2",4.9,0.1,21,-1,32,23.3,0,0,-1,0,-1,-1,-2,-2
"168",2018-02-01,"Brush Creek Trailhead","w1718","Hybrid",NA,"Thu","weekday","sled","2","2","2",4.9,0.1,21,-1,32,23.3,0,0,-1,0,-1,-1,-2,-2
"169",2018-02-02,"Brush Creek Trailhead","w1718","Non.motorized",18,"Fri","weekday","no_sled","2","2","2",4.9,0,20,-1,33,24.5,-1,0,0,-1,-2,-2,-2,-3
"170",2018-02-02,"Brush Creek Trailhead","w1718","Mechanized",0,"Fri","weekday","no_sled","2","2","2",4.9,0,20,-1,33,24.5,-1,0,0,-1,-2,-2,-2,-3
"171",2018-02-02,"Brush Creek Trailhead","w1718","Motorized",0,"Fri","weekday","sled","2","2","2",4.9,0,20,-1,33,24.5,-1,0,0,-1,-2,-2,-2,-3
"172",2018-02-02,"Brush Creek Trailhead","w1718","Hybrid",NA,"Fri","weekday","sled","2","2","2",4.9,0,20,-1,33,24.5,-1,0,0,-1,-2,-2,-2,-3
"173",2018-02-03,"Brush Creek Trailhead","w1718","Non.motorized",19,"Sat","weekend","no_sled","2","2","2",4.9,0,21,1,32,23.3,-1,-1,0,0,0,-1,-1,-1
"174",2018-02-03,"Brush Creek Trailhead","w1718","Mechanized",0,"Sat","weekend","no_sled","2","2","2",4.9,0,21,1,32,23.3,-1,-1,0,0,0,-1,-1,-1
"175",2018-02-03,"Brush Creek Trailhead","w1718","Motorized",0,"Sat","weekend","sled","2","2","2",4.9,0,21,1,32,23.3,-1,-1,0,0,0,-1,-1,-1
"176",2018-02-03,"Brush Creek Trailhead","w1718","Hybrid",NA,"Sat","weekend","sled","2","2","2",4.9,0,21,1,32,23.3,-1,-1,0,0,0,-1,-1,-1
"177",2018-02-04,"Brush Creek Trailhead","w1718","Non.motorized",18,"Sun","weekend","no_sled","2","2","2",4.9,0,19,-2,32,25.8,1,-1,-1,0,-1,-2,-3,-3
"178",2018-02-04,"Brush Creek Trailhead","w1718","Mechanized",1,"Sun","weekend","no_sled","2","2","2",4.9,0,19,-2,32,25.8,1,-1,-1,0,-1,-2,-3,-3
"179",2018-02-04,"Brush Creek Trailhead","w1718","Motorized",0,"Sun","weekend","sled","2","2","2",4.9,0,19,-2,32,25.8,1,-1,-1,0,-1,-2,-3,-3
"180",2018-02-04,"Brush Creek Trailhead","w1718","Hybrid",NA,"Sun","weekend","sled","2","2","2",4.9,0,19,-2,32,25.8,1,-1,-1,0,-1,-2,-3,-3
"181",2018-02-05,"Brush Creek Trailhead","w1718","Non.motorized",0,"Mon","weekday","no_sled","2","2","2",5,0.1,18,-1,29,27.8,-2,1,-1,-1,-3,-2,-3,-4
"182",2018-02-05,"Brush Creek Trailhead","w1718","Mechanized",0,"Mon","weekday","no_sled","2","2","2",5,0.1,18,-1,29,27.8,-2,1,-1,-1,-3,-2,-3,-4
"183",2018-02-05,"Brush Creek Trailhead","w1718","Motorized",0,"Mon","weekday","sled","2","2","2",5,0.1,18,-1,29,27.8,-2,1,-1,-1,-3,-2,-3,-4
"184",2018-02-05,"Brush Creek Trailhead","w1718","Hybrid",NA,"Mon","weekday","sled","2","2","2",5,0.1,18,-1,29,27.8,-2,1,-1,-1,-3,-2,-3,-4
"185",2018-02-06,"Brush Creek Trailhead","w1718","Non.motorized",11,"Tue","weekday","no_sled","2","2","2",5.2,0.2,23,5,22,22.6,-1,-2,1,-1,4,2,3,2
"186",2018-02-06,"Brush Creek Trailhead","w1718","Mechanized",0,"Tue","weekday","no_sled","2","2","2",5.2,0.2,23,5,22,22.6,-1,-2,1,-1,4,2,3,2
"187",2018-02-06,"Brush Creek Trailhead","w1718","Motorized",0,"Tue","weekday","sled","2","2","2",5.2,0.2,23,5,22,22.6,-1,-2,1,-1,4,2,3,2
"188",2018-02-06,"Brush Creek Trailhead","w1718","Hybrid",NA,"Tue","weekday","sled","2","2","2",5.2,0.2,23,5,22,22.6,-1,-2,1,-1,4,2,3,2
"189",2018-02-07,"Brush Creek Trailhead","w1718","Non.motorized",19,"Wed","weekday","no_sled","2","2","2",5.2,0,23,0,24,22.6,5,-1,-2,1,5,4,2,3
"190",2018-02-07,"Brush Creek Trailhead","w1718","Mechanized",0,"Wed","weekday","no_sled","2","2","2",5.2,0,23,0,24,22.6,5,-1,-2,1,5,4,2,3
"191",2018-02-07,"Brush Creek Trailhead","w1718","Motorized",0,"Wed","weekday","sled","2","2","2",5.2,0,23,0,24,22.6,5,-1,-2,1,5,4,2,3
"192",2018-02-07,"Brush Creek Trailhead","w1718","Hybrid",NA,"Wed","weekday","sled","2","2","2",5.2,0,23,0,24,22.6,5,-1,-2,1,5,4,2,3
"193",2018-02-08,"Brush Creek Trailhead","w1718","Non.motorized",16,"Thu","weekday","no_sled","2","2","1",5.3,0.1,25,2,28,21.2,0,5,-1,-2,2,7,6,4
"194",2018-02-08,"Brush Creek Trailhead","w1718","Mechanized",0,"Thu","weekday","no_sled","2","2","1",5.3,0.1,25,2,28,21.2,0,5,-1,-2,2,7,6,4
"195",2018-02-08,"Brush Creek Trailhead","w1718","Motorized",0,"Thu","weekday","sled","2","2","1",5.3,0.1,25,2,28,21.2,0,5,-1,-2,2,7,6,4
"196",2018-02-08,"Brush Creek Trailhead","w1718","Hybrid",NA,"Thu","weekday","sled","2","2","1",5.3,0.1,25,2,28,21.2,0,5,-1,-2,2,7,6,4
"197",2018-02-09,"Brush Creek Trailhead","w1718","Non.motorized",19,"Fri","weekday","no_sled","2","2","1",5.3,0,24,-1,33,22.1,2,0,5,-1,1,1,6,5
"198",2018-02-09,"Brush Creek Trailhead","w1718","Mechanized",3,"Fri","weekday","no_sled","2","2","1",5.3,0,24,-1,33,22.1,2,0,5,-1,1,1,6,5
"199",2018-02-09,"Brush Creek Trailhead","w1718","Motorized",0,"Fri","weekday","sled","2","2","1",5.3,0,24,-1,33,22.1,2,0,5,-1,1,1,6,5
"200",2018-02-09,"Brush Creek Trailhead","w1718","Hybrid",NA,"Fri","weekday","sled","2","2","1",5.3,0,24,-1,33,22.1,2,0,5,-1,1,1,6,5
"201",2018-02-10,"Brush Creek Trailhead","w1718","Non.motorized",4,"Sat","weekend","no_sled","3","3","2",5.3,0,24,0,24,22.1,-1,2,0,5,-1,1,1,6
"202",2018-02-10,"Brush Creek Trailhead","w1718","Mechanized",0,"Sat","weekend","no_sled","3","3","2",5.3,0,24,0,24,22.1,-1,2,0,5,-1,1,1,6
"203",2018-02-10,"Brush Creek Trailhead","w1718","Motorized",0,"Sat","weekend","sled","3","3","2",5.3,0,24,0,24,22.1,-1,2,0,5,-1,1,1,6
"204",2018-02-10,"Brush Creek Trailhead","w1718","Hybrid",NA,"Sat","weekend","sled","3","3","2",5.3,0,24,0,24,22.1,-1,2,0,5,-1,1,1,6
"205",2018-02-11,"Brush Creek Trailhead","w1718","Non.motorized",14,"Sun","weekend","no_sled","3","3","2",5.6,0.3,27,3,13,20.7,0,-1,2,0,3,2,4,4
"206",2018-02-11,"Brush Creek Trailhead","w1718","Mechanized",0,"Sun","weekend","no_sled","3","3","2",5.6,0.3,27,3,13,20.7,0,-1,2,0,3,2,4,4
"207",2018-02-11,"Brush Creek Trailhead","w1718","Motorized",0,"Sun","weekend","sled","3","3","2",5.6,0.3,27,3,13,20.7,0,-1,2,0,3,2,4,4
"208",2018-02-11,"Brush Creek Trailhead","w1718","Hybrid",NA,"Sun","weekend","sled","3","3","2",5.6,0.3,27,3,13,20.7,0,-1,2,0,3,2,4,4
"209",2018-02-12,"Brush Creek Trailhead","w1718","Non.motorized",8,"Mon","weekday","no_sled","3","3","3",5.7,0.1,27,0,23,21.1,3,0,-1,2,3,3,2,4
"210",2018-02-12,"Brush Creek Trailhead","w1718","Mechanized",0,"Mon","weekday","no_sled","3","3","3",5.7,0.1,27,0,23,21.1,3,0,-1,2,3,3,2,4
"211",2018-02-12,"Brush Creek Trailhead","w1718","Motorized",0,"Mon","weekday","sled","3","3","3",5.7,0.1,27,0,23,21.1,3,0,-1,2,3,3,2,4
"212",2018-02-12,"Brush Creek Trailhead","w1718","Hybrid",NA,"Mon","weekday","sled","3","3","3",5.7,0.1,27,0,23,21.1,3,0,-1,2,3,3,2,4
"213",2018-02-13,"Brush Creek Trailhead","w1718","Non.motorized",4,"Tue","weekday","no_sled","3","3","3",6.1,0.4,29,2,28,21,0,3,0,-1,2,5,5,4
"214",2018-02-13,"Brush Creek Trailhead","w1718","Mechanized",0,"Tue","weekday","no_sled","3","3","3",6.1,0.4,29,2,28,21,0,3,0,-1,2,5,5,4
"215",2018-02-13,"Brush Creek Trailhead","w1718","Motorized",0,"Tue","weekday","sled","3","3","3",6.1,0.4,29,2,28,21,0,3,0,-1,2,5,5,4
"216",2018-02-13,"Brush Creek Trailhead","w1718","Hybrid",NA,"Tue","weekday","sled","3","3","3",6.1,0.4,29,2,28,21,0,3,0,-1,2,5,5,4
"217",2018-02-14,"Brush Creek Trailhead","w1718","Non.motorized",1,"Wed","weekday","no_sled","3","3","3",6.2,0.1,30,1,30,20.7,2,0,3,0,3,3,6,6
"218",2018-02-14,"Brush Creek Trailhead","w1718","Mechanized",0,"Wed","weekday","no_sled","3","3","3",6.2,0.1,30,1,30,20.7,2,0,3,0,3,3,6,6
"219",2018-02-14,"Brush Creek Trailhead","w1718","Motorized",0,"Wed","weekday","sled","3","3","3",6.2,0.1,30,1,30,20.7,2,0,3,0,3,3,6,6
"220",2018-02-14,"Brush Creek Trailhead","w1718","Hybrid",NA,"Wed","weekday","sled","3","3","3",6.2,0.1,30,1,30,20.7,2,0,3,0,3,3,6,6
"221",2018-02-15,"Brush Creek Trailhead","w1718","Non.motorized",9,"Thu","weekday","no_sled","3","3","3",6.3,0.1,28,-2,24,22.5,1,2,0,3,-1,1,1,4
"222",2018-02-15,"Brush Creek Trailhead","w1718","Mechanized",0,"Thu","weekday","no_sled","3","3","3",6.3,0.1,28,-2,24,22.5,1,2,0,3,-1,1,1,4
"223",2018-02-15,"Brush Creek Trailhead","w1718","Motorized",0,"Thu","weekday","sled","3","3","3",6.3,0.1,28,-2,24,22.5,1,2,0,3,-1,1,1,4
"224",2018-02-15,"Brush Creek Trailhead","w1718","Hybrid",NA,"Thu","weekday","sled","3","3","3",6.3,0.1,28,-2,24,22.5,1,2,0,3,-1,1,1,4
"225",2018-02-16,"Brush Creek Trailhead","w1718","Non.motorized",7,"Fri","weekday","no_sled","3","3","3",6.7,0.4,32,4,18,20.9,-2,1,2,0,2,3,5,5
"226",2018-02-16,"Brush Creek Trailhead","w1718","Mechanized",0,"Fri","weekday","no_sled","3","3","3",6.7,0.4,32,4,18,20.9,-2,1,2,0,2,3,5,5
"227",2018-02-16,"Brush Creek Trailhead","w1718","Motorized",0,"Fri","weekday","sled","3","3","3",6.7,0.4,32,4,18,20.9,-2,1,2,0,2,3,5,5
"228",2018-02-16,"Brush Creek Trailhead","w1718","Hybrid",NA,"Fri","weekday","sled","3","3","3",6.7,0.4,32,4,18,20.9,-2,1,2,0,2,3,5,5
"229",2018-02-17,"Brush Creek Trailhead","w1718","Non.motorized",32,"Sat","weekend","no_sled","3","3","2",6.7,0,32,0,25,20.9,4,-2,1,2,4,2,3,5
"230",2018-02-17,"Brush Creek Trailhead","w1718","Mechanized",2,"Sat","weekend","no_sled","3","3","2",6.7,0,32,0,25,20.9,4,-2,1,2,4,2,3,5
"231",2018-02-17,"Brush Creek Trailhead","w1718","Motorized",2,"Sat","weekend","sled","3","3","2",6.7,0,32,0,25,20.9,4,-2,1,2,4,2,3,5
"232",2018-02-17,"Brush Creek Trailhead","w1718","Hybrid",NA,"Sat","weekend","sled","3","3","2",6.7,0,32,0,25,20.9,4,-2,1,2,4,2,3,5
"233",2018-02-18,"Brush Creek Trailhead","w1718","Non.motorized",38,"Sun","weekend","no_sled","2","2","2",6.7,0,31,-1,32,21.6,0,4,-2,1,-1,3,1,2
"234",2018-02-18,"Brush Creek Trailhead","w1718","Mechanized",0,"Sun","weekend","no_sled","2","2","2",6.7,0,31,-1,32,21.6,0,4,-2,1,-1,3,1,2
"235",2018-02-18,"Brush Creek Trailhead","w1718","Motorized",0,"Sun","weekend","sled","2","2","2",6.7,0,31,-1,32,21.6,0,4,-2,1,-1,3,1,2
"236",2018-02-18,"Brush Creek Trailhead","w1718","Hybrid",NA,"Sun","weekend","sled","2","2","2",6.7,0,31,-1,32,21.6,0,4,-2,1,-1,3,1,2
"237",2018-02-19,"Brush Creek Trailhead","w1718","Non.motorized",6,"Mon","weekday","no_sled","2","2","2",6.8,0.1,29,-2,24,23.4,-1,0,4,-2,-3,-3,1,-1
"238",2018-02-19,"Brush Creek Trailhead","w1718","Non.motorized",6,"Mon","weekday","no_sled","3","3","3",6.8,0.1,29,-2,24,23.4,-1,0,4,-2,-3,-3,1,-1
"239",2018-02-19,"Brush Creek Trailhead","w1718","Mechanized",0,"Mon","weekday","no_sled","2","2","2",6.8,0.1,29,-2,24,23.4,-1,0,4,-2,-3,-3,1,-1
"240",2018-02-19,"Brush Creek Trailhead","w1718","Mechanized",0,"Mon","weekday","no_sled","3","3","3",6.8,0.1,29,-2,24,23.4,-1,0,4,-2,-3,-3,1,-1
"241",2018-02-19,"Brush Creek Trailhead","w1718","Motorized",0,"Mon","weekday","sled","2","2","2",6.8,0.1,29,-2,24,23.4,-1,0,4,-2,-3,-3,1,-1
"242",2018-02-19,"Brush Creek Trailhead","w1718","Motorized",0,"Mon","weekday","sled","3","3","3",6.8,0.1,29,-2,24,23.4,-1,0,4,-2,-3,-3,1,-1
"243",2018-02-19,"Brush Creek Trailhead","w1718","Hybrid",NA,"Mon","weekday","sled","2","2","2",6.8,0.1,29,-2,24,23.4,-1,0,4,-2,-3,-3,1,-1
"244",2018-02-19,"Brush Creek Trailhead","w1718","Hybrid",NA,"Mon","weekday","sled","3","3","3",6.8,0.1,29,-2,24,23.4,-1,0,4,-2,-3,-3,1,-1
"245",2018-02-20,"Brush Creek Trailhead","w1718","Non.motorized",9,"Tue","weekday","no_sled","3","3","3",6.8,0,31,2,8,21.9,-2,-1,0,4,0,-1,-1,3
"246",2018-02-20,"Brush Creek Trailhead","w1718","Mechanized",0,"Tue","weekday","no_sled","3","3","3",6.8,0,31,2,8,21.9,-2,-1,0,4,0,-1,-1,3
"247",2018-02-20,"Brush Creek Trailhead","w1718","Motorized",0,"Tue","weekday","sled","3","3","3",6.8,0,31,2,8,21.9,-2,-1,0,4,0,-1,-1,3
"248",2018-02-20,"Brush Creek Trailhead","w1718","Hybrid",NA,"Tue","weekday","sled","3","3","3",6.8,0,31,2,8,21.9,-2,-1,0,4,0,-1,-1,3
"249",2018-02-21,"Brush Creek Trailhead","w1718","Non.motorized",4,"Wed","weekday","no_sled","3","3","3",6.8,0,31,0,11,21.9,2,-2,-1,0,2,0,-1,-1
"250",2018-02-21,"Brush Creek Trailhead","w1718","Mechanized",0,"Wed","weekday","no_sled","3","3","3",6.8,0,31,0,11,21.9,2,-2,-1,0,2,0,-1,-1
"251",2018-02-21,"Brush Creek Trailhead","w1718","Motorized",0,"Wed","weekday","sled","3","3","3",6.8,0,31,0,11,21.9,2,-2,-1,0,2,0,-1,-1
"252",2018-02-21,"Brush Creek Trailhead","w1718","Hybrid",NA,"Wed","weekday","sled","3","3","3",6.8,0,31,0,11,21.9,2,-2,-1,0,2,0,-1,-1
"253",2018-02-22,"Brush Creek Trailhead","w1718","Non.motorized",18,"Thu","weekday","no_sled","3","3","2",6.8,0,30,-1,16,22.7,0,2,-2,-1,-1,1,-1,-2
"254",2018-02-22,"Brush Creek Trailhead","w1718","Mechanized",0,"Thu","weekday","no_sled","3","3","2",6.8,0,30,-1,16,22.7,0,2,-2,-1,-1,1,-1,-2
"255",2018-02-22,"Brush Creek Trailhead","w1718","Motorized",0,"Thu","weekday","sled","3","3","2",6.8,0,30,-1,16,22.7,0,2,-2,-1,-1,1,-1,-2
"256",2018-02-22,"Brush Creek Trailhead","w1718","Hybrid",NA,"Thu","weekday","sled","3","3","2",6.8,0,30,-1,16,22.7,0,2,-2,-1,-1,1,-1,-2
"257",2018-02-23,"Brush Creek Trailhead","w1718","Non.motorized",19,"Fri","weekday","no_sled","3","3","2",6.9,0.1,30,0,15,23,-1,0,2,-2,-1,-1,1,-1
"258",2018-02-23,"Brush Creek Trailhead","w1718","Mechanized",0,"Fri","weekday","no_sled","3","3","2",6.9,0.1,30,0,15,23,-1,0,2,-2,-1,-1,1,-1
"259",2018-02-23,"Brush Creek Trailhead","w1718","Motorized",0,"Fri","weekday","sled","3","3","2",6.9,0.1,30,0,15,23,-1,0,2,-2,-1,-1,1,-1
"260",2018-02-23,"Brush Creek Trailhead","w1718","Hybrid",NA,"Fri","weekday","sled","3","3","2",6.9,0.1,30,0,15,23,-1,0,2,-2,-1,-1,1,-1
"261",2018-02-24,"Brush Creek Trailhead","w1718","Non.motorized",8,"Sat","weekend","no_sled","3","3","2",6.9,0,31,1,10,22.3,0,-1,0,2,1,0,0,2
"262",2018-02-24,"Brush Creek Trailhead","w1718","Mechanized",0,"Sat","weekend","no_sled","3","3","2",6.9,0,31,1,10,22.3,0,-1,0,2,1,0,0,2
"263",2018-02-24,"Brush Creek Trailhead","w1718","Motorized",0,"Sat","weekend","sled","3","3","2",6.9,0,31,1,10,22.3,0,-1,0,2,1,0,0,2
"264",2018-02-24,"Brush Creek Trailhead","w1718","Hybrid",NA,"Sat","weekend","sled","3","3","2",6.9,0,31,1,10,22.3,0,-1,0,2,1,0,0,2
"265",2018-02-25,"Brush Creek Trailhead","w1718","Non.motorized",25,"Sun","weekend","no_sled","3","3","2",7.1,0.2,32,1,11,22.2,1,0,-1,0,2,2,1,1
"266",2018-02-25,"Brush Creek Trailhead","w1718","Mechanized",0,"Sun","weekend","no_sled","3","3","2",7.1,0.2,32,1,11,22.2,1,0,-1,0,2,2,1,1
"267",2018-02-25,"Brush Creek Trailhead","w1718","Motorized",0,"Sun","weekend","sled","3","3","2",7.1,0.2,32,1,11,22.2,1,0,-1,0,2,2,1,1
"268",2018-02-25,"Brush Creek Trailhead","w1718","Hybrid",NA,"Sun","weekend","sled","3","3","2",7.1,0.2,32,1,11,22.2,1,0,-1,0,2,2,1,1
"269",2018-02-26,"Brush Creek Trailhead","w1718","Non.motorized",13,"Mon","weekday","no_sled","2","2","2",7.1,0,32,0,20,22.2,1,1,0,-1,1,2,2,1
"270",2018-02-26,"Brush Creek Trailhead","w1718","Mechanized",1,"Mon","weekday","no_sled","2","2","2",7.1,0,32,0,20,22.2,1,1,0,-1,1,2,2,1
"271",2018-02-26,"Brush Creek Trailhead","w1718","Motorized",0,"Mon","weekday","sled","2","2","2",7.1,0,32,0,20,22.2,1,1,0,-1,1,2,2,1
"272",2018-02-26,"Brush Creek Trailhead","w1718","Hybrid",NA,"Mon","weekday","sled","2","2","2",7.1,0,32,0,20,22.2,1,1,0,-1,1,2,2,1
"273",2018-02-27,"Brush Creek Trailhead","w1718","Non.motorized",8,"Tue","weekday","no_sled","2","2","2",7.2,0.1,32,0,26,22.5,0,1,1,0,0,1,2,2
"274",2018-02-27,"Brush Creek Trailhead","w1718","Mechanized",1,"Tue","weekday","no_sled","2","2","2",7.2,0.1,32,0,26,22.5,0,1,1,0,0,1,2,2
"275",2018-02-27,"Brush Creek Trailhead","w1718","Motorized",0,"Tue","weekday","sled","2","2","2",7.2,0.1,32,0,26,22.5,0,1,1,0,0,1,2,2
"276",2018-02-27,"Brush Creek Trailhead","w1718","Hybrid",NA,"Tue","weekday","sled","2","2","2",7.2,0.1,32,0,26,22.5,0,1,1,0,0,1,2,2
"277",2018-02-28,"Brush Creek Trailhead","w1718","Non.motorized",13,"Wed","weekday","no_sled","2","2","2",7.2,0,31,-1,23,23.2,0,0,1,1,-1,-1,0,1
"278",2018-02-28,"Brush Creek Trailhead","w1718","Mechanized",0,"Wed","weekday","no_sled","2","2","2",7.2,0,31,-1,23,23.2,0,0,1,1,-1,-1,0,1
"279",2018-02-28,"Brush Creek Trailhead","w1718","Motorized",0,"Wed","weekday","sled","2","2","2",7.2,0,31,-1,23,23.2,0,0,1,1,-1,-1,0,1
"280",2018-02-28,"Brush Creek Trailhead","w1718","Hybrid",NA,"Wed","weekday","sled","2","2","2",7.2,0,31,-1,23,23.2,0,0,1,1,-1,-1,0,1
"281",2018-03-01,"Brush Creek Trailhead","w1718","Non.motorized",7,"Thu","weekday","no_sled","2","2","2",7.2,0,31,0,24,23.2,-1,0,0,1,-1,-1,-1,0
"282",2018-03-01,"Brush Creek Trailhead","w1718","Mechanized",1,"Thu","weekday","no_sled","2","2","2",7.2,0,31,0,24,23.2,-1,0,0,1,-1,-1,-1,0
"283",2018-03-01,"Brush Creek Trailhead","w1718","Motorized",0,"Thu","weekday","sled","2","2","2",7.2,0,31,0,24,23.2,-1,0,0,1,-1,-1,-1,0
"284",2018-03-01,"Brush Creek Trailhead","w1718","Hybrid",NA,"Thu","weekday","sled","2","2","2",7.2,0,31,0,24,23.2,-1,0,0,1,-1,-1,-1,0
"285",2018-03-02,"Brush Creek Trailhead","w1718","Non.motorized",14,"Fri","weekday","no_sled","2","2","1",7.2,0,31,0,30,23.2,0,-1,0,0,0,-1,-1,-1
"286",2018-03-02,"Brush Creek Trailhead","w1718","Mechanized",0,"Fri","weekday","no_sled","2","2","1",7.2,0,31,0,30,23.2,0,-1,0,0,0,-1,-1,-1
"287",2018-03-02,"Brush Creek Trailhead","w1718","Motorized",0,"Fri","weekday","sled","2","2","1",7.2,0,31,0,30,23.2,0,-1,0,0,0,-1,-1,-1
"288",2018-03-02,"Brush Creek Trailhead","w1718","Hybrid",NA,"Fri","weekday","sled","2","2","1",7.2,0,31,0,30,23.2,0,-1,0,0,0,-1,-1,-1
"289",2018-03-03,"Brush Creek Trailhead","w1718","Non.motorized",36,"Sat","weekend","no_sled","2","2","1",7.3,0.1,30,-1,34,24.3,0,0,-1,0,-1,-1,-2,-2
"290",2018-03-03,"Brush Creek Trailhead","w1718","Mechanized",0,"Sat","weekend","no_sled","2","2","1",7.3,0.1,30,-1,34,24.3,0,0,-1,0,-1,-1,-2,-2
"291",2018-03-03,"Brush Creek Trailhead","w1718","Motorized",0,"Sat","weekend","sled","2","2","1",7.3,0.1,30,-1,34,24.3,0,0,-1,0,-1,-1,-2,-2
"292",2018-03-03,"Brush Creek Trailhead","w1718","Hybrid",NA,"Sat","weekend","sled","2","2","1",7.3,0.1,30,-1,34,24.3,0,0,-1,0,-1,-1,-2,-2
"293",2018-03-04,"Brush Creek Trailhead","w1718","Non.motorized",34,"Sun","weekend","no_sled","2","2","1",7.3,0,29,-1,24,25.2,-1,0,0,-1,-2,-2,-2,-3
"294",2018-03-04,"Brush Creek Trailhead","w1718","Mechanized",0,"Sun","weekend","no_sled","2","2","1",7.3,0,29,-1,24,25.2,-1,0,0,-1,-2,-2,-2,-3
"295",2018-03-04,"Brush Creek Trailhead","w1718","Motorized",0,"Sun","weekend","sled","2","2","1",7.3,0,29,-1,24,25.2,-1,0,0,-1,-2,-2,-2,-3
"296",2018-03-04,"Brush Creek Trailhead","w1718","Hybrid",NA,"Sun","weekend","sled","2","2","1",7.3,0,29,-1,24,25.2,-1,0,0,-1,-2,-2,-2,-3
"297",2018-03-05,"Brush Creek Trailhead","w1718","Non.motorized",6,"Mon","weekday","no_sled","2","2","1",7.3,0,31,2,13,23.5,-1,-1,0,0,1,0,0,0
"298",2018-03-05,"Brush Creek Trailhead","w1718","Mechanized",0,"Mon","weekday","no_sled","2","2","1",7.3,0,31,2,13,23.5,-1,-1,0,0,1,0,0,0
"299",2018-03-05,"Brush Creek Trailhead","w1718","Motorized",0,"Mon","weekday","sled","2","2","1",7.3,0,31,2,13,23.5,-1,-1,0,0,1,0,0,0
"300",2018-03-05,"Brush Creek Trailhead","w1718","Hybrid",NA,"Mon","weekday","sled","2","2","1",7.3,0,31,2,13,23.5,-1,-1,0,0,1,0,0,0
"301",2018-03-06,"Brush Creek Trailhead","w1718","Non.motorized",17,"Tue","weekday","no_sled","2","2","1",7.3,0,31,0,19,23.5,2,-1,-1,0,2,1,0,0
"302",2018-03-06,"Brush Creek Trailhead","w1718","Mechanized",0,"Tue","weekday","no_sled","2","2","1",7.3,0,31,0,19,23.5,2,-1,-1,0,2,1,0,0
"303",2018-03-06,"Brush Creek Trailhead","w1718","Motorized",0,"Tue","weekday","sled","2","2","1",7.3,0,31,0,19,23.5,2,-1,-1,0,2,1,0,0
"304",2018-03-06,"Brush Creek Trailhead","w1718","Hybrid",NA,"Tue","weekday","sled","2","2","1",7.3,0,31,0,19,23.5,2,-1,-1,0,2,1,0,0
"305",2018-03-07,"Brush Creek Trailhead","w1718","Non.motorized",17,"Wed","weekday","no_sled","2","2","1",7.4,0.1,31,0,27,23.9,0,2,-1,-1,0,2,1,0
"306",2018-03-07,"Brush Creek Trailhead","w1718","Mechanized",0,"Wed","weekday","no_sled","2","2","1",7.4,0.1,31,0,27,23.9,0,2,-1,-1,0,2,1,0
"307",2018-03-07,"Brush Creek Trailhead","w1718","Motorized",0,"Wed","weekday","sled","2","2","1",7.4,0.1,31,0,27,23.9,0,2,-1,-1,0,2,1,0
"308",2018-03-07,"Brush Creek Trailhead","w1718","Hybrid",NA,"Wed","weekday","sled","2","2","1",7.4,0.1,31,0,27,23.9,0,2,-1,-1,0,2,1,0
"309",2018-03-08,"Brush Creek Trailhead","w1718","Non.motorized",7,"Thu","weekday","no_sled","2","2","1",7.4,0,30,-1,33,24.7,0,0,2,-1,-1,-1,1,0
"310",2018-03-08,"Brush Creek Trailhead","w1718","Mechanized",0,"Thu","weekday","no_sled","2","2","1",7.4,0,30,-1,33,24.7,0,0,2,-1,-1,-1,1,0
"311",2018-03-08,"Brush Creek Trailhead","w1718","Motorized",0,"Thu","weekday","sled","2","2","1",7.4,0,30,-1,33,24.7,0,0,2,-1,-1,-1,1,0
"312",2018-03-08,"Brush Creek Trailhead","w1718","Hybrid",NA,"Thu","weekday","sled","2","2","1",7.4,0,30,-1,33,24.7,0,0,2,-1,-1,-1,1,0
"313",2018-03-09,"Brush Creek Trailhead","w1718","Non.motorized",19,"Fri","weekday","no_sled","2","2","1",7.4,0,30,0,34,24.7,-1,0,0,2,-1,-1,-1,1
"314",2018-03-09,"Brush Creek Trailhead","w1718","Mechanized",0,"Fri","weekday","no_sled","2","2","1",7.4,0,30,0,34,24.7,-1,0,0,2,-1,-1,-1,1
"315",2018-03-09,"Brush Creek Trailhead","w1718","Motorized",0,"Fri","weekday","sled","2","2","1",7.4,0,30,0,34,24.7,-1,0,0,2,-1,-1,-1,1
"316",2018-03-09,"Brush Creek Trailhead","w1718","Hybrid",NA,"Fri","weekday","sled","2","2","1",7.4,0,30,0,34,24.7,-1,0,0,2,-1,-1,-1,1
"317",2018-03-10,"Brush Creek Trailhead","w1718","Non.motorized",12,"Sat","weekend","no_sled","1","1","1",7.4,0,30,0,31,24.7,0,-1,0,0,0,-1,-1,-1
"318",2018-03-10,"Brush Creek Trailhead","w1718","Mechanized",0,"Sat","weekend","no_sled","1","1","1",7.4,0,30,0,31,24.7,0,-1,0,0,0,-1,-1,-1
"319",2018-03-10,"Brush Creek Trailhead","w1718","Motorized",0,"Sat","weekend","sled","1","1","1",7.4,0,30,0,31,24.7,0,-1,0,0,0,-1,-1,-1
"320",2018-03-10,"Brush Creek Trailhead","w1718","Hybrid",NA,"Sat","weekend","sled","1","1","1",7.4,0,30,0,31,24.7,0,-1,0,0,0,-1,-1,-1
"321",2018-03-11,"Brush Creek Trailhead","w1718","Non.motorized",19,"Sun","weekend","no_sled","1","1","1",7.4,0,29,-1,31,25.5,0,0,-1,0,-1,-1,-2,-2
"322",2018-03-11,"Brush Creek Trailhead","w1718","Mechanized",0,"Sun","weekend","no_sled","1","1","1",7.4,0,29,-1,31,25.5,0,0,-1,0,-1,-1,-2,-2
"323",2018-03-11,"Brush Creek Trailhead","w1718","Motorized",0,"Sun","weekend","sled","1","1","1",7.4,0,29,-1,31,25.5,0,0,-1,0,-1,-1,-2,-2
"324",2018-03-11,"Brush Creek Trailhead","w1718","Hybrid",NA,"Sun","weekend","sled","1","1","1",7.4,0,29,-1,31,25.5,0,0,-1,0,-1,-1,-2,-2
"325",2018-03-12,"Brush Creek Trailhead","w1718","Non.motorized",16,"Mon","weekday","no_sled","1","1","1",7.4,0,29,0,33,25.5,-1,0,0,-1,-1,-1,-1,-2
"326",2018-03-12,"Brush Creek Trailhead","w1718","Mechanized",0,"Mon","weekday","no_sled","1","1","1",7.4,0,29,0,33,25.5,-1,0,0,-1,-1,-1,-1,-2
"327",2018-03-12,"Brush Creek Trailhead","w1718","Motorized",0,"Mon","weekday","sled","1","1","1",7.4,0,29,0,33,25.5,-1,0,0,-1,-1,-1,-1,-2
"328",2018-03-12,"Brush Creek Trailhead","w1718","Hybrid",NA,"Mon","weekday","sled","1","1","1",7.4,0,29,0,33,25.5,-1,0,0,-1,-1,-1,-1,-2
"329",2018-03-13,"Brush Creek Trailhead","w1718","Non.motorized",7,"Tue","weekday","no_sled","1","1","1",7.4,0,29,0,34,25.5,0,-1,0,0,0,-1,-1,-1
"330",2018-03-13,"Brush Creek Trailhead","w1718","Mechanized",0,"Tue","weekday","no_sled","1","1","1",7.4,0,29,0,34,25.5,0,-1,0,0,0,-1,-1,-1
"331",2018-03-13,"Brush Creek Trailhead","w1718","Motorized",0,"Tue","weekday","sled","1","1","1",7.4,0,29,0,34,25.5,0,-1,0,0,0,-1,-1,-1
"332",2018-03-13,"Brush Creek Trailhead","w1718","Hybrid",NA,"Tue","weekday","sled","1","1","1",7.4,0,29,0,34,25.5,0,-1,0,0,0,-1,-1,-1
"333",2018-03-14,"Brush Creek Trailhead","w1718","Non.motorized",8,"Wed","weekday","no_sled","1","2","2",7.4,0,29,0,39,25.5,0,0,-1,0,0,0,-1,-1
"334",2018-03-14,"Brush Creek Trailhead","w1718","Mechanized",0,"Wed","weekday","no_sled","1","2","2",7.4,0,29,0,39,25.5,0,0,-1,0,0,0,-1,-1
"335",2018-03-14,"Brush Creek Trailhead","w1718","Motorized",0,"Wed","weekday","sled","1","2","2",7.4,0,29,0,39,25.5,0,0,-1,0,0,0,-1,-1
"336",2018-03-14,"Brush Creek Trailhead","w1718","Hybrid",NA,"Wed","weekday","sled","1","2","2",7.4,0,29,0,39,25.5,0,0,-1,0,0,0,-1,-1
"337",2018-03-15,"Brush Creek Trailhead","w1718","Non.motorized",10,"Thu","weekday","no_sled","2","2","2",7.5,0.1,28,-1,31,26.8,0,0,0,-1,-1,-1,-1,-2
"338",2018-03-15,"Brush Creek Trailhead","w1718","Mechanized",0,"Thu","weekday","no_sled","2","2","2",7.5,0.1,28,-1,31,26.8,0,0,0,-1,-1,-1,-1,-2
"339",2018-03-15,"Brush Creek Trailhead","w1718","Motorized",0,"Thu","weekday","sled","2","2","2",7.5,0.1,28,-1,31,26.8,0,0,0,-1,-1,-1,-1,-2
"340",2018-03-15,"Brush Creek Trailhead","w1718","Hybrid",NA,"Thu","weekday","sled","2","2","2",7.5,0.1,28,-1,31,26.8,0,0,0,-1,-1,-1,-1,-2
"341",2018-03-16,"Brush Creek Trailhead","w1718","Non.motorized",10,"Fri","weekday","no_sled","2","2","2",7.7,0.2,29,1,25,26.6,-1,0,0,0,0,0,0,0
"342",2018-03-16,"Brush Creek Trailhead","w1718","Mechanized",0,"Fri","weekday","no_sled","2","2","2",7.7,0.2,29,1,25,26.6,-1,0,0,0,0,0,0,0
"343",2018-03-16,"Brush Creek Trailhead","w1718","Motorized",0,"Fri","weekday","sled","2","2","2",7.7,0.2,29,1,25,26.6,-1,0,0,0,0,0,0,0
"344",2018-03-16,"Brush Creek Trailhead","w1718","Hybrid",NA,"Fri","weekday","sled","2","2","2",7.7,0.2,29,1,25,26.6,-1,0,0,0,0,0,0,0
"345",2018-03-17,"Brush Creek Trailhead","w1718","Non.motorized",17,"Sat","weekend","no_sled","2","2","2",7.8,0.1,32,3,29,24.4,1,-1,0,0,4,3,3,3
"346",2018-03-17,"Brush Creek Trailhead","w1718","Mechanized",0,"Sat","weekend","no_sled","2","2","2",7.8,0.1,32,3,29,24.4,1,-1,0,0,4,3,3,3
"347",2018-03-17,"Brush Creek Trailhead","w1718","Motorized",0,"Sat","weekend","sled","2","2","2",7.8,0.1,32,3,29,24.4,1,-1,0,0,4,3,3,3
"348",2018-03-17,"Brush Creek Trailhead","w1718","Hybrid",NA,"Sat","weekend","sled","2","2","2",7.8,0.1,32,3,29,24.4,1,-1,0,0,4,3,3,3
"349",2018-03-18,"Brush Creek Trailhead","w1718","Non.motorized",17,"Sun","weekend","no_sled","2","2","2",7.9,0.1,31,-1,24,25.5,3,1,-1,0,2,3,2,2
"350",2018-03-18,"Brush Creek Trailhead","w1718","Mechanized",0,"Sun","weekend","no_sled","2","2","2",7.9,0.1,31,-1,24,25.5,3,1,-1,0,2,3,2,2
"351",2018-03-18,"Brush Creek Trailhead","w1718","Motorized",0,"Sun","weekend","sled","2","2","2",7.9,0.1,31,-1,24,25.5,3,1,-1,0,2,3,2,2
"352",2018-03-18,"Brush Creek Trailhead","w1718","Hybrid",NA,"Sun","weekend","sled","2","2","2",7.9,0.1,31,-1,24,25.5,3,1,-1,0,2,3,2,2
"353",2018-03-19,"Brush Creek Trailhead","w1718","Non.motorized",8,"Mon","weekday","no_sled","2","2","1",8,0.1,32,1,19,25,-1,3,1,-1,0,3,4,3
"354",2018-03-19,"Brush Creek Trailhead","w1718","Mechanized",0,"Mon","weekday","no_sled","2","2","1",8,0.1,32,1,19,25,-1,3,1,-1,0,3,4,3
"355",2018-03-19,"Brush Creek Trailhead","w1718","Motorized",0,"Mon","weekday","sled","2","2","1",8,0.1,32,1,19,25,-1,3,1,-1,0,3,4,3
"356",2018-03-19,"Brush Creek Trailhead","w1718","Hybrid",NA,"Mon","weekday","sled","2","2","1",8,0.1,32,1,19,25,-1,3,1,-1,0,3,4,3
"357",2018-03-20,"Brush Creek Trailhead","w1718","Non.motorized",NA,"Tue","weekday","no_sled","2","2","1",8,0,30,-2,24,26.7,1,-1,3,1,-1,-2,1,2
"358",2018-03-20,"Brush Creek Trailhead","w1718","Mechanized",NA,"Tue","weekday","no_sled","2","2","1",8,0,30,-2,24,26.7,1,-1,3,1,-1,-2,1,2
"359",2018-03-20,"Brush Creek Trailhead","w1718","Motorized",NA,"Tue","weekday","sled","2","2","1",8,0,30,-2,24,26.7,1,-1,3,1,-1,-2,1,2
"360",2018-03-20,"Brush Creek Trailhead","w1718","Hybrid",NA,"Tue","weekday","sled","2","2","1",8,0,30,-2,24,26.7,1,-1,3,1,-1,-2,1,2
"361",2018-03-21,"Brush Creek Trailhead","w1718","Non.motorized",NA,"Wed","weekday","no_sled","1","1","1",8.1,0.1,32,2,30,25.3,-2,1,-1,3,0,1,0,3
"362",2018-03-21,"Brush Creek Trailhead","w1718","Mechanized",NA,"Wed","weekday","no_sled","1","1","1",8.1,0.1,32,2,30,25.3,-2,1,-1,3,0,1,0,3
"363",2018-03-21,"Brush Creek Trailhead","w1718","Motorized",NA,"Wed","weekday","sled","1","1","1",8.1,0.1,32,2,30,25.3,-2,1,-1,3,0,1,0,3
"364",2018-03-21,"Brush Creek Trailhead","w1718","Hybrid",NA,"Wed","weekday","sled","1","1","1",8.1,0.1,32,2,30,25.3,-2,1,-1,3,0,1,0,3
"365",2018-03-22,"Brush Creek Trailhead","w1718","Non.motorized",NA,"Thu","weekday","no_sled","1","1","1",8.1,0,30,-2,36,27,2,-2,1,-1,0,-2,-1,-2
"366",2018-03-22,"Brush Creek Trailhead","w1718","Mechanized",NA,"Thu","weekday","no_sled","1","1","1",8.1,0,30,-2,36,27,2,-2,1,-1,0,-2,-1,-2
"367",2018-03-22,"Brush Creek Trailhead","w1718","Motorized",NA,"Thu","weekday","sled","1","1","1",8.1,0,30,-2,36,27,2,-2,1,-1,0,-2,-1,-2
"368",2018-03-22,"Brush Creek Trailhead","w1718","Hybrid",NA,"Thu","weekday","sled","1","1","1",8.1,0,30,-2,36,27,2,-2,1,-1,0,-2,-1,-2
"369",2018-03-23,"Brush Creek Trailhead","w1718","Non.motorized",1,"Fri","weekday","no_sled","2","2","3",8.2,0.1,29,-1,34,28.3,-2,2,-2,1,-3,-1,-3,-2
"370",2018-03-23,"Brush Creek Trailhead","w1718","Mechanized",0,"Fri","weekday","no_sled","2","2","3",8.2,0.1,29,-1,34,28.3,-2,2,-2,1,-3,-1,-3,-2
"371",2018-03-23,"Brush Creek Trailhead","w1718","Motorized",0,"Fri","weekday","sled","2","2","3",8.2,0.1,29,-1,34,28.3,-2,2,-2,1,-3,-1,-3,-2
"372",2018-03-23,"Brush Creek Trailhead","w1718","Hybrid",NA,"Fri","weekday","sled","2","2","3",8.2,0.1,29,-1,34,28.3,-2,2,-2,1,-3,-1,-3,-2
"373",2018-03-24,"Brush Creek Trailhead","w1718","Non.motorized",4,"Sat","weekend","no_sled","2","2","1",8.9,0.7,34,5,32,26.2,-1,-2,2,-2,4,2,4,2
"374",2018-03-24,"Brush Creek Trailhead","w1718","Mechanized",0,"Sat","weekend","no_sled","2","2","1",8.9,0.7,34,5,32,26.2,-1,-2,2,-2,4,2,4,2
"375",2018-03-24,"Brush Creek Trailhead","w1718","Motorized",0,"Sat","weekend","sled","2","2","1",8.9,0.7,34,5,32,26.2,-1,-2,2,-2,4,2,4,2
"376",2018-03-24,"Brush Creek Trailhead","w1718","Hybrid",NA,"Sat","weekend","sled","2","2","1",8.9,0.7,34,5,32,26.2,-1,-2,2,-2,4,2,4,2
"377",2018-02-06,"Brush Creek Rd","w1718","Non.motorized",5,"Tue","weekday","no_sled","2","2","2",5.2,0.2,23,5,22,22.6,-1,-2,1,-1,4,2,3,2
"378",2018-02-06,"Brush Creek Rd","w1718","Mechanized",0,"Tue","weekday","no_sled","2","2","2",5.2,0.2,23,5,22,22.6,-1,-2,1,-1,4,2,3,2
"379",2018-02-06,"Brush Creek Rd","w1718","Motorized",0,"Tue","weekday","sled","2","2","2",5.2,0.2,23,5,22,22.6,-1,-2,1,-1,4,2,3,2
"380",2018-02-06,"Brush Creek Rd","w1718","Hybrid",0,"Tue","weekday","sled","2","2","2",5.2,0.2,23,5,22,22.6,-1,-2,1,-1,4,2,3,2
"381",2018-02-07,"Brush Creek Rd","w1718","Non.motorized",6,"Wed","weekday","no_sled","2","2","2",5.2,0,23,0,24,22.6,5,-1,-2,1,5,4,2,3
"382",2018-02-07,"Brush Creek Rd","w1718","Mechanized",0,"Wed","weekday","no_sled","2","2","2",5.2,0,23,0,24,22.6,5,-1,-2,1,5,4,2,3
"383",2018-02-07,"Brush Creek Rd","w1718","Motorized",0,"Wed","weekday","sled","2","2","2",5.2,0,23,0,24,22.6,5,-1,-2,1,5,4,2,3
"384",2018-02-07,"Brush Creek Rd","w1718","Hybrid",0,"Wed","weekday","sled","2","2","2",5.2,0,23,0,24,22.6,5,-1,-2,1,5,4,2,3
"385",2018-02-08,"Brush Creek Rd","w1718","Non.motorized",6,"Thu","weekday","no_sled","2","2","1",5.3,0.1,25,2,28,21.2,0,5,-1,-2,2,7,6,4
"386",2018-02-08,"Brush Creek Rd","w1718","Mechanized",0,"Thu","weekday","no_sled","2","2","1",5.3,0.1,25,2,28,21.2,0,5,-1,-2,2,7,6,4
"387",2018-02-08,"Brush Creek Rd","w1718","Motorized",0,"Thu","weekday","sled","2","2","1",5.3,0.1,25,2,28,21.2,0,5,-1,-2,2,7,6,4
"388",2018-02-08,"Brush Creek Rd","w1718","Hybrid",0,"Thu","weekday","sled","2","2","1",5.3,0.1,25,2,28,21.2,0,5,-1,-2,2,7,6,4
"389",2018-02-09,"Brush Creek Rd","w1718","Non.motorized",9,"Fri","weekday","no_sled","2","2","1",5.3,0,24,-1,33,22.1,2,0,5,-1,1,1,6,5
"390",2018-02-09,"Brush Creek Rd","w1718","Mechanized",0,"Fri","weekday","no_sled","2","2","1",5.3,0,24,-1,33,22.1,2,0,5,-1,1,1,6,5
"391",2018-02-09,"Brush Creek Rd","w1718","Motorized",1,"Fri","weekday","sled","2","2","1",5.3,0,24,-1,33,22.1,2,0,5,-1,1,1,6,5
"392",2018-02-09,"Brush Creek Rd","w1718","Hybrid",0,"Fri","weekday","sled","2","2","1",5.3,0,24,-1,33,22.1,2,0,5,-1,1,1,6,5
"393",2018-02-10,"Brush Creek Rd","w1718","Non.motorized",5,"Sat","weekend","no_sled","3","3","2",5.3,0,24,0,24,22.1,-1,2,0,5,-1,1,1,6
"394",2018-02-10,"Brush Creek Rd","w1718","Mechanized",0,"Sat","weekend","no_sled","3","3","2",5.3,0,24,0,24,22.1,-1,2,0,5,-1,1,1,6
"395",2018-02-10,"Brush Creek Rd","w1718","Motorized",0,"Sat","weekend","sled","3","3","2",5.3,0,24,0,24,22.1,-1,2,0,5,-1,1,1,6
"396",2018-02-10,"Brush Creek Rd","w1718","Hybrid",0,"Sat","weekend","sled","3","3","2",5.3,0,24,0,24,22.1,-1,2,0,5,-1,1,1,6
"397",2018-02-11,"Brush Creek Rd","w1718","Non.motorized",11,"Sun","weekend","no_sled","3","3","2",5.6,0.3,27,3,13,20.7,0,-1,2,0,3,2,4,4
"398",2018-02-11,"Brush Creek Rd","w1718","Mechanized",0,"Sun","weekend","no_sled","3","3","2",5.6,0.3,27,3,13,20.7,0,-1,2,0,3,2,4,4
"399",2018-02-11,"Brush Creek Rd","w1718","Motorized",0,"Sun","weekend","sled","3","3","2",5.6,0.3,27,3,13,20.7,0,-1,2,0,3,2,4,4
"400",2018-02-11,"Brush Creek Rd","w1718","Hybrid",0,"Sun","weekend","sled","3","3","2",5.6,0.3,27,3,13,20.7,0,-1,2,0,3,2,4,4
"401",2018-02-12,"Brush Creek Rd","w1718","Non.motorized",1,"Mon","weekday","no_sled","3","3","3",5.7,0.1,27,0,23,21.1,3,0,-1,2,3,3,2,4
"402",2018-02-12,"Brush Creek Rd","w1718","Mechanized",0,"Mon","weekday","no_sled","3","3","3",5.7,0.1,27,0,23,21.1,3,0,-1,2,3,3,2,4
"403",2018-02-12,"Brush Creek Rd","w1718","Motorized",0,"Mon","weekday","sled","3","3","3",5.7,0.1,27,0,23,21.1,3,0,-1,2,3,3,2,4
"404",2018-02-12,"Brush Creek Rd","w1718","Hybrid",0,"Mon","weekday","sled","3","3","3",5.7,0.1,27,0,23,21.1,3,0,-1,2,3,3,2,4
"405",2018-02-13,"Brush Creek Rd","w1718","Non.motorized",0,"Tue","weekday","no_sled","3","3","3",6.1,0.4,29,2,28,21,0,3,0,-1,2,5,5,4
"406",2018-02-13,"Brush Creek Rd","w1718","Mechanized",0,"Tue","weekday","no_sled","3","3","3",6.1,0.4,29,2,28,21,0,3,0,-1,2,5,5,4
"407",2018-02-13,"Brush Creek Rd","w1718","Motorized",0,"Tue","weekday","sled","3","3","3",6.1,0.4,29,2,28,21,0,3,0,-1,2,5,5,4
"408",2018-02-13,"Brush Creek Rd","w1718","Hybrid",0,"Tue","weekday","sled","3","3","3",6.1,0.4,29,2,28,21,0,3,0,-1,2,5,5,4
"409",2018-02-14,"Brush Creek Rd","w1718","Non.motorized",3,"Wed","weekday","no_sled","3","3","3",6.2,0.1,30,1,30,20.7,2,0,3,0,3,3,6,6
"410",2018-02-14,"Brush Creek Rd","w1718","Mechanized",0,"Wed","weekday","no_sled","3","3","3",6.2,0.1,30,1,30,20.7,2,0,3,0,3,3,6,6
"411",2018-02-14,"Brush Creek Rd","w1718","Motorized",1,"Wed","weekday","sled","3","3","3",6.2,0.1,30,1,30,20.7,2,0,3,0,3,3,6,6
"412",2018-02-14,"Brush Creek Rd","w1718","Hybrid",0,"Wed","weekday","sled","3","3","3",6.2,0.1,30,1,30,20.7,2,0,3,0,3,3,6,6
"413",2018-02-15,"Brush Creek Rd","w1718","Non.motorized",5,"Thu","weekday","no_sled","3","3","3",6.3,0.1,28,-2,24,22.5,1,2,0,3,-1,1,1,4
"414",2018-02-15,"Brush Creek Rd","w1718","Mechanized",0,"Thu","weekday","no_sled","3","3","3",6.3,0.1,28,-2,24,22.5,1,2,0,3,-1,1,1,4
"415",2018-02-15,"Brush Creek Rd","w1718","Motorized",0,"Thu","weekday","sled","3","3","3",6.3,0.1,28,-2,24,22.5,1,2,0,3,-1,1,1,4
"416",2018-02-15,"Brush Creek Rd","w1718","Hybrid",0,"Thu","weekday","sled","3","3","3",6.3,0.1,28,-2,24,22.5,1,2,0,3,-1,1,1,4
"417",2018-02-16,"Brush Creek Rd","w1718","Non.motorized",6,"Fri","weekday","no_sled","3","3","3",6.7,0.4,32,4,18,20.9,-2,1,2,0,2,3,5,5
"418",2018-02-16,"Brush Creek Rd","w1718","Mechanized",0,"Fri","weekday","no_sled","3","3","3",6.7,0.4,32,4,18,20.9,-2,1,2,0,2,3,5,5
"419",2018-02-16,"Brush Creek Rd","w1718","Motorized",0,"Fri","weekday","sled","3","3","3",6.7,0.4,32,4,18,20.9,-2,1,2,0,2,3,5,5
"420",2018-02-16,"Brush Creek Rd","w1718","Hybrid",0,"Fri","weekday","sled","3","3","3",6.7,0.4,32,4,18,20.9,-2,1,2,0,2,3,5,5
"421",2018-02-17,"Brush Creek Rd","w1718","Non.motorized",24,"Sat","weekend","no_sled","3","3","2",6.7,0,32,0,25,20.9,4,-2,1,2,4,2,3,5
"422",2018-02-17,"Brush Creek Rd","w1718","Mechanized",3,"Sat","weekend","no_sled","3","3","2",6.7,0,32,0,25,20.9,4,-2,1,2,4,2,3,5
"423",2018-02-17,"Brush Creek Rd","w1718","Motorized",1,"Sat","weekend","sled","3","3","2",6.7,0,32,0,25,20.9,4,-2,1,2,4,2,3,5
"424",2018-02-17,"Brush Creek Rd","w1718","Hybrid",1,"Sat","weekend","sled","3","3","2",6.7,0,32,0,25,20.9,4,-2,1,2,4,2,3,5
"425",2018-02-18,"Brush Creek Rd","w1718","Non.motorized",21,"Sun","weekend","no_sled","2","2","2",6.7,0,31,-1,32,21.6,0,4,-2,1,-1,3,1,2
"426",2018-02-18,"Brush Creek Rd","w1718","Mechanized",3,"Sun","weekend","no_sled","2","2","2",6.7,0,31,-1,32,21.6,0,4,-2,1,-1,3,1,2
"427",2018-02-18,"Brush Creek Rd","w1718","Motorized",2,"Sun","weekend","sled","2","2","2",6.7,0,31,-1,32,21.6,0,4,-2,1,-1,3,1,2
"428",2018-02-18,"Brush Creek Rd","w1718","Hybrid",0,"Sun","weekend","sled","2","2","2",6.7,0,31,-1,32,21.6,0,4,-2,1,-1,3,1,2
"429",2018-02-19,"Brush Creek Rd","w1718","Non.motorized",1,"Mon","weekday","no_sled","2","2","2",6.8,0.1,29,-2,24,23.4,-1,0,4,-2,-3,-3,1,-1
"430",2018-02-19,"Brush Creek Rd","w1718","Non.motorized",1,"Mon","weekday","no_sled","3","3","3",6.8,0.1,29,-2,24,23.4,-1,0,4,-2,-3,-3,1,-1
"431",2018-02-19,"Brush Creek Rd","w1718","Mechanized",0,"Mon","weekday","no_sled","2","2","2",6.8,0.1,29,-2,24,23.4,-1,0,4,-2,-3,-3,1,-1
"432",2018-02-19,"Brush Creek Rd","w1718","Mechanized",0,"Mon","weekday","no_sled","3","3","3",6.8,0.1,29,-2,24,23.4,-1,0,4,-2,-3,-3,1,-1
"433",2018-02-19,"Brush Creek Rd","w1718","Motorized",0,"Mon","weekday","sled","2","2","2",6.8,0.1,29,-2,24,23.4,-1,0,4,-2,-3,-3,1,-1
"434",2018-02-19,"Brush Creek Rd","w1718","Motorized",0,"Mon","weekday","sled","3","3","3",6.8,0.1,29,-2,24,23.4,-1,0,4,-2,-3,-3,1,-1
"435",2018-02-19,"Brush Creek Rd","w1718","Hybrid",0,"Mon","weekday","sled","2","2","2",6.8,0.1,29,-2,24,23.4,-1,0,4,-2,-3,-3,1,-1
"436",2018-02-19,"Brush Creek Rd","w1718","Hybrid",0,"Mon","weekday","sled","3","3","3",6.8,0.1,29,-2,24,23.4,-1,0,4,-2,-3,-3,1,-1
"437",2018-02-20,"Brush Creek Rd","w1718","Non.motorized",0,"Tue","weekday","no_sled","3","3","3",6.8,0,31,2,8,21.9,-2,-1,0,4,0,-1,-1,3
"438",2018-02-20,"Brush Creek Rd","w1718","Mechanized",0,"Tue","weekday","no_sled","3","3","3",6.8,0,31,2,8,21.9,-2,-1,0,4,0,-1,-1,3
"439",2018-02-20,"Brush Creek Rd","w1718","Motorized",0,"Tue","weekday","sled","3","3","3",6.8,0,31,2,8,21.9,-2,-1,0,4,0,-1,-1,3
"440",2018-02-20,"Brush Creek Rd","w1718","Hybrid",0,"Tue","weekday","sled","3","3","3",6.8,0,31,2,8,21.9,-2,-1,0,4,0,-1,-1,3
"441",2018-02-21,"Brush Creek Rd","w1718","Non.motorized",9,"Wed","weekday","no_sled","3","3","3",6.8,0,31,0,11,21.9,2,-2,-1,0,2,0,-1,-1
"442",2018-02-21,"Brush Creek Rd","w1718","Mechanized",0,"Wed","weekday","no_sled","3","3","3",6.8,0,31,0,11,21.9,2,-2,-1,0,2,0,-1,-1
"443",2018-02-21,"Brush Creek Rd","w1718","Motorized",0,"Wed","weekday","sled","3","3","3",6.8,0,31,0,11,21.9,2,-2,-1,0,2,0,-1,-1
"444",2018-02-21,"Brush Creek Rd","w1718","Hybrid",0,"Wed","weekday","sled","3","3","3",6.8,0,31,0,11,21.9,2,-2,-1,0,2,0,-1,-1
"445",2018-02-22,"Brush Creek Rd","w1718","Non.motorized",2,"Thu","weekday","no_sled","3","3","2",6.8,0,30,-1,16,22.7,0,2,-2,-1,-1,1,-1,-2
"446",2018-02-22,"Brush Creek Rd","w1718","Mechanized",0,"Thu","weekday","no_sled","3","3","2",6.8,0,30,-1,16,22.7,0,2,-2,-1,-1,1,-1,-2
"447",2018-02-22,"Brush Creek Rd","w1718","Motorized",0,"Thu","weekday","sled","3","3","2",6.8,0,30,-1,16,22.7,0,2,-2,-1,-1,1,-1,-2
"448",2018-02-22,"Brush Creek Rd","w1718","Hybrid",0,"Thu","weekday","sled","3","3","2",6.8,0,30,-1,16,22.7,0,2,-2,-1,-1,1,-1,-2
"449",2018-02-23,"Brush Creek Rd","w1718","Non.motorized",12,"Fri","weekday","no_sled","3","3","2",6.9,0.1,30,0,15,23,-1,0,2,-2,-1,-1,1,-1
"450",2018-02-23,"Brush Creek Rd","w1718","Mechanized",0,"Fri","weekday","no_sled","3","3","2",6.9,0.1,30,0,15,23,-1,0,2,-2,-1,-1,1,-1
"451",2018-02-23,"Brush Creek Rd","w1718","Motorized",0,"Fri","weekday","sled","3","3","2",6.9,0.1,30,0,15,23,-1,0,2,-2,-1,-1,1,-1
"452",2018-02-23,"Brush Creek Rd","w1718","Hybrid",0,"Fri","weekday","sled","3","3","2",6.9,0.1,30,0,15,23,-1,0,2,-2,-1,-1,1,-1
"453",2018-02-24,"Brush Creek Rd","w1718","Non.motorized",18,"Sat","weekend","no_sled","3","3","2",6.9,0,31,1,10,22.3,0,-1,0,2,1,0,0,2
"454",2018-02-24,"Brush Creek Rd","w1718","Mechanized",2,"Sat","weekend","no_sled","3","3","2",6.9,0,31,1,10,22.3,0,-1,0,2,1,0,0,2
"455",2018-02-24,"Brush Creek Rd","w1718","Motorized",0,"Sat","weekend","sled","3","3","2",6.9,0,31,1,10,22.3,0,-1,0,2,1,0,0,2
"456",2018-02-24,"Brush Creek Rd","w1718","Hybrid",0,"Sat","weekend","sled","3","3","2",6.9,0,31,1,10,22.3,0,-1,0,2,1,0,0,2
"457",2018-02-25,"Brush Creek Rd","w1718","Non.motorized",8,"Sun","weekend","no_sled","3","3","2",7.1,0.2,32,1,11,22.2,1,0,-1,0,2,2,1,1
"458",2018-02-25,"Brush Creek Rd","w1718","Mechanized",1,"Sun","weekend","no_sled","3","3","2",7.1,0.2,32,1,11,22.2,1,0,-1,0,2,2,1,1
"459",2018-02-25,"Brush Creek Rd","w1718","Motorized",4,"Sun","weekend","sled","3","3","2",7.1,0.2,32,1,11,22.2,1,0,-1,0,2,2,1,1
"460",2018-02-25,"Brush Creek Rd","w1718","Hybrid",0,"Sun","weekend","sled","3","3","2",7.1,0.2,32,1,11,22.2,1,0,-1,0,2,2,1,1
"461",2018-02-26,"Brush Creek Rd","w1718","Non.motorized",2,"Mon","weekday","no_sled","2","2","2",7.1,0,32,0,20,22.2,1,1,0,-1,1,2,2,1
"462",2018-02-26,"Brush Creek Rd","w1718","Mechanized",3,"Mon","weekday","no_sled","2","2","2",7.1,0,32,0,20,22.2,1,1,0,-1,1,2,2,1
"463",2018-02-26,"Brush Creek Rd","w1718","Motorized",0,"Mon","weekday","sled","2","2","2",7.1,0,32,0,20,22.2,1,1,0,-1,1,2,2,1
"464",2018-02-26,"Brush Creek Rd","w1718","Hybrid",0,"Mon","weekday","sled","2","2","2",7.1,0,32,0,20,22.2,1,1,0,-1,1,2,2,1
"465",2018-02-27,"Brush Creek Rd","w1718","Non.motorized",NA,"Tue","weekday","no_sled","2","2","2",7.2,0.1,32,0,26,22.5,0,1,1,0,0,1,2,2
"466",2018-02-27,"Brush Creek Rd","w1718","Mechanized",NA,"Tue","weekday","no_sled","2","2","2",7.2,0.1,32,0,26,22.5,0,1,1,0,0,1,2,2
"467",2018-02-27,"Brush Creek Rd","w1718","Motorized",NA,"Tue","weekday","sled","2","2","2",7.2,0.1,32,0,26,22.5,0,1,1,0,0,1,2,2
"468",2018-02-27,"Brush Creek Rd","w1718","Hybrid",NA,"Tue","weekday","sled","2","2","2",7.2,0.1,32,0,26,22.5,0,1,1,0,0,1,2,2
"469",2018-02-28,"Brush Creek Rd","w1718","Non.motorized",NA,"Wed","weekday","no_sled","2","2","2",7.2,0,31,-1,23,23.2,0,0,1,1,-1,-1,0,1
"470",2018-02-28,"Brush Creek Rd","w1718","Mechanized",NA,"Wed","weekday","no_sled","2","2","2",7.2,0,31,-1,23,23.2,0,0,1,1,-1,-1,0,1
"471",2018-02-28,"Brush Creek Rd","w1718","Motorized",NA,"Wed","weekday","sled","2","2","2",7.2,0,31,-1,23,23.2,0,0,1,1,-1,-1,0,1
"472",2018-02-28,"Brush Creek Rd","w1718","Hybrid",NA,"Wed","weekday","sled","2","2","2",7.2,0,31,-1,23,23.2,0,0,1,1,-1,-1,0,1
"473",2018-03-01,"Brush Creek Rd","w1718","Non.motorized",NA,"Thu","weekday","no_sled","2","2","2",7.2,0,31,0,24,23.2,-1,0,0,1,-1,-1,-1,0
"474",2018-03-01,"Brush Creek Rd","w1718","Mechanized",NA,"Thu","weekday","no_sled","2","2","2",7.2,0,31,0,24,23.2,-1,0,0,1,-1,-1,-1,0
"475",2018-03-01,"Brush Creek Rd","w1718","Motorized",NA,"Thu","weekday","sled","2","2","2",7.2,0,31,0,24,23.2,-1,0,0,1,-1,-1,-1,0
"476",2018-03-01,"Brush Creek Rd","w1718","Hybrid",NA,"Thu","weekday","sled","2","2","2",7.2,0,31,0,24,23.2,-1,0,0,1,-1,-1,-1,0
"477",2018-03-02,"Brush Creek Rd","w1718","Non.motorized",NA,"Fri","weekday","no_sled","2","2","1",7.2,0,31,0,30,23.2,0,-1,0,0,0,-1,-1,-1
"478",2018-03-02,"Brush Creek Rd","w1718","Mechanized",NA,"Fri","weekday","no_sled","2","2","1",7.2,0,31,0,30,23.2,0,-1,0,0,0,-1,-1,-1
"479",2018-03-02,"Brush Creek Rd","w1718","Motorized",NA,"Fri","weekday","sled","2","2","1",7.2,0,31,0,30,23.2,0,-1,0,0,0,-1,-1,-1
"480",2018-03-02,"Brush Creek Rd","w1718","Hybrid",NA,"Fri","weekday","sled","2","2","1",7.2,0,31,0,30,23.2,0,-1,0,0,0,-1,-1,-1
"481",2018-03-03,"Brush Creek Rd","w1718","Non.motorized",NA,"Sat","weekend","no_sled","2","2","1",7.3,0.1,30,-1,34,24.3,0,0,-1,0,-1,-1,-2,-2
"482",2018-03-03,"Brush Creek Rd","w1718","Mechanized",NA,"Sat","weekend","no_sled","2","2","1",7.3,0.1,30,-1,34,24.3,0,0,-1,0,-1,-1,-2,-2
"483",2018-03-03,"Brush Creek Rd","w1718","Motorized",NA,"Sat","weekend","sled","2","2","1",7.3,0.1,30,-1,34,24.3,0,0,-1,0,-1,-1,-2,-2
"484",2018-03-03,"Brush Creek Rd","w1718","Hybrid",NA,"Sat","weekend","sled","2","2","1",7.3,0.1,30,-1,34,24.3,0,0,-1,0,-1,-1,-2,-2
"485",2018-03-04,"Brush Creek Rd","w1718","Non.motorized",NA,"Sun","weekend","no_sled","2","2","1",7.3,0,29,-1,24,25.2,-1,0,0,-1,-2,-2,-2,-3
"486",2018-03-04,"Brush Creek Rd","w1718","Mechanized",NA,"Sun","weekend","no_sled","2","2","1",7.3,0,29,-1,24,25.2,-1,0,0,-1,-2,-2,-2,-3
"487",2018-03-04,"Brush Creek Rd","w1718","Motorized",NA,"Sun","weekend","sled","2","2","1",7.3,0,29,-1,24,25.2,-1,0,0,-1,-2,-2,-2,-3
"488",2018-03-04,"Brush Creek Rd","w1718","Hybrid",NA,"Sun","weekend","sled","2","2","1",7.3,0,29,-1,24,25.2,-1,0,0,-1,-2,-2,-2,-3
"489",2018-03-05,"Brush Creek Rd","w1718","Non.motorized",NA,"Mon","weekday","no_sled","2","2","1",7.3,0,31,2,13,23.5,-1,-1,0,0,1,0,0,0
"490",2018-03-05,"Brush Creek Rd","w1718","Mechanized",NA,"Mon","weekday","no_sled","2","2","1",7.3,0,31,2,13,23.5,-1,-1,0,0,1,0,0,0
"491",2018-03-05,"Brush Creek Rd","w1718","Motorized",NA,"Mon","weekday","sled","2","2","1",7.3,0,31,2,13,23.5,-1,-1,0,0,1,0,0,0
"492",2018-03-05,"Brush Creek Rd","w1718","Hybrid",NA,"Mon","weekday","sled","2","2","1",7.3,0,31,2,13,23.5,-1,-1,0,0,1,0,0,0
"493",2018-03-06,"Brush Creek Rd","w1718","Non.motorized",0,"Tue","weekday","no_sled","2","2","1",7.3,0,31,0,19,23.5,2,-1,-1,0,2,1,0,0
"494",2018-03-06,"Brush Creek Rd","w1718","Mechanized",0,"Tue","weekday","no_sled","2","2","1",7.3,0,31,0,19,23.5,2,-1,-1,0,2,1,0,0
"495",2018-03-06,"Brush Creek Rd","w1718","Motorized",1,"Tue","weekday","sled","2","2","1",7.3,0,31,0,19,23.5,2,-1,-1,0,2,1,0,0
"496",2018-03-06,"Brush Creek Rd","w1718","Hybrid",0,"Tue","weekday","sled","2","2","1",7.3,0,31,0,19,23.5,2,-1,-1,0,2,1,0,0
"497",2018-03-07,"Brush Creek Rd","w1718","Non.motorized",6,"Wed","weekday","no_sled","2","2","1",7.4,0.1,31,0,27,23.9,0,2,-1,-1,0,2,1,0
"498",2018-03-07,"Brush Creek Rd","w1718","Mechanized",0,"Wed","weekday","no_sled","2","2","1",7.4,0.1,31,0,27,23.9,0,2,-1,-1,0,2,1,0
"499",2018-03-07,"Brush Creek Rd","w1718","Motorized",2,"Wed","weekday","sled","2","2","1",7.4,0.1,31,0,27,23.9,0,2,-1,-1,0,2,1,0
"500",2018-03-07,"Brush Creek Rd","w1718","Hybrid",0,"Wed","weekday","sled","2","2","1",7.4,0.1,31,0,27,23.9,0,2,-1,-1,0,2,1,0
"501",2018-03-08,"Brush Creek Rd","w1718","Non.motorized",4,"Thu","weekday","no_sled","2","2","1",7.4,0,30,-1,33,24.7,0,0,2,-1,-1,-1,1,0
"502",2018-03-08,"Brush Creek Rd","w1718","Mechanized",0,"Thu","weekday","no_sled","2","2","1",7.4,0,30,-1,33,24.7,0,0,2,-1,-1,-1,1,0
"503",2018-03-08,"Brush Creek Rd","w1718","Motorized",0,"Thu","weekday","sled","2","2","1",7.4,0,30,-1,33,24.7,0,0,2,-1,-1,-1,1,0
"504",2018-03-08,"Brush Creek Rd","w1718","Hybrid",0,"Thu","weekday","sled","2","2","1",7.4,0,30,-1,33,24.7,0,0,2,-1,-1,-1,1,0
"505",2018-03-09,"Brush Creek Rd","w1718","Non.motorized",NA,"Fri","weekday","no_sled","2","2","1",7.4,0,30,0,34,24.7,-1,0,0,2,-1,-1,-1,1
"506",2018-03-09,"Brush Creek Rd","w1718","Mechanized",NA,"Fri","weekday","no_sled","2","2","1",7.4,0,30,0,34,24.7,-1,0,0,2,-1,-1,-1,1
"507",2018-03-09,"Brush Creek Rd","w1718","Motorized",NA,"Fri","weekday","sled","2","2","1",7.4,0,30,0,34,24.7,-1,0,0,2,-1,-1,-1,1
"508",2018-03-09,"Brush Creek Rd","w1718","Hybrid",NA,"Fri","weekday","sled","2","2","1",7.4,0,30,0,34,24.7,-1,0,0,2,-1,-1,-1,1
"509",2018-03-10,"Brush Creek Rd","w1718","Non.motorized",NA,"Sat","weekend","no_sled","1","1","1",7.4,0,30,0,31,24.7,0,-1,0,0,0,-1,-1,-1
"510",2018-03-10,"Brush Creek Rd","w1718","Mechanized",NA,"Sat","weekend","no_sled","1","1","1",7.4,0,30,0,31,24.7,0,-1,0,0,0,-1,-1,-1
"511",2018-03-10,"Brush Creek Rd","w1718","Motorized",NA,"Sat","weekend","sled","1","1","1",7.4,0,30,0,31,24.7,0,-1,0,0,0,-1,-1,-1
"512",2018-03-10,"Brush Creek Rd","w1718","Hybrid",NA,"Sat","weekend","sled","1","1","1",7.4,0,30,0,31,24.7,0,-1,0,0,0,-1,-1,-1
"513",2018-03-11,"Brush Creek Rd","w1718","Non.motorized",NA,"Sun","weekend","no_sled","1","1","1",7.4,0,29,-1,31,25.5,0,0,-1,0,-1,-1,-2,-2
"514",2018-03-11,"Brush Creek Rd","w1718","Mechanized",NA,"Sun","weekend","no_sled","1","1","1",7.4,0,29,-1,31,25.5,0,0,-1,0,-1,-1,-2,-2
"515",2018-03-11,"Brush Creek Rd","w1718","Motorized",NA,"Sun","weekend","sled","1","1","1",7.4,0,29,-1,31,25.5,0,0,-1,0,-1,-1,-2,-2
"516",2018-03-11,"Brush Creek Rd","w1718","Hybrid",NA,"Sun","weekend","sled","1","1","1",7.4,0,29,-1,31,25.5,0,0,-1,0,-1,-1,-2,-2
"517",2018-03-12,"Brush Creek Rd","w1718","Non.motorized",NA,"Mon","weekday","no_sled","1","1","1",7.4,0,29,0,33,25.5,-1,0,0,-1,-1,-1,-1,-2
"518",2018-03-12,"Brush Creek Rd","w1718","Mechanized",NA,"Mon","weekday","no_sled","1","1","1",7.4,0,29,0,33,25.5,-1,0,0,-1,-1,-1,-1,-2
"519",2018-03-12,"Brush Creek Rd","w1718","Motorized",NA,"Mon","weekday","sled","1","1","1",7.4,0,29,0,33,25.5,-1,0,0,-1,-1,-1,-1,-2
"520",2018-03-12,"Brush Creek Rd","w1718","Hybrid",NA,"Mon","weekday","sled","1","1","1",7.4,0,29,0,33,25.5,-1,0,0,-1,-1,-1,-1,-2
"521",2018-03-13,"Brush Creek Rd","w1718","Non.motorized",NA,"Tue","weekday","no_sled","1","1","1",7.4,0,29,0,34,25.5,0,-1,0,0,0,-1,-1,-1
"522",2018-03-13,"Brush Creek Rd","w1718","Mechanized",NA,"Tue","weekday","no_sled","1","1","1",7.4,0,29,0,34,25.5,0,-1,0,0,0,-1,-1,-1
"523",2018-03-13,"Brush Creek Rd","w1718","Motorized",NA,"Tue","weekday","sled","1","1","1",7.4,0,29,0,34,25.5,0,-1,0,0,0,-1,-1,-1
"524",2018-03-13,"Brush Creek Rd","w1718","Hybrid",NA,"Tue","weekday","sled","1","1","1",7.4,0,29,0,34,25.5,0,-1,0,0,0,-1,-1,-1
"525",2018-03-14,"Brush Creek Rd","w1718","Non.motorized",NA,"Wed","weekday","no_sled","1","2","2",7.4,0,29,0,39,25.5,0,0,-1,0,0,0,-1,-1
"526",2018-03-14,"Brush Creek Rd","w1718","Mechanized",NA,"Wed","weekday","no_sled","1","2","2",7.4,0,29,0,39,25.5,0,0,-1,0,0,0,-1,-1
"527",2018-03-14,"Brush Creek Rd","w1718","Motorized",NA,"Wed","weekday","sled","1","2","2",7.4,0,29,0,39,25.5,0,0,-1,0,0,0,-1,-1
"528",2018-03-14,"Brush Creek Rd","w1718","Hybrid",NA,"Wed","weekday","sled","1","2","2",7.4,0,29,0,39,25.5,0,0,-1,0,0,0,-1,-1
"529",2018-03-15,"Brush Creek Rd","w1718","Non.motorized",NA,"Thu","weekday","no_sled","2","2","2",7.5,0.1,28,-1,31,26.8,0,0,0,-1,-1,-1,-1,-2
"530",2018-03-15,"Brush Creek Rd","w1718","Mechanized",NA,"Thu","weekday","no_sled","2","2","2",7.5,0.1,28,-1,31,26.8,0,0,0,-1,-1,-1,-1,-2
"531",2018-03-15,"Brush Creek Rd","w1718","Motorized",NA,"Thu","weekday","sled","2","2","2",7.5,0.1,28,-1,31,26.8,0,0,0,-1,-1,-1,-1,-2
"532",2018-03-15,"Brush Creek Rd","w1718","Hybrid",NA,"Thu","weekday","sled","2","2","2",7.5,0.1,28,-1,31,26.8,0,0,0,-1,-1,-1,-1,-2
"533",2018-03-16,"Brush Creek Rd","w1718","Non.motorized",NA,"Fri","weekday","no_sled","2","2","2",7.7,0.2,29,1,25,26.6,-1,0,0,0,0,0,0,0
"534",2018-03-16,"Brush Creek Rd","w1718","Mechanized",NA,"Fri","weekday","no_sled","2","2","2",7.7,0.2,29,1,25,26.6,-1,0,0,0,0,0,0,0
"535",2018-03-16,"Brush Creek Rd","w1718","Motorized",NA,"Fri","weekday","sled","2","2","2",7.7,0.2,29,1,25,26.6,-1,0,0,0,0,0,0,0
"536",2018-03-16,"Brush Creek Rd","w1718","Hybrid",NA,"Fri","weekday","sled","2","2","2",7.7,0.2,29,1,25,26.6,-1,0,0,0,0,0,0,0
"537",2018-03-17,"Brush Creek Rd","w1718","Non.motorized",NA,"Sat","weekend","no_sled","2","2","2",7.8,0.1,32,3,29,24.4,1,-1,0,0,4,3,3,3
"538",2018-03-17,"Brush Creek Rd","w1718","Mechanized",NA,"Sat","weekend","no_sled","2","2","2",7.8,0.1,32,3,29,24.4,1,-1,0,0,4,3,3,3
"539",2018-03-17,"Brush Creek Rd","w1718","Motorized",NA,"Sat","weekend","sled","2","2","2",7.8,0.1,32,3,29,24.4,1,-1,0,0,4,3,3,3
"540",2018-03-17,"Brush Creek Rd","w1718","Hybrid",NA,"Sat","weekend","sled","2","2","2",7.8,0.1,32,3,29,24.4,1,-1,0,0,4,3,3,3
"541",2018-03-18,"Brush Creek Rd","w1718","Non.motorized",NA,"Sun","weekend","no_sled","2","2","2",7.9,0.1,31,-1,24,25.5,3,1,-1,0,2,3,2,2
"542",2018-03-18,"Brush Creek Rd","w1718","Mechanized",NA,"Sun","weekend","no_sled","2","2","2",7.9,0.1,31,-1,24,25.5,3,1,-1,0,2,3,2,2
"543",2018-03-18,"Brush Creek Rd","w1718","Motorized",NA,"Sun","weekend","sled","2","2","2",7.9,0.1,31,-1,24,25.5,3,1,-1,0,2,3,2,2
"544",2018-03-18,"Brush Creek Rd","w1718","Hybrid",NA,"Sun","weekend","sled","2","2","2",7.9,0.1,31,-1,24,25.5,3,1,-1,0,2,3,2,2
"545",2018-03-19,"Brush Creek Rd","w1718","Non.motorized",NA,"Mon","weekday","no_sled","2","2","1",8,0.1,32,1,19,25,-1,3,1,-1,0,3,4,3
"546",2018-03-19,"Brush Creek Rd","w1718","Mechanized",NA,"Mon","weekday","no_sled","2","2","1",8,0.1,32,1,19,25,-1,3,1,-1,0,3,4,3
"547",2018-03-19,"Brush Creek Rd","w1718","Motorized",NA,"Mon","weekday","sled","2","2","1",8,0.1,32,1,19,25,-1,3,1,-1,0,3,4,3
"548",2018-03-19,"Brush Creek Rd","w1718","Hybrid",NA,"Mon","weekday","sled","2","2","1",8,0.1,32,1,19,25,-1,3,1,-1,0,3,4,3
"549",2018-03-20,"Brush Creek Rd","w1718","Non.motorized",9,"Tue","weekday","no_sled","2","2","1",8,0,30,-2,24,26.7,1,-1,3,1,-1,-2,1,2
"550",2018-03-20,"Brush Creek Rd","w1718","Mechanized",0,"Tue","weekday","no_sled","2","2","1",8,0,30,-2,24,26.7,1,-1,3,1,-1,-2,1,2
"551",2018-03-20,"Brush Creek Rd","w1718","Motorized",0,"Tue","weekday","sled","2","2","1",8,0,30,-2,24,26.7,1,-1,3,1,-1,-2,1,2
"552",2018-03-20,"Brush Creek Rd","w1718","Hybrid",0,"Tue","weekday","sled","2","2","1",8,0,30,-2,24,26.7,1,-1,3,1,-1,-2,1,2
"553",2018-03-21,"Brush Creek Rd","w1718","Non.motorized",274,"Wed","weekday","no_sled","1","1","1",8.1,0.1,32,2,30,25.3,-2,1,-1,3,0,1,0,3
"554",2018-03-21,"Brush Creek Rd","w1718","Mechanized",2,"Wed","weekday","no_sled","1","1","1",8.1,0.1,32,2,30,25.3,-2,1,-1,3,0,1,0,3
"555",2018-03-21,"Brush Creek Rd","w1718","Motorized",8,"Wed","weekday","sled","1","1","1",8.1,0.1,32,2,30,25.3,-2,1,-1,3,0,1,0,3
"556",2018-03-21,"Brush Creek Rd","w1718","Hybrid",0,"Wed","weekday","sled","1","1","1",8.1,0.1,32,2,30,25.3,-2,1,-1,3,0,1,0,3
"557",2018-03-22,"Brush Creek Rd","w1718","Non.motorized",10,"Thu","weekday","no_sled","1","1","1",8.1,0,30,-2,36,27,2,-2,1,-1,0,-2,-1,-2
"558",2018-03-22,"Brush Creek Rd","w1718","Mechanized",1,"Thu","weekday","no_sled","1","1","1",8.1,0,30,-2,36,27,2,-2,1,-1,0,-2,-1,-2
"559",2018-03-22,"Brush Creek Rd","w1718","Motorized",1,"Thu","weekday","sled","1","1","1",8.1,0,30,-2,36,27,2,-2,1,-1,0,-2,-1,-2
"560",2018-03-22,"Brush Creek Rd","w1718","Hybrid",0,"Thu","weekday","sled","1","1","1",8.1,0,30,-2,36,27,2,-2,1,-1,0,-2,-1,-2
"561",2018-03-23,"Brush Creek Rd","w1718","Non.motorized",6,"Fri","weekday","no_sled","2","2","3",8.2,0.1,29,-1,34,28.3,-2,2,-2,1,-3,-1,-3,-2
"562",2018-03-23,"Brush Creek Rd","w1718","Mechanized",0,"Fri","weekday","no_sled","2","2","3",8.2,0.1,29,-1,34,28.3,-2,2,-2,1,-3,-1,-3,-2
"563",2018-03-23,"Brush Creek Rd","w1718","Motorized",0,"Fri","weekday","sled","2","2","3",8.2,0.1,29,-1,34,28.3,-2,2,-2,1,-3,-1,-3,-2
"564",2018-03-23,"Brush Creek Rd","w1718","Hybrid",0,"Fri","weekday","sled","2","2","3",8.2,0.1,29,-1,34,28.3,-2,2,-2,1,-3,-1,-3,-2
"565",2018-03-24,"Brush Creek Rd","w1718","Non.motorized",3,"Sat","weekend","no_sled","2","2","1",8.9,0.7,34,5,32,26.2,-1,-2,2,-2,4,2,4,2
"566",2018-03-24,"Brush Creek Rd","w1718","Mechanized",0,"Sat","weekend","no_sled","2","2","1",8.9,0.7,34,5,32,26.2,-1,-2,2,-2,4,2,4,2
"567",2018-03-24,"Brush Creek Rd","w1718","Motorized",2,"Sat","weekend","sled","2","2","1",8.9,0.7,34,5,32,26.2,-1,-2,2,-2,4,2,4,2
"568",2018-03-24,"Brush Creek Rd","w1718","Hybrid",1,"Sat","weekend","sled","2","2","1",8.9,0.7,34,5,32,26.2,-1,-2,2,-2,4,2,4,2
"569",2018-03-25,"Brush Creek Rd","w1718","Non.motorized",2,"Sun","weekend","no_sled","2","2","1",8.9,0,35,1,35,25.4,5,-1,-2,2,6,5,3,5
"570",2018-03-25,"Brush Creek Rd","w1718","Mechanized",0,"Sun","weekend","no_sled","2","2","1",8.9,0,35,1,35,25.4,5,-1,-2,2,6,5,3,5
"571",2018-03-25,"Brush Creek Rd","w1718","Motorized",0,"Sun","weekend","sled","2","2","1",8.9,0,35,1,35,25.4,5,-1,-2,2,6,5,3,5
"572",2018-03-25,"Brush Creek Rd","w1718","Hybrid",0,"Sun","weekend","sled","2","2","1",8.9,0,35,1,35,25.4,5,-1,-2,2,6,5,3,5
"573",2018-03-26,"Brush Creek Rd","w1718","Non.motorized",2,"Mon","weekday","no_sled","1","1","1",8.9,0,34,-1,31,26.2,1,5,-1,-2,0,5,4,2
"574",2018-03-26,"Brush Creek Rd","w1718","Non.motorized",2,"Mon","weekday","no_sled","2","1","1",8.9,0,34,-1,31,26.2,1,5,-1,-2,0,5,4,2
"575",2018-03-26,"Brush Creek Rd","w1718","Mechanized",0,"Mon","weekday","no_sled","1","1","1",8.9,0,34,-1,31,26.2,1,5,-1,-2,0,5,4,2
"576",2018-03-26,"Brush Creek Rd","w1718","Mechanized",0,"Mon","weekday","no_sled","2","1","1",8.9,0,34,-1,31,26.2,1,5,-1,-2,0,5,4,2
"577",2018-03-26,"Brush Creek Rd","w1718","Motorized",4,"Mon","weekday","sled","1","1","1",8.9,0,34,-1,31,26.2,1,5,-1,-2,0,5,4,2
"578",2018-03-26,"Brush Creek Rd","w1718","Motorized",4,"Mon","weekday","sled","2","1","1",8.9,0,34,-1,31,26.2,1,5,-1,-2,0,5,4,2
"579",2018-03-26,"Brush Creek Rd","w1718","Hybrid",2,"Mon","weekday","sled","1","1","1",8.9,0,34,-1,31,26.2,1,5,-1,-2,0,5,4,2
"580",2018-03-26,"Brush Creek Rd","w1718","Hybrid",2,"Mon","weekday","sled","2","1","1",8.9,0,34,-1,31,26.2,1,5,-1,-2,0,5,4,2
"581",2018-03-27,"Brush Creek Rd","w1718","Non.motorized",2,"Tue","weekday","no_sled","1","1","1",8.9,0,33,-1,29,27,-1,1,5,-1,-2,-1,4,3
"582",2018-03-27,"Brush Creek Rd","w1718","Mechanized",0,"Tue","weekday","no_sled","1","1","1",8.9,0,33,-1,29,27,-1,1,5,-1,-2,-1,4,3
"583",2018-03-27,"Brush Creek Rd","w1718","Motorized",0,"Tue","weekday","sled","1","1","1",8.9,0,33,-1,29,27,-1,1,5,-1,-2,-1,4,3
"584",2018-03-27,"Brush Creek Rd","w1718","Hybrid",0,"Tue","weekday","sled","1","1","1",8.9,0,33,-1,29,27,-1,1,5,-1,-2,-1,4,3
"585",2018-03-28,"Brush Creek Rd","w1718","Non.motorized",7,"Wed","weekday","no_sled","1","1","1",8.9,0,33,0,27,27,-1,-1,1,5,-1,-2,-1,4
"586",2018-03-28,"Brush Creek Rd","w1718","Mechanized",0,"Wed","weekday","no_sled","1","1","1",8.9,0,33,0,27,27,-1,-1,1,5,-1,-2,-1,4
"587",2018-03-28,"Brush Creek Rd","w1718","Motorized",0,"Wed","weekday","sled","1","1","1",8.9,0,33,0,27,27,-1,-1,1,5,-1,-2,-1,4
"588",2018-03-28,"Brush Creek Rd","w1718","Hybrid",0,"Wed","weekday","sled","1","1","1",8.9,0,33,0,27,27,-1,-1,1,5,-1,-2,-1,4
"589",2018-03-29,"Brush Creek Rd","w1718","Non.motorized",6,"Thu","weekday","no_sled","1","1","1",8.9,0,33,0,27,27,0,-1,-1,1,0,-1,-2,-1
"590",2018-03-29,"Brush Creek Rd","w1718","Mechanized",3,"Thu","weekday","no_sled","1","1","1",8.9,0,33,0,27,27,0,-1,-1,1,0,-1,-2,-1
"591",2018-03-29,"Brush Creek Rd","w1718","Motorized",0,"Thu","weekday","sled","1","1","1",8.9,0,33,0,27,27,0,-1,-1,1,0,-1,-2,-1
"592",2018-03-29,"Brush Creek Rd","w1718","Hybrid",0,"Thu","weekday","sled","1","1","1",8.9,0,33,0,27,27,0,-1,-1,1,0,-1,-2,-1
"593",2018-03-30,"Brush Creek Rd","w1718","Non.motorized",0,"Fri","weekday","no_sled","1","1","1",8.9,0,32,-1,33,27.8,0,0,-1,-1,-1,-1,-2,-3
"594",2018-03-30,"Brush Creek Rd","w1718","Mechanized",0,"Fri","weekday","no_sled","1","1","1",8.9,0,32,-1,33,27.8,0,0,-1,-1,-1,-1,-2,-3
"595",2018-03-30,"Brush Creek Rd","w1718","Motorized",1,"Fri","weekday","sled","1","1","1",8.9,0,32,-1,33,27.8,0,0,-1,-1,-1,-1,-2,-3
"596",2018-03-30,"Brush Creek Rd","w1718","Hybrid",0,"Fri","weekday","sled","1","1","1",8.9,0,32,-1,33,27.8,0,0,-1,-1,-1,-1,-2,-3
"597",2018-03-31,"Brush Creek Rd","w1718","Non.motorized",0,"Sat","weekend","no_sled","1","1","1",8.9,0,32,0,39,27.8,-1,0,0,-1,-1,-1,-1,-2
"598",2018-03-31,"Brush Creek Rd","w1718","Mechanized",0,"Sat","weekend","no_sled","1","1","1",8.9,0,32,0,39,27.8,-1,0,0,-1,-1,-1,-1,-2
"599",2018-03-31,"Brush Creek Rd","w1718","Motorized",0,"Sat","weekend","sled","1","1","1",8.9,0,32,0,39,27.8,-1,0,0,-1,-1,-1,-1,-2
"600",2018-03-31,"Brush Creek Rd","w1718","Hybrid",0,"Sat","weekend","sled","1","1","1",8.9,0,32,0,39,27.8,-1,0,0,-1,-1,-1,-1,-2
"601",2018-04-01,"Brush Creek Rd","w1718","Non.motorized",3,"Sun","weekend","no_sled","1","1","1",8.8,-0.1,30,-2,41,29.3,0,-1,0,0,-2,-3,-3,-3
"602",2018-04-01,"Brush Creek Rd","w1718","Mechanized",0,"Sun","weekend","no_sled","1","1","1",8.8,-0.1,30,-2,41,29.3,0,-1,0,0,-2,-3,-3,-3
"603",2018-04-01,"Brush Creek Rd","w1718","Motorized",0,"Sun","weekend","sled","1","1","1",8.8,-0.1,30,-2,41,29.3,0,-1,0,0,-2,-3,-3,-3
"604",2018-04-01,"Brush Creek Rd","w1718","Hybrid",0,"Sun","weekend","sled","1","1","1",8.8,-0.1,30,-2,41,29.3,0,-1,0,0,-2,-3,-3,-3
"605",2018-04-02,"Brush Creek Rd","w1718","Non.motorized",0,"Mon","weekday","no_sled","1","1","1",8.7,-0.1,29,-1,39,30,-2,0,-1,0,-3,-3,-4,-4
"606",2018-04-02,"Brush Creek Rd","w1718","Mechanized",0,"Mon","weekday","no_sled","1","1","1",8.7,-0.1,29,-1,39,30,-2,0,-1,0,-3,-3,-4,-4
"607",2018-04-02,"Brush Creek Rd","w1718","Motorized",0,"Mon","weekday","sled","1","1","1",8.7,-0.1,29,-1,39,30,-2,0,-1,0,-3,-3,-4,-4
"608",2018-04-02,"Brush Creek Rd","w1718","Hybrid",0,"Mon","weekday","sled","1","1","1",8.7,-0.1,29,-1,39,30,-2,0,-1,0,-3,-3,-4,-4
"609",2018-04-03,"Brush Creek Rd","w1718","Non.motorized",0,"Tue","weekday","no_sled","1","1","1",8.8,0.1,30,1,27,29.3,-1,-2,0,-1,0,-2,-2,-3
"610",2018-04-03,"Brush Creek Rd","w1718","Mechanized",0,"Tue","weekday","no_sled","1","1","1",8.8,0.1,30,1,27,29.3,-1,-2,0,-1,0,-2,-2,-3
"611",2018-04-03,"Brush Creek Rd","w1718","Motorized",0,"Tue","weekday","sled","1","1","1",8.8,0.1,30,1,27,29.3,-1,-2,0,-1,0,-2,-2,-3
"612",2018-04-03,"Brush Creek Rd","w1718","Hybrid",0,"Tue","weekday","sled","1","1","1",8.8,0.1,30,1,27,29.3,-1,-2,0,-1,0,-2,-2,-3
"613",2018-04-04,"Brush Creek Rd","w1718","Non.motorized",0,"Wed","weekday","no_sled","1","2","2",8.9,0.1,28,-2,33,31.8,1,-1,-2,0,-1,-2,-4,-4
"614",2018-04-04,"Brush Creek Rd","w1718","Mechanized",0,"Wed","weekday","no_sled","1","2","2",8.9,0.1,28,-2,33,31.8,1,-1,-2,0,-1,-2,-4,-4
"615",2018-04-04,"Brush Creek Rd","w1718","Motorized",0,"Wed","weekday","sled","1","2","2",8.9,0.1,28,-2,33,31.8,1,-1,-2,0,-1,-2,-4,-4
"616",2018-04-04,"Brush Creek Rd","w1718","Hybrid",0,"Wed","weekday","sled","1","2","2",8.9,0.1,28,-2,33,31.8,1,-1,-2,0,-1,-2,-4,-4
"617",2018-04-05,"Brush Creek Rd","w1718","Non.motorized",0,"Thu","weekday","no_sled","1","2","2",8.9,0,27,-1,35,33,-2,1,-1,-2,-3,-2,-3,-5
"618",2018-04-05,"Brush Creek Rd","w1718","Mechanized",0,"Thu","weekday","no_sled","1","2","2",8.9,0,27,-1,35,33,-2,1,-1,-2,-3,-2,-3,-5
"619",2018-04-05,"Brush Creek Rd","w1718","Motorized",0,"Thu","weekday","sled","1","2","2",8.9,0,27,-1,35,33,-2,1,-1,-2,-3,-2,-3,-5
"620",2018-04-05,"Brush Creek Rd","w1718","Hybrid",0,"Thu","weekday","sled","1","2","2",8.9,0,27,-1,35,33,-2,1,-1,-2,-3,-2,-3,-5
"621",2018-02-15,"Cement Creek","w1718","Non.motorized",2,"Thu","weekday","no_sled","3","3","3",6.3,0.1,28,-2,24,22.5,1,2,0,3,-1,1,1,4
"622",2018-02-15,"Cement Creek","w1718","Mechanized",0,"Thu","weekday","no_sled","3","3","3",6.3,0.1,28,-2,24,22.5,1,2,0,3,-1,1,1,4
"623",2018-02-15,"Cement Creek","w1718","Motorized",0,"Thu","weekday","sled","3","3","3",6.3,0.1,28,-2,24,22.5,1,2,0,3,-1,1,1,4
"624",2018-02-15,"Cement Creek","w1718","Hybrid",0,"Thu","weekday","sled","3","3","3",6.3,0.1,28,-2,24,22.5,1,2,0,3,-1,1,1,4
"625",2018-02-16,"Cement Creek","w1718","Non.motorized",1,"Fri","weekday","no_sled","3","3","3",6.7,0.4,32,4,18,20.9,-2,1,2,0,2,3,5,5
"626",2018-02-16,"Cement Creek","w1718","Mechanized",0,"Fri","weekday","no_sled","3","3","3",6.7,0.4,32,4,18,20.9,-2,1,2,0,2,3,5,5
"627",2018-02-16,"Cement Creek","w1718","Motorized",0,"Fri","weekday","sled","3","3","3",6.7,0.4,32,4,18,20.9,-2,1,2,0,2,3,5,5
"628",2018-02-16,"Cement Creek","w1718","Hybrid",0,"Fri","weekday","sled","3","3","3",6.7,0.4,32,4,18,20.9,-2,1,2,0,2,3,5,5
"629",2018-02-17,"Cement Creek","w1718","Non.motorized",26,"Sat","weekend","no_sled","3","3","2",6.7,0,32,0,25,20.9,4,-2,1,2,4,2,3,5
"630",2018-02-17,"Cement Creek","w1718","Mechanized",0,"Sat","weekend","no_sled","3","3","2",6.7,0,32,0,25,20.9,4,-2,1,2,4,2,3,5
"631",2018-02-17,"Cement Creek","w1718","Motorized",0,"Sat","weekend","sled","3","3","2",6.7,0,32,0,25,20.9,4,-2,1,2,4,2,3,5
"632",2018-02-17,"Cement Creek","w1718","Hybrid",0,"Sat","weekend","sled","3","3","2",6.7,0,32,0,25,20.9,4,-2,1,2,4,2,3,5
"633",2018-02-18,"Cement Creek","w1718","Non.motorized",19,"Sun","weekend","no_sled","2","2","2",6.7,0,31,-1,32,21.6,0,4,-2,1,-1,3,1,2
"634",2018-02-18,"Cement Creek","w1718","Mechanized",0,"Sun","weekend","no_sled","2","2","2",6.7,0,31,-1,32,21.6,0,4,-2,1,-1,3,1,2
"635",2018-02-18,"Cement Creek","w1718","Motorized",0,"Sun","weekend","sled","2","2","2",6.7,0,31,-1,32,21.6,0,4,-2,1,-1,3,1,2
"636",2018-02-18,"Cement Creek","w1718","Hybrid",0,"Sun","weekend","sled","2","2","2",6.7,0,31,-1,32,21.6,0,4,-2,1,-1,3,1,2
"637",2018-02-19,"Cement Creek","w1718","Non.motorized",1,"Mon","weekday","no_sled","2","2","2",6.8,0.1,29,-2,24,23.4,-1,0,4,-2,-3,-3,1,-1
"638",2018-02-19,"Cement Creek","w1718","Non.motorized",1,"Mon","weekday","no_sled","3","3","3",6.8,0.1,29,-2,24,23.4,-1,0,4,-2,-3,-3,1,-1
"639",2018-02-19,"Cement Creek","w1718","Mechanized",0,"Mon","weekday","no_sled","2","2","2",6.8,0.1,29,-2,24,23.4,-1,0,4,-2,-3,-3,1,-1
"640",2018-02-19,"Cement Creek","w1718","Mechanized",0,"Mon","weekday","no_sled","3","3","3",6.8,0.1,29,-2,24,23.4,-1,0,4,-2,-3,-3,1,-1
"641",2018-02-19,"Cement Creek","w1718","Motorized",0,"Mon","weekday","sled","2","2","2",6.8,0.1,29,-2,24,23.4,-1,0,4,-2,-3,-3,1,-1
"642",2018-02-19,"Cement Creek","w1718","Motorized",0,"Mon","weekday","sled","3","3","3",6.8,0.1,29,-2,24,23.4,-1,0,4,-2,-3,-3,1,-1
"643",2018-02-19,"Cement Creek","w1718","Hybrid",0,"Mon","weekday","sled","2","2","2",6.8,0.1,29,-2,24,23.4,-1,0,4,-2,-3,-3,1,-1
"644",2018-02-19,"Cement Creek","w1718","Hybrid",0,"Mon","weekday","sled","3","3","3",6.8,0.1,29,-2,24,23.4,-1,0,4,-2,-3,-3,1,-1
"645",2018-02-20,"Cement Creek","w1718","Non.motorized",0,"Tue","weekday","no_sled","3","3","3",6.8,0,31,2,8,21.9,-2,-1,0,4,0,-1,-1,3
"646",2018-02-20,"Cement Creek","w1718","Mechanized",0,"Tue","weekday","no_sled","3","3","3",6.8,0,31,2,8,21.9,-2,-1,0,4,0,-1,-1,3
"647",2018-02-20,"Cement Creek","w1718","Motorized",0,"Tue","weekday","sled","3","3","3",6.8,0,31,2,8,21.9,-2,-1,0,4,0,-1,-1,3
"648",2018-02-20,"Cement Creek","w1718","Hybrid",0,"Tue","weekday","sled","3","3","3",6.8,0,31,2,8,21.9,-2,-1,0,4,0,-1,-1,3
"649",2018-02-21,"Cement Creek","w1718","Non.motorized",1,"Wed","weekday","no_sled","3","3","3",6.8,0,31,0,11,21.9,2,-2,-1,0,2,0,-1,-1
"650",2018-02-21,"Cement Creek","w1718","Mechanized",0,"Wed","weekday","no_sled","3","3","3",6.8,0,31,0,11,21.9,2,-2,-1,0,2,0,-1,-1
"651",2018-02-21,"Cement Creek","w1718","Motorized",1,"Wed","weekday","sled","3","3","3",6.8,0,31,0,11,21.9,2,-2,-1,0,2,0,-1,-1
"652",2018-02-21,"Cement Creek","w1718","Hybrid",0,"Wed","weekday","sled","3","3","3",6.8,0,31,0,11,21.9,2,-2,-1,0,2,0,-1,-1
"653",2018-02-22,"Cement Creek","w1718","Non.motorized",0,"Thu","weekday","no_sled","3","3","2",6.8,0,30,-1,16,22.7,0,2,-2,-1,-1,1,-1,-2
"654",2018-02-22,"Cement Creek","w1718","Mechanized",0,"Thu","weekday","no_sled","3","3","2",6.8,0,30,-1,16,22.7,0,2,-2,-1,-1,1,-1,-2
"655",2018-02-22,"Cement Creek","w1718","Motorized",0,"Thu","weekday","sled","3","3","2",6.8,0,30,-1,16,22.7,0,2,-2,-1,-1,1,-1,-2
"656",2018-02-22,"Cement Creek","w1718","Hybrid",0,"Thu","weekday","sled","3","3","2",6.8,0,30,-1,16,22.7,0,2,-2,-1,-1,1,-1,-2
"657",2018-02-23,"Cement Creek","w1718","Non.motorized",0,"Fri","weekday","no_sled","3","3","2",6.9,0.1,30,0,15,23,-1,0,2,-2,-1,-1,1,-1
"658",2018-02-23,"Cement Creek","w1718","Mechanized",0,"Fri","weekday","no_sled","3","3","2",6.9,0.1,30,0,15,23,-1,0,2,-2,-1,-1,1,-1
"659",2018-02-23,"Cement Creek","w1718","Motorized",0,"Fri","weekday","sled","3","3","2",6.9,0.1,30,0,15,23,-1,0,2,-2,-1,-1,1,-1
"660",2018-02-23,"Cement Creek","w1718","Hybrid",0,"Fri","weekday","sled","3","3","2",6.9,0.1,30,0,15,23,-1,0,2,-2,-1,-1,1,-1
"661",2018-02-24,"Cement Creek","w1718","Non.motorized",1,"Sat","weekend","no_sled","3","3","2",6.9,0,31,1,10,22.3,0,-1,0,2,1,0,0,2
"662",2018-02-24,"Cement Creek","w1718","Mechanized",0,"Sat","weekend","no_sled","3","3","2",6.9,0,31,1,10,22.3,0,-1,0,2,1,0,0,2
"663",2018-02-24,"Cement Creek","w1718","Motorized",0,"Sat","weekend","sled","3","3","2",6.9,0,31,1,10,22.3,0,-1,0,2,1,0,0,2
"664",2018-02-24,"Cement Creek","w1718","Hybrid",0,"Sat","weekend","sled","3","3","2",6.9,0,31,1,10,22.3,0,-1,0,2,1,0,0,2
"665",2018-02-25,"Cement Creek","w1718","Non.motorized",3,"Sun","weekend","no_sled","3","3","2",7.1,0.2,32,1,11,22.2,1,0,-1,0,2,2,1,1
"666",2018-02-25,"Cement Creek","w1718","Mechanized",0,"Sun","weekend","no_sled","3","3","2",7.1,0.2,32,1,11,22.2,1,0,-1,0,2,2,1,1
"667",2018-02-25,"Cement Creek","w1718","Motorized",0,"Sun","weekend","sled","3","3","2",7.1,0.2,32,1,11,22.2,1,0,-1,0,2,2,1,1
"668",2018-02-25,"Cement Creek","w1718","Hybrid",0,"Sun","weekend","sled","3","3","2",7.1,0.2,32,1,11,22.2,1,0,-1,0,2,2,1,1
"669",2018-02-26,"Cement Creek","w1718","Non.motorized",3,"Mon","weekday","no_sled","2","2","2",7.1,0,32,0,20,22.2,1,1,0,-1,1,2,2,1
"670",2018-02-26,"Cement Creek","w1718","Mechanized",0,"Mon","weekday","no_sled","2","2","2",7.1,0,32,0,20,22.2,1,1,0,-1,1,2,2,1
"671",2018-02-26,"Cement Creek","w1718","Motorized",0,"Mon","weekday","sled","2","2","2",7.1,0,32,0,20,22.2,1,1,0,-1,1,2,2,1
"672",2018-02-26,"Cement Creek","w1718","Hybrid",0,"Mon","weekday","sled","2","2","2",7.1,0,32,0,20,22.2,1,1,0,-1,1,2,2,1
"673",2018-02-27,"Cement Creek","w1718","Non.motorized",16,"Tue","weekday","no_sled","2","2","2",7.2,0.1,32,0,26,22.5,0,1,1,0,0,1,2,2
"674",2018-02-27,"Cement Creek","w1718","Mechanized",2,"Tue","weekday","no_sled","2","2","2",7.2,0.1,32,0,26,22.5,0,1,1,0,0,1,2,2
"675",2018-02-27,"Cement Creek","w1718","Motorized",9,"Tue","weekday","sled","2","2","2",7.2,0.1,32,0,26,22.5,0,1,1,0,0,1,2,2
"676",2018-02-27,"Cement Creek","w1718","Hybrid",0,"Tue","weekday","sled","2","2","2",7.2,0.1,32,0,26,22.5,0,1,1,0,0,1,2,2
"677",2018-02-28,"Cement Creek","w1718","Non.motorized",12,"Wed","weekday","no_sled","2","2","2",7.2,0,31,-1,23,23.2,0,0,1,1,-1,-1,0,1
"678",2018-02-28,"Cement Creek","w1718","Mechanized",1,"Wed","weekday","no_sled","2","2","2",7.2,0,31,-1,23,23.2,0,0,1,1,-1,-1,0,1
"679",2018-02-28,"Cement Creek","w1718","Motorized",5,"Wed","weekday","sled","2","2","2",7.2,0,31,-1,23,23.2,0,0,1,1,-1,-1,0,1
"680",2018-02-28,"Cement Creek","w1718","Hybrid",0,"Wed","weekday","sled","2","2","2",7.2,0,31,-1,23,23.2,0,0,1,1,-1,-1,0,1
"681",2018-03-01,"Cement Creek","w1718","Non.motorized",10,"Thu","weekday","no_sled","2","2","2",7.2,0,31,0,24,23.2,-1,0,0,1,-1,-1,-1,0
"682",2018-03-01,"Cement Creek","w1718","Mechanized",5,"Thu","weekday","no_sled","2","2","2",7.2,0,31,0,24,23.2,-1,0,0,1,-1,-1,-1,0
"683",2018-03-01,"Cement Creek","w1718","Motorized",7,"Thu","weekday","sled","2","2","2",7.2,0,31,0,24,23.2,-1,0,0,1,-1,-1,-1,0
"684",2018-03-01,"Cement Creek","w1718","Hybrid",0,"Thu","weekday","sled","2","2","2",7.2,0,31,0,24,23.2,-1,0,0,1,-1,-1,-1,0
"685",2018-03-02,"Cement Creek","w1718","Non.motorized",19,"Fri","weekday","no_sled","2","2","1",7.2,0,31,0,30,23.2,0,-1,0,0,0,-1,-1,-1
"686",2018-03-02,"Cement Creek","w1718","Mechanized",2,"Fri","weekday","no_sled","2","2","1",7.2,0,31,0,30,23.2,0,-1,0,0,0,-1,-1,-1
"687",2018-03-02,"Cement Creek","w1718","Motorized",12,"Fri","weekday","sled","2","2","1",7.2,0,31,0,30,23.2,0,-1,0,0,0,-1,-1,-1
"688",2018-03-02,"Cement Creek","w1718","Hybrid",0,"Fri","weekday","sled","2","2","1",7.2,0,31,0,30,23.2,0,-1,0,0,0,-1,-1,-1
"689",2018-03-03,"Cement Creek","w1718","Non.motorized",49,"Sat","weekend","no_sled","2","2","1",7.3,0.1,30,-1,34,24.3,0,0,-1,0,-1,-1,-2,-2
"690",2018-03-03,"Cement Creek","w1718","Mechanized",1,"Sat","weekend","no_sled","2","2","1",7.3,0.1,30,-1,34,24.3,0,0,-1,0,-1,-1,-2,-2
"691",2018-03-03,"Cement Creek","w1718","Motorized",7,"Sat","weekend","sled","2","2","1",7.3,0.1,30,-1,34,24.3,0,0,-1,0,-1,-1,-2,-2
"692",2018-03-03,"Cement Creek","w1718","Hybrid",0,"Sat","weekend","sled","2","2","1",7.3,0.1,30,-1,34,24.3,0,0,-1,0,-1,-1,-2,-2
"693",2018-03-04,"Cement Creek","w1718","Non.motorized",39,"Sun","weekend","no_sled","2","2","1",7.3,0,29,-1,24,25.2,-1,0,0,-1,-2,-2,-2,-3
"694",2018-03-04,"Cement Creek","w1718","Mechanized",2,"Sun","weekend","no_sled","2","2","1",7.3,0,29,-1,24,25.2,-1,0,0,-1,-2,-2,-2,-3
"695",2018-03-04,"Cement Creek","w1718","Motorized",5,"Sun","weekend","sled","2","2","1",7.3,0,29,-1,24,25.2,-1,0,0,-1,-2,-2,-2,-3
"696",2018-03-04,"Cement Creek","w1718","Hybrid",0,"Sun","weekend","sled","2","2","1",7.3,0,29,-1,24,25.2,-1,0,0,-1,-2,-2,-2,-3
"697",2018-03-05,"Cement Creek","w1718","Non.motorized",17,"Mon","weekday","no_sled","2","2","1",7.3,0,31,2,13,23.5,-1,-1,0,0,1,0,0,0
"698",2018-03-05,"Cement Creek","w1718","Mechanized",0,"Mon","weekday","no_sled","2","2","1",7.3,0,31,2,13,23.5,-1,-1,0,0,1,0,0,0
"699",2018-03-05,"Cement Creek","w1718","Motorized",9,"Mon","weekday","sled","2","2","1",7.3,0,31,2,13,23.5,-1,-1,0,0,1,0,0,0
"700",2018-03-05,"Cement Creek","w1718","Hybrid",0,"Mon","weekday","sled","2","2","1",7.3,0,31,2,13,23.5,-1,-1,0,0,1,0,0,0
"701",2018-03-06,"Cement Creek","w1718","Non.motorized",12,"Tue","weekday","no_sled","2","2","1",7.3,0,31,0,19,23.5,2,-1,-1,0,2,1,0,0
"702",2018-03-06,"Cement Creek","w1718","Mechanized",1,"Tue","weekday","no_sled","2","2","1",7.3,0,31,0,19,23.5,2,-1,-1,0,2,1,0,0
"703",2018-03-06,"Cement Creek","w1718","Motorized",6,"Tue","weekday","sled","2","2","1",7.3,0,31,0,19,23.5,2,-1,-1,0,2,1,0,0
"704",2018-03-06,"Cement Creek","w1718","Hybrid",0,"Tue","weekday","sled","2","2","1",7.3,0,31,0,19,23.5,2,-1,-1,0,2,1,0,0
"705",2018-03-07,"Cement Creek","w1718","Non.motorized",22,"Wed","weekday","no_sled","2","2","1",7.4,0.1,31,0,27,23.9,0,2,-1,-1,0,2,1,0
"706",2018-03-07,"Cement Creek","w1718","Mechanized",3,"Wed","weekday","no_sled","2","2","1",7.4,0.1,31,0,27,23.9,0,2,-1,-1,0,2,1,0
"707",2018-03-07,"Cement Creek","w1718","Motorized",7,"Wed","weekday","sled","2","2","1",7.4,0.1,31,0,27,23.9,0,2,-1,-1,0,2,1,0
"708",2018-03-07,"Cement Creek","w1718","Hybrid",2,"Wed","weekday","sled","2","2","1",7.4,0.1,31,0,27,23.9,0,2,-1,-1,0,2,1,0
"709",2018-03-08,"Cement Creek","w1718","Non.motorized",13,"Thu","weekday","no_sled","2","2","1",7.4,0,30,-1,33,24.7,0,0,2,-1,-1,-1,1,0
"710",2018-03-08,"Cement Creek","w1718","Mechanized",1,"Thu","weekday","no_sled","2","2","1",7.4,0,30,-1,33,24.7,0,0,2,-1,-1,-1,1,0
"711",2018-03-08,"Cement Creek","w1718","Motorized",2,"Thu","weekday","sled","2","2","1",7.4,0,30,-1,33,24.7,0,0,2,-1,-1,-1,1,0
"712",2018-03-08,"Cement Creek","w1718","Hybrid",0,"Thu","weekday","sled","2","2","1",7.4,0,30,-1,33,24.7,0,0,2,-1,-1,-1,1,0
"713",2018-03-09,"Cement Creek","w1718","Non.motorized",5,"Fri","weekday","no_sled","2","2","1",7.4,0,30,0,34,24.7,-1,0,0,2,-1,-1,-1,1
"714",2018-03-09,"Cement Creek","w1718","Mechanized",2,"Fri","weekday","no_sled","2","2","1",7.4,0,30,0,34,24.7,-1,0,0,2,-1,-1,-1,1
"715",2018-03-09,"Cement Creek","w1718","Motorized",7,"Fri","weekday","sled","2","2","1",7.4,0,30,0,34,24.7,-1,0,0,2,-1,-1,-1,1
"716",2018-03-09,"Cement Creek","w1718","Hybrid",0,"Fri","weekday","sled","2","2","1",7.4,0,30,0,34,24.7,-1,0,0,2,-1,-1,-1,1
"717",2018-03-10,"Cement Creek","w1718","Non.motorized",11,"Sat","weekend","no_sled","1","1","1",7.4,0,30,0,31,24.7,0,-1,0,0,0,-1,-1,-1
"718",2018-03-10,"Cement Creek","w1718","Mechanized",2,"Sat","weekend","no_sled","1","1","1",7.4,0,30,0,31,24.7,0,-1,0,0,0,-1,-1,-1
"719",2018-03-10,"Cement Creek","w1718","Motorized",5,"Sat","weekend","sled","1","1","1",7.4,0,30,0,31,24.7,0,-1,0,0,0,-1,-1,-1
"720",2018-03-10,"Cement Creek","w1718","Hybrid",0,"Sat","weekend","sled","1","1","1",7.4,0,30,0,31,24.7,0,-1,0,0,0,-1,-1,-1
"721",2018-03-11,"Cement Creek","w1718","Non.motorized",30,"Sun","weekend","no_sled","1","1","1",7.4,0,29,-1,31,25.5,0,0,-1,0,-1,-1,-2,-2
"722",2018-03-11,"Cement Creek","w1718","Mechanized",0,"Sun","weekend","no_sled","1","1","1",7.4,0,29,-1,31,25.5,0,0,-1,0,-1,-1,-2,-2
"723",2018-03-11,"Cement Creek","w1718","Motorized",6,"Sun","weekend","sled","1","1","1",7.4,0,29,-1,31,25.5,0,0,-1,0,-1,-1,-2,-2
"724",2018-03-11,"Cement Creek","w1718","Hybrid",2,"Sun","weekend","sled","1","1","1",7.4,0,29,-1,31,25.5,0,0,-1,0,-1,-1,-2,-2
"725",2018-03-12,"Cement Creek","w1718","Non.motorized",15,"Mon","weekday","no_sled","1","1","1",7.4,0,29,0,33,25.5,-1,0,0,-1,-1,-1,-1,-2
"726",2018-03-12,"Cement Creek","w1718","Mechanized",0,"Mon","weekday","no_sled","1","1","1",7.4,0,29,0,33,25.5,-1,0,0,-1,-1,-1,-1,-2
"727",2018-03-12,"Cement Creek","w1718","Motorized",4,"Mon","weekday","sled","1","1","1",7.4,0,29,0,33,25.5,-1,0,0,-1,-1,-1,-1,-2
"728",2018-03-12,"Cement Creek","w1718","Hybrid",2,"Mon","weekday","sled","1","1","1",7.4,0,29,0,33,25.5,-1,0,0,-1,-1,-1,-1,-2
"729",2018-03-13,"Cement Creek","w1718","Non.motorized",4,"Tue","weekday","no_sled","1","1","1",7.4,0,29,0,34,25.5,0,-1,0,0,0,-1,-1,-1
"730",2018-03-13,"Cement Creek","w1718","Mechanized",0,"Tue","weekday","no_sled","1","1","1",7.4,0,29,0,34,25.5,0,-1,0,0,0,-1,-1,-1
"731",2018-03-13,"Cement Creek","w1718","Motorized",10,"Tue","weekday","sled","1","1","1",7.4,0,29,0,34,25.5,0,-1,0,0,0,-1,-1,-1
"732",2018-03-13,"Cement Creek","w1718","Hybrid",3,"Tue","weekday","sled","1","1","1",7.4,0,29,0,34,25.5,0,-1,0,0,0,-1,-1,-1
"733",2018-03-14,"Cement Creek","w1718","Non.motorized",13,"Wed","weekday","no_sled","1","2","2",7.4,0,29,0,39,25.5,0,0,-1,0,0,0,-1,-1
"734",2018-03-14,"Cement Creek","w1718","Mechanized",2,"Wed","weekday","no_sled","1","2","2",7.4,0,29,0,39,25.5,0,0,-1,0,0,0,-1,-1
"735",2018-03-14,"Cement Creek","w1718","Motorized",3,"Wed","weekday","sled","1","2","2",7.4,0,29,0,39,25.5,0,0,-1,0,0,0,-1,-1
"736",2018-03-14,"Cement Creek","w1718","Hybrid",0,"Wed","weekday","sled","1","2","2",7.4,0,29,0,39,25.5,0,0,-1,0,0,0,-1,-1
"737",2018-03-15,"Cement Creek","w1718","Non.motorized",11,"Thu","weekday","no_sled","2","2","2",7.5,0.1,28,-1,31,26.8,0,0,0,-1,-1,-1,-1,-2
"738",2018-03-15,"Cement Creek","w1718","Mechanized",0,"Thu","weekday","no_sled","2","2","2",7.5,0.1,28,-1,31,26.8,0,0,0,-1,-1,-1,-1,-2
"739",2018-03-15,"Cement Creek","w1718","Motorized",0,"Thu","weekday","sled","2","2","2",7.5,0.1,28,-1,31,26.8,0,0,0,-1,-1,-1,-1,-2
"740",2018-03-15,"Cement Creek","w1718","Hybrid",0,"Thu","weekday","sled","2","2","2",7.5,0.1,28,-1,31,26.8,0,0,0,-1,-1,-1,-1,-2
"741",2018-03-16,"Cement Creek","w1718","Non.motorized",21,"Fri","weekday","no_sled","2","2","2",7.7,0.2,29,1,25,26.6,-1,0,0,0,0,0,0,0
"742",2018-03-16,"Cement Creek","w1718","Mechanized",0,"Fri","weekday","no_sled","2","2","2",7.7,0.2,29,1,25,26.6,-1,0,0,0,0,0,0,0
"743",2018-03-16,"Cement Creek","w1718","Motorized",6,"Fri","weekday","sled","2","2","2",7.7,0.2,29,1,25,26.6,-1,0,0,0,0,0,0,0
"744",2018-03-16,"Cement Creek","w1718","Hybrid",0,"Fri","weekday","sled","2","2","2",7.7,0.2,29,1,25,26.6,-1,0,0,0,0,0,0,0
"745",2018-03-17,"Cement Creek","w1718","Non.motorized",40,"Sat","weekend","no_sled","2","2","2",7.8,0.1,32,3,29,24.4,1,-1,0,0,4,3,3,3
"746",2018-03-17,"Cement Creek","w1718","Mechanized",1,"Sat","weekend","no_sled","2","2","2",7.8,0.1,32,3,29,24.4,1,-1,0,0,4,3,3,3
"747",2018-03-17,"Cement Creek","w1718","Motorized",8,"Sat","weekend","sled","2","2","2",7.8,0.1,32,3,29,24.4,1,-1,0,0,4,3,3,3
"748",2018-03-17,"Cement Creek","w1718","Hybrid",0,"Sat","weekend","sled","2","2","2",7.8,0.1,32,3,29,24.4,1,-1,0,0,4,3,3,3
"749",2018-03-18,"Cement Creek","w1718","Non.motorized",13,"Sun","weekend","no_sled","2","2","2",7.9,0.1,31,-1,24,25.5,3,1,-1,0,2,3,2,2
"750",2018-03-18,"Cement Creek","w1718","Mechanized",1,"Sun","weekend","no_sled","2","2","2",7.9,0.1,31,-1,24,25.5,3,1,-1,0,2,3,2,2
"751",2018-03-18,"Cement Creek","w1718","Motorized",8,"Sun","weekend","sled","2","2","2",7.9,0.1,31,-1,24,25.5,3,1,-1,0,2,3,2,2
"752",2018-03-18,"Cement Creek","w1718","Hybrid",0,"Sun","weekend","sled","2","2","2",7.9,0.1,31,-1,24,25.5,3,1,-1,0,2,3,2,2
"753",2018-03-19,"Cement Creek","w1718","Non.motorized",9,"Mon","weekday","no_sled","2","2","1",8,0.1,32,1,19,25,-1,3,1,-1,0,3,4,3
"754",2018-03-19,"Cement Creek","w1718","Mechanized",1,"Mon","weekday","no_sled","2","2","1",8,0.1,32,1,19,25,-1,3,1,-1,0,3,4,3
"755",2018-03-19,"Cement Creek","w1718","Motorized",7,"Mon","weekday","sled","2","2","1",8,0.1,32,1,19,25,-1,3,1,-1,0,3,4,3
"756",2018-03-19,"Cement Creek","w1718","Hybrid",0,"Mon","weekday","sled","2","2","1",8,0.1,32,1,19,25,-1,3,1,-1,0,3,4,3
"757",2018-03-20,"Cement Creek","w1718","Non.motorized",13,"Tue","weekday","no_sled","2","2","1",8,0,30,-2,24,26.7,1,-1,3,1,-1,-2,1,2
"758",2018-03-20,"Cement Creek","w1718","Mechanized",2,"Tue","weekday","no_sled","2","2","1",8,0,30,-2,24,26.7,1,-1,3,1,-1,-2,1,2
"759",2018-03-20,"Cement Creek","w1718","Motorized",10,"Tue","weekday","sled","2","2","1",8,0,30,-2,24,26.7,1,-1,3,1,-1,-2,1,2
"760",2018-03-20,"Cement Creek","w1718","Hybrid",0,"Tue","weekday","sled","2","2","1",8,0,30,-2,24,26.7,1,-1,3,1,-1,-2,1,2
"761",2018-03-21,"Cement Creek","w1718","Non.motorized",8,"Wed","weekday","no_sled","1","1","1",8.1,0.1,32,2,30,25.3,-2,1,-1,3,0,1,0,3
"762",2018-03-21,"Cement Creek","w1718","Mechanized",0,"Wed","weekday","no_sled","1","1","1",8.1,0.1,32,2,30,25.3,-2,1,-1,3,0,1,0,3
"763",2018-03-21,"Cement Creek","w1718","Motorized",6,"Wed","weekday","sled","1","1","1",8.1,0.1,32,2,30,25.3,-2,1,-1,3,0,1,0,3
"764",2018-03-21,"Cement Creek","w1718","Hybrid",1,"Wed","weekday","sled","1","1","1",8.1,0.1,32,2,30,25.3,-2,1,-1,3,0,1,0,3
"765",2018-03-22,"Cement Creek","w1718","Non.motorized",21,"Thu","weekday","no_sled","1","1","1",8.1,0,30,-2,36,27,2,-2,1,-1,0,-2,-1,-2
"766",2018-03-22,"Cement Creek","w1718","Mechanized",0,"Thu","weekday","no_sled","1","1","1",8.1,0,30,-2,36,27,2,-2,1,-1,0,-2,-1,-2
"767",2018-03-22,"Cement Creek","w1718","Motorized",3,"Thu","weekday","sled","1","1","1",8.1,0,30,-2,36,27,2,-2,1,-1,0,-2,-1,-2
"768",2018-03-22,"Cement Creek","w1718","Hybrid",0,"Thu","weekday","sled","1","1","1",8.1,0,30,-2,36,27,2,-2,1,-1,0,-2,-1,-2
"769",2018-03-23,"Cement Creek","w1718","Non.motorized",2,"Fri","weekday","no_sled","2","2","3",8.2,0.1,29,-1,34,28.3,-2,2,-2,1,-3,-1,-3,-2
"770",2018-03-23,"Cement Creek","w1718","Mechanized",0,"Fri","weekday","no_sled","2","2","3",8.2,0.1,29,-1,34,28.3,-2,2,-2,1,-3,-1,-3,-2
"771",2018-03-23,"Cement Creek","w1718","Motorized",4,"Fri","weekday","sled","2","2","3",8.2,0.1,29,-1,34,28.3,-2,2,-2,1,-3,-1,-3,-2
"772",2018-03-23,"Cement Creek","w1718","Hybrid",0,"Fri","weekday","sled","2","2","3",8.2,0.1,29,-1,34,28.3,-2,2,-2,1,-3,-1,-3,-2
"773",2018-03-24,"Cement Creek","w1718","Non.motorized",6,"Sat","weekend","no_sled","2","2","1",8.9,0.7,34,5,32,26.2,-1,-2,2,-2,4,2,4,2
"774",2018-03-24,"Cement Creek","w1718","Mechanized",0,"Sat","weekend","no_sled","2","2","1",8.9,0.7,34,5,32,26.2,-1,-2,2,-2,4,2,4,2
"775",2018-03-24,"Cement Creek","w1718","Motorized",5,"Sat","weekend","sled","2","2","1",8.9,0.7,34,5,32,26.2,-1,-2,2,-2,4,2,4,2
"776",2018-03-24,"Cement Creek","w1718","Hybrid",0,"Sat","weekend","sled","2","2","1",8.9,0.7,34,5,32,26.2,-1,-2,2,-2,4,2,4,2
"777",2018-03-25,"Cement Creek","w1718","Non.motorized",20,"Sun","weekend","no_sled","2","2","1",8.9,0,35,1,35,25.4,5,-1,-2,2,6,5,3,5
"778",2018-03-25,"Cement Creek","w1718","Mechanized",0,"Sun","weekend","no_sled","2","2","1",8.9,0,35,1,35,25.4,5,-1,-2,2,6,5,3,5
"779",2018-03-25,"Cement Creek","w1718","Motorized",6,"Sun","weekend","sled","2","2","1",8.9,0,35,1,35,25.4,5,-1,-2,2,6,5,3,5
"780",2018-03-25,"Cement Creek","w1718","Hybrid",2,"Sun","weekend","sled","2","2","1",8.9,0,35,1,35,25.4,5,-1,-2,2,6,5,3,5
"781",2018-03-26,"Cement Creek","w1718","Non.motorized",10,"Mon","weekday","no_sled","1","1","1",8.9,0,34,-1,31,26.2,1,5,-1,-2,0,5,4,2
"782",2018-03-26,"Cement Creek","w1718","Non.motorized",10,"Mon","weekday","no_sled","2","1","1",8.9,0,34,-1,31,26.2,1,5,-1,-2,0,5,4,2
"783",2018-03-26,"Cement Creek","w1718","Mechanized",1,"Mon","weekday","no_sled","1","1","1",8.9,0,34,-1,31,26.2,1,5,-1,-2,0,5,4,2
"784",2018-03-26,"Cement Creek","w1718","Mechanized",1,"Mon","weekday","no_sled","2","1","1",8.9,0,34,-1,31,26.2,1,5,-1,-2,0,5,4,2
"785",2018-03-26,"Cement Creek","w1718","Motorized",2,"Mon","weekday","sled","1","1","1",8.9,0,34,-1,31,26.2,1,5,-1,-2,0,5,4,2
"786",2018-03-26,"Cement Creek","w1718","Motorized",2,"Mon","weekday","sled","2","1","1",8.9,0,34,-1,31,26.2,1,5,-1,-2,0,5,4,2
"787",2018-03-26,"Cement Creek","w1718","Hybrid",0,"Mon","weekday","sled","1","1","1",8.9,0,34,-1,31,26.2,1,5,-1,-2,0,5,4,2
"788",2018-03-26,"Cement Creek","w1718","Hybrid",0,"Mon","weekday","sled","2","1","1",8.9,0,34,-1,31,26.2,1,5,-1,-2,0,5,4,2
"789",2018-03-27,"Cement Creek","w1718","Non.motorized",2,"Tue","weekday","no_sled","1","1","1",8.9,0,33,-1,29,27,-1,1,5,-1,-2,-1,4,3
"790",2018-03-27,"Cement Creek","w1718","Mechanized",0,"Tue","weekday","no_sled","1","1","1",8.9,0,33,-1,29,27,-1,1,5,-1,-2,-1,4,3
"791",2018-03-27,"Cement Creek","w1718","Motorized",4,"Tue","weekday","sled","1","1","1",8.9,0,33,-1,29,27,-1,1,5,-1,-2,-1,4,3
"792",2018-03-27,"Cement Creek","w1718","Hybrid",0,"Tue","weekday","sled","1","1","1",8.9,0,33,-1,29,27,-1,1,5,-1,-2,-1,4,3
"793",2018-03-28,"Cement Creek","w1718","Non.motorized",10,"Wed","weekday","no_sled","1","1","1",8.9,0,33,0,27,27,-1,-1,1,5,-1,-2,-1,4
"794",2018-03-28,"Cement Creek","w1718","Mechanized",0,"Wed","weekday","no_sled","1","1","1",8.9,0,33,0,27,27,-1,-1,1,5,-1,-2,-1,4
"795",2018-03-28,"Cement Creek","w1718","Motorized",1,"Wed","weekday","sled","1","1","1",8.9,0,33,0,27,27,-1,-1,1,5,-1,-2,-1,4
"796",2018-03-28,"Cement Creek","w1718","Hybrid",0,"Wed","weekday","sled","1","1","1",8.9,0,33,0,27,27,-1,-1,1,5,-1,-2,-1,4
"797",2018-03-29,"Cement Creek","w1718","Non.motorized",10,"Thu","weekday","no_sled","1","1","1",8.9,0,33,0,27,27,0,-1,-1,1,0,-1,-2,-1
"798",2018-03-29,"Cement Creek","w1718","Mechanized",0,"Thu","weekday","no_sled","1","1","1",8.9,0,33,0,27,27,0,-1,-1,1,0,-1,-2,-1
"799",2018-03-29,"Cement Creek","w1718","Motorized",4,"Thu","weekday","sled","1","1","1",8.9,0,33,0,27,27,0,-1,-1,1,0,-1,-2,-1
"800",2018-03-29,"Cement Creek","w1718","Hybrid",0,"Thu","weekday","sled","1","1","1",8.9,0,33,0,27,27,0,-1,-1,1,0,-1,-2,-1
"801",2018-03-30,"Cement Creek","w1718","Non.motorized",11,"Fri","weekday","no_sled","1","1","1",8.9,0,32,-1,33,27.8,0,0,-1,-1,-1,-1,-2,-3
"802",2018-03-30,"Cement Creek","w1718","Mechanized",0,"Fri","weekday","no_sled","1","1","1",8.9,0,32,-1,33,27.8,0,0,-1,-1,-1,-1,-2,-3
"803",2018-03-30,"Cement Creek","w1718","Motorized",8,"Fri","weekday","sled","1","1","1",8.9,0,32,-1,33,27.8,0,0,-1,-1,-1,-1,-2,-3
"804",2018-03-30,"Cement Creek","w1718","Hybrid",0,"Fri","weekday","sled","1","1","1",8.9,0,32,-1,33,27.8,0,0,-1,-1,-1,-1,-2,-3
"805",2017-12-22,"Gothic Rd","w1718","Non.motorized",0,"Fri","weekday","no_sled","2","2","1",2,0,11,3,17,18.2,0,0,0,0,3,3,3,3
"806",2017-12-22,"Gothic Rd","w1718","Mechanized",0,"Fri","weekday","no_sled","2","2","1",2,0,11,3,17,18.2,0,0,0,0,3,3,3,3
"807",2017-12-22,"Gothic Rd","w1718","Motorized",0,"Fri","weekday","sled","2","2","1",2,0,11,3,17,18.2,0,0,0,0,3,3,3,3
"808",2017-12-22,"Gothic Rd","w1718","Hybrid",0,"Fri","weekday","sled","2","2","1",2,0,11,3,17,18.2,0,0,0,0,3,3,3,3
"809",2017-12-23,"Gothic Rd","w1718","Non.motorized",0,"Sat","weekend","no_sled","2","1","1",2.1,0.1,10,-1,21,21,3,0,0,0,2,2,2,2
"810",2017-12-23,"Gothic Rd","w1718","Mechanized",0,"Sat","weekend","no_sled","2","1","1",2.1,0.1,10,-1,21,21,3,0,0,0,2,2,2,2
"811",2017-12-23,"Gothic Rd","w1718","Motorized",0,"Sat","weekend","sled","2","1","1",2.1,0.1,10,-1,21,21,3,0,0,0,2,2,2,2
"812",2017-12-23,"Gothic Rd","w1718","Hybrid",0,"Sat","weekend","sled","2","1","1",2.1,0.1,10,-1,21,21,3,0,0,0,2,2,2,2
"813",2017-12-24,"Gothic Rd","w1718","Non.motorized",0,"Sun","weekend","no_sled","1","1","1",2.4,0.3,14,4,19,17.1,-1,3,0,0,3,6,6,6
"814",2017-12-24,"Gothic Rd","w1718","Mechanized",0,"Sun","weekend","no_sled","1","1","1",2.4,0.3,14,4,19,17.1,-1,3,0,0,3,6,6,6
"815",2017-12-24,"Gothic Rd","w1718","Motorized",0,"Sun","weekend","sled","1","1","1",2.4,0.3,14,4,19,17.1,-1,3,0,0,3,6,6,6
"816",2017-12-24,"Gothic Rd","w1718","Hybrid",0,"Sun","weekend","sled","1","1","1",2.4,0.3,14,4,19,17.1,-1,3,0,0,3,6,6,6
"817",2017-12-25,"Gothic Rd","w1718","Non.motorized",42,"Mon","weekday","no_sled","2","1","1",2.6,0.2,14,0,25,18.6,4,-1,3,0,4,3,6,6
"818",2017-12-25,"Gothic Rd","w1718","Mechanized",0,"Mon","weekday","no_sled","2","1","1",2.6,0.2,14,0,25,18.6,4,-1,3,0,4,3,6,6
"819",2017-12-25,"Gothic Rd","w1718","Motorized",2,"Mon","weekday","sled","2","1","1",2.6,0.2,14,0,25,18.6,4,-1,3,0,4,3,6,6
"820",2017-12-25,"Gothic Rd","w1718","Hybrid",0,"Mon","weekday","sled","2","1","1",2.6,0.2,14,0,25,18.6,4,-1,3,0,4,3,6,6
"821",2017-12-26,"Gothic Rd","w1718","Non.motorized",55,"Tue","weekday","no_sled","1","1","1",3.1,0.5,20,6,25,15.5,0,4,-1,3,6,10,9,12
"822",2017-12-26,"Gothic Rd","w1718","Mechanized",0,"Tue","weekday","no_sled","1","1","1",3.1,0.5,20,6,25,15.5,0,4,-1,3,6,10,9,12
"823",2017-12-26,"Gothic Rd","w1718","Motorized",4,"Tue","weekday","sled","1","1","1",3.1,0.5,20,6,25,15.5,0,4,-1,3,6,10,9,12
"824",2017-12-26,"Gothic Rd","w1718","Hybrid",0,"Tue","weekday","sled","1","1","1",3.1,0.5,20,6,25,15.5,0,4,-1,3,6,10,9,12
"825",2017-12-27,"Gothic Rd","w1718","Non.motorized",6,"Wed","weekday","no_sled","1","1","1",3.1,0,18,-2,27,17.2,6,0,4,-1,4,4,8,7
"826",2017-12-27,"Gothic Rd","w1718","Mechanized",1,"Wed","weekday","no_sled","1","1","1",3.1,0,18,-2,27,17.2,6,0,4,-1,4,4,8,7
"827",2017-12-27,"Gothic Rd","w1718","Motorized",0,"Wed","weekday","sled","1","1","1",3.1,0,18,-2,27,17.2,6,0,4,-1,4,4,8,7
"828",2017-12-27,"Gothic Rd","w1718","Hybrid",0,"Wed","weekday","sled","1","1","1",3.1,0,18,-2,27,17.2,6,0,4,-1,4,4,8,7
"829",2017-12-28,"Gothic Rd","w1718","Non.motorized",77,"Thu","weekday","no_sled","1","1","1",3.2,0.1,17,-1,31,18.8,-2,6,0,4,-3,3,3,7
"830",2017-12-28,"Gothic Rd","w1718","Mechanized",16,"Thu","weekday","no_sled","1","1","1",3.2,0.1,17,-1,31,18.8,-2,6,0,4,-3,3,3,7
"831",2017-12-28,"Gothic Rd","w1718","Motorized",1,"Thu","weekday","sled","1","1","1",3.2,0.1,17,-1,31,18.8,-2,6,0,4,-3,3,3,7
"832",2017-12-28,"Gothic Rd","w1718","Hybrid",0,"Thu","weekday","sled","1","1","1",3.2,0.1,17,-1,31,18.8,-2,6,0,4,-3,3,3,7
"833",2017-12-29,"Gothic Rd","w1718","Non.motorized",117,"Fri","weekday","no_sled","1","1","1",3.2,0,17,0,36,18.8,-1,-2,6,0,-1,-3,3,3
"834",2017-12-29,"Gothic Rd","w1718","Mechanized",9,"Fri","weekday","no_sled","1","1","1",3.2,0,17,0,36,18.8,-1,-2,6,0,-1,-3,3,3
"835",2017-12-29,"Gothic Rd","w1718","Motorized",0,"Fri","weekday","sled","1","1","1",3.2,0,17,0,36,18.8,-1,-2,6,0,-1,-3,3,3
"836",2017-12-29,"Gothic Rd","w1718","Hybrid",0,"Fri","weekday","sled","1","1","1",3.2,0,17,0,36,18.8,-1,-2,6,0,-1,-3,3,3
"837",2017-12-30,"Gothic Rd","w1718","Non.motorized",147,"Sat","weekend","no_sled","1","1","1",3.2,0,15,-2,37,21.3,0,-1,-2,6,-2,-3,-5,1
"838",2017-12-30,"Gothic Rd","w1718","Mechanized",10,"Sat","weekend","no_sled","1","1","1",3.2,0,15,-2,37,21.3,0,-1,-2,6,-2,-3,-5,1
"839",2017-12-30,"Gothic Rd","w1718","Motorized",2,"Sat","weekend","sled","1","1","1",3.2,0,15,-2,37,21.3,0,-1,-2,6,-2,-3,-5,1
"840",2017-12-30,"Gothic Rd","w1718","Hybrid",0,"Sat","weekend","sled","1","1","1",3.2,0,15,-2,37,21.3,0,-1,-2,6,-2,-3,-5,1
"841",2017-12-31,"Gothic Rd","w1718","Non.motorized",106,"Sun","weekend","no_sled","1","1","1",3.2,0,15,0,31,21.3,-2,0,-1,-2,-2,-2,-3,-5
"842",2017-12-31,"Gothic Rd","w1718","Mechanized",6,"Sun","weekend","no_sled","1","1","1",3.2,0,15,0,31,21.3,-2,0,-1,-2,-2,-2,-3,-5
"843",2017-12-31,"Gothic Rd","w1718","Motorized",4,"Sun","weekend","sled","1","1","1",3.2,0,15,0,31,21.3,-2,0,-1,-2,-2,-2,-3,-5
"844",2017-12-31,"Gothic Rd","w1718","Hybrid",0,"Sun","weekend","sled","1","1","1",3.2,0,15,0,31,21.3,-2,0,-1,-2,-2,-2,-3,-5
"845",2018-01-01,"Gothic Rd","w1718","Non.motorized",93,"Mon","weekday","no_sled","1","1","1",3.2,0,15,0,27,21.3,0,-2,0,-1,0,-2,-2,-3
"846",2018-01-01,"Gothic Rd","w1718","Mechanized",2,"Mon","weekday","no_sled","1","1","1",3.2,0,15,0,27,21.3,0,-2,0,-1,0,-2,-2,-3
"847",2018-01-01,"Gothic Rd","w1718","Motorized",0,"Mon","weekday","sled","1","1","1",3.2,0,15,0,27,21.3,0,-2,0,-1,0,-2,-2,-3
"848",2018-01-01,"Gothic Rd","w1718","Hybrid",0,"Mon","weekday","sled","1","1","1",3.2,0,15,0,27,21.3,0,-2,0,-1,0,-2,-2,-3
"849",2018-01-02,"Gothic Rd","w1718","Non.motorized",NA,"Tue","weekday","no_sled","1","1","1",3.2,0,15,0,22,21.3,0,0,-2,0,0,0,-2,-2
"850",2018-01-02,"Gothic Rd","w1718","Mechanized",NA,"Tue","weekday","no_sled","1","1","1",3.2,0,15,0,22,21.3,0,0,-2,0,0,0,-2,-2
"851",2018-01-02,"Gothic Rd","w1718","Motorized",NA,"Tue","weekday","sled","1","1","1",3.2,0,15,0,22,21.3,0,0,-2,0,0,0,-2,-2
"852",2018-01-02,"Gothic Rd","w1718","Hybrid",NA,"Tue","weekday","sled","1","1","1",3.2,0,15,0,22,21.3,0,0,-2,0,0,0,-2,-2
"853",2018-01-03,"Gothic Rd","w1718","Non.motorized",NA,"Wed","weekday","no_sled","1","1","1",3.2,0,15,0,27,21.3,0,0,0,-2,0,0,0,-2
"854",2018-01-03,"Gothic Rd","w1718","Mechanized",NA,"Wed","weekday","no_sled","1","1","1",3.2,0,15,0,27,21.3,0,0,0,-2,0,0,0,-2
"855",2018-01-03,"Gothic Rd","w1718","Motorized",NA,"Wed","weekday","sled","1","1","1",3.2,0,15,0,27,21.3,0,0,0,-2,0,0,0,-2
"856",2018-01-03,"Gothic Rd","w1718","Hybrid",NA,"Wed","weekday","sled","1","1","1",3.2,0,15,0,27,21.3,0,0,0,-2,0,0,0,-2
"857",2018-01-04,"Gothic Rd","w1718","Non.motorized",NA,"Thu","weekday","no_sled","1","1","1",3.2,0,15,0,29,21.3,0,0,0,0,0,0,0,0
"858",2018-01-04,"Gothic Rd","w1718","Mechanized",NA,"Thu","weekday","no_sled","1","1","1",3.2,0,15,0,29,21.3,0,0,0,0,0,0,0,0
"859",2018-01-04,"Gothic Rd","w1718","Motorized",NA,"Thu","weekday","sled","1","1","1",3.2,0,15,0,29,21.3,0,0,0,0,0,0,0,0
"860",2018-01-04,"Gothic Rd","w1718","Hybrid",NA,"Thu","weekday","sled","1","1","1",3.2,0,15,0,29,21.3,0,0,0,0,0,0,0,0
"861",2018-01-05,"Gothic Rd","w1718","Non.motorized",NA,"Fri","weekday","no_sled","1","1","1",3.2,0,14,-1,32,22.9,0,0,0,0,-1,-1,-1,-1
"862",2018-01-05,"Gothic Rd","w1718","Mechanized",NA,"Fri","weekday","no_sled","1","1","1",3.2,0,14,-1,32,22.9,0,0,0,0,-1,-1,-1,-1
"863",2018-01-05,"Gothic Rd","w1718","Motorized",NA,"Fri","weekday","sled","1","1","1",3.2,0,14,-1,32,22.9,0,0,0,0,-1,-1,-1,-1
"864",2018-01-05,"Gothic Rd","w1718","Hybrid",NA,"Fri","weekday","sled","1","1","1",3.2,0,14,-1,32,22.9,0,0,0,0,-1,-1,-1,-1
"865",2018-01-06,"Gothic Rd","w1718","Non.motorized",NA,"Sat","weekend","no_sled","1","1","1",3.2,0,14,0,30,22.9,-1,0,0,0,-1,-1,-1,-1
"866",2018-01-06,"Gothic Rd","w1718","Mechanized",NA,"Sat","weekend","no_sled","1","1","1",3.2,0,14,0,30,22.9,-1,0,0,0,-1,-1,-1,-1
"867",2018-01-06,"Gothic Rd","w1718","Motorized",NA,"Sat","weekend","sled","1","1","1",3.2,0,14,0,30,22.9,-1,0,0,0,-1,-1,-1,-1
"868",2018-01-06,"Gothic Rd","w1718","Hybrid",NA,"Sat","weekend","sled","1","1","1",3.2,0,14,0,30,22.9,-1,0,0,0,-1,-1,-1,-1
"869",2018-01-07,"Gothic Rd","w1718","Non.motorized",16,"Sun","weekend","no_sled","2","2","2",3.5,0.3,18,4,25,19.4,0,-1,0,0,4,3,3,3
"870",2018-01-07,"Gothic Rd","w1718","Mechanized",0,"Sun","weekend","no_sled","2","2","2",3.5,0.3,18,4,25,19.4,0,-1,0,0,4,3,3,3
"871",2018-01-07,"Gothic Rd","w1718","Motorized",0,"Sun","weekend","sled","2","2","2",3.5,0.3,18,4,25,19.4,0,-1,0,0,4,3,3,3
"872",2018-01-07,"Gothic Rd","w1718","Hybrid",0,"Sun","weekend","sled","2","2","2",3.5,0.3,18,4,25,19.4,0,-1,0,0,4,3,3,3
"873",2018-01-08,"Gothic Rd","w1718","Non.motorized",24,"Mon","weekday","no_sled","2","2","1",3.7,0.2,20,2,29,18.5,4,0,-1,0,6,6,5,5
"874",2018-01-08,"Gothic Rd","w1718","Mechanized",1,"Mon","weekday","no_sled","2","2","1",3.7,0.2,20,2,29,18.5,4,0,-1,0,6,6,5,5
"875",2018-01-08,"Gothic Rd","w1718","Motorized",0,"Mon","weekday","sled","2","2","1",3.7,0.2,20,2,29,18.5,4,0,-1,0,6,6,5,5
"876",2018-01-08,"Gothic Rd","w1718","Hybrid",0,"Mon","weekday","sled","2","2","1",3.7,0.2,20,2,29,18.5,4,0,-1,0,6,6,5,5
"877",2018-01-09,"Gothic Rd","w1718","Non.motorized",26,"Tue","weekday","no_sled","2","2","1",3.8,0.1,21,1,34,18.1,2,4,0,-1,3,7,7,6
"878",2018-01-09,"Gothic Rd","w1718","Mechanized",0,"Tue","weekday","no_sled","2","2","1",3.8,0.1,21,1,34,18.1,2,4,0,-1,3,7,7,6
"879",2018-01-09,"Gothic Rd","w1718","Motorized",1,"Tue","weekday","sled","2","2","1",3.8,0.1,21,1,34,18.1,2,4,0,-1,3,7,7,6
"880",2018-01-09,"Gothic Rd","w1718","Hybrid",0,"Tue","weekday","sled","2","2","1",3.8,0.1,21,1,34,18.1,2,4,0,-1,3,7,7,6
"881",2018-01-10,"Gothic Rd","w1718","Non.motorized",NA,"Wed","weekday","no_sled","3","3","3",4,0.2,21,0,28,19,1,2,4,0,1,3,7,7
"882",2018-01-10,"Gothic Rd","w1718","Mechanized",NA,"Wed","weekday","no_sled","3","3","3",4,0.2,21,0,28,19,1,2,4,0,1,3,7,7
"883",2018-01-10,"Gothic Rd","w1718","Motorized",NA,"Wed","weekday","sled","3","3","3",4,0.2,21,0,28,19,1,2,4,0,1,3,7,7
"884",2018-01-10,"Gothic Rd","w1718","Hybrid",NA,"Wed","weekday","sled","3","3","3",4,0.2,21,0,28,19,1,2,4,0,1,3,7,7
"885",2018-01-11,"Gothic Rd","w1718","Non.motorized",NA,"Thu","weekday","no_sled","3","3","3",4.1,0.1,26,5,17,15.8,0,1,2,4,5,6,8,12
"886",2018-01-11,"Gothic Rd","w1718","Mechanized",NA,"Thu","weekday","no_sled","3","3","3",4.1,0.1,26,5,17,15.8,0,1,2,4,5,6,8,12
"887",2018-01-11,"Gothic Rd","w1718","Motorized",NA,"Thu","weekday","sled","3","3","3",4.1,0.1,26,5,17,15.8,0,1,2,4,5,6,8,12
"888",2018-01-11,"Gothic Rd","w1718","Hybrid",NA,"Thu","weekday","sled","3","3","3",4.1,0.1,26,5,17,15.8,0,1,2,4,5,6,8,12
"889",2018-01-12,"Gothic Rd","w1718","Non.motorized",NA,"Fri","weekday","no_sled","3","3","3",4.3,0.2,24,-2,22,17.9,5,0,1,2,3,3,4,6
"890",2018-01-12,"Gothic Rd","w1718","Mechanized",NA,"Fri","weekday","no_sled","3","3","3",4.3,0.2,24,-2,22,17.9,5,0,1,2,3,3,4,6
"891",2018-01-12,"Gothic Rd","w1718","Motorized",NA,"Fri","weekday","sled","3","3","3",4.3,0.2,24,-2,22,17.9,5,0,1,2,3,3,4,6
"892",2018-01-12,"Gothic Rd","w1718","Hybrid",NA,"Fri","weekday","sled","3","3","3",4.3,0.2,24,-2,22,17.9,5,0,1,2,3,3,4,6
"893",2018-01-13,"Gothic Rd","w1718","Non.motorized",NA,"Sat","weekend","no_sled","3","3","3",4.4,0.1,24,0,24,18.3,-2,5,0,1,-2,3,3,4
"894",2018-01-13,"Gothic Rd","w1718","Mechanized",NA,"Sat","weekend","no_sled","3","3","3",4.4,0.1,24,0,24,18.3,-2,5,0,1,-2,3,3,4
"895",2018-01-13,"Gothic Rd","w1718","Motorized",NA,"Sat","weekend","sled","3","3","3",4.4,0.1,24,0,24,18.3,-2,5,0,1,-2,3,3,4
"896",2018-01-13,"Gothic Rd","w1718","Hybrid",NA,"Sat","weekend","sled","3","3","3",4.4,0.1,24,0,24,18.3,-2,5,0,1,-2,3,3,4
"897",2018-01-14,"Gothic Rd","w1718","Non.motorized",NA,"Sun","weekend","no_sled","3","3","2",4.4,0,24,0,27,18.3,0,-2,5,0,0,-2,3,3
"898",2018-01-14,"Gothic Rd","w1718","Mechanized",NA,"Sun","weekend","no_sled","3","3","2",4.4,0,24,0,27,18.3,0,-2,5,0,0,-2,3,3
"899",2018-01-14,"Gothic Rd","w1718","Motorized",NA,"Sun","weekend","sled","3","3","2",4.4,0,24,0,27,18.3,0,-2,5,0,0,-2,3,3
"900",2018-01-14,"Gothic Rd","w1718","Hybrid",NA,"Sun","weekend","sled","3","3","2",4.4,0,24,0,27,18.3,0,-2,5,0,0,-2,3,3
"901",2018-01-15,"Gothic Rd","w1718","Non.motorized",NA,"Mon","weekday","no_sled","3","3","2",4.4,0,23,-1,27,19.1,0,0,-2,5,-1,-1,-3,2
"902",2018-01-15,"Gothic Rd","w1718","Mechanized",NA,"Mon","weekday","no_sled","3","3","2",4.4,0,23,-1,27,19.1,0,0,-2,5,-1,-1,-3,2
"903",2018-01-15,"Gothic Rd","w1718","Motorized",NA,"Mon","weekday","sled","3","3","2",4.4,0,23,-1,27,19.1,0,0,-2,5,-1,-1,-3,2
"904",2018-01-15,"Gothic Rd","w1718","Hybrid",NA,"Mon","weekday","sled","3","3","2",4.4,0,23,-1,27,19.1,0,0,-2,5,-1,-1,-3,2
"905",2018-01-16,"Gothic Rd","w1718","Non.motorized",NA,"Tue","weekday","no_sled","3","3","2",4.4,0,22,-1,20,20,-1,0,0,-2,-2,-2,-2,-4
"906",2018-01-16,"Gothic Rd","w1718","Mechanized",NA,"Tue","weekday","no_sled","3","3","2",4.4,0,22,-1,20,20,-1,0,0,-2,-2,-2,-2,-4
"907",2018-01-16,"Gothic Rd","w1718","Motorized",NA,"Tue","weekday","sled","3","3","2",4.4,0,22,-1,20,20,-1,0,0,-2,-2,-2,-2,-4
"908",2018-01-16,"Gothic Rd","w1718","Hybrid",NA,"Tue","weekday","sled","3","3","2",4.4,0,22,-1,20,20,-1,0,0,-2,-2,-2,-2,-4
"909",2018-01-17,"Gothic Rd","w1718","Non.motorized",NA,"Wed","weekday","no_sled","2","2","2",4.4,0,22,0,24,20,-1,-1,0,0,-1,-2,-2,-2
"910",2018-01-17,"Gothic Rd","w1718","Mechanized",NA,"Wed","weekday","no_sled","2","2","2",4.4,0,22,0,24,20,-1,-1,0,0,-1,-2,-2,-2
"911",2018-01-17,"Gothic Rd","w1718","Motorized",NA,"Wed","weekday","sled","2","2","2",4.4,0,22,0,24,20,-1,-1,0,0,-1,-2,-2,-2
"912",2018-01-17,"Gothic Rd","w1718","Hybrid",NA,"Wed","weekday","sled","2","2","2",4.4,0,22,0,24,20,-1,-1,0,0,-1,-2,-2,-2
"913",2018-01-18,"Gothic Rd","w1718","Non.motorized",NA,"Thu","weekday","no_sled","2","2","2",4.4,0,21,-1,29,21,0,-1,-1,0,-1,-2,-3,-3
"914",2018-01-18,"Gothic Rd","w1718","Mechanized",NA,"Thu","weekday","no_sled","2","2","2",4.4,0,21,-1,29,21,0,-1,-1,0,-1,-2,-3,-3
"915",2018-01-18,"Gothic Rd","w1718","Motorized",NA,"Thu","weekday","sled","2","2","2",4.4,0,21,-1,29,21,0,-1,-1,0,-1,-2,-3,-3
"916",2018-01-18,"Gothic Rd","w1718","Hybrid",NA,"Thu","weekday","sled","2","2","2",4.4,0,21,-1,29,21,0,-1,-1,0,-1,-2,-3,-3
"917",2018-01-19,"Gothic Rd","w1718","Non.motorized",NA,"Fri","weekday","no_sled","2","2","2",4.5,0.1,21,0,34,21.4,-1,0,-1,-1,-1,-1,-2,-3
"918",2018-01-19,"Gothic Rd","w1718","Mechanized",NA,"Fri","weekday","no_sled","2","2","2",4.5,0.1,21,0,34,21.4,-1,0,-1,-1,-1,-1,-2,-3
"919",2018-01-19,"Gothic Rd","w1718","Motorized",NA,"Fri","weekday","sled","2","2","2",4.5,0.1,21,0,34,21.4,-1,0,-1,-1,-1,-1,-2,-3
"920",2018-01-19,"Gothic Rd","w1718","Hybrid",NA,"Fri","weekday","sled","2","2","2",4.5,0.1,21,0,34,21.4,-1,0,-1,-1,-1,-1,-2,-3
"921",2018-01-20,"Gothic Rd","w1718","Non.motorized",NA,"Sat","weekend","no_sled","2","2","2",4.5,0,21,0,32,21.4,0,-1,0,-1,0,-1,-1,-2
"922",2018-01-20,"Gothic Rd","w1718","Mechanized",NA,"Sat","weekend","no_sled","2","2","2",4.5,0,21,0,32,21.4,0,-1,0,-1,0,-1,-1,-2
"923",2018-01-20,"Gothic Rd","w1718","Motorized",NA,"Sat","weekend","sled","2","2","2",4.5,0,21,0,32,21.4,0,-1,0,-1,0,-1,-1,-2
"924",2018-01-20,"Gothic Rd","w1718","Hybrid",NA,"Sat","weekend","sled","2","2","2",4.5,0,21,0,32,21.4,0,-1,0,-1,0,-1,-1,-2
"925",2018-01-21,"Gothic Rd","w1718","Non.motorized",NA,"Sun","weekend","no_sled","3","3","3",4.6,0.1,23,2,15,20,0,0,-1,0,2,2,1,1
"926",2018-01-21,"Gothic Rd","w1718","Mechanized",NA,"Sun","weekend","no_sled","3","3","3",4.6,0.1,23,2,15,20,0,0,-1,0,2,2,1,1
"927",2018-01-21,"Gothic Rd","w1718","Motorized",NA,"Sun","weekend","sled","3","3","3",4.6,0.1,23,2,15,20,0,0,-1,0,2,2,1,1
"928",2018-01-21,"Gothic Rd","w1718","Hybrid",NA,"Sun","weekend","sled","3","3","3",4.6,0.1,23,2,15,20,0,0,-1,0,2,2,1,1
"929",2018-01-22,"Gothic Rd","w1718","Non.motorized",NA,"Mon","weekday","no_sled","3","3","3",4.6,0,21,-2,12,21.9,2,0,0,-1,0,0,0,-1
"930",2018-01-22,"Gothic Rd","w1718","Mechanized",NA,"Mon","weekday","no_sled","3","3","3",4.6,0,21,-2,12,21.9,2,0,0,-1,0,0,0,-1
"931",2018-01-22,"Gothic Rd","w1718","Motorized",NA,"Mon","weekday","sled","3","3","3",4.6,0,21,-2,12,21.9,2,0,0,-1,0,0,0,-1
"932",2018-01-22,"Gothic Rd","w1718","Hybrid",NA,"Mon","weekday","sled","3","3","3",4.6,0,21,-2,12,21.9,2,0,0,-1,0,0,0,-1
"933",2018-01-23,"Gothic Rd","w1718","Non.motorized",NA,"Tue","weekday","no_sled","3","3","3",4.6,0,22,1,16,20.9,-2,2,0,0,-1,1,1,1
"934",2018-01-23,"Gothic Rd","w1718","Mechanized",NA,"Tue","weekday","no_sled","3","3","3",4.6,0,22,1,16,20.9,-2,2,0,0,-1,1,1,1
"935",2018-01-23,"Gothic Rd","w1718","Motorized",NA,"Tue","weekday","sled","3","3","3",4.6,0,22,1,16,20.9,-2,2,0,0,-1,1,1,1
"936",2018-01-23,"Gothic Rd","w1718","Hybrid",NA,"Tue","weekday","sled","3","3","3",4.6,0,22,1,16,20.9,-2,2,0,0,-1,1,1,1
"937",2018-01-24,"Gothic Rd","w1718","Non.motorized",NA,"Wed","weekday","no_sled","2","2","2",4.6,0,22,0,22,20.9,1,-2,2,0,1,-1,1,1
"938",2018-01-24,"Gothic Rd","w1718","Mechanized",NA,"Wed","weekday","no_sled","2","2","2",4.6,0,22,0,22,20.9,1,-2,2,0,1,-1,1,1
"939",2018-01-24,"Gothic Rd","w1718","Motorized",NA,"Wed","weekday","sled","2","2","2",4.6,0,22,0,22,20.9,1,-2,2,0,1,-1,1,1
"940",2018-01-24,"Gothic Rd","w1718","Hybrid",NA,"Wed","weekday","sled","2","2","2",4.6,0,22,0,22,20.9,1,-2,2,0,1,-1,1,1
"941",2018-01-25,"Gothic Rd","w1718","Non.motorized",NA,"Thu","weekday","no_sled","2","2","2",4.6,0,22,0,28,20.9,0,1,-2,2,0,1,-1,1
"942",2018-01-25,"Gothic Rd","w1718","Mechanized",NA,"Thu","weekday","no_sled","2","2","2",4.6,0,22,0,28,20.9,0,1,-2,2,0,1,-1,1
"943",2018-01-25,"Gothic Rd","w1718","Motorized",NA,"Thu","weekday","sled","2","2","2",4.6,0,22,0,28,20.9,0,1,-2,2,0,1,-1,1
"944",2018-01-25,"Gothic Rd","w1718","Hybrid",NA,"Thu","weekday","sled","2","2","2",4.6,0,22,0,28,20.9,0,1,-2,2,0,1,-1,1
"945",2018-01-26,"Gothic Rd","w1718","Non.motorized",NA,"Fri","weekday","no_sled","2","2","2",4.7,0.1,22,0,15,21.4,0,0,1,-2,0,0,1,-1
"946",2018-01-26,"Gothic Rd","w1718","Mechanized",NA,"Fri","weekday","no_sled","2","2","2",4.7,0.1,22,0,15,21.4,0,0,1,-2,0,0,1,-1
"947",2018-01-26,"Gothic Rd","w1718","Motorized",NA,"Fri","weekday","sled","2","2","2",4.7,0.1,22,0,15,21.4,0,0,1,-2,0,0,1,-1
"948",2018-01-26,"Gothic Rd","w1718","Hybrid",NA,"Fri","weekday","sled","2","2","2",4.7,0.1,22,0,15,21.4,0,0,1,-2,0,0,1,-1
"949",2018-01-27,"Gothic Rd","w1718","Non.motorized",NA,"Sat","weekend","no_sled","2","2","2",4.7,0,23,1,16,20.4,0,0,0,1,1,1,1,2
"950",2018-01-27,"Gothic Rd","w1718","Mechanized",NA,"Sat","weekend","no_sled","2","2","2",4.7,0,23,1,16,20.4,0,0,0,1,1,1,1,2
"951",2018-01-27,"Gothic Rd","w1718","Motorized",NA,"Sat","weekend","sled","2","2","2",4.7,0,23,1,16,20.4,0,0,0,1,1,1,1,2
"952",2018-01-27,"Gothic Rd","w1718","Hybrid",NA,"Sat","weekend","sled","2","2","2",4.7,0,23,1,16,20.4,0,0,0,1,1,1,1,2
"953",2018-01-28,"Gothic Rd","w1718","Non.motorized",NA,"Sun","weekend","no_sled","2","2","2",4.7,0,23,0,25,20.4,1,0,0,0,1,1,1,1
"954",2018-01-28,"Gothic Rd","w1718","Mechanized",NA,"Sun","weekend","no_sled","2","2","2",4.7,0,23,0,25,20.4,1,0,0,0,1,1,1,1
"955",2018-01-28,"Gothic Rd","w1718","Motorized",NA,"Sun","weekend","sled","2","2","2",4.7,0,23,0,25,20.4,1,0,0,0,1,1,1,1
"956",2018-01-28,"Gothic Rd","w1718","Hybrid",NA,"Sun","weekend","sled","2","2","2",4.7,0,23,0,25,20.4,1,0,0,0,1,1,1,1
"957",2018-01-29,"Gothic Rd","w1718","Non.motorized",NA,"Mon","weekday","no_sled","2","2","2",4.8,0.1,22,-1,30,21.8,0,1,0,0,-1,0,0,0
"958",2018-01-29,"Gothic Rd","w1718","Mechanized",NA,"Mon","weekday","no_sled","2","2","2",4.8,0.1,22,-1,30,21.8,0,1,0,0,-1,0,0,0
"959",2018-01-29,"Gothic Rd","w1718","Motorized",NA,"Mon","weekday","sled","2","2","2",4.8,0.1,22,-1,30,21.8,0,1,0,0,-1,0,0,0
"960",2018-01-29,"Gothic Rd","w1718","Hybrid",NA,"Mon","weekday","sled","2","2","2",4.8,0.1,22,-1,30,21.8,0,1,0,0,-1,0,0,0
"961",2018-01-30,"Gothic Rd","w1718","Non.motorized",NA,"Tue","weekday","no_sled","2","2","2",4.8,0,22,0,34,21.8,-1,0,1,0,-1,-1,0,0
"962",2018-01-30,"Gothic Rd","w1718","Mechanized",NA,"Tue","weekday","no_sled","2","2","2",4.8,0,22,0,34,21.8,-1,0,1,0,-1,-1,0,0
"963",2018-01-30,"Gothic Rd","w1718","Motorized",NA,"Tue","weekday","sled","2","2","2",4.8,0,22,0,34,21.8,-1,0,1,0,-1,-1,0,0
"964",2018-01-30,"Gothic Rd","w1718","Hybrid",NA,"Tue","weekday","sled","2","2","2",4.8,0,22,0,34,21.8,-1,0,1,0,-1,-1,0,0
"965",2018-01-31,"Gothic Rd","w1718","Non.motorized",7,"Wed","weekday","no_sled","2","2","2",4.8,0,22,0,34,21.8,0,-1,0,1,0,-1,-1,0
"966",2018-01-31,"Gothic Rd","w1718","Mechanized",0,"Wed","weekday","no_sled","2","2","2",4.8,0,22,0,34,21.8,0,-1,0,1,0,-1,-1,0
"967",2018-01-31,"Gothic Rd","w1718","Motorized",1,"Wed","weekday","sled","2","2","2",4.8,0,22,0,34,21.8,0,-1,0,1,0,-1,-1,0
"968",2018-01-31,"Gothic Rd","w1718","Hybrid",0,"Wed","weekday","sled","2","2","2",4.8,0,22,0,34,21.8,0,-1,0,1,0,-1,-1,0
"969",2018-02-01,"Gothic Rd","w1718","Non.motorized",25,"Thu","weekday","no_sled","2","2","2",4.9,0.1,21,-1,32,23.3,0,0,-1,0,-1,-1,-2,-2
"970",2018-02-01,"Gothic Rd","w1718","Mechanized",2,"Thu","weekday","no_sled","2","2","2",4.9,0.1,21,-1,32,23.3,0,0,-1,0,-1,-1,-2,-2
"971",2018-02-01,"Gothic Rd","w1718","Motorized",0,"Thu","weekday","sled","2","2","2",4.9,0.1,21,-1,32,23.3,0,0,-1,0,-1,-1,-2,-2
"972",2018-02-01,"Gothic Rd","w1718","Hybrid",0,"Thu","weekday","sled","2","2","2",4.9,0.1,21,-1,32,23.3,0,0,-1,0,-1,-1,-2,-2
"973",2018-02-02,"Gothic Rd","w1718","Non.motorized",55,"Fri","weekday","no_sled","2","2","2",4.9,0,20,-1,33,24.5,-1,0,0,-1,-2,-2,-2,-3
"974",2018-02-02,"Gothic Rd","w1718","Mechanized",7,"Fri","weekday","no_sled","2","2","2",4.9,0,20,-1,33,24.5,-1,0,0,-1,-2,-2,-2,-3
"975",2018-02-02,"Gothic Rd","w1718","Motorized",0,"Fri","weekday","sled","2","2","2",4.9,0,20,-1,33,24.5,-1,0,0,-1,-2,-2,-2,-3
"976",2018-02-02,"Gothic Rd","w1718","Hybrid",0,"Fri","weekday","sled","2","2","2",4.9,0,20,-1,33,24.5,-1,0,0,-1,-2,-2,-2,-3
"977",2018-02-03,"Gothic Rd","w1718","Non.motorized",106,"Sat","weekend","no_sled","2","2","2",4.9,0,21,1,32,23.3,-1,-1,0,0,0,-1,-1,-1
"978",2018-02-03,"Gothic Rd","w1718","Mechanized",3,"Sat","weekend","no_sled","2","2","2",4.9,0,21,1,32,23.3,-1,-1,0,0,0,-1,-1,-1
"979",2018-02-03,"Gothic Rd","w1718","Motorized",7,"Sat","weekend","sled","2","2","2",4.9,0,21,1,32,23.3,-1,-1,0,0,0,-1,-1,-1
"980",2018-02-03,"Gothic Rd","w1718","Hybrid",0,"Sat","weekend","sled","2","2","2",4.9,0,21,1,32,23.3,-1,-1,0,0,0,-1,-1,-1
"981",2018-02-04,"Gothic Rd","w1718","Non.motorized",89,"Sun","weekend","no_sled","2","2","2",4.9,0,19,-2,32,25.8,1,-1,-1,0,-1,-2,-3,-3
"982",2018-02-04,"Gothic Rd","w1718","Mechanized",7,"Sun","weekend","no_sled","2","2","2",4.9,0,19,-2,32,25.8,1,-1,-1,0,-1,-2,-3,-3
"983",2018-02-04,"Gothic Rd","w1718","Motorized",3,"Sun","weekend","sled","2","2","2",4.9,0,19,-2,32,25.8,1,-1,-1,0,-1,-2,-3,-3
"984",2018-02-04,"Gothic Rd","w1718","Hybrid",2,"Sun","weekend","sled","2","2","2",4.9,0,19,-2,32,25.8,1,-1,-1,0,-1,-2,-3,-3
"985",2018-02-05,"Gothic Rd","w1718","Non.motorized",29,"Mon","weekday","no_sled","2","2","2",5,0.1,18,-1,29,27.8,-2,1,-1,-1,-3,-2,-3,-4
"986",2018-02-05,"Gothic Rd","w1718","Mechanized",1,"Mon","weekday","no_sled","2","2","2",5,0.1,18,-1,29,27.8,-2,1,-1,-1,-3,-2,-3,-4
"987",2018-02-05,"Gothic Rd","w1718","Motorized",0,"Mon","weekday","sled","2","2","2",5,0.1,18,-1,29,27.8,-2,1,-1,-1,-3,-2,-3,-4
"988",2018-02-05,"Gothic Rd","w1718","Hybrid",0,"Mon","weekday","sled","2","2","2",5,0.1,18,-1,29,27.8,-2,1,-1,-1,-3,-2,-3,-4
"989",2018-02-06,"Gothic Rd","w1718","Non.motorized",15,"Tue","weekday","no_sled","2","2","2",5.2,0.2,23,5,22,22.6,-1,-2,1,-1,4,2,3,2
"990",2018-02-06,"Gothic Rd","w1718","Mechanized",0,"Tue","weekday","no_sled","2","2","2",5.2,0.2,23,5,22,22.6,-1,-2,1,-1,4,2,3,2
"991",2018-02-06,"Gothic Rd","w1718","Motorized",0,"Tue","weekday","sled","2","2","2",5.2,0.2,23,5,22,22.6,-1,-2,1,-1,4,2,3,2
"992",2018-02-06,"Gothic Rd","w1718","Hybrid",0,"Tue","weekday","sled","2","2","2",5.2,0.2,23,5,22,22.6,-1,-2,1,-1,4,2,3,2
"993",2018-02-07,"Gothic Rd","w1718","Non.motorized",51,"Wed","weekday","no_sled","2","2","2",5.2,0,23,0,24,22.6,5,-1,-2,1,5,4,2,3
"994",2018-02-07,"Gothic Rd","w1718","Mechanized",8,"Wed","weekday","no_sled","2","2","2",5.2,0,23,0,24,22.6,5,-1,-2,1,5,4,2,3
"995",2018-02-07,"Gothic Rd","w1718","Motorized",1,"Wed","weekday","sled","2","2","2",5.2,0,23,0,24,22.6,5,-1,-2,1,5,4,2,3
"996",2018-02-07,"Gothic Rd","w1718","Hybrid",0,"Wed","weekday","sled","2","2","2",5.2,0,23,0,24,22.6,5,-1,-2,1,5,4,2,3
"997",2018-02-08,"Gothic Rd","w1718","Non.motorized",60,"Thu","weekday","no_sled","2","2","1",5.3,0.1,25,2,28,21.2,0,5,-1,-2,2,7,6,4
"998",2018-02-08,"Gothic Rd","w1718","Mechanized",7,"Thu","weekday","no_sled","2","2","1",5.3,0.1,25,2,28,21.2,0,5,-1,-2,2,7,6,4
"999",2018-02-08,"Gothic Rd","w1718","Motorized",0,"Thu","weekday","sled","2","2","1",5.3,0.1,25,2,28,21.2,0,5,-1,-2,2,7,6,4
"1000",2018-02-08,"Gothic Rd","w1718","Hybrid",0,"Thu","weekday","sled","2","2","1",5.3,0.1,25,2,28,21.2,0,5,-1,-2,2,7,6,4
"1001",2018-02-09,"Gothic Rd","w1718","Non.motorized",72,"Fri","weekday","no_sled","2","2","1",5.3,0,24,-1,33,22.1,2,0,5,-1,1,1,6,5
"1002",2018-02-09,"Gothic Rd","w1718","Mechanized",8,"Fri","weekday","no_sled","2","2","1",5.3,0,24,-1,33,22.1,2,0,5,-1,1,1,6,5
"1003",2018-02-09,"Gothic Rd","w1718","Motorized",0,"Fri","weekday","sled","2","2","1",5.3,0,24,-1,33,22.1,2,0,5,-1,1,1,6,5
"1004",2018-02-09,"Gothic Rd","w1718","Hybrid",0,"Fri","weekday","sled","2","2","1",5.3,0,24,-1,33,22.1,2,0,5,-1,1,1,6,5
"1005",2018-02-10,"Gothic Rd","w1718","Non.motorized",42,"Sat","weekend","no_sled","3","3","2",5.3,0,24,0,24,22.1,-1,2,0,5,-1,1,1,6
"1006",2018-02-10,"Gothic Rd","w1718","Mechanized",7,"Sat","weekend","no_sled","3","3","2",5.3,0,24,0,24,22.1,-1,2,0,5,-1,1,1,6
"1007",2018-02-10,"Gothic Rd","w1718","Motorized",0,"Sat","weekend","sled","3","3","2",5.3,0,24,0,24,22.1,-1,2,0,5,-1,1,1,6
"1008",2018-02-10,"Gothic Rd","w1718","Hybrid",0,"Sat","weekend","sled","3","3","2",5.3,0,24,0,24,22.1,-1,2,0,5,-1,1,1,6
"1009",2018-02-11,"Gothic Rd","w1718","Non.motorized",39,"Sun","weekend","no_sled","3","3","2",5.6,0.3,27,3,13,20.7,0,-1,2,0,3,2,4,4
"1010",2018-02-11,"Gothic Rd","w1718","Mechanized",1,"Sun","weekend","no_sled","3","3","2",5.6,0.3,27,3,13,20.7,0,-1,2,0,3,2,4,4
"1011",2018-02-11,"Gothic Rd","w1718","Motorized",0,"Sun","weekend","sled","3","3","2",5.6,0.3,27,3,13,20.7,0,-1,2,0,3,2,4,4
"1012",2018-02-11,"Gothic Rd","w1718","Hybrid",0,"Sun","weekend","sled","3","3","2",5.6,0.3,27,3,13,20.7,0,-1,2,0,3,2,4,4
"1013",2018-02-12,"Gothic Rd","w1718","Non.motorized",25,"Mon","weekday","no_sled","3","3","3",5.7,0.1,27,0,23,21.1,3,0,-1,2,3,3,2,4
"1014",2018-02-12,"Gothic Rd","w1718","Mechanized",0,"Mon","weekday","no_sled","3","3","3",5.7,0.1,27,0,23,21.1,3,0,-1,2,3,3,2,4
"1015",2018-02-12,"Gothic Rd","w1718","Motorized",0,"Mon","weekday","sled","3","3","3",5.7,0.1,27,0,23,21.1,3,0,-1,2,3,3,2,4
"1016",2018-02-12,"Gothic Rd","w1718","Hybrid",0,"Mon","weekday","sled","3","3","3",5.7,0.1,27,0,23,21.1,3,0,-1,2,3,3,2,4
"1017",2018-02-13,"Gothic Rd","w1718","Non.motorized",20,"Tue","weekday","no_sled","3","3","3",6.1,0.4,29,2,28,21,0,3,0,-1,2,5,5,4
"1018",2018-02-13,"Gothic Rd","w1718","Mechanized",2,"Tue","weekday","no_sled","3","3","3",6.1,0.4,29,2,28,21,0,3,0,-1,2,5,5,4
"1019",2018-02-13,"Gothic Rd","w1718","Motorized",0,"Tue","weekday","sled","3","3","3",6.1,0.4,29,2,28,21,0,3,0,-1,2,5,5,4
"1020",2018-02-13,"Gothic Rd","w1718","Hybrid",0,"Tue","weekday","sled","3","3","3",6.1,0.4,29,2,28,21,0,3,0,-1,2,5,5,4
"1021",2018-02-14,"Gothic Rd","w1718","Non.motorized",32,"Wed","weekday","no_sled","3","3","3",6.2,0.1,30,1,30,20.7,2,0,3,0,3,3,6,6
"1022",2018-02-14,"Gothic Rd","w1718","Mechanized",4,"Wed","weekday","no_sled","3","3","3",6.2,0.1,30,1,30,20.7,2,0,3,0,3,3,6,6
"1023",2018-02-14,"Gothic Rd","w1718","Motorized",0,"Wed","weekday","sled","3","3","3",6.2,0.1,30,1,30,20.7,2,0,3,0,3,3,6,6
"1024",2018-02-14,"Gothic Rd","w1718","Hybrid",0,"Wed","weekday","sled","3","3","3",6.2,0.1,30,1,30,20.7,2,0,3,0,3,3,6,6
"1025",2018-02-15,"Gothic Rd","w1718","Non.motorized",10,"Thu","weekday","no_sled","3","3","3",6.3,0.1,28,-2,24,22.5,1,2,0,3,-1,1,1,4
"1026",2018-02-15,"Gothic Rd","w1718","Mechanized",0,"Thu","weekday","no_sled","3","3","3",6.3,0.1,28,-2,24,22.5,1,2,0,3,-1,1,1,4
"1027",2018-02-15,"Gothic Rd","w1718","Motorized",0,"Thu","weekday","sled","3","3","3",6.3,0.1,28,-2,24,22.5,1,2,0,3,-1,1,1,4
"1028",2018-02-15,"Gothic Rd","w1718","Hybrid",0,"Thu","weekday","sled","3","3","3",6.3,0.1,28,-2,24,22.5,1,2,0,3,-1,1,1,4
"1029",2018-02-16,"Gothic Rd","w1718","Non.motorized",23,"Fri","weekday","no_sled","3","3","3",6.7,0.4,32,4,18,20.9,-2,1,2,0,2,3,5,5
"1030",2018-02-16,"Gothic Rd","w1718","Mechanized",0,"Fri","weekday","no_sled","3","3","3",6.7,0.4,32,4,18,20.9,-2,1,2,0,2,3,5,5
"1031",2018-02-16,"Gothic Rd","w1718","Motorized",1,"Fri","weekday","sled","3","3","3",6.7,0.4,32,4,18,20.9,-2,1,2,0,2,3,5,5
"1032",2018-02-16,"Gothic Rd","w1718","Hybrid",0,"Fri","weekday","sled","3","3","3",6.7,0.4,32,4,18,20.9,-2,1,2,0,2,3,5,5
"1033",2018-02-17,"Gothic Rd","w1718","Non.motorized",107,"Sat","weekend","no_sled","3","3","2",6.7,0,32,0,25,20.9,4,-2,1,2,4,2,3,5
"1034",2018-02-17,"Gothic Rd","w1718","Mechanized",8,"Sat","weekend","no_sled","3","3","2",6.7,0,32,0,25,20.9,4,-2,1,2,4,2,3,5
"1035",2018-02-17,"Gothic Rd","w1718","Motorized",1,"Sat","weekend","sled","3","3","2",6.7,0,32,0,25,20.9,4,-2,1,2,4,2,3,5
"1036",2018-02-17,"Gothic Rd","w1718","Hybrid",0,"Sat","weekend","sled","3","3","2",6.7,0,32,0,25,20.9,4,-2,1,2,4,2,3,5
"1037",2018-02-18,"Gothic Rd","w1718","Non.motorized",122,"Sun","weekend","no_sled","2","2","2",6.7,0,31,-1,32,21.6,0,4,-2,1,-1,3,1,2
"1038",2018-02-18,"Gothic Rd","w1718","Mechanized",9,"Sun","weekend","no_sled","2","2","2",6.7,0,31,-1,32,21.6,0,4,-2,1,-1,3,1,2
"1039",2018-02-18,"Gothic Rd","w1718","Motorized",4,"Sun","weekend","sled","2","2","2",6.7,0,31,-1,32,21.6,0,4,-2,1,-1,3,1,2
"1040",2018-02-18,"Gothic Rd","w1718","Hybrid",0,"Sun","weekend","sled","2","2","2",6.7,0,31,-1,32,21.6,0,4,-2,1,-1,3,1,2
"1041",2018-02-19,"Gothic Rd","w1718","Non.motorized",36,"Mon","weekday","no_sled","2","2","2",6.8,0.1,29,-2,24,23.4,-1,0,4,-2,-3,-3,1,-1
"1042",2018-02-19,"Gothic Rd","w1718","Non.motorized",36,"Mon","weekday","no_sled","3","3","3",6.8,0.1,29,-2,24,23.4,-1,0,4,-2,-3,-3,1,-1
"1043",2018-02-19,"Gothic Rd","w1718","Mechanized",0,"Mon","weekday","no_sled","2","2","2",6.8,0.1,29,-2,24,23.4,-1,0,4,-2,-3,-3,1,-1
"1044",2018-02-19,"Gothic Rd","w1718","Mechanized",0,"Mon","weekday","no_sled","3","3","3",6.8,0.1,29,-2,24,23.4,-1,0,4,-2,-3,-3,1,-1
"1045",2018-02-19,"Gothic Rd","w1718","Motorized",0,"Mon","weekday","sled","2","2","2",6.8,0.1,29,-2,24,23.4,-1,0,4,-2,-3,-3,1,-1
"1046",2018-02-19,"Gothic Rd","w1718","Motorized",0,"Mon","weekday","sled","3","3","3",6.8,0.1,29,-2,24,23.4,-1,0,4,-2,-3,-3,1,-1
"1047",2018-02-19,"Gothic Rd","w1718","Hybrid",0,"Mon","weekday","sled","2","2","2",6.8,0.1,29,-2,24,23.4,-1,0,4,-2,-3,-3,1,-1
"1048",2018-02-19,"Gothic Rd","w1718","Hybrid",0,"Mon","weekday","sled","3","3","3",6.8,0.1,29,-2,24,23.4,-1,0,4,-2,-3,-3,1,-1
"1049",2018-02-20,"Gothic Rd","w1718","Non.motorized",21,"Tue","weekday","no_sled","3","3","3",6.8,0,31,2,8,21.9,-2,-1,0,4,0,-1,-1,3
"1050",2018-02-20,"Gothic Rd","w1718","Mechanized",0,"Tue","weekday","no_sled","3","3","3",6.8,0,31,2,8,21.9,-2,-1,0,4,0,-1,-1,3
"1051",2018-02-20,"Gothic Rd","w1718","Motorized",1,"Tue","weekday","sled","3","3","3",6.8,0,31,2,8,21.9,-2,-1,0,4,0,-1,-1,3
"1052",2018-02-20,"Gothic Rd","w1718","Hybrid",0,"Tue","weekday","sled","3","3","3",6.8,0,31,2,8,21.9,-2,-1,0,4,0,-1,-1,3
"1053",2018-02-21,"Gothic Rd","w1718","Non.motorized",27,"Wed","weekday","no_sled","3","3","3",6.8,0,31,0,11,21.9,2,-2,-1,0,2,0,-1,-1
"1054",2018-02-21,"Gothic Rd","w1718","Mechanized",1,"Wed","weekday","no_sled","3","3","3",6.8,0,31,0,11,21.9,2,-2,-1,0,2,0,-1,-1
"1055",2018-02-21,"Gothic Rd","w1718","Motorized",0,"Wed","weekday","sled","3","3","3",6.8,0,31,0,11,21.9,2,-2,-1,0,2,0,-1,-1
"1056",2018-02-21,"Gothic Rd","w1718","Hybrid",0,"Wed","weekday","sled","3","3","3",6.8,0,31,0,11,21.9,2,-2,-1,0,2,0,-1,-1
"1057",2018-02-22,"Gothic Rd","w1718","Non.motorized",17,"Thu","weekday","no_sled","3","3","2",6.8,0,30,-1,16,22.7,0,2,-2,-1,-1,1,-1,-2
"1058",2018-02-22,"Gothic Rd","w1718","Mechanized",0,"Thu","weekday","no_sled","3","3","2",6.8,0,30,-1,16,22.7,0,2,-2,-1,-1,1,-1,-2
"1059",2018-02-22,"Gothic Rd","w1718","Motorized",0,"Thu","weekday","sled","3","3","2",6.8,0,30,-1,16,22.7,0,2,-2,-1,-1,1,-1,-2
"1060",2018-02-22,"Gothic Rd","w1718","Hybrid",0,"Thu","weekday","sled","3","3","2",6.8,0,30,-1,16,22.7,0,2,-2,-1,-1,1,-1,-2
"1061",2018-02-23,"Gothic Rd","w1718","Non.motorized",25,"Fri","weekday","no_sled","3","3","2",6.9,0.1,30,0,15,23,-1,0,2,-2,-1,-1,1,-1
"1062",2018-02-23,"Gothic Rd","w1718","Mechanized",1,"Fri","weekday","no_sled","3","3","2",6.9,0.1,30,0,15,23,-1,0,2,-2,-1,-1,1,-1
"1063",2018-02-23,"Gothic Rd","w1718","Motorized",0,"Fri","weekday","sled","3","3","2",6.9,0.1,30,0,15,23,-1,0,2,-2,-1,-1,1,-1
"1064",2018-02-23,"Gothic Rd","w1718","Hybrid",0,"Fri","weekday","sled","3","3","2",6.9,0.1,30,0,15,23,-1,0,2,-2,-1,-1,1,-1
"1065",2018-02-24,"Gothic Rd","w1718","Non.motorized",46,"Sat","weekend","no_sled","3","3","2",6.9,0,31,1,10,22.3,0,-1,0,2,1,0,0,2
"1066",2018-02-24,"Gothic Rd","w1718","Mechanized",3,"Sat","weekend","no_sled","3","3","2",6.9,0,31,1,10,22.3,0,-1,0,2,1,0,0,2
"1067",2018-02-24,"Gothic Rd","w1718","Motorized",0,"Sat","weekend","sled","3","3","2",6.9,0,31,1,10,22.3,0,-1,0,2,1,0,0,2
"1068",2018-02-24,"Gothic Rd","w1718","Hybrid",0,"Sat","weekend","sled","3","3","2",6.9,0,31,1,10,22.3,0,-1,0,2,1,0,0,2
"1069",2018-02-25,"Gothic Rd","w1718","Non.motorized",30,"Sun","weekend","no_sled","3","3","2",7.1,0.2,32,1,11,22.2,1,0,-1,0,2,2,1,1
"1070",2018-02-25,"Gothic Rd","w1718","Mechanized",9,"Sun","weekend","no_sled","3","3","2",7.1,0.2,32,1,11,22.2,1,0,-1,0,2,2,1,1
"1071",2018-02-25,"Gothic Rd","w1718","Motorized",0,"Sun","weekend","sled","3","3","2",7.1,0.2,32,1,11,22.2,1,0,-1,0,2,2,1,1
"1072",2018-02-25,"Gothic Rd","w1718","Hybrid",0,"Sun","weekend","sled","3","3","2",7.1,0.2,32,1,11,22.2,1,0,-1,0,2,2,1,1
"1073",2018-02-26,"Gothic Rd","w1718","Non.motorized",25,"Mon","weekday","no_sled","2","2","2",7.1,0,32,0,20,22.2,1,1,0,-1,1,2,2,1
"1074",2018-02-26,"Gothic Rd","w1718","Mechanized",5,"Mon","weekday","no_sled","2","2","2",7.1,0,32,0,20,22.2,1,1,0,-1,1,2,2,1
"1075",2018-02-26,"Gothic Rd","w1718","Motorized",0,"Mon","weekday","sled","2","2","2",7.1,0,32,0,20,22.2,1,1,0,-1,1,2,2,1
"1076",2018-02-26,"Gothic Rd","w1718","Hybrid",0,"Mon","weekday","sled","2","2","2",7.1,0,32,0,20,22.2,1,1,0,-1,1,2,2,1
"1077",2018-02-27,"Gothic Rd","w1718","Non.motorized",38,"Tue","weekday","no_sled","2","2","2",7.2,0.1,32,0,26,22.5,0,1,1,0,0,1,2,2
"1078",2018-02-27,"Gothic Rd","w1718","Mechanized",2,"Tue","weekday","no_sled","2","2","2",7.2,0.1,32,0,26,22.5,0,1,1,0,0,1,2,2
"1079",2018-02-27,"Gothic Rd","w1718","Motorized",1,"Tue","weekday","sled","2","2","2",7.2,0.1,32,0,26,22.5,0,1,1,0,0,1,2,2
"1080",2018-02-27,"Gothic Rd","w1718","Hybrid",0,"Tue","weekday","sled","2","2","2",7.2,0.1,32,0,26,22.5,0,1,1,0,0,1,2,2
"1081",2018-02-28,"Gothic Rd","w1718","Non.motorized",33,"Wed","weekday","no_sled","2","2","2",7.2,0,31,-1,23,23.2,0,0,1,1,-1,-1,0,1
"1082",2018-02-28,"Gothic Rd","w1718","Mechanized",2,"Wed","weekday","no_sled","2","2","2",7.2,0,31,-1,23,23.2,0,0,1,1,-1,-1,0,1
"1083",2018-02-28,"Gothic Rd","w1718","Motorized",0,"Wed","weekday","sled","2","2","2",7.2,0,31,-1,23,23.2,0,0,1,1,-1,-1,0,1
"1084",2018-02-28,"Gothic Rd","w1718","Hybrid",0,"Wed","weekday","sled","2","2","2",7.2,0,31,-1,23,23.2,0,0,1,1,-1,-1,0,1
"1085",2018-03-01,"Gothic Rd","w1718","Non.motorized",28,"Thu","weekday","no_sled","2","2","2",7.2,0,31,0,24,23.2,-1,0,0,1,-1,-1,-1,0
"1086",2018-03-01,"Gothic Rd","w1718","Mechanized",1,"Thu","weekday","no_sled","2","2","2",7.2,0,31,0,24,23.2,-1,0,0,1,-1,-1,-1,0
"1087",2018-03-01,"Gothic Rd","w1718","Motorized",1,"Thu","weekday","sled","2","2","2",7.2,0,31,0,24,23.2,-1,0,0,1,-1,-1,-1,0
"1088",2018-03-01,"Gothic Rd","w1718","Hybrid",0,"Thu","weekday","sled","2","2","2",7.2,0,31,0,24,23.2,-1,0,0,1,-1,-1,-1,0
"1089",2018-03-02,"Gothic Rd","w1718","Non.motorized",62,"Fri","weekday","no_sled","2","2","1",7.2,0,31,0,30,23.2,0,-1,0,0,0,-1,-1,-1
"1090",2018-03-02,"Gothic Rd","w1718","Mechanized",4,"Fri","weekday","no_sled","2","2","1",7.2,0,31,0,30,23.2,0,-1,0,0,0,-1,-1,-1
"1091",2018-03-02,"Gothic Rd","w1718","Motorized",2,"Fri","weekday","sled","2","2","1",7.2,0,31,0,30,23.2,0,-1,0,0,0,-1,-1,-1
"1092",2018-03-02,"Gothic Rd","w1718","Hybrid",0,"Fri","weekday","sled","2","2","1",7.2,0,31,0,30,23.2,0,-1,0,0,0,-1,-1,-1
"1093",2018-03-03,"Gothic Rd","w1718","Non.motorized",68,"Sat","weekend","no_sled","2","2","1",7.3,0.1,30,-1,34,24.3,0,0,-1,0,-1,-1,-2,-2
"1094",2018-03-03,"Gothic Rd","w1718","Mechanized",5,"Sat","weekend","no_sled","2","2","1",7.3,0.1,30,-1,34,24.3,0,0,-1,0,-1,-1,-2,-2
"1095",2018-03-03,"Gothic Rd","w1718","Motorized",1,"Sat","weekend","sled","2","2","1",7.3,0.1,30,-1,34,24.3,0,0,-1,0,-1,-1,-2,-2
"1096",2018-03-03,"Gothic Rd","w1718","Hybrid",0,"Sat","weekend","sled","2","2","1",7.3,0.1,30,-1,34,24.3,0,0,-1,0,-1,-1,-2,-2
"1097",2018-03-04,"Gothic Rd","w1718","Non.motorized",NA,"Sun","weekend","no_sled","2","2","1",7.3,0,29,-1,24,25.2,-1,0,0,-1,-2,-2,-2,-3
"1098",2018-03-04,"Gothic Rd","w1718","Mechanized",NA,"Sun","weekend","no_sled","2","2","1",7.3,0,29,-1,24,25.2,-1,0,0,-1,-2,-2,-2,-3
"1099",2018-03-04,"Gothic Rd","w1718","Motorized",NA,"Sun","weekend","sled","2","2","1",7.3,0,29,-1,24,25.2,-1,0,0,-1,-2,-2,-2,-3
"1100",2018-03-04,"Gothic Rd","w1718","Hybrid",NA,"Sun","weekend","sled","2","2","1",7.3,0,29,-1,24,25.2,-1,0,0,-1,-2,-2,-2,-3
"1101",2018-03-05,"Gothic Rd","w1718","Non.motorized",NA,"Mon","weekday","no_sled","2","2","1",7.3,0,31,2,13,23.5,-1,-1,0,0,1,0,0,0
"1102",2018-03-05,"Gothic Rd","w1718","Mechanized",NA,"Mon","weekday","no_sled","2","2","1",7.3,0,31,2,13,23.5,-1,-1,0,0,1,0,0,0
"1103",2018-03-05,"Gothic Rd","w1718","Motorized",NA,"Mon","weekday","sled","2","2","1",7.3,0,31,2,13,23.5,-1,-1,0,0,1,0,0,0
"1104",2018-03-05,"Gothic Rd","w1718","Hybrid",NA,"Mon","weekday","sled","2","2","1",7.3,0,31,2,13,23.5,-1,-1,0,0,1,0,0,0
"1105",2018-03-06,"Gothic Rd","w1718","Non.motorized",NA,"Tue","weekday","no_sled","2","2","1",7.3,0,31,0,19,23.5,2,-1,-1,0,2,1,0,0
"1106",2018-03-06,"Gothic Rd","w1718","Mechanized",NA,"Tue","weekday","no_sled","2","2","1",7.3,0,31,0,19,23.5,2,-1,-1,0,2,1,0,0
"1107",2018-03-06,"Gothic Rd","w1718","Motorized",NA,"Tue","weekday","sled","2","2","1",7.3,0,31,0,19,23.5,2,-1,-1,0,2,1,0,0
"1108",2018-03-06,"Gothic Rd","w1718","Hybrid",NA,"Tue","weekday","sled","2","2","1",7.3,0,31,0,19,23.5,2,-1,-1,0,2,1,0,0
"1109",2018-03-07,"Gothic Rd","w1718","Non.motorized",NA,"Wed","weekday","no_sled","2","2","1",7.4,0.1,31,0,27,23.9,0,2,-1,-1,0,2,1,0
"1110",2018-03-07,"Gothic Rd","w1718","Mechanized",NA,"Wed","weekday","no_sled","2","2","1",7.4,0.1,31,0,27,23.9,0,2,-1,-1,0,2,1,0
"1111",2018-03-07,"Gothic Rd","w1718","Motorized",NA,"Wed","weekday","sled","2","2","1",7.4,0.1,31,0,27,23.9,0,2,-1,-1,0,2,1,0
"1112",2018-03-07,"Gothic Rd","w1718","Hybrid",NA,"Wed","weekday","sled","2","2","1",7.4,0.1,31,0,27,23.9,0,2,-1,-1,0,2,1,0
"1113",2018-03-08,"Gothic Rd","w1718","Non.motorized",NA,"Thu","weekday","no_sled","2","2","1",7.4,0,30,-1,33,24.7,0,0,2,-1,-1,-1,1,0
"1114",2018-03-08,"Gothic Rd","w1718","Mechanized",NA,"Thu","weekday","no_sled","2","2","1",7.4,0,30,-1,33,24.7,0,0,2,-1,-1,-1,1,0
"1115",2018-03-08,"Gothic Rd","w1718","Motorized",NA,"Thu","weekday","sled","2","2","1",7.4,0,30,-1,33,24.7,0,0,2,-1,-1,-1,1,0
"1116",2018-03-08,"Gothic Rd","w1718","Hybrid",NA,"Thu","weekday","sled","2","2","1",7.4,0,30,-1,33,24.7,0,0,2,-1,-1,-1,1,0
"1117",2018-03-09,"Gothic Rd","w1718","Non.motorized",10,"Fri","weekday","no_sled","2","2","1",7.4,0,30,0,34,24.7,-1,0,0,2,-1,-1,-1,1
"1118",2018-03-09,"Gothic Rd","w1718","Mechanized",0,"Fri","weekday","no_sled","2","2","1",7.4,0,30,0,34,24.7,-1,0,0,2,-1,-1,-1,1
"1119",2018-03-09,"Gothic Rd","w1718","Motorized",0,"Fri","weekday","sled","2","2","1",7.4,0,30,0,34,24.7,-1,0,0,2,-1,-1,-1,1
"1120",2018-03-09,"Gothic Rd","w1718","Hybrid",0,"Fri","weekday","sled","2","2","1",7.4,0,30,0,34,24.7,-1,0,0,2,-1,-1,-1,1
"1121",2018-03-10,"Gothic Rd","w1718","Non.motorized",80,"Sat","weekend","no_sled","1","1","1",7.4,0,30,0,31,24.7,0,-1,0,0,0,-1,-1,-1
"1122",2018-03-10,"Gothic Rd","w1718","Mechanized",4,"Sat","weekend","no_sled","1","1","1",7.4,0,30,0,31,24.7,0,-1,0,0,0,-1,-1,-1
"1123",2018-03-10,"Gothic Rd","w1718","Motorized",3,"Sat","weekend","sled","1","1","1",7.4,0,30,0,31,24.7,0,-1,0,0,0,-1,-1,-1
"1124",2018-03-10,"Gothic Rd","w1718","Hybrid",0,"Sat","weekend","sled","1","1","1",7.4,0,30,0,31,24.7,0,-1,0,0,0,-1,-1,-1
"1125",2018-03-11,"Gothic Rd","w1718","Non.motorized",77,"Sun","weekend","no_sled","1","1","1",7.4,0,29,-1,31,25.5,0,0,-1,0,-1,-1,-2,-2
"1126",2018-03-11,"Gothic Rd","w1718","Mechanized",7,"Sun","weekend","no_sled","1","1","1",7.4,0,29,-1,31,25.5,0,0,-1,0,-1,-1,-2,-2
"1127",2018-03-11,"Gothic Rd","w1718","Motorized",1,"Sun","weekend","sled","1","1","1",7.4,0,29,-1,31,25.5,0,0,-1,0,-1,-1,-2,-2
"1128",2018-03-11,"Gothic Rd","w1718","Hybrid",0,"Sun","weekend","sled","1","1","1",7.4,0,29,-1,31,25.5,0,0,-1,0,-1,-1,-2,-2
"1129",2018-03-12,"Gothic Rd","w1718","Non.motorized",28,"Mon","weekday","no_sled","1","1","1",7.4,0,29,0,33,25.5,-1,0,0,-1,-1,-1,-1,-2
"1130",2018-03-12,"Gothic Rd","w1718","Mechanized",3,"Mon","weekday","no_sled","1","1","1",7.4,0,29,0,33,25.5,-1,0,0,-1,-1,-1,-1,-2
"1131",2018-03-12,"Gothic Rd","w1718","Motorized",2,"Mon","weekday","sled","1","1","1",7.4,0,29,0,33,25.5,-1,0,0,-1,-1,-1,-1,-2
"1132",2018-03-12,"Gothic Rd","w1718","Hybrid",2,"Mon","weekday","sled","1","1","1",7.4,0,29,0,33,25.5,-1,0,0,-1,-1,-1,-1,-2
"1133",2018-03-13,"Gothic Rd","w1718","Non.motorized",50,"Tue","weekday","no_sled","1","1","1",7.4,0,29,0,34,25.5,0,-1,0,0,0,-1,-1,-1
"1134",2018-03-13,"Gothic Rd","w1718","Mechanized",6,"Tue","weekday","no_sled","1","1","1",7.4,0,29,0,34,25.5,0,-1,0,0,0,-1,-1,-1
"1135",2018-03-13,"Gothic Rd","w1718","Motorized",1,"Tue","weekday","sled","1","1","1",7.4,0,29,0,34,25.5,0,-1,0,0,0,-1,-1,-1
"1136",2018-03-13,"Gothic Rd","w1718","Hybrid",0,"Tue","weekday","sled","1","1","1",7.4,0,29,0,34,25.5,0,-1,0,0,0,-1,-1,-1
"1137",2018-03-14,"Gothic Rd","w1718","Non.motorized",31,"Wed","weekday","no_sled","1","2","2",7.4,0,29,0,39,25.5,0,0,-1,0,0,0,-1,-1
"1138",2018-03-14,"Gothic Rd","w1718","Mechanized",3,"Wed","weekday","no_sled","1","2","2",7.4,0,29,0,39,25.5,0,0,-1,0,0,0,-1,-1
"1139",2018-03-14,"Gothic Rd","w1718","Motorized",0,"Wed","weekday","sled","1","2","2",7.4,0,29,0,39,25.5,0,0,-1,0,0,0,-1,-1
"1140",2018-03-14,"Gothic Rd","w1718","Hybrid",0,"Wed","weekday","sled","1","2","2",7.4,0,29,0,39,25.5,0,0,-1,0,0,0,-1,-1
"1141",2018-03-15,"Gothic Rd","w1718","Non.motorized",14,"Thu","weekday","no_sled","2","2","2",7.5,0.1,28,-1,31,26.8,0,0,0,-1,-1,-1,-1,-2
"1142",2018-03-15,"Gothic Rd","w1718","Mechanized",2,"Thu","weekday","no_sled","2","2","2",7.5,0.1,28,-1,31,26.8,0,0,0,-1,-1,-1,-1,-2
"1143",2018-03-15,"Gothic Rd","w1718","Motorized",0,"Thu","weekday","sled","2","2","2",7.5,0.1,28,-1,31,26.8,0,0,0,-1,-1,-1,-1,-2
"1144",2018-03-15,"Gothic Rd","w1718","Hybrid",0,"Thu","weekday","sled","2","2","2",7.5,0.1,28,-1,31,26.8,0,0,0,-1,-1,-1,-1,-2
"1145",2018-03-16,"Gothic Rd","w1718","Non.motorized",37,"Fri","weekday","no_sled","2","2","2",7.7,0.2,29,1,25,26.6,-1,0,0,0,0,0,0,0
"1146",2018-03-16,"Gothic Rd","w1718","Mechanized",3,"Fri","weekday","no_sled","2","2","2",7.7,0.2,29,1,25,26.6,-1,0,0,0,0,0,0,0
"1147",2018-03-16,"Gothic Rd","w1718","Motorized",0,"Fri","weekday","sled","2","2","2",7.7,0.2,29,1,25,26.6,-1,0,0,0,0,0,0,0
"1148",2018-03-16,"Gothic Rd","w1718","Hybrid",0,"Fri","weekday","sled","2","2","2",7.7,0.2,29,1,25,26.6,-1,0,0,0,0,0,0,0
"1149",2018-03-17,"Gothic Rd","w1718","Non.motorized",54,"Sat","weekend","no_sled","2","2","2",7.8,0.1,32,3,29,24.4,1,-1,0,0,4,3,3,3
"1150",2018-03-17,"Gothic Rd","w1718","Mechanized",5,"Sat","weekend","no_sled","2","2","2",7.8,0.1,32,3,29,24.4,1,-1,0,0,4,3,3,3
"1151",2018-03-17,"Gothic Rd","w1718","Motorized",0,"Sat","weekend","sled","2","2","2",7.8,0.1,32,3,29,24.4,1,-1,0,0,4,3,3,3
"1152",2018-03-17,"Gothic Rd","w1718","Hybrid",0,"Sat","weekend","sled","2","2","2",7.8,0.1,32,3,29,24.4,1,-1,0,0,4,3,3,3
"1153",2018-03-18,"Gothic Rd","w1718","Non.motorized",27,"Sun","weekend","no_sled","2","2","2",7.9,0.1,31,-1,24,25.5,3,1,-1,0,2,3,2,2
"1154",2018-03-18,"Gothic Rd","w1718","Mechanized",4,"Sun","weekend","no_sled","2","2","2",7.9,0.1,31,-1,24,25.5,3,1,-1,0,2,3,2,2
"1155",2018-03-18,"Gothic Rd","w1718","Motorized",0,"Sun","weekend","sled","2","2","2",7.9,0.1,31,-1,24,25.5,3,1,-1,0,2,3,2,2
"1156",2018-03-18,"Gothic Rd","w1718","Hybrid",0,"Sun","weekend","sled","2","2","2",7.9,0.1,31,-1,24,25.5,3,1,-1,0,2,3,2,2
"1157",2018-03-19,"Gothic Rd","w1718","Non.motorized",51,"Mon","weekday","no_sled","2","2","1",8,0.1,32,1,19,25,-1,3,1,-1,0,3,4,3
"1158",2018-03-19,"Gothic Rd","w1718","Mechanized",0,"Mon","weekday","no_sled","2","2","1",8,0.1,32,1,19,25,-1,3,1,-1,0,3,4,3
"1159",2018-03-19,"Gothic Rd","w1718","Motorized",1,"Mon","weekday","sled","2","2","1",8,0.1,32,1,19,25,-1,3,1,-1,0,3,4,3
"1160",2018-03-19,"Gothic Rd","w1718","Hybrid",0,"Mon","weekday","sled","2","2","1",8,0.1,32,1,19,25,-1,3,1,-1,0,3,4,3
"1161",2018-03-20,"Gothic Rd","w1718","Non.motorized",19,"Tue","weekday","no_sled","2","2","1",8,0,30,-2,24,26.7,1,-1,3,1,-1,-2,1,2
"1162",2018-03-20,"Gothic Rd","w1718","Mechanized",0,"Tue","weekday","no_sled","2","2","1",8,0,30,-2,24,26.7,1,-1,3,1,-1,-2,1,2
"1163",2018-03-20,"Gothic Rd","w1718","Motorized",0,"Tue","weekday","sled","2","2","1",8,0,30,-2,24,26.7,1,-1,3,1,-1,-2,1,2
"1164",2018-03-20,"Gothic Rd","w1718","Hybrid",0,"Tue","weekday","sled","2","2","1",8,0,30,-2,24,26.7,1,-1,3,1,-1,-2,1,2
"1165",2018-03-21,"Gothic Rd","w1718","Non.motorized",29,"Wed","weekday","no_sled","1","1","1",8.1,0.1,32,2,30,25.3,-2,1,-1,3,0,1,0,3
"1166",2018-03-21,"Gothic Rd","w1718","Mechanized",2,"Wed","weekday","no_sled","1","1","1",8.1,0.1,32,2,30,25.3,-2,1,-1,3,0,1,0,3
"1167",2018-03-21,"Gothic Rd","w1718","Motorized",0,"Wed","weekday","sled","1","1","1",8.1,0.1,32,2,30,25.3,-2,1,-1,3,0,1,0,3
"1168",2018-03-21,"Gothic Rd","w1718","Hybrid",0,"Wed","weekday","sled","1","1","1",8.1,0.1,32,2,30,25.3,-2,1,-1,3,0,1,0,3
"1169",2018-03-22,"Gothic Rd","w1718","Non.motorized",30,"Thu","weekday","no_sled","1","1","1",8.1,0,30,-2,36,27,2,-2,1,-1,0,-2,-1,-2
"1170",2018-03-22,"Gothic Rd","w1718","Mechanized",0,"Thu","weekday","no_sled","1","1","1",8.1,0,30,-2,36,27,2,-2,1,-1,0,-2,-1,-2
"1171",2018-03-22,"Gothic Rd","w1718","Motorized",0,"Thu","weekday","sled","1","1","1",8.1,0,30,-2,36,27,2,-2,1,-1,0,-2,-1,-2
"1172",2018-03-22,"Gothic Rd","w1718","Hybrid",0,"Thu","weekday","sled","1","1","1",8.1,0,30,-2,36,27,2,-2,1,-1,0,-2,-1,-2
"1173",2018-03-23,"Gothic Rd","w1718","Non.motorized",18,"Fri","weekday","no_sled","2","2","3",8.2,0.1,29,-1,34,28.3,-2,2,-2,1,-3,-1,-3,-2
"1174",2018-03-23,"Gothic Rd","w1718","Mechanized",0,"Fri","weekday","no_sled","2","2","3",8.2,0.1,29,-1,34,28.3,-2,2,-2,1,-3,-1,-3,-2
"1175",2018-03-23,"Gothic Rd","w1718","Motorized",0,"Fri","weekday","sled","2","2","3",8.2,0.1,29,-1,34,28.3,-2,2,-2,1,-3,-1,-3,-2
"1176",2018-03-23,"Gothic Rd","w1718","Hybrid",0,"Fri","weekday","sled","2","2","3",8.2,0.1,29,-1,34,28.3,-2,2,-2,1,-3,-1,-3,-2
"1177",2018-03-24,"Gothic Rd","w1718","Non.motorized",25,"Sat","weekend","no_sled","2","2","1",8.9,0.7,34,5,32,26.2,-1,-2,2,-2,4,2,4,2
"1178",2018-03-24,"Gothic Rd","w1718","Mechanized",7,"Sat","weekend","no_sled","2","2","1",8.9,0.7,34,5,32,26.2,-1,-2,2,-2,4,2,4,2
"1179",2018-03-24,"Gothic Rd","w1718","Motorized",1,"Sat","weekend","sled","2","2","1",8.9,0.7,34,5,32,26.2,-1,-2,2,-2,4,2,4,2
"1180",2018-03-24,"Gothic Rd","w1718","Hybrid",0,"Sat","weekend","sled","2","2","1",8.9,0.7,34,5,32,26.2,-1,-2,2,-2,4,2,4,2
"1181",2018-03-25,"Gothic Rd","w1718","Non.motorized",65,"Sun","weekend","no_sled","2","2","1",8.9,0,35,1,35,25.4,5,-1,-2,2,6,5,3,5
"1182",2018-03-25,"Gothic Rd","w1718","Mechanized",3,"Sun","weekend","no_sled","2","2","1",8.9,0,35,1,35,25.4,5,-1,-2,2,6,5,3,5
"1183",2018-03-25,"Gothic Rd","w1718","Motorized",0,"Sun","weekend","sled","2","2","1",8.9,0,35,1,35,25.4,5,-1,-2,2,6,5,3,5
"1184",2018-03-25,"Gothic Rd","w1718","Hybrid",0,"Sun","weekend","sled","2","2","1",8.9,0,35,1,35,25.4,5,-1,-2,2,6,5,3,5
"1185",2018-03-26,"Gothic Rd","w1718","Non.motorized",52,"Mon","weekday","no_sled","1","1","1",8.9,0,34,-1,31,26.2,1,5,-1,-2,0,5,4,2
"1186",2018-03-26,"Gothic Rd","w1718","Non.motorized",52,"Mon","weekday","no_sled","2","1","1",8.9,0,34,-1,31,26.2,1,5,-1,-2,0,5,4,2
"1187",2018-03-26,"Gothic Rd","w1718","Mechanized",4,"Mon","weekday","no_sled","1","1","1",8.9,0,34,-1,31,26.2,1,5,-1,-2,0,5,4,2
"1188",2018-03-26,"Gothic Rd","w1718","Mechanized",4,"Mon","weekday","no_sled","2","1","1",8.9,0,34,-1,31,26.2,1,5,-1,-2,0,5,4,2
"1189",2018-03-26,"Gothic Rd","w1718","Motorized",0,"Mon","weekday","sled","1","1","1",8.9,0,34,-1,31,26.2,1,5,-1,-2,0,5,4,2
"1190",2018-03-26,"Gothic Rd","w1718","Motorized",0,"Mon","weekday","sled","2","1","1",8.9,0,34,-1,31,26.2,1,5,-1,-2,0,5,4,2
"1191",2018-03-26,"Gothic Rd","w1718","Hybrid",0,"Mon","weekday","sled","1","1","1",8.9,0,34,-1,31,26.2,1,5,-1,-2,0,5,4,2
"1192",2018-03-26,"Gothic Rd","w1718","Hybrid",0,"Mon","weekday","sled","2","1","1",8.9,0,34,-1,31,26.2,1,5,-1,-2,0,5,4,2
"1193",2018-03-27,"Gothic Rd","w1718","Non.motorized",34,"Tue","weekday","no_sled","1","1","1",8.9,0,33,-1,29,27,-1,1,5,-1,-2,-1,4,3
"1194",2018-03-27,"Gothic Rd","w1718","Mechanized",3,"Tue","weekday","no_sled","1","1","1",8.9,0,33,-1,29,27,-1,1,5,-1,-2,-1,4,3
"1195",2018-03-27,"Gothic Rd","w1718","Motorized",0,"Tue","weekday","sled","1","1","1",8.9,0,33,-1,29,27,-1,1,5,-1,-2,-1,4,3
"1196",2018-03-27,"Gothic Rd","w1718","Hybrid",0,"Tue","weekday","sled","1","1","1",8.9,0,33,-1,29,27,-1,1,5,-1,-2,-1,4,3
"1197",2018-03-28,"Gothic Rd","w1718","Non.motorized",25,"Wed","weekday","no_sled","1","1","1",8.9,0,33,0,27,27,-1,-1,1,5,-1,-2,-1,4
"1198",2018-03-28,"Gothic Rd","w1718","Mechanized",0,"Wed","weekday","no_sled","1","1","1",8.9,0,33,0,27,27,-1,-1,1,5,-1,-2,-1,4
"1199",2018-03-28,"Gothic Rd","w1718","Motorized",0,"Wed","weekday","sled","1","1","1",8.9,0,33,0,27,27,-1,-1,1,5,-1,-2,-1,4
"1200",2018-03-28,"Gothic Rd","w1718","Hybrid",0,"Wed","weekday","sled","1","1","1",8.9,0,33,0,27,27,-1,-1,1,5,-1,-2,-1,4
"1201",2018-03-29,"Gothic Rd","w1718","Non.motorized",36,"Thu","weekday","no_sled","1","1","1",8.9,0,33,0,27,27,0,-1,-1,1,0,-1,-2,-1
"1202",2018-03-29,"Gothic Rd","w1718","Mechanized",3,"Thu","weekday","no_sled","1","1","1",8.9,0,33,0,27,27,0,-1,-1,1,0,-1,-2,-1
"1203",2018-03-29,"Gothic Rd","w1718","Motorized",0,"Thu","weekday","sled","1","1","1",8.9,0,33,0,27,27,0,-1,-1,1,0,-1,-2,-1
"1204",2018-03-29,"Gothic Rd","w1718","Hybrid",0,"Thu","weekday","sled","1","1","1",8.9,0,33,0,27,27,0,-1,-1,1,0,-1,-2,-1
"1205",2018-03-30,"Gothic Rd","w1718","Non.motorized",61,"Fri","weekday","no_sled","1","1","1",8.9,0,32,-1,33,27.8,0,0,-1,-1,-1,-1,-2,-3
"1206",2018-03-30,"Gothic Rd","w1718","Mechanized",3,"Fri","weekday","no_sled","1","1","1",8.9,0,32,-1,33,27.8,0,0,-1,-1,-1,-1,-2,-3
"1207",2018-03-30,"Gothic Rd","w1718","Motorized",2,"Fri","weekday","sled","1","1","1",8.9,0,32,-1,33,27.8,0,0,-1,-1,-1,-1,-2,-3
"1208",2018-03-30,"Gothic Rd","w1718","Hybrid",0,"Fri","weekday","sled","1","1","1",8.9,0,32,-1,33,27.8,0,0,-1,-1,-1,-1,-2,-3
"1209",2018-03-31,"Gothic Rd","w1718","Non.motorized",58,"Sat","weekend","no_sled","1","1","1",8.9,0,32,0,39,27.8,-1,0,0,-1,-1,-1,-1,-2
"1210",2018-03-31,"Gothic Rd","w1718","Mechanized",1,"Sat","weekend","no_sled","1","1","1",8.9,0,32,0,39,27.8,-1,0,0,-1,-1,-1,-1,-2
"1211",2018-03-31,"Gothic Rd","w1718","Motorized",0,"Sat","weekend","sled","1","1","1",8.9,0,32,0,39,27.8,-1,0,0,-1,-1,-1,-1,-2
"1212",2018-03-31,"Gothic Rd","w1718","Hybrid",0,"Sat","weekend","sled","1","1","1",8.9,0,32,0,39,27.8,-1,0,0,-1,-1,-1,-1,-2
"1213",2018-04-01,"Gothic Rd","w1718","Non.motorized",27,"Sun","weekend","no_sled","1","1","1",8.8,-0.1,30,-2,41,29.3,0,-1,0,0,-2,-3,-3,-3
"1214",2018-04-01,"Gothic Rd","w1718","Mechanized",0,"Sun","weekend","no_sled","1","1","1",8.8,-0.1,30,-2,41,29.3,0,-1,0,0,-2,-3,-3,-3
"1215",2018-04-01,"Gothic Rd","w1718","Motorized",0,"Sun","weekend","sled","1","1","1",8.8,-0.1,30,-2,41,29.3,0,-1,0,0,-2,-3,-3,-3
"1216",2018-04-01,"Gothic Rd","w1718","Hybrid",0,"Sun","weekend","sled","1","1","1",8.8,-0.1,30,-2,41,29.3,0,-1,0,0,-2,-3,-3,-3
"1217",2018-04-02,"Gothic Rd","w1718","Non.motorized",21,"Mon","weekday","no_sled","1","1","1",8.7,-0.1,29,-1,39,30,-2,0,-1,0,-3,-3,-4,-4
"1218",2018-04-02,"Gothic Rd","w1718","Mechanized",0,"Mon","weekday","no_sled","1","1","1",8.7,-0.1,29,-1,39,30,-2,0,-1,0,-3,-3,-4,-4
"1219",2018-04-02,"Gothic Rd","w1718","Motorized",0,"Mon","weekday","sled","1","1","1",8.7,-0.1,29,-1,39,30,-2,0,-1,0,-3,-3,-4,-4
"1220",2018-04-02,"Gothic Rd","w1718","Hybrid",0,"Mon","weekday","sled","1","1","1",8.7,-0.1,29,-1,39,30,-2,0,-1,0,-3,-3,-4,-4
"1221",2018-04-03,"Gothic Rd","w1718","Non.motorized",11,"Tue","weekday","no_sled","1","1","1",8.8,0.1,30,1,27,29.3,-1,-2,0,-1,0,-2,-2,-3
"1222",2018-04-03,"Gothic Rd","w1718","Mechanized",0,"Tue","weekday","no_sled","1","1","1",8.8,0.1,30,1,27,29.3,-1,-2,0,-1,0,-2,-2,-3
"1223",2018-04-03,"Gothic Rd","w1718","Motorized",0,"Tue","weekday","sled","1","1","1",8.8,0.1,30,1,27,29.3,-1,-2,0,-1,0,-2,-2,-3
"1224",2018-04-03,"Gothic Rd","w1718","Hybrid",0,"Tue","weekday","sled","1","1","1",8.8,0.1,30,1,27,29.3,-1,-2,0,-1,0,-2,-2,-3
"1225",2018-04-04,"Gothic Rd","w1718","Non.motorized",16,"Wed","weekday","no_sled","1","2","2",8.9,0.1,28,-2,33,31.8,1,-1,-2,0,-1,-2,-4,-4
"1226",2018-04-04,"Gothic Rd","w1718","Mechanized",0,"Wed","weekday","no_sled","1","2","2",8.9,0.1,28,-2,33,31.8,1,-1,-2,0,-1,-2,-4,-4
"1227",2018-04-04,"Gothic Rd","w1718","Motorized",0,"Wed","weekday","sled","1","2","2",8.9,0.1,28,-2,33,31.8,1,-1,-2,0,-1,-2,-4,-4
"1228",2018-04-04,"Gothic Rd","w1718","Hybrid",0,"Wed","weekday","sled","1","2","2",8.9,0.1,28,-2,33,31.8,1,-1,-2,0,-1,-2,-4,-4
"1229",2018-04-05,"Gothic Rd","w1718","Non.motorized",17,"Thu","weekday","no_sled","1","2","2",8.9,0,27,-1,35,33,-2,1,-1,-2,-3,-2,-3,-5
"1230",2018-04-05,"Gothic Rd","w1718","Mechanized",0,"Thu","weekday","no_sled","1","2","2",8.9,0,27,-1,35,33,-2,1,-1,-2,-3,-2,-3,-5
"1231",2018-04-05,"Gothic Rd","w1718","Motorized",1,"Thu","weekday","sled","1","2","2",8.9,0,27,-1,35,33,-2,1,-1,-2,-3,-2,-3,-5
"1232",2018-04-05,"Gothic Rd","w1718","Hybrid",0,"Thu","weekday","sled","1","2","2",8.9,0,27,-1,35,33,-2,1,-1,-2,-3,-2,-3,-5
"1233",2018-04-06,"Gothic Rd","w1718","Non.motorized",4,"Fri","weekday","no_sled","1","2","2",8.9,0,25,-2,35,35.6,-1,-2,1,-1,-3,-5,-4,-5
"1234",2018-04-06,"Gothic Rd","w1718","Mechanized",0,"Fri","weekday","no_sled","1","2","2",8.9,0,25,-2,35,35.6,-1,-2,1,-1,-3,-5,-4,-5
"1235",2018-04-06,"Gothic Rd","w1718","Motorized",0,"Fri","weekday","sled","1","2","2",8.9,0,25,-2,35,35.6,-1,-2,1,-1,-3,-5,-4,-5
"1236",2018-04-06,"Gothic Rd","w1718","Hybrid",0,"Fri","weekday","sled","1","2","2",8.9,0,25,-2,35,35.6,-1,-2,1,-1,-3,-5,-4,-5
"1237",2018-04-07,"Gothic Rd","w1718","Non.motorized",18,"Sat","weekend","no_sled","2","2","2",9.2,0.3,31,6,37,29.7,-2,-1,-2,1,4,3,1,2
"1238",2018-04-07,"Gothic Rd","w1718","Mechanized",0,"Sat","weekend","no_sled","2","2","2",9.2,0.3,31,6,37,29.7,-2,-1,-2,1,4,3,1,2
"1239",2018-04-07,"Gothic Rd","w1718","Motorized",0,"Sat","weekend","sled","2","2","2",9.2,0.3,31,6,37,29.7,-2,-1,-2,1,4,3,1,2
"1240",2018-04-07,"Gothic Rd","w1718","Hybrid",0,"Sat","weekend","sled","2","2","2",9.2,0.3,31,6,37,29.7,-2,-1,-2,1,4,3,1,2
"1241",2018-04-08,"Gothic Rd","w1718","Non.motorized",6,"Sun","weekend","no_sled","3","3","3",10,0.8,33,2,33,30.3,6,-2,-1,-2,8,6,5,3
"1242",2018-04-08,"Gothic Rd","w1718","Mechanized",0,"Sun","weekend","no_sled","3","3","3",10,0.8,33,2,33,30.3,6,-2,-1,-2,8,6,5,3
"1243",2018-04-08,"Gothic Rd","w1718","Motorized",0,"Sun","weekend","sled","3","3","3",10,0.8,33,2,33,30.3,6,-2,-1,-2,8,6,5,3
"1244",2018-04-08,"Gothic Rd","w1718","Hybrid",0,"Sun","weekend","sled","3","3","3",10,0.8,33,2,33,30.3,6,-2,-1,-2,8,6,5,3
"1245",2018-04-09,"Gothic Rd","w1718","Non.motorized",7,"Mon","weekday","no_sled","1","1","1",10.1,0.1,33,0,31,30.6,2,6,-2,-1,2,8,6,5
"1246",2018-04-09,"Gothic Rd","w1718","Mechanized",0,"Mon","weekday","no_sled","1","1","1",10.1,0.1,33,0,31,30.6,2,6,-2,-1,2,8,6,5
"1247",2018-04-09,"Gothic Rd","w1718","Motorized",0,"Mon","weekday","sled","1","1","1",10.1,0.1,33,0,31,30.6,2,6,-2,-1,2,8,6,5
"1248",2018-04-09,"Gothic Rd","w1718","Hybrid",0,"Mon","weekday","sled","1","1","1",10.1,0.1,33,0,31,30.6,2,6,-2,-1,2,8,6,5
"1249",2018-04-10,"Gothic Rd","w1718","Non.motorized",12,"Tue","weekday","no_sled","1","1","1",10.1,0,31,-2,38,32.6,0,2,6,-2,-2,0,6,4
"1250",2018-04-10,"Gothic Rd","w1718","Mechanized",0,"Tue","weekday","no_sled","1","1","1",10.1,0,31,-2,38,32.6,0,2,6,-2,-2,0,6,4
"1251",2018-04-10,"Gothic Rd","w1718","Motorized",0,"Tue","weekday","sled","1","1","1",10.1,0,31,-2,38,32.6,0,2,6,-2,-2,0,6,4
"1252",2018-04-10,"Gothic Rd","w1718","Hybrid",0,"Tue","weekday","sled","1","1","1",10.1,0,31,-2,38,32.6,0,2,6,-2,-2,0,6,4
"1253",2018-04-11,"Gothic Rd","w1718","Non.motorized",11,"Wed","weekday","no_sled","2","2","2",9.9,-0.2,29,-2,45,34.1,-2,0,2,6,-4,-4,-2,4
"1254",2018-04-11,"Gothic Rd","w1718","Mechanized",0,"Wed","weekday","no_sled","2","2","2",9.9,-0.2,29,-2,45,34.1,-2,0,2,6,-4,-4,-2,4
"1255",2018-04-11,"Gothic Rd","w1718","Motorized",0,"Wed","weekday","sled","2","2","2",9.9,-0.2,29,-2,45,34.1,-2,0,2,6,-4,-4,-2,4
"1256",2018-04-11,"Gothic Rd","w1718","Hybrid",0,"Wed","weekday","sled","2","2","2",9.9,-0.2,29,-2,45,34.1,-2,0,2,6,-4,-4,-2,4
"1257",2018-04-12,"Gothic Rd","w1718","Non.motorized",6,"Thu","weekday","no_sled","1","2","2",9.5,-0.4,28,-1,40,33.9,-2,-2,0,2,-3,-5,-5,-3
"1258",2018-04-12,"Gothic Rd","w1718","Mechanized",0,"Thu","weekday","no_sled","1","2","2",9.5,-0.4,28,-1,40,33.9,-2,-2,0,2,-3,-5,-5,-3
"1259",2018-04-12,"Gothic Rd","w1718","Motorized",0,"Thu","weekday","sled","1","2","2",9.5,-0.4,28,-1,40,33.9,-2,-2,0,2,-3,-5,-5,-3
"1260",2018-04-12,"Gothic Rd","w1718","Hybrid",0,"Thu","weekday","sled","1","2","2",9.5,-0.4,28,-1,40,33.9,-2,-2,0,2,-3,-5,-5,-3
"1261",2018-04-13,"Gothic Rd","w1718","Non.motorized",6,"Fri","weekday","no_sled","2","2","1",9.4,-0.1,26,-2,23,36.2,-1,-2,-2,0,-3,-5,-7,-7
"1262",2018-04-13,"Gothic Rd","w1718","Mechanized",1,"Fri","weekday","no_sled","2","2","1",9.4,-0.1,26,-2,23,36.2,-1,-2,-2,0,-3,-5,-7,-7
"1263",2018-04-13,"Gothic Rd","w1718","Motorized",0,"Fri","weekday","sled","2","2","1",9.4,-0.1,26,-2,23,36.2,-1,-2,-2,0,-3,-5,-7,-7
"1264",2018-04-13,"Gothic Rd","w1718","Hybrid",0,"Fri","weekday","sled","2","2","1",9.4,-0.1,26,-2,23,36.2,-1,-2,-2,0,-3,-5,-7,-7
"1265",2018-04-14,"Gothic Rd","w1718","Non.motorized",9,"Sat","weekend","no_sled","2","2","1",9.4,0,28,2,28,33.6,-2,-1,-2,-2,0,-1,-3,-5
"1266",2018-04-14,"Gothic Rd","w1718","Mechanized",0,"Sat","weekend","no_sled","2","2","1",9.4,0,28,2,28,33.6,-2,-1,-2,-2,0,-1,-3,-5
"1267",2018-04-14,"Gothic Rd","w1718","Motorized",0,"Sat","weekend","sled","2","2","1",9.4,0,28,2,28,33.6,-2,-1,-2,-2,0,-1,-3,-5
"1268",2018-04-14,"Gothic Rd","w1718","Hybrid",0,"Sat","weekend","sled","2","2","1",9.4,0,28,2,28,33.6,-2,-1,-2,-2,0,-1,-3,-5
"1269",2018-04-15,"Gothic Rd","w1718","Non.motorized",11,"Sun","weekend","no_sled","2","2","1",9.2,-0.2,27,-1,37,34.1,2,-2,-1,-2,1,-1,-2,-4
"1270",2018-04-15,"Gothic Rd","w1718","Mechanized",0,"Sun","weekend","no_sled","2","2","1",9.2,-0.2,27,-1,37,34.1,2,-2,-1,-2,1,-1,-2,-4
"1271",2018-04-15,"Gothic Rd","w1718","Motorized",0,"Sun","weekend","sled","2","2","1",9.2,-0.2,27,-1,37,34.1,2,-2,-1,-2,1,-1,-2,-4
"1272",2018-04-15,"Gothic Rd","w1718","Hybrid",0,"Sun","weekend","sled","2","2","1",9.2,-0.2,27,-1,37,34.1,2,-2,-1,-2,1,-1,-2,-4
"1273",2018-02-09,"Kebler","w1718","Non.motorized",1,"Fri","weekday","no_sled","2","2","1",5.3,0,24,-1,33,22.1,2,0,5,-1,1,1,6,5
"1274",2018-02-09,"Kebler","w1718","Mechanized",1,"Fri","weekday","no_sled","2","2","1",5.3,0,24,-1,33,22.1,2,0,5,-1,1,1,6,5
"1275",2018-02-09,"Kebler","w1718","Motorized",29,"Fri","weekday","sled","2","2","1",5.3,0,24,-1,33,22.1,2,0,5,-1,1,1,6,5
"1276",2018-02-09,"Kebler","w1718","Hybrid",0,"Fri","weekday","sled","2","2","1",5.3,0,24,-1,33,22.1,2,0,5,-1,1,1,6,5
"1277",2018-02-10,"Kebler","w1718","Non.motorized",3,"Sat","weekend","no_sled","3","3","2",5.3,0,24,0,24,22.1,-1,2,0,5,-1,1,1,6
"1278",2018-02-10,"Kebler","w1718","Mechanized",1,"Sat","weekend","no_sled","3","3","2",5.3,0,24,0,24,22.1,-1,2,0,5,-1,1,1,6
"1279",2018-02-10,"Kebler","w1718","Motorized",20,"Sat","weekend","sled","3","3","2",5.3,0,24,0,24,22.1,-1,2,0,5,-1,1,1,6
"1280",2018-02-10,"Kebler","w1718","Hybrid",4,"Sat","weekend","sled","3","3","2",5.3,0,24,0,24,22.1,-1,2,0,5,-1,1,1,6
"1281",2018-02-11,"Kebler","w1718","Non.motorized",10,"Sun","weekend","no_sled","3","3","2",5.6,0.3,27,3,13,20.7,0,-1,2,0,3,2,4,4
"1282",2018-02-11,"Kebler","w1718","Mechanized",0,"Sun","weekend","no_sled","3","3","2",5.6,0.3,27,3,13,20.7,0,-1,2,0,3,2,4,4
"1283",2018-02-11,"Kebler","w1718","Motorized",129,"Sun","weekend","sled","3","3","2",5.6,0.3,27,3,13,20.7,0,-1,2,0,3,2,4,4
"1284",2018-02-11,"Kebler","w1718","Hybrid",21,"Sun","weekend","sled","3","3","2",5.6,0.3,27,3,13,20.7,0,-1,2,0,3,2,4,4
"1285",2018-02-12,"Kebler","w1718","Non.motorized",0,"Mon","weekday","no_sled","3","3","3",5.7,0.1,27,0,23,21.1,3,0,-1,2,3,3,2,4
"1286",2018-02-12,"Kebler","w1718","Mechanized",0,"Mon","weekday","no_sled","3","3","3",5.7,0.1,27,0,23,21.1,3,0,-1,2,3,3,2,4
"1287",2018-02-12,"Kebler","w1718","Motorized",32,"Mon","weekday","sled","3","3","3",5.7,0.1,27,0,23,21.1,3,0,-1,2,3,3,2,4
"1288",2018-02-12,"Kebler","w1718","Hybrid",9,"Mon","weekday","sled","3","3","3",5.7,0.1,27,0,23,21.1,3,0,-1,2,3,3,2,4
"1289",2018-02-13,"Kebler","w1718","Non.motorized",16,"Tue","weekday","no_sled","3","3","3",6.1,0.4,29,2,28,21,0,3,0,-1,2,5,5,4
"1290",2018-02-13,"Kebler","w1718","Mechanized",1,"Tue","weekday","no_sled","3","3","3",6.1,0.4,29,2,28,21,0,3,0,-1,2,5,5,4
"1291",2018-02-13,"Kebler","w1718","Motorized",38,"Tue","weekday","sled","3","3","3",6.1,0.4,29,2,28,21,0,3,0,-1,2,5,5,4
"1292",2018-02-13,"Kebler","w1718","Hybrid",2,"Tue","weekday","sled","3","3","3",6.1,0.4,29,2,28,21,0,3,0,-1,2,5,5,4
"1293",2018-02-14,"Kebler","w1718","Non.motorized",9,"Wed","weekday","no_sled","3","3","3",6.2,0.1,30,1,30,20.7,2,0,3,0,3,3,6,6
"1294",2018-02-14,"Kebler","w1718","Mechanized",0,"Wed","weekday","no_sled","3","3","3",6.2,0.1,30,1,30,20.7,2,0,3,0,3,3,6,6
"1295",2018-02-14,"Kebler","w1718","Motorized",80,"Wed","weekday","sled","3","3","3",6.2,0.1,30,1,30,20.7,2,0,3,0,3,3,6,6
"1296",2018-02-14,"Kebler","w1718","Hybrid",0,"Wed","weekday","sled","3","3","3",6.2,0.1,30,1,30,20.7,2,0,3,0,3,3,6,6
"1297",2018-02-15,"Kebler","w1718","Non.motorized",10,"Thu","weekday","no_sled","3","3","3",6.3,0.1,28,-2,24,22.5,1,2,0,3,-1,1,1,4
"1298",2018-02-15,"Kebler","w1718","Mechanized",0,"Thu","weekday","no_sled","3","3","3",6.3,0.1,28,-2,24,22.5,1,2,0,3,-1,1,1,4
"1299",2018-02-15,"Kebler","w1718","Motorized",43,"Thu","weekday","sled","3","3","3",6.3,0.1,28,-2,24,22.5,1,2,0,3,-1,1,1,4
"1300",2018-02-15,"Kebler","w1718","Hybrid",0,"Thu","weekday","sled","3","3","3",6.3,0.1,28,-2,24,22.5,1,2,0,3,-1,1,1,4
"1301",2018-02-16,"Kebler","w1718","Non.motorized",12,"Fri","weekday","no_sled","3","3","3",6.7,0.4,32,4,18,20.9,-2,1,2,0,2,3,5,5
"1302",2018-02-16,"Kebler","w1718","Mechanized",0,"Fri","weekday","no_sled","3","3","3",6.7,0.4,32,4,18,20.9,-2,1,2,0,2,3,5,5
"1303",2018-02-16,"Kebler","w1718","Motorized",114,"Fri","weekday","sled","3","3","3",6.7,0.4,32,4,18,20.9,-2,1,2,0,2,3,5,5
"1304",2018-02-16,"Kebler","w1718","Hybrid",6,"Fri","weekday","sled","3","3","3",6.7,0.4,32,4,18,20.9,-2,1,2,0,2,3,5,5
"1305",2018-02-17,"Kebler","w1718","Non.motorized",39,"Sat","weekend","no_sled","3","3","2",6.7,0,32,0,25,20.9,4,-2,1,2,4,2,3,5
"1306",2018-02-17,"Kebler","w1718","Mechanized",0,"Sat","weekend","no_sled","3","3","2",6.7,0,32,0,25,20.9,4,-2,1,2,4,2,3,5
"1307",2018-02-17,"Kebler","w1718","Motorized",184,"Sat","weekend","sled","3","3","2",6.7,0,32,0,25,20.9,4,-2,1,2,4,2,3,5
"1308",2018-02-17,"Kebler","w1718","Hybrid",2,"Sat","weekend","sled","3","3","2",6.7,0,32,0,25,20.9,4,-2,1,2,4,2,3,5
"1309",2018-02-18,"Kebler","w1718","Non.motorized",19,"Sun","weekend","no_sled","2","2","2",6.7,0,31,-1,32,21.6,0,4,-2,1,-1,3,1,2
"1310",2018-02-18,"Kebler","w1718","Mechanized",0,"Sun","weekend","no_sled","2","2","2",6.7,0,31,-1,32,21.6,0,4,-2,1,-1,3,1,2
"1311",2018-02-18,"Kebler","w1718","Motorized",156,"Sun","weekend","sled","2","2","2",6.7,0,31,-1,32,21.6,0,4,-2,1,-1,3,1,2
"1312",2018-02-18,"Kebler","w1718","Hybrid",17,"Sun","weekend","sled","2","2","2",6.7,0,31,-1,32,21.6,0,4,-2,1,-1,3,1,2
"1313",2018-02-19,"Kebler","w1718","Non.motorized",0,"Mon","weekday","no_sled","2","2","2",6.8,0.1,29,-2,24,23.4,-1,0,4,-2,-3,-3,1,-1
"1314",2018-02-19,"Kebler","w1718","Non.motorized",0,"Mon","weekday","no_sled","3","3","3",6.8,0.1,29,-2,24,23.4,-1,0,4,-2,-3,-3,1,-1
"1315",2018-02-19,"Kebler","w1718","Mechanized",0,"Mon","weekday","no_sled","2","2","2",6.8,0.1,29,-2,24,23.4,-1,0,4,-2,-3,-3,1,-1
"1316",2018-02-19,"Kebler","w1718","Mechanized",0,"Mon","weekday","no_sled","3","3","3",6.8,0.1,29,-2,24,23.4,-1,0,4,-2,-3,-3,1,-1
"1317",2018-02-19,"Kebler","w1718","Motorized",49,"Mon","weekday","sled","2","2","2",6.8,0.1,29,-2,24,23.4,-1,0,4,-2,-3,-3,1,-1
"1318",2018-02-19,"Kebler","w1718","Motorized",49,"Mon","weekday","sled","3","3","3",6.8,0.1,29,-2,24,23.4,-1,0,4,-2,-3,-3,1,-1
"1319",2018-02-19,"Kebler","w1718","Hybrid",2,"Mon","weekday","sled","2","2","2",6.8,0.1,29,-2,24,23.4,-1,0,4,-2,-3,-3,1,-1
"1320",2018-02-19,"Kebler","w1718","Hybrid",2,"Mon","weekday","sled","3","3","3",6.8,0.1,29,-2,24,23.4,-1,0,4,-2,-3,-3,1,-1
"1321",2018-02-20,"Kebler","w1718","Non.motorized",8,"Tue","weekday","no_sled","3","3","3",6.8,0,31,2,8,21.9,-2,-1,0,4,0,-1,-1,3
"1322",2018-02-20,"Kebler","w1718","Mechanized",0,"Tue","weekday","no_sled","3","3","3",6.8,0,31,2,8,21.9,-2,-1,0,4,0,-1,-1,3
"1323",2018-02-20,"Kebler","w1718","Motorized",35,"Tue","weekday","sled","3","3","3",6.8,0,31,2,8,21.9,-2,-1,0,4,0,-1,-1,3
"1324",2018-02-20,"Kebler","w1718","Hybrid",1,"Tue","weekday","sled","3","3","3",6.8,0,31,2,8,21.9,-2,-1,0,4,0,-1,-1,3
"1325",2018-02-21,"Kebler","w1718","Non.motorized",18,"Wed","weekday","no_sled","3","3","3",6.8,0,31,0,11,21.9,2,-2,-1,0,2,0,-1,-1
"1326",2018-02-21,"Kebler","w1718","Mechanized",0,"Wed","weekday","no_sled","3","3","3",6.8,0,31,0,11,21.9,2,-2,-1,0,2,0,-1,-1
"1327",2018-02-21,"Kebler","w1718","Motorized",63,"Wed","weekday","sled","3","3","3",6.8,0,31,0,11,21.9,2,-2,-1,0,2,0,-1,-1
"1328",2018-02-21,"Kebler","w1718","Hybrid",3,"Wed","weekday","sled","3","3","3",6.8,0,31,0,11,21.9,2,-2,-1,0,2,0,-1,-1
"1329",2018-02-22,"Kebler","w1718","Non.motorized",1,"Thu","weekday","no_sled","3","3","2",6.8,0,30,-1,16,22.7,0,2,-2,-1,-1,1,-1,-2
"1330",2018-02-22,"Kebler","w1718","Mechanized",0,"Thu","weekday","no_sled","3","3","2",6.8,0,30,-1,16,22.7,0,2,-2,-1,-1,1,-1,-2
"1331",2018-02-22,"Kebler","w1718","Motorized",49,"Thu","weekday","sled","3","3","2",6.8,0,30,-1,16,22.7,0,2,-2,-1,-1,1,-1,-2
"1332",2018-02-22,"Kebler","w1718","Hybrid",0,"Thu","weekday","sled","3","3","2",6.8,0,30,-1,16,22.7,0,2,-2,-1,-1,1,-1,-2
"1333",2018-02-23,"Kebler","w1718","Non.motorized",16,"Fri","weekday","no_sled","3","3","2",6.9,0.1,30,0,15,23,-1,0,2,-2,-1,-1,1,-1
"1334",2018-02-23,"Kebler","w1718","Mechanized",0,"Fri","weekday","no_sled","3","3","2",6.9,0.1,30,0,15,23,-1,0,2,-2,-1,-1,1,-1
"1335",2018-02-23,"Kebler","w1718","Motorized",66,"Fri","weekday","sled","3","3","2",6.9,0.1,30,0,15,23,-1,0,2,-2,-1,-1,1,-1
"1336",2018-02-23,"Kebler","w1718","Hybrid",2,"Fri","weekday","sled","3","3","2",6.9,0.1,30,0,15,23,-1,0,2,-2,-1,-1,1,-1
"1337",2018-02-24,"Kebler","w1718","Non.motorized",7,"Sat","weekend","no_sled","3","3","2",6.9,0,31,1,10,22.3,0,-1,0,2,1,0,0,2
"1338",2018-02-24,"Kebler","w1718","Mechanized",0,"Sat","weekend","no_sled","3","3","2",6.9,0,31,1,10,22.3,0,-1,0,2,1,0,0,2
"1339",2018-02-24,"Kebler","w1718","Motorized",86,"Sat","weekend","sled","3","3","2",6.9,0,31,1,10,22.3,0,-1,0,2,1,0,0,2
"1340",2018-02-24,"Kebler","w1718","Hybrid",5,"Sat","weekend","sled","3","3","2",6.9,0,31,1,10,22.3,0,-1,0,2,1,0,0,2
"1341",2018-02-25,"Kebler","w1718","Non.motorized",9,"Sun","weekend","no_sled","3","3","2",7.1,0.2,32,1,11,22.2,1,0,-1,0,2,2,1,1
"1342",2018-02-25,"Kebler","w1718","Mechanized",0,"Sun","weekend","no_sled","3","3","2",7.1,0.2,32,1,11,22.2,1,0,-1,0,2,2,1,1
"1343",2018-02-25,"Kebler","w1718","Motorized",57,"Sun","weekend","sled","3","3","2",7.1,0.2,32,1,11,22.2,1,0,-1,0,2,2,1,1
"1344",2018-02-25,"Kebler","w1718","Hybrid",7,"Sun","weekend","sled","3","3","2",7.1,0.2,32,1,11,22.2,1,0,-1,0,2,2,1,1
"1345",2018-02-26,"Kebler","w1718","Non.motorized",23,"Mon","weekday","no_sled","2","2","2",7.1,0,32,0,20,22.2,1,1,0,-1,1,2,2,1
"1346",2018-02-26,"Kebler","w1718","Mechanized",0,"Mon","weekday","no_sled","2","2","2",7.1,0,32,0,20,22.2,1,1,0,-1,1,2,2,1
"1347",2018-02-26,"Kebler","w1718","Motorized",103,"Mon","weekday","sled","2","2","2",7.1,0,32,0,20,22.2,1,1,0,-1,1,2,2,1
"1348",2018-02-26,"Kebler","w1718","Hybrid",5,"Mon","weekday","sled","2","2","2",7.1,0,32,0,20,22.2,1,1,0,-1,1,2,2,1
"1349",2018-02-27,"Kebler","w1718","Non.motorized",3,"Tue","weekday","no_sled","2","2","2",7.2,0.1,32,0,26,22.5,0,1,1,0,0,1,2,2
"1350",2018-02-27,"Kebler","w1718","Mechanized",0,"Tue","weekday","no_sled","2","2","2",7.2,0.1,32,0,26,22.5,0,1,1,0,0,1,2,2
"1351",2018-02-27,"Kebler","w1718","Motorized",76,"Tue","weekday","sled","2","2","2",7.2,0.1,32,0,26,22.5,0,1,1,0,0,1,2,2
"1352",2018-02-27,"Kebler","w1718","Hybrid",2,"Tue","weekday","sled","2","2","2",7.2,0.1,32,0,26,22.5,0,1,1,0,0,1,2,2
"1353",2018-02-28,"Kebler","w1718","Non.motorized",6,"Wed","weekday","no_sled","2","2","2",7.2,0,31,-1,23,23.2,0,0,1,1,-1,-1,0,1
"1354",2018-02-28,"Kebler","w1718","Mechanized",0,"Wed","weekday","no_sled","2","2","2",7.2,0,31,-1,23,23.2,0,0,1,1,-1,-1,0,1
"1355",2018-02-28,"Kebler","w1718","Motorized",81,"Wed","weekday","sled","2","2","2",7.2,0,31,-1,23,23.2,0,0,1,1,-1,-1,0,1
"1356",2018-02-28,"Kebler","w1718","Hybrid",2,"Wed","weekday","sled","2","2","2",7.2,0,31,-1,23,23.2,0,0,1,1,-1,-1,0,1
"1357",2018-03-01,"Kebler","w1718","Non.motorized",1,"Thu","weekday","no_sled","2","2","2",7.2,0,31,0,24,23.2,-1,0,0,1,-1,-1,-1,0
"1358",2018-03-01,"Kebler","w1718","Mechanized",0,"Thu","weekday","no_sled","2","2","2",7.2,0,31,0,24,23.2,-1,0,0,1,-1,-1,-1,0
"1359",2018-03-01,"Kebler","w1718","Motorized",29,"Thu","weekday","sled","2","2","2",7.2,0,31,0,24,23.2,-1,0,0,1,-1,-1,-1,0
"1360",2018-03-01,"Kebler","w1718","Hybrid",0,"Thu","weekday","sled","2","2","2",7.2,0,31,0,24,23.2,-1,0,0,1,-1,-1,-1,0
"1361",2018-03-02,"Kebler","w1718","Non.motorized",0,"Fri","weekday","no_sled","2","2","1",7.2,0,31,0,30,23.2,0,-1,0,0,0,-1,-1,-1
"1362",2018-03-02,"Kebler","w1718","Mechanized",0,"Fri","weekday","no_sled","2","2","1",7.2,0,31,0,30,23.2,0,-1,0,0,0,-1,-1,-1
"1363",2018-03-02,"Kebler","w1718","Motorized",62,"Fri","weekday","sled","2","2","1",7.2,0,31,0,30,23.2,0,-1,0,0,0,-1,-1,-1
"1364",2018-03-02,"Kebler","w1718","Hybrid",5,"Fri","weekday","sled","2","2","1",7.2,0,31,0,30,23.2,0,-1,0,0,0,-1,-1,-1
"1365",2018-03-03,"Kebler","w1718","Non.motorized",12,"Sat","weekend","no_sled","2","2","1",7.3,0.1,30,-1,34,24.3,0,0,-1,0,-1,-1,-2,-2
"1366",2018-03-03,"Kebler","w1718","Mechanized",0,"Sat","weekend","no_sled","2","2","1",7.3,0.1,30,-1,34,24.3,0,0,-1,0,-1,-1,-2,-2
"1367",2018-03-03,"Kebler","w1718","Motorized",102,"Sat","weekend","sled","2","2","1",7.3,0.1,30,-1,34,24.3,0,0,-1,0,-1,-1,-2,-2
"1368",2018-03-03,"Kebler","w1718","Hybrid",23,"Sat","weekend","sled","2","2","1",7.3,0.1,30,-1,34,24.3,0,0,-1,0,-1,-1,-2,-2
"1369",2018-03-04,"Kebler","w1718","Non.motorized",0,"Sun","weekend","no_sled","2","2","1",7.3,0,29,-1,24,25.2,-1,0,0,-1,-2,-2,-2,-3
"1370",2018-03-04,"Kebler","w1718","Mechanized",1,"Sun","weekend","no_sled","2","2","1",7.3,0,29,-1,24,25.2,-1,0,0,-1,-2,-2,-2,-3
"1371",2018-03-04,"Kebler","w1718","Motorized",55,"Sun","weekend","sled","2","2","1",7.3,0,29,-1,24,25.2,-1,0,0,-1,-2,-2,-2,-3
"1372",2018-03-04,"Kebler","w1718","Hybrid",9,"Sun","weekend","sled","2","2","1",7.3,0,29,-1,24,25.2,-1,0,0,-1,-2,-2,-2,-3
"1373",2018-03-05,"Kebler","w1718","Non.motorized",5,"Mon","weekday","no_sled","2","2","1",7.3,0,31,2,13,23.5,-1,-1,0,0,1,0,0,0
"1374",2018-03-05,"Kebler","w1718","Mechanized",0,"Mon","weekday","no_sled","2","2","1",7.3,0,31,2,13,23.5,-1,-1,0,0,1,0,0,0
"1375",2018-03-05,"Kebler","w1718","Motorized",60,"Mon","weekday","sled","2","2","1",7.3,0,31,2,13,23.5,-1,-1,0,0,1,0,0,0
"1376",2018-03-05,"Kebler","w1718","Hybrid",3,"Mon","weekday","sled","2","2","1",7.3,0,31,2,13,23.5,-1,-1,0,0,1,0,0,0
"1377",2018-03-06,"Kebler","w1718","Non.motorized",0,"Tue","weekday","no_sled","2","2","1",7.3,0,31,0,19,23.5,2,-1,-1,0,2,1,0,0
"1378",2018-03-06,"Kebler","w1718","Mechanized",0,"Tue","weekday","no_sled","2","2","1",7.3,0,31,0,19,23.5,2,-1,-1,0,2,1,0,0
"1379",2018-03-06,"Kebler","w1718","Motorized",68,"Tue","weekday","sled","2","2","1",7.3,0,31,0,19,23.5,2,-1,-1,0,2,1,0,0
"1380",2018-03-06,"Kebler","w1718","Hybrid",6,"Tue","weekday","sled","2","2","1",7.3,0,31,0,19,23.5,2,-1,-1,0,2,1,0,0
"1381",2018-03-07,"Kebler","w1718","Non.motorized",6,"Wed","weekday","no_sled","2","2","1",7.4,0.1,31,0,27,23.9,0,2,-1,-1,0,2,1,0
"1382",2018-03-07,"Kebler","w1718","Mechanized",0,"Wed","weekday","no_sled","2","2","1",7.4,0.1,31,0,27,23.9,0,2,-1,-1,0,2,1,0
"1383",2018-03-07,"Kebler","w1718","Motorized",43,"Wed","weekday","sled","2","2","1",7.4,0.1,31,0,27,23.9,0,2,-1,-1,0,2,1,0
"1384",2018-03-07,"Kebler","w1718","Hybrid",4,"Wed","weekday","sled","2","2","1",7.4,0.1,31,0,27,23.9,0,2,-1,-1,0,2,1,0
"1385",2018-03-08,"Kebler","w1718","Non.motorized",0,"Thu","weekday","no_sled","2","2","1",7.4,0,30,-1,33,24.7,0,0,2,-1,-1,-1,1,0
"1386",2018-03-08,"Kebler","w1718","Mechanized",0,"Thu","weekday","no_sled","2","2","1",7.4,0,30,-1,33,24.7,0,0,2,-1,-1,-1,1,0
"1387",2018-03-08,"Kebler","w1718","Motorized",77,"Thu","weekday","sled","2","2","1",7.4,0,30,-1,33,24.7,0,0,2,-1,-1,-1,1,0
"1388",2018-03-08,"Kebler","w1718","Hybrid",8,"Thu","weekday","sled","2","2","1",7.4,0,30,-1,33,24.7,0,0,2,-1,-1,-1,1,0
"1389",2018-03-09,"Kebler","w1718","Non.motorized",6,"Fri","weekday","no_sled","2","2","1",7.4,0,30,0,34,24.7,-1,0,0,2,-1,-1,-1,1
"1390",2018-03-09,"Kebler","w1718","Mechanized",0,"Fri","weekday","no_sled","2","2","1",7.4,0,30,0,34,24.7,-1,0,0,2,-1,-1,-1,1
"1391",2018-03-09,"Kebler","w1718","Motorized",105,"Fri","weekday","sled","2","2","1",7.4,0,30,0,34,24.7,-1,0,0,2,-1,-1,-1,1
"1392",2018-03-09,"Kebler","w1718","Hybrid",0,"Fri","weekday","sled","2","2","1",7.4,0,30,0,34,24.7,-1,0,0,2,-1,-1,-1,1
"1393",2018-03-10,"Kebler","w1718","Non.motorized",8,"Sat","weekend","no_sled","1","1","1",7.4,0,30,0,31,24.7,0,-1,0,0,0,-1,-1,-1
"1394",2018-03-10,"Kebler","w1718","Mechanized",0,"Sat","weekend","no_sled","1","1","1",7.4,0,30,0,31,24.7,0,-1,0,0,0,-1,-1,-1
"1395",2018-03-10,"Kebler","w1718","Motorized",138,"Sat","weekend","sled","1","1","1",7.4,0,30,0,31,24.7,0,-1,0,0,0,-1,-1,-1
"1396",2018-03-10,"Kebler","w1718","Hybrid",11,"Sat","weekend","sled","1","1","1",7.4,0,30,0,31,24.7,0,-1,0,0,0,-1,-1,-1
"1397",2018-03-11,"Kebler","w1718","Non.motorized",16,"Sun","weekend","no_sled","1","1","1",7.4,0,29,-1,31,25.5,0,0,-1,0,-1,-1,-2,-2
"1398",2018-03-11,"Kebler","w1718","Mechanized",0,"Sun","weekend","no_sled","1","1","1",7.4,0,29,-1,31,25.5,0,0,-1,0,-1,-1,-2,-2
"1399",2018-03-11,"Kebler","w1718","Motorized",170,"Sun","weekend","sled","1","1","1",7.4,0,29,-1,31,25.5,0,0,-1,0,-1,-1,-2,-2
"1400",2018-03-11,"Kebler","w1718","Hybrid",14,"Sun","weekend","sled","1","1","1",7.4,0,29,-1,31,25.5,0,0,-1,0,-1,-1,-2,-2
"1401",2018-03-12,"Kebler","w1718","Non.motorized",2,"Mon","weekday","no_sled","1","1","1",7.4,0,29,0,33,25.5,-1,0,0,-1,-1,-1,-1,-2
"1402",2018-03-12,"Kebler","w1718","Mechanized",0,"Mon","weekday","no_sled","1","1","1",7.4,0,29,0,33,25.5,-1,0,0,-1,-1,-1,-1,-2
"1403",2018-03-12,"Kebler","w1718","Motorized",99,"Mon","weekday","sled","1","1","1",7.4,0,29,0,33,25.5,-1,0,0,-1,-1,-1,-1,-2
"1404",2018-03-12,"Kebler","w1718","Hybrid",0,"Mon","weekday","sled","1","1","1",7.4,0,29,0,33,25.5,-1,0,0,-1,-1,-1,-1,-2
"1405",2018-03-13,"Kebler","w1718","Non.motorized",7,"Tue","weekday","no_sled","1","1","1",7.4,0,29,0,34,25.5,0,-1,0,0,0,-1,-1,-1
"1406",2018-03-13,"Kebler","w1718","Mechanized",2,"Tue","weekday","no_sled","1","1","1",7.4,0,29,0,34,25.5,0,-1,0,0,0,-1,-1,-1
"1407",2018-03-13,"Kebler","w1718","Motorized",163,"Tue","weekday","sled","1","1","1",7.4,0,29,0,34,25.5,0,-1,0,0,0,-1,-1,-1
"1408",2018-03-13,"Kebler","w1718","Hybrid",3,"Tue","weekday","sled","1","1","1",7.4,0,29,0,34,25.5,0,-1,0,0,0,-1,-1,-1
"1409",2018-03-14,"Kebler","w1718","Non.motorized",10,"Wed","weekday","no_sled","1","2","2",7.4,0,29,0,39,25.5,0,0,-1,0,0,0,-1,-1
"1410",2018-03-14,"Kebler","w1718","Mechanized",0,"Wed","weekday","no_sled","1","2","2",7.4,0,29,0,39,25.5,0,0,-1,0,0,0,-1,-1
"1411",2018-03-14,"Kebler","w1718","Motorized",137,"Wed","weekday","sled","1","2","2",7.4,0,29,0,39,25.5,0,0,-1,0,0,0,-1,-1
"1412",2018-03-14,"Kebler","w1718","Hybrid",6,"Wed","weekday","sled","1","2","2",7.4,0,29,0,39,25.5,0,0,-1,0,0,0,-1,-1
"1413",2018-03-15,"Kebler","w1718","Non.motorized",3,"Thu","weekday","no_sled","2","2","2",7.5,0.1,28,-1,31,26.8,0,0,0,-1,-1,-1,-1,-2
"1414",2018-03-15,"Kebler","w1718","Mechanized",0,"Thu","weekday","no_sled","2","2","2",7.5,0.1,28,-1,31,26.8,0,0,0,-1,-1,-1,-1,-2
"1415",2018-03-15,"Kebler","w1718","Motorized",157,"Thu","weekday","sled","2","2","2",7.5,0.1,28,-1,31,26.8,0,0,0,-1,-1,-1,-1,-2
"1416",2018-03-15,"Kebler","w1718","Hybrid",3,"Thu","weekday","sled","2","2","2",7.5,0.1,28,-1,31,26.8,0,0,0,-1,-1,-1,-1,-2
"1417",2018-03-16,"Kebler","w1718","Non.motorized",10,"Fri","weekday","no_sled","2","2","2",7.7,0.2,29,1,25,26.6,-1,0,0,0,0,0,0,0
"1418",2018-03-16,"Kebler","w1718","Mechanized",0,"Fri","weekday","no_sled","2","2","2",7.7,0.2,29,1,25,26.6,-1,0,0,0,0,0,0,0
"1419",2018-03-16,"Kebler","w1718","Motorized",99,"Fri","weekday","sled","2","2","2",7.7,0.2,29,1,25,26.6,-1,0,0,0,0,0,0,0
"1420",2018-03-16,"Kebler","w1718","Hybrid",12,"Fri","weekday","sled","2","2","2",7.7,0.2,29,1,25,26.6,-1,0,0,0,0,0,0,0
"1421",2018-03-17,"Kebler","w1718","Non.motorized",3,"Sat","weekend","no_sled","2","2","2",7.8,0.1,32,3,29,24.4,1,-1,0,0,4,3,3,3
"1422",2018-03-17,"Kebler","w1718","Mechanized",1,"Sat","weekend","no_sled","2","2","2",7.8,0.1,32,3,29,24.4,1,-1,0,0,4,3,3,3
"1423",2018-03-17,"Kebler","w1718","Motorized",130,"Sat","weekend","sled","2","2","2",7.8,0.1,32,3,29,24.4,1,-1,0,0,4,3,3,3
"1424",2018-03-17,"Kebler","w1718","Hybrid",17,"Sat","weekend","sled","2","2","2",7.8,0.1,32,3,29,24.4,1,-1,0,0,4,3,3,3
"1425",2018-03-18,"Kebler","w1718","Non.motorized",4,"Sun","weekend","no_sled","2","2","2",7.9,0.1,31,-1,24,25.5,3,1,-1,0,2,3,2,2
"1426",2018-03-18,"Kebler","w1718","Mechanized",0,"Sun","weekend","no_sled","2","2","2",7.9,0.1,31,-1,24,25.5,3,1,-1,0,2,3,2,2
"1427",2018-03-18,"Kebler","w1718","Motorized",92,"Sun","weekend","sled","2","2","2",7.9,0.1,31,-1,24,25.5,3,1,-1,0,2,3,2,2
"1428",2018-03-18,"Kebler","w1718","Hybrid",14,"Sun","weekend","sled","2","2","2",7.9,0.1,31,-1,24,25.5,3,1,-1,0,2,3,2,2
"1429",2018-03-19,"Kebler","w1718","Non.motorized",2,"Mon","weekday","no_sled","2","2","1",8,0.1,32,1,19,25,-1,3,1,-1,0,3,4,3
"1430",2018-03-19,"Kebler","w1718","Mechanized",0,"Mon","weekday","no_sled","2","2","1",8,0.1,32,1,19,25,-1,3,1,-1,0,3,4,3
"1431",2018-03-19,"Kebler","w1718","Motorized",61,"Mon","weekday","sled","2","2","1",8,0.1,32,1,19,25,-1,3,1,-1,0,3,4,3
"1432",2018-03-19,"Kebler","w1718","Hybrid",7,"Mon","weekday","sled","2","2","1",8,0.1,32,1,19,25,-1,3,1,-1,0,3,4,3
"1433",2018-03-20,"Kebler","w1718","Non.motorized",3,"Tue","weekday","no_sled","2","2","1",8,0,30,-2,24,26.7,1,-1,3,1,-1,-2,1,2
"1434",2018-03-20,"Kebler","w1718","Mechanized",0,"Tue","weekday","no_sled","2","2","1",8,0,30,-2,24,26.7,1,-1,3,1,-1,-2,1,2
"1435",2018-03-20,"Kebler","w1718","Motorized",87,"Tue","weekday","sled","2","2","1",8,0,30,-2,24,26.7,1,-1,3,1,-1,-2,1,2
"1436",2018-03-20,"Kebler","w1718","Hybrid",7,"Tue","weekday","sled","2","2","1",8,0,30,-2,24,26.7,1,-1,3,1,-1,-2,1,2
"1437",2018-03-21,"Kebler","w1718","Non.motorized",0,"Wed","weekday","no_sled","1","1","1",8.1,0.1,32,2,30,25.3,-2,1,-1,3,0,1,0,3
"1438",2018-03-21,"Kebler","w1718","Mechanized",0,"Wed","weekday","no_sled","1","1","1",8.1,0.1,32,2,30,25.3,-2,1,-1,3,0,1,0,3
"1439",2018-03-21,"Kebler","w1718","Motorized",86,"Wed","weekday","sled","1","1","1",8.1,0.1,32,2,30,25.3,-2,1,-1,3,0,1,0,3
"1440",2018-03-21,"Kebler","w1718","Hybrid",7,"Wed","weekday","sled","1","1","1",8.1,0.1,32,2,30,25.3,-2,1,-1,3,0,1,0,3
"1441",2018-03-22,"Kebler","w1718","Non.motorized",3,"Thu","weekday","no_sled","1","1","1",8.1,0,30,-2,36,27,2,-2,1,-1,0,-2,-1,-2
"1442",2018-03-22,"Kebler","w1718","Mechanized",0,"Thu","weekday","no_sled","1","1","1",8.1,0,30,-2,36,27,2,-2,1,-1,0,-2,-1,-2
"1443",2018-03-22,"Kebler","w1718","Motorized",67,"Thu","weekday","sled","1","1","1",8.1,0,30,-2,36,27,2,-2,1,-1,0,-2,-1,-2
"1444",2018-03-22,"Kebler","w1718","Hybrid",4,"Thu","weekday","sled","1","1","1",8.1,0,30,-2,36,27,2,-2,1,-1,0,-2,-1,-2
"1445",2018-03-23,"Kebler","w1718","Non.motorized",1,"Fri","weekday","no_sled","2","2","3",8.2,0.1,29,-1,34,28.3,-2,2,-2,1,-3,-1,-3,-2
"1446",2018-03-23,"Kebler","w1718","Mechanized",0,"Fri","weekday","no_sled","2","2","3",8.2,0.1,29,-1,34,28.3,-2,2,-2,1,-3,-1,-3,-2
"1447",2018-03-23,"Kebler","w1718","Motorized",30,"Fri","weekday","sled","2","2","3",8.2,0.1,29,-1,34,28.3,-2,2,-2,1,-3,-1,-3,-2
"1448",2018-03-23,"Kebler","w1718","Hybrid",1,"Fri","weekday","sled","2","2","3",8.2,0.1,29,-1,34,28.3,-2,2,-2,1,-3,-1,-3,-2
"1449",2018-03-24,"Kebler","w1718","Non.motorized",5,"Sat","weekend","no_sled","2","2","1",8.9,0.7,34,5,32,26.2,-1,-2,2,-2,4,2,4,2
"1450",2018-03-24,"Kebler","w1718","Mechanized",0,"Sat","weekend","no_sled","2","2","1",8.9,0.7,34,5,32,26.2,-1,-2,2,-2,4,2,4,2
"1451",2018-03-24,"Kebler","w1718","Motorized",74,"Sat","weekend","sled","2","2","1",8.9,0.7,34,5,32,26.2,-1,-2,2,-2,4,2,4,2
"1452",2018-03-24,"Kebler","w1718","Hybrid",4,"Sat","weekend","sled","2","2","1",8.9,0.7,34,5,32,26.2,-1,-2,2,-2,4,2,4,2
"1453",2018-03-25,"Kebler","w1718","Non.motorized",5,"Sun","weekend","no_sled","2","2","1",8.9,0,35,1,35,25.4,5,-1,-2,2,6,5,3,5
"1454",2018-03-25,"Kebler","w1718","Mechanized",0,"Sun","weekend","no_sled","2","2","1",8.9,0,35,1,35,25.4,5,-1,-2,2,6,5,3,5
"1455",2018-03-25,"Kebler","w1718","Motorized",90,"Sun","weekend","sled","2","2","1",8.9,0,35,1,35,25.4,5,-1,-2,2,6,5,3,5
"1456",2018-03-25,"Kebler","w1718","Hybrid",11,"Sun","weekend","sled","2","2","1",8.9,0,35,1,35,25.4,5,-1,-2,2,6,5,3,5
"1457",2018-03-26,"Kebler","w1718","Non.motorized",12,"Mon","weekday","no_sled","1","1","1",8.9,0,34,-1,31,26.2,1,5,-1,-2,0,5,4,2
"1458",2018-03-26,"Kebler","w1718","Non.motorized",12,"Mon","weekday","no_sled","2","1","1",8.9,0,34,-1,31,26.2,1,5,-1,-2,0,5,4,2
"1459",2018-03-26,"Kebler","w1718","Mechanized",0,"Mon","weekday","no_sled","1","1","1",8.9,0,34,-1,31,26.2,1,5,-1,-2,0,5,4,2
"1460",2018-03-26,"Kebler","w1718","Mechanized",0,"Mon","weekday","no_sled","2","1","1",8.9,0,34,-1,31,26.2,1,5,-1,-2,0,5,4,2
"1461",2018-03-26,"Kebler","w1718","Motorized",76,"Mon","weekday","sled","1","1","1",8.9,0,34,-1,31,26.2,1,5,-1,-2,0,5,4,2
"1462",2018-03-26,"Kebler","w1718","Motorized",76,"Mon","weekday","sled","2","1","1",8.9,0,34,-1,31,26.2,1,5,-1,-2,0,5,4,2
"1463",2018-03-26,"Kebler","w1718","Hybrid",9,"Mon","weekday","sled","1","1","1",8.9,0,34,-1,31,26.2,1,5,-1,-2,0,5,4,2
"1464",2018-03-26,"Kebler","w1718","Hybrid",9,"Mon","weekday","sled","2","1","1",8.9,0,34,-1,31,26.2,1,5,-1,-2,0,5,4,2
"1465",2018-03-27,"Kebler","w1718","Non.motorized",4,"Tue","weekday","no_sled","1","1","1",8.9,0,33,-1,29,27,-1,1,5,-1,-2,-1,4,3
"1466",2018-03-27,"Kebler","w1718","Mechanized",1,"Tue","weekday","no_sled","1","1","1",8.9,0,33,-1,29,27,-1,1,5,-1,-2,-1,4,3
"1467",2018-03-27,"Kebler","w1718","Motorized",54,"Tue","weekday","sled","1","1","1",8.9,0,33,-1,29,27,-1,1,5,-1,-2,-1,4,3
"1468",2018-03-27,"Kebler","w1718","Hybrid",8,"Tue","weekday","sled","1","1","1",8.9,0,33,-1,29,27,-1,1,5,-1,-2,-1,4,3
"1469",2018-03-28,"Kebler","w1718","Non.motorized",2,"Wed","weekday","no_sled","1","1","1",8.9,0,33,0,27,27,-1,-1,1,5,-1,-2,-1,4
"1470",2018-03-28,"Kebler","w1718","Mechanized",0,"Wed","weekday","no_sled","1","1","1",8.9,0,33,0,27,27,-1,-1,1,5,-1,-2,-1,4
"1471",2018-03-28,"Kebler","w1718","Motorized",58,"Wed","weekday","sled","1","1","1",8.9,0,33,0,27,27,-1,-1,1,5,-1,-2,-1,4
"1472",2018-03-28,"Kebler","w1718","Hybrid",4,"Wed","weekday","sled","1","1","1",8.9,0,33,0,27,27,-1,-1,1,5,-1,-2,-1,4
"1473",2018-03-29,"Kebler","w1718","Non.motorized",1,"Thu","weekday","no_sled","1","1","1",8.9,0,33,0,27,27,0,-1,-1,1,0,-1,-2,-1
"1474",2018-03-29,"Kebler","w1718","Mechanized",4,"Thu","weekday","no_sled","1","1","1",8.9,0,33,0,27,27,0,-1,-1,1,0,-1,-2,-1
"1475",2018-03-29,"Kebler","w1718","Motorized",69,"Thu","weekday","sled","1","1","1",8.9,0,33,0,27,27,0,-1,-1,1,0,-1,-2,-1
"1476",2018-03-29,"Kebler","w1718","Hybrid",10,"Thu","weekday","sled","1","1","1",8.9,0,33,0,27,27,0,-1,-1,1,0,-1,-2,-1
"1477",2018-03-30,"Kebler","w1718","Non.motorized",12,"Fri","weekday","no_sled","1","1","1",8.9,0,32,-1,33,27.8,0,0,-1,-1,-1,-1,-2,-3
"1478",2018-03-30,"Kebler","w1718","Mechanized",0,"Fri","weekday","no_sled","1","1","1",8.9,0,32,-1,33,27.8,0,0,-1,-1,-1,-1,-2,-3
"1479",2018-03-30,"Kebler","w1718","Motorized",83,"Fri","weekday","sled","1","1","1",8.9,0,32,-1,33,27.8,0,0,-1,-1,-1,-1,-2,-3
"1480",2018-03-30,"Kebler","w1718","Hybrid",14,"Fri","weekday","sled","1","1","1",8.9,0,32,-1,33,27.8,0,0,-1,-1,-1,-1,-2,-3
"1481",2018-03-31,"Kebler","w1718","Non.motorized",4,"Sat","weekend","no_sled","1","1","1",8.9,0,32,0,39,27.8,-1,0,0,-1,-1,-1,-1,-2
"1482",2018-03-31,"Kebler","w1718","Mechanized",0,"Sat","weekend","no_sled","1","1","1",8.9,0,32,0,39,27.8,-1,0,0,-1,-1,-1,-1,-2
"1483",2018-03-31,"Kebler","w1718","Motorized",78,"Sat","weekend","sled","1","1","1",8.9,0,32,0,39,27.8,-1,0,0,-1,-1,-1,-1,-2
"1484",2018-03-31,"Kebler","w1718","Hybrid",14,"Sat","weekend","sled","1","1","1",8.9,0,32,0,39,27.8,-1,0,0,-1,-1,-1,-1,-2
"1485",2018-04-01,"Kebler","w1718","Non.motorized",4,"Sun","weekend","no_sled","1","1","1",8.8,-0.1,30,-2,41,29.3,0,-1,0,0,-2,-3,-3,-3
"1486",2018-04-01,"Kebler","w1718","Mechanized",0,"Sun","weekend","no_sled","1","1","1",8.8,-0.1,30,-2,41,29.3,0,-1,0,0,-2,-3,-3,-3
"1487",2018-04-01,"Kebler","w1718","Motorized",37,"Sun","weekend","sled","1","1","1",8.8,-0.1,30,-2,41,29.3,0,-1,0,0,-2,-3,-3,-3
"1488",2018-04-01,"Kebler","w1718","Hybrid",4,"Sun","weekend","sled","1","1","1",8.8,-0.1,30,-2,41,29.3,0,-1,0,0,-2,-3,-3,-3
"1489",2018-04-02,"Kebler","w1718","Non.motorized",2,"Mon","weekday","no_sled","1","1","1",8.7,-0.1,29,-1,39,30,-2,0,-1,0,-3,-3,-4,-4
"1490",2018-04-02,"Kebler","w1718","Mechanized",0,"Mon","weekday","no_sled","1","1","1",8.7,-0.1,29,-1,39,30,-2,0,-1,0,-3,-3,-4,-4
"1491",2018-04-02,"Kebler","w1718","Motorized",47,"Mon","weekday","sled","1","1","1",8.7,-0.1,29,-1,39,30,-2,0,-1,0,-3,-3,-4,-4
"1492",2018-04-02,"Kebler","w1718","Hybrid",7,"Mon","weekday","sled","1","1","1",8.7,-0.1,29,-1,39,30,-2,0,-1,0,-3,-3,-4,-4
"1493",2018-04-03,"Kebler","w1718","Non.motorized",0,"Tue","weekday","no_sled","1","1","1",8.8,0.1,30,1,27,29.3,-1,-2,0,-1,0,-2,-2,-3
"1494",2018-04-03,"Kebler","w1718","Mechanized",0,"Tue","weekday","no_sled","1","1","1",8.8,0.1,30,1,27,29.3,-1,-2,0,-1,0,-2,-2,-3
"1495",2018-04-03,"Kebler","w1718","Motorized",54,"Tue","weekday","sled","1","1","1",8.8,0.1,30,1,27,29.3,-1,-2,0,-1,0,-2,-2,-3
"1496",2018-04-03,"Kebler","w1718","Hybrid",4,"Tue","weekday","sled","1","1","1",8.8,0.1,30,1,27,29.3,-1,-2,0,-1,0,-2,-2,-3
"1497",2018-04-04,"Kebler","w1718","Non.motorized",6,"Wed","weekday","no_sled","1","2","2",8.9,0.1,28,-2,33,31.8,1,-1,-2,0,-1,-2,-4,-4
"1498",2018-04-04,"Kebler","w1718","Mechanized",0,"Wed","weekday","no_sled","1","2","2",8.9,0.1,28,-2,33,31.8,1,-1,-2,0,-1,-2,-4,-4
"1499",2018-04-04,"Kebler","w1718","Motorized",65,"Wed","weekday","sled","1","2","2",8.9,0.1,28,-2,33,31.8,1,-1,-2,0,-1,-2,-4,-4
"1500",2018-04-04,"Kebler","w1718","Hybrid",5,"Wed","weekday","sled","1","2","2",8.9,0.1,28,-2,33,31.8,1,-1,-2,0,-1,-2,-4,-4
"1501",2018-04-05,"Kebler","w1718","Non.motorized",3,"Thu","weekday","no_sled","1","2","2",8.9,0,27,-1,35,33,-2,1,-1,-2,-3,-2,-3,-5
"1502",2018-04-05,"Kebler","w1718","Mechanized",1,"Thu","weekday","no_sled","1","2","2",8.9,0,27,-1,35,33,-2,1,-1,-2,-3,-2,-3,-5
"1503",2018-04-05,"Kebler","w1718","Motorized",57,"Thu","weekday","sled","1","2","2",8.9,0,27,-1,35,33,-2,1,-1,-2,-3,-2,-3,-5
"1504",2018-04-05,"Kebler","w1718","Hybrid",4,"Thu","weekday","sled","1","2","2",8.9,0,27,-1,35,33,-2,1,-1,-2,-3,-2,-3,-5
"1505",2018-04-06,"Kebler","w1718","Non.motorized",0,"Fri","weekday","no_sled","1","2","2",8.9,0,25,-2,35,35.6,-1,-2,1,-1,-3,-5,-4,-5
"1506",2018-04-06,"Kebler","w1718","Mechanized",0,"Fri","weekday","no_sled","1","2","2",8.9,0,25,-2,35,35.6,-1,-2,1,-1,-3,-5,-4,-5
"1507",2018-04-06,"Kebler","w1718","Motorized",86,"Fri","weekday","sled","1","2","2",8.9,0,25,-2,35,35.6,-1,-2,1,-1,-3,-5,-4,-5
"1508",2018-04-06,"Kebler","w1718","Hybrid",3,"Fri","weekday","sled","1","2","2",8.9,0,25,-2,35,35.6,-1,-2,1,-1,-3,-5,-4,-5
"1509",2018-04-07,"Kebler","w1718","Non.motorized",0,"Sat","weekend","no_sled","2","2","2",9.2,0.3,31,6,37,29.7,-2,-1,-2,1,4,3,1,2
"1510",2018-04-07,"Kebler","w1718","Mechanized",0,"Sat","weekend","no_sled","2","2","2",9.2,0.3,31,6,37,29.7,-2,-1,-2,1,4,3,1,2
"1511",2018-04-07,"Kebler","w1718","Motorized",50,"Sat","weekend","sled","2","2","2",9.2,0.3,31,6,37,29.7,-2,-1,-2,1,4,3,1,2
"1512",2018-04-07,"Kebler","w1718","Hybrid",8,"Sat","weekend","sled","2","2","2",9.2,0.3,31,6,37,29.7,-2,-1,-2,1,4,3,1,2
"1513",2018-04-08,"Kebler","w1718","Non.motorized",0,"Sun","weekend","no_sled","3","3","3",10,0.8,33,2,33,30.3,6,-2,-1,-2,8,6,5,3
"1514",2018-04-08,"Kebler","w1718","Mechanized",1,"Sun","weekend","no_sled","3","3","3",10,0.8,33,2,33,30.3,6,-2,-1,-2,8,6,5,3
"1515",2018-04-08,"Kebler","w1718","Motorized",40,"Sun","weekend","sled","3","3","3",10,0.8,33,2,33,30.3,6,-2,-1,-2,8,6,5,3
"1516",2018-04-08,"Kebler","w1718","Hybrid",0,"Sun","weekend","sled","3","3","3",10,0.8,33,2,33,30.3,6,-2,-1,-2,8,6,5,3
"1517",2018-04-09,"Kebler","w1718","Non.motorized",0,"Mon","weekday","no_sled","1","1","1",10.1,0.1,33,0,31,30.6,2,6,-2,-1,2,8,6,5
"1518",2018-04-09,"Kebler","w1718","Mechanized",0,"Mon","weekday","no_sled","1","1","1",10.1,0.1,33,0,31,30.6,2,6,-2,-1,2,8,6,5
"1519",2018-04-09,"Kebler","w1718","Motorized",11,"Mon","weekday","sled","1","1","1",10.1,0.1,33,0,31,30.6,2,6,-2,-1,2,8,6,5
"1520",2018-04-09,"Kebler","w1718","Hybrid",3,"Mon","weekday","sled","1","1","1",10.1,0.1,33,0,31,30.6,2,6,-2,-1,2,8,6,5
"1521",2017-12-22,"Slate River Rd","w1718","Non.motorized",14,"Fri","weekday","no_sled","2","2","1",2,0,11,3,17,18.2,0,0,0,0,3,3,3,3
"1522",2017-12-22,"Slate River Rd","w1718","Mechanized",1,"Fri","weekday","no_sled","2","2","1",2,0,11,3,17,18.2,0,0,0,0,3,3,3,3
"1523",2017-12-22,"Slate River Rd","w1718","Motorized",0,"Fri","weekday","sled","2","2","1",2,0,11,3,17,18.2,0,0,0,0,3,3,3,3
"1524",2017-12-22,"Slate River Rd","w1718","Hybrid",0,"Fri","weekday","sled","2","2","1",2,0,11,3,17,18.2,0,0,0,0,3,3,3,3
"1525",2017-12-23,"Slate River Rd","w1718","Non.motorized",5,"Sat","weekend","no_sled","2","1","1",2.1,0.1,10,-1,21,21,3,0,0,0,2,2,2,2
"1526",2017-12-23,"Slate River Rd","w1718","Mechanized",2,"Sat","weekend","no_sled","2","1","1",2.1,0.1,10,-1,21,21,3,0,0,0,2,2,2,2
"1527",2017-12-23,"Slate River Rd","w1718","Motorized",4,"Sat","weekend","sled","2","1","1",2.1,0.1,10,-1,21,21,3,0,0,0,2,2,2,2
"1528",2017-12-23,"Slate River Rd","w1718","Hybrid",0,"Sat","weekend","sled","2","1","1",2.1,0.1,10,-1,21,21,3,0,0,0,2,2,2,2
"1529",2017-12-24,"Slate River Rd","w1718","Non.motorized",7,"Sun","weekend","no_sled","1","1","1",2.4,0.3,14,4,19,17.1,-1,3,0,0,3,6,6,6
"1530",2017-12-24,"Slate River Rd","w1718","Mechanized",2,"Sun","weekend","no_sled","1","1","1",2.4,0.3,14,4,19,17.1,-1,3,0,0,3,6,6,6
"1531",2017-12-24,"Slate River Rd","w1718","Motorized",5,"Sun","weekend","sled","1","1","1",2.4,0.3,14,4,19,17.1,-1,3,0,0,3,6,6,6
"1532",2017-12-24,"Slate River Rd","w1718","Hybrid",2,"Sun","weekend","sled","1","1","1",2.4,0.3,14,4,19,17.1,-1,3,0,0,3,6,6,6
"1533",2017-12-25,"Slate River Rd","w1718","Non.motorized",18,"Mon","weekday","no_sled","2","1","1",2.6,0.2,14,0,25,18.6,4,-1,3,0,4,3,6,6
"1534",2017-12-25,"Slate River Rd","w1718","Mechanized",3,"Mon","weekday","no_sled","2","1","1",2.6,0.2,14,0,25,18.6,4,-1,3,0,4,3,6,6
"1535",2017-12-25,"Slate River Rd","w1718","Motorized",5,"Mon","weekday","sled","2","1","1",2.6,0.2,14,0,25,18.6,4,-1,3,0,4,3,6,6
"1536",2017-12-25,"Slate River Rd","w1718","Hybrid",3,"Mon","weekday","sled","2","1","1",2.6,0.2,14,0,25,18.6,4,-1,3,0,4,3,6,6
"1537",2017-12-26,"Slate River Rd","w1718","Non.motorized",30,"Tue","weekday","no_sled","1","1","1",3.1,0.5,20,6,25,15.5,0,4,-1,3,6,10,9,12
"1538",2017-12-26,"Slate River Rd","w1718","Mechanized",4,"Tue","weekday","no_sled","1","1","1",3.1,0.5,20,6,25,15.5,0,4,-1,3,6,10,9,12
"1539",2017-12-26,"Slate River Rd","w1718","Motorized",6,"Tue","weekday","sled","1","1","1",3.1,0.5,20,6,25,15.5,0,4,-1,3,6,10,9,12
"1540",2017-12-26,"Slate River Rd","w1718","Hybrid",5,"Tue","weekday","sled","1","1","1",3.1,0.5,20,6,25,15.5,0,4,-1,3,6,10,9,12
"1541",2017-12-27,"Slate River Rd","w1718","Non.motorized",71,"Wed","weekday","no_sled","1","1","1",3.1,0,18,-2,27,17.2,6,0,4,-1,4,4,8,7
"1542",2017-12-27,"Slate River Rd","w1718","Mechanized",0,"Wed","weekday","no_sled","1","1","1",3.1,0,18,-2,27,17.2,6,0,4,-1,4,4,8,7
"1543",2017-12-27,"Slate River Rd","w1718","Motorized",92,"Wed","weekday","sled","1","1","1",3.1,0,18,-2,27,17.2,6,0,4,-1,4,4,8,7
"1544",2017-12-27,"Slate River Rd","w1718","Hybrid",88,"Wed","weekday","sled","1","1","1",3.1,0,18,-2,27,17.2,6,0,4,-1,4,4,8,7
"1545",2017-12-28,"Slate River Rd","w1718","Non.motorized",66,"Thu","weekday","no_sled","1","1","1",3.2,0.1,17,-1,31,18.8,-2,6,0,4,-3,3,3,7
"1546",2017-12-28,"Slate River Rd","w1718","Mechanized",4,"Thu","weekday","no_sled","1","1","1",3.2,0.1,17,-1,31,18.8,-2,6,0,4,-3,3,3,7
"1547",2017-12-28,"Slate River Rd","w1718","Motorized",4,"Thu","weekday","sled","1","1","1",3.2,0.1,17,-1,31,18.8,-2,6,0,4,-3,3,3,7
"1548",2017-12-28,"Slate River Rd","w1718","Hybrid",1,"Thu","weekday","sled","1","1","1",3.2,0.1,17,-1,31,18.8,-2,6,0,4,-3,3,3,7
"1549",2017-12-29,"Slate River Rd","w1718","Non.motorized",50,"Fri","weekday","no_sled","1","1","1",3.2,0,17,0,36,18.8,-1,-2,6,0,-1,-3,3,3
"1550",2017-12-29,"Slate River Rd","w1718","Mechanized",0,"Fri","weekday","no_sled","1","1","1",3.2,0,17,0,36,18.8,-1,-2,6,0,-1,-3,3,3
"1551",2017-12-29,"Slate River Rd","w1718","Motorized",3,"Fri","weekday","sled","1","1","1",3.2,0,17,0,36,18.8,-1,-2,6,0,-1,-3,3,3
"1552",2017-12-29,"Slate River Rd","w1718","Hybrid",2,"Fri","weekday","sled","1","1","1",3.2,0,17,0,36,18.8,-1,-2,6,0,-1,-3,3,3
"1553",2017-12-30,"Slate River Rd","w1718","Non.motorized",65,"Sat","weekend","no_sled","1","1","1",3.2,0,15,-2,37,21.3,0,-1,-2,6,-2,-3,-5,1
"1554",2017-12-30,"Slate River Rd","w1718","Mechanized",8,"Sat","weekend","no_sled","1","1","1",3.2,0,15,-2,37,21.3,0,-1,-2,6,-2,-3,-5,1
"1555",2017-12-30,"Slate River Rd","w1718","Motorized",13,"Sat","weekend","sled","1","1","1",3.2,0,15,-2,37,21.3,0,-1,-2,6,-2,-3,-5,1
"1556",2017-12-30,"Slate River Rd","w1718","Hybrid",9,"Sat","weekend","sled","1","1","1",3.2,0,15,-2,37,21.3,0,-1,-2,6,-2,-3,-5,1
"1557",2017-12-31,"Slate River Rd","w1718","Non.motorized",78,"Sun","weekend","no_sled","1","1","1",3.2,0,15,0,31,21.3,-2,0,-1,-2,-2,-2,-3,-5
"1558",2017-12-31,"Slate River Rd","w1718","Mechanized",2,"Sun","weekend","no_sled","1","1","1",3.2,0,15,0,31,21.3,-2,0,-1,-2,-2,-2,-3,-5
"1559",2017-12-31,"Slate River Rd","w1718","Motorized",20,"Sun","weekend","sled","1","1","1",3.2,0,15,0,31,21.3,-2,0,-1,-2,-2,-2,-3,-5
"1560",2017-12-31,"Slate River Rd","w1718","Hybrid",4,"Sun","weekend","sled","1","1","1",3.2,0,15,0,31,21.3,-2,0,-1,-2,-2,-2,-3,-5
"1561",2018-01-01,"Slate River Rd","w1718","Non.motorized",63,"Mon","weekday","no_sled","1","1","1",3.2,0,15,0,27,21.3,0,-2,0,-1,0,-2,-2,-3
"1562",2018-01-01,"Slate River Rd","w1718","Mechanized",7,"Mon","weekday","no_sled","1","1","1",3.2,0,15,0,27,21.3,0,-2,0,-1,0,-2,-2,-3
"1563",2018-01-01,"Slate River Rd","w1718","Motorized",26,"Mon","weekday","sled","1","1","1",3.2,0,15,0,27,21.3,0,-2,0,-1,0,-2,-2,-3
"1564",2018-01-01,"Slate River Rd","w1718","Hybrid",14,"Mon","weekday","sled","1","1","1",3.2,0,15,0,27,21.3,0,-2,0,-1,0,-2,-2,-3
"1565",2018-01-02,"Slate River Rd","w1718","Non.motorized",29,"Tue","weekday","no_sled","1","1","1",3.2,0,15,0,22,21.3,0,0,-2,0,0,0,-2,-2
"1566",2018-01-02,"Slate River Rd","w1718","Mechanized",3,"Tue","weekday","no_sled","1","1","1",3.2,0,15,0,22,21.3,0,0,-2,0,0,0,-2,-2
"1567",2018-01-02,"Slate River Rd","w1718","Motorized",17,"Tue","weekday","sled","1","1","1",3.2,0,15,0,22,21.3,0,0,-2,0,0,0,-2,-2
"1568",2018-01-02,"Slate River Rd","w1718","Hybrid",11,"Tue","weekday","sled","1","1","1",3.2,0,15,0,22,21.3,0,0,-2,0,0,0,-2,-2
"1569",2018-01-03,"Slate River Rd","w1718","Non.motorized",26,"Wed","weekday","no_sled","1","1","1",3.2,0,15,0,27,21.3,0,0,0,-2,0,0,0,-2
"1570",2018-01-03,"Slate River Rd","w1718","Mechanized",4,"Wed","weekday","no_sled","1","1","1",3.2,0,15,0,27,21.3,0,0,0,-2,0,0,0,-2
"1571",2018-01-03,"Slate River Rd","w1718","Motorized",14,"Wed","weekday","sled","1","1","1",3.2,0,15,0,27,21.3,0,0,0,-2,0,0,0,-2
"1572",2018-01-03,"Slate River Rd","w1718","Hybrid",4,"Wed","weekday","sled","1","1","1",3.2,0,15,0,27,21.3,0,0,0,-2,0,0,0,-2
"1573",2018-01-04,"Slate River Rd","w1718","Non.motorized",19,"Thu","weekday","no_sled","1","1","1",3.2,0,15,0,29,21.3,0,0,0,0,0,0,0,0
"1574",2018-01-04,"Slate River Rd","w1718","Mechanized",5,"Thu","weekday","no_sled","1","1","1",3.2,0,15,0,29,21.3,0,0,0,0,0,0,0,0
"1575",2018-01-04,"Slate River Rd","w1718","Motorized",17,"Thu","weekday","sled","1","1","1",3.2,0,15,0,29,21.3,0,0,0,0,0,0,0,0
"1576",2018-01-04,"Slate River Rd","w1718","Hybrid",4,"Thu","weekday","sled","1","1","1",3.2,0,15,0,29,21.3,0,0,0,0,0,0,0,0
"1577",2018-01-05,"Slate River Rd","w1718","Non.motorized",25,"Fri","weekday","no_sled","1","1","1",3.2,0,14,-1,32,22.9,0,0,0,0,-1,-1,-1,-1
"1578",2018-01-05,"Slate River Rd","w1718","Mechanized",3,"Fri","weekday","no_sled","1","1","1",3.2,0,14,-1,32,22.9,0,0,0,0,-1,-1,-1,-1
"1579",2018-01-05,"Slate River Rd","w1718","Motorized",18,"Fri","weekday","sled","1","1","1",3.2,0,14,-1,32,22.9,0,0,0,0,-1,-1,-1,-1
"1580",2018-01-05,"Slate River Rd","w1718","Hybrid",2,"Fri","weekday","sled","1","1","1",3.2,0,14,-1,32,22.9,0,0,0,0,-1,-1,-1,-1
"1581",2018-01-06,"Slate River Rd","w1718","Non.motorized",20,"Sat","weekend","no_sled","1","1","1",3.2,0,14,0,30,22.9,-1,0,0,0,-1,-1,-1,-1
"1582",2018-01-06,"Slate River Rd","w1718","Mechanized",6,"Sat","weekend","no_sled","1","1","1",3.2,0,14,0,30,22.9,-1,0,0,0,-1,-1,-1,-1
"1583",2018-01-06,"Slate River Rd","w1718","Motorized",24,"Sat","weekend","sled","1","1","1",3.2,0,14,0,30,22.9,-1,0,0,0,-1,-1,-1,-1
"1584",2018-01-06,"Slate River Rd","w1718","Hybrid",6,"Sat","weekend","sled","1","1","1",3.2,0,14,0,30,22.9,-1,0,0,0,-1,-1,-1,-1
"1585",2018-01-07,"Slate River Rd","w1718","Non.motorized",NA,"Sun","weekend","no_sled","2","2","2",3.5,0.3,18,4,25,19.4,0,-1,0,0,4,3,3,3
"1586",2018-01-07,"Slate River Rd","w1718","Mechanized",NA,"Sun","weekend","no_sled","2","2","2",3.5,0.3,18,4,25,19.4,0,-1,0,0,4,3,3,3
"1587",2018-01-07,"Slate River Rd","w1718","Motorized",NA,"Sun","weekend","sled","2","2","2",3.5,0.3,18,4,25,19.4,0,-1,0,0,4,3,3,3
"1588",2018-01-07,"Slate River Rd","w1718","Hybrid",NA,"Sun","weekend","sled","2","2","2",3.5,0.3,18,4,25,19.4,0,-1,0,0,4,3,3,3
"1589",2018-01-08,"Slate River Rd","w1718","Non.motorized",NA,"Mon","weekday","no_sled","2","2","1",3.7,0.2,20,2,29,18.5,4,0,-1,0,6,6,5,5
"1590",2018-01-08,"Slate River Rd","w1718","Mechanized",NA,"Mon","weekday","no_sled","2","2","1",3.7,0.2,20,2,29,18.5,4,0,-1,0,6,6,5,5
"1591",2018-01-08,"Slate River Rd","w1718","Motorized",NA,"Mon","weekday","sled","2","2","1",3.7,0.2,20,2,29,18.5,4,0,-1,0,6,6,5,5
"1592",2018-01-08,"Slate River Rd","w1718","Hybrid",NA,"Mon","weekday","sled","2","2","1",3.7,0.2,20,2,29,18.5,4,0,-1,0,6,6,5,5
"1593",2018-01-09,"Slate River Rd","w1718","Non.motorized",NA,"Tue","weekday","no_sled","2","2","1",3.8,0.1,21,1,34,18.1,2,4,0,-1,3,7,7,6
"1594",2018-01-09,"Slate River Rd","w1718","Mechanized",NA,"Tue","weekday","no_sled","2","2","1",3.8,0.1,21,1,34,18.1,2,4,0,-1,3,7,7,6
"1595",2018-01-09,"Slate River Rd","w1718","Motorized",NA,"Tue","weekday","sled","2","2","1",3.8,0.1,21,1,34,18.1,2,4,0,-1,3,7,7,6
"1596",2018-01-09,"Slate River Rd","w1718","Hybrid",NA,"Tue","weekday","sled","2","2","1",3.8,0.1,21,1,34,18.1,2,4,0,-1,3,7,7,6
"1597",2018-01-10,"Slate River Rd","w1718","Non.motorized",NA,"Wed","weekday","no_sled","3","3","3",4,0.2,21,0,28,19,1,2,4,0,1,3,7,7
"1598",2018-01-10,"Slate River Rd","w1718","Mechanized",NA,"Wed","weekday","no_sled","3","3","3",4,0.2,21,0,28,19,1,2,4,0,1,3,7,7
"1599",2018-01-10,"Slate River Rd","w1718","Motorized",NA,"Wed","weekday","sled","3","3","3",4,0.2,21,0,28,19,1,2,4,0,1,3,7,7
"1600",2018-01-10,"Slate River Rd","w1718","Hybrid",NA,"Wed","weekday","sled","3","3","3",4,0.2,21,0,28,19,1,2,4,0,1,3,7,7
"1601",2018-01-11,"Slate River Rd","w1718","Non.motorized",3,"Thu","weekday","no_sled","3","3","3",4.1,0.1,26,5,17,15.8,0,1,2,4,5,6,8,12
"1602",2018-01-11,"Slate River Rd","w1718","Mechanized",0,"Thu","weekday","no_sled","3","3","3",4.1,0.1,26,5,17,15.8,0,1,2,4,5,6,8,12
"1603",2018-01-11,"Slate River Rd","w1718","Motorized",2,"Thu","weekday","sled","3","3","3",4.1,0.1,26,5,17,15.8,0,1,2,4,5,6,8,12
"1604",2018-01-11,"Slate River Rd","w1718","Hybrid",1,"Thu","weekday","sled","3","3","3",4.1,0.1,26,5,17,15.8,0,1,2,4,5,6,8,12
"1605",2018-01-12,"Slate River Rd","w1718","Non.motorized",3,"Fri","weekday","no_sled","3","3","3",4.3,0.2,24,-2,22,17.9,5,0,1,2,3,3,4,6
"1606",2018-01-12,"Slate River Rd","w1718","Mechanized",0,"Fri","weekday","no_sled","3","3","3",4.3,0.2,24,-2,22,17.9,5,0,1,2,3,3,4,6
"1607",2018-01-12,"Slate River Rd","w1718","Motorized",4,"Fri","weekday","sled","3","3","3",4.3,0.2,24,-2,22,17.9,5,0,1,2,3,3,4,6
"1608",2018-01-12,"Slate River Rd","w1718","Hybrid",3,"Fri","weekday","sled","3","3","3",4.3,0.2,24,-2,22,17.9,5,0,1,2,3,3,4,6
"1609",2018-01-13,"Slate River Rd","w1718","Non.motorized",34,"Sat","weekend","no_sled","3","3","3",4.4,0.1,24,0,24,18.3,-2,5,0,1,-2,3,3,4
"1610",2018-01-13,"Slate River Rd","w1718","Mechanized",2,"Sat","weekend","no_sled","3","3","3",4.4,0.1,24,0,24,18.3,-2,5,0,1,-2,3,3,4
"1611",2018-01-13,"Slate River Rd","w1718","Motorized",18,"Sat","weekend","sled","3","3","3",4.4,0.1,24,0,24,18.3,-2,5,0,1,-2,3,3,4
"1612",2018-01-13,"Slate River Rd","w1718","Hybrid",15,"Sat","weekend","sled","3","3","3",4.4,0.1,24,0,24,18.3,-2,5,0,1,-2,3,3,4
"1613",2018-01-14,"Slate River Rd","w1718","Non.motorized",39,"Sun","weekend","no_sled","3","3","2",4.4,0,24,0,27,18.3,0,-2,5,0,0,-2,3,3
"1614",2018-01-14,"Slate River Rd","w1718","Mechanized",0,"Sun","weekend","no_sled","3","3","2",4.4,0,24,0,27,18.3,0,-2,5,0,0,-2,3,3
"1615",2018-01-14,"Slate River Rd","w1718","Motorized",18,"Sun","weekend","sled","3","3","2",4.4,0,24,0,27,18.3,0,-2,5,0,0,-2,3,3
"1616",2018-01-14,"Slate River Rd","w1718","Hybrid",13,"Sun","weekend","sled","3","3","2",4.4,0,24,0,27,18.3,0,-2,5,0,0,-2,3,3
"1617",2018-01-15,"Slate River Rd","w1718","Non.motorized",12,"Mon","weekday","no_sled","3","3","2",4.4,0,23,-1,27,19.1,0,0,-2,5,-1,-1,-3,2
"1618",2018-01-15,"Slate River Rd","w1718","Mechanized",0,"Mon","weekday","no_sled","3","3","2",4.4,0,23,-1,27,19.1,0,0,-2,5,-1,-1,-3,2
"1619",2018-01-15,"Slate River Rd","w1718","Motorized",8,"Mon","weekday","sled","3","3","2",4.4,0,23,-1,27,19.1,0,0,-2,5,-1,-1,-3,2
"1620",2018-01-15,"Slate River Rd","w1718","Hybrid",7,"Mon","weekday","sled","3","3","2",4.4,0,23,-1,27,19.1,0,0,-2,5,-1,-1,-3,2
"1621",2018-01-16,"Slate River Rd","w1718","Non.motorized",11,"Tue","weekday","no_sled","3","3","2",4.4,0,22,-1,20,20,-1,0,0,-2,-2,-2,-2,-4
"1622",2018-01-16,"Slate River Rd","w1718","Mechanized",0,"Tue","weekday","no_sled","3","3","2",4.4,0,22,-1,20,20,-1,0,0,-2,-2,-2,-2,-4
"1623",2018-01-16,"Slate River Rd","w1718","Motorized",10,"Tue","weekday","sled","3","3","2",4.4,0,22,-1,20,20,-1,0,0,-2,-2,-2,-2,-4
"1624",2018-01-16,"Slate River Rd","w1718","Hybrid",9,"Tue","weekday","sled","3","3","2",4.4,0,22,-1,20,20,-1,0,0,-2,-2,-2,-2,-4
"1625",2018-01-17,"Slate River Rd","w1718","Non.motorized",10,"Wed","weekday","no_sled","2","2","2",4.4,0,22,0,24,20,-1,-1,0,0,-1,-2,-2,-2
"1626",2018-01-17,"Slate River Rd","w1718","Mechanized",0,"Wed","weekday","no_sled","2","2","2",4.4,0,22,0,24,20,-1,-1,0,0,-1,-2,-2,-2
"1627",2018-01-17,"Slate River Rd","w1718","Motorized",0,"Wed","weekday","sled","2","2","2",4.4,0,22,0,24,20,-1,-1,0,0,-1,-2,-2,-2
"1628",2018-01-17,"Slate River Rd","w1718","Hybrid",0,"Wed","weekday","sled","2","2","2",4.4,0,22,0,24,20,-1,-1,0,0,-1,-2,-2,-2
"1629",2018-01-18,"Slate River Rd","w1718","Non.motorized",13,"Thu","weekday","no_sled","2","2","2",4.4,0,21,-1,29,21,0,-1,-1,0,-1,-2,-3,-3
"1630",2018-01-18,"Slate River Rd","w1718","Mechanized",0,"Thu","weekday","no_sled","2","2","2",4.4,0,21,-1,29,21,0,-1,-1,0,-1,-2,-3,-3
"1631",2018-01-18,"Slate River Rd","w1718","Motorized",2,"Thu","weekday","sled","2","2","2",4.4,0,21,-1,29,21,0,-1,-1,0,-1,-2,-3,-3
"1632",2018-01-18,"Slate River Rd","w1718","Hybrid",2,"Thu","weekday","sled","2","2","2",4.4,0,21,-1,29,21,0,-1,-1,0,-1,-2,-3,-3
"1633",2018-01-19,"Slate River Rd","w1718","Non.motorized",30,"Fri","weekday","no_sled","2","2","2",4.5,0.1,21,0,34,21.4,-1,0,-1,-1,-1,-1,-2,-3
"1634",2018-01-19,"Slate River Rd","w1718","Mechanized",0,"Fri","weekday","no_sled","2","2","2",4.5,0.1,21,0,34,21.4,-1,0,-1,-1,-1,-1,-2,-3
"1635",2018-01-19,"Slate River Rd","w1718","Motorized",2,"Fri","weekday","sled","2","2","2",4.5,0.1,21,0,34,21.4,-1,0,-1,-1,-1,-1,-2,-3
"1636",2018-01-19,"Slate River Rd","w1718","Hybrid",2,"Fri","weekday","sled","2","2","2",4.5,0.1,21,0,34,21.4,-1,0,-1,-1,-1,-1,-2,-3
"1637",2018-01-20,"Slate River Rd","w1718","Non.motorized",34,"Sat","weekend","no_sled","2","2","2",4.5,0,21,0,32,21.4,0,-1,0,-1,0,-1,-1,-2
"1638",2018-01-20,"Slate River Rd","w1718","Mechanized",0,"Sat","weekend","no_sled","2","2","2",4.5,0,21,0,32,21.4,0,-1,0,-1,0,-1,-1,-2
"1639",2018-01-20,"Slate River Rd","w1718","Motorized",17,"Sat","weekend","sled","2","2","2",4.5,0,21,0,32,21.4,0,-1,0,-1,0,-1,-1,-2
"1640",2018-01-20,"Slate River Rd","w1718","Hybrid",17,"Sat","weekend","sled","2","2","2",4.5,0,21,0,32,21.4,0,-1,0,-1,0,-1,-1,-2
"1641",2018-01-21,"Slate River Rd","w1718","Non.motorized",5,"Sun","weekend","no_sled","3","3","3",4.6,0.1,23,2,15,20,0,0,-1,0,2,2,1,1
"1642",2018-01-21,"Slate River Rd","w1718","Mechanized",0,"Sun","weekend","no_sled","3","3","3",4.6,0.1,23,2,15,20,0,0,-1,0,2,2,1,1
"1643",2018-01-21,"Slate River Rd","w1718","Motorized",0,"Sun","weekend","sled","3","3","3",4.6,0.1,23,2,15,20,0,0,-1,0,2,2,1,1
"1644",2018-01-21,"Slate River Rd","w1718","Hybrid",0,"Sun","weekend","sled","3","3","3",4.6,0.1,23,2,15,20,0,0,-1,0,2,2,1,1
"1645",2018-01-22,"Slate River Rd","w1718","Non.motorized",19,"Mon","weekday","no_sled","3","3","3",4.6,0,21,-2,12,21.9,2,0,0,-1,0,0,0,-1
"1646",2018-01-22,"Slate River Rd","w1718","Mechanized",0,"Mon","weekday","no_sled","3","3","3",4.6,0,21,-2,12,21.9,2,0,0,-1,0,0,0,-1
"1647",2018-01-22,"Slate River Rd","w1718","Motorized",6,"Mon","weekday","sled","3","3","3",4.6,0,21,-2,12,21.9,2,0,0,-1,0,0,0,-1
"1648",2018-01-22,"Slate River Rd","w1718","Hybrid",6,"Mon","weekday","sled","3","3","3",4.6,0,21,-2,12,21.9,2,0,0,-1,0,0,0,-1
"1649",2018-01-23,"Slate River Rd","w1718","Non.motorized",9,"Tue","weekday","no_sled","3","3","3",4.6,0,22,1,16,20.9,-2,2,0,0,-1,1,1,1
"1650",2018-01-23,"Slate River Rd","w1718","Mechanized",0,"Tue","weekday","no_sled","3","3","3",4.6,0,22,1,16,20.9,-2,2,0,0,-1,1,1,1
"1651",2018-01-23,"Slate River Rd","w1718","Motorized",7,"Tue","weekday","sled","3","3","3",4.6,0,22,1,16,20.9,-2,2,0,0,-1,1,1,1
"1652",2018-01-23,"Slate River Rd","w1718","Hybrid",7,"Tue","weekday","sled","3","3","3",4.6,0,22,1,16,20.9,-2,2,0,0,-1,1,1,1
"1653",2018-01-24,"Slate River Rd","w1718","Non.motorized",12,"Wed","weekday","no_sled","2","2","2",4.6,0,22,0,22,20.9,1,-2,2,0,1,-1,1,1
"1654",2018-01-24,"Slate River Rd","w1718","Mechanized",0,"Wed","weekday","no_sled","2","2","2",4.6,0,22,0,22,20.9,1,-2,2,0,1,-1,1,1
"1655",2018-01-24,"Slate River Rd","w1718","Motorized",0,"Wed","weekday","sled","2","2","2",4.6,0,22,0,22,20.9,1,-2,2,0,1,-1,1,1
"1656",2018-01-24,"Slate River Rd","w1718","Hybrid",0,"Wed","weekday","sled","2","2","2",4.6,0,22,0,22,20.9,1,-2,2,0,1,-1,1,1
"1657",2018-01-25,"Slate River Rd","w1718","Non.motorized",21,"Thu","weekday","no_sled","2","2","2",4.6,0,22,0,28,20.9,0,1,-2,2,0,1,-1,1
"1658",2018-01-25,"Slate River Rd","w1718","Mechanized",0,"Thu","weekday","no_sled","2","2","2",4.6,0,22,0,28,20.9,0,1,-2,2,0,1,-1,1
"1659",2018-01-25,"Slate River Rd","w1718","Motorized",9,"Thu","weekday","sled","2","2","2",4.6,0,22,0,28,20.9,0,1,-2,2,0,1,-1,1
"1660",2018-01-25,"Slate River Rd","w1718","Hybrid",9,"Thu","weekday","sled","2","2","2",4.6,0,22,0,28,20.9,0,1,-2,2,0,1,-1,1
"1661",2018-01-26,"Slate River Rd","w1718","Non.motorized",4,"Fri","weekday","no_sled","2","2","2",4.7,0.1,22,0,15,21.4,0,0,1,-2,0,0,1,-1
"1662",2018-01-26,"Slate River Rd","w1718","Mechanized",0,"Fri","weekday","no_sled","2","2","2",4.7,0.1,22,0,15,21.4,0,0,1,-2,0,0,1,-1
"1663",2018-01-26,"Slate River Rd","w1718","Motorized",1,"Fri","weekday","sled","2","2","2",4.7,0.1,22,0,15,21.4,0,0,1,-2,0,0,1,-1
"1664",2018-01-26,"Slate River Rd","w1718","Hybrid",1,"Fri","weekday","sled","2","2","2",4.7,0.1,22,0,15,21.4,0,0,1,-2,0,0,1,-1
"1665",2018-01-27,"Slate River Rd","w1718","Non.motorized",34,"Sat","weekend","no_sled","2","2","2",4.7,0,23,1,16,20.4,0,0,0,1,1,1,1,2
"1666",2018-01-27,"Slate River Rd","w1718","Mechanized",1,"Sat","weekend","no_sled","2","2","2",4.7,0,23,1,16,20.4,0,0,0,1,1,1,1,2
"1667",2018-01-27,"Slate River Rd","w1718","Motorized",19,"Sat","weekend","sled","2","2","2",4.7,0,23,1,16,20.4,0,0,0,1,1,1,1,2
"1668",2018-01-27,"Slate River Rd","w1718","Hybrid",17,"Sat","weekend","sled","2","2","2",4.7,0,23,1,16,20.4,0,0,0,1,1,1,1,2
"1669",2018-01-28,"Slate River Rd","w1718","Non.motorized",41,"Sun","weekend","no_sled","2","2","2",4.7,0,23,0,25,20.4,1,0,0,0,1,1,1,1
"1670",2018-01-28,"Slate River Rd","w1718","Mechanized",2,"Sun","weekend","no_sled","2","2","2",4.7,0,23,0,25,20.4,1,0,0,0,1,1,1,1
"1671",2018-01-28,"Slate River Rd","w1718","Motorized",17,"Sun","weekend","sled","2","2","2",4.7,0,23,0,25,20.4,1,0,0,0,1,1,1,1
"1672",2018-01-28,"Slate River Rd","w1718","Hybrid",17,"Sun","weekend","sled","2","2","2",4.7,0,23,0,25,20.4,1,0,0,0,1,1,1,1
"1673",2018-01-29,"Slate River Rd","w1718","Non.motorized",21,"Mon","weekday","no_sled","2","2","2",4.8,0.1,22,-1,30,21.8,0,1,0,0,-1,0,0,0
"1674",2018-01-29,"Slate River Rd","w1718","Mechanized",0,"Mon","weekday","no_sled","2","2","2",4.8,0.1,22,-1,30,21.8,0,1,0,0,-1,0,0,0
"1675",2018-01-29,"Slate River Rd","w1718","Motorized",8,"Mon","weekday","sled","2","2","2",4.8,0.1,22,-1,30,21.8,0,1,0,0,-1,0,0,0
"1676",2018-01-29,"Slate River Rd","w1718","Hybrid",7,"Mon","weekday","sled","2","2","2",4.8,0.1,22,-1,30,21.8,0,1,0,0,-1,0,0,0
"1677",2018-01-30,"Slate River Rd","w1718","Non.motorized",19,"Tue","weekday","no_sled","2","2","2",4.8,0,22,0,34,21.8,-1,0,1,0,-1,-1,0,0
"1678",2018-01-30,"Slate River Rd","w1718","Mechanized",0,"Tue","weekday","no_sled","2","2","2",4.8,0,22,0,34,21.8,-1,0,1,0,-1,-1,0,0
"1679",2018-01-30,"Slate River Rd","w1718","Motorized",7,"Tue","weekday","sled","2","2","2",4.8,0,22,0,34,21.8,-1,0,1,0,-1,-1,0,0
"1680",2018-01-30,"Slate River Rd","w1718","Hybrid",7,"Tue","weekday","sled","2","2","2",4.8,0,22,0,34,21.8,-1,0,1,0,-1,-1,0,0
"1681",2018-01-31,"Slate River Rd","w1718","Non.motorized",13,"Wed","weekday","no_sled","2","2","2",4.8,0,22,0,34,21.8,0,-1,0,1,0,-1,-1,0
"1682",2018-01-31,"Slate River Rd","w1718","Mechanized",0,"Wed","weekday","no_sled","2","2","2",4.8,0,22,0,34,21.8,0,-1,0,1,0,-1,-1,0
"1683",2018-01-31,"Slate River Rd","w1718","Motorized",2,"Wed","weekday","sled","2","2","2",4.8,0,22,0,34,21.8,0,-1,0,1,0,-1,-1,0
"1684",2018-01-31,"Slate River Rd","w1718","Hybrid",2,"Wed","weekday","sled","2","2","2",4.8,0,22,0,34,21.8,0,-1,0,1,0,-1,-1,0
"1685",2018-02-01,"Slate River Rd","w1718","Non.motorized",16,"Thu","weekday","no_sled","2","2","2",4.9,0.1,21,-1,32,23.3,0,0,-1,0,-1,-1,-2,-2
"1686",2018-02-01,"Slate River Rd","w1718","Mechanized",0,"Thu","weekday","no_sled","2","2","2",4.9,0.1,21,-1,32,23.3,0,0,-1,0,-1,-1,-2,-2
"1687",2018-02-01,"Slate River Rd","w1718","Motorized",7,"Thu","weekday","sled","2","2","2",4.9,0.1,21,-1,32,23.3,0,0,-1,0,-1,-1,-2,-2
"1688",2018-02-01,"Slate River Rd","w1718","Hybrid",6,"Thu","weekday","sled","2","2","2",4.9,0.1,21,-1,32,23.3,0,0,-1,0,-1,-1,-2,-2
"1689",2018-02-02,"Slate River Rd","w1718","Non.motorized",11,"Fri","weekday","no_sled","2","2","2",4.9,0,20,-1,33,24.5,-1,0,0,-1,-2,-2,-2,-3
"1690",2018-02-02,"Slate River Rd","w1718","Mechanized",2,"Fri","weekday","no_sled","2","2","2",4.9,0,20,-1,33,24.5,-1,0,0,-1,-2,-2,-2,-3
"1691",2018-02-02,"Slate River Rd","w1718","Motorized",8,"Fri","weekday","sled","2","2","2",4.9,0,20,-1,33,24.5,-1,0,0,-1,-2,-2,-2,-3
"1692",2018-02-02,"Slate River Rd","w1718","Hybrid",8,"Fri","weekday","sled","2","2","2",4.9,0,20,-1,33,24.5,-1,0,0,-1,-2,-2,-2,-3
"1693",2018-02-03,"Slate River Rd","w1718","Non.motorized",42,"Sat","weekend","no_sled","2","2","2",4.9,0,21,1,32,23.3,-1,-1,0,0,0,-1,-1,-1
"1694",2018-02-03,"Slate River Rd","w1718","Mechanized",2,"Sat","weekend","no_sled","2","2","2",4.9,0,21,1,32,23.3,-1,-1,0,0,0,-1,-1,-1
"1695",2018-02-03,"Slate River Rd","w1718","Motorized",7,"Sat","weekend","sled","2","2","2",4.9,0,21,1,32,23.3,-1,-1,0,0,0,-1,-1,-1
"1696",2018-02-03,"Slate River Rd","w1718","Hybrid",3,"Sat","weekend","sled","2","2","2",4.9,0,21,1,32,23.3,-1,-1,0,0,0,-1,-1,-1
"1697",2018-02-04,"Slate River Rd","w1718","Non.motorized",54,"Sun","weekend","no_sled","2","2","2",4.9,0,19,-2,32,25.8,1,-1,-1,0,-1,-2,-3,-3
"1698",2018-02-04,"Slate River Rd","w1718","Mechanized",4,"Sun","weekend","no_sled","2","2","2",4.9,0,19,-2,32,25.8,1,-1,-1,0,-1,-2,-3,-3
"1699",2018-02-04,"Slate River Rd","w1718","Motorized",10,"Sun","weekend","sled","2","2","2",4.9,0,19,-2,32,25.8,1,-1,-1,0,-1,-2,-3,-3
"1700",2018-02-04,"Slate River Rd","w1718","Hybrid",9,"Sun","weekend","sled","2","2","2",4.9,0,19,-2,32,25.8,1,-1,-1,0,-1,-2,-3,-3
"1701",2018-02-05,"Slate River Rd","w1718","Non.motorized",37,"Mon","weekday","no_sled","2","2","2",5,0.1,18,-1,29,27.8,-2,1,-1,-1,-3,-2,-3,-4
"1702",2018-02-05,"Slate River Rd","w1718","Mechanized",0,"Mon","weekday","no_sled","2","2","2",5,0.1,18,-1,29,27.8,-2,1,-1,-1,-3,-2,-3,-4
"1703",2018-02-05,"Slate River Rd","w1718","Motorized",5,"Mon","weekday","sled","2","2","2",5,0.1,18,-1,29,27.8,-2,1,-1,-1,-3,-2,-3,-4
"1704",2018-02-05,"Slate River Rd","w1718","Hybrid",4,"Mon","weekday","sled","2","2","2",5,0.1,18,-1,29,27.8,-2,1,-1,-1,-3,-2,-3,-4
"1705",2018-02-06,"Slate River Rd","w1718","Non.motorized",16,"Tue","weekday","no_sled","2","2","2",5.2,0.2,23,5,22,22.6,-1,-2,1,-1,4,2,3,2
"1706",2018-02-06,"Slate River Rd","w1718","Mechanized",0,"Tue","weekday","no_sled","2","2","2",5.2,0.2,23,5,22,22.6,-1,-2,1,-1,4,2,3,2
"1707",2018-02-06,"Slate River Rd","w1718","Motorized",7,"Tue","weekday","sled","2","2","2",5.2,0.2,23,5,22,22.6,-1,-2,1,-1,4,2,3,2
"1708",2018-02-06,"Slate River Rd","w1718","Hybrid",6,"Tue","weekday","sled","2","2","2",5.2,0.2,23,5,22,22.6,-1,-2,1,-1,4,2,3,2
"1709",2018-02-07,"Slate River Rd","w1718","Non.motorized",18,"Wed","weekday","no_sled","2","2","2",5.2,0,23,0,24,22.6,5,-1,-2,1,5,4,2,3
"1710",2018-02-07,"Slate River Rd","w1718","Mechanized",0,"Wed","weekday","no_sled","2","2","2",5.2,0,23,0,24,22.6,5,-1,-2,1,5,4,2,3
"1711",2018-02-07,"Slate River Rd","w1718","Motorized",11,"Wed","weekday","sled","2","2","2",5.2,0,23,0,24,22.6,5,-1,-2,1,5,4,2,3
"1712",2018-02-07,"Slate River Rd","w1718","Hybrid",10,"Wed","weekday","sled","2","2","2",5.2,0,23,0,24,22.6,5,-1,-2,1,5,4,2,3
"1713",2018-02-08,"Slate River Rd","w1718","Non.motorized",23,"Thu","weekday","no_sled","2","2","1",5.3,0.1,25,2,28,21.2,0,5,-1,-2,2,7,6,4
"1714",2018-02-08,"Slate River Rd","w1718","Mechanized",0,"Thu","weekday","no_sled","2","2","1",5.3,0.1,25,2,28,21.2,0,5,-1,-2,2,7,6,4
"1715",2018-02-08,"Slate River Rd","w1718","Motorized",4,"Thu","weekday","sled","2","2","1",5.3,0.1,25,2,28,21.2,0,5,-1,-2,2,7,6,4
"1716",2018-02-08,"Slate River Rd","w1718","Hybrid",3,"Thu","weekday","sled","2","2","1",5.3,0.1,25,2,28,21.2,0,5,-1,-2,2,7,6,4
"1717",2018-02-09,"Slate River Rd","w1718","Non.motorized",16,"Fri","weekday","no_sled","2","2","1",5.3,0,24,-1,33,22.1,2,0,5,-1,1,1,6,5
"1718",2018-02-09,"Slate River Rd","w1718","Mechanized",0,"Fri","weekday","no_sled","2","2","1",5.3,0,24,-1,33,22.1,2,0,5,-1,1,1,6,5
"1719",2018-02-09,"Slate River Rd","w1718","Motorized",4,"Fri","weekday","sled","2","2","1",5.3,0,24,-1,33,22.1,2,0,5,-1,1,1,6,5
"1720",2018-02-09,"Slate River Rd","w1718","Hybrid",4,"Fri","weekday","sled","2","2","1",5.3,0,24,-1,33,22.1,2,0,5,-1,1,1,6,5
"1721",2018-02-10,"Slate River Rd","w1718","Non.motorized",3,"Sat","weekend","no_sled","3","3","2",5.3,0,24,0,24,22.1,-1,2,0,5,-1,1,1,6
"1722",2018-02-10,"Slate River Rd","w1718","Mechanized",0,"Sat","weekend","no_sled","3","3","2",5.3,0,24,0,24,22.1,-1,2,0,5,-1,1,1,6
"1723",2018-02-10,"Slate River Rd","w1718","Motorized",0,"Sat","weekend","sled","3","3","2",5.3,0,24,0,24,22.1,-1,2,0,5,-1,1,1,6
"1724",2018-02-10,"Slate River Rd","w1718","Hybrid",0,"Sat","weekend","sled","3","3","2",5.3,0,24,0,24,22.1,-1,2,0,5,-1,1,1,6
"1725",2018-02-11,"Slate River Rd","w1718","Non.motorized",20,"Sun","weekend","no_sled","3","3","2",5.6,0.3,27,3,13,20.7,0,-1,2,0,3,2,4,4
"1726",2018-02-11,"Slate River Rd","w1718","Mechanized",1,"Sun","weekend","no_sled","3","3","2",5.6,0.3,27,3,13,20.7,0,-1,2,0,3,2,4,4
"1727",2018-02-11,"Slate River Rd","w1718","Motorized",4,"Sun","weekend","sled","3","3","2",5.6,0.3,27,3,13,20.7,0,-1,2,0,3,2,4,4
"1728",2018-02-11,"Slate River Rd","w1718","Hybrid",3,"Sun","weekend","sled","3","3","2",5.6,0.3,27,3,13,20.7,0,-1,2,0,3,2,4,4
"1729",2018-02-12,"Slate River Rd","w1718","Non.motorized",11,"Mon","weekday","no_sled","3","3","3",5.7,0.1,27,0,23,21.1,3,0,-1,2,3,3,2,4
"1730",2018-02-12,"Slate River Rd","w1718","Mechanized",0,"Mon","weekday","no_sled","3","3","3",5.7,0.1,27,0,23,21.1,3,0,-1,2,3,3,2,4
"1731",2018-02-12,"Slate River Rd","w1718","Motorized",4,"Mon","weekday","sled","3","3","3",5.7,0.1,27,0,23,21.1,3,0,-1,2,3,3,2,4
"1732",2018-02-12,"Slate River Rd","w1718","Hybrid",4,"Mon","weekday","sled","3","3","3",5.7,0.1,27,0,23,21.1,3,0,-1,2,3,3,2,4
"1733",2018-02-13,"Slate River Rd","w1718","Non.motorized",7,"Tue","weekday","no_sled","3","3","3",6.1,0.4,29,2,28,21,0,3,0,-1,2,5,5,4
"1734",2018-02-13,"Slate River Rd","w1718","Mechanized",2,"Tue","weekday","no_sled","3","3","3",6.1,0.4,29,2,28,21,0,3,0,-1,2,5,5,4
"1735",2018-02-13,"Slate River Rd","w1718","Motorized",6,"Tue","weekday","sled","3","3","3",6.1,0.4,29,2,28,21,0,3,0,-1,2,5,5,4
"1736",2018-02-13,"Slate River Rd","w1718","Hybrid",6,"Tue","weekday","sled","3","3","3",6.1,0.4,29,2,28,21,0,3,0,-1,2,5,5,4
"1737",2018-02-14,"Slate River Rd","w1718","Non.motorized",14,"Wed","weekday","no_sled","3","3","3",6.2,0.1,30,1,30,20.7,2,0,3,0,3,3,6,6
"1738",2018-02-14,"Slate River Rd","w1718","Mechanized",0,"Wed","weekday","no_sled","3","3","3",6.2,0.1,30,1,30,20.7,2,0,3,0,3,3,6,6
"1739",2018-02-14,"Slate River Rd","w1718","Motorized",4,"Wed","weekday","sled","3","3","3",6.2,0.1,30,1,30,20.7,2,0,3,0,3,3,6,6
"1740",2018-02-14,"Slate River Rd","w1718","Hybrid",4,"Wed","weekday","sled","3","3","3",6.2,0.1,30,1,30,20.7,2,0,3,0,3,3,6,6
"1741",2018-02-15,"Slate River Rd","w1718","Non.motorized",7,"Thu","weekday","no_sled","3","3","3",6.3,0.1,28,-2,24,22.5,1,2,0,3,-1,1,1,4
"1742",2018-02-15,"Slate River Rd","w1718","Mechanized",0,"Thu","weekday","no_sled","3","3","3",6.3,0.1,28,-2,24,22.5,1,2,0,3,-1,1,1,4
"1743",2018-02-15,"Slate River Rd","w1718","Motorized",10,"Thu","weekday","sled","3","3","3",6.3,0.1,28,-2,24,22.5,1,2,0,3,-1,1,1,4
"1744",2018-02-15,"Slate River Rd","w1718","Hybrid",10,"Thu","weekday","sled","3","3","3",6.3,0.1,28,-2,24,22.5,1,2,0,3,-1,1,1,4
"1745",2018-02-16,"Slate River Rd","w1718","Non.motorized",14,"Fri","weekday","no_sled","3","3","3",6.7,0.4,32,4,18,20.9,-2,1,2,0,2,3,5,5
"1746",2018-02-16,"Slate River Rd","w1718","Mechanized",1,"Fri","weekday","no_sled","3","3","3",6.7,0.4,32,4,18,20.9,-2,1,2,0,2,3,5,5
"1747",2018-02-16,"Slate River Rd","w1718","Motorized",8,"Fri","weekday","sled","3","3","3",6.7,0.4,32,4,18,20.9,-2,1,2,0,2,3,5,5
"1748",2018-02-16,"Slate River Rd","w1718","Hybrid",6,"Fri","weekday","sled","3","3","3",6.7,0.4,32,4,18,20.9,-2,1,2,0,2,3,5,5
"1749",2018-02-17,"Slate River Rd","w1718","Non.motorized",65,"Sat","weekend","no_sled","3","3","2",6.7,0,32,0,25,20.9,4,-2,1,2,4,2,3,5
"1750",2018-02-17,"Slate River Rd","w1718","Mechanized",4,"Sat","weekend","no_sled","3","3","2",6.7,0,32,0,25,20.9,4,-2,1,2,4,2,3,5
"1751",2018-02-17,"Slate River Rd","w1718","Motorized",10,"Sat","weekend","sled","3","3","2",6.7,0,32,0,25,20.9,4,-2,1,2,4,2,3,5
"1752",2018-02-17,"Slate River Rd","w1718","Hybrid",9,"Sat","weekend","sled","3","3","2",6.7,0,32,0,25,20.9,4,-2,1,2,4,2,3,5
"1753",2018-02-18,"Slate River Rd","w1718","Non.motorized",51,"Sun","weekend","no_sled","2","2","2",6.7,0,31,-1,32,21.6,0,4,-2,1,-1,3,1,2
"1754",2018-02-18,"Slate River Rd","w1718","Mechanized",6,"Sun","weekend","no_sled","2","2","2",6.7,0,31,-1,32,21.6,0,4,-2,1,-1,3,1,2
"1755",2018-02-18,"Slate River Rd","w1718","Motorized",6,"Sun","weekend","sled","2","2","2",6.7,0,31,-1,32,21.6,0,4,-2,1,-1,3,1,2
"1756",2018-02-18,"Slate River Rd","w1718","Hybrid",6,"Sun","weekend","sled","2","2","2",6.7,0,31,-1,32,21.6,0,4,-2,1,-1,3,1,2
"1757",2018-02-19,"Slate River Rd","w1718","Non.motorized",6,"Mon","weekday","no_sled","2","2","2",6.8,0.1,29,-2,24,23.4,-1,0,4,-2,-3,-3,1,-1
"1758",2018-02-19,"Slate River Rd","w1718","Non.motorized",6,"Mon","weekday","no_sled","3","3","3",6.8,0.1,29,-2,24,23.4,-1,0,4,-2,-3,-3,1,-1
"1759",2018-02-19,"Slate River Rd","w1718","Mechanized",0,"Mon","weekday","no_sled","2","2","2",6.8,0.1,29,-2,24,23.4,-1,0,4,-2,-3,-3,1,-1
"1760",2018-02-19,"Slate River Rd","w1718","Mechanized",0,"Mon","weekday","no_sled","3","3","3",6.8,0.1,29,-2,24,23.4,-1,0,4,-2,-3,-3,1,-1
"1761",2018-02-19,"Slate River Rd","w1718","Motorized",17,"Mon","weekday","sled","2","2","2",6.8,0.1,29,-2,24,23.4,-1,0,4,-2,-3,-3,1,-1
"1762",2018-02-19,"Slate River Rd","w1718","Motorized",17,"Mon","weekday","sled","3","3","3",6.8,0.1,29,-2,24,23.4,-1,0,4,-2,-3,-3,1,-1
"1763",2018-02-19,"Slate River Rd","w1718","Hybrid",16,"Mon","weekday","sled","2","2","2",6.8,0.1,29,-2,24,23.4,-1,0,4,-2,-3,-3,1,-1
"1764",2018-02-19,"Slate River Rd","w1718","Hybrid",16,"Mon","weekday","sled","3","3","3",6.8,0.1,29,-2,24,23.4,-1,0,4,-2,-3,-3,1,-1
"1765",2018-02-20,"Slate River Rd","w1718","Non.motorized",0,"Tue","weekday","no_sled","3","3","3",6.8,0,31,2,8,21.9,-2,-1,0,4,0,-1,-1,3
"1766",2018-02-20,"Slate River Rd","w1718","Mechanized",0,"Tue","weekday","no_sled","3","3","3",6.8,0,31,2,8,21.9,-2,-1,0,4,0,-1,-1,3
"1767",2018-02-20,"Slate River Rd","w1718","Motorized",1,"Tue","weekday","sled","3","3","3",6.8,0,31,2,8,21.9,-2,-1,0,4,0,-1,-1,3
"1768",2018-02-20,"Slate River Rd","w1718","Hybrid",1,"Tue","weekday","sled","3","3","3",6.8,0,31,2,8,21.9,-2,-1,0,4,0,-1,-1,3
"1769",2018-02-21,"Slate River Rd","w1718","Non.motorized",19,"Wed","weekday","no_sled","3","3","3",6.8,0,31,0,11,21.9,2,-2,-1,0,2,0,-1,-1
"1770",2018-02-21,"Slate River Rd","w1718","Mechanized",0,"Wed","weekday","no_sled","3","3","3",6.8,0,31,0,11,21.9,2,-2,-1,0,2,0,-1,-1
"1771",2018-02-21,"Slate River Rd","w1718","Motorized",2,"Wed","weekday","sled","3","3","3",6.8,0,31,0,11,21.9,2,-2,-1,0,2,0,-1,-1
"1772",2018-02-21,"Slate River Rd","w1718","Hybrid",2,"Wed","weekday","sled","3","3","3",6.8,0,31,0,11,21.9,2,-2,-1,0,2,0,-1,-1
"1773",2018-02-22,"Slate River Rd","w1718","Non.motorized",14,"Thu","weekday","no_sled","3","3","2",6.8,0,30,-1,16,22.7,0,2,-2,-1,-1,1,-1,-2
"1774",2018-02-22,"Slate River Rd","w1718","Mechanized",0,"Thu","weekday","no_sled","3","3","2",6.8,0,30,-1,16,22.7,0,2,-2,-1,-1,1,-1,-2
"1775",2018-02-22,"Slate River Rd","w1718","Motorized",3,"Thu","weekday","sled","3","3","2",6.8,0,30,-1,16,22.7,0,2,-2,-1,-1,1,-1,-2
"1776",2018-02-22,"Slate River Rd","w1718","Hybrid",3,"Thu","weekday","sled","3","3","2",6.8,0,30,-1,16,22.7,0,2,-2,-1,-1,1,-1,-2
"1777",2018-02-23,"Slate River Rd","w1718","Non.motorized",10,"Fri","weekday","no_sled","3","3","2",6.9,0.1,30,0,15,23,-1,0,2,-2,-1,-1,1,-1
"1778",2018-02-23,"Slate River Rd","w1718","Mechanized",1,"Fri","weekday","no_sled","3","3","2",6.9,0.1,30,0,15,23,-1,0,2,-2,-1,-1,1,-1
"1779",2018-02-23,"Slate River Rd","w1718","Motorized",8,"Fri","weekday","sled","3","3","2",6.9,0.1,30,0,15,23,-1,0,2,-2,-1,-1,1,-1
"1780",2018-02-23,"Slate River Rd","w1718","Hybrid",7,"Fri","weekday","sled","3","3","2",6.9,0.1,30,0,15,23,-1,0,2,-2,-1,-1,1,-1
"1781",2018-02-24,"Slate River Rd","w1718","Non.motorized",8,"Sat","weekend","no_sled","3","3","2",6.9,0,31,1,10,22.3,0,-1,0,2,1,0,0,2
"1782",2018-02-24,"Slate River Rd","w1718","Mechanized",1,"Sat","weekend","no_sled","3","3","2",6.9,0,31,1,10,22.3,0,-1,0,2,1,0,0,2
"1783",2018-02-24,"Slate River Rd","w1718","Motorized",2,"Sat","weekend","sled","3","3","2",6.9,0,31,1,10,22.3,0,-1,0,2,1,0,0,2
"1784",2018-02-24,"Slate River Rd","w1718","Hybrid",0,"Sat","weekend","sled","3","3","2",6.9,0,31,1,10,22.3,0,-1,0,2,1,0,0,2
"1785",2018-02-25,"Slate River Rd","w1718","Non.motorized",4,"Sun","weekend","no_sled","3","3","2",7.1,0.2,32,1,11,22.2,1,0,-1,0,2,2,1,1
"1786",2018-02-25,"Slate River Rd","w1718","Mechanized",1,"Sun","weekend","no_sled","3","3","2",7.1,0.2,32,1,11,22.2,1,0,-1,0,2,2,1,1
"1787",2018-02-25,"Slate River Rd","w1718","Motorized",5,"Sun","weekend","sled","3","3","2",7.1,0.2,32,1,11,22.2,1,0,-1,0,2,2,1,1
"1788",2018-02-25,"Slate River Rd","w1718","Hybrid",5,"Sun","weekend","sled","3","3","2",7.1,0.2,32,1,11,22.2,1,0,-1,0,2,2,1,1
"1789",2018-02-26,"Slate River Rd","w1718","Non.motorized",20,"Mon","weekday","no_sled","2","2","2",7.1,0,32,0,20,22.2,1,1,0,-1,1,2,2,1
"1790",2018-02-26,"Slate River Rd","w1718","Mechanized",0,"Mon","weekday","no_sled","2","2","2",7.1,0,32,0,20,22.2,1,1,0,-1,1,2,2,1
"1791",2018-02-26,"Slate River Rd","w1718","Motorized",0,"Mon","weekday","sled","2","2","2",7.1,0,32,0,20,22.2,1,1,0,-1,1,2,2,1
"1792",2018-02-26,"Slate River Rd","w1718","Hybrid",0,"Mon","weekday","sled","2","2","2",7.1,0,32,0,20,22.2,1,1,0,-1,1,2,2,1
"1793",2018-02-27,"Slate River Rd","w1718","Non.motorized",19,"Tue","weekday","no_sled","2","2","2",7.2,0.1,32,0,26,22.5,0,1,1,0,0,1,2,2
"1794",2018-02-27,"Slate River Rd","w1718","Mechanized",0,"Tue","weekday","no_sled","2","2","2",7.2,0.1,32,0,26,22.5,0,1,1,0,0,1,2,2
"1795",2018-02-27,"Slate River Rd","w1718","Motorized",1,"Tue","weekday","sled","2","2","2",7.2,0.1,32,0,26,22.5,0,1,1,0,0,1,2,2
"1796",2018-02-27,"Slate River Rd","w1718","Hybrid",0,"Tue","weekday","sled","2","2","2",7.2,0.1,32,0,26,22.5,0,1,1,0,0,1,2,2
"1797",2018-02-28,"Slate River Rd","w1718","Non.motorized",7,"Wed","weekday","no_sled","2","2","2",7.2,0,31,-1,23,23.2,0,0,1,1,-1,-1,0,1
"1798",2018-02-28,"Slate River Rd","w1718","Mechanized",0,"Wed","weekday","no_sled","2","2","2",7.2,0,31,-1,23,23.2,0,0,1,1,-1,-1,0,1
"1799",2018-02-28,"Slate River Rd","w1718","Motorized",1,"Wed","weekday","sled","2","2","2",7.2,0,31,-1,23,23.2,0,0,1,1,-1,-1,0,1
"1800",2018-02-28,"Slate River Rd","w1718","Hybrid",0,"Wed","weekday","sled","2","2","2",7.2,0,31,-1,23,23.2,0,0,1,1,-1,-1,0,1
"1801",2018-03-01,"Slate River Rd","w1718","Non.motorized",15,"Thu","weekday","no_sled","2","2","2",7.2,0,31,0,24,23.2,-1,0,0,1,-1,-1,-1,0
"1802",2018-03-01,"Slate River Rd","w1718","Mechanized",15,"Thu","weekday","no_sled","2","2","2",7.2,0,31,0,24,23.2,-1,0,0,1,-1,-1,-1,0
"1803",2018-03-01,"Slate River Rd","w1718","Motorized",12,"Thu","weekday","sled","2","2","2",7.2,0,31,0,24,23.2,-1,0,0,1,-1,-1,-1,0
"1804",2018-03-01,"Slate River Rd","w1718","Hybrid",8,"Thu","weekday","sled","2","2","2",7.2,0,31,0,24,23.2,-1,0,0,1,-1,-1,-1,0
"1805",2018-03-02,"Slate River Rd","w1718","Non.motorized",11,"Fri","weekday","no_sled","2","2","1",7.2,0,31,0,30,23.2,0,-1,0,0,0,-1,-1,-1
"1806",2018-03-02,"Slate River Rd","w1718","Mechanized",0,"Fri","weekday","no_sled","2","2","1",7.2,0,31,0,30,23.2,0,-1,0,0,0,-1,-1,-1
"1807",2018-03-02,"Slate River Rd","w1718","Motorized",5,"Fri","weekday","sled","2","2","1",7.2,0,31,0,30,23.2,0,-1,0,0,0,-1,-1,-1
"1808",2018-03-02,"Slate River Rd","w1718","Hybrid",5,"Fri","weekday","sled","2","2","1",7.2,0,31,0,30,23.2,0,-1,0,0,0,-1,-1,-1
"1809",2018-03-03,"Slate River Rd","w1718","Non.motorized",44,"Sat","weekend","no_sled","2","2","1",7.3,0.1,30,-1,34,24.3,0,0,-1,0,-1,-1,-2,-2
"1810",2018-03-03,"Slate River Rd","w1718","Mechanized",1,"Sat","weekend","no_sled","2","2","1",7.3,0.1,30,-1,34,24.3,0,0,-1,0,-1,-1,-2,-2
"1811",2018-03-03,"Slate River Rd","w1718","Motorized",11,"Sat","weekend","sled","2","2","1",7.3,0.1,30,-1,34,24.3,0,0,-1,0,-1,-1,-2,-2
"1812",2018-03-03,"Slate River Rd","w1718","Hybrid",11,"Sat","weekend","sled","2","2","1",7.3,0.1,30,-1,34,24.3,0,0,-1,0,-1,-1,-2,-2
"1813",2018-03-04,"Slate River Rd","w1718","Non.motorized",35,"Sun","weekend","no_sled","2","2","1",7.3,0,29,-1,24,25.2,-1,0,0,-1,-2,-2,-2,-3
"1814",2018-03-04,"Slate River Rd","w1718","Mechanized",1,"Sun","weekend","no_sled","2","2","1",7.3,0,29,-1,24,25.2,-1,0,0,-1,-2,-2,-2,-3
"1815",2018-03-04,"Slate River Rd","w1718","Motorized",13,"Sun","weekend","sled","2","2","1",7.3,0,29,-1,24,25.2,-1,0,0,-1,-2,-2,-2,-3
"1816",2018-03-04,"Slate River Rd","w1718","Hybrid",13,"Sun","weekend","sled","2","2","1",7.3,0,29,-1,24,25.2,-1,0,0,-1,-2,-2,-2,-3
"1817",2018-03-05,"Slate River Rd","w1718","Non.motorized",14,"Mon","weekday","no_sled","2","2","1",7.3,0,31,2,13,23.5,-1,-1,0,0,1,0,0,0
"1818",2018-03-05,"Slate River Rd","w1718","Mechanized",3,"Mon","weekday","no_sled","2","2","1",7.3,0,31,2,13,23.5,-1,-1,0,0,1,0,0,0
"1819",2018-03-05,"Slate River Rd","w1718","Motorized",2,"Mon","weekday","sled","2","2","1",7.3,0,31,2,13,23.5,-1,-1,0,0,1,0,0,0
"1820",2018-03-05,"Slate River Rd","w1718","Hybrid",0,"Mon","weekday","sled","2","2","1",7.3,0,31,2,13,23.5,-1,-1,0,0,1,0,0,0
"1821",2018-03-06,"Slate River Rd","w1718","Non.motorized",9,"Tue","weekday","no_sled","2","2","1",7.3,0,31,0,19,23.5,2,-1,-1,0,2,1,0,0
"1822",2018-03-06,"Slate River Rd","w1718","Mechanized",0,"Tue","weekday","no_sled","2","2","1",7.3,0,31,0,19,23.5,2,-1,-1,0,2,1,0,0
"1823",2018-03-06,"Slate River Rd","w1718","Motorized",6,"Tue","weekday","sled","2","2","1",7.3,0,31,0,19,23.5,2,-1,-1,0,2,1,0,0
"1824",2018-03-06,"Slate River Rd","w1718","Hybrid",4,"Tue","weekday","sled","2","2","1",7.3,0,31,0,19,23.5,2,-1,-1,0,2,1,0,0
"1825",2018-03-07,"Slate River Rd","w1718","Non.motorized",16,"Wed","weekday","no_sled","2","2","1",7.4,0.1,31,0,27,23.9,0,2,-1,-1,0,2,1,0
"1826",2018-03-07,"Slate River Rd","w1718","Mechanized",0,"Wed","weekday","no_sled","2","2","1",7.4,0.1,31,0,27,23.9,0,2,-1,-1,0,2,1,0
"1827",2018-03-07,"Slate River Rd","w1718","Motorized",9,"Wed","weekday","sled","2","2","1",7.4,0.1,31,0,27,23.9,0,2,-1,-1,0,2,1,0
"1828",2018-03-07,"Slate River Rd","w1718","Hybrid",9,"Wed","weekday","sled","2","2","1",7.4,0.1,31,0,27,23.9,0,2,-1,-1,0,2,1,0
"1829",2018-03-08,"Slate River Rd","w1718","Non.motorized",17,"Thu","weekday","no_sled","2","2","1",7.4,0,30,-1,33,24.7,0,0,2,-1,-1,-1,1,0
"1830",2018-03-08,"Slate River Rd","w1718","Mechanized",0,"Thu","weekday","no_sled","2","2","1",7.4,0,30,-1,33,24.7,0,0,2,-1,-1,-1,1,0
"1831",2018-03-08,"Slate River Rd","w1718","Motorized",10,"Thu","weekday","sled","2","2","1",7.4,0,30,-1,33,24.7,0,0,2,-1,-1,-1,1,0
"1832",2018-03-08,"Slate River Rd","w1718","Hybrid",8,"Thu","weekday","sled","2","2","1",7.4,0,30,-1,33,24.7,0,0,2,-1,-1,-1,1,0
"1833",2018-03-09,"Slate River Rd","w1718","Non.motorized",41,"Fri","weekday","no_sled","2","2","1",7.4,0,30,0,34,24.7,-1,0,0,2,-1,-1,-1,1
"1834",2018-03-09,"Slate River Rd","w1718","Mechanized",0,"Fri","weekday","no_sled","2","2","1",7.4,0,30,0,34,24.7,-1,0,0,2,-1,-1,-1,1
"1835",2018-03-09,"Slate River Rd","w1718","Motorized",10,"Fri","weekday","sled","2","2","1",7.4,0,30,0,34,24.7,-1,0,0,2,-1,-1,-1,1
"1836",2018-03-09,"Slate River Rd","w1718","Hybrid",10,"Fri","weekday","sled","2","2","1",7.4,0,30,0,34,24.7,-1,0,0,2,-1,-1,-1,1
"1837",2018-03-10,"Slate River Rd","w1718","Non.motorized",37,"Sat","weekend","no_sled","1","1","1",7.4,0,30,0,31,24.7,0,-1,0,0,0,-1,-1,-1
"1838",2018-03-10,"Slate River Rd","w1718","Mechanized",0,"Sat","weekend","no_sled","1","1","1",7.4,0,30,0,31,24.7,0,-1,0,0,0,-1,-1,-1
"1839",2018-03-10,"Slate River Rd","w1718","Motorized",6,"Sat","weekend","sled","1","1","1",7.4,0,30,0,31,24.7,0,-1,0,0,0,-1,-1,-1
"1840",2018-03-10,"Slate River Rd","w1718","Hybrid",5,"Sat","weekend","sled","1","1","1",7.4,0,30,0,31,24.7,0,-1,0,0,0,-1,-1,-1
"1841",2018-03-11,"Slate River Rd","w1718","Non.motorized",54,"Sun","weekend","no_sled","1","1","1",7.4,0,29,-1,31,25.5,0,0,-1,0,-1,-1,-2,-2
"1842",2018-03-11,"Slate River Rd","w1718","Mechanized",0,"Sun","weekend","no_sled","1","1","1",7.4,0,29,-1,31,25.5,0,0,-1,0,-1,-1,-2,-2
"1843",2018-03-11,"Slate River Rd","w1718","Motorized",4,"Sun","weekend","sled","1","1","1",7.4,0,29,-1,31,25.5,0,0,-1,0,-1,-1,-2,-2
"1844",2018-03-11,"Slate River Rd","w1718","Hybrid",4,"Sun","weekend","sled","1","1","1",7.4,0,29,-1,31,25.5,0,0,-1,0,-1,-1,-2,-2
"1845",2018-03-12,"Slate River Rd","w1718","Non.motorized",26,"Mon","weekday","no_sled","1","1","1",7.4,0,29,0,33,25.5,-1,0,0,-1,-1,-1,-1,-2
"1846",2018-03-12,"Slate River Rd","w1718","Mechanized",0,"Mon","weekday","no_sled","1","1","1",7.4,0,29,0,33,25.5,-1,0,0,-1,-1,-1,-1,-2
"1847",2018-03-12,"Slate River Rd","w1718","Motorized",4,"Mon","weekday","sled","1","1","1",7.4,0,29,0,33,25.5,-1,0,0,-1,-1,-1,-1,-2
"1848",2018-03-12,"Slate River Rd","w1718","Hybrid",2,"Mon","weekday","sled","1","1","1",7.4,0,29,0,33,25.5,-1,0,0,-1,-1,-1,-1,-2
"1849",2018-03-13,"Slate River Rd","w1718","Non.motorized",49,"Tue","weekday","no_sled","1","1","1",7.4,0,29,0,34,25.5,0,-1,0,0,0,-1,-1,-1
"1850",2018-03-13,"Slate River Rd","w1718","Mechanized",1,"Tue","weekday","no_sled","1","1","1",7.4,0,29,0,34,25.5,0,-1,0,0,0,-1,-1,-1
"1851",2018-03-13,"Slate River Rd","w1718","Motorized",3,"Tue","weekday","sled","1","1","1",7.4,0,29,0,34,25.5,0,-1,0,0,0,-1,-1,-1
"1852",2018-03-13,"Slate River Rd","w1718","Hybrid",2,"Tue","weekday","sled","1","1","1",7.4,0,29,0,34,25.5,0,-1,0,0,0,-1,-1,-1
"1853",2018-03-14,"Slate River Rd","w1718","Non.motorized",27,"Wed","weekday","no_sled","1","2","2",7.4,0,29,0,39,25.5,0,0,-1,0,0,0,-1,-1
"1854",2018-03-14,"Slate River Rd","w1718","Mechanized",0,"Wed","weekday","no_sled","1","2","2",7.4,0,29,0,39,25.5,0,0,-1,0,0,0,-1,-1
"1855",2018-03-14,"Slate River Rd","w1718","Motorized",7,"Wed","weekday","sled","1","2","2",7.4,0,29,0,39,25.5,0,0,-1,0,0,0,-1,-1
"1856",2018-03-14,"Slate River Rd","w1718","Hybrid",2,"Wed","weekday","sled","1","2","2",7.4,0,29,0,39,25.5,0,0,-1,0,0,0,-1,-1
"1857",2018-03-15,"Slate River Rd","w1718","Non.motorized",12,"Thu","weekday","no_sled","2","2","2",7.5,0.1,28,-1,31,26.8,0,0,0,-1,-1,-1,-1,-2
"1858",2018-03-15,"Slate River Rd","w1718","Mechanized",0,"Thu","weekday","no_sled","2","2","2",7.5,0.1,28,-1,31,26.8,0,0,0,-1,-1,-1,-1,-2
"1859",2018-03-15,"Slate River Rd","w1718","Motorized",2,"Thu","weekday","sled","2","2","2",7.5,0.1,28,-1,31,26.8,0,0,0,-1,-1,-1,-1,-2
"1860",2018-03-15,"Slate River Rd","w1718","Hybrid",2,"Thu","weekday","sled","2","2","2",7.5,0.1,28,-1,31,26.8,0,0,0,-1,-1,-1,-1,-2
"1861",2018-03-16,"Slate River Rd","w1718","Non.motorized",20,"Fri","weekday","no_sled","2","2","2",7.7,0.2,29,1,25,26.6,-1,0,0,0,0,0,0,0
"1862",2018-03-16,"Slate River Rd","w1718","Mechanized",0,"Fri","weekday","no_sled","2","2","2",7.7,0.2,29,1,25,26.6,-1,0,0,0,0,0,0,0
"1863",2018-03-16,"Slate River Rd","w1718","Motorized",10,"Fri","weekday","sled","2","2","2",7.7,0.2,29,1,25,26.6,-1,0,0,0,0,0,0,0
"1864",2018-03-16,"Slate River Rd","w1718","Hybrid",10,"Fri","weekday","sled","2","2","2",7.7,0.2,29,1,25,26.6,-1,0,0,0,0,0,0,0
"1865",2018-03-17,"Slate River Rd","w1718","Non.motorized",22,"Sat","weekend","no_sled","2","2","2",7.8,0.1,32,3,29,24.4,1,-1,0,0,4,3,3,3
"1866",2018-03-17,"Slate River Rd","w1718","Mechanized",0,"Sat","weekend","no_sled","2","2","2",7.8,0.1,32,3,29,24.4,1,-1,0,0,4,3,3,3
"1867",2018-03-17,"Slate River Rd","w1718","Motorized",11,"Sat","weekend","sled","2","2","2",7.8,0.1,32,3,29,24.4,1,-1,0,0,4,3,3,3
"1868",2018-03-17,"Slate River Rd","w1718","Hybrid",11,"Sat","weekend","sled","2","2","2",7.8,0.1,32,3,29,24.4,1,-1,0,0,4,3,3,3
"1869",2018-03-18,"Slate River Rd","w1718","Non.motorized",11,"Sun","weekend","no_sled","2","2","2",7.9,0.1,31,-1,24,25.5,3,1,-1,0,2,3,2,2
"1870",2018-03-18,"Slate River Rd","w1718","Mechanized",1,"Sun","weekend","no_sled","2","2","2",7.9,0.1,31,-1,24,25.5,3,1,-1,0,2,3,2,2
"1871",2018-03-18,"Slate River Rd","w1718","Motorized",14,"Sun","weekend","sled","2","2","2",7.9,0.1,31,-1,24,25.5,3,1,-1,0,2,3,2,2
"1872",2018-03-18,"Slate River Rd","w1718","Hybrid",10,"Sun","weekend","sled","2","2","2",7.9,0.1,31,-1,24,25.5,3,1,-1,0,2,3,2,2
"1873",2018-03-19,"Slate River Rd","w1718","Non.motorized",15,"Mon","weekday","no_sled","2","2","1",8,0.1,32,1,19,25,-1,3,1,-1,0,3,4,3
"1874",2018-03-19,"Slate River Rd","w1718","Mechanized",0,"Mon","weekday","no_sled","2","2","1",8,0.1,32,1,19,25,-1,3,1,-1,0,3,4,3
"1875",2018-03-19,"Slate River Rd","w1718","Motorized",14,"Mon","weekday","sled","2","2","1",8,0.1,32,1,19,25,-1,3,1,-1,0,3,4,3
"1876",2018-03-19,"Slate River Rd","w1718","Hybrid",14,"Mon","weekday","sled","2","2","1",8,0.1,32,1,19,25,-1,3,1,-1,0,3,4,3
"1877",2018-03-20,"Slate River Rd","w1718","Non.motorized",40,"Tue","weekday","no_sled","2","2","1",8,0,30,-2,24,26.7,1,-1,3,1,-1,-2,1,2
"1878",2018-03-20,"Slate River Rd","w1718","Mechanized",0,"Tue","weekday","no_sled","2","2","1",8,0,30,-2,24,26.7,1,-1,3,1,-1,-2,1,2
"1879",2018-03-20,"Slate River Rd","w1718","Motorized",10,"Tue","weekday","sled","2","2","1",8,0,30,-2,24,26.7,1,-1,3,1,-1,-2,1,2
"1880",2018-03-20,"Slate River Rd","w1718","Hybrid",10,"Tue","weekday","sled","2","2","1",8,0,30,-2,24,26.7,1,-1,3,1,-1,-2,1,2
"1881",2018-03-21,"Slate River Rd","w1718","Non.motorized",16,"Wed","weekday","no_sled","1","1","1",8.1,0.1,32,2,30,25.3,-2,1,-1,3,0,1,0,3
"1882",2018-03-21,"Slate River Rd","w1718","Mechanized",1,"Wed","weekday","no_sled","1","1","1",8.1,0.1,32,2,30,25.3,-2,1,-1,3,0,1,0,3
"1883",2018-03-21,"Slate River Rd","w1718","Motorized",7,"Wed","weekday","sled","1","1","1",8.1,0.1,32,2,30,25.3,-2,1,-1,3,0,1,0,3
"1884",2018-03-21,"Slate River Rd","w1718","Hybrid",6,"Wed","weekday","sled","1","1","1",8.1,0.1,32,2,30,25.3,-2,1,-1,3,0,1,0,3
"1885",2018-03-22,"Slate River Rd","w1718","Non.motorized",43,"Thu","weekday","no_sled","1","1","1",8.1,0,30,-2,36,27,2,-2,1,-1,0,-2,-1,-2
"1886",2018-03-22,"Slate River Rd","w1718","Mechanized",0,"Thu","weekday","no_sled","1","1","1",8.1,0,30,-2,36,27,2,-2,1,-1,0,-2,-1,-2
"1887",2018-03-22,"Slate River Rd","w1718","Motorized",11,"Thu","weekday","sled","1","1","1",8.1,0,30,-2,36,27,2,-2,1,-1,0,-2,-1,-2
"1888",2018-03-22,"Slate River Rd","w1718","Hybrid",10,"Thu","weekday","sled","1","1","1",8.1,0,30,-2,36,27,2,-2,1,-1,0,-2,-1,-2
"1889",2018-03-23,"Slate River Rd","w1718","Non.motorized",9,"Fri","weekday","no_sled","2","2","3",8.2,0.1,29,-1,34,28.3,-2,2,-2,1,-3,-1,-3,-2
"1890",2018-03-23,"Slate River Rd","w1718","Mechanized",0,"Fri","weekday","no_sled","2","2","3",8.2,0.1,29,-1,34,28.3,-2,2,-2,1,-3,-1,-3,-2
"1891",2018-03-23,"Slate River Rd","w1718","Motorized",2,"Fri","weekday","sled","2","2","3",8.2,0.1,29,-1,34,28.3,-2,2,-2,1,-3,-1,-3,-2
"1892",2018-03-23,"Slate River Rd","w1718","Hybrid",2,"Fri","weekday","sled","2","2","3",8.2,0.1,29,-1,34,28.3,-2,2,-2,1,-3,-1,-3,-2
"1893",2018-03-24,"Slate River Rd","w1718","Non.motorized",43,"Sat","weekend","no_sled","2","2","1",8.9,0.7,34,5,32,26.2,-1,-2,2,-2,4,2,4,2
"1894",2018-03-24,"Slate River Rd","w1718","Mechanized",1,"Sat","weekend","no_sled","2","2","1",8.9,0.7,34,5,32,26.2,-1,-2,2,-2,4,2,4,2
"1895",2018-03-24,"Slate River Rd","w1718","Motorized",3,"Sat","weekend","sled","2","2","1",8.9,0.7,34,5,32,26.2,-1,-2,2,-2,4,2,4,2
"1896",2018-03-24,"Slate River Rd","w1718","Hybrid",3,"Sat","weekend","sled","2","2","1",8.9,0.7,34,5,32,26.2,-1,-2,2,-2,4,2,4,2
"1897",2018-03-25,"Slate River Rd","w1718","Non.motorized",44,"Sun","weekend","no_sled","2","2","1",8.9,0,35,1,35,25.4,5,-1,-2,2,6,5,3,5
"1898",2018-03-25,"Slate River Rd","w1718","Mechanized",0,"Sun","weekend","no_sled","2","2","1",8.9,0,35,1,35,25.4,5,-1,-2,2,6,5,3,5
"1899",2018-03-25,"Slate River Rd","w1718","Motorized",12,"Sun","weekend","sled","2","2","1",8.9,0,35,1,35,25.4,5,-1,-2,2,6,5,3,5
"1900",2018-03-25,"Slate River Rd","w1718","Hybrid",9,"Sun","weekend","sled","2","2","1",8.9,0,35,1,35,25.4,5,-1,-2,2,6,5,3,5
"1901",2018-03-26,"Slate River Rd","w1718","Non.motorized",29,"Mon","weekday","no_sled","1","1","1",8.9,0,34,-1,31,26.2,1,5,-1,-2,0,5,4,2
"1902",2018-03-26,"Slate River Rd","w1718","Non.motorized",29,"Mon","weekday","no_sled","2","1","1",8.9,0,34,-1,31,26.2,1,5,-1,-2,0,5,4,2
"1903",2018-03-26,"Slate River Rd","w1718","Mechanized",0,"Mon","weekday","no_sled","1","1","1",8.9,0,34,-1,31,26.2,1,5,-1,-2,0,5,4,2
"1904",2018-03-26,"Slate River Rd","w1718","Mechanized",0,"Mon","weekday","no_sled","2","1","1",8.9,0,34,-1,31,26.2,1,5,-1,-2,0,5,4,2
"1905",2018-03-26,"Slate River Rd","w1718","Motorized",1,"Mon","weekday","sled","1","1","1",8.9,0,34,-1,31,26.2,1,5,-1,-2,0,5,4,2
"1906",2018-03-26,"Slate River Rd","w1718","Motorized",1,"Mon","weekday","sled","2","1","1",8.9,0,34,-1,31,26.2,1,5,-1,-2,0,5,4,2
"1907",2018-03-26,"Slate River Rd","w1718","Hybrid",1,"Mon","weekday","sled","1","1","1",8.9,0,34,-1,31,26.2,1,5,-1,-2,0,5,4,2
"1908",2018-03-26,"Slate River Rd","w1718","Hybrid",1,"Mon","weekday","sled","2","1","1",8.9,0,34,-1,31,26.2,1,5,-1,-2,0,5,4,2
"1909",2018-03-27,"Slate River Rd","w1718","Non.motorized",30,"Tue","weekday","no_sled","1","1","1",8.9,0,33,-1,29,27,-1,1,5,-1,-2,-1,4,3
"1910",2018-03-27,"Slate River Rd","w1718","Mechanized",0,"Tue","weekday","no_sled","1","1","1",8.9,0,33,-1,29,27,-1,1,5,-1,-2,-1,4,3
"1911",2018-03-27,"Slate River Rd","w1718","Motorized",3,"Tue","weekday","sled","1","1","1",8.9,0,33,-1,29,27,-1,1,5,-1,-2,-1,4,3
"1912",2018-03-27,"Slate River Rd","w1718","Hybrid",1,"Tue","weekday","sled","1","1","1",8.9,0,33,-1,29,27,-1,1,5,-1,-2,-1,4,3
"1913",2018-03-28,"Slate River Rd","w1718","Non.motorized",21,"Wed","weekday","no_sled","1","1","1",8.9,0,33,0,27,27,-1,-1,1,5,-1,-2,-1,4
"1914",2018-03-28,"Slate River Rd","w1718","Mechanized",0,"Wed","weekday","no_sled","1","1","1",8.9,0,33,0,27,27,-1,-1,1,5,-1,-2,-1,4
"1915",2018-03-28,"Slate River Rd","w1718","Motorized",5,"Wed","weekday","sled","1","1","1",8.9,0,33,0,27,27,-1,-1,1,5,-1,-2,-1,4
"1916",2018-03-28,"Slate River Rd","w1718","Hybrid",5,"Wed","weekday","sled","1","1","1",8.9,0,33,0,27,27,-1,-1,1,5,-1,-2,-1,4
"1917",2018-03-29,"Slate River Rd","w1718","Non.motorized",33,"Thu","weekday","no_sled","1","1","1",8.9,0,33,0,27,27,0,-1,-1,1,0,-1,-2,-1
"1918",2018-03-29,"Slate River Rd","w1718","Mechanized",0,"Thu","weekday","no_sled","1","1","1",8.9,0,33,0,27,27,0,-1,-1,1,0,-1,-2,-1
"1919",2018-03-29,"Slate River Rd","w1718","Motorized",5,"Thu","weekday","sled","1","1","1",8.9,0,33,0,27,27,0,-1,-1,1,0,-1,-2,-1
"1920",2018-03-29,"Slate River Rd","w1718","Hybrid",5,"Thu","weekday","sled","1","1","1",8.9,0,33,0,27,27,0,-1,-1,1,0,-1,-2,-1
"1921",2018-03-30,"Slate River Rd","w1718","Non.motorized",22,"Fri","weekday","no_sled","1","1","1",8.9,0,32,-1,33,27.8,0,0,-1,-1,-1,-1,-2,-3
"1922",2018-03-30,"Slate River Rd","w1718","Mechanized",0,"Fri","weekday","no_sled","1","1","1",8.9,0,32,-1,33,27.8,0,0,-1,-1,-1,-1,-2,-3
"1923",2018-03-30,"Slate River Rd","w1718","Motorized",7,"Fri","weekday","sled","1","1","1",8.9,0,32,-1,33,27.8,0,0,-1,-1,-1,-1,-2,-3
"1924",2018-03-30,"Slate River Rd","w1718","Hybrid",7,"Fri","weekday","sled","1","1","1",8.9,0,32,-1,33,27.8,0,0,-1,-1,-1,-1,-2,-3
"1925",2018-03-31,"Slate River Rd","w1718","Non.motorized",34,"Sat","weekend","no_sled","1","1","1",8.9,0,32,0,39,27.8,-1,0,0,-1,-1,-1,-1,-2
"1926",2018-03-31,"Slate River Rd","w1718","Mechanized",0,"Sat","weekend","no_sled","1","1","1",8.9,0,32,0,39,27.8,-1,0,0,-1,-1,-1,-1,-2
"1927",2018-03-31,"Slate River Rd","w1718","Motorized",4,"Sat","weekend","sled","1","1","1",8.9,0,32,0,39,27.8,-1,0,0,-1,-1,-1,-1,-2
"1928",2018-03-31,"Slate River Rd","w1718","Hybrid",4,"Sat","weekend","sled","1","1","1",8.9,0,32,0,39,27.8,-1,0,0,-1,-1,-1,-1,-2
"1929",2018-04-01,"Slate River Rd","w1718","Non.motorized",12,"Sun","weekend","no_sled","1","1","1",8.8,-0.1,30,-2,41,29.3,0,-1,0,0,-2,-3,-3,-3
"1930",2018-04-01,"Slate River Rd","w1718","Mechanized",0,"Sun","weekend","no_sled","1","1","1",8.8,-0.1,30,-2,41,29.3,0,-1,0,0,-2,-3,-3,-3
"1931",2018-04-01,"Slate River Rd","w1718","Motorized",7,"Sun","weekend","sled","1","1","1",8.8,-0.1,30,-2,41,29.3,0,-1,0,0,-2,-3,-3,-3
"1932",2018-04-01,"Slate River Rd","w1718","Hybrid",7,"Sun","weekend","sled","1","1","1",8.8,-0.1,30,-2,41,29.3,0,-1,0,0,-2,-3,-3,-3
"1933",2018-04-02,"Slate River Rd","w1718","Non.motorized",9,"Mon","weekday","no_sled","1","1","1",8.7,-0.1,29,-1,39,30,-2,0,-1,0,-3,-3,-4,-4
"1934",2018-04-02,"Slate River Rd","w1718","Mechanized",0,"Mon","weekday","no_sled","1","1","1",8.7,-0.1,29,-1,39,30,-2,0,-1,0,-3,-3,-4,-4
"1935",2018-04-02,"Slate River Rd","w1718","Motorized",3,"Mon","weekday","sled","1","1","1",8.7,-0.1,29,-1,39,30,-2,0,-1,0,-3,-3,-4,-4
"1936",2018-04-02,"Slate River Rd","w1718","Hybrid",2,"Mon","weekday","sled","1","1","1",8.7,-0.1,29,-1,39,30,-2,0,-1,0,-3,-3,-4,-4
"1937",2018-04-03,"Slate River Rd","w1718","Non.motorized",7,"Tue","weekday","no_sled","1","1","1",8.8,0.1,30,1,27,29.3,-1,-2,0,-1,0,-2,-2,-3
"1938",2018-04-03,"Slate River Rd","w1718","Mechanized",0,"Tue","weekday","no_sled","1","1","1",8.8,0.1,30,1,27,29.3,-1,-2,0,-1,0,-2,-2,-3
"1939",2018-04-03,"Slate River Rd","w1718","Motorized",7,"Tue","weekday","sled","1","1","1",8.8,0.1,30,1,27,29.3,-1,-2,0,-1,0,-2,-2,-3
"1940",2018-04-03,"Slate River Rd","w1718","Hybrid",5,"Tue","weekday","sled","1","1","1",8.8,0.1,30,1,27,29.3,-1,-2,0,-1,0,-2,-2,-3
"1941",2018-04-04,"Slate River Rd","w1718","Non.motorized",6,"Wed","weekday","no_sled","1","2","2",8.9,0.1,28,-2,33,31.8,1,-1,-2,0,-1,-2,-4,-4
"1942",2018-04-04,"Slate River Rd","w1718","Mechanized",1,"Wed","weekday","no_sled","1","2","2",8.9,0.1,28,-2,33,31.8,1,-1,-2,0,-1,-2,-4,-4
"1943",2018-04-04,"Slate River Rd","w1718","Motorized",3,"Wed","weekday","sled","1","2","2",8.9,0.1,28,-2,33,31.8,1,-1,-2,0,-1,-2,-4,-4
"1944",2018-04-04,"Slate River Rd","w1718","Hybrid",2,"Wed","weekday","sled","1","2","2",8.9,0.1,28,-2,33,31.8,1,-1,-2,0,-1,-2,-4,-4
"1945",2018-04-05,"Slate River Rd","w1718","Non.motorized",11,"Thu","weekday","no_sled","1","2","2",8.9,0,27,-1,35,33,-2,1,-1,-2,-3,-2,-3,-5
"1946",2018-04-05,"Slate River Rd","w1718","Mechanized",0,"Thu","weekday","no_sled","1","2","2",8.9,0,27,-1,35,33,-2,1,-1,-2,-3,-2,-3,-5
"1947",2018-04-05,"Slate River Rd","w1718","Motorized",2,"Thu","weekday","sled","1","2","2",8.9,0,27,-1,35,33,-2,1,-1,-2,-3,-2,-3,-5
"1948",2018-04-05,"Slate River Rd","w1718","Hybrid",2,"Thu","weekday","sled","1","2","2",8.9,0,27,-1,35,33,-2,1,-1,-2,-3,-2,-3,-5
"1949",2018-04-06,"Slate River Rd","w1718","Non.motorized",7,"Fri","weekday","no_sled","1","2","2",8.9,0,25,-2,35,35.6,-1,-2,1,-1,-3,-5,-4,-5
"1950",2018-04-06,"Slate River Rd","w1718","Mechanized",0,"Fri","weekday","no_sled","1","2","2",8.9,0,25,-2,35,35.6,-1,-2,1,-1,-3,-5,-4,-5
"1951",2018-04-06,"Slate River Rd","w1718","Motorized",5,"Fri","weekday","sled","1","2","2",8.9,0,25,-2,35,35.6,-1,-2,1,-1,-3,-5,-4,-5
"1952",2018-04-06,"Slate River Rd","w1718","Hybrid",5,"Fri","weekday","sled","1","2","2",8.9,0,25,-2,35,35.6,-1,-2,1,-1,-3,-5,-4,-5
"1953",2018-04-07,"Slate River Rd","w1718","Non.motorized",10,"Sat","weekend","no_sled","2","2","2",9.2,0.3,31,6,37,29.7,-2,-1,-2,1,4,3,1,2
"1954",2018-04-07,"Slate River Rd","w1718","Mechanized",0,"Sat","weekend","no_sled","2","2","2",9.2,0.3,31,6,37,29.7,-2,-1,-2,1,4,3,1,2
"1955",2018-04-07,"Slate River Rd","w1718","Motorized",2,"Sat","weekend","sled","2","2","2",9.2,0.3,31,6,37,29.7,-2,-1,-2,1,4,3,1,2
"1956",2018-04-07,"Slate River Rd","w1718","Hybrid",2,"Sat","weekend","sled","2","2","2",9.2,0.3,31,6,37,29.7,-2,-1,-2,1,4,3,1,2
"1957",2018-04-08,"Slate River Rd","w1718","Non.motorized",7,"Sun","weekend","no_sled","3","3","3",10,0.8,33,2,33,30.3,6,-2,-1,-2,8,6,5,3
"1958",2018-04-08,"Slate River Rd","w1718","Mechanized",0,"Sun","weekend","no_sled","3","3","3",10,0.8,33,2,33,30.3,6,-2,-1,-2,8,6,5,3
"1959",2018-04-08,"Slate River Rd","w1718","Motorized",1,"Sun","weekend","sled","3","3","3",10,0.8,33,2,33,30.3,6,-2,-1,-2,8,6,5,3
"1960",2018-04-08,"Slate River Rd","w1718","Hybrid",1,"Sun","weekend","sled","3","3","3",10,0.8,33,2,33,30.3,6,-2,-1,-2,8,6,5,3
"1961",2018-04-09,"Slate River Rd","w1718","Non.motorized",7,"Mon","weekday","no_sled","1","1","1",10.1,0.1,33,0,31,30.6,2,6,-2,-1,2,8,6,5
"1962",2018-04-09,"Slate River Rd","w1718","Mechanized",0,"Mon","weekday","no_sled","1","1","1",10.1,0.1,33,0,31,30.6,2,6,-2,-1,2,8,6,5
"1963",2018-04-09,"Slate River Rd","w1718","Motorized",0,"Mon","weekday","sled","1","1","1",10.1,0.1,33,0,31,30.6,2,6,-2,-1,2,8,6,5
"1964",2018-04-09,"Slate River Rd","w1718","Hybrid",0,"Mon","weekday","sled","1","1","1",10.1,0.1,33,0,31,30.6,2,6,-2,-1,2,8,6,5
"1965",2018-04-10,"Slate River Rd","w1718","Non.motorized",10,"Tue","weekday","no_sled","1","1","1",10.1,0,31,-2,38,32.6,0,2,6,-2,-2,0,6,4
"1966",2018-04-10,"Slate River Rd","w1718","Mechanized",0,"Tue","weekday","no_sled","1","1","1",10.1,0,31,-2,38,32.6,0,2,6,-2,-2,0,6,4
"1967",2018-04-10,"Slate River Rd","w1718","Motorized",5,"Tue","weekday","sled","1","1","1",10.1,0,31,-2,38,32.6,0,2,6,-2,-2,0,6,4
"1968",2018-04-10,"Slate River Rd","w1718","Hybrid",3,"Tue","weekday","sled","1","1","1",10.1,0,31,-2,38,32.6,0,2,6,-2,-2,0,6,4
"1969",2018-04-11,"Slate River Rd","w1718","Non.motorized",11,"Wed","weekday","no_sled","2","2","2",9.9,-0.2,29,-2,45,34.1,-2,0,2,6,-4,-4,-2,4
"1970",2018-04-11,"Slate River Rd","w1718","Mechanized",0,"Wed","weekday","no_sled","2","2","2",9.9,-0.2,29,-2,45,34.1,-2,0,2,6,-4,-4,-2,4
"1971",2018-04-11,"Slate River Rd","w1718","Motorized",3,"Wed","weekday","sled","2","2","2",9.9,-0.2,29,-2,45,34.1,-2,0,2,6,-4,-4,-2,4
"1972",2018-04-11,"Slate River Rd","w1718","Hybrid",2,"Wed","weekday","sled","2","2","2",9.9,-0.2,29,-2,45,34.1,-2,0,2,6,-4,-4,-2,4
"1973",2018-04-12,"Slate River Rd","w1718","Non.motorized",1,"Thu","weekday","no_sled","1","2","2",9.5,-0.4,28,-1,40,33.9,-2,-2,0,2,-3,-5,-5,-3
"1974",2018-04-12,"Slate River Rd","w1718","Mechanized",0,"Thu","weekday","no_sled","1","2","2",9.5,-0.4,28,-1,40,33.9,-2,-2,0,2,-3,-5,-5,-3
"1975",2018-04-12,"Slate River Rd","w1718","Motorized",0,"Thu","weekday","sled","1","2","2",9.5,-0.4,28,-1,40,33.9,-2,-2,0,2,-3,-5,-5,-3
"1976",2018-04-12,"Slate River Rd","w1718","Hybrid",0,"Thu","weekday","sled","1","2","2",9.5,-0.4,28,-1,40,33.9,-2,-2,0,2,-3,-5,-5,-3
"1977",2018-04-13,"Slate River Rd","w1718","Non.motorized",9,"Fri","weekday","no_sled","2","2","1",9.4,-0.1,26,-2,23,36.2,-1,-2,-2,0,-3,-5,-7,-7
"1978",2018-04-13,"Slate River Rd","w1718","Mechanized",0,"Fri","weekday","no_sled","2","2","1",9.4,-0.1,26,-2,23,36.2,-1,-2,-2,0,-3,-5,-7,-7
"1979",2018-04-13,"Slate River Rd","w1718","Motorized",8,"Fri","weekday","sled","2","2","1",9.4,-0.1,26,-2,23,36.2,-1,-2,-2,0,-3,-5,-7,-7
"1980",2018-04-13,"Slate River Rd","w1718","Hybrid",0,"Fri","weekday","sled","2","2","1",9.4,-0.1,26,-2,23,36.2,-1,-2,-2,0,-3,-5,-7,-7
"1981",2018-04-14,"Slate River Rd","w1718","Non.motorized",20,"Sat","weekend","no_sled","2","2","1",9.4,0,28,2,28,33.6,-2,-1,-2,-2,0,-1,-3,-5
"1982",2018-04-14,"Slate River Rd","w1718","Mechanized",0,"Sat","weekend","no_sled","2","2","1",9.4,0,28,2,28,33.6,-2,-1,-2,-2,0,-1,-3,-5
"1983",2018-04-14,"Slate River Rd","w1718","Motorized",9,"Sat","weekend","sled","2","2","1",9.4,0,28,2,28,33.6,-2,-1,-2,-2,0,-1,-3,-5
"1984",2018-04-14,"Slate River Rd","w1718","Hybrid",5,"Sat","weekend","sled","2","2","1",9.4,0,28,2,28,33.6,-2,-1,-2,-2,0,-1,-3,-5
"1985",2018-04-15,"Slate River Rd","w1718","Non.motorized",10,"Sun","weekend","no_sled","2","2","1",9.2,-0.2,27,-1,37,34.1,2,-2,-1,-2,1,-1,-2,-4
"1986",2018-04-15,"Slate River Rd","w1718","Mechanized",2,"Sun","weekend","no_sled","2","2","1",9.2,-0.2,27,-1,37,34.1,2,-2,-1,-2,1,-1,-2,-4
"1987",2018-04-15,"Slate River Rd","w1718","Motorized",7,"Sun","weekend","sled","2","2","1",9.2,-0.2,27,-1,37,34.1,2,-2,-1,-2,1,-1,-2,-4
"1988",2018-04-15,"Slate River Rd","w1718","Hybrid",2,"Sun","weekend","sled","2","2","1",9.2,-0.2,27,-1,37,34.1,2,-2,-1,-2,1,-1,-2,-4
"1989",2018-04-16,"Slate River Rd","w1718","Non.motorized",5,"Mon","weekday","no_sled",NA,NA,NA,8.9,-0.3,24,-3,43,37.1,-1,2,-2,-1,-4,-2,-4,-5
"1990",2018-04-16,"Slate River Rd","w1718","Mechanized",0,"Mon","weekday","no_sled",NA,NA,NA,8.9,-0.3,24,-3,43,37.1,-1,2,-2,-1,-4,-2,-4,-5
"1991",2018-04-16,"Slate River Rd","w1718","Motorized",3,"Mon","weekday","sled",NA,NA,NA,8.9,-0.3,24,-3,43,37.1,-1,2,-2,-1,-4,-2,-4,-5
"1992",2018-04-16,"Slate River Rd","w1718","Hybrid",2,"Mon","weekday","sled",NA,NA,NA,8.9,-0.3,24,-3,43,37.1,-1,2,-2,-1,-4,-2,-4,-5
"1993",2017-12-22,"Snodgrass","w1718","Non.motorized",0,"Fri","weekday","no_sled","2","2","1",2,0,11,3,17,18.2,0,0,0,0,3,3,3,3
"1994",2017-12-22,"Snodgrass","w1718","Mechanized",0,"Fri","weekday","no_sled","2","2","1",2,0,11,3,17,18.2,0,0,0,0,3,3,3,3
"1995",2017-12-22,"Snodgrass","w1718","Motorized",0,"Fri","weekday","sled","2","2","1",2,0,11,3,17,18.2,0,0,0,0,3,3,3,3
"1996",2017-12-22,"Snodgrass","w1718","Hybrid",NA,"Fri","weekday","sled","2","2","1",2,0,11,3,17,18.2,0,0,0,0,3,3,3,3
"1997",2017-12-23,"Snodgrass","w1718","Non.motorized",0,"Sat","weekend","no_sled","2","1","1",2.1,0.1,10,-1,21,21,3,0,0,0,2,2,2,2
"1998",2017-12-23,"Snodgrass","w1718","Mechanized",0,"Sat","weekend","no_sled","2","1","1",2.1,0.1,10,-1,21,21,3,0,0,0,2,2,2,2
"1999",2017-12-23,"Snodgrass","w1718","Motorized",0,"Sat","weekend","sled","2","1","1",2.1,0.1,10,-1,21,21,3,0,0,0,2,2,2,2
"2000",2017-12-23,"Snodgrass","w1718","Hybrid",NA,"Sat","weekend","sled","2","1","1",2.1,0.1,10,-1,21,21,3,0,0,0,2,2,2,2
"2001",2017-12-24,"Snodgrass","w1718","Non.motorized",0,"Sun","weekend","no_sled","1","1","1",2.4,0.3,14,4,19,17.1,-1,3,0,0,3,6,6,6
"2002",2017-12-24,"Snodgrass","w1718","Mechanized",0,"Sun","weekend","no_sled","1","1","1",2.4,0.3,14,4,19,17.1,-1,3,0,0,3,6,6,6
"2003",2017-12-24,"Snodgrass","w1718","Motorized",0,"Sun","weekend","sled","1","1","1",2.4,0.3,14,4,19,17.1,-1,3,0,0,3,6,6,6
"2004",2017-12-24,"Snodgrass","w1718","Hybrid",NA,"Sun","weekend","sled","1","1","1",2.4,0.3,14,4,19,17.1,-1,3,0,0,3,6,6,6
"2005",2017-12-25,"Snodgrass","w1718","Non.motorized",40,"Mon","weekday","no_sled","2","1","1",2.6,0.2,14,0,25,18.6,4,-1,3,0,4,3,6,6
"2006",2017-12-25,"Snodgrass","w1718","Mechanized",0,"Mon","weekday","no_sled","2","1","1",2.6,0.2,14,0,25,18.6,4,-1,3,0,4,3,6,6
"2007",2017-12-25,"Snodgrass","w1718","Motorized",2,"Mon","weekday","sled","2","1","1",2.6,0.2,14,0,25,18.6,4,-1,3,0,4,3,6,6
"2008",2017-12-25,"Snodgrass","w1718","Hybrid",NA,"Mon","weekday","sled","2","1","1",2.6,0.2,14,0,25,18.6,4,-1,3,0,4,3,6,6
"2009",2017-12-26,"Snodgrass","w1718","Non.motorized",51,"Tue","weekday","no_sled","1","1","1",3.1,0.5,20,6,25,15.5,0,4,-1,3,6,10,9,12
"2010",2017-12-26,"Snodgrass","w1718","Mechanized",0,"Tue","weekday","no_sled","1","1","1",3.1,0.5,20,6,25,15.5,0,4,-1,3,6,10,9,12
"2011",2017-12-26,"Snodgrass","w1718","Motorized",4,"Tue","weekday","sled","1","1","1",3.1,0.5,20,6,25,15.5,0,4,-1,3,6,10,9,12
"2012",2017-12-26,"Snodgrass","w1718","Hybrid",NA,"Tue","weekday","sled","1","1","1",3.1,0.5,20,6,25,15.5,0,4,-1,3,6,10,9,12
"2013",2017-12-27,"Snodgrass","w1718","Non.motorized",97,"Wed","weekday","no_sled","1","1","1",3.1,0,18,-2,27,17.2,6,0,4,-1,4,4,8,7
"2014",2017-12-27,"Snodgrass","w1718","Mechanized",1,"Wed","weekday","no_sled","1","1","1",3.1,0,18,-2,27,17.2,6,0,4,-1,4,4,8,7
"2015",2017-12-27,"Snodgrass","w1718","Motorized",2,"Wed","weekday","sled","1","1","1",3.1,0,18,-2,27,17.2,6,0,4,-1,4,4,8,7
"2016",2017-12-27,"Snodgrass","w1718","Hybrid",NA,"Wed","weekday","sled","1","1","1",3.1,0,18,-2,27,17.2,6,0,4,-1,4,4,8,7
"2017",2017-12-28,"Snodgrass","w1718","Non.motorized",NA,"Thu","weekday","no_sled","1","1","1",3.2,0.1,17,-1,31,18.8,-2,6,0,4,-3,3,3,7
"2018",2017-12-28,"Snodgrass","w1718","Mechanized",NA,"Thu","weekday","no_sled","1","1","1",3.2,0.1,17,-1,31,18.8,-2,6,0,4,-3,3,3,7
"2019",2017-12-28,"Snodgrass","w1718","Motorized",NA,"Thu","weekday","sled","1","1","1",3.2,0.1,17,-1,31,18.8,-2,6,0,4,-3,3,3,7
"2020",2017-12-28,"Snodgrass","w1718","Hybrid",NA,"Thu","weekday","sled","1","1","1",3.2,0.1,17,-1,31,18.8,-2,6,0,4,-3,3,3,7
"2021",2017-12-29,"Snodgrass","w1718","Non.motorized",NA,"Fri","weekday","no_sled","1","1","1",3.2,0,17,0,36,18.8,-1,-2,6,0,-1,-3,3,3
"2022",2017-12-29,"Snodgrass","w1718","Mechanized",NA,"Fri","weekday","no_sled","1","1","1",3.2,0,17,0,36,18.8,-1,-2,6,0,-1,-3,3,3
"2023",2017-12-29,"Snodgrass","w1718","Motorized",NA,"Fri","weekday","sled","1","1","1",3.2,0,17,0,36,18.8,-1,-2,6,0,-1,-3,3,3
"2024",2017-12-29,"Snodgrass","w1718","Hybrid",NA,"Fri","weekday","sled","1","1","1",3.2,0,17,0,36,18.8,-1,-2,6,0,-1,-3,3,3
"2025",2017-12-30,"Snodgrass","w1718","Non.motorized",NA,"Sat","weekend","no_sled","1","1","1",3.2,0,15,-2,37,21.3,0,-1,-2,6,-2,-3,-5,1
"2026",2017-12-30,"Snodgrass","w1718","Mechanized",NA,"Sat","weekend","no_sled","1","1","1",3.2,0,15,-2,37,21.3,0,-1,-2,6,-2,-3,-5,1
"2027",2017-12-30,"Snodgrass","w1718","Motorized",NA,"Sat","weekend","sled","1","1","1",3.2,0,15,-2,37,21.3,0,-1,-2,6,-2,-3,-5,1
"2028",2017-12-30,"Snodgrass","w1718","Hybrid",NA,"Sat","weekend","sled","1","1","1",3.2,0,15,-2,37,21.3,0,-1,-2,6,-2,-3,-5,1
"2029",2017-12-31,"Snodgrass","w1718","Non.motorized",NA,"Sun","weekend","no_sled","1","1","1",3.2,0,15,0,31,21.3,-2,0,-1,-2,-2,-2,-3,-5
"2030",2017-12-31,"Snodgrass","w1718","Mechanized",NA,"Sun","weekend","no_sled","1","1","1",3.2,0,15,0,31,21.3,-2,0,-1,-2,-2,-2,-3,-5
"2031",2017-12-31,"Snodgrass","w1718","Motorized",NA,"Sun","weekend","sled","1","1","1",3.2,0,15,0,31,21.3,-2,0,-1,-2,-2,-2,-3,-5
"2032",2017-12-31,"Snodgrass","w1718","Hybrid",NA,"Sun","weekend","sled","1","1","1",3.2,0,15,0,31,21.3,-2,0,-1,-2,-2,-2,-3,-5
"2033",2018-01-01,"Snodgrass","w1718","Non.motorized",NA,"Mon","weekday","no_sled","1","1","1",3.2,0,15,0,27,21.3,0,-2,0,-1,0,-2,-2,-3
"2034",2018-01-01,"Snodgrass","w1718","Mechanized",NA,"Mon","weekday","no_sled","1","1","1",3.2,0,15,0,27,21.3,0,-2,0,-1,0,-2,-2,-3
"2035",2018-01-01,"Snodgrass","w1718","Motorized",NA,"Mon","weekday","sled","1","1","1",3.2,0,15,0,27,21.3,0,-2,0,-1,0,-2,-2,-3
"2036",2018-01-01,"Snodgrass","w1718","Hybrid",NA,"Mon","weekday","sled","1","1","1",3.2,0,15,0,27,21.3,0,-2,0,-1,0,-2,-2,-3
"2037",2018-01-02,"Snodgrass","w1718","Non.motorized",NA,"Tue","weekday","no_sled","1","1","1",3.2,0,15,0,22,21.3,0,0,-2,0,0,0,-2,-2
"2038",2018-01-02,"Snodgrass","w1718","Mechanized",NA,"Tue","weekday","no_sled","1","1","1",3.2,0,15,0,22,21.3,0,0,-2,0,0,0,-2,-2
"2039",2018-01-02,"Snodgrass","w1718","Motorized",NA,"Tue","weekday","sled","1","1","1",3.2,0,15,0,22,21.3,0,0,-2,0,0,0,-2,-2
"2040",2018-01-02,"Snodgrass","w1718","Hybrid",NA,"Tue","weekday","sled","1","1","1",3.2,0,15,0,22,21.3,0,0,-2,0,0,0,-2,-2
"2041",2018-01-03,"Snodgrass","w1718","Non.motorized",NA,"Wed","weekday","no_sled","1","1","1",3.2,0,15,0,27,21.3,0,0,0,-2,0,0,0,-2
"2042",2018-01-03,"Snodgrass","w1718","Mechanized",NA,"Wed","weekday","no_sled","1","1","1",3.2,0,15,0,27,21.3,0,0,0,-2,0,0,0,-2
"2043",2018-01-03,"Snodgrass","w1718","Motorized",NA,"Wed","weekday","sled","1","1","1",3.2,0,15,0,27,21.3,0,0,0,-2,0,0,0,-2
"2044",2018-01-03,"Snodgrass","w1718","Hybrid",NA,"Wed","weekday","sled","1","1","1",3.2,0,15,0,27,21.3,0,0,0,-2,0,0,0,-2
"2045",2018-01-04,"Snodgrass","w1718","Non.motorized",NA,"Thu","weekday","no_sled","1","1","1",3.2,0,15,0,29,21.3,0,0,0,0,0,0,0,0
"2046",2018-01-04,"Snodgrass","w1718","Mechanized",NA,"Thu","weekday","no_sled","1","1","1",3.2,0,15,0,29,21.3,0,0,0,0,0,0,0,0
"2047",2018-01-04,"Snodgrass","w1718","Motorized",NA,"Thu","weekday","sled","1","1","1",3.2,0,15,0,29,21.3,0,0,0,0,0,0,0,0
"2048",2018-01-04,"Snodgrass","w1718","Hybrid",NA,"Thu","weekday","sled","1","1","1",3.2,0,15,0,29,21.3,0,0,0,0,0,0,0,0
"2049",2018-01-05,"Snodgrass","w1718","Non.motorized",NA,"Fri","weekday","no_sled","1","1","1",3.2,0,14,-1,32,22.9,0,0,0,0,-1,-1,-1,-1
"2050",2018-01-05,"Snodgrass","w1718","Mechanized",NA,"Fri","weekday","no_sled","1","1","1",3.2,0,14,-1,32,22.9,0,0,0,0,-1,-1,-1,-1
"2051",2018-01-05,"Snodgrass","w1718","Motorized",NA,"Fri","weekday","sled","1","1","1",3.2,0,14,-1,32,22.9,0,0,0,0,-1,-1,-1,-1
"2052",2018-01-05,"Snodgrass","w1718","Hybrid",NA,"Fri","weekday","sled","1","1","1",3.2,0,14,-1,32,22.9,0,0,0,0,-1,-1,-1,-1
"2053",2018-01-06,"Snodgrass","w1718","Non.motorized",NA,"Sat","weekend","no_sled","1","1","1",3.2,0,14,0,30,22.9,-1,0,0,0,-1,-1,-1,-1
"2054",2018-01-06,"Snodgrass","w1718","Mechanized",NA,"Sat","weekend","no_sled","1","1","1",3.2,0,14,0,30,22.9,-1,0,0,0,-1,-1,-1,-1
"2055",2018-01-06,"Snodgrass","w1718","Motorized",NA,"Sat","weekend","sled","1","1","1",3.2,0,14,0,30,22.9,-1,0,0,0,-1,-1,-1,-1
"2056",2018-01-06,"Snodgrass","w1718","Hybrid",NA,"Sat","weekend","sled","1","1","1",3.2,0,14,0,30,22.9,-1,0,0,0,-1,-1,-1,-1
"2057",2018-01-07,"Snodgrass","w1718","Non.motorized",NA,"Sun","weekend","no_sled","2","2","2",3.5,0.3,18,4,25,19.4,0,-1,0,0,4,3,3,3
"2058",2018-01-07,"Snodgrass","w1718","Mechanized",NA,"Sun","weekend","no_sled","2","2","2",3.5,0.3,18,4,25,19.4,0,-1,0,0,4,3,3,3
"2059",2018-01-07,"Snodgrass","w1718","Motorized",NA,"Sun","weekend","sled","2","2","2",3.5,0.3,18,4,25,19.4,0,-1,0,0,4,3,3,3
"2060",2018-01-07,"Snodgrass","w1718","Hybrid",NA,"Sun","weekend","sled","2","2","2",3.5,0.3,18,4,25,19.4,0,-1,0,0,4,3,3,3
"2061",2018-01-08,"Snodgrass","w1718","Non.motorized",NA,"Mon","weekday","no_sled","2","2","1",3.7,0.2,20,2,29,18.5,4,0,-1,0,6,6,5,5
"2062",2018-01-08,"Snodgrass","w1718","Mechanized",NA,"Mon","weekday","no_sled","2","2","1",3.7,0.2,20,2,29,18.5,4,0,-1,0,6,6,5,5
"2063",2018-01-08,"Snodgrass","w1718","Motorized",NA,"Mon","weekday","sled","2","2","1",3.7,0.2,20,2,29,18.5,4,0,-1,0,6,6,5,5
"2064",2018-01-08,"Snodgrass","w1718","Hybrid",NA,"Mon","weekday","sled","2","2","1",3.7,0.2,20,2,29,18.5,4,0,-1,0,6,6,5,5
"2065",2018-01-09,"Snodgrass","w1718","Non.motorized",7,"Tue","weekday","no_sled","2","2","1",3.8,0.1,21,1,34,18.1,2,4,0,-1,3,7,7,6
"2066",2018-01-09,"Snodgrass","w1718","Mechanized",0,"Tue","weekday","no_sled","2","2","1",3.8,0.1,21,1,34,18.1,2,4,0,-1,3,7,7,6
"2067",2018-01-09,"Snodgrass","w1718","Motorized",0,"Tue","weekday","sled","2","2","1",3.8,0.1,21,1,34,18.1,2,4,0,-1,3,7,7,6
"2068",2018-01-09,"Snodgrass","w1718","Hybrid",NA,"Tue","weekday","sled","2","2","1",3.8,0.1,21,1,34,18.1,2,4,0,-1,3,7,7,6
"2069",2018-01-10,"Snodgrass","w1718","Non.motorized",73,"Wed","weekday","no_sled","3","3","3",4,0.2,21,0,28,19,1,2,4,0,1,3,7,7
"2070",2018-01-10,"Snodgrass","w1718","Mechanized",0,"Wed","weekday","no_sled","3","3","3",4,0.2,21,0,28,19,1,2,4,0,1,3,7,7
"2071",2018-01-10,"Snodgrass","w1718","Motorized",0,"Wed","weekday","sled","3","3","3",4,0.2,21,0,28,19,1,2,4,0,1,3,7,7
"2072",2018-01-10,"Snodgrass","w1718","Hybrid",NA,"Wed","weekday","sled","3","3","3",4,0.2,21,0,28,19,1,2,4,0,1,3,7,7
"2073",2018-01-11,"Snodgrass","w1718","Non.motorized",55,"Thu","weekday","no_sled","3","3","3",4.1,0.1,26,5,17,15.8,0,1,2,4,5,6,8,12
"2074",2018-01-11,"Snodgrass","w1718","Mechanized",1,"Thu","weekday","no_sled","3","3","3",4.1,0.1,26,5,17,15.8,0,1,2,4,5,6,8,12
"2075",2018-01-11,"Snodgrass","w1718","Motorized",0,"Thu","weekday","sled","3","3","3",4.1,0.1,26,5,17,15.8,0,1,2,4,5,6,8,12
"2076",2018-01-11,"Snodgrass","w1718","Hybrid",NA,"Thu","weekday","sled","3","3","3",4.1,0.1,26,5,17,15.8,0,1,2,4,5,6,8,12
"2077",2018-01-12,"Snodgrass","w1718","Non.motorized",29,"Fri","weekday","no_sled","3","3","3",4.3,0.2,24,-2,22,17.9,5,0,1,2,3,3,4,6
"2078",2018-01-12,"Snodgrass","w1718","Mechanized",0,"Fri","weekday","no_sled","3","3","3",4.3,0.2,24,-2,22,17.9,5,0,1,2,3,3,4,6
"2079",2018-01-12,"Snodgrass","w1718","Motorized",0,"Fri","weekday","sled","3","3","3",4.3,0.2,24,-2,22,17.9,5,0,1,2,3,3,4,6
"2080",2018-01-12,"Snodgrass","w1718","Hybrid",NA,"Fri","weekday","sled","3","3","3",4.3,0.2,24,-2,22,17.9,5,0,1,2,3,3,4,6
"2081",2018-01-13,"Snodgrass","w1718","Non.motorized",106,"Sat","weekend","no_sled","3","3","3",4.4,0.1,24,0,24,18.3,-2,5,0,1,-2,3,3,4
"2082",2018-01-13,"Snodgrass","w1718","Mechanized",0,"Sat","weekend","no_sled","3","3","3",4.4,0.1,24,0,24,18.3,-2,5,0,1,-2,3,3,4
"2083",2018-01-13,"Snodgrass","w1718","Motorized",3,"Sat","weekend","sled","3","3","3",4.4,0.1,24,0,24,18.3,-2,5,0,1,-2,3,3,4
"2084",2018-01-13,"Snodgrass","w1718","Hybrid",NA,"Sat","weekend","sled","3","3","3",4.4,0.1,24,0,24,18.3,-2,5,0,1,-2,3,3,4
"2085",2018-01-14,"Snodgrass","w1718","Non.motorized",151,"Sun","weekend","no_sled","3","3","2",4.4,0,24,0,27,18.3,0,-2,5,0,0,-2,3,3
"2086",2018-01-14,"Snodgrass","w1718","Mechanized",2,"Sun","weekend","no_sled","3","3","2",4.4,0,24,0,27,18.3,0,-2,5,0,0,-2,3,3
"2087",2018-01-14,"Snodgrass","w1718","Motorized",9,"Sun","weekend","sled","3","3","2",4.4,0,24,0,27,18.3,0,-2,5,0,0,-2,3,3
"2088",2018-01-14,"Snodgrass","w1718","Hybrid",NA,"Sun","weekend","sled","3","3","2",4.4,0,24,0,27,18.3,0,-2,5,0,0,-2,3,3
"2089",2018-01-15,"Snodgrass","w1718","Non.motorized",94,"Mon","weekday","no_sled","3","3","2",4.4,0,23,-1,27,19.1,0,0,-2,5,-1,-1,-3,2
"2090",2018-01-15,"Snodgrass","w1718","Mechanized",0,"Mon","weekday","no_sled","3","3","2",4.4,0,23,-1,27,19.1,0,0,-2,5,-1,-1,-3,2
"2091",2018-01-15,"Snodgrass","w1718","Motorized",0,"Mon","weekday","sled","3","3","2",4.4,0,23,-1,27,19.1,0,0,-2,5,-1,-1,-3,2
"2092",2018-01-15,"Snodgrass","w1718","Hybrid",NA,"Mon","weekday","sled","3","3","2",4.4,0,23,-1,27,19.1,0,0,-2,5,-1,-1,-3,2
"2093",2018-01-16,"Snodgrass","w1718","Non.motorized",32,"Tue","weekday","no_sled","3","3","2",4.4,0,22,-1,20,20,-1,0,0,-2,-2,-2,-2,-4
"2094",2018-01-16,"Snodgrass","w1718","Mechanized",0,"Tue","weekday","no_sled","3","3","2",4.4,0,22,-1,20,20,-1,0,0,-2,-2,-2,-2,-4
"2095",2018-01-16,"Snodgrass","w1718","Motorized",0,"Tue","weekday","sled","3","3","2",4.4,0,22,-1,20,20,-1,0,0,-2,-2,-2,-2,-4
"2096",2018-01-16,"Snodgrass","w1718","Hybrid",NA,"Tue","weekday","sled","3","3","2",4.4,0,22,-1,20,20,-1,0,0,-2,-2,-2,-2,-4
"2097",2018-01-17,"Snodgrass","w1718","Non.motorized",70,"Wed","weekday","no_sled","2","2","2",4.4,0,22,0,24,20,-1,-1,0,0,-1,-2,-2,-2
"2098",2018-01-17,"Snodgrass","w1718","Mechanized",0,"Wed","weekday","no_sled","2","2","2",4.4,0,22,0,24,20,-1,-1,0,0,-1,-2,-2,-2
"2099",2018-01-17,"Snodgrass","w1718","Motorized",1,"Wed","weekday","sled","2","2","2",4.4,0,22,0,24,20,-1,-1,0,0,-1,-2,-2,-2
"2100",2018-01-17,"Snodgrass","w1718","Hybrid",NA,"Wed","weekday","sled","2","2","2",4.4,0,22,0,24,20,-1,-1,0,0,-1,-2,-2,-2
"2101",2018-01-18,"Snodgrass","w1718","Non.motorized",88,"Thu","weekday","no_sled","2","2","2",4.4,0,21,-1,29,21,0,-1,-1,0,-1,-2,-3,-3
"2102",2018-01-18,"Snodgrass","w1718","Mechanized",2,"Thu","weekday","no_sled","2","2","2",4.4,0,21,-1,29,21,0,-1,-1,0,-1,-2,-3,-3
"2103",2018-01-18,"Snodgrass","w1718","Motorized",0,"Thu","weekday","sled","2","2","2",4.4,0,21,-1,29,21,0,-1,-1,0,-1,-2,-3,-3
"2104",2018-01-18,"Snodgrass","w1718","Hybrid",NA,"Thu","weekday","sled","2","2","2",4.4,0,21,-1,29,21,0,-1,-1,0,-1,-2,-3,-3
"2105",2018-01-19,"Snodgrass","w1718","Non.motorized",84,"Fri","weekday","no_sled","2","2","2",4.5,0.1,21,0,34,21.4,-1,0,-1,-1,-1,-1,-2,-3
"2106",2018-01-19,"Snodgrass","w1718","Mechanized",1,"Fri","weekday","no_sled","2","2","2",4.5,0.1,21,0,34,21.4,-1,0,-1,-1,-1,-1,-2,-3
"2107",2018-01-19,"Snodgrass","w1718","Motorized",4,"Fri","weekday","sled","2","2","2",4.5,0.1,21,0,34,21.4,-1,0,-1,-1,-1,-1,-2,-3
"2108",2018-01-19,"Snodgrass","w1718","Hybrid",NA,"Fri","weekday","sled","2","2","2",4.5,0.1,21,0,34,21.4,-1,0,-1,-1,-1,-1,-2,-3
"2109",2018-01-20,"Snodgrass","w1718","Non.motorized",118,"Sat","weekend","no_sled","2","2","2",4.5,0,21,0,32,21.4,0,-1,0,-1,0,-1,-1,-2
"2110",2018-01-20,"Snodgrass","w1718","Mechanized",5,"Sat","weekend","no_sled","2","2","2",4.5,0,21,0,32,21.4,0,-1,0,-1,0,-1,-1,-2
"2111",2018-01-20,"Snodgrass","w1718","Motorized",1,"Sat","weekend","sled","2","2","2",4.5,0,21,0,32,21.4,0,-1,0,-1,0,-1,-1,-2
"2112",2018-01-20,"Snodgrass","w1718","Hybrid",NA,"Sat","weekend","sled","2","2","2",4.5,0,21,0,32,21.4,0,-1,0,-1,0,-1,-1,-2
"2113",2018-01-21,"Snodgrass","w1718","Non.motorized",10,"Sun","weekend","no_sled","3","3","3",4.6,0.1,23,2,15,20,0,0,-1,0,2,2,1,1
"2114",2018-01-21,"Snodgrass","w1718","Mechanized",2,"Sun","weekend","no_sled","3","3","3",4.6,0.1,23,2,15,20,0,0,-1,0,2,2,1,1
"2115",2018-01-21,"Snodgrass","w1718","Motorized",1,"Sun","weekend","sled","3","3","3",4.6,0.1,23,2,15,20,0,0,-1,0,2,2,1,1
"2116",2018-01-21,"Snodgrass","w1718","Hybrid",NA,"Sun","weekend","sled","3","3","3",4.6,0.1,23,2,15,20,0,0,-1,0,2,2,1,1
"2117",2018-01-22,"Snodgrass","w1718","Non.motorized",55,"Mon","weekday","no_sled","3","3","3",4.6,0,21,-2,12,21.9,2,0,0,-1,0,0,0,-1
"2118",2018-01-22,"Snodgrass","w1718","Mechanized",1,"Mon","weekday","no_sled","3","3","3",4.6,0,21,-2,12,21.9,2,0,0,-1,0,0,0,-1
"2119",2018-01-22,"Snodgrass","w1718","Motorized",1,"Mon","weekday","sled","3","3","3",4.6,0,21,-2,12,21.9,2,0,0,-1,0,0,0,-1
"2120",2018-01-22,"Snodgrass","w1718","Hybrid",NA,"Mon","weekday","sled","3","3","3",4.6,0,21,-2,12,21.9,2,0,0,-1,0,0,0,-1
"2121",2018-01-23,"Snodgrass","w1718","Non.motorized",41,"Tue","weekday","no_sled","3","3","3",4.6,0,22,1,16,20.9,-2,2,0,0,-1,1,1,1
"2122",2018-01-23,"Snodgrass","w1718","Mechanized",2,"Tue","weekday","no_sled","3","3","3",4.6,0,22,1,16,20.9,-2,2,0,0,-1,1,1,1
"2123",2018-01-23,"Snodgrass","w1718","Motorized",6,"Tue","weekday","sled","3","3","3",4.6,0,22,1,16,20.9,-2,2,0,0,-1,1,1,1
"2124",2018-01-23,"Snodgrass","w1718","Hybrid",NA,"Tue","weekday","sled","3","3","3",4.6,0,22,1,16,20.9,-2,2,0,0,-1,1,1,1
"2125",2018-01-24,"Snodgrass","w1718","Non.motorized",62,"Wed","weekday","no_sled","2","2","2",4.6,0,22,0,22,20.9,1,-2,2,0,1,-1,1,1
"2126",2018-01-24,"Snodgrass","w1718","Mechanized",1,"Wed","weekday","no_sled","2","2","2",4.6,0,22,0,22,20.9,1,-2,2,0,1,-1,1,1
"2127",2018-01-24,"Snodgrass","w1718","Motorized",1,"Wed","weekday","sled","2","2","2",4.6,0,22,0,22,20.9,1,-2,2,0,1,-1,1,1
"2128",2018-01-24,"Snodgrass","w1718","Hybrid",NA,"Wed","weekday","sled","2","2","2",4.6,0,22,0,22,20.9,1,-2,2,0,1,-1,1,1
"2129",2018-01-25,"Snodgrass","w1718","Non.motorized",66,"Thu","weekday","no_sled","2","2","2",4.6,0,22,0,28,20.9,0,1,-2,2,0,1,-1,1
"2130",2018-01-25,"Snodgrass","w1718","Mechanized",10,"Thu","weekday","no_sled","2","2","2",4.6,0,22,0,28,20.9,0,1,-2,2,0,1,-1,1
"2131",2018-01-25,"Snodgrass","w1718","Motorized",1,"Thu","weekday","sled","2","2","2",4.6,0,22,0,28,20.9,0,1,-2,2,0,1,-1,1
"2132",2018-01-25,"Snodgrass","w1718","Hybrid",NA,"Thu","weekday","sled","2","2","2",4.6,0,22,0,28,20.9,0,1,-2,2,0,1,-1,1
"2133",2018-01-26,"Snodgrass","w1718","Non.motorized",29,"Fri","weekday","no_sled","2","2","2",4.7,0.1,22,0,15,21.4,0,0,1,-2,0,0,1,-1
"2134",2018-01-26,"Snodgrass","w1718","Mechanized",7,"Fri","weekday","no_sled","2","2","2",4.7,0.1,22,0,15,21.4,0,0,1,-2,0,0,1,-1
"2135",2018-01-26,"Snodgrass","w1718","Motorized",2,"Fri","weekday","sled","2","2","2",4.7,0.1,22,0,15,21.4,0,0,1,-2,0,0,1,-1
"2136",2018-01-26,"Snodgrass","w1718","Hybrid",NA,"Fri","weekday","sled","2","2","2",4.7,0.1,22,0,15,21.4,0,0,1,-2,0,0,1,-1
"2137",2018-01-27,"Snodgrass","w1718","Non.motorized",493,"Sat","weekend","no_sled","2","2","2",4.7,0,23,1,16,20.4,0,0,0,1,1,1,1,2
"2138",2018-01-27,"Snodgrass","w1718","Mechanized",2,"Sat","weekend","no_sled","2","2","2",4.7,0,23,1,16,20.4,0,0,0,1,1,1,1,2
"2139",2018-01-27,"Snodgrass","w1718","Motorized",0,"Sat","weekend","sled","2","2","2",4.7,0,23,1,16,20.4,0,0,0,1,1,1,1,2
"2140",2018-01-27,"Snodgrass","w1718","Hybrid",NA,"Sat","weekend","sled","2","2","2",4.7,0,23,1,16,20.4,0,0,0,1,1,1,1,2
"2141",2018-01-28,"Snodgrass","w1718","Non.motorized",109,"Sun","weekend","no_sled","2","2","2",4.7,0,23,0,25,20.4,1,0,0,0,1,1,1,1
"2142",2018-01-28,"Snodgrass","w1718","Mechanized",13,"Sun","weekend","no_sled","2","2","2",4.7,0,23,0,25,20.4,1,0,0,0,1,1,1,1
"2143",2018-01-28,"Snodgrass","w1718","Motorized",0,"Sun","weekend","sled","2","2","2",4.7,0,23,0,25,20.4,1,0,0,0,1,1,1,1
"2144",2018-01-28,"Snodgrass","w1718","Hybrid",NA,"Sun","weekend","sled","2","2","2",4.7,0,23,0,25,20.4,1,0,0,0,1,1,1,1
"2145",2018-01-29,"Snodgrass","w1718","Non.motorized",53,"Mon","weekday","no_sled","2","2","2",4.8,0.1,22,-1,30,21.8,0,1,0,0,-1,0,0,0
"2146",2018-01-29,"Snodgrass","w1718","Mechanized",2,"Mon","weekday","no_sled","2","2","2",4.8,0.1,22,-1,30,21.8,0,1,0,0,-1,0,0,0
"2147",2018-01-29,"Snodgrass","w1718","Motorized",0,"Mon","weekday","sled","2","2","2",4.8,0.1,22,-1,30,21.8,0,1,0,0,-1,0,0,0
"2148",2018-01-29,"Snodgrass","w1718","Hybrid",NA,"Mon","weekday","sled","2","2","2",4.8,0.1,22,-1,30,21.8,0,1,0,0,-1,0,0,0
"2149",2018-01-30,"Snodgrass","w1718","Non.motorized",50,"Tue","weekday","no_sled","2","2","2",4.8,0,22,0,34,21.8,-1,0,1,0,-1,-1,0,0
"2150",2018-01-30,"Snodgrass","w1718","Mechanized",2,"Tue","weekday","no_sled","2","2","2",4.8,0,22,0,34,21.8,-1,0,1,0,-1,-1,0,0
"2151",2018-01-30,"Snodgrass","w1718","Motorized",3,"Tue","weekday","sled","2","2","2",4.8,0,22,0,34,21.8,-1,0,1,0,-1,-1,0,0
"2152",2018-01-30,"Snodgrass","w1718","Hybrid",NA,"Tue","weekday","sled","2","2","2",4.8,0,22,0,34,21.8,-1,0,1,0,-1,-1,0,0
"2153",2018-01-31,"Snodgrass","w1718","Non.motorized",31,"Wed","weekday","no_sled","2","2","2",4.8,0,22,0,34,21.8,0,-1,0,1,0,-1,-1,0
"2154",2018-01-31,"Snodgrass","w1718","Mechanized",4,"Wed","weekday","no_sled","2","2","2",4.8,0,22,0,34,21.8,0,-1,0,1,0,-1,-1,0
"2155",2018-01-31,"Snodgrass","w1718","Motorized",1,"Wed","weekday","sled","2","2","2",4.8,0,22,0,34,21.8,0,-1,0,1,0,-1,-1,0
"2156",2018-01-31,"Snodgrass","w1718","Hybrid",NA,"Wed","weekday","sled","2","2","2",4.8,0,22,0,34,21.8,0,-1,0,1,0,-1,-1,0
"2157",2018-02-01,"Snodgrass","w1718","Non.motorized",45,"Thu","weekday","no_sled","2","2","2",4.9,0.1,21,-1,32,23.3,0,0,-1,0,-1,-1,-2,-2
"2158",2018-02-01,"Snodgrass","w1718","Mechanized",4,"Thu","weekday","no_sled","2","2","2",4.9,0.1,21,-1,32,23.3,0,0,-1,0,-1,-1,-2,-2
"2159",2018-02-01,"Snodgrass","w1718","Motorized",0,"Thu","weekday","sled","2","2","2",4.9,0.1,21,-1,32,23.3,0,0,-1,0,-1,-1,-2,-2
"2160",2018-02-01,"Snodgrass","w1718","Hybrid",NA,"Thu","weekday","sled","2","2","2",4.9,0.1,21,-1,32,23.3,0,0,-1,0,-1,-1,-2,-2
"2161",2018-02-02,"Snodgrass","w1718","Non.motorized",49,"Fri","weekday","no_sled","2","2","2",4.9,0,20,-1,33,24.5,-1,0,0,-1,-2,-2,-2,-3
"2162",2018-02-02,"Snodgrass","w1718","Mechanized",4,"Fri","weekday","no_sled","2","2","2",4.9,0,20,-1,33,24.5,-1,0,0,-1,-2,-2,-2,-3
"2163",2018-02-02,"Snodgrass","w1718","Motorized",0,"Fri","weekday","sled","2","2","2",4.9,0,20,-1,33,24.5,-1,0,0,-1,-2,-2,-2,-3
"2164",2018-02-02,"Snodgrass","w1718","Hybrid",NA,"Fri","weekday","sled","2","2","2",4.9,0,20,-1,33,24.5,-1,0,0,-1,-2,-2,-2,-3
"2165",2018-02-03,"Snodgrass","w1718","Non.motorized",97,"Sat","weekend","no_sled","2","2","2",4.9,0,21,1,32,23.3,-1,-1,0,0,0,-1,-1,-1
"2166",2018-02-03,"Snodgrass","w1718","Mechanized",0,"Sat","weekend","no_sled","2","2","2",4.9,0,21,1,32,23.3,-1,-1,0,0,0,-1,-1,-1
"2167",2018-02-03,"Snodgrass","w1718","Motorized",0,"Sat","weekend","sled","2","2","2",4.9,0,21,1,32,23.3,-1,-1,0,0,0,-1,-1,-1
"2168",2018-02-03,"Snodgrass","w1718","Hybrid",NA,"Sat","weekend","sled","2","2","2",4.9,0,21,1,32,23.3,-1,-1,0,0,0,-1,-1,-1
"2169",2018-02-04,"Snodgrass","w1718","Non.motorized",95,"Sun","weekend","no_sled","2","2","2",4.9,0,19,-2,32,25.8,1,-1,-1,0,-1,-2,-3,-3
"2170",2018-02-04,"Snodgrass","w1718","Mechanized",2,"Sun","weekend","no_sled","2","2","2",4.9,0,19,-2,32,25.8,1,-1,-1,0,-1,-2,-3,-3
"2171",2018-02-04,"Snodgrass","w1718","Motorized",1,"Sun","weekend","sled","2","2","2",4.9,0,19,-2,32,25.8,1,-1,-1,0,-1,-2,-3,-3
"2172",2018-02-04,"Snodgrass","w1718","Hybrid",NA,"Sun","weekend","sled","2","2","2",4.9,0,19,-2,32,25.8,1,-1,-1,0,-1,-2,-3,-3
"2173",2018-02-05,"Snodgrass","w1718","Non.motorized",29,"Mon","weekday","no_sled","2","2","2",5,0.1,18,-1,29,27.8,-2,1,-1,-1,-3,-2,-3,-4
"2174",2018-02-05,"Snodgrass","w1718","Mechanized",0,"Mon","weekday","no_sled","2","2","2",5,0.1,18,-1,29,27.8,-2,1,-1,-1,-3,-2,-3,-4
"2175",2018-02-05,"Snodgrass","w1718","Motorized",0,"Mon","weekday","sled","2","2","2",5,0.1,18,-1,29,27.8,-2,1,-1,-1,-3,-2,-3,-4
"2176",2018-02-05,"Snodgrass","w1718","Hybrid",NA,"Mon","weekday","sled","2","2","2",5,0.1,18,-1,29,27.8,-2,1,-1,-1,-3,-2,-3,-4
"2177",2018-02-06,"Snodgrass","w1718","Non.motorized",34,"Tue","weekday","no_sled","2","2","2",5.2,0.2,23,5,22,22.6,-1,-2,1,-1,4,2,3,2
"2178",2018-02-06,"Snodgrass","w1718","Mechanized",0,"Tue","weekday","no_sled","2","2","2",5.2,0.2,23,5,22,22.6,-1,-2,1,-1,4,2,3,2
"2179",2018-02-06,"Snodgrass","w1718","Motorized",0,"Tue","weekday","sled","2","2","2",5.2,0.2,23,5,22,22.6,-1,-2,1,-1,4,2,3,2
"2180",2018-02-06,"Snodgrass","w1718","Hybrid",NA,"Tue","weekday","sled","2","2","2",5.2,0.2,23,5,22,22.6,-1,-2,1,-1,4,2,3,2
"2181",2018-02-07,"Snodgrass","w1718","Non.motorized",62,"Wed","weekday","no_sled","2","2","2",5.2,0,23,0,24,22.6,5,-1,-2,1,5,4,2,3
"2182",2018-02-07,"Snodgrass","w1718","Mechanized",0,"Wed","weekday","no_sled","2","2","2",5.2,0,23,0,24,22.6,5,-1,-2,1,5,4,2,3
"2183",2018-02-07,"Snodgrass","w1718","Motorized",1,"Wed","weekday","sled","2","2","2",5.2,0,23,0,24,22.6,5,-1,-2,1,5,4,2,3
"2184",2018-02-07,"Snodgrass","w1718","Hybrid",NA,"Wed","weekday","sled","2","2","2",5.2,0,23,0,24,22.6,5,-1,-2,1,5,4,2,3
"2185",2018-02-08,"Snodgrass","w1718","Non.motorized",67,"Thu","weekday","no_sled","2","2","1",5.3,0.1,25,2,28,21.2,0,5,-1,-2,2,7,6,4
"2186",2018-02-08,"Snodgrass","w1718","Mechanized",3,"Thu","weekday","no_sled","2","2","1",5.3,0.1,25,2,28,21.2,0,5,-1,-2,2,7,6,4
"2187",2018-02-08,"Snodgrass","w1718","Motorized",1,"Thu","weekday","sled","2","2","1",5.3,0.1,25,2,28,21.2,0,5,-1,-2,2,7,6,4
"2188",2018-02-08,"Snodgrass","w1718","Hybrid",NA,"Thu","weekday","sled","2","2","1",5.3,0.1,25,2,28,21.2,0,5,-1,-2,2,7,6,4
"2189",2018-02-09,"Snodgrass","w1718","Non.motorized",55,"Fri","weekday","no_sled","2","2","1",5.3,0,24,-1,33,22.1,2,0,5,-1,1,1,6,5
"2190",2018-02-09,"Snodgrass","w1718","Mechanized",1,"Fri","weekday","no_sled","2","2","1",5.3,0,24,-1,33,22.1,2,0,5,-1,1,1,6,5
"2191",2018-02-09,"Snodgrass","w1718","Motorized",1,"Fri","weekday","sled","2","2","1",5.3,0,24,-1,33,22.1,2,0,5,-1,1,1,6,5
"2192",2018-02-09,"Snodgrass","w1718","Hybrid",NA,"Fri","weekday","sled","2","2","1",5.3,0,24,-1,33,22.1,2,0,5,-1,1,1,6,5
"2193",2018-02-10,"Snodgrass","w1718","Non.motorized",0,"Sat","weekend","no_sled","3","3","2",5.3,0,24,0,24,22.1,-1,2,0,5,-1,1,1,6
"2194",2018-02-10,"Snodgrass","w1718","Mechanized",0,"Sat","weekend","no_sled","3","3","2",5.3,0,24,0,24,22.1,-1,2,0,5,-1,1,1,6
"2195",2018-02-10,"Snodgrass","w1718","Motorized",0,"Sat","weekend","sled","3","3","2",5.3,0,24,0,24,22.1,-1,2,0,5,-1,1,1,6
"2196",2018-02-10,"Snodgrass","w1718","Hybrid",NA,"Sat","weekend","sled","3","3","2",5.3,0,24,0,24,22.1,-1,2,0,5,-1,1,1,6
"2197",2018-02-11,"Snodgrass","w1718","Non.motorized",87,"Sun","weekend","no_sled","3","3","2",5.6,0.3,27,3,13,20.7,0,-1,2,0,3,2,4,4
"2198",2018-02-11,"Snodgrass","w1718","Mechanized",0,"Sun","weekend","no_sled","3","3","2",5.6,0.3,27,3,13,20.7,0,-1,2,0,3,2,4,4
"2199",2018-02-11,"Snodgrass","w1718","Motorized",3,"Sun","weekend","sled","3","3","2",5.6,0.3,27,3,13,20.7,0,-1,2,0,3,2,4,4
"2200",2018-02-11,"Snodgrass","w1718","Hybrid",NA,"Sun","weekend","sled","3","3","2",5.6,0.3,27,3,13,20.7,0,-1,2,0,3,2,4,4
"2201",2018-02-12,"Snodgrass","w1718","Non.motorized",49,"Mon","weekday","no_sled","3","3","3",5.7,0.1,27,0,23,21.1,3,0,-1,2,3,3,2,4
"2202",2018-02-12,"Snodgrass","w1718","Mechanized",0,"Mon","weekday","no_sled","3","3","3",5.7,0.1,27,0,23,21.1,3,0,-1,2,3,3,2,4
"2203",2018-02-12,"Snodgrass","w1718","Motorized",0,"Mon","weekday","sled","3","3","3",5.7,0.1,27,0,23,21.1,3,0,-1,2,3,3,2,4
"2204",2018-02-12,"Snodgrass","w1718","Hybrid",NA,"Mon","weekday","sled","3","3","3",5.7,0.1,27,0,23,21.1,3,0,-1,2,3,3,2,4
"2205",2018-02-13,"Snodgrass","w1718","Non.motorized",35,"Tue","weekday","no_sled","3","3","3",6.1,0.4,29,2,28,21,0,3,0,-1,2,5,5,4
"2206",2018-02-13,"Snodgrass","w1718","Mechanized",0,"Tue","weekday","no_sled","3","3","3",6.1,0.4,29,2,28,21,0,3,0,-1,2,5,5,4
"2207",2018-02-13,"Snodgrass","w1718","Motorized",0,"Tue","weekday","sled","3","3","3",6.1,0.4,29,2,28,21,0,3,0,-1,2,5,5,4
"2208",2018-02-13,"Snodgrass","w1718","Hybrid",NA,"Tue","weekday","sled","3","3","3",6.1,0.4,29,2,28,21,0,3,0,-1,2,5,5,4
"2209",2018-02-14,"Snodgrass","w1718","Non.motorized",49,"Wed","weekday","no_sled","3","3","3",6.2,0.1,30,1,30,20.7,2,0,3,0,3,3,6,6
"2210",2018-02-14,"Snodgrass","w1718","Mechanized",0,"Wed","weekday","no_sled","3","3","3",6.2,0.1,30,1,30,20.7,2,0,3,0,3,3,6,6
"2211",2018-02-14,"Snodgrass","w1718","Motorized",2,"Wed","weekday","sled","3","3","3",6.2,0.1,30,1,30,20.7,2,0,3,0,3,3,6,6
"2212",2018-02-14,"Snodgrass","w1718","Hybrid",NA,"Wed","weekday","sled","3","3","3",6.2,0.1,30,1,30,20.7,2,0,3,0,3,3,6,6
"2213",2018-02-15,"Snodgrass","w1718","Non.motorized",29,"Thu","weekday","no_sled","3","3","3",6.3,0.1,28,-2,24,22.5,1,2,0,3,-1,1,1,4
"2214",2018-02-15,"Snodgrass","w1718","Mechanized",0,"Thu","weekday","no_sled","3","3","3",6.3,0.1,28,-2,24,22.5,1,2,0,3,-1,1,1,4
"2215",2018-02-15,"Snodgrass","w1718","Motorized",0,"Thu","weekday","sled","3","3","3",6.3,0.1,28,-2,24,22.5,1,2,0,3,-1,1,1,4
"2216",2018-02-15,"Snodgrass","w1718","Hybrid",NA,"Thu","weekday","sled","3","3","3",6.3,0.1,28,-2,24,22.5,1,2,0,3,-1,1,1,4
"2217",2018-02-16,"Snodgrass","w1718","Non.motorized",66,"Fri","weekday","no_sled","3","3","3",6.7,0.4,32,4,18,20.9,-2,1,2,0,2,3,5,5
"2218",2018-02-16,"Snodgrass","w1718","Mechanized",0,"Fri","weekday","no_sled","3","3","3",6.7,0.4,32,4,18,20.9,-2,1,2,0,2,3,5,5
"2219",2018-02-16,"Snodgrass","w1718","Motorized",9,"Fri","weekday","sled","3","3","3",6.7,0.4,32,4,18,20.9,-2,1,2,0,2,3,5,5
"2220",2018-02-16,"Snodgrass","w1718","Hybrid",NA,"Fri","weekday","sled","3","3","3",6.7,0.4,32,4,18,20.9,-2,1,2,0,2,3,5,5
"2221",2018-02-17,"Snodgrass","w1718","Non.motorized",180,"Sat","weekend","no_sled","3","3","2",6.7,0,32,0,25,20.9,4,-2,1,2,4,2,3,5
"2222",2018-02-17,"Snodgrass","w1718","Mechanized",1,"Sat","weekend","no_sled","3","3","2",6.7,0,32,0,25,20.9,4,-2,1,2,4,2,3,5
"2223",2018-02-17,"Snodgrass","w1718","Motorized",6,"Sat","weekend","sled","3","3","2",6.7,0,32,0,25,20.9,4,-2,1,2,4,2,3,5
"2224",2018-02-17,"Snodgrass","w1718","Hybrid",NA,"Sat","weekend","sled","3","3","2",6.7,0,32,0,25,20.9,4,-2,1,2,4,2,3,5
"2225",2018-02-18,"Snodgrass","w1718","Non.motorized",163,"Sun","weekend","no_sled","2","2","2",6.7,0,31,-1,32,21.6,0,4,-2,1,-1,3,1,2
"2226",2018-02-18,"Snodgrass","w1718","Mechanized",2,"Sun","weekend","no_sled","2","2","2",6.7,0,31,-1,32,21.6,0,4,-2,1,-1,3,1,2
"2227",2018-02-18,"Snodgrass","w1718","Motorized",0,"Sun","weekend","sled","2","2","2",6.7,0,31,-1,32,21.6,0,4,-2,1,-1,3,1,2
"2228",2018-02-18,"Snodgrass","w1718","Hybrid",NA,"Sun","weekend","sled","2","2","2",6.7,0,31,-1,32,21.6,0,4,-2,1,-1,3,1,2
"2229",2018-02-19,"Snodgrass","w1718","Non.motorized",59,"Mon","weekday","no_sled","2","2","2",6.8,0.1,29,-2,24,23.4,-1,0,4,-2,-3,-3,1,-1
"2230",2018-02-19,"Snodgrass","w1718","Non.motorized",59,"Mon","weekday","no_sled","3","3","3",6.8,0.1,29,-2,24,23.4,-1,0,4,-2,-3,-3,1,-1
"2231",2018-02-19,"Snodgrass","w1718","Mechanized",1,"Mon","weekday","no_sled","2","2","2",6.8,0.1,29,-2,24,23.4,-1,0,4,-2,-3,-3,1,-1
"2232",2018-02-19,"Snodgrass","w1718","Mechanized",1,"Mon","weekday","no_sled","3","3","3",6.8,0.1,29,-2,24,23.4,-1,0,4,-2,-3,-3,1,-1
"2233",2018-02-19,"Snodgrass","w1718","Motorized",0,"Mon","weekday","sled","2","2","2",6.8,0.1,29,-2,24,23.4,-1,0,4,-2,-3,-3,1,-1
"2234",2018-02-19,"Snodgrass","w1718","Motorized",0,"Mon","weekday","sled","3","3","3",6.8,0.1,29,-2,24,23.4,-1,0,4,-2,-3,-3,1,-1
"2235",2018-02-19,"Snodgrass","w1718","Hybrid",NA,"Mon","weekday","sled","2","2","2",6.8,0.1,29,-2,24,23.4,-1,0,4,-2,-3,-3,1,-1
"2236",2018-02-19,"Snodgrass","w1718","Hybrid",NA,"Mon","weekday","sled","3","3","3",6.8,0.1,29,-2,24,23.4,-1,0,4,-2,-3,-3,1,-1
"2237",2018-02-20,"Snodgrass","w1718","Non.motorized",26,"Tue","weekday","no_sled","3","3","3",6.8,0,31,2,8,21.9,-2,-1,0,4,0,-1,-1,3
"2238",2018-02-20,"Snodgrass","w1718","Mechanized",0,"Tue","weekday","no_sled","3","3","3",6.8,0,31,2,8,21.9,-2,-1,0,4,0,-1,-1,3
"2239",2018-02-20,"Snodgrass","w1718","Motorized",1,"Tue","weekday","sled","3","3","3",6.8,0,31,2,8,21.9,-2,-1,0,4,0,-1,-1,3
"2240",2018-02-20,"Snodgrass","w1718","Hybrid",NA,"Tue","weekday","sled","3","3","3",6.8,0,31,2,8,21.9,-2,-1,0,4,0,-1,-1,3
"2241",2018-02-21,"Snodgrass","w1718","Non.motorized",47,"Wed","weekday","no_sled","3","3","3",6.8,0,31,0,11,21.9,2,-2,-1,0,2,0,-1,-1
"2242",2018-02-21,"Snodgrass","w1718","Mechanized",0,"Wed","weekday","no_sled","3","3","3",6.8,0,31,0,11,21.9,2,-2,-1,0,2,0,-1,-1
"2243",2018-02-21,"Snodgrass","w1718","Motorized",0,"Wed","weekday","sled","3","3","3",6.8,0,31,0,11,21.9,2,-2,-1,0,2,0,-1,-1
"2244",2018-02-21,"Snodgrass","w1718","Hybrid",NA,"Wed","weekday","sled","3","3","3",6.8,0,31,0,11,21.9,2,-2,-1,0,2,0,-1,-1
"2245",2018-02-22,"Snodgrass","w1718","Non.motorized",28,"Thu","weekday","no_sled","3","3","2",6.8,0,30,-1,16,22.7,0,2,-2,-1,-1,1,-1,-2
"2246",2018-02-22,"Snodgrass","w1718","Mechanized",1,"Thu","weekday","no_sled","3","3","2",6.8,0,30,-1,16,22.7,0,2,-2,-1,-1,1,-1,-2
"2247",2018-02-22,"Snodgrass","w1718","Motorized",0,"Thu","weekday","sled","3","3","2",6.8,0,30,-1,16,22.7,0,2,-2,-1,-1,1,-1,-2
"2248",2018-02-22,"Snodgrass","w1718","Hybrid",NA,"Thu","weekday","sled","3","3","2",6.8,0,30,-1,16,22.7,0,2,-2,-1,-1,1,-1,-2
"2249",2018-02-23,"Snodgrass","w1718","Non.motorized",63,"Fri","weekday","no_sled","3","3","2",6.9,0.1,30,0,15,23,-1,0,2,-2,-1,-1,1,-1
"2250",2018-02-23,"Snodgrass","w1718","Mechanized",0,"Fri","weekday","no_sled","3","3","2",6.9,0.1,30,0,15,23,-1,0,2,-2,-1,-1,1,-1
"2251",2018-02-23,"Snodgrass","w1718","Motorized",0,"Fri","weekday","sled","3","3","2",6.9,0.1,30,0,15,23,-1,0,2,-2,-1,-1,1,-1
"2252",2018-02-23,"Snodgrass","w1718","Hybrid",NA,"Fri","weekday","sled","3","3","2",6.9,0.1,30,0,15,23,-1,0,2,-2,-1,-1,1,-1
"2253",2018-02-24,"Snodgrass","w1718","Non.motorized",56,"Sat","weekend","no_sled","3","3","2",6.9,0,31,1,10,22.3,0,-1,0,2,1,0,0,2
"2254",2018-02-24,"Snodgrass","w1718","Mechanized",0,"Sat","weekend","no_sled","3","3","2",6.9,0,31,1,10,22.3,0,-1,0,2,1,0,0,2
"2255",2018-02-24,"Snodgrass","w1718","Motorized",2,"Sat","weekend","sled","3","3","2",6.9,0,31,1,10,22.3,0,-1,0,2,1,0,0,2
"2256",2018-02-24,"Snodgrass","w1718","Hybrid",NA,"Sat","weekend","sled","3","3","2",6.9,0,31,1,10,22.3,0,-1,0,2,1,0,0,2
"2257",2018-02-25,"Snodgrass","w1718","Non.motorized",49,"Sun","weekend","no_sled","3","3","2",7.1,0.2,32,1,11,22.2,1,0,-1,0,2,2,1,1
"2258",2018-02-25,"Snodgrass","w1718","Mechanized",5,"Sun","weekend","no_sled","3","3","2",7.1,0.2,32,1,11,22.2,1,0,-1,0,2,2,1,1
"2259",2018-02-25,"Snodgrass","w1718","Motorized",0,"Sun","weekend","sled","3","3","2",7.1,0.2,32,1,11,22.2,1,0,-1,0,2,2,1,1
"2260",2018-02-25,"Snodgrass","w1718","Hybrid",NA,"Sun","weekend","sled","3","3","2",7.1,0.2,32,1,11,22.2,1,0,-1,0,2,2,1,1
"2261",2018-02-26,"Snodgrass","w1718","Non.motorized",48,"Mon","weekday","no_sled","2","2","2",7.1,0,32,0,20,22.2,1,1,0,-1,1,2,2,1
"2262",2018-02-26,"Snodgrass","w1718","Mechanized",0,"Mon","weekday","no_sled","2","2","2",7.1,0,32,0,20,22.2,1,1,0,-1,1,2,2,1
"2263",2018-02-26,"Snodgrass","w1718","Motorized",7,"Mon","weekday","sled","2","2","2",7.1,0,32,0,20,22.2,1,1,0,-1,1,2,2,1
"2264",2018-02-26,"Snodgrass","w1718","Hybrid",NA,"Mon","weekday","sled","2","2","2",7.1,0,32,0,20,22.2,1,1,0,-1,1,2,2,1
"2265",2018-02-27,"Snodgrass","w1718","Non.motorized",49,"Tue","weekday","no_sled","2","2","2",7.2,0.1,32,0,26,22.5,0,1,1,0,0,1,2,2
"2266",2018-02-27,"Snodgrass","w1718","Mechanized",0,"Tue","weekday","no_sled","2","2","2",7.2,0.1,32,0,26,22.5,0,1,1,0,0,1,2,2
"2267",2018-02-27,"Snodgrass","w1718","Motorized",1,"Tue","weekday","sled","2","2","2",7.2,0.1,32,0,26,22.5,0,1,1,0,0,1,2,2
"2268",2018-02-27,"Snodgrass","w1718","Hybrid",NA,"Tue","weekday","sled","2","2","2",7.2,0.1,32,0,26,22.5,0,1,1,0,0,1,2,2
"2269",2018-02-28,"Snodgrass","w1718","Non.motorized",37,"Wed","weekday","no_sled","2","2","2",7.2,0,31,-1,23,23.2,0,0,1,1,-1,-1,0,1
"2270",2018-02-28,"Snodgrass","w1718","Mechanized",0,"Wed","weekday","no_sled","2","2","2",7.2,0,31,-1,23,23.2,0,0,1,1,-1,-1,0,1
"2271",2018-02-28,"Snodgrass","w1718","Motorized",1,"Wed","weekday","sled","2","2","2",7.2,0,31,-1,23,23.2,0,0,1,1,-1,-1,0,1
"2272",2018-02-28,"Snodgrass","w1718","Hybrid",NA,"Wed","weekday","sled","2","2","2",7.2,0,31,-1,23,23.2,0,0,1,1,-1,-1,0,1
"2273",2018-03-01,"Snodgrass","w1718","Non.motorized",50,"Thu","weekday","no_sled","2","2","2",7.2,0,31,0,24,23.2,-1,0,0,1,-1,-1,-1,0
"2274",2018-03-01,"Snodgrass","w1718","Mechanized",2,"Thu","weekday","no_sled","2","2","2",7.2,0,31,0,24,23.2,-1,0,0,1,-1,-1,-1,0
"2275",2018-03-01,"Snodgrass","w1718","Motorized",1,"Thu","weekday","sled","2","2","2",7.2,0,31,0,24,23.2,-1,0,0,1,-1,-1,-1,0
"2276",2018-03-01,"Snodgrass","w1718","Hybrid",NA,"Thu","weekday","sled","2","2","2",7.2,0,31,0,24,23.2,-1,0,0,1,-1,-1,-1,0
"2277",2018-03-02,"Snodgrass","w1718","Non.motorized",75,"Fri","weekday","no_sled","2","2","1",7.2,0,31,0,30,23.2,0,-1,0,0,0,-1,-1,-1
"2278",2018-03-02,"Snodgrass","w1718","Mechanized",1,"Fri","weekday","no_sled","2","2","1",7.2,0,31,0,30,23.2,0,-1,0,0,0,-1,-1,-1
"2279",2018-03-02,"Snodgrass","w1718","Motorized",3,"Fri","weekday","sled","2","2","1",7.2,0,31,0,30,23.2,0,-1,0,0,0,-1,-1,-1
"2280",2018-03-02,"Snodgrass","w1718","Hybrid",NA,"Fri","weekday","sled","2","2","1",7.2,0,31,0,30,23.2,0,-1,0,0,0,-1,-1,-1
"2281",2018-03-03,"Snodgrass","w1718","Non.motorized",156,"Sat","weekend","no_sled","2","2","1",7.3,0.1,30,-1,34,24.3,0,0,-1,0,-1,-1,-2,-2
"2282",2018-03-03,"Snodgrass","w1718","Mechanized",4,"Sat","weekend","no_sled","2","2","1",7.3,0.1,30,-1,34,24.3,0,0,-1,0,-1,-1,-2,-2
"2283",2018-03-03,"Snodgrass","w1718","Motorized",5,"Sat","weekend","sled","2","2","1",7.3,0.1,30,-1,34,24.3,0,0,-1,0,-1,-1,-2,-2
"2284",2018-03-03,"Snodgrass","w1718","Hybrid",NA,"Sat","weekend","sled","2","2","1",7.3,0.1,30,-1,34,24.3,0,0,-1,0,-1,-1,-2,-2
"2285",2018-03-04,"Snodgrass","w1718","Non.motorized",77,"Sun","weekend","no_sled","2","2","1",7.3,0,29,-1,24,25.2,-1,0,0,-1,-2,-2,-2,-3
"2286",2018-03-04,"Snodgrass","w1718","Mechanized",3,"Sun","weekend","no_sled","2","2","1",7.3,0,29,-1,24,25.2,-1,0,0,-1,-2,-2,-2,-3
"2287",2018-03-04,"Snodgrass","w1718","Motorized",2,"Sun","weekend","sled","2","2","1",7.3,0,29,-1,24,25.2,-1,0,0,-1,-2,-2,-2,-3
"2288",2018-03-04,"Snodgrass","w1718","Hybrid",NA,"Sun","weekend","sled","2","2","1",7.3,0,29,-1,24,25.2,-1,0,0,-1,-2,-2,-2,-3
"2289",2018-03-05,"Snodgrass","w1718","Non.motorized",17,"Mon","weekday","no_sled","2","2","1",7.3,0,31,2,13,23.5,-1,-1,0,0,1,0,0,0
"2290",2018-03-05,"Snodgrass","w1718","Mechanized",0,"Mon","weekday","no_sled","2","2","1",7.3,0,31,2,13,23.5,-1,-1,0,0,1,0,0,0
"2291",2018-03-05,"Snodgrass","w1718","Motorized",0,"Mon","weekday","sled","2","2","1",7.3,0,31,2,13,23.5,-1,-1,0,0,1,0,0,0
"2292",2018-03-05,"Snodgrass","w1718","Hybrid",NA,"Mon","weekday","sled","2","2","1",7.3,0,31,2,13,23.5,-1,-1,0,0,1,0,0,0
"2293",2018-03-06,"Snodgrass","w1718","Non.motorized",50,"Tue","weekday","no_sled","2","2","1",7.3,0,31,0,19,23.5,2,-1,-1,0,2,1,0,0
"2294",2018-03-06,"Snodgrass","w1718","Mechanized",0,"Tue","weekday","no_sled","2","2","1",7.3,0,31,0,19,23.5,2,-1,-1,0,2,1,0,0
"2295",2018-03-06,"Snodgrass","w1718","Motorized",5,"Tue","weekday","sled","2","2","1",7.3,0,31,0,19,23.5,2,-1,-1,0,2,1,0,0
"2296",2018-03-06,"Snodgrass","w1718","Hybrid",NA,"Tue","weekday","sled","2","2","1",7.3,0,31,0,19,23.5,2,-1,-1,0,2,1,0,0
"2297",2018-03-07,"Snodgrass","w1718","Non.motorized",39,"Wed","weekday","no_sled","2","2","1",7.4,0.1,31,0,27,23.9,0,2,-1,-1,0,2,1,0
"2298",2018-03-07,"Snodgrass","w1718","Mechanized",2,"Wed","weekday","no_sled","2","2","1",7.4,0.1,31,0,27,23.9,0,2,-1,-1,0,2,1,0
"2299",2018-03-07,"Snodgrass","w1718","Motorized",0,"Wed","weekday","sled","2","2","1",7.4,0.1,31,0,27,23.9,0,2,-1,-1,0,2,1,0
"2300",2018-03-07,"Snodgrass","w1718","Hybrid",NA,"Wed","weekday","sled","2","2","1",7.4,0.1,31,0,27,23.9,0,2,-1,-1,0,2,1,0
"2301",2018-03-08,"Snodgrass","w1718","Non.motorized",39,"Thu","weekday","no_sled","2","2","1",7.4,0,30,-1,33,24.7,0,0,2,-1,-1,-1,1,0
"2302",2018-03-08,"Snodgrass","w1718","Mechanized",0,"Thu","weekday","no_sled","2","2","1",7.4,0,30,-1,33,24.7,0,0,2,-1,-1,-1,1,0
"2303",2018-03-08,"Snodgrass","w1718","Motorized",0,"Thu","weekday","sled","2","2","1",7.4,0,30,-1,33,24.7,0,0,2,-1,-1,-1,1,0
"2304",2018-03-08,"Snodgrass","w1718","Hybrid",NA,"Thu","weekday","sled","2","2","1",7.4,0,30,-1,33,24.7,0,0,2,-1,-1,-1,1,0
"2305",2018-03-09,"Snodgrass","w1718","Non.motorized",50,"Fri","weekday","no_sled","2","2","1",7.4,0,30,0,34,24.7,-1,0,0,2,-1,-1,-1,1
"2306",2018-03-09,"Snodgrass","w1718","Mechanized",0,"Fri","weekday","no_sled","2","2","1",7.4,0,30,0,34,24.7,-1,0,0,2,-1,-1,-1,1
"2307",2018-03-09,"Snodgrass","w1718","Motorized",1,"Fri","weekday","sled","2","2","1",7.4,0,30,0,34,24.7,-1,0,0,2,-1,-1,-1,1
"2308",2018-03-09,"Snodgrass","w1718","Hybrid",NA,"Fri","weekday","sled","2","2","1",7.4,0,30,0,34,24.7,-1,0,0,2,-1,-1,-1,1
"2309",2018-03-10,"Snodgrass","w1718","Non.motorized",64,"Sat","weekend","no_sled","1","1","1",7.4,0,30,0,31,24.7,0,-1,0,0,0,-1,-1,-1
"2310",2018-03-10,"Snodgrass","w1718","Mechanized",3,"Sat","weekend","no_sled","1","1","1",7.4,0,30,0,31,24.7,0,-1,0,0,0,-1,-1,-1
"2311",2018-03-10,"Snodgrass","w1718","Motorized",1,"Sat","weekend","sled","1","1","1",7.4,0,30,0,31,24.7,0,-1,0,0,0,-1,-1,-1
"2312",2018-03-10,"Snodgrass","w1718","Hybrid",NA,"Sat","weekend","sled","1","1","1",7.4,0,30,0,31,24.7,0,-1,0,0,0,-1,-1,-1
"2313",2018-03-11,"Snodgrass","w1718","Non.motorized",60,"Sun","weekend","no_sled","1","1","1",7.4,0,29,-1,31,25.5,0,0,-1,0,-1,-1,-2,-2
"2314",2018-03-11,"Snodgrass","w1718","Mechanized",4,"Sun","weekend","no_sled","1","1","1",7.4,0,29,-1,31,25.5,0,0,-1,0,-1,-1,-2,-2
"2315",2018-03-11,"Snodgrass","w1718","Motorized",13,"Sun","weekend","sled","1","1","1",7.4,0,29,-1,31,25.5,0,0,-1,0,-1,-1,-2,-2
"2316",2018-03-11,"Snodgrass","w1718","Hybrid",NA,"Sun","weekend","sled","1","1","1",7.4,0,29,-1,31,25.5,0,0,-1,0,-1,-1,-2,-2
"2317",2018-03-12,"Snodgrass","w1718","Non.motorized",46,"Mon","weekday","no_sled","1","1","1",7.4,0,29,0,33,25.5,-1,0,0,-1,-1,-1,-1,-2
"2318",2018-03-12,"Snodgrass","w1718","Mechanized",1,"Mon","weekday","no_sled","1","1","1",7.4,0,29,0,33,25.5,-1,0,0,-1,-1,-1,-1,-2
"2319",2018-03-12,"Snodgrass","w1718","Motorized",0,"Mon","weekday","sled","1","1","1",7.4,0,29,0,33,25.5,-1,0,0,-1,-1,-1,-1,-2
"2320",2018-03-12,"Snodgrass","w1718","Hybrid",NA,"Mon","weekday","sled","1","1","1",7.4,0,29,0,33,25.5,-1,0,0,-1,-1,-1,-1,-2
"2321",2018-03-13,"Snodgrass","w1718","Non.motorized",55,"Tue","weekday","no_sled","1","1","1",7.4,0,29,0,34,25.5,0,-1,0,0,0,-1,-1,-1
"2322",2018-03-13,"Snodgrass","w1718","Mechanized",2,"Tue","weekday","no_sled","1","1","1",7.4,0,29,0,34,25.5,0,-1,0,0,0,-1,-1,-1
"2323",2018-03-13,"Snodgrass","w1718","Motorized",12,"Tue","weekday","sled","1","1","1",7.4,0,29,0,34,25.5,0,-1,0,0,0,-1,-1,-1
"2324",2018-03-13,"Snodgrass","w1718","Hybrid",NA,"Tue","weekday","sled","1","1","1",7.4,0,29,0,34,25.5,0,-1,0,0,0,-1,-1,-1
"2325",2018-03-14,"Snodgrass","w1718","Non.motorized",41,"Wed","weekday","no_sled","1","2","2",7.4,0,29,0,39,25.5,0,0,-1,0,0,0,-1,-1
"2326",2018-03-14,"Snodgrass","w1718","Mechanized",4,"Wed","weekday","no_sled","1","2","2",7.4,0,29,0,39,25.5,0,0,-1,0,0,0,-1,-1
"2327",2018-03-14,"Snodgrass","w1718","Motorized",6,"Wed","weekday","sled","1","2","2",7.4,0,29,0,39,25.5,0,0,-1,0,0,0,-1,-1
"2328",2018-03-14,"Snodgrass","w1718","Hybrid",NA,"Wed","weekday","sled","1","2","2",7.4,0,29,0,39,25.5,0,0,-1,0,0,0,-1,-1
"2329",2018-03-15,"Snodgrass","w1718","Non.motorized",26,"Thu","weekday","no_sled","2","2","2",7.5,0.1,28,-1,31,26.8,0,0,0,-1,-1,-1,-1,-2
"2330",2018-03-15,"Snodgrass","w1718","Mechanized",0,"Thu","weekday","no_sled","2","2","2",7.5,0.1,28,-1,31,26.8,0,0,0,-1,-1,-1,-1,-2
"2331",2018-03-15,"Snodgrass","w1718","Motorized",2,"Thu","weekday","sled","2","2","2",7.5,0.1,28,-1,31,26.8,0,0,0,-1,-1,-1,-1,-2
"2332",2018-03-15,"Snodgrass","w1718","Hybrid",NA,"Thu","weekday","sled","2","2","2",7.5,0.1,28,-1,31,26.8,0,0,0,-1,-1,-1,-1,-2
"2333",2018-03-16,"Snodgrass","w1718","Non.motorized",49,"Fri","weekday","no_sled","2","2","2",7.7,0.2,29,1,25,26.6,-1,0,0,0,0,0,0,0
"2334",2018-03-16,"Snodgrass","w1718","Mechanized",0,"Fri","weekday","no_sled","2","2","2",7.7,0.2,29,1,25,26.6,-1,0,0,0,0,0,0,0
"2335",2018-03-16,"Snodgrass","w1718","Motorized",1,"Fri","weekday","sled","2","2","2",7.7,0.2,29,1,25,26.6,-1,0,0,0,0,0,0,0
"2336",2018-03-16,"Snodgrass","w1718","Hybrid",NA,"Fri","weekday","sled","2","2","2",7.7,0.2,29,1,25,26.6,-1,0,0,0,0,0,0,0
"2337",2018-03-17,"Snodgrass","w1718","Non.motorized",85,"Sat","weekend","no_sled","2","2","2",7.8,0.1,32,3,29,24.4,1,-1,0,0,4,3,3,3
"2338",2018-03-17,"Snodgrass","w1718","Mechanized",0,"Sat","weekend","no_sled","2","2","2",7.8,0.1,32,3,29,24.4,1,-1,0,0,4,3,3,3
"2339",2018-03-17,"Snodgrass","w1718","Motorized",0,"Sat","weekend","sled","2","2","2",7.8,0.1,32,3,29,24.4,1,-1,0,0,4,3,3,3
"2340",2018-03-17,"Snodgrass","w1718","Hybrid",NA,"Sat","weekend","sled","2","2","2",7.8,0.1,32,3,29,24.4,1,-1,0,0,4,3,3,3
"2341",2018-03-18,"Snodgrass","w1718","Non.motorized",48,"Sun","weekend","no_sled","2","2","2",7.9,0.1,31,-1,24,25.5,3,1,-1,0,2,3,2,2
"2342",2018-03-18,"Snodgrass","w1718","Mechanized",0,"Sun","weekend","no_sled","2","2","2",7.9,0.1,31,-1,24,25.5,3,1,-1,0,2,3,2,2
"2343",2018-03-18,"Snodgrass","w1718","Motorized",0,"Sun","weekend","sled","2","2","2",7.9,0.1,31,-1,24,25.5,3,1,-1,0,2,3,2,2
"2344",2018-03-18,"Snodgrass","w1718","Hybrid",NA,"Sun","weekend","sled","2","2","2",7.9,0.1,31,-1,24,25.5,3,1,-1,0,2,3,2,2
"2345",2018-03-19,"Snodgrass","w1718","Non.motorized",38,"Mon","weekday","no_sled","2","2","1",8,0.1,32,1,19,25,-1,3,1,-1,0,3,4,3
"2346",2018-03-19,"Snodgrass","w1718","Mechanized",0,"Mon","weekday","no_sled","2","2","1",8,0.1,32,1,19,25,-1,3,1,-1,0,3,4,3
"2347",2018-03-19,"Snodgrass","w1718","Motorized",1,"Mon","weekday","sled","2","2","1",8,0.1,32,1,19,25,-1,3,1,-1,0,3,4,3
"2348",2018-03-19,"Snodgrass","w1718","Hybrid",NA,"Mon","weekday","sled","2","2","1",8,0.1,32,1,19,25,-1,3,1,-1,0,3,4,3
"2349",2018-03-20,"Snodgrass","w1718","Non.motorized",42,"Tue","weekday","no_sled","2","2","1",8,0,30,-2,24,26.7,1,-1,3,1,-1,-2,1,2
"2350",2018-03-20,"Snodgrass","w1718","Mechanized",0,"Tue","weekday","no_sled","2","2","1",8,0,30,-2,24,26.7,1,-1,3,1,-1,-2,1,2
"2351",2018-03-20,"Snodgrass","w1718","Motorized",0,"Tue","weekday","sled","2","2","1",8,0,30,-2,24,26.7,1,-1,3,1,-1,-2,1,2
"2352",2018-03-20,"Snodgrass","w1718","Hybrid",NA,"Tue","weekday","sled","2","2","1",8,0,30,-2,24,26.7,1,-1,3,1,-1,-2,1,2
"2353",2018-03-21,"Snodgrass","w1718","Non.motorized",29,"Wed","weekday","no_sled","1","1","1",8.1,0.1,32,2,30,25.3,-2,1,-1,3,0,1,0,3
"2354",2018-03-21,"Snodgrass","w1718","Mechanized",0,"Wed","weekday","no_sled","1","1","1",8.1,0.1,32,2,30,25.3,-2,1,-1,3,0,1,0,3
"2355",2018-03-21,"Snodgrass","w1718","Motorized",0,"Wed","weekday","sled","1","1","1",8.1,0.1,32,2,30,25.3,-2,1,-1,3,0,1,0,3
"2356",2018-03-21,"Snodgrass","w1718","Hybrid",NA,"Wed","weekday","sled","1","1","1",8.1,0.1,32,2,30,25.3,-2,1,-1,3,0,1,0,3
"2357",2018-03-22,"Snodgrass","w1718","Non.motorized",37,"Thu","weekday","no_sled","1","1","1",8.1,0,30,-2,36,27,2,-2,1,-1,0,-2,-1,-2
"2358",2018-03-22,"Snodgrass","w1718","Mechanized",0,"Thu","weekday","no_sled","1","1","1",8.1,0,30,-2,36,27,2,-2,1,-1,0,-2,-1,-2
"2359",2018-03-22,"Snodgrass","w1718","Motorized",0,"Thu","weekday","sled","1","1","1",8.1,0,30,-2,36,27,2,-2,1,-1,0,-2,-1,-2
"2360",2018-03-22,"Snodgrass","w1718","Hybrid",NA,"Thu","weekday","sled","1","1","1",8.1,0,30,-2,36,27,2,-2,1,-1,0,-2,-1,-2
"2361",2018-03-23,"Snodgrass","w1718","Non.motorized",5,"Fri","weekday","no_sled","2","2","3",8.2,0.1,29,-1,34,28.3,-2,2,-2,1,-3,-1,-3,-2
"2362",2018-03-23,"Snodgrass","w1718","Mechanized",0,"Fri","weekday","no_sled","2","2","3",8.2,0.1,29,-1,34,28.3,-2,2,-2,1,-3,-1,-3,-2
"2363",2018-03-23,"Snodgrass","w1718","Motorized",0,"Fri","weekday","sled","2","2","3",8.2,0.1,29,-1,34,28.3,-2,2,-2,1,-3,-1,-3,-2
"2364",2018-03-23,"Snodgrass","w1718","Hybrid",NA,"Fri","weekday","sled","2","2","3",8.2,0.1,29,-1,34,28.3,-2,2,-2,1,-3,-1,-3,-2
"2365",2018-03-24,"Snodgrass","w1718","Non.motorized",75,"Sat","weekend","no_sled","2","2","1",8.9,0.7,34,5,32,26.2,-1,-2,2,-2,4,2,4,2
"2366",2018-03-24,"Snodgrass","w1718","Mechanized",6,"Sat","weekend","no_sled","2","2","1",8.9,0.7,34,5,32,26.2,-1,-2,2,-2,4,2,4,2
"2367",2018-03-24,"Snodgrass","w1718","Motorized",2,"Sat","weekend","sled","2","2","1",8.9,0.7,34,5,32,26.2,-1,-2,2,-2,4,2,4,2
"2368",2018-03-24,"Snodgrass","w1718","Hybrid",NA,"Sat","weekend","sled","2","2","1",8.9,0.7,34,5,32,26.2,-1,-2,2,-2,4,2,4,2
"2369",2018-03-25,"Snodgrass","w1718","Non.motorized",56,"Sun","weekend","no_sled","2","2","1",8.9,0,35,1,35,25.4,5,-1,-2,2,6,5,3,5
"2370",2018-03-25,"Snodgrass","w1718","Mechanized",0,"Sun","weekend","no_sled","2","2","1",8.9,0,35,1,35,25.4,5,-1,-2,2,6,5,3,5
"2371",2018-03-25,"Snodgrass","w1718","Motorized",4,"Sun","weekend","sled","2","2","1",8.9,0,35,1,35,25.4,5,-1,-2,2,6,5,3,5
"2372",2018-03-25,"Snodgrass","w1718","Hybrid",NA,"Sun","weekend","sled","2","2","1",8.9,0,35,1,35,25.4,5,-1,-2,2,6,5,3,5
"2373",2018-03-26,"Snodgrass","w1718","Non.motorized",44,"Mon","weekday","no_sled","1","1","1",8.9,0,34,-1,31,26.2,1,5,-1,-2,0,5,4,2
"2374",2018-03-26,"Snodgrass","w1718","Non.motorized",44,"Mon","weekday","no_sled","2","1","1",8.9,0,34,-1,31,26.2,1,5,-1,-2,0,5,4,2
"2375",2018-03-26,"Snodgrass","w1718","Mechanized",4,"Mon","weekday","no_sled","1","1","1",8.9,0,34,-1,31,26.2,1,5,-1,-2,0,5,4,2
"2376",2018-03-26,"Snodgrass","w1718","Mechanized",4,"Mon","weekday","no_sled","2","1","1",8.9,0,34,-1,31,26.2,1,5,-1,-2,0,5,4,2
"2377",2018-03-26,"Snodgrass","w1718","Motorized",2,"Mon","weekday","sled","1","1","1",8.9,0,34,-1,31,26.2,1,5,-1,-2,0,5,4,2
"2378",2018-03-26,"Snodgrass","w1718","Motorized",2,"Mon","weekday","sled","2","1","1",8.9,0,34,-1,31,26.2,1,5,-1,-2,0,5,4,2
"2379",2018-03-26,"Snodgrass","w1718","Hybrid",NA,"Mon","weekday","sled","1","1","1",8.9,0,34,-1,31,26.2,1,5,-1,-2,0,5,4,2
"2380",2018-03-26,"Snodgrass","w1718","Hybrid",NA,"Mon","weekday","sled","2","1","1",8.9,0,34,-1,31,26.2,1,5,-1,-2,0,5,4,2
"2381",2018-03-27,"Snodgrass","w1718","Non.motorized",24,"Tue","weekday","no_sled","1","1","1",8.9,0,33,-1,29,27,-1,1,5,-1,-2,-1,4,3
"2382",2018-03-27,"Snodgrass","w1718","Mechanized",1,"Tue","weekday","no_sled","1","1","1",8.9,0,33,-1,29,27,-1,1,5,-1,-2,-1,4,3
"2383",2018-03-27,"Snodgrass","w1718","Motorized",4,"Tue","weekday","sled","1","1","1",8.9,0,33,-1,29,27,-1,1,5,-1,-2,-1,4,3
"2384",2018-03-27,"Snodgrass","w1718","Hybrid",NA,"Tue","weekday","sled","1","1","1",8.9,0,33,-1,29,27,-1,1,5,-1,-2,-1,4,3
"2385",2018-03-28,"Snodgrass","w1718","Non.motorized",34,"Wed","weekday","no_sled","1","1","1",8.9,0,33,0,27,27,-1,-1,1,5,-1,-2,-1,4
"2386",2018-03-28,"Snodgrass","w1718","Mechanized",0,"Wed","weekday","no_sled","1","1","1",8.9,0,33,0,27,27,-1,-1,1,5,-1,-2,-1,4
"2387",2018-03-28,"Snodgrass","w1718","Motorized",0,"Wed","weekday","sled","1","1","1",8.9,0,33,0,27,27,-1,-1,1,5,-1,-2,-1,4
"2388",2018-03-28,"Snodgrass","w1718","Hybrid",NA,"Wed","weekday","sled","1","1","1",8.9,0,33,0,27,27,-1,-1,1,5,-1,-2,-1,4
"2389",2018-03-29,"Snodgrass","w1718","Non.motorized",33,"Thu","weekday","no_sled","1","1","1",8.9,0,33,0,27,27,0,-1,-1,1,0,-1,-2,-1
"2390",2018-03-29,"Snodgrass","w1718","Mechanized",0,"Thu","weekday","no_sled","1","1","1",8.9,0,33,0,27,27,0,-1,-1,1,0,-1,-2,-1
"2391",2018-03-29,"Snodgrass","w1718","Motorized",1,"Thu","weekday","sled","1","1","1",8.9,0,33,0,27,27,0,-1,-1,1,0,-1,-2,-1
"2392",2018-03-29,"Snodgrass","w1718","Hybrid",NA,"Thu","weekday","sled","1","1","1",8.9,0,33,0,27,27,0,-1,-1,1,0,-1,-2,-1
"2393",2018-03-30,"Snodgrass","w1718","Non.motorized",39,"Fri","weekday","no_sled","1","1","1",8.9,0,32,-1,33,27.8,0,0,-1,-1,-1,-1,-2,-3
"2394",2018-03-30,"Snodgrass","w1718","Mechanized",0,"Fri","weekday","no_sled","1","1","1",8.9,0,32,-1,33,27.8,0,0,-1,-1,-1,-1,-2,-3
"2395",2018-03-30,"Snodgrass","w1718","Motorized",2,"Fri","weekday","sled","1","1","1",8.9,0,32,-1,33,27.8,0,0,-1,-1,-1,-1,-2,-3
"2396",2018-03-30,"Snodgrass","w1718","Hybrid",NA,"Fri","weekday","sled","1","1","1",8.9,0,32,-1,33,27.8,0,0,-1,-1,-1,-1,-2,-3
"2397",2018-03-31,"Snodgrass","w1718","Non.motorized",63,"Sat","weekend","no_sled","1","1","1",8.9,0,32,0,39,27.8,-1,0,0,-1,-1,-1,-1,-2
"2398",2018-03-31,"Snodgrass","w1718","Mechanized",0,"Sat","weekend","no_sled","1","1","1",8.9,0,32,0,39,27.8,-1,0,0,-1,-1,-1,-1,-2
"2399",2018-03-31,"Snodgrass","w1718","Motorized",0,"Sat","weekend","sled","1","1","1",8.9,0,32,0,39,27.8,-1,0,0,-1,-1,-1,-1,-2
"2400",2018-03-31,"Snodgrass","w1718","Hybrid",NA,"Sat","weekend","sled","1","1","1",8.9,0,32,0,39,27.8,-1,0,0,-1,-1,-1,-1,-2
"2401",2018-04-01,"Snodgrass","w1718","Non.motorized",41,"Sun","weekend","no_sled","1","1","1",8.8,-0.1,30,-2,41,29.3,0,-1,0,0,-2,-3,-3,-3
"2402",2018-04-01,"Snodgrass","w1718","Mechanized",1,"Sun","weekend","no_sled","1","1","1",8.8,-0.1,30,-2,41,29.3,0,-1,0,0,-2,-3,-3,-3
"2403",2018-04-01,"Snodgrass","w1718","Motorized",2,"Sun","weekend","sled","1","1","1",8.8,-0.1,30,-2,41,29.3,0,-1,0,0,-2,-3,-3,-3
"2404",2018-04-01,"Snodgrass","w1718","Hybrid",NA,"Sun","weekend","sled","1","1","1",8.8,-0.1,30,-2,41,29.3,0,-1,0,0,-2,-3,-3,-3
"2405",2018-04-02,"Snodgrass","w1718","Non.motorized",10,"Mon","weekday","no_sled","1","1","1",8.7,-0.1,29,-1,39,30,-2,0,-1,0,-3,-3,-4,-4
"2406",2018-04-02,"Snodgrass","w1718","Mechanized",0,"Mon","weekday","no_sled","1","1","1",8.7,-0.1,29,-1,39,30,-2,0,-1,0,-3,-3,-4,-4
"2407",2018-04-02,"Snodgrass","w1718","Motorized",0,"Mon","weekday","sled","1","1","1",8.7,-0.1,29,-1,39,30,-2,0,-1,0,-3,-3,-4,-4
"2408",2018-04-02,"Snodgrass","w1718","Hybrid",NA,"Mon","weekday","sled","1","1","1",8.7,-0.1,29,-1,39,30,-2,0,-1,0,-3,-3,-4,-4
"2409",2018-04-03,"Snodgrass","w1718","Non.motorized",16,"Tue","weekday","no_sled","1","1","1",8.8,0.1,30,1,27,29.3,-1,-2,0,-1,0,-2,-2,-3
"2410",2018-04-03,"Snodgrass","w1718","Mechanized",0,"Tue","weekday","no_sled","1","1","1",8.8,0.1,30,1,27,29.3,-1,-2,0,-1,0,-2,-2,-3
"2411",2018-04-03,"Snodgrass","w1718","Motorized",0,"Tue","weekday","sled","1","1","1",8.8,0.1,30,1,27,29.3,-1,-2,0,-1,0,-2,-2,-3
"2412",2018-04-03,"Snodgrass","w1718","Hybrid",NA,"Tue","weekday","sled","1","1","1",8.8,0.1,30,1,27,29.3,-1,-2,0,-1,0,-2,-2,-3
"2413",2018-04-04,"Snodgrass","w1718","Non.motorized",27,"Wed","weekday","no_sled","1","2","2",8.9,0.1,28,-2,33,31.8,1,-1,-2,0,-1,-2,-4,-4
"2414",2018-04-04,"Snodgrass","w1718","Mechanized",0,"Wed","weekday","no_sled","1","2","2",8.9,0.1,28,-2,33,31.8,1,-1,-2,0,-1,-2,-4,-4
"2415",2018-04-04,"Snodgrass","w1718","Motorized",0,"Wed","weekday","sled","1","2","2",8.9,0.1,28,-2,33,31.8,1,-1,-2,0,-1,-2,-4,-4
"2416",2018-04-04,"Snodgrass","w1718","Hybrid",NA,"Wed","weekday","sled","1","2","2",8.9,0.1,28,-2,33,31.8,1,-1,-2,0,-1,-2,-4,-4
"2417",2018-04-05,"Snodgrass","w1718","Non.motorized",14,"Thu","weekday","no_sled","1","2","2",8.9,0,27,-1,35,33,-2,1,-1,-2,-3,-2,-3,-5
"2418",2018-04-05,"Snodgrass","w1718","Mechanized",0,"Thu","weekday","no_sled","1","2","2",8.9,0,27,-1,35,33,-2,1,-1,-2,-3,-2,-3,-5
"2419",2018-04-05,"Snodgrass","w1718","Motorized",0,"Thu","weekday","sled","1","2","2",8.9,0,27,-1,35,33,-2,1,-1,-2,-3,-2,-3,-5
"2420",2018-04-05,"Snodgrass","w1718","Hybrid",NA,"Thu","weekday","sled","1","2","2",8.9,0,27,-1,35,33,-2,1,-1,-2,-3,-2,-3,-5
"2421",2018-04-06,"Snodgrass","w1718","Non.motorized",11,"Fri","weekday","no_sled","1","2","2",8.9,0,25,-2,35,35.6,-1,-2,1,-1,-3,-5,-4,-5
"2422",2018-04-06,"Snodgrass","w1718","Mechanized",0,"Fri","weekday","no_sled","1","2","2",8.9,0,25,-2,35,35.6,-1,-2,1,-1,-3,-5,-4,-5
"2423",2018-04-06,"Snodgrass","w1718","Motorized",0,"Fri","weekday","sled","1","2","2",8.9,0,25,-2,35,35.6,-1,-2,1,-1,-3,-5,-4,-5
"2424",2018-04-06,"Snodgrass","w1718","Hybrid",NA,"Fri","weekday","sled","1","2","2",8.9,0,25,-2,35,35.6,-1,-2,1,-1,-3,-5,-4,-5
"2425",2018-04-07,"Snodgrass","w1718","Non.motorized",30,"Sat","weekend","no_sled","2","2","2",9.2,0.3,31,6,37,29.7,-2,-1,-2,1,4,3,1,2
"2426",2018-04-07,"Snodgrass","w1718","Mechanized",0,"Sat","weekend","no_sled","2","2","2",9.2,0.3,31,6,37,29.7,-2,-1,-2,1,4,3,1,2
"2427",2018-04-07,"Snodgrass","w1718","Motorized",1,"Sat","weekend","sled","2","2","2",9.2,0.3,31,6,37,29.7,-2,-1,-2,1,4,3,1,2
"2428",2018-04-07,"Snodgrass","w1718","Hybrid",NA,"Sat","weekend","sled","2","2","2",9.2,0.3,31,6,37,29.7,-2,-1,-2,1,4,3,1,2
"2429",2018-04-08,"Snodgrass","w1718","Non.motorized",7,"Sun","weekend","no_sled","3","3","3",10,0.8,33,2,33,30.3,6,-2,-1,-2,8,6,5,3
"2430",2018-04-08,"Snodgrass","w1718","Mechanized",0,"Sun","weekend","no_sled","3","3","3",10,0.8,33,2,33,30.3,6,-2,-1,-2,8,6,5,3
"2431",2018-04-08,"Snodgrass","w1718","Motorized",0,"Sun","weekend","sled","3","3","3",10,0.8,33,2,33,30.3,6,-2,-1,-2,8,6,5,3
"2432",2018-04-08,"Snodgrass","w1718","Hybrid",NA,"Sun","weekend","sled","3","3","3",10,0.8,33,2,33,30.3,6,-2,-1,-2,8,6,5,3
"2433",2018-04-09,"Snodgrass","w1718","Non.motorized",19,"Mon","weekday","no_sled","1","1","1",10.1,0.1,33,0,31,30.6,2,6,-2,-1,2,8,6,5
"2434",2018-04-09,"Snodgrass","w1718","Mechanized",0,"Mon","weekday","no_sled","1","1","1",10.1,0.1,33,0,31,30.6,2,6,-2,-1,2,8,6,5
"2435",2018-04-09,"Snodgrass","w1718","Motorized",0,"Mon","weekday","sled","1","1","1",10.1,0.1,33,0,31,30.6,2,6,-2,-1,2,8,6,5
"2436",2018-04-09,"Snodgrass","w1718","Hybrid",NA,"Mon","weekday","sled","1","1","1",10.1,0.1,33,0,31,30.6,2,6,-2,-1,2,8,6,5
"2437",2018-04-10,"Snodgrass","w1718","Non.motorized",9,"Tue","weekday","no_sled","1","1","1",10.1,0,31,-2,38,32.6,0,2,6,-2,-2,0,6,4
"2438",2018-04-10,"Snodgrass","w1718","Mechanized",0,"Tue","weekday","no_sled","1","1","1",10.1,0,31,-2,38,32.6,0,2,6,-2,-2,0,6,4
"2439",2018-04-10,"Snodgrass","w1718","Motorized",0,"Tue","weekday","sled","1","1","1",10.1,0,31,-2,38,32.6,0,2,6,-2,-2,0,6,4
"2440",2018-04-10,"Snodgrass","w1718","Hybrid",NA,"Tue","weekday","sled","1","1","1",10.1,0,31,-2,38,32.6,0,2,6,-2,-2,0,6,4
"2441",2018-04-11,"Snodgrass","w1718","Non.motorized",3,"Wed","weekday","no_sled","2","2","2",9.9,-0.2,29,-2,45,34.1,-2,0,2,6,-4,-4,-2,4
"2442",2018-04-11,"Snodgrass","w1718","Mechanized",0,"Wed","weekday","no_sled","2","2","2",9.9,-0.2,29,-2,45,34.1,-2,0,2,6,-4,-4,-2,4
"2443",2018-04-11,"Snodgrass","w1718","Motorized",0,"Wed","weekday","sled","2","2","2",9.9,-0.2,29,-2,45,34.1,-2,0,2,6,-4,-4,-2,4
"2444",2018-04-11,"Snodgrass","w1718","Hybrid",NA,"Wed","weekday","sled","2","2","2",9.9,-0.2,29,-2,45,34.1,-2,0,2,6,-4,-4,-2,4
"2445",2018-04-12,"Snodgrass","w1718","Non.motorized",3,"Thu","weekday","no_sled","1","2","2",9.5,-0.4,28,-1,40,33.9,-2,-2,0,2,-3,-5,-5,-3
"2446",2018-04-12,"Snodgrass","w1718","Mechanized",0,"Thu","weekday","no_sled","1","2","2",9.5,-0.4,28,-1,40,33.9,-2,-2,0,2,-3,-5,-5,-3
"2447",2018-04-12,"Snodgrass","w1718","Motorized",0,"Thu","weekday","sled","1","2","2",9.5,-0.4,28,-1,40,33.9,-2,-2,0,2,-3,-5,-5,-3
"2448",2018-04-12,"Snodgrass","w1718","Hybrid",NA,"Thu","weekday","sled","1","2","2",9.5,-0.4,28,-1,40,33.9,-2,-2,0,2,-3,-5,-5,-3
"2449",2018-04-13,"Snodgrass","w1718","Non.motorized",0,"Fri","weekday","no_sled","2","2","1",9.4,-0.1,26,-2,23,36.2,-1,-2,-2,0,-3,-5,-7,-7
"2450",2018-04-13,"Snodgrass","w1718","Mechanized",0,"Fri","weekday","no_sled","2","2","1",9.4,-0.1,26,-2,23,36.2,-1,-2,-2,0,-3,-5,-7,-7
"2451",2018-04-13,"Snodgrass","w1718","Motorized",0,"Fri","weekday","sled","2","2","1",9.4,-0.1,26,-2,23,36.2,-1,-2,-2,0,-3,-5,-7,-7
"2452",2018-04-13,"Snodgrass","w1718","Hybrid",NA,"Fri","weekday","sled","2","2","1",9.4,-0.1,26,-2,23,36.2,-1,-2,-2,0,-3,-5,-7,-7
"2453",2018-04-14,"Snodgrass","w1718","Non.motorized",13,"Sat","weekend","no_sled","2","2","1",9.4,0,28,2,28,33.6,-2,-1,-2,-2,0,-1,-3,-5
"2454",2018-04-14,"Snodgrass","w1718","Mechanized",0,"Sat","weekend","no_sled","2","2","1",9.4,0,28,2,28,33.6,-2,-1,-2,-2,0,-1,-3,-5
"2455",2018-04-14,"Snodgrass","w1718","Motorized",0,"Sat","weekend","sled","2","2","1",9.4,0,28,2,28,33.6,-2,-1,-2,-2,0,-1,-3,-5
"2456",2018-04-14,"Snodgrass","w1718","Hybrid",NA,"Sat","weekend","sled","2","2","1",9.4,0,28,2,28,33.6,-2,-1,-2,-2,0,-1,-3,-5
"2457",2018-04-15,"Snodgrass","w1718","Non.motorized",11,"Sun","weekend","no_sled","2","2","1",9.2,-0.2,27,-1,37,34.1,2,-2,-1,-2,1,-1,-2,-4
"2458",2018-04-15,"Snodgrass","w1718","Mechanized",0,"Sun","weekend","no_sled","2","2","1",9.2,-0.2,27,-1,37,34.1,2,-2,-1,-2,1,-1,-2,-4
"2459",2018-04-15,"Snodgrass","w1718","Motorized",0,"Sun","weekend","sled","2","2","1",9.2,-0.2,27,-1,37,34.1,2,-2,-1,-2,1,-1,-2,-4
"2460",2018-04-15,"Snodgrass","w1718","Hybrid",NA,"Sun","weekend","sled","2","2","1",9.2,-0.2,27,-1,37,34.1,2,-2,-1,-2,1,-1,-2,-4
"2461",2017-12-22,"Washington Gulch","w1718","Non.motorized",0,"Fri","weekday","no_sled","2","2","1",2,0,11,3,17,18.2,0,0,0,0,3,3,3,3
"2462",2017-12-22,"Washington Gulch","w1718","Mechanized",0,"Fri","weekday","no_sled","2","2","1",2,0,11,3,17,18.2,0,0,0,0,3,3,3,3
"2463",2017-12-22,"Washington Gulch","w1718","Motorized",1,"Fri","weekday","sled","2","2","1",2,0,11,3,17,18.2,0,0,0,0,3,3,3,3
"2464",2017-12-22,"Washington Gulch","w1718","Hybrid",0,"Fri","weekday","sled","2","2","1",2,0,11,3,17,18.2,0,0,0,0,3,3,3,3
"2465",2017-12-23,"Washington Gulch","w1718","Non.motorized",0,"Sat","weekend","no_sled","2","1","1",2.1,0.1,10,-1,21,21,3,0,0,0,2,2,2,2
"2466",2017-12-23,"Washington Gulch","w1718","Mechanized",0,"Sat","weekend","no_sled","2","1","1",2.1,0.1,10,-1,21,21,3,0,0,0,2,2,2,2
"2467",2017-12-23,"Washington Gulch","w1718","Motorized",0,"Sat","weekend","sled","2","1","1",2.1,0.1,10,-1,21,21,3,0,0,0,2,2,2,2
"2468",2017-12-23,"Washington Gulch","w1718","Hybrid",0,"Sat","weekend","sled","2","1","1",2.1,0.1,10,-1,21,21,3,0,0,0,2,2,2,2
"2469",2017-12-24,"Washington Gulch","w1718","Non.motorized",17,"Sun","weekend","no_sled","1","1","1",2.4,0.3,14,4,19,17.1,-1,3,0,0,3,6,6,6
"2470",2017-12-24,"Washington Gulch","w1718","Mechanized",2,"Sun","weekend","no_sled","1","1","1",2.4,0.3,14,4,19,17.1,-1,3,0,0,3,6,6,6
"2471",2017-12-24,"Washington Gulch","w1718","Motorized",7,"Sun","weekend","sled","1","1","1",2.4,0.3,14,4,19,17.1,-1,3,0,0,3,6,6,6
"2472",2017-12-24,"Washington Gulch","w1718","Hybrid",4,"Sun","weekend","sled","1","1","1",2.4,0.3,14,4,19,17.1,-1,3,0,0,3,6,6,6
"2473",2017-12-25,"Washington Gulch","w1718","Non.motorized",14,"Mon","weekday","no_sled","2","1","1",2.6,0.2,14,0,25,18.6,4,-1,3,0,4,3,6,6
"2474",2017-12-25,"Washington Gulch","w1718","Mechanized",2,"Mon","weekday","no_sled","2","1","1",2.6,0.2,14,0,25,18.6,4,-1,3,0,4,3,6,6
"2475",2017-12-25,"Washington Gulch","w1718","Motorized",1,"Mon","weekday","sled","2","1","1",2.6,0.2,14,0,25,18.6,4,-1,3,0,4,3,6,6
"2476",2017-12-25,"Washington Gulch","w1718","Hybrid",0,"Mon","weekday","sled","2","1","1",2.6,0.2,14,0,25,18.6,4,-1,3,0,4,3,6,6
"2477",2017-12-26,"Washington Gulch","w1718","Non.motorized",24,"Tue","weekday","no_sled","1","1","1",3.1,0.5,20,6,25,15.5,0,4,-1,3,6,10,9,12
"2478",2017-12-26,"Washington Gulch","w1718","Mechanized",0,"Tue","weekday","no_sled","1","1","1",3.1,0.5,20,6,25,15.5,0,4,-1,3,6,10,9,12
"2479",2017-12-26,"Washington Gulch","w1718","Motorized",3,"Tue","weekday","sled","1","1","1",3.1,0.5,20,6,25,15.5,0,4,-1,3,6,10,9,12
"2480",2017-12-26,"Washington Gulch","w1718","Hybrid",3,"Tue","weekday","sled","1","1","1",3.1,0.5,20,6,25,15.5,0,4,-1,3,6,10,9,12
"2481",2017-12-27,"Washington Gulch","w1718","Non.motorized",60,"Wed","weekday","no_sled","1","1","1",3.1,0,18,-2,27,17.2,6,0,4,-1,4,4,8,7
"2482",2017-12-27,"Washington Gulch","w1718","Mechanized",0,"Wed","weekday","no_sled","1","1","1",3.1,0,18,-2,27,17.2,6,0,4,-1,4,4,8,7
"2483",2017-12-27,"Washington Gulch","w1718","Motorized",2,"Wed","weekday","sled","1","1","1",3.1,0,18,-2,27,17.2,6,0,4,-1,4,4,8,7
"2484",2017-12-27,"Washington Gulch","w1718","Hybrid",2,"Wed","weekday","sled","1","1","1",3.1,0,18,-2,27,17.2,6,0,4,-1,4,4,8,7
"2485",2017-12-28,"Washington Gulch","w1718","Non.motorized",74,"Thu","weekday","no_sled","1","1","1",3.2,0.1,17,-1,31,18.8,-2,6,0,4,-3,3,3,7
"2486",2017-12-28,"Washington Gulch","w1718","Mechanized",2,"Thu","weekday","no_sled","1","1","1",3.2,0.1,17,-1,31,18.8,-2,6,0,4,-3,3,3,7
"2487",2017-12-28,"Washington Gulch","w1718","Motorized",4,"Thu","weekday","sled","1","1","1",3.2,0.1,17,-1,31,18.8,-2,6,0,4,-3,3,3,7
"2488",2017-12-28,"Washington Gulch","w1718","Hybrid",1,"Thu","weekday","sled","1","1","1",3.2,0.1,17,-1,31,18.8,-2,6,0,4,-3,3,3,7
"2489",2017-12-29,"Washington Gulch","w1718","Non.motorized",33,"Fri","weekday","no_sled","1","1","1",3.2,0,17,0,36,18.8,-1,-2,6,0,-1,-3,3,3
"2490",2017-12-29,"Washington Gulch","w1718","Mechanized",0,"Fri","weekday","no_sled","1","1","1",3.2,0,17,0,36,18.8,-1,-2,6,0,-1,-3,3,3
"2491",2017-12-29,"Washington Gulch","w1718","Motorized",13,"Fri","weekday","sled","1","1","1",3.2,0,17,0,36,18.8,-1,-2,6,0,-1,-3,3,3
"2492",2017-12-29,"Washington Gulch","w1718","Hybrid",8,"Fri","weekday","sled","1","1","1",3.2,0,17,0,36,18.8,-1,-2,6,0,-1,-3,3,3
"2493",2017-12-30,"Washington Gulch","w1718","Non.motorized",111,"Sat","weekend","no_sled","1","1","1",3.2,0,15,-2,37,21.3,0,-1,-2,6,-2,-3,-5,1
"2494",2017-12-30,"Washington Gulch","w1718","Mechanized",1,"Sat","weekend","no_sled","1","1","1",3.2,0,15,-2,37,21.3,0,-1,-2,6,-2,-3,-5,1
"2495",2017-12-30,"Washington Gulch","w1718","Motorized",2,"Sat","weekend","sled","1","1","1",3.2,0,15,-2,37,21.3,0,-1,-2,6,-2,-3,-5,1
"2496",2017-12-30,"Washington Gulch","w1718","Hybrid",0,"Sat","weekend","sled","1","1","1",3.2,0,15,-2,37,21.3,0,-1,-2,6,-2,-3,-5,1
"2497",2017-12-31,"Washington Gulch","w1718","Non.motorized",109,"Sun","weekend","no_sled","1","1","1",3.2,0,15,0,31,21.3,-2,0,-1,-2,-2,-2,-3,-5
"2498",2017-12-31,"Washington Gulch","w1718","Mechanized",0,"Sun","weekend","no_sled","1","1","1",3.2,0,15,0,31,21.3,-2,0,-1,-2,-2,-2,-3,-5
"2499",2017-12-31,"Washington Gulch","w1718","Motorized",6,"Sun","weekend","sled","1","1","1",3.2,0,15,0,31,21.3,-2,0,-1,-2,-2,-2,-3,-5
"2500",2017-12-31,"Washington Gulch","w1718","Hybrid",2,"Sun","weekend","sled","1","1","1",3.2,0,15,0,31,21.3,-2,0,-1,-2,-2,-2,-3,-5
"2501",2018-01-01,"Washington Gulch","w1718","Non.motorized",73,"Mon","weekday","no_sled","1","1","1",3.2,0,15,0,27,21.3,0,-2,0,-1,0,-2,-2,-3
"2502",2018-01-01,"Washington Gulch","w1718","Mechanized",2,"Mon","weekday","no_sled","1","1","1",3.2,0,15,0,27,21.3,0,-2,0,-1,0,-2,-2,-3
"2503",2018-01-01,"Washington Gulch","w1718","Motorized",16,"Mon","weekday","sled","1","1","1",3.2,0,15,0,27,21.3,0,-2,0,-1,0,-2,-2,-3
"2504",2018-01-01,"Washington Gulch","w1718","Hybrid",4,"Mon","weekday","sled","1","1","1",3.2,0,15,0,27,21.3,0,-2,0,-1,0,-2,-2,-3
"2505",2018-01-02,"Washington Gulch","w1718","Non.motorized",35,"Tue","weekday","no_sled","1","1","1",3.2,0,15,0,22,21.3,0,0,-2,0,0,0,-2,-2
"2506",2018-01-02,"Washington Gulch","w1718","Mechanized",0,"Tue","weekday","no_sled","1","1","1",3.2,0,15,0,22,21.3,0,0,-2,0,0,0,-2,-2
"2507",2018-01-02,"Washington Gulch","w1718","Motorized",1,"Tue","weekday","sled","1","1","1",3.2,0,15,0,22,21.3,0,0,-2,0,0,0,-2,-2
"2508",2018-01-02,"Washington Gulch","w1718","Hybrid",0,"Tue","weekday","sled","1","1","1",3.2,0,15,0,22,21.3,0,0,-2,0,0,0,-2,-2
"2509",2018-01-03,"Washington Gulch","w1718","Non.motorized",NA,"Wed","weekday","no_sled","1","1","1",3.2,0,15,0,27,21.3,0,0,0,-2,0,0,0,-2
"2510",2018-01-03,"Washington Gulch","w1718","Mechanized",NA,"Wed","weekday","no_sled","1","1","1",3.2,0,15,0,27,21.3,0,0,0,-2,0,0,0,-2
"2511",2018-01-03,"Washington Gulch","w1718","Motorized",NA,"Wed","weekday","sled","1","1","1",3.2,0,15,0,27,21.3,0,0,0,-2,0,0,0,-2
"2512",2018-01-03,"Washington Gulch","w1718","Hybrid",NA,"Wed","weekday","sled","1","1","1",3.2,0,15,0,27,21.3,0,0,0,-2,0,0,0,-2
"2513",2018-01-04,"Washington Gulch","w1718","Non.motorized",NA,"Thu","weekday","no_sled","1","1","1",3.2,0,15,0,29,21.3,0,0,0,0,0,0,0,0
"2514",2018-01-04,"Washington Gulch","w1718","Mechanized",NA,"Thu","weekday","no_sled","1","1","1",3.2,0,15,0,29,21.3,0,0,0,0,0,0,0,0
"2515",2018-01-04,"Washington Gulch","w1718","Motorized",NA,"Thu","weekday","sled","1","1","1",3.2,0,15,0,29,21.3,0,0,0,0,0,0,0,0
"2516",2018-01-04,"Washington Gulch","w1718","Hybrid",NA,"Thu","weekday","sled","1","1","1",3.2,0,15,0,29,21.3,0,0,0,0,0,0,0,0
"2517",2018-01-05,"Washington Gulch","w1718","Non.motorized",NA,"Fri","weekday","no_sled","1","1","1",3.2,0,14,-1,32,22.9,0,0,0,0,-1,-1,-1,-1
"2518",2018-01-05,"Washington Gulch","w1718","Mechanized",NA,"Fri","weekday","no_sled","1","1","1",3.2,0,14,-1,32,22.9,0,0,0,0,-1,-1,-1,-1
"2519",2018-01-05,"Washington Gulch","w1718","Motorized",NA,"Fri","weekday","sled","1","1","1",3.2,0,14,-1,32,22.9,0,0,0,0,-1,-1,-1,-1
"2520",2018-01-05,"Washington Gulch","w1718","Hybrid",NA,"Fri","weekday","sled","1","1","1",3.2,0,14,-1,32,22.9,0,0,0,0,-1,-1,-1,-1
"2521",2018-01-06,"Washington Gulch","w1718","Non.motorized",0,"Sat","weekend","no_sled","1","1","1",3.2,0,14,0,30,22.9,-1,0,0,0,-1,-1,-1,-1
"2522",2018-01-06,"Washington Gulch","w1718","Mechanized",1,"Sat","weekend","no_sled","1","1","1",3.2,0,14,0,30,22.9,-1,0,0,0,-1,-1,-1,-1
"2523",2018-01-06,"Washington Gulch","w1718","Motorized",0,"Sat","weekend","sled","1","1","1",3.2,0,14,0,30,22.9,-1,0,0,0,-1,-1,-1,-1
"2524",2018-01-06,"Washington Gulch","w1718","Hybrid",0,"Sat","weekend","sled","1","1","1",3.2,0,14,0,30,22.9,-1,0,0,0,-1,-1,-1,-1
"2525",2018-01-07,"Washington Gulch","w1718","Non.motorized",36,"Sun","weekend","no_sled","2","2","2",3.5,0.3,18,4,25,19.4,0,-1,0,0,4,3,3,3
"2526",2018-01-07,"Washington Gulch","w1718","Mechanized",0,"Sun","weekend","no_sled","2","2","2",3.5,0.3,18,4,25,19.4,0,-1,0,0,4,3,3,3
"2527",2018-01-07,"Washington Gulch","w1718","Motorized",8,"Sun","weekend","sled","2","2","2",3.5,0.3,18,4,25,19.4,0,-1,0,0,4,3,3,3
"2528",2018-01-07,"Washington Gulch","w1718","Hybrid",2,"Sun","weekend","sled","2","2","2",3.5,0.3,18,4,25,19.4,0,-1,0,0,4,3,3,3
"2529",2018-01-08,"Washington Gulch","w1718","Non.motorized",18,"Mon","weekday","no_sled","2","2","1",3.7,0.2,20,2,29,18.5,4,0,-1,0,6,6,5,5
"2530",2018-01-08,"Washington Gulch","w1718","Mechanized",0,"Mon","weekday","no_sled","2","2","1",3.7,0.2,20,2,29,18.5,4,0,-1,0,6,6,5,5
"2531",2018-01-08,"Washington Gulch","w1718","Motorized",4,"Mon","weekday","sled","2","2","1",3.7,0.2,20,2,29,18.5,4,0,-1,0,6,6,5,5
"2532",2018-01-08,"Washington Gulch","w1718","Hybrid",4,"Mon","weekday","sled","2","2","1",3.7,0.2,20,2,29,18.5,4,0,-1,0,6,6,5,5
"2533",2018-01-09,"Washington Gulch","w1718","Non.motorized",18,"Tue","weekday","no_sled","2","2","1",3.8,0.1,21,1,34,18.1,2,4,0,-1,3,7,7,6
"2534",2018-01-09,"Washington Gulch","w1718","Mechanized",0,"Tue","weekday","no_sled","2","2","1",3.8,0.1,21,1,34,18.1,2,4,0,-1,3,7,7,6
"2535",2018-01-09,"Washington Gulch","w1718","Motorized",3,"Tue","weekday","sled","2","2","1",3.8,0.1,21,1,34,18.1,2,4,0,-1,3,7,7,6
"2536",2018-01-09,"Washington Gulch","w1718","Hybrid",1,"Tue","weekday","sled","2","2","1",3.8,0.1,21,1,34,18.1,2,4,0,-1,3,7,7,6
"2537",2018-01-10,"Washington Gulch","w1718","Non.motorized",20,"Wed","weekday","no_sled","3","3","3",4,0.2,21,0,28,19,1,2,4,0,1,3,7,7
"2538",2018-01-10,"Washington Gulch","w1718","Mechanized",0,"Wed","weekday","no_sled","3","3","3",4,0.2,21,0,28,19,1,2,4,0,1,3,7,7
"2539",2018-01-10,"Washington Gulch","w1718","Motorized",0,"Wed","weekday","sled","3","3","3",4,0.2,21,0,28,19,1,2,4,0,1,3,7,7
"2540",2018-01-10,"Washington Gulch","w1718","Hybrid",0,"Wed","weekday","sled","3","3","3",4,0.2,21,0,28,19,1,2,4,0,1,3,7,7
"2541",2018-01-11,"Washington Gulch","w1718","Non.motorized",9,"Thu","weekday","no_sled","3","3","3",4.1,0.1,26,5,17,15.8,0,1,2,4,5,6,8,12
"2542",2018-01-11,"Washington Gulch","w1718","Mechanized",0,"Thu","weekday","no_sled","3","3","3",4.1,0.1,26,5,17,15.8,0,1,2,4,5,6,8,12
"2543",2018-01-11,"Washington Gulch","w1718","Motorized",7,"Thu","weekday","sled","3","3","3",4.1,0.1,26,5,17,15.8,0,1,2,4,5,6,8,12
"2544",2018-01-11,"Washington Gulch","w1718","Hybrid",7,"Thu","weekday","sled","3","3","3",4.1,0.1,26,5,17,15.8,0,1,2,4,5,6,8,12
"2545",2018-01-12,"Washington Gulch","w1718","Non.motorized",13,"Fri","weekday","no_sled","3","3","3",4.3,0.2,24,-2,22,17.9,5,0,1,2,3,3,4,6
"2546",2018-01-12,"Washington Gulch","w1718","Mechanized",0,"Fri","weekday","no_sled","3","3","3",4.3,0.2,24,-2,22,17.9,5,0,1,2,3,3,4,6
"2547",2018-01-12,"Washington Gulch","w1718","Motorized",0,"Fri","weekday","sled","3","3","3",4.3,0.2,24,-2,22,17.9,5,0,1,2,3,3,4,6
"2548",2018-01-12,"Washington Gulch","w1718","Hybrid",0,"Fri","weekday","sled","3","3","3",4.3,0.2,24,-2,22,17.9,5,0,1,2,3,3,4,6
"2549",2018-01-13,"Washington Gulch","w1718","Non.motorized",55,"Sat","weekend","no_sled","3","3","3",4.4,0.1,24,0,24,18.3,-2,5,0,1,-2,3,3,4
"2550",2018-01-13,"Washington Gulch","w1718","Mechanized",0,"Sat","weekend","no_sled","3","3","3",4.4,0.1,24,0,24,18.3,-2,5,0,1,-2,3,3,4
"2551",2018-01-13,"Washington Gulch","w1718","Motorized",5,"Sat","weekend","sled","3","3","3",4.4,0.1,24,0,24,18.3,-2,5,0,1,-2,3,3,4
"2552",2018-01-13,"Washington Gulch","w1718","Hybrid",3,"Sat","weekend","sled","3","3","3",4.4,0.1,24,0,24,18.3,-2,5,0,1,-2,3,3,4
"2553",2018-01-14,"Washington Gulch","w1718","Non.motorized",61,"Sun","weekend","no_sled","3","3","2",4.4,0,24,0,27,18.3,0,-2,5,0,0,-2,3,3
"2554",2018-01-14,"Washington Gulch","w1718","Mechanized",0,"Sun","weekend","no_sled","3","3","2",4.4,0,24,0,27,18.3,0,-2,5,0,0,-2,3,3
"2555",2018-01-14,"Washington Gulch","w1718","Motorized",11,"Sun","weekend","sled","3","3","2",4.4,0,24,0,27,18.3,0,-2,5,0,0,-2,3,3
"2556",2018-01-14,"Washington Gulch","w1718","Hybrid",10,"Sun","weekend","sled","3","3","2",4.4,0,24,0,27,18.3,0,-2,5,0,0,-2,3,3
"2557",2018-01-15,"Washington Gulch","w1718","Non.motorized",39,"Mon","weekday","no_sled","3","3","2",4.4,0,23,-1,27,19.1,0,0,-2,5,-1,-1,-3,2
"2558",2018-01-15,"Washington Gulch","w1718","Mechanized",0,"Mon","weekday","no_sled","3","3","2",4.4,0,23,-1,27,19.1,0,0,-2,5,-1,-1,-3,2
"2559",2018-01-15,"Washington Gulch","w1718","Motorized",4,"Mon","weekday","sled","3","3","2",4.4,0,23,-1,27,19.1,0,0,-2,5,-1,-1,-3,2
"2560",2018-01-15,"Washington Gulch","w1718","Hybrid",4,"Mon","weekday","sled","3","3","2",4.4,0,23,-1,27,19.1,0,0,-2,5,-1,-1,-3,2
"2561",2018-01-16,"Washington Gulch","w1718","Non.motorized",19,"Tue","weekday","no_sled","3","3","2",4.4,0,22,-1,20,20,-1,0,0,-2,-2,-2,-2,-4
"2562",2018-01-16,"Washington Gulch","w1718","Mechanized",3,"Tue","weekday","no_sled","3","3","2",4.4,0,22,-1,20,20,-1,0,0,-2,-2,-2,-2,-4
"2563",2018-01-16,"Washington Gulch","w1718","Motorized",5,"Tue","weekday","sled","3","3","2",4.4,0,22,-1,20,20,-1,0,0,-2,-2,-2,-2,-4
"2564",2018-01-16,"Washington Gulch","w1718","Hybrid",4,"Tue","weekday","sled","3","3","2",4.4,0,22,-1,20,20,-1,0,0,-2,-2,-2,-2,-4
"2565",2018-01-17,"Washington Gulch","w1718","Non.motorized",15,"Wed","weekday","no_sled","2","2","2",4.4,0,22,0,24,20,-1,-1,0,0,-1,-2,-2,-2
"2566",2018-01-17,"Washington Gulch","w1718","Mechanized",0,"Wed","weekday","no_sled","2","2","2",4.4,0,22,0,24,20,-1,-1,0,0,-1,-2,-2,-2
"2567",2018-01-17,"Washington Gulch","w1718","Motorized",8,"Wed","weekday","sled","2","2","2",4.4,0,22,0,24,20,-1,-1,0,0,-1,-2,-2,-2
"2568",2018-01-17,"Washington Gulch","w1718","Hybrid",5,"Wed","weekday","sled","2","2","2",4.4,0,22,0,24,20,-1,-1,0,0,-1,-2,-2,-2
"2569",2018-01-18,"Washington Gulch","w1718","Non.motorized",22,"Thu","weekday","no_sled","2","2","2",4.4,0,21,-1,29,21,0,-1,-1,0,-1,-2,-3,-3
"2570",2018-01-18,"Washington Gulch","w1718","Mechanized",0,"Thu","weekday","no_sled","2","2","2",4.4,0,21,-1,29,21,0,-1,-1,0,-1,-2,-3,-3
"2571",2018-01-18,"Washington Gulch","w1718","Motorized",0,"Thu","weekday","sled","2","2","2",4.4,0,21,-1,29,21,0,-1,-1,0,-1,-2,-3,-3
"2572",2018-01-18,"Washington Gulch","w1718","Hybrid",0,"Thu","weekday","sled","2","2","2",4.4,0,21,-1,29,21,0,-1,-1,0,-1,-2,-3,-3
"2573",2018-01-19,"Washington Gulch","w1718","Non.motorized",39,"Fri","weekday","no_sled","2","2","2",4.5,0.1,21,0,34,21.4,-1,0,-1,-1,-1,-1,-2,-3
"2574",2018-01-19,"Washington Gulch","w1718","Mechanized",0,"Fri","weekday","no_sled","2","2","2",4.5,0.1,21,0,34,21.4,-1,0,-1,-1,-1,-1,-2,-3
"2575",2018-01-19,"Washington Gulch","w1718","Motorized",5,"Fri","weekday","sled","2","2","2",4.5,0.1,21,0,34,21.4,-1,0,-1,-1,-1,-1,-2,-3
"2576",2018-01-19,"Washington Gulch","w1718","Hybrid",5,"Fri","weekday","sled","2","2","2",4.5,0.1,21,0,34,21.4,-1,0,-1,-1,-1,-1,-2,-3
"2577",2018-01-20,"Washington Gulch","w1718","Non.motorized",44,"Sat","weekend","no_sled","2","2","2",4.5,0,21,0,32,21.4,0,-1,0,-1,0,-1,-1,-2
"2578",2018-01-20,"Washington Gulch","w1718","Mechanized",1,"Sat","weekend","no_sled","2","2","2",4.5,0,21,0,32,21.4,0,-1,0,-1,0,-1,-1,-2
"2579",2018-01-20,"Washington Gulch","w1718","Motorized",5,"Sat","weekend","sled","2","2","2",4.5,0,21,0,32,21.4,0,-1,0,-1,0,-1,-1,-2
"2580",2018-01-20,"Washington Gulch","w1718","Hybrid",2,"Sat","weekend","sled","2","2","2",4.5,0,21,0,32,21.4,0,-1,0,-1,0,-1,-1,-2
"2581",2018-01-21,"Washington Gulch","w1718","Non.motorized",0,"Sun","weekend","no_sled","3","3","3",4.6,0.1,23,2,15,20,0,0,-1,0,2,2,1,1
"2582",2018-01-21,"Washington Gulch","w1718","Mechanized",0,"Sun","weekend","no_sled","3","3","3",4.6,0.1,23,2,15,20,0,0,-1,0,2,2,1,1
"2583",2018-01-21,"Washington Gulch","w1718","Motorized",0,"Sun","weekend","sled","3","3","3",4.6,0.1,23,2,15,20,0,0,-1,0,2,2,1,1
"2584",2018-01-21,"Washington Gulch","w1718","Hybrid",0,"Sun","weekend","sled","3","3","3",4.6,0.1,23,2,15,20,0,0,-1,0,2,2,1,1
"2585",2018-01-22,"Washington Gulch","w1718","Non.motorized",28,"Mon","weekday","no_sled","3","3","3",4.6,0,21,-2,12,21.9,2,0,0,-1,0,0,0,-1
"2586",2018-01-22,"Washington Gulch","w1718","Mechanized",0,"Mon","weekday","no_sled","3","3","3",4.6,0,21,-2,12,21.9,2,0,0,-1,0,0,0,-1
"2587",2018-01-22,"Washington Gulch","w1718","Motorized",6,"Mon","weekday","sled","3","3","3",4.6,0,21,-2,12,21.9,2,0,0,-1,0,0,0,-1
"2588",2018-01-22,"Washington Gulch","w1718","Hybrid",2,"Mon","weekday","sled","3","3","3",4.6,0,21,-2,12,21.9,2,0,0,-1,0,0,0,-1
"2589",2018-01-23,"Washington Gulch","w1718","Non.motorized",28,"Tue","weekday","no_sled","3","3","3",4.6,0,22,1,16,20.9,-2,2,0,0,-1,1,1,1
"2590",2018-01-23,"Washington Gulch","w1718","Mechanized",1,"Tue","weekday","no_sled","3","3","3",4.6,0,22,1,16,20.9,-2,2,0,0,-1,1,1,1
"2591",2018-01-23,"Washington Gulch","w1718","Motorized",6,"Tue","weekday","sled","3","3","3",4.6,0,22,1,16,20.9,-2,2,0,0,-1,1,1,1
"2592",2018-01-23,"Washington Gulch","w1718","Hybrid",6,"Tue","weekday","sled","3","3","3",4.6,0,22,1,16,20.9,-2,2,0,0,-1,1,1,1
"2593",2018-01-24,"Washington Gulch","w1718","Non.motorized",21,"Wed","weekday","no_sled","2","2","2",4.6,0,22,0,22,20.9,1,-2,2,0,1,-1,1,1
"2594",2018-01-24,"Washington Gulch","w1718","Mechanized",0,"Wed","weekday","no_sled","2","2","2",4.6,0,22,0,22,20.9,1,-2,2,0,1,-1,1,1
"2595",2018-01-24,"Washington Gulch","w1718","Motorized",10,"Wed","weekday","sled","2","2","2",4.6,0,22,0,22,20.9,1,-2,2,0,1,-1,1,1
"2596",2018-01-24,"Washington Gulch","w1718","Hybrid",9,"Wed","weekday","sled","2","2","2",4.6,0,22,0,22,20.9,1,-2,2,0,1,-1,1,1
"2597",2018-01-25,"Washington Gulch","w1718","Non.motorized",25,"Thu","weekday","no_sled","2","2","2",4.6,0,22,0,28,20.9,0,1,-2,2,0,1,-1,1
"2598",2018-01-25,"Washington Gulch","w1718","Mechanized",1,"Thu","weekday","no_sled","2","2","2",4.6,0,22,0,28,20.9,0,1,-2,2,0,1,-1,1
"2599",2018-01-25,"Washington Gulch","w1718","Motorized",13,"Thu","weekday","sled","2","2","2",4.6,0,22,0,28,20.9,0,1,-2,2,0,1,-1,1
"2600",2018-01-25,"Washington Gulch","w1718","Hybrid",8,"Thu","weekday","sled","2","2","2",4.6,0,22,0,28,20.9,0,1,-2,2,0,1,-1,1
"2601",2018-01-26,"Washington Gulch","w1718","Non.motorized",14,"Fri","weekday","no_sled","2","2","2",4.7,0.1,22,0,15,21.4,0,0,1,-2,0,0,1,-1
"2602",2018-01-26,"Washington Gulch","w1718","Mechanized",2,"Fri","weekday","no_sled","2","2","2",4.7,0.1,22,0,15,21.4,0,0,1,-2,0,0,1,-1
"2603",2018-01-26,"Washington Gulch","w1718","Motorized",3,"Fri","weekday","sled","2","2","2",4.7,0.1,22,0,15,21.4,0,0,1,-2,0,0,1,-1
"2604",2018-01-26,"Washington Gulch","w1718","Hybrid",1,"Fri","weekday","sled","2","2","2",4.7,0.1,22,0,15,21.4,0,0,1,-2,0,0,1,-1
"2605",2018-01-27,"Washington Gulch","w1718","Non.motorized",53,"Sat","weekend","no_sled","2","2","2",4.7,0,23,1,16,20.4,0,0,0,1,1,1,1,2
"2606",2018-01-27,"Washington Gulch","w1718","Mechanized",1,"Sat","weekend","no_sled","2","2","2",4.7,0,23,1,16,20.4,0,0,0,1,1,1,1,2
"2607",2018-01-27,"Washington Gulch","w1718","Motorized",9,"Sat","weekend","sled","2","2","2",4.7,0,23,1,16,20.4,0,0,0,1,1,1,1,2
"2608",2018-01-27,"Washington Gulch","w1718","Hybrid",9,"Sat","weekend","sled","2","2","2",4.7,0,23,1,16,20.4,0,0,0,1,1,1,1,2
"2609",2018-01-28,"Washington Gulch","w1718","Non.motorized",101,"Sun","weekend","no_sled","2","2","2",4.7,0,23,0,25,20.4,1,0,0,0,1,1,1,1
"2610",2018-01-28,"Washington Gulch","w1718","Mechanized",1,"Sun","weekend","no_sled","2","2","2",4.7,0,23,0,25,20.4,1,0,0,0,1,1,1,1
"2611",2018-01-28,"Washington Gulch","w1718","Motorized",18,"Sun","weekend","sled","2","2","2",4.7,0,23,0,25,20.4,1,0,0,0,1,1,1,1
"2612",2018-01-28,"Washington Gulch","w1718","Hybrid",12,"Sun","weekend","sled","2","2","2",4.7,0,23,0,25,20.4,1,0,0,0,1,1,1,1
"2613",2018-01-29,"Washington Gulch","w1718","Non.motorized",18,"Mon","weekday","no_sled","2","2","2",4.8,0.1,22,-1,30,21.8,0,1,0,0,-1,0,0,0
"2614",2018-01-29,"Washington Gulch","w1718","Mechanized",0,"Mon","weekday","no_sled","2","2","2",4.8,0.1,22,-1,30,21.8,0,1,0,0,-1,0,0,0
"2615",2018-01-29,"Washington Gulch","w1718","Motorized",4,"Mon","weekday","sled","2","2","2",4.8,0.1,22,-1,30,21.8,0,1,0,0,-1,0,0,0
"2616",2018-01-29,"Washington Gulch","w1718","Hybrid",4,"Mon","weekday","sled","2","2","2",4.8,0.1,22,-1,30,21.8,0,1,0,0,-1,0,0,0
"2617",2018-01-30,"Washington Gulch","w1718","Non.motorized",22,"Tue","weekday","no_sled","2","2","2",4.8,0,22,0,34,21.8,-1,0,1,0,-1,-1,0,0
"2618",2018-01-30,"Washington Gulch","w1718","Mechanized",1,"Tue","weekday","no_sled","2","2","2",4.8,0,22,0,34,21.8,-1,0,1,0,-1,-1,0,0
"2619",2018-01-30,"Washington Gulch","w1718","Motorized",6,"Tue","weekday","sled","2","2","2",4.8,0,22,0,34,21.8,-1,0,1,0,-1,-1,0,0
"2620",2018-01-30,"Washington Gulch","w1718","Hybrid",2,"Tue","weekday","sled","2","2","2",4.8,0,22,0,34,21.8,-1,0,1,0,-1,-1,0,0
"2621",2018-01-31,"Washington Gulch","w1718","Non.motorized",20,"Wed","weekday","no_sled","2","2","2",4.8,0,22,0,34,21.8,0,-1,0,1,0,-1,-1,0
"2622",2018-01-31,"Washington Gulch","w1718","Mechanized",0,"Wed","weekday","no_sled","2","2","2",4.8,0,22,0,34,21.8,0,-1,0,1,0,-1,-1,0
"2623",2018-01-31,"Washington Gulch","w1718","Motorized",3,"Wed","weekday","sled","2","2","2",4.8,0,22,0,34,21.8,0,-1,0,1,0,-1,-1,0
"2624",2018-01-31,"Washington Gulch","w1718","Hybrid",2,"Wed","weekday","sled","2","2","2",4.8,0,22,0,34,21.8,0,-1,0,1,0,-1,-1,0
"2625",2018-02-01,"Washington Gulch","w1718","Non.motorized",21,"Thu","weekday","no_sled","2","2","2",4.9,0.1,21,-1,32,23.3,0,0,-1,0,-1,-1,-2,-2
"2626",2018-02-01,"Washington Gulch","w1718","Mechanized",0,"Thu","weekday","no_sled","2","2","2",4.9,0.1,21,-1,32,23.3,0,0,-1,0,-1,-1,-2,-2
"2627",2018-02-01,"Washington Gulch","w1718","Motorized",5,"Thu","weekday","sled","2","2","2",4.9,0.1,21,-1,32,23.3,0,0,-1,0,-1,-1,-2,-2
"2628",2018-02-01,"Washington Gulch","w1718","Hybrid",2,"Thu","weekday","sled","2","2","2",4.9,0.1,21,-1,32,23.3,0,0,-1,0,-1,-1,-2,-2
"2629",2018-02-02,"Washington Gulch","w1718","Non.motorized",35,"Fri","weekday","no_sled","2","2","2",4.9,0,20,-1,33,24.5,-1,0,0,-1,-2,-2,-2,-3
"2630",2018-02-02,"Washington Gulch","w1718","Mechanized",0,"Fri","weekday","no_sled","2","2","2",4.9,0,20,-1,33,24.5,-1,0,0,-1,-2,-2,-2,-3
"2631",2018-02-02,"Washington Gulch","w1718","Motorized",4,"Fri","weekday","sled","2","2","2",4.9,0,20,-1,33,24.5,-1,0,0,-1,-2,-2,-2,-3
"2632",2018-02-02,"Washington Gulch","w1718","Hybrid",4,"Fri","weekday","sled","2","2","2",4.9,0,20,-1,33,24.5,-1,0,0,-1,-2,-2,-2,-3
"2633",2018-02-03,"Washington Gulch","w1718","Non.motorized",53,"Sat","weekend","no_sled","2","2","2",4.9,0,21,1,32,23.3,-1,-1,0,0,0,-1,-1,-1
"2634",2018-02-03,"Washington Gulch","w1718","Mechanized",0,"Sat","weekend","no_sled","2","2","2",4.9,0,21,1,32,23.3,-1,-1,0,0,0,-1,-1,-1
"2635",2018-02-03,"Washington Gulch","w1718","Motorized",3,"Sat","weekend","sled","2","2","2",4.9,0,21,1,32,23.3,-1,-1,0,0,0,-1,-1,-1
"2636",2018-02-03,"Washington Gulch","w1718","Hybrid",3,"Sat","weekend","sled","2","2","2",4.9,0,21,1,32,23.3,-1,-1,0,0,0,-1,-1,-1
"2637",2018-02-04,"Washington Gulch","w1718","Non.motorized",69,"Sun","weekend","no_sled","2","2","2",4.9,0,19,-2,32,25.8,1,-1,-1,0,-1,-2,-3,-3
"2638",2018-02-04,"Washington Gulch","w1718","Mechanized",2,"Sun","weekend","no_sled","2","2","2",4.9,0,19,-2,32,25.8,1,-1,-1,0,-1,-2,-3,-3
"2639",2018-02-04,"Washington Gulch","w1718","Motorized",11,"Sun","weekend","sled","2","2","2",4.9,0,19,-2,32,25.8,1,-1,-1,0,-1,-2,-3,-3
"2640",2018-02-04,"Washington Gulch","w1718","Hybrid",5,"Sun","weekend","sled","2","2","2",4.9,0,19,-2,32,25.8,1,-1,-1,0,-1,-2,-3,-3
"2641",2018-02-05,"Washington Gulch","w1718","Non.motorized",10,"Mon","weekday","no_sled","2","2","2",5,0.1,18,-1,29,27.8,-2,1,-1,-1,-3,-2,-3,-4
"2642",2018-02-05,"Washington Gulch","w1718","Mechanized",0,"Mon","weekday","no_sled","2","2","2",5,0.1,18,-1,29,27.8,-2,1,-1,-1,-3,-2,-3,-4
"2643",2018-02-05,"Washington Gulch","w1718","Motorized",2,"Mon","weekday","sled","2","2","2",5,0.1,18,-1,29,27.8,-2,1,-1,-1,-3,-2,-3,-4
"2644",2018-02-05,"Washington Gulch","w1718","Hybrid",0,"Mon","weekday","sled","2","2","2",5,0.1,18,-1,29,27.8,-2,1,-1,-1,-3,-2,-3,-4
"2645",2018-02-06,"Washington Gulch","w1718","Non.motorized",18,"Tue","weekday","no_sled","2","2","2",5.2,0.2,23,5,22,22.6,-1,-2,1,-1,4,2,3,2
"2646",2018-02-06,"Washington Gulch","w1718","Mechanized",0,"Tue","weekday","no_sled","2","2","2",5.2,0.2,23,5,22,22.6,-1,-2,1,-1,4,2,3,2
"2647",2018-02-06,"Washington Gulch","w1718","Motorized",8,"Tue","weekday","sled","2","2","2",5.2,0.2,23,5,22,22.6,-1,-2,1,-1,4,2,3,2
"2648",2018-02-06,"Washington Gulch","w1718","Hybrid",6,"Tue","weekday","sled","2","2","2",5.2,0.2,23,5,22,22.6,-1,-2,1,-1,4,2,3,2
"2649",2018-02-07,"Washington Gulch","w1718","Non.motorized",43,"Wed","weekday","no_sled","2","2","2",5.2,0,23,0,24,22.6,5,-1,-2,1,5,4,2,3
"2650",2018-02-07,"Washington Gulch","w1718","Mechanized",0,"Wed","weekday","no_sled","2","2","2",5.2,0,23,0,24,22.6,5,-1,-2,1,5,4,2,3
"2651",2018-02-07,"Washington Gulch","w1718","Motorized",6,"Wed","weekday","sled","2","2","2",5.2,0,23,0,24,22.6,5,-1,-2,1,5,4,2,3
"2652",2018-02-07,"Washington Gulch","w1718","Hybrid",4,"Wed","weekday","sled","2","2","2",5.2,0,23,0,24,22.6,5,-1,-2,1,5,4,2,3
"2653",2018-02-08,"Washington Gulch","w1718","Non.motorized",18,"Thu","weekday","no_sled","2","2","1",5.3,0.1,25,2,28,21.2,0,5,-1,-2,2,7,6,4
"2654",2018-02-08,"Washington Gulch","w1718","Mechanized",0,"Thu","weekday","no_sled","2","2","1",5.3,0.1,25,2,28,21.2,0,5,-1,-2,2,7,6,4
"2655",2018-02-08,"Washington Gulch","w1718","Motorized",10,"Thu","weekday","sled","2","2","1",5.3,0.1,25,2,28,21.2,0,5,-1,-2,2,7,6,4
"2656",2018-02-08,"Washington Gulch","w1718","Hybrid",8,"Thu","weekday","sled","2","2","1",5.3,0.1,25,2,28,21.2,0,5,-1,-2,2,7,6,4
"2657",2018-02-09,"Washington Gulch","w1718","Non.motorized",27,"Fri","weekday","no_sled","2","2","1",5.3,0,24,-1,33,22.1,2,0,5,-1,1,1,6,5
"2658",2018-02-09,"Washington Gulch","w1718","Mechanized",2,"Fri","weekday","no_sled","2","2","1",5.3,0,24,-1,33,22.1,2,0,5,-1,1,1,6,5
"2659",2018-02-09,"Washington Gulch","w1718","Motorized",4,"Fri","weekday","sled","2","2","1",5.3,0,24,-1,33,22.1,2,0,5,-1,1,1,6,5
"2660",2018-02-09,"Washington Gulch","w1718","Hybrid",3,"Fri","weekday","sled","2","2","1",5.3,0,24,-1,33,22.1,2,0,5,-1,1,1,6,5
"2661",2018-02-10,"Washington Gulch","w1718","Non.motorized",28,"Sat","weekend","no_sled","3","3","2",5.3,0,24,0,24,22.1,-1,2,0,5,-1,1,1,6
"2662",2018-02-10,"Washington Gulch","w1718","Mechanized",0,"Sat","weekend","no_sled","3","3","2",5.3,0,24,0,24,22.1,-1,2,0,5,-1,1,1,6
"2663",2018-02-10,"Washington Gulch","w1718","Motorized",3,"Sat","weekend","sled","3","3","2",5.3,0,24,0,24,22.1,-1,2,0,5,-1,1,1,6
"2664",2018-02-10,"Washington Gulch","w1718","Hybrid",2,"Sat","weekend","sled","3","3","2",5.3,0,24,0,24,22.1,-1,2,0,5,-1,1,1,6
"2665",2018-02-11,"Washington Gulch","w1718","Non.motorized",43,"Sun","weekend","no_sled","3","3","2",5.6,0.3,27,3,13,20.7,0,-1,2,0,3,2,4,4
"2666",2018-02-11,"Washington Gulch","w1718","Mechanized",1,"Sun","weekend","no_sled","3","3","2",5.6,0.3,27,3,13,20.7,0,-1,2,0,3,2,4,4
"2667",2018-02-11,"Washington Gulch","w1718","Motorized",13,"Sun","weekend","sled","3","3","2",5.6,0.3,27,3,13,20.7,0,-1,2,0,3,2,4,4
"2668",2018-02-11,"Washington Gulch","w1718","Hybrid",9,"Sun","weekend","sled","3","3","2",5.6,0.3,27,3,13,20.7,0,-1,2,0,3,2,4,4
"2669",2018-02-12,"Washington Gulch","w1718","Non.motorized",20,"Mon","weekday","no_sled","3","3","3",5.7,0.1,27,0,23,21.1,3,0,-1,2,3,3,2,4
"2670",2018-02-12,"Washington Gulch","w1718","Mechanized",0,"Mon","weekday","no_sled","3","3","3",5.7,0.1,27,0,23,21.1,3,0,-1,2,3,3,2,4
"2671",2018-02-12,"Washington Gulch","w1718","Motorized",2,"Mon","weekday","sled","3","3","3",5.7,0.1,27,0,23,21.1,3,0,-1,2,3,3,2,4
"2672",2018-02-12,"Washington Gulch","w1718","Hybrid",2,"Mon","weekday","sled","3","3","3",5.7,0.1,27,0,23,21.1,3,0,-1,2,3,3,2,4
"2673",2018-02-13,"Washington Gulch","w1718","Non.motorized",9,"Tue","weekday","no_sled","3","3","3",6.1,0.4,29,2,28,21,0,3,0,-1,2,5,5,4
"2674",2018-02-13,"Washington Gulch","w1718","Mechanized",0,"Tue","weekday","no_sled","3","3","3",6.1,0.4,29,2,28,21,0,3,0,-1,2,5,5,4
"2675",2018-02-13,"Washington Gulch","w1718","Motorized",1,"Tue","weekday","sled","3","3","3",6.1,0.4,29,2,28,21,0,3,0,-1,2,5,5,4
"2676",2018-02-13,"Washington Gulch","w1718","Hybrid",0,"Tue","weekday","sled","3","3","3",6.1,0.4,29,2,28,21,0,3,0,-1,2,5,5,4
"2677",2018-02-14,"Washington Gulch","w1718","Non.motorized",30,"Wed","weekday","no_sled","3","3","3",6.2,0.1,30,1,30,20.7,2,0,3,0,3,3,6,6
"2678",2018-02-14,"Washington Gulch","w1718","Mechanized",0,"Wed","weekday","no_sled","3","3","3",6.2,0.1,30,1,30,20.7,2,0,3,0,3,3,6,6
"2679",2018-02-14,"Washington Gulch","w1718","Motorized",2,"Wed","weekday","sled","3","3","3",6.2,0.1,30,1,30,20.7,2,0,3,0,3,3,6,6
"2680",2018-02-14,"Washington Gulch","w1718","Hybrid",0,"Wed","weekday","sled","3","3","3",6.2,0.1,30,1,30,20.7,2,0,3,0,3,3,6,6
"2681",2018-02-15,"Washington Gulch","w1718","Non.motorized",13,"Thu","weekday","no_sled","3","3","3",6.3,0.1,28,-2,24,22.5,1,2,0,3,-1,1,1,4
"2682",2018-02-15,"Washington Gulch","w1718","Mechanized",0,"Thu","weekday","no_sled","3","3","3",6.3,0.1,28,-2,24,22.5,1,2,0,3,-1,1,1,4
"2683",2018-02-15,"Washington Gulch","w1718","Motorized",3,"Thu","weekday","sled","3","3","3",6.3,0.1,28,-2,24,22.5,1,2,0,3,-1,1,1,4
"2684",2018-02-15,"Washington Gulch","w1718","Hybrid",3,"Thu","weekday","sled","3","3","3",6.3,0.1,28,-2,24,22.5,1,2,0,3,-1,1,1,4
"2685",2018-02-16,"Washington Gulch","w1718","Non.motorized",33,"Fri","weekday","no_sled","3","3","3",6.7,0.4,32,4,18,20.9,-2,1,2,0,2,3,5,5
"2686",2018-02-16,"Washington Gulch","w1718","Mechanized",0,"Fri","weekday","no_sled","3","3","3",6.7,0.4,32,4,18,20.9,-2,1,2,0,2,3,5,5
"2687",2018-02-16,"Washington Gulch","w1718","Motorized",4,"Fri","weekday","sled","3","3","3",6.7,0.4,32,4,18,20.9,-2,1,2,0,2,3,5,5
"2688",2018-02-16,"Washington Gulch","w1718","Hybrid",3,"Fri","weekday","sled","3","3","3",6.7,0.4,32,4,18,20.9,-2,1,2,0,2,3,5,5
"2689",2018-02-17,"Washington Gulch","w1718","Non.motorized",84,"Sat","weekend","no_sled","3","3","2",6.7,0,32,0,25,20.9,4,-2,1,2,4,2,3,5
"2690",2018-02-17,"Washington Gulch","w1718","Mechanized",1,"Sat","weekend","no_sled","3","3","2",6.7,0,32,0,25,20.9,4,-2,1,2,4,2,3,5
"2691",2018-02-17,"Washington Gulch","w1718","Motorized",18,"Sat","weekend","sled","3","3","2",6.7,0,32,0,25,20.9,4,-2,1,2,4,2,3,5
"2692",2018-02-17,"Washington Gulch","w1718","Hybrid",9,"Sat","weekend","sled","3","3","2",6.7,0,32,0,25,20.9,4,-2,1,2,4,2,3,5
"2693",2018-02-18,"Washington Gulch","w1718","Non.motorized",81,"Sun","weekend","no_sled","2","2","2",6.7,0,31,-1,32,21.6,0,4,-2,1,-1,3,1,2
"2694",2018-02-18,"Washington Gulch","w1718","Mechanized",0,"Sun","weekend","no_sled","2","2","2",6.7,0,31,-1,32,21.6,0,4,-2,1,-1,3,1,2
"2695",2018-02-18,"Washington Gulch","w1718","Motorized",14,"Sun","weekend","sled","2","2","2",6.7,0,31,-1,32,21.6,0,4,-2,1,-1,3,1,2
"2696",2018-02-18,"Washington Gulch","w1718","Hybrid",5,"Sun","weekend","sled","2","2","2",6.7,0,31,-1,32,21.6,0,4,-2,1,-1,3,1,2
"2697",2018-02-19,"Washington Gulch","w1718","Non.motorized",21,"Mon","weekday","no_sled","2","2","2",6.8,0.1,29,-2,24,23.4,-1,0,4,-2,-3,-3,1,-1
"2698",2018-02-19,"Washington Gulch","w1718","Non.motorized",21,"Mon","weekday","no_sled","3","3","3",6.8,0.1,29,-2,24,23.4,-1,0,4,-2,-3,-3,1,-1
"2699",2018-02-19,"Washington Gulch","w1718","Mechanized",0,"Mon","weekday","no_sled","2","2","2",6.8,0.1,29,-2,24,23.4,-1,0,4,-2,-3,-3,1,-1
"2700",2018-02-19,"Washington Gulch","w1718","Mechanized",0,"Mon","weekday","no_sled","3","3","3",6.8,0.1,29,-2,24,23.4,-1,0,4,-2,-3,-3,1,-1
"2701",2018-02-19,"Washington Gulch","w1718","Motorized",2,"Mon","weekday","sled","2","2","2",6.8,0.1,29,-2,24,23.4,-1,0,4,-2,-3,-3,1,-1
"2702",2018-02-19,"Washington Gulch","w1718","Motorized",2,"Mon","weekday","sled","3","3","3",6.8,0.1,29,-2,24,23.4,-1,0,4,-2,-3,-3,1,-1
"2703",2018-02-19,"Washington Gulch","w1718","Hybrid",0,"Mon","weekday","sled","2","2","2",6.8,0.1,29,-2,24,23.4,-1,0,4,-2,-3,-3,1,-1
"2704",2018-02-19,"Washington Gulch","w1718","Hybrid",0,"Mon","weekday","sled","3","3","3",6.8,0.1,29,-2,24,23.4,-1,0,4,-2,-3,-3,1,-1
"2705",2018-02-20,"Washington Gulch","w1718","Non.motorized",19,"Tue","weekday","no_sled","3","3","3",6.8,0,31,2,8,21.9,-2,-1,0,4,0,-1,-1,3
"2706",2018-02-20,"Washington Gulch","w1718","Mechanized",0,"Tue","weekday","no_sled","3","3","3",6.8,0,31,2,8,21.9,-2,-1,0,4,0,-1,-1,3
"2707",2018-02-20,"Washington Gulch","w1718","Motorized",2,"Tue","weekday","sled","3","3","3",6.8,0,31,2,8,21.9,-2,-1,0,4,0,-1,-1,3
"2708",2018-02-20,"Washington Gulch","w1718","Hybrid",0,"Tue","weekday","sled","3","3","3",6.8,0,31,2,8,21.9,-2,-1,0,4,0,-1,-1,3
"2709",2018-02-21,"Washington Gulch","w1718","Non.motorized",16,"Wed","weekday","no_sled","3","3","3",6.8,0,31,0,11,21.9,2,-2,-1,0,2,0,-1,-1
"2710",2018-02-21,"Washington Gulch","w1718","Mechanized",0,"Wed","weekday","no_sled","3","3","3",6.8,0,31,0,11,21.9,2,-2,-1,0,2,0,-1,-1
"2711",2018-02-21,"Washington Gulch","w1718","Motorized",4,"Wed","weekday","sled","3","3","3",6.8,0,31,0,11,21.9,2,-2,-1,0,2,0,-1,-1
"2712",2018-02-21,"Washington Gulch","w1718","Hybrid",2,"Wed","weekday","sled","3","3","3",6.8,0,31,0,11,21.9,2,-2,-1,0,2,0,-1,-1
"2713",2018-02-22,"Washington Gulch","w1718","Non.motorized",20,"Thu","weekday","no_sled","3","3","2",6.8,0,30,-1,16,22.7,0,2,-2,-1,-1,1,-1,-2
"2714",2018-02-22,"Washington Gulch","w1718","Mechanized",0,"Thu","weekday","no_sled","3","3","2",6.8,0,30,-1,16,22.7,0,2,-2,-1,-1,1,-1,-2
"2715",2018-02-22,"Washington Gulch","w1718","Motorized",0,"Thu","weekday","sled","3","3","2",6.8,0,30,-1,16,22.7,0,2,-2,-1,-1,1,-1,-2
"2716",2018-02-22,"Washington Gulch","w1718","Hybrid",0,"Thu","weekday","sled","3","3","2",6.8,0,30,-1,16,22.7,0,2,-2,-1,-1,1,-1,-2
"2717",2018-02-23,"Washington Gulch","w1718","Non.motorized",21,"Fri","weekday","no_sled","3","3","2",6.9,0.1,30,0,15,23,-1,0,2,-2,-1,-1,1,-1
"2718",2018-02-23,"Washington Gulch","w1718","Mechanized",0,"Fri","weekday","no_sled","3","3","2",6.9,0.1,30,0,15,23,-1,0,2,-2,-1,-1,1,-1
"2719",2018-02-23,"Washington Gulch","w1718","Motorized",5,"Fri","weekday","sled","3","3","2",6.9,0.1,30,0,15,23,-1,0,2,-2,-1,-1,1,-1
"2720",2018-02-23,"Washington Gulch","w1718","Hybrid",1,"Fri","weekday","sled","3","3","2",6.9,0.1,30,0,15,23,-1,0,2,-2,-1,-1,1,-1
"2721",2018-02-24,"Washington Gulch","w1718","Non.motorized",40,"Sat","weekend","no_sled","3","3","2",6.9,0,31,1,10,22.3,0,-1,0,2,1,0,0,2
"2722",2018-02-24,"Washington Gulch","w1718","Mechanized",0,"Sat","weekend","no_sled","3","3","2",6.9,0,31,1,10,22.3,0,-1,0,2,1,0,0,2
"2723",2018-02-24,"Washington Gulch","w1718","Motorized",20,"Sat","weekend","sled","3","3","2",6.9,0,31,1,10,22.3,0,-1,0,2,1,0,0,2
"2724",2018-02-24,"Washington Gulch","w1718","Hybrid",11,"Sat","weekend","sled","3","3","2",6.9,0,31,1,10,22.3,0,-1,0,2,1,0,0,2
"2725",2018-02-25,"Washington Gulch","w1718","Non.motorized",35,"Sun","weekend","no_sled","3","3","2",7.1,0.2,32,1,11,22.2,1,0,-1,0,2,2,1,1
"2726",2018-02-25,"Washington Gulch","w1718","Mechanized",0,"Sun","weekend","no_sled","3","3","2",7.1,0.2,32,1,11,22.2,1,0,-1,0,2,2,1,1
"2727",2018-02-25,"Washington Gulch","w1718","Motorized",11,"Sun","weekend","sled","3","3","2",7.1,0.2,32,1,11,22.2,1,0,-1,0,2,2,1,1
"2728",2018-02-25,"Washington Gulch","w1718","Hybrid",6,"Sun","weekend","sled","3","3","2",7.1,0.2,32,1,11,22.2,1,0,-1,0,2,2,1,1
"2729",2018-02-26,"Washington Gulch","w1718","Non.motorized",19,"Mon","weekday","no_sled","2","2","2",7.1,0,32,0,20,22.2,1,1,0,-1,1,2,2,1
"2730",2018-02-26,"Washington Gulch","w1718","Mechanized",0,"Mon","weekday","no_sled","2","2","2",7.1,0,32,0,20,22.2,1,1,0,-1,1,2,2,1
"2731",2018-02-26,"Washington Gulch","w1718","Motorized",13,"Mon","weekday","sled","2","2","2",7.1,0,32,0,20,22.2,1,1,0,-1,1,2,2,1
"2732",2018-02-26,"Washington Gulch","w1718","Hybrid",9,"Mon","weekday","sled","2","2","2",7.1,0,32,0,20,22.2,1,1,0,-1,1,2,2,1
"2733",2018-02-27,"Washington Gulch","w1718","Non.motorized",30,"Tue","weekday","no_sled","2","2","2",7.2,0.1,32,0,26,22.5,0,1,1,0,0,1,2,2
"2734",2018-02-27,"Washington Gulch","w1718","Mechanized",1,"Tue","weekday","no_sled","2","2","2",7.2,0.1,32,0,26,22.5,0,1,1,0,0,1,2,2
"2735",2018-02-27,"Washington Gulch","w1718","Motorized",10,"Tue","weekday","sled","2","2","2",7.2,0.1,32,0,26,22.5,0,1,1,0,0,1,2,2
"2736",2018-02-27,"Washington Gulch","w1718","Hybrid",5,"Tue","weekday","sled","2","2","2",7.2,0.1,32,0,26,22.5,0,1,1,0,0,1,2,2
"2737",2018-02-28,"Washington Gulch","w1718","Non.motorized",17,"Wed","weekday","no_sled","2","2","2",7.2,0,31,-1,23,23.2,0,0,1,1,-1,-1,0,1
"2738",2018-02-28,"Washington Gulch","w1718","Mechanized",0,"Wed","weekday","no_sled","2","2","2",7.2,0,31,-1,23,23.2,0,0,1,1,-1,-1,0,1
"2739",2018-02-28,"Washington Gulch","w1718","Motorized",7,"Wed","weekday","sled","2","2","2",7.2,0,31,-1,23,23.2,0,0,1,1,-1,-1,0,1
"2740",2018-02-28,"Washington Gulch","w1718","Hybrid",3,"Wed","weekday","sled","2","2","2",7.2,0,31,-1,23,23.2,0,0,1,1,-1,-1,0,1
"2741",2018-03-01,"Washington Gulch","w1718","Non.motorized",25,"Thu","weekday","no_sled","2","2","2",7.2,0,31,0,24,23.2,-1,0,0,1,-1,-1,-1,0
"2742",2018-03-01,"Washington Gulch","w1718","Mechanized",2,"Thu","weekday","no_sled","2","2","2",7.2,0,31,0,24,23.2,-1,0,0,1,-1,-1,-1,0
"2743",2018-03-01,"Washington Gulch","w1718","Motorized",8,"Thu","weekday","sled","2","2","2",7.2,0,31,0,24,23.2,-1,0,0,1,-1,-1,-1,0
"2744",2018-03-01,"Washington Gulch","w1718","Hybrid",4,"Thu","weekday","sled","2","2","2",7.2,0,31,0,24,23.2,-1,0,0,1,-1,-1,-1,0
"2745",2018-03-02,"Washington Gulch","w1718","Non.motorized",17,"Fri","weekday","no_sled","2","2","1",7.2,0,31,0,30,23.2,0,-1,0,0,0,-1,-1,-1
"2746",2018-03-02,"Washington Gulch","w1718","Mechanized",0,"Fri","weekday","no_sled","2","2","1",7.2,0,31,0,30,23.2,0,-1,0,0,0,-1,-1,-1
"2747",2018-03-02,"Washington Gulch","w1718","Motorized",11,"Fri","weekday","sled","2","2","1",7.2,0,31,0,30,23.2,0,-1,0,0,0,-1,-1,-1
"2748",2018-03-02,"Washington Gulch","w1718","Hybrid",6,"Fri","weekday","sled","2","2","1",7.2,0,31,0,30,23.2,0,-1,0,0,0,-1,-1,-1
"2749",2018-03-03,"Washington Gulch","w1718","Non.motorized",103,"Sat","weekend","no_sled","2","2","1",7.3,0.1,30,-1,34,24.3,0,0,-1,0,-1,-1,-2,-2
"2750",2018-03-03,"Washington Gulch","w1718","Mechanized",0,"Sat","weekend","no_sled","2","2","1",7.3,0.1,30,-1,34,24.3,0,0,-1,0,-1,-1,-2,-2
"2751",2018-03-03,"Washington Gulch","w1718","Motorized",21,"Sat","weekend","sled","2","2","1",7.3,0.1,30,-1,34,24.3,0,0,-1,0,-1,-1,-2,-2
"2752",2018-03-03,"Washington Gulch","w1718","Hybrid",5,"Sat","weekend","sled","2","2","1",7.3,0.1,30,-1,34,24.3,0,0,-1,0,-1,-1,-2,-2
"2753",2018-03-04,"Washington Gulch","w1718","Non.motorized",39,"Sun","weekend","no_sled","2","2","1",7.3,0,29,-1,24,25.2,-1,0,0,-1,-2,-2,-2,-3
"2754",2018-03-04,"Washington Gulch","w1718","Mechanized",2,"Sun","weekend","no_sled","2","2","1",7.3,0,29,-1,24,25.2,-1,0,0,-1,-2,-2,-2,-3
"2755",2018-03-04,"Washington Gulch","w1718","Motorized",6,"Sun","weekend","sled","2","2","1",7.3,0,29,-1,24,25.2,-1,0,0,-1,-2,-2,-2,-3
"2756",2018-03-04,"Washington Gulch","w1718","Hybrid",0,"Sun","weekend","sled","2","2","1",7.3,0,29,-1,24,25.2,-1,0,0,-1,-2,-2,-2,-3
"2757",2018-03-05,"Washington Gulch","w1718","Non.motorized",10,"Mon","weekday","no_sled","2","2","1",7.3,0,31,2,13,23.5,-1,-1,0,0,1,0,0,0
"2758",2018-03-05,"Washington Gulch","w1718","Mechanized",0,"Mon","weekday","no_sled","2","2","1",7.3,0,31,2,13,23.5,-1,-1,0,0,1,0,0,0
"2759",2018-03-05,"Washington Gulch","w1718","Motorized",5,"Mon","weekday","sled","2","2","1",7.3,0,31,2,13,23.5,-1,-1,0,0,1,0,0,0
"2760",2018-03-05,"Washington Gulch","w1718","Hybrid",0,"Mon","weekday","sled","2","2","1",7.3,0,31,2,13,23.5,-1,-1,0,0,1,0,0,0
"2761",2018-03-06,"Washington Gulch","w1718","Non.motorized",17,"Tue","weekday","no_sled","2","2","1",7.3,0,31,0,19,23.5,2,-1,-1,0,2,1,0,0
"2762",2018-03-06,"Washington Gulch","w1718","Mechanized",0,"Tue","weekday","no_sled","2","2","1",7.3,0,31,0,19,23.5,2,-1,-1,0,2,1,0,0
"2763",2018-03-06,"Washington Gulch","w1718","Motorized",10,"Tue","weekday","sled","2","2","1",7.3,0,31,0,19,23.5,2,-1,-1,0,2,1,0,0
"2764",2018-03-06,"Washington Gulch","w1718","Hybrid",6,"Tue","weekday","sled","2","2","1",7.3,0,31,0,19,23.5,2,-1,-1,0,2,1,0,0
"2765",2018-03-07,"Washington Gulch","w1718","Non.motorized",22,"Wed","weekday","no_sled","2","2","1",7.4,0.1,31,0,27,23.9,0,2,-1,-1,0,2,1,0
"2766",2018-03-07,"Washington Gulch","w1718","Mechanized",0,"Wed","weekday","no_sled","2","2","1",7.4,0.1,31,0,27,23.9,0,2,-1,-1,0,2,1,0
"2767",2018-03-07,"Washington Gulch","w1718","Motorized",2,"Wed","weekday","sled","2","2","1",7.4,0.1,31,0,27,23.9,0,2,-1,-1,0,2,1,0
"2768",2018-03-07,"Washington Gulch","w1718","Hybrid",2,"Wed","weekday","sled","2","2","1",7.4,0.1,31,0,27,23.9,0,2,-1,-1,0,2,1,0
"2769",2018-03-08,"Washington Gulch","w1718","Non.motorized",17,"Thu","weekday","no_sled","2","2","1",7.4,0,30,-1,33,24.7,0,0,2,-1,-1,-1,1,0
"2770",2018-03-08,"Washington Gulch","w1718","Mechanized",1,"Thu","weekday","no_sled","2","2","1",7.4,0,30,-1,33,24.7,0,0,2,-1,-1,-1,1,0
"2771",2018-03-08,"Washington Gulch","w1718","Motorized",15,"Thu","weekday","sled","2","2","1",7.4,0,30,-1,33,24.7,0,0,2,-1,-1,-1,1,0
"2772",2018-03-08,"Washington Gulch","w1718","Hybrid",8,"Thu","weekday","sled","2","2","1",7.4,0,30,-1,33,24.7,0,0,2,-1,-1,-1,1,0
"2773",2018-03-09,"Washington Gulch","w1718","Non.motorized",26,"Fri","weekday","no_sled","2","2","1",7.4,0,30,0,34,24.7,-1,0,0,2,-1,-1,-1,1
"2774",2018-03-09,"Washington Gulch","w1718","Mechanized",3,"Fri","weekday","no_sled","2","2","1",7.4,0,30,0,34,24.7,-1,0,0,2,-1,-1,-1,1
"2775",2018-03-09,"Washington Gulch","w1718","Motorized",3,"Fri","weekday","sled","2","2","1",7.4,0,30,0,34,24.7,-1,0,0,2,-1,-1,-1,1
"2776",2018-03-09,"Washington Gulch","w1718","Hybrid",2,"Fri","weekday","sled","2","2","1",7.4,0,30,0,34,24.7,-1,0,0,2,-1,-1,-1,1
"2777",2018-03-10,"Washington Gulch","w1718","Non.motorized",69,"Sat","weekend","no_sled","1","1","1",7.4,0,30,0,31,24.7,0,-1,0,0,0,-1,-1,-1
"2778",2018-03-10,"Washington Gulch","w1718","Mechanized",2,"Sat","weekend","no_sled","1","1","1",7.4,0,30,0,31,24.7,0,-1,0,0,0,-1,-1,-1
"2779",2018-03-10,"Washington Gulch","w1718","Motorized",4,"Sat","weekend","sled","1","1","1",7.4,0,30,0,31,24.7,0,-1,0,0,0,-1,-1,-1
"2780",2018-03-10,"Washington Gulch","w1718","Hybrid",3,"Sat","weekend","sled","1","1","1",7.4,0,30,0,31,24.7,0,-1,0,0,0,-1,-1,-1
"2781",2018-03-11,"Washington Gulch","w1718","Non.motorized",35,"Sun","weekend","no_sled","1","1","1",7.4,0,29,-1,31,25.5,0,0,-1,0,-1,-1,-2,-2
"2782",2018-03-11,"Washington Gulch","w1718","Mechanized",3,"Sun","weekend","no_sled","1","1","1",7.4,0,29,-1,31,25.5,0,0,-1,0,-1,-1,-2,-2
"2783",2018-03-11,"Washington Gulch","w1718","Motorized",15,"Sun","weekend","sled","1","1","1",7.4,0,29,-1,31,25.5,0,0,-1,0,-1,-1,-2,-2
"2784",2018-03-11,"Washington Gulch","w1718","Hybrid",10,"Sun","weekend","sled","1","1","1",7.4,0,29,-1,31,25.5,0,0,-1,0,-1,-1,-2,-2
"2785",2018-03-12,"Washington Gulch","w1718","Non.motorized",18,"Mon","weekday","no_sled","1","1","1",7.4,0,29,0,33,25.5,-1,0,0,-1,-1,-1,-1,-2
"2786",2018-03-12,"Washington Gulch","w1718","Mechanized",0,"Mon","weekday","no_sled","1","1","1",7.4,0,29,0,33,25.5,-1,0,0,-1,-1,-1,-1,-2
"2787",2018-03-12,"Washington Gulch","w1718","Motorized",12,"Mon","weekday","sled","1","1","1",7.4,0,29,0,33,25.5,-1,0,0,-1,-1,-1,-1,-2
"2788",2018-03-12,"Washington Gulch","w1718","Hybrid",9,"Mon","weekday","sled","1","1","1",7.4,0,29,0,33,25.5,-1,0,0,-1,-1,-1,-1,-2
"2789",2018-03-13,"Washington Gulch","w1718","Non.motorized",20,"Tue","weekday","no_sled","1","1","1",7.4,0,29,0,34,25.5,0,-1,0,0,0,-1,-1,-1
"2790",2018-03-13,"Washington Gulch","w1718","Mechanized",2,"Tue","weekday","no_sled","1","1","1",7.4,0,29,0,34,25.5,0,-1,0,0,0,-1,-1,-1
"2791",2018-03-13,"Washington Gulch","w1718","Motorized",7,"Tue","weekday","sled","1","1","1",7.4,0,29,0,34,25.5,0,-1,0,0,0,-1,-1,-1
"2792",2018-03-13,"Washington Gulch","w1718","Hybrid",6,"Tue","weekday","sled","1","1","1",7.4,0,29,0,34,25.5,0,-1,0,0,0,-1,-1,-1
"2793",2018-03-14,"Washington Gulch","w1718","Non.motorized",31,"Wed","weekday","no_sled","1","2","2",7.4,0,29,0,39,25.5,0,0,-1,0,0,0,-1,-1
"2794",2018-03-14,"Washington Gulch","w1718","Mechanized",1,"Wed","weekday","no_sled","1","2","2",7.4,0,29,0,39,25.5,0,0,-1,0,0,0,-1,-1
"2795",2018-03-14,"Washington Gulch","w1718","Motorized",9,"Wed","weekday","sled","1","2","2",7.4,0,29,0,39,25.5,0,0,-1,0,0,0,-1,-1
"2796",2018-03-14,"Washington Gulch","w1718","Hybrid",5,"Wed","weekday","sled","1","2","2",7.4,0,29,0,39,25.5,0,0,-1,0,0,0,-1,-1
"2797",2018-03-15,"Washington Gulch","w1718","Non.motorized",20,"Thu","weekday","no_sled","2","2","2",7.5,0.1,28,-1,31,26.8,0,0,0,-1,-1,-1,-1,-2
"2798",2018-03-15,"Washington Gulch","w1718","Mechanized",0,"Thu","weekday","no_sled","2","2","2",7.5,0.1,28,-1,31,26.8,0,0,0,-1,-1,-1,-1,-2
"2799",2018-03-15,"Washington Gulch","w1718","Motorized",16,"Thu","weekday","sled","2","2","2",7.5,0.1,28,-1,31,26.8,0,0,0,-1,-1,-1,-1,-2
"2800",2018-03-15,"Washington Gulch","w1718","Hybrid",7,"Thu","weekday","sled","2","2","2",7.5,0.1,28,-1,31,26.8,0,0,0,-1,-1,-1,-1,-2
"2801",2018-03-16,"Washington Gulch","w1718","Non.motorized",11,"Fri","weekday","no_sled","2","2","2",7.7,0.2,29,1,25,26.6,-1,0,0,0,0,0,0,0
"2802",2018-03-16,"Washington Gulch","w1718","Mechanized",0,"Fri","weekday","no_sled","2","2","2",7.7,0.2,29,1,25,26.6,-1,0,0,0,0,0,0,0
"2803",2018-03-16,"Washington Gulch","w1718","Motorized",24,"Fri","weekday","sled","2","2","2",7.7,0.2,29,1,25,26.6,-1,0,0,0,0,0,0,0
"2804",2018-03-16,"Washington Gulch","w1718","Hybrid",7,"Fri","weekday","sled","2","2","2",7.7,0.2,29,1,25,26.6,-1,0,0,0,0,0,0,0
"2805",2018-03-17,"Washington Gulch","w1718","Non.motorized",57,"Sat","weekend","no_sled","2","2","2",7.8,0.1,32,3,29,24.4,1,-1,0,0,4,3,3,3
"2806",2018-03-17,"Washington Gulch","w1718","Mechanized",2,"Sat","weekend","no_sled","2","2","2",7.8,0.1,32,3,29,24.4,1,-1,0,0,4,3,3,3
"2807",2018-03-17,"Washington Gulch","w1718","Motorized",24,"Sat","weekend","sled","2","2","2",7.8,0.1,32,3,29,24.4,1,-1,0,0,4,3,3,3
"2808",2018-03-17,"Washington Gulch","w1718","Hybrid",8,"Sat","weekend","sled","2","2","2",7.8,0.1,32,3,29,24.4,1,-1,0,0,4,3,3,3
"2809",2018-03-18,"Washington Gulch","w1718","Non.motorized",12,"Sun","weekend","no_sled","2","2","2",7.9,0.1,31,-1,24,25.5,3,1,-1,0,2,3,2,2
"2810",2018-03-18,"Washington Gulch","w1718","Mechanized",0,"Sun","weekend","no_sled","2","2","2",7.9,0.1,31,-1,24,25.5,3,1,-1,0,2,3,2,2
"2811",2018-03-18,"Washington Gulch","w1718","Motorized",11,"Sun","weekend","sled","2","2","2",7.9,0.1,31,-1,24,25.5,3,1,-1,0,2,3,2,2
"2812",2018-03-18,"Washington Gulch","w1718","Hybrid",6,"Sun","weekend","sled","2","2","2",7.9,0.1,31,-1,24,25.5,3,1,-1,0,2,3,2,2
"2813",2018-03-19,"Washington Gulch","w1718","Non.motorized",17,"Mon","weekday","no_sled","2","2","1",8,0.1,32,1,19,25,-1,3,1,-1,0,3,4,3
"2814",2018-03-19,"Washington Gulch","w1718","Mechanized",0,"Mon","weekday","no_sled","2","2","1",8,0.1,32,1,19,25,-1,3,1,-1,0,3,4,3
"2815",2018-03-19,"Washington Gulch","w1718","Motorized",5,"Mon","weekday","sled","2","2","1",8,0.1,32,1,19,25,-1,3,1,-1,0,3,4,3
"2816",2018-03-19,"Washington Gulch","w1718","Hybrid",1,"Mon","weekday","sled","2","2","1",8,0.1,32,1,19,25,-1,3,1,-1,0,3,4,3
"2817",2018-03-20,"Washington Gulch","w1718","Non.motorized",16,"Tue","weekday","no_sled","2","2","1",8,0,30,-2,24,26.7,1,-1,3,1,-1,-2,1,2
"2818",2018-03-20,"Washington Gulch","w1718","Mechanized",0,"Tue","weekday","no_sled","2","2","1",8,0,30,-2,24,26.7,1,-1,3,1,-1,-2,1,2
"2819",2018-03-20,"Washington Gulch","w1718","Motorized",9,"Tue","weekday","sled","2","2","1",8,0,30,-2,24,26.7,1,-1,3,1,-1,-2,1,2
"2820",2018-03-20,"Washington Gulch","w1718","Hybrid",4,"Tue","weekday","sled","2","2","1",8,0,30,-2,24,26.7,1,-1,3,1,-1,-2,1,2
"2821",2018-03-21,"Washington Gulch","w1718","Non.motorized",31,"Wed","weekday","no_sled","1","1","1",8.1,0.1,32,2,30,25.3,-2,1,-1,3,0,1,0,3
"2822",2018-03-21,"Washington Gulch","w1718","Mechanized",0,"Wed","weekday","no_sled","1","1","1",8.1,0.1,32,2,30,25.3,-2,1,-1,3,0,1,0,3
"2823",2018-03-21,"Washington Gulch","w1718","Motorized",2,"Wed","weekday","sled","1","1","1",8.1,0.1,32,2,30,25.3,-2,1,-1,3,0,1,0,3
"2824",2018-03-21,"Washington Gulch","w1718","Hybrid",2,"Wed","weekday","sled","1","1","1",8.1,0.1,32,2,30,25.3,-2,1,-1,3,0,1,0,3
"2825",2018-03-22,"Washington Gulch","w1718","Non.motorized",18,"Thu","weekday","no_sled","1","1","1",8.1,0,30,-2,36,27,2,-2,1,-1,0,-2,-1,-2
"2826",2018-03-22,"Washington Gulch","w1718","Mechanized",0,"Thu","weekday","no_sled","1","1","1",8.1,0,30,-2,36,27,2,-2,1,-1,0,-2,-1,-2
"2827",2018-03-22,"Washington Gulch","w1718","Motorized",2,"Thu","weekday","sled","1","1","1",8.1,0,30,-2,36,27,2,-2,1,-1,0,-2,-1,-2
"2828",2018-03-22,"Washington Gulch","w1718","Hybrid",0,"Thu","weekday","sled","1","1","1",8.1,0,30,-2,36,27,2,-2,1,-1,0,-2,-1,-2
"2829",2018-03-23,"Washington Gulch","w1718","Non.motorized",1,"Fri","weekday","no_sled","2","2","3",8.2,0.1,29,-1,34,28.3,-2,2,-2,1,-3,-1,-3,-2
"2830",2018-03-23,"Washington Gulch","w1718","Mechanized",0,"Fri","weekday","no_sled","2","2","3",8.2,0.1,29,-1,34,28.3,-2,2,-2,1,-3,-1,-3,-2
"2831",2018-03-23,"Washington Gulch","w1718","Motorized",0,"Fri","weekday","sled","2","2","3",8.2,0.1,29,-1,34,28.3,-2,2,-2,1,-3,-1,-3,-2
"2832",2018-03-23,"Washington Gulch","w1718","Hybrid",0,"Fri","weekday","sled","2","2","3",8.2,0.1,29,-1,34,28.3,-2,2,-2,1,-3,-1,-3,-2
"2833",2018-03-24,"Washington Gulch","w1718","Non.motorized",25,"Sat","weekend","no_sled","2","2","1",8.9,0.7,34,5,32,26.2,-1,-2,2,-2,4,2,4,2
"2834",2018-03-24,"Washington Gulch","w1718","Mechanized",0,"Sat","weekend","no_sled","2","2","1",8.9,0.7,34,5,32,26.2,-1,-2,2,-2,4,2,4,2
"2835",2018-03-24,"Washington Gulch","w1718","Motorized",16,"Sat","weekend","sled","2","2","1",8.9,0.7,34,5,32,26.2,-1,-2,2,-2,4,2,4,2
"2836",2018-03-24,"Washington Gulch","w1718","Hybrid",1,"Sat","weekend","sled","2","2","1",8.9,0.7,34,5,32,26.2,-1,-2,2,-2,4,2,4,2
"2837",2018-03-25,"Washington Gulch","w1718","Non.motorized",36,"Sun","weekend","no_sled","2","2","1",8.9,0,35,1,35,25.4,5,-1,-2,2,6,5,3,5
"2838",2018-03-25,"Washington Gulch","w1718","Mechanized",0,"Sun","weekend","no_sled","2","2","1",8.9,0,35,1,35,25.4,5,-1,-2,2,6,5,3,5
"2839",2018-03-25,"Washington Gulch","w1718","Motorized",10,"Sun","weekend","sled","2","2","1",8.9,0,35,1,35,25.4,5,-1,-2,2,6,5,3,5
"2840",2018-03-25,"Washington Gulch","w1718","Hybrid",6,"Sun","weekend","sled","2","2","1",8.9,0,35,1,35,25.4,5,-1,-2,2,6,5,3,5
"2841",2018-03-26,"Washington Gulch","w1718","Non.motorized",29,"Mon","weekday","no_sled","1","1","1",8.9,0,34,-1,31,26.2,1,5,-1,-2,0,5,4,2
"2842",2018-03-26,"Washington Gulch","w1718","Non.motorized",29,"Mon","weekday","no_sled","2","1","1",8.9,0,34,-1,31,26.2,1,5,-1,-2,0,5,4,2
"2843",2018-03-26,"Washington Gulch","w1718","Mechanized",0,"Mon","weekday","no_sled","1","1","1",8.9,0,34,-1,31,26.2,1,5,-1,-2,0,5,4,2
"2844",2018-03-26,"Washington Gulch","w1718","Mechanized",0,"Mon","weekday","no_sled","2","1","1",8.9,0,34,-1,31,26.2,1,5,-1,-2,0,5,4,2
"2845",2018-03-26,"Washington Gulch","w1718","Motorized",6,"Mon","weekday","sled","1","1","1",8.9,0,34,-1,31,26.2,1,5,-1,-2,0,5,4,2
"2846",2018-03-26,"Washington Gulch","w1718","Motorized",6,"Mon","weekday","sled","2","1","1",8.9,0,34,-1,31,26.2,1,5,-1,-2,0,5,4,2
"2847",2018-03-26,"Washington Gulch","w1718","Hybrid",3,"Mon","weekday","sled","1","1","1",8.9,0,34,-1,31,26.2,1,5,-1,-2,0,5,4,2
"2848",2018-03-26,"Washington Gulch","w1718","Hybrid",3,"Mon","weekday","sled","2","1","1",8.9,0,34,-1,31,26.2,1,5,-1,-2,0,5,4,2
"2849",2018-03-27,"Washington Gulch","w1718","Non.motorized",20,"Tue","weekday","no_sled","1","1","1",8.9,0,33,-1,29,27,-1,1,5,-1,-2,-1,4,3
"2850",2018-03-27,"Washington Gulch","w1718","Mechanized",0,"Tue","weekday","no_sled","1","1","1",8.9,0,33,-1,29,27,-1,1,5,-1,-2,-1,4,3
"2851",2018-03-27,"Washington Gulch","w1718","Motorized",10,"Tue","weekday","sled","1","1","1",8.9,0,33,-1,29,27,-1,1,5,-1,-2,-1,4,3
"2852",2018-03-27,"Washington Gulch","w1718","Hybrid",2,"Tue","weekday","sled","1","1","1",8.9,0,33,-1,29,27,-1,1,5,-1,-2,-1,4,3
"2853",2018-03-28,"Washington Gulch","w1718","Non.motorized",20,"Wed","weekday","no_sled","1","1","1",8.9,0,33,0,27,27,-1,-1,1,5,-1,-2,-1,4
"2854",2018-03-28,"Washington Gulch","w1718","Mechanized",0,"Wed","weekday","no_sled","1","1","1",8.9,0,33,0,27,27,-1,-1,1,5,-1,-2,-1,4
"2855",2018-03-28,"Washington Gulch","w1718","Motorized",3,"Wed","weekday","sled","1","1","1",8.9,0,33,0,27,27,-1,-1,1,5,-1,-2,-1,4
"2856",2018-03-28,"Washington Gulch","w1718","Hybrid",2,"Wed","weekday","sled","1","1","1",8.9,0,33,0,27,27,-1,-1,1,5,-1,-2,-1,4
"2857",2018-03-29,"Washington Gulch","w1718","Non.motorized",20,"Thu","weekday","no_sled","1","1","1",8.9,0,33,0,27,27,0,-1,-1,1,0,-1,-2,-1
"2858",2018-03-29,"Washington Gulch","w1718","Mechanized",0,"Thu","weekday","no_sled","1","1","1",8.9,0,33,0,27,27,0,-1,-1,1,0,-1,-2,-1
"2859",2018-03-29,"Washington Gulch","w1718","Motorized",3,"Thu","weekday","sled","1","1","1",8.9,0,33,0,27,27,0,-1,-1,1,0,-1,-2,-1
"2860",2018-03-29,"Washington Gulch","w1718","Hybrid",2,"Thu","weekday","sled","1","1","1",8.9,0,33,0,27,27,0,-1,-1,1,0,-1,-2,-1
"2861",2018-03-30,"Washington Gulch","w1718","Non.motorized",30,"Fri","weekday","no_sled","1","1","1",8.9,0,32,-1,33,27.8,0,0,-1,-1,-1,-1,-2,-3
"2862",2018-03-30,"Washington Gulch","w1718","Mechanized",0,"Fri","weekday","no_sled","1","1","1",8.9,0,32,-1,33,27.8,0,0,-1,-1,-1,-1,-2,-3
"2863",2018-03-30,"Washington Gulch","w1718","Motorized",3,"Fri","weekday","sled","1","1","1",8.9,0,32,-1,33,27.8,0,0,-1,-1,-1,-1,-2,-3
"2864",2018-03-30,"Washington Gulch","w1718","Hybrid",0,"Fri","weekday","sled","1","1","1",8.9,0,32,-1,33,27.8,0,0,-1,-1,-1,-1,-2,-3
"2865",2018-03-31,"Washington Gulch","w1718","Non.motorized",50,"Sat","weekend","no_sled","1","1","1",8.9,0,32,0,39,27.8,-1,0,0,-1,-1,-1,-1,-2
"2866",2018-03-31,"Washington Gulch","w1718","Mechanized",0,"Sat","weekend","no_sled","1","1","1",8.9,0,32,0,39,27.8,-1,0,0,-1,-1,-1,-1,-2
"2867",2018-03-31,"Washington Gulch","w1718","Motorized",10,"Sat","weekend","sled","1","1","1",8.9,0,32,0,39,27.8,-1,0,0,-1,-1,-1,-1,-2
"2868",2018-03-31,"Washington Gulch","w1718","Hybrid",5,"Sat","weekend","sled","1","1","1",8.9,0,32,0,39,27.8,-1,0,0,-1,-1,-1,-1,-2
"2869",2018-04-01,"Washington Gulch","w1718","Non.motorized",18,"Sun","weekend","no_sled","1","1","1",8.8,-0.1,30,-2,41,29.3,0,-1,0,0,-2,-3,-3,-3
"2870",2018-04-01,"Washington Gulch","w1718","Mechanized",0,"Sun","weekend","no_sled","1","1","1",8.8,-0.1,30,-2,41,29.3,0,-1,0,0,-2,-3,-3,-3
"2871",2018-04-01,"Washington Gulch","w1718","Motorized",19,"Sun","weekend","sled","1","1","1",8.8,-0.1,30,-2,41,29.3,0,-1,0,0,-2,-3,-3,-3
"2872",2018-04-01,"Washington Gulch","w1718","Hybrid",12,"Sun","weekend","sled","1","1","1",8.8,-0.1,30,-2,41,29.3,0,-1,0,0,-2,-3,-3,-3
"2873",2018-04-02,"Washington Gulch","w1718","Non.motorized",10,"Mon","weekday","no_sled","1","1","1",8.7,-0.1,29,-1,39,30,-2,0,-1,0,-3,-3,-4,-4
"2874",2018-04-02,"Washington Gulch","w1718","Mechanized",0,"Mon","weekday","no_sled","1","1","1",8.7,-0.1,29,-1,39,30,-2,0,-1,0,-3,-3,-4,-4
"2875",2018-04-02,"Washington Gulch","w1718","Motorized",0,"Mon","weekday","sled","1","1","1",8.7,-0.1,29,-1,39,30,-2,0,-1,0,-3,-3,-4,-4
"2876",2018-04-02,"Washington Gulch","w1718","Hybrid",0,"Mon","weekday","sled","1","1","1",8.7,-0.1,29,-1,39,30,-2,0,-1,0,-3,-3,-4,-4
"2877",2018-04-03,"Washington Gulch","w1718","Non.motorized",7,"Tue","weekday","no_sled","1","1","1",8.8,0.1,30,1,27,29.3,-1,-2,0,-1,0,-2,-2,-3
"2878",2018-04-03,"Washington Gulch","w1718","Mechanized",0,"Tue","weekday","no_sled","1","1","1",8.8,0.1,30,1,27,29.3,-1,-2,0,-1,0,-2,-2,-3
"2879",2018-04-03,"Washington Gulch","w1718","Motorized",0,"Tue","weekday","sled","1","1","1",8.8,0.1,30,1,27,29.3,-1,-2,0,-1,0,-2,-2,-3
"2880",2018-04-03,"Washington Gulch","w1718","Hybrid",0,"Tue","weekday","sled","1","1","1",8.8,0.1,30,1,27,29.3,-1,-2,0,-1,0,-2,-2,-3
"2881",2018-04-04,"Washington Gulch","w1718","Non.motorized",18,"Wed","weekday","no_sled","1","2","2",8.9,0.1,28,-2,33,31.8,1,-1,-2,0,-1,-2,-4,-4
"2882",2018-04-04,"Washington Gulch","w1718","Mechanized",0,"Wed","weekday","no_sled","1","2","2",8.9,0.1,28,-2,33,31.8,1,-1,-2,0,-1,-2,-4,-4
"2883",2018-04-04,"Washington Gulch","w1718","Motorized",0,"Wed","weekday","sled","1","2","2",8.9,0.1,28,-2,33,31.8,1,-1,-2,0,-1,-2,-4,-4
"2884",2018-04-04,"Washington Gulch","w1718","Hybrid",0,"Wed","weekday","sled","1","2","2",8.9,0.1,28,-2,33,31.8,1,-1,-2,0,-1,-2,-4,-4
"2885",2018-04-05,"Washington Gulch","w1718","Non.motorized",7,"Thu","weekday","no_sled","1","2","2",8.9,0,27,-1,35,33,-2,1,-1,-2,-3,-2,-3,-5
"2886",2018-04-05,"Washington Gulch","w1718","Mechanized",0,"Thu","weekday","no_sled","1","2","2",8.9,0,27,-1,35,33,-2,1,-1,-2,-3,-2,-3,-5
"2887",2018-04-05,"Washington Gulch","w1718","Motorized",8,"Thu","weekday","sled","1","2","2",8.9,0,27,-1,35,33,-2,1,-1,-2,-3,-2,-3,-5
"2888",2018-04-05,"Washington Gulch","w1718","Hybrid",8,"Thu","weekday","sled","1","2","2",8.9,0,27,-1,35,33,-2,1,-1,-2,-3,-2,-3,-5
"2889",2018-04-06,"Washington Gulch","w1718","Non.motorized",8,"Fri","weekday","no_sled","1","2","2",8.9,0,25,-2,35,35.6,-1,-2,1,-1,-3,-5,-4,-5
"2890",2018-04-06,"Washington Gulch","w1718","Mechanized",0,"Fri","weekday","no_sled","1","2","2",8.9,0,25,-2,35,35.6,-1,-2,1,-1,-3,-5,-4,-5
"2891",2018-04-06,"Washington Gulch","w1718","Motorized",0,"Fri","weekday","sled","1","2","2",8.9,0,25,-2,35,35.6,-1,-2,1,-1,-3,-5,-4,-5
"2892",2018-04-06,"Washington Gulch","w1718","Hybrid",0,"Fri","weekday","sled","1","2","2",8.9,0,25,-2,35,35.6,-1,-2,1,-1,-3,-5,-4,-5
"2893",2018-04-07,"Washington Gulch","w1718","Non.motorized",11,"Sat","weekend","no_sled","2","2","2",9.2,0.3,31,6,37,29.7,-2,-1,-2,1,4,3,1,2
"2894",2018-04-07,"Washington Gulch","w1718","Mechanized",0,"Sat","weekend","no_sled","2","2","2",9.2,0.3,31,6,37,29.7,-2,-1,-2,1,4,3,1,2
"2895",2018-04-07,"Washington Gulch","w1718","Motorized",5,"Sat","weekend","sled","2","2","2",9.2,0.3,31,6,37,29.7,-2,-1,-2,1,4,3,1,2
"2896",2018-04-07,"Washington Gulch","w1718","Hybrid",0,"Sat","weekend","sled","2","2","2",9.2,0.3,31,6,37,29.7,-2,-1,-2,1,4,3,1,2
"2897",2018-04-08,"Washington Gulch","w1718","Non.motorized",7,"Sun","weekend","no_sled","3","3","3",10,0.8,33,2,33,30.3,6,-2,-1,-2,8,6,5,3
"2898",2018-04-08,"Washington Gulch","w1718","Mechanized",1,"Sun","weekend","no_sled","3","3","3",10,0.8,33,2,33,30.3,6,-2,-1,-2,8,6,5,3
"2899",2018-04-08,"Washington Gulch","w1718","Motorized",5,"Sun","weekend","sled","3","3","3",10,0.8,33,2,33,30.3,6,-2,-1,-2,8,6,5,3
"2900",2018-04-08,"Washington Gulch","w1718","Hybrid",0,"Sun","weekend","sled","3","3","3",10,0.8,33,2,33,30.3,6,-2,-1,-2,8,6,5,3
"2901",2018-04-09,"Washington Gulch","w1718","Non.motorized",9,"Mon","weekday","no_sled","1","1","1",10.1,0.1,33,0,31,30.6,2,6,-2,-1,2,8,6,5
"2902",2018-04-09,"Washington Gulch","w1718","Mechanized",0,"Mon","weekday","no_sled","1","1","1",10.1,0.1,33,0,31,30.6,2,6,-2,-1,2,8,6,5
"2903",2018-04-09,"Washington Gulch","w1718","Motorized",1,"Mon","weekday","sled","1","1","1",10.1,0.1,33,0,31,30.6,2,6,-2,-1,2,8,6,5
"2904",2018-04-09,"Washington Gulch","w1718","Hybrid",0,"Mon","weekday","sled","1","1","1",10.1,0.1,33,0,31,30.6,2,6,-2,-1,2,8,6,5
"2905",2018-04-10,"Washington Gulch","w1718","Non.motorized",11,"Tue","weekday","no_sled","1","1","1",10.1,0,31,-2,38,32.6,0,2,6,-2,-2,0,6,4
"2906",2018-04-10,"Washington Gulch","w1718","Mechanized",0,"Tue","weekday","no_sled","1","1","1",10.1,0,31,-2,38,32.6,0,2,6,-2,-2,0,6,4
"2907",2018-04-10,"Washington Gulch","w1718","Motorized",6,"Tue","weekday","sled","1","1","1",10.1,0,31,-2,38,32.6,0,2,6,-2,-2,0,6,4
"2908",2018-04-10,"Washington Gulch","w1718","Hybrid",5,"Tue","weekday","sled","1","1","1",10.1,0,31,-2,38,32.6,0,2,6,-2,-2,0,6,4
"2909",2018-04-11,"Washington Gulch","w1718","Non.motorized",5,"Wed","weekday","no_sled","2","2","2",9.9,-0.2,29,-2,45,34.1,-2,0,2,6,-4,-4,-2,4
"2910",2018-04-11,"Washington Gulch","w1718","Mechanized",0,"Wed","weekday","no_sled","2","2","2",9.9,-0.2,29,-2,45,34.1,-2,0,2,6,-4,-4,-2,4
"2911",2018-04-11,"Washington Gulch","w1718","Motorized",6,"Wed","weekday","sled","2","2","2",9.9,-0.2,29,-2,45,34.1,-2,0,2,6,-4,-4,-2,4
"2912",2018-04-11,"Washington Gulch","w1718","Hybrid",5,"Wed","weekday","sled","2","2","2",9.9,-0.2,29,-2,45,34.1,-2,0,2,6,-4,-4,-2,4
"2913",2018-04-12,"Washington Gulch","w1718","Non.motorized",8,"Thu","weekday","no_sled","1","2","2",9.5,-0.4,28,-1,40,33.9,-2,-2,0,2,-3,-5,-5,-3
"2914",2018-04-12,"Washington Gulch","w1718","Mechanized",0,"Thu","weekday","no_sled","1","2","2",9.5,-0.4,28,-1,40,33.9,-2,-2,0,2,-3,-5,-5,-3
"2915",2018-04-12,"Washington Gulch","w1718","Motorized",5,"Thu","weekday","sled","1","2","2",9.5,-0.4,28,-1,40,33.9,-2,-2,0,2,-3,-5,-5,-3
"2916",2018-04-12,"Washington Gulch","w1718","Hybrid",3,"Thu","weekday","sled","1","2","2",9.5,-0.4,28,-1,40,33.9,-2,-2,0,2,-3,-5,-5,-3
"2917",2018-04-13,"Washington Gulch","w1718","Non.motorized",14,"Fri","weekday","no_sled","2","2","1",9.4,-0.1,26,-2,23,36.2,-1,-2,-2,0,-3,-5,-7,-7
"2918",2018-04-13,"Washington Gulch","w1718","Mechanized",0,"Fri","weekday","no_sled","2","2","1",9.4,-0.1,26,-2,23,36.2,-1,-2,-2,0,-3,-5,-7,-7
"2919",2018-04-13,"Washington Gulch","w1718","Motorized",1,"Fri","weekday","sled","2","2","1",9.4,-0.1,26,-2,23,36.2,-1,-2,-2,0,-3,-5,-7,-7
"2920",2018-04-13,"Washington Gulch","w1718","Hybrid",0,"Fri","weekday","sled","2","2","1",9.4,-0.1,26,-2,23,36.2,-1,-2,-2,0,-3,-5,-7,-7
"2921",2018-04-14,"Washington Gulch","w1718","Non.motorized",11,"Sat","weekend","no_sled","2","2","1",9.4,0,28,2,28,33.6,-2,-1,-2,-2,0,-1,-3,-5
"2922",2018-04-14,"Washington Gulch","w1718","Mechanized",0,"Sat","weekend","no_sled","2","2","1",9.4,0,28,2,28,33.6,-2,-1,-2,-2,0,-1,-3,-5
"2923",2018-04-14,"Washington Gulch","w1718","Motorized",6,"Sat","weekend","sled","2","2","1",9.4,0,28,2,28,33.6,-2,-1,-2,-2,0,-1,-3,-5
"2924",2018-04-14,"Washington Gulch","w1718","Hybrid",1,"Sat","weekend","sled","2","2","1",9.4,0,28,2,28,33.6,-2,-1,-2,-2,0,-1,-3,-5
"2925",2018-04-15,"Washington Gulch","w1718","Non.motorized",15,"Sun","weekend","no_sled","2","2","1",9.2,-0.2,27,-1,37,34.1,2,-2,-1,-2,1,-1,-2,-4
"2926",2018-04-15,"Washington Gulch","w1718","Mechanized",0,"Sun","weekend","no_sled","2","2","1",9.2,-0.2,27,-1,37,34.1,2,-2,-1,-2,1,-1,-2,-4
"2927",2018-04-15,"Washington Gulch","w1718","Motorized",4,"Sun","weekend","sled","2","2","1",9.2,-0.2,27,-1,37,34.1,2,-2,-1,-2,1,-1,-2,-4
"2928",2018-04-15,"Washington Gulch","w1718","Hybrid",1,"Sun","weekend","sled","2","2","1",9.2,-0.2,27,-1,37,34.1,2,-2,-1,-2,1,-1,-2,-4
"2929",2018-04-16,"Washington Gulch","w1718","Non.motorized",3,"Mon","weekday","no_sled",NA,NA,NA,8.9,-0.3,24,-3,43,37.1,-1,2,-2,-1,-4,-2,-4,-5
"2930",2018-04-16,"Washington Gulch","w1718","Mechanized",0,"Mon","weekday","no_sled",NA,NA,NA,8.9,-0.3,24,-3,43,37.1,-1,2,-2,-1,-4,-2,-4,-5
"2931",2018-04-16,"Washington Gulch","w1718","Motorized",1,"Mon","weekday","sled",NA,NA,NA,8.9,-0.3,24,-3,43,37.1,-1,2,-2,-1,-4,-2,-4,-5
"2932",2018-04-16,"Washington Gulch","w1718","Hybrid",0,"Mon","weekday","sled",NA,NA,NA,8.9,-0.3,24,-3,43,37.1,-1,2,-2,-1,-4,-2,-4,-5
"2933",2018-12-01,"Brush Creek Trailhead","w1819","Non.motorized",0,"Sat","weekend","no_sled","3","3","2",3.3,0.2,19,1,16,17.4,0,0,0,0,1,1,1,1
"2934",2018-12-01,"Brush Creek Trailhead","w1819","Mechanized",0,"Sat","weekend","no_sled","3","3","2",3.3,0.2,19,1,16,17.4,0,0,0,0,1,1,1,1
"2935",2018-12-01,"Brush Creek Trailhead","w1819","Motorized",0,"Sat","weekend","sled","3","3","2",3.3,0.2,19,1,16,17.4,0,0,0,0,1,1,1,1
"2936",2018-12-01,"Brush Creek Trailhead","w1819","Hybrid",0,"Sat","weekend","sled","3","3","2",3.3,0.2,19,1,16,17.4,0,0,0,0,1,1,1,1
"2937",2018-12-02,"Brush Creek Trailhead","w1819","Non.motorized",0,"Sun","weekend","no_sled","3","3","3",3.3,0,20,1,14,16.5,1,0,0,0,2,2,2,2
"2938",2018-12-02,"Brush Creek Trailhead","w1819","Mechanized",0,"Sun","weekend","no_sled","3","3","3",3.3,0,20,1,14,16.5,1,0,0,0,2,2,2,2
"2939",2018-12-02,"Brush Creek Trailhead","w1819","Motorized",0,"Sun","weekend","sled","3","3","3",3.3,0,20,1,14,16.5,1,0,0,0,2,2,2,2
"2940",2018-12-02,"Brush Creek Trailhead","w1819","Hybrid",0,"Sun","weekend","sled","3","3","3",3.3,0,20,1,14,16.5,1,0,0,0,2,2,2,2
"2941",2018-12-03,"Brush Creek Trailhead","w1819","Non.motorized",0,"Mon","weekday","no_sled","3","3","2",3.4,0.1,19,-1,13,17.9,1,1,0,0,0,1,1,1
"2942",2018-12-03,"Brush Creek Trailhead","w1819","Mechanized",0,"Mon","weekday","no_sled","3","3","2",3.4,0.1,19,-1,13,17.9,1,1,0,0,0,1,1,1
"2943",2018-12-03,"Brush Creek Trailhead","w1819","Motorized",0,"Mon","weekday","sled","3","3","2",3.4,0.1,19,-1,13,17.9,1,1,0,0,0,1,1,1
"2944",2018-12-03,"Brush Creek Trailhead","w1819","Hybrid",0,"Mon","weekday","sled","3","3","2",3.4,0.1,19,-1,13,17.9,1,1,0,0,0,1,1,1
"2945",2018-12-04,"Brush Creek Trailhead","w1819","Non.motorized",0,"Tue","weekday","no_sled","3","3","2",3.5,0.1,20,1,8,17.5,-1,1,1,0,0,1,2,2
"2946",2018-12-04,"Brush Creek Trailhead","w1819","Mechanized",0,"Tue","weekday","no_sled","3","3","2",3.5,0.1,20,1,8,17.5,-1,1,1,0,0,1,2,2
"2947",2018-12-04,"Brush Creek Trailhead","w1819","Motorized",0,"Tue","weekday","sled","3","3","2",3.5,0.1,20,1,8,17.5,-1,1,1,0,0,1,2,2
"2948",2018-12-04,"Brush Creek Trailhead","w1819","Hybrid",0,"Tue","weekday","sled","3","3","2",3.5,0.1,20,1,8,17.5,-1,1,1,0,0,1,2,2
"2949",2018-12-05,"Brush Creek Trailhead","w1819","Non.motorized",0,"Wed","weekday","no_sled","3","3","2",3.5,0,19,-1,21,18.4,1,-1,1,1,0,-1,0,1
"2950",2018-12-05,"Brush Creek Trailhead","w1819","Mechanized",0,"Wed","weekday","no_sled","3","3","2",3.5,0,19,-1,21,18.4,1,-1,1,1,0,-1,0,1
"2951",2018-12-05,"Brush Creek Trailhead","w1819","Motorized",0,"Wed","weekday","sled","3","3","2",3.5,0,19,-1,21,18.4,1,-1,1,1,0,-1,0,1
"2952",2018-12-05,"Brush Creek Trailhead","w1819","Hybrid",0,"Wed","weekday","sled","3","3","2",3.5,0,19,-1,21,18.4,1,-1,1,1,0,-1,0,1
"2953",2018-12-06,"Brush Creek Trailhead","w1819","Non.motorized",8,"Thu","weekday","no_sled","2","2","2",3.7,0.2,18,-1,25,20.6,-1,1,-1,1,-2,-1,-2,-1
"2954",2018-12-06,"Brush Creek Trailhead","w1819","Mechanized",0,"Thu","weekday","no_sled","2","2","2",3.7,0.2,18,-1,25,20.6,-1,1,-1,1,-2,-1,-2,-1
"2955",2018-12-06,"Brush Creek Trailhead","w1819","Motorized",0,"Thu","weekday","sled","2","2","2",3.7,0.2,18,-1,25,20.6,-1,1,-1,1,-2,-1,-2,-1
"2956",2018-12-06,"Brush Creek Trailhead","w1819","Hybrid",0,"Thu","weekday","sled","2","2","2",3.7,0.2,18,-1,25,20.6,-1,1,-1,1,-2,-1,-2,-1
"2957",2018-12-07,"Brush Creek Trailhead","w1819","Non.motorized",13,"Fri","weekday","no_sled","2","2","2",3.8,0.1,21,3,23,18.1,-1,-1,1,-1,2,1,2,1
"2958",2018-12-07,"Brush Creek Trailhead","w1819","Mechanized",0,"Fri","weekday","no_sled","2","2","2",3.8,0.1,21,3,23,18.1,-1,-1,1,-1,2,1,2,1
"2959",2018-12-07,"Brush Creek Trailhead","w1819","Motorized",0,"Fri","weekday","sled","2","2","2",3.8,0.1,21,3,23,18.1,-1,-1,1,-1,2,1,2,1
"2960",2018-12-07,"Brush Creek Trailhead","w1819","Hybrid",0,"Fri","weekday","sled","2","2","2",3.8,0.1,21,3,23,18.1,-1,-1,1,-1,2,1,2,1
"2961",2018-12-08,"Brush Creek Trailhead","w1819","Non.motorized",11,"Sat","weekend","no_sled","2","2","2",3.8,0,20,-1,23,19,3,-1,-1,1,2,1,0,1
"2962",2018-12-08,"Brush Creek Trailhead","w1819","Mechanized",0,"Sat","weekend","no_sled","2","2","2",3.8,0,20,-1,23,19,3,-1,-1,1,2,1,0,1
"2963",2018-12-08,"Brush Creek Trailhead","w1819","Motorized",0,"Sat","weekend","sled","2","2","2",3.8,0,20,-1,23,19,3,-1,-1,1,2,1,0,1
"2964",2018-12-08,"Brush Creek Trailhead","w1819","Hybrid",0,"Sat","weekend","sled","2","2","2",3.8,0,20,-1,23,19,3,-1,-1,1,2,1,0,1
"2965",2018-12-09,"Brush Creek Trailhead","w1819","Non.motorized",26,"Sun","weekend","no_sled","2","2","2",3.8,0,20,0,19,19,-1,3,-1,-1,-1,2,1,0
"2966",2018-12-09,"Brush Creek Trailhead","w1819","Mechanized",0,"Sun","weekend","no_sled","2","2","2",3.8,0,20,0,19,19,-1,3,-1,-1,-1,2,1,0
"2967",2018-12-09,"Brush Creek Trailhead","w1819","Motorized",0,"Sun","weekend","sled","2","2","2",3.8,0,20,0,19,19,-1,3,-1,-1,-1,2,1,0
"2968",2018-12-09,"Brush Creek Trailhead","w1819","Hybrid",0,"Sun","weekend","sled","2","2","2",3.8,0,20,0,19,19,-1,3,-1,-1,-1,2,1,0
"2969",2018-12-10,"Brush Creek Trailhead","w1819","Non.motorized",5,"Mon","weekday","no_sled","2","2","2",3.8,0,20,0,21,19,0,-1,3,-1,0,-1,2,1
"2970",2018-12-10,"Brush Creek Trailhead","w1819","Mechanized",0,"Mon","weekday","no_sled","2","2","2",3.8,0,20,0,21,19,0,-1,3,-1,0,-1,2,1
"2971",2018-12-10,"Brush Creek Trailhead","w1819","Motorized",0,"Mon","weekday","sled","2","2","2",3.8,0,20,0,21,19,0,-1,3,-1,0,-1,2,1
"2972",2018-12-10,"Brush Creek Trailhead","w1819","Hybrid",0,"Mon","weekday","sled","2","2","2",3.8,0,20,0,21,19,0,-1,3,-1,0,-1,2,1
"2973",2018-12-11,"Brush Creek Trailhead","w1819","Non.motorized",5,"Tue","weekday","no_sled","2","2","2",3.9,0.1,19,-1,27,20.5,0,0,-1,3,-1,-1,-2,1
"2974",2018-12-11,"Brush Creek Trailhead","w1819","Mechanized",0,"Tue","weekday","no_sled","2","2","2",3.9,0.1,19,-1,27,20.5,0,0,-1,3,-1,-1,-2,1
"2975",2018-12-11,"Brush Creek Trailhead","w1819","Motorized",0,"Tue","weekday","sled","2","2","2",3.9,0.1,19,-1,27,20.5,0,0,-1,3,-1,-1,-2,1
"2976",2018-12-11,"Brush Creek Trailhead","w1819","Hybrid",0,"Tue","weekday","sled","2","2","2",3.9,0.1,19,-1,27,20.5,0,0,-1,3,-1,-1,-2,1
"2977",2018-12-12,"Brush Creek Trailhead","w1819","Non.motorized",3,"Wed","weekday","no_sled","2","2","1",3.9,0,19,0,21,20.5,-1,0,0,-1,-1,-1,-1,-2
"2978",2018-12-12,"Brush Creek Trailhead","w1819","Mechanized",0,"Wed","weekday","no_sled","2","2","1",3.9,0,19,0,21,20.5,-1,0,0,-1,-1,-1,-1,-2
"2979",2018-12-12,"Brush Creek Trailhead","w1819","Motorized",0,"Wed","weekday","sled","2","2","1",3.9,0,19,0,21,20.5,-1,0,0,-1,-1,-1,-1,-2
"2980",2018-12-12,"Brush Creek Trailhead","w1819","Hybrid",0,"Wed","weekday","sled","2","2","1",3.9,0,19,0,21,20.5,-1,0,0,-1,-1,-1,-1,-2
"2981",2018-12-13,"Brush Creek Trailhead","w1819","Non.motorized",3,"Thu","weekday","no_sled","3","3","2",4,0.1,21,2,15,19,0,-1,0,0,2,1,1,1
"2982",2018-12-13,"Brush Creek Trailhead","w1819","Mechanized",0,"Thu","weekday","no_sled","3","3","2",4,0.1,21,2,15,19,0,-1,0,0,2,1,1,1
"2983",2018-12-13,"Brush Creek Trailhead","w1819","Motorized",0,"Thu","weekday","sled","3","3","2",4,0.1,21,2,15,19,0,-1,0,0,2,1,1,1
"2984",2018-12-13,"Brush Creek Trailhead","w1819","Hybrid",0,"Thu","weekday","sled","3","3","2",4,0.1,21,2,15,19,0,-1,0,0,2,1,1,1
"2985",2018-12-14,"Brush Creek Trailhead","w1819","Non.motorized",1,"Fri","weekday","no_sled","3","3","2",4,0,20,-1,24,20,2,0,-1,0,1,1,0,0
"2986",2018-12-14,"Brush Creek Trailhead","w1819","Mechanized",0,"Fri","weekday","no_sled","3","3","2",4,0,20,-1,24,20,2,0,-1,0,1,1,0,0
"2987",2018-12-14,"Brush Creek Trailhead","w1819","Motorized",0,"Fri","weekday","sled","3","3","2",4,0,20,-1,24,20,2,0,-1,0,1,1,0,0
"2988",2018-12-14,"Brush Creek Trailhead","w1819","Hybrid",0,"Fri","weekday","sled","3","3","2",4,0,20,-1,24,20,2,0,-1,0,1,1,0,0
"2989",2018-12-15,"Brush Creek Trailhead","w1819","Non.motorized",19,"Sat","weekend","no_sled","2","2","2",4,0,20,0,29,20,-1,2,0,-1,-1,1,1,0
"2990",2018-12-15,"Brush Creek Trailhead","w1819","Mechanized",1,"Sat","weekend","no_sled","2","2","2",4,0,20,0,29,20,-1,2,0,-1,-1,1,1,0
"2991",2018-12-15,"Brush Creek Trailhead","w1819","Motorized",0,"Sat","weekend","sled","2","2","2",4,0,20,0,29,20,-1,2,0,-1,-1,1,1,0
"2992",2018-12-15,"Brush Creek Trailhead","w1819","Hybrid",0,"Sat","weekend","sled","2","2","2",4,0,20,0,29,20,-1,2,0,-1,-1,1,1,0
"2993",2018-12-16,"Brush Creek Trailhead","w1819","Non.motorized",10,"Sun","weekend","no_sled","2","2","2",4.1,0.1,19,-1,28,21.6,0,-1,2,0,-1,-2,0,0
"2994",2018-12-16,"Brush Creek Trailhead","w1819","Mechanized",0,"Sun","weekend","no_sled","2","2","2",4.1,0.1,19,-1,28,21.6,0,-1,2,0,-1,-2,0,0
"2995",2018-12-16,"Brush Creek Trailhead","w1819","Motorized",0,"Sun","weekend","sled","2","2","2",4.1,0.1,19,-1,28,21.6,0,-1,2,0,-1,-2,0,0
"2996",2018-12-16,"Brush Creek Trailhead","w1819","Hybrid",0,"Sun","weekend","sled","2","2","2",4.1,0.1,19,-1,28,21.6,0,-1,2,0,-1,-2,0,0
"2997",2018-12-17,"Brush Creek Trailhead","w1819","Non.motorized",5,"Mon","weekday","no_sled","2","2","2",4.1,0,19,0,29,21.6,-1,0,-1,2,-1,-1,-2,0
"2998",2018-12-17,"Brush Creek Trailhead","w1819","Mechanized",0,"Mon","weekday","no_sled","2","2","2",4.1,0,19,0,29,21.6,-1,0,-1,2,-1,-1,-2,0
"2999",2018-12-17,"Brush Creek Trailhead","w1819","Motorized",0,"Mon","weekday","sled","2","2","2",4.1,0,19,0,29,21.6,-1,0,-1,2,-1,-1,-2,0
"3000",2018-12-17,"Brush Creek Trailhead","w1819","Hybrid",0,"Mon","weekday","sled","2","2","2",4.1,0,19,0,29,21.6,-1,0,-1,2,-1,-1,-2,0
"3001",2018-12-18,"Brush Creek Trailhead","w1819","Non.motorized",12,"Tue","weekday","no_sled","2","2","2",4.1,0,19,0,27,21.6,0,-1,0,-1,0,-1,-1,-2
"3002",2018-12-18,"Brush Creek Trailhead","w1819","Mechanized",1,"Tue","weekday","no_sled","2","2","2",4.1,0,19,0,27,21.6,0,-1,0,-1,0,-1,-1,-2
"3003",2018-12-18,"Brush Creek Trailhead","w1819","Motorized",0,"Tue","weekday","sled","2","2","2",4.1,0,19,0,27,21.6,0,-1,0,-1,0,-1,-1,-2
"3004",2018-12-18,"Brush Creek Trailhead","w1819","Hybrid",0,"Tue","weekday","sled","2","2","2",4.1,0,19,0,27,21.6,0,-1,0,-1,0,-1,-1,-2
"3005",2018-12-19,"Brush Creek Trailhead","w1819","Non.motorized",11,"Wed","weekday","no_sled","2","2","2",4.1,0,19,0,24,21.6,0,0,-1,0,0,0,-1,-1
"3006",2018-12-19,"Brush Creek Trailhead","w1819","Mechanized",0,"Wed","weekday","no_sled","2","2","2",4.1,0,19,0,24,21.6,0,0,-1,0,0,0,-1,-1
"3007",2018-12-19,"Brush Creek Trailhead","w1819","Motorized",0,"Wed","weekday","sled","2","2","2",4.1,0,19,0,24,21.6,0,0,-1,0,0,0,-1,-1
"3008",2018-12-19,"Brush Creek Trailhead","w1819","Hybrid",0,"Wed","weekday","sled","2","2","2",4.1,0,19,0,24,21.6,0,0,-1,0,0,0,-1,-1
"3009",2018-12-20,"Brush Creek Trailhead","w1819","Non.motorized",12,"Thu","weekday","no_sled","2","2","1",4.1,0,20,1,25,20.5,0,0,0,-1,1,1,1,0
"3010",2018-12-20,"Brush Creek Trailhead","w1819","Mechanized",0,"Thu","weekday","no_sled","2","2","1",4.1,0,20,1,25,20.5,0,0,0,-1,1,1,1,0
"3011",2018-12-20,"Brush Creek Trailhead","w1819","Motorized",0,"Thu","weekday","sled","2","2","1",4.1,0,20,1,25,20.5,0,0,0,-1,1,1,1,0
"3012",2018-12-20,"Brush Creek Trailhead","w1819","Hybrid",0,"Thu","weekday","sled","2","2","1",4.1,0,20,1,25,20.5,0,0,0,-1,1,1,1,0
"3013",2018-12-21,"Brush Creek Trailhead","w1819","Non.motorized",7,"Fri","weekday","no_sled","2","2","1",4.1,0,19,-1,28,21.6,1,0,0,0,0,0,0,0
"3014",2018-12-21,"Brush Creek Trailhead","w1819","Mechanized",0,"Fri","weekday","no_sled","2","2","1",4.1,0,19,-1,28,21.6,1,0,0,0,0,0,0,0
"3015",2018-12-21,"Brush Creek Trailhead","w1819","Motorized",0,"Fri","weekday","sled","2","2","1",4.1,0,19,-1,28,21.6,1,0,0,0,0,0,0,0
"3016",2018-12-21,"Brush Creek Trailhead","w1819","Hybrid",0,"Fri","weekday","sled","2","2","1",4.1,0,19,-1,28,21.6,1,0,0,0,0,0,0,0
"3017",2018-12-22,"Brush Creek Trailhead","w1819","Non.motorized",11,"Sat","weekend","no_sled","2","2","1",4.2,0.1,19,0,20,22.1,-1,1,0,0,-1,0,0,0
"3018",2018-12-22,"Brush Creek Trailhead","w1819","Mechanized",0,"Sat","weekend","no_sled","2","2","1",4.2,0.1,19,0,20,22.1,-1,1,0,0,-1,0,0,0
"3019",2018-12-22,"Brush Creek Trailhead","w1819","Motorized",0,"Sat","weekend","sled","2","2","1",4.2,0.1,19,0,20,22.1,-1,1,0,0,-1,0,0,0
"3020",2018-12-22,"Brush Creek Trailhead","w1819","Hybrid",0,"Sat","weekend","sled","2","2","1",4.2,0.1,19,0,20,22.1,-1,1,0,0,-1,0,0,0
"3021",2018-12-23,"Brush Creek Trailhead","w1819","Non.motorized",17,"Sun","weekend","no_sled","2","2","1",4.2,0,21,2,19,20,0,-1,1,0,2,1,2,2
"3022",2018-12-23,"Brush Creek Trailhead","w1819","Mechanized",0,"Sun","weekend","no_sled","2","2","1",4.2,0,21,2,19,20,0,-1,1,0,2,1,2,2
"3023",2018-12-23,"Brush Creek Trailhead","w1819","Motorized",0,"Sun","weekend","sled","2","2","1",4.2,0,21,2,19,20,0,-1,1,0,2,1,2,2
"3024",2018-12-23,"Brush Creek Trailhead","w1819","Hybrid",0,"Sun","weekend","sled","2","2","1",4.2,0,21,2,19,20,0,-1,1,0,2,1,2,2
"3025",2018-12-24,"Brush Creek Trailhead","w1819","Non.motorized",1,"Mon","weekday","no_sled","2","2","2",4.3,0.1,20,-1,21,21.5,2,0,-1,1,1,1,0,1
"3026",2018-12-24,"Brush Creek Trailhead","w1819","Mechanized",0,"Mon","weekday","no_sled","2","2","2",4.3,0.1,20,-1,21,21.5,2,0,-1,1,1,1,0,1
"3027",2018-12-24,"Brush Creek Trailhead","w1819","Motorized",0,"Mon","weekday","sled","2","2","2",4.3,0.1,20,-1,21,21.5,2,0,-1,1,1,1,0,1
"3028",2018-12-24,"Brush Creek Trailhead","w1819","Hybrid",0,"Mon","weekday","sled","2","2","2",4.3,0.1,20,-1,21,21.5,2,0,-1,1,1,1,0,1
"3029",2018-12-25,"Brush Creek Trailhead","w1819","Non.motorized",14,"Tue","weekday","no_sled","2","2","2",4.7,0.4,25,5,25,18.8,-1,2,0,-1,4,6,6,5
"3030",2018-12-25,"Brush Creek Trailhead","w1819","Mechanized",0,"Tue","weekday","no_sled","2","2","2",4.7,0.4,25,5,25,18.8,-1,2,0,-1,4,6,6,5
"3031",2018-12-25,"Brush Creek Trailhead","w1819","Motorized",0,"Tue","weekday","sled","2","2","2",4.7,0.4,25,5,25,18.8,-1,2,0,-1,4,6,6,5
"3032",2018-12-25,"Brush Creek Trailhead","w1819","Hybrid",0,"Tue","weekday","sled","2","2","2",4.7,0.4,25,5,25,18.8,-1,2,0,-1,4,6,6,5
"3033",2018-12-26,"Brush Creek Trailhead","w1819","Non.motorized",21,"Wed","weekday","no_sled","3","3","3",4.7,0,23,-2,24,20.4,5,-1,2,0,3,2,4,4
"3034",2018-12-26,"Brush Creek Trailhead","w1819","Mechanized",0,"Wed","weekday","no_sled","3","3","3",4.7,0,23,-2,24,20.4,5,-1,2,0,3,2,4,4
"3035",2018-12-26,"Brush Creek Trailhead","w1819","Motorized",0,"Wed","weekday","sled","3","3","3",4.7,0,23,-2,24,20.4,5,-1,2,0,3,2,4,4
"3036",2018-12-26,"Brush Creek Trailhead","w1819","Hybrid",0,"Wed","weekday","sled","3","3","3",4.7,0,23,-2,24,20.4,5,-1,2,0,3,2,4,4
"3037",2018-12-27,"Brush Creek Trailhead","w1819","Non.motorized",14,"Thu","weekday","no_sled","3","3","2",4.7,0,24,1,12,19.6,-2,5,-1,2,-1,4,3,5
"3038",2018-12-27,"Brush Creek Trailhead","w1819","Mechanized",0,"Thu","weekday","no_sled","3","3","2",4.7,0,24,1,12,19.6,-2,5,-1,2,-1,4,3,5
"3039",2018-12-27,"Brush Creek Trailhead","w1819","Motorized",0,"Thu","weekday","sled","3","3","2",4.7,0,24,1,12,19.6,-2,5,-1,2,-1,4,3,5
"3040",2018-12-27,"Brush Creek Trailhead","w1819","Hybrid",0,"Thu","weekday","sled","3","3","2",4.7,0,24,1,12,19.6,-2,5,-1,2,-1,4,3,5
"3041",2018-12-28,"Brush Creek Trailhead","w1819","Non.motorized",16,"Fri","weekday","no_sled","3","3","2",4.7,0,24,0,12,19.6,1,-2,5,-1,1,-1,4,3
"3042",2018-12-28,"Brush Creek Trailhead","w1819","Mechanized",0,"Fri","weekday","no_sled","3","3","2",4.7,0,24,0,12,19.6,1,-2,5,-1,1,-1,4,3
"3043",2018-12-28,"Brush Creek Trailhead","w1819","Motorized",0,"Fri","weekday","sled","3","3","2",4.7,0,24,0,12,19.6,1,-2,5,-1,1,-1,4,3
"3044",2018-12-28,"Brush Creek Trailhead","w1819","Hybrid",0,"Fri","weekday","sled","3","3","2",4.7,0,24,0,12,19.6,1,-2,5,-1,1,-1,4,3
"3045",2018-12-29,"Brush Creek Trailhead","w1819","Non.motorized",38,"Sat","weekend","no_sled","3","3","2",4.7,0,24,0,8,19.6,0,1,-2,5,0,1,-1,4
"3046",2018-12-29,"Brush Creek Trailhead","w1819","Mechanized",0,"Sat","weekend","no_sled","3","3","2",4.7,0,24,0,8,19.6,0,1,-2,5,0,1,-1,4
"3047",2018-12-29,"Brush Creek Trailhead","w1819","Motorized",0,"Sat","weekend","sled","3","3","2",4.7,0,24,0,8,19.6,0,1,-2,5,0,1,-1,4
"3048",2018-12-29,"Brush Creek Trailhead","w1819","Hybrid",0,"Sat","weekend","sled","3","3","2",4.7,0,24,0,8,19.6,0,1,-2,5,0,1,-1,4
"3049",2018-12-30,"Brush Creek Trailhead","w1819","Non.motorized",29,"Sun","weekend","no_sled","3","3","2",4.7,0,24,0,16,19.6,0,0,1,-2,0,0,1,-1
"3050",2018-12-30,"Brush Creek Trailhead","w1819","Mechanized",0,"Sun","weekend","no_sled","3","3","2",4.7,0,24,0,16,19.6,0,0,1,-2,0,0,1,-1
"3051",2018-12-30,"Brush Creek Trailhead","w1819","Motorized",0,"Sun","weekend","sled","3","3","2",4.7,0,24,0,16,19.6,0,0,1,-2,0,0,1,-1
"3052",2018-12-30,"Brush Creek Trailhead","w1819","Hybrid",0,"Sun","weekend","sled","3","3","2",4.7,0,24,0,16,19.6,0,0,1,-2,0,0,1,-1
"3053",2018-12-31,"Brush Creek Trailhead","w1819","Non.motorized",2,"Mon","weekday","no_sled","3","3","3",4.9,0.2,23,-1,14,21.3,0,0,0,1,-1,-1,-1,0
"3054",2018-12-31,"Brush Creek Trailhead","w1819","Mechanized",0,"Mon","weekday","no_sled","3","3","3",4.9,0.2,23,-1,14,21.3,0,0,0,1,-1,-1,-1,0
"3055",2018-12-31,"Brush Creek Trailhead","w1819","Motorized",0,"Mon","weekday","sled","3","3","3",4.9,0.2,23,-1,14,21.3,0,0,0,1,-1,-1,-1,0
"3056",2018-12-31,"Brush Creek Trailhead","w1819","Hybrid",0,"Mon","weekday","sled","3","3","3",4.9,0.2,23,-1,14,21.3,0,0,0,1,-1,-1,-1,0
"3057",2019-01-01,"Brush Creek Trailhead","w1819","Non.motorized",22,"Tue","weekday","no_sled","3","3","3",5.1,0.2,29,6,11,17.6,-1,0,0,0,5,5,5,5
"3058",2019-01-01,"Brush Creek Trailhead","w1819","Mechanized",0,"Tue","weekday","no_sled","3","3","3",5.1,0.2,29,6,11,17.6,-1,0,0,0,5,5,5,5
"3059",2019-01-01,"Brush Creek Trailhead","w1819","Motorized",0,"Tue","weekday","sled","3","3","3",5.1,0.2,29,6,11,17.6,-1,0,0,0,5,5,5,5
"3060",2019-01-01,"Brush Creek Trailhead","w1819","Hybrid",0,"Tue","weekday","sled","3","3","3",5.1,0.2,29,6,11,17.6,-1,0,0,0,5,5,5,5
"3061",2019-01-02,"Brush Creek Trailhead","w1819","Non.motorized",22,"Wed","weekday","no_sled","3","3","2",5.1,0,28,-1,10,18.2,6,-1,0,0,5,4,4,4
"3062",2019-01-02,"Brush Creek Trailhead","w1819","Mechanized",0,"Wed","weekday","no_sled","3","3","2",5.1,0,28,-1,10,18.2,6,-1,0,0,5,4,4,4
"3063",2019-01-02,"Brush Creek Trailhead","w1819","Motorized",0,"Wed","weekday","sled","3","3","2",5.1,0,28,-1,10,18.2,6,-1,0,0,5,4,4,4
"3064",2019-01-02,"Brush Creek Trailhead","w1819","Hybrid",0,"Wed","weekday","sled","3","3","2",5.1,0,28,-1,10,18.2,6,-1,0,0,5,4,4,4
"3065",2019-01-03,"Brush Creek Trailhead","w1819","Non.motorized",6,"Thu","weekday","no_sled","3","3","2",5.1,0,27,-1,22,18.9,-1,6,-1,0,-2,4,3,3
"3066",2019-01-03,"Brush Creek Trailhead","w1819","Mechanized",0,"Thu","weekday","no_sled","3","3","2",5.1,0,27,-1,22,18.9,-1,6,-1,0,-2,4,3,3
"3067",2019-01-03,"Brush Creek Trailhead","w1819","Motorized",0,"Thu","weekday","sled","3","3","2",5.1,0,27,-1,22,18.9,-1,6,-1,0,-2,4,3,3
"3068",2019-01-03,"Brush Creek Trailhead","w1819","Hybrid",0,"Thu","weekday","sled","3","3","2",5.1,0,27,-1,22,18.9,-1,6,-1,0,-2,4,3,3
"3069",2019-01-04,"Brush Creek Trailhead","w1819","Non.motorized",9,"Fri","weekday","no_sled","3","3","2",5.3,0.2,26,-1,29,20.4,-1,-1,6,-1,-2,-3,3,2
"3070",2019-01-04,"Brush Creek Trailhead","w1819","Mechanized",0,"Fri","weekday","no_sled","3","3","2",5.3,0.2,26,-1,29,20.4,-1,-1,6,-1,-2,-3,3,2
"3071",2019-01-04,"Brush Creek Trailhead","w1819","Motorized",0,"Fri","weekday","sled","3","3","2",5.3,0.2,26,-1,29,20.4,-1,-1,6,-1,-2,-3,3,2
"3072",2019-01-04,"Brush Creek Trailhead","w1819","Hybrid",0,"Fri","weekday","sled","3","3","2",5.3,0.2,26,-1,29,20.4,-1,-1,6,-1,-2,-3,3,2
"3073",2019-01-05,"Brush Creek Trailhead","w1819","Non.motorized",19,"Sat","weekend","no_sled","2","2","2",5.3,0,25,-1,30,21.2,-1,-1,-1,6,-2,-3,-4,2
"3074",2019-01-05,"Brush Creek Trailhead","w1819","Mechanized",0,"Sat","weekend","no_sled","2","2","2",5.3,0,25,-1,30,21.2,-1,-1,-1,6,-2,-3,-4,2
"3075",2019-01-05,"Brush Creek Trailhead","w1819","Motorized",0,"Sat","weekend","sled","2","2","2",5.3,0,25,-1,30,21.2,-1,-1,-1,6,-2,-3,-4,2
"3076",2019-01-05,"Brush Creek Trailhead","w1819","Hybrid",0,"Sat","weekend","sled","2","2","2",5.3,0,25,-1,30,21.2,-1,-1,-1,6,-2,-3,-4,2
"3077",2019-01-06,"Brush Creek Trailhead","w1819","Non.motorized",6,"Sun","weekend","no_sled","3","3","3",5.3,0,25,0,26,21.2,-1,-1,-1,-1,-1,-2,-3,-4
"3078",2019-01-06,"Brush Creek Trailhead","w1819","Mechanized",0,"Sun","weekend","no_sled","3","3","3",5.3,0,25,0,26,21.2,-1,-1,-1,-1,-1,-2,-3,-4
"3079",2019-01-06,"Brush Creek Trailhead","w1819","Motorized",0,"Sun","weekend","sled","3","3","3",5.3,0,25,0,26,21.2,-1,-1,-1,-1,-1,-2,-3,-4
"3080",2019-01-06,"Brush Creek Trailhead","w1819","Hybrid",0,"Sun","weekend","sled","3","3","3",5.3,0,25,0,26,21.2,-1,-1,-1,-1,-1,-2,-3,-4
"3081",2019-01-07,"Brush Creek Trailhead","w1819","Non.motorized",5,"Mon","weekday","no_sled","3","3","3",5.8,0.5,32,7,21,18.1,0,-1,-1,-1,7,6,5,4
"3082",2019-01-07,"Brush Creek Trailhead","w1819","Mechanized",0,"Mon","weekday","no_sled","3","3","3",5.8,0.5,32,7,21,18.1,0,-1,-1,-1,7,6,5,4
"3083",2019-01-07,"Brush Creek Trailhead","w1819","Motorized",0,"Mon","weekday","sled","3","3","3",5.8,0.5,32,7,21,18.1,0,-1,-1,-1,7,6,5,4
"3084",2019-01-07,"Brush Creek Trailhead","w1819","Hybrid",0,"Mon","weekday","sled","3","3","3",5.8,0.5,32,7,21,18.1,0,-1,-1,-1,7,6,5,4
"3085",2019-01-08,"Brush Creek Trailhead","w1819","Non.motorized",6,"Tue","weekday","no_sled","3","3","3",5.9,0.1,32,0,24,18.4,7,0,-1,-1,7,7,6,5
"3086",2019-01-08,"Brush Creek Trailhead","w1819","Mechanized",0,"Tue","weekday","no_sled","3","3","3",5.9,0.1,32,0,24,18.4,7,0,-1,-1,7,7,6,5
"3087",2019-01-08,"Brush Creek Trailhead","w1819","Motorized",0,"Tue","weekday","sled","3","3","3",5.9,0.1,32,0,24,18.4,7,0,-1,-1,7,7,6,5
"3088",2019-01-08,"Brush Creek Trailhead","w1819","Hybrid",0,"Tue","weekday","sled","3","3","3",5.9,0.1,32,0,24,18.4,7,0,-1,-1,7,7,6,5
"3089",2019-01-09,"Brush Creek Trailhead","w1819","Non.motorized",9,"Wed","weekday","no_sled","3","3","3",6,0.1,30,-2,29,20,0,7,0,-1,-2,5,5,4
"3090",2019-01-09,"Brush Creek Trailhead","w1819","Mechanized",0,"Wed","weekday","no_sled","3","3","3",6,0.1,30,-2,29,20,0,7,0,-1,-2,5,5,4
"3091",2019-01-09,"Brush Creek Trailhead","w1819","Motorized",0,"Wed","weekday","sled","3","3","3",6,0.1,30,-2,29,20,0,7,0,-1,-2,5,5,4
"3092",2019-01-09,"Brush Creek Trailhead","w1819","Hybrid",0,"Wed","weekday","sled","3","3","3",6,0.1,30,-2,29,20,0,7,0,-1,-2,5,5,4
"3093",2019-01-10,"Brush Creek Trailhead","w1819","Non.motorized",9,"Thu","weekday","no_sled","3","3","3",6,0,29,-1,29,20.7,-2,0,7,0,-3,-3,4,4
"3094",2019-01-10,"Brush Creek Trailhead","w1819","Mechanized",0,"Thu","weekday","no_sled","3","3","3",6,0,29,-1,29,20.7,-2,0,7,0,-3,-3,4,4
"3095",2019-01-10,"Brush Creek Trailhead","w1819","Motorized",0,"Thu","weekday","sled","3","3","3",6,0,29,-1,29,20.7,-2,0,7,0,-3,-3,4,4
"3096",2019-01-10,"Brush Creek Trailhead","w1819","Hybrid",0,"Thu","weekday","sled","3","3","3",6,0,29,-1,29,20.7,-2,0,7,0,-3,-3,4,4
"3097",2019-01-11,"Brush Creek Trailhead","w1819","Non.motorized",2,"Fri","weekday","no_sled","2","2","2",6.1,0.1,29,0,25,21,-1,-2,0,7,-1,-3,-3,4
"3098",2019-01-11,"Brush Creek Trailhead","w1819","Mechanized",0,"Fri","weekday","no_sled","2","2","2",6.1,0.1,29,0,25,21,-1,-2,0,7,-1,-3,-3,4
"3099",2019-01-11,"Brush Creek Trailhead","w1819","Motorized",0,"Fri","weekday","sled","2","2","2",6.1,0.1,29,0,25,21,-1,-2,0,7,-1,-3,-3,4
"3100",2019-01-11,"Brush Creek Trailhead","w1819","Hybrid",0,"Fri","weekday","sled","2","2","2",6.1,0.1,29,0,25,21,-1,-2,0,7,-1,-3,-3,4
"3101",2019-01-12,"Brush Creek Trailhead","w1819","Non.motorized",8,"Sat","weekend","no_sled","3","3","2",6.1,0,28,-1,21,21.8,0,-1,-2,0,-1,-2,-4,-4
"3102",2019-01-12,"Brush Creek Trailhead","w1819","Mechanized",0,"Sat","weekend","no_sled","3","3","2",6.1,0,28,-1,21,21.8,0,-1,-2,0,-1,-2,-4,-4
"3103",2019-01-12,"Brush Creek Trailhead","w1819","Motorized",0,"Sat","weekend","sled","3","3","2",6.1,0,28,-1,21,21.8,0,-1,-2,0,-1,-2,-4,-4
"3104",2019-01-12,"Brush Creek Trailhead","w1819","Hybrid",0,"Sat","weekend","sled","3","3","2",6.1,0,28,-1,21,21.8,0,-1,-2,0,-1,-2,-4,-4
"3105",2019-01-13,"Brush Creek Trailhead","w1819","Non.motorized",10,"Sun","weekend","no_sled","2","2","2",6.2,0.1,30,2,18,20.7,-1,0,-1,-2,1,1,0,-2
"3106",2019-01-13,"Brush Creek Trailhead","w1819","Mechanized",0,"Sun","weekend","no_sled","2","2","2",6.2,0.1,30,2,18,20.7,-1,0,-1,-2,1,1,0,-2
"3107",2019-01-13,"Brush Creek Trailhead","w1819","Motorized",0,"Sun","weekend","sled","2","2","2",6.2,0.1,30,2,18,20.7,-1,0,-1,-2,1,1,0,-2
"3108",2019-01-13,"Brush Creek Trailhead","w1819","Hybrid",0,"Sun","weekend","sled","2","2","2",6.2,0.1,30,2,18,20.7,-1,0,-1,-2,1,1,0,-2
"3109",2019-01-14,"Brush Creek Trailhead","w1819","Non.motorized",5,"Mon","weekday","no_sled","2","2","2",6.2,0,30,0,18,20.7,2,-1,0,-1,2,1,1,0
"3110",2019-01-14,"Brush Creek Trailhead","w1819","Mechanized",0,"Mon","weekday","no_sled","2","2","2",6.2,0,30,0,18,20.7,2,-1,0,-1,2,1,1,0
"3111",2019-01-14,"Brush Creek Trailhead","w1819","Motorized",0,"Mon","weekday","sled","2","2","2",6.2,0,30,0,18,20.7,2,-1,0,-1,2,1,1,0
"3112",2019-01-14,"Brush Creek Trailhead","w1819","Hybrid",0,"Mon","weekday","sled","2","2","2",6.2,0,30,0,18,20.7,2,-1,0,-1,2,1,1,0
"3113",2019-01-15,"Brush Creek Trailhead","w1819","Non.motorized",8,"Tue","weekday","no_sled","2","2","2",6.2,0,29,-1,24,21.4,0,2,-1,0,-1,1,0,0
"3114",2019-01-15,"Brush Creek Trailhead","w1819","Mechanized",0,"Tue","weekday","no_sled","2","2","2",6.2,0,29,-1,24,21.4,0,2,-1,0,-1,1,0,0
"3115",2019-01-15,"Brush Creek Trailhead","w1819","Motorized",0,"Tue","weekday","sled","2","2","2",6.2,0,29,-1,24,21.4,0,2,-1,0,-1,1,0,0
"3116",2019-01-15,"Brush Creek Trailhead","w1819","Hybrid",0,"Tue","weekday","sled","2","2","2",6.2,0,29,-1,24,21.4,0,2,-1,0,-1,1,0,0
"3117",2019-01-16,"Brush Creek Trailhead","w1819","Non.motorized",1,"Wed","weekday","no_sled","4","4","3",6.3,0.1,29,0,26,21.7,-1,0,2,-1,-1,-1,1,0
"3118",2019-01-16,"Brush Creek Trailhead","w1819","Mechanized",0,"Wed","weekday","no_sled","4","4","3",6.3,0.1,29,0,26,21.7,-1,0,2,-1,-1,-1,1,0
"3119",2019-01-16,"Brush Creek Trailhead","w1819","Motorized",0,"Wed","weekday","sled","4","4","3",6.3,0.1,29,0,26,21.7,-1,0,2,-1,-1,-1,1,0
"3120",2019-01-16,"Brush Creek Trailhead","w1819","Hybrid",0,"Wed","weekday","sled","4","4","3",6.3,0.1,29,0,26,21.7,-1,0,2,-1,-1,-1,1,0
"3121",2019-01-17,"Brush Creek Trailhead","w1819","Non.motorized",1,"Thu","weekday","no_sled","3","3","2",7,0.7,38,9,28,18.4,0,-1,0,2,9,8,8,10
"3122",2019-01-17,"Brush Creek Trailhead","w1819","Mechanized",0,"Thu","weekday","no_sled","3","3","2",7,0.7,38,9,28,18.4,0,-1,0,2,9,8,8,10
"3123",2019-01-17,"Brush Creek Trailhead","w1819","Motorized",0,"Thu","weekday","sled","3","3","2",7,0.7,38,9,28,18.4,0,-1,0,2,9,8,8,10
"3124",2019-01-17,"Brush Creek Trailhead","w1819","Hybrid",0,"Thu","weekday","sled","3","3","2",7,0.7,38,9,28,18.4,0,-1,0,2,9,8,8,10
"3125",2019-01-18,"Brush Creek Trailhead","w1819","Non.motorized",0,"Fri","weekday","no_sled","4","4","4",7.5,0.5,41,3,22,18.3,9,0,-1,0,12,12,11,11
"3126",2019-01-18,"Brush Creek Trailhead","w1819","Mechanized",0,"Fri","weekday","no_sled","4","4","4",7.5,0.5,41,3,22,18.3,9,0,-1,0,12,12,11,11
"3127",2019-01-18,"Brush Creek Trailhead","w1819","Motorized",0,"Fri","weekday","sled","4","4","4",7.5,0.5,41,3,22,18.3,9,0,-1,0,12,12,11,11
"3128",2019-01-18,"Brush Creek Trailhead","w1819","Hybrid",0,"Fri","weekday","sled","4","4","4",7.5,0.5,41,3,22,18.3,9,0,-1,0,12,12,11,11
"3129",2019-01-19,"Brush Creek Trailhead","w1819","Non.motorized",0,"Sat","weekend","no_sled","3","3","3",7.8,0.3,43,2,20,18.1,3,9,0,-1,5,14,14,13
"3130",2019-01-19,"Brush Creek Trailhead","w1819","Mechanized",0,"Sat","weekend","no_sled","3","3","3",7.8,0.3,43,2,20,18.1,3,9,0,-1,5,14,14,13
"3131",2019-01-19,"Brush Creek Trailhead","w1819","Motorized",0,"Sat","weekend","sled","3","3","3",7.8,0.3,43,2,20,18.1,3,9,0,-1,5,14,14,13
"3132",2019-01-19,"Brush Creek Trailhead","w1819","Hybrid",0,"Sat","weekend","sled","3","3","3",7.8,0.3,43,2,20,18.1,3,9,0,-1,5,14,14,13
"3133",2019-01-20,"Brush Creek Trailhead","w1819","Non.motorized",0,"Sun","weekend","no_sled","3","3","3",7.9,0.1,41,-2,27,19.3,2,3,9,0,0,3,12,12
"3134",2019-01-20,"Brush Creek Trailhead","w1819","Mechanized",0,"Sun","weekend","no_sled","3","3","3",7.9,0.1,41,-2,27,19.3,2,3,9,0,0,3,12,12
"3135",2019-01-20,"Brush Creek Trailhead","w1819","Motorized",0,"Sun","weekend","sled","3","3","3",7.9,0.1,41,-2,27,19.3,2,3,9,0,0,3,12,12
"3136",2019-01-20,"Brush Creek Trailhead","w1819","Hybrid",0,"Sun","weekend","sled","3","3","3",7.9,0.1,41,-2,27,19.3,2,3,9,0,0,3,12,12
"3137",2019-01-21,"Brush Creek Trailhead","w1819","Non.motorized",NA,"Mon","weekday","no_sled","3","3","3",7.9,0,39,-2,23,20.3,-2,2,3,9,-4,-2,1,10
"3138",2019-01-21,"Brush Creek Trailhead","w1819","Mechanized",NA,"Mon","weekday","no_sled","3","3","3",7.9,0,39,-2,23,20.3,-2,2,3,9,-4,-2,1,10
"3139",2019-01-21,"Brush Creek Trailhead","w1819","Motorized",NA,"Mon","weekday","sled","3","3","3",7.9,0,39,-2,23,20.3,-2,2,3,9,-4,-2,1,10
"3140",2019-01-21,"Brush Creek Trailhead","w1819","Hybrid",NA,"Mon","weekday","sled","3","3","3",7.9,0,39,-2,23,20.3,-2,2,3,9,-4,-2,1,10
"3141",2019-01-22,"Brush Creek Trailhead","w1819","Non.motorized",9,"Tue","weekday","no_sled","3","3","3",8,0.1,41,2,12,19.5,-2,-2,2,3,0,-2,0,3
"3142",2019-01-22,"Brush Creek Trailhead","w1819","Mechanized",0,"Tue","weekday","no_sled","3","3","3",8,0.1,41,2,12,19.5,-2,-2,2,3,0,-2,0,3
"3143",2019-01-22,"Brush Creek Trailhead","w1819","Motorized",0,"Tue","weekday","sled","3","3","3",8,0.1,41,2,12,19.5,-2,-2,2,3,0,-2,0,3
"3144",2019-01-22,"Brush Creek Trailhead","w1819","Hybrid",0,"Tue","weekday","sled","3","3","3",8,0.1,41,2,12,19.5,-2,-2,2,3,0,-2,0,3
"3145",2019-01-23,"Brush Creek Trailhead","w1819","Non.motorized",3,"Wed","weekday","no_sled","3","3","2",8,0,40,-1,14,20,2,-2,-2,2,1,-1,-3,-1
"3146",2019-01-23,"Brush Creek Trailhead","w1819","Mechanized",0,"Wed","weekday","no_sled","3","3","2",8,0,40,-1,14,20,2,-2,-2,2,1,-1,-3,-1
"3147",2019-01-23,"Brush Creek Trailhead","w1819","Motorized",0,"Wed","weekday","sled","3","3","2",8,0,40,-1,14,20,2,-2,-2,2,1,-1,-3,-1
"3148",2019-01-23,"Brush Creek Trailhead","w1819","Hybrid",0,"Wed","weekday","sled","3","3","2",8,0,40,-1,14,20,2,-2,-2,2,1,-1,-3,-1
"3149",2019-01-24,"Brush Creek Trailhead","w1819","Non.motorized",5,"Thu","weekday","no_sled","3","3","2",8.2,0.2,40,0,17,20.5,-1,2,-2,-2,-1,1,-1,-3
"3150",2019-01-24,"Brush Creek Trailhead","w1819","Mechanized",0,"Thu","weekday","no_sled","3","3","2",8.2,0.2,40,0,17,20.5,-1,2,-2,-2,-1,1,-1,-3
"3151",2019-01-24,"Brush Creek Trailhead","w1819","Motorized",0,"Thu","weekday","sled","3","3","2",8.2,0.2,40,0,17,20.5,-1,2,-2,-2,-1,1,-1,-3
"3152",2019-01-24,"Brush Creek Trailhead","w1819","Hybrid",0,"Thu","weekday","sled","3","3","2",8.2,0.2,40,0,17,20.5,-1,2,-2,-2,-1,1,-1,-3
"3153",2019-01-25,"Brush Creek Trailhead","w1819","Non.motorized",7,"Fri","weekday","no_sled","3","3","2",8.3,0.1,40,0,15,20.8,0,-1,2,-2,0,-1,1,-1
"3154",2019-01-25,"Brush Creek Trailhead","w1819","Mechanized",2,"Fri","weekday","no_sled","3","3","2",8.3,0.1,40,0,15,20.8,0,-1,2,-2,0,-1,1,-1
"3155",2019-01-25,"Brush Creek Trailhead","w1819","Motorized",0,"Fri","weekday","sled","3","3","2",8.3,0.1,40,0,15,20.8,0,-1,2,-2,0,-1,1,-1
"3156",2019-01-25,"Brush Creek Trailhead","w1819","Hybrid",0,"Fri","weekday","sled","3","3","2",8.3,0.1,40,0,15,20.8,0,-1,2,-2,0,-1,1,-1
"3157",2019-01-26,"Brush Creek Trailhead","w1819","Non.motorized",25,"Sat","weekend","no_sled","3","3","2",8.3,0,39,-1,19,21.3,0,0,-1,2,-1,-1,-2,0
"3158",2019-01-26,"Brush Creek Trailhead","w1819","Mechanized",1,"Sat","weekend","no_sled","3","3","2",8.3,0,39,-1,19,21.3,0,0,-1,2,-1,-1,-2,0
"3159",2019-01-26,"Brush Creek Trailhead","w1819","Motorized",0,"Sat","weekend","sled","3","3","2",8.3,0,39,-1,19,21.3,0,0,-1,2,-1,-1,-2,0
"3160",2019-01-26,"Brush Creek Trailhead","w1819","Hybrid",0,"Sat","weekend","sled","3","3","2",8.3,0,39,-1,19,21.3,0,0,-1,2,-1,-1,-2,0
"3161",2019-01-27,"Brush Creek Trailhead","w1819","Non.motorized",15,"Sun","weekend","no_sled","3","3","2",8.3,0,38,-1,24,21.8,-1,0,0,-1,-2,-2,-2,-3
"3162",2019-01-27,"Brush Creek Trailhead","w1819","Mechanized",0,"Sun","weekend","no_sled","3","3","2",8.3,0,38,-1,24,21.8,-1,0,0,-1,-2,-2,-2,-3
"3163",2019-01-27,"Brush Creek Trailhead","w1819","Motorized",0,"Sun","weekend","sled","3","3","2",8.3,0,38,-1,24,21.8,-1,0,0,-1,-2,-2,-2,-3
"3164",2019-01-27,"Brush Creek Trailhead","w1819","Hybrid",0,"Sun","weekend","sled","3","3","2",8.3,0,38,-1,24,21.8,-1,0,0,-1,-2,-2,-2,-3
"3165",2019-01-28,"Brush Creek Trailhead","w1819","Non.motorized",5,"Mon","weekday","no_sled","2","2","2",8.3,0,38,0,17,21.8,-1,-1,0,0,-1,-2,-2,-2
"3166",2019-01-28,"Brush Creek Trailhead","w1819","Mechanized",0,"Mon","weekday","no_sled","2","2","2",8.3,0,38,0,17,21.8,-1,-1,0,0,-1,-2,-2,-2
"3167",2019-01-28,"Brush Creek Trailhead","w1819","Motorized",0,"Mon","weekday","sled","2","2","2",8.3,0,38,0,17,21.8,-1,-1,0,0,-1,-2,-2,-2
"3168",2019-01-28,"Brush Creek Trailhead","w1819","Hybrid",0,"Mon","weekday","sled","2","2","2",8.3,0,38,0,17,21.8,-1,-1,0,0,-1,-2,-2,-2
"3169",2019-01-29,"Brush Creek Trailhead","w1819","Non.motorized",0,"Tue","weekday","no_sled","2","2","2",8.3,0,38,0,16,21.8,0,-1,-1,0,0,-1,-2,-2
"3170",2019-01-29,"Brush Creek Trailhead","w1819","Mechanized",0,"Tue","weekday","no_sled","2","2","2",8.3,0,38,0,16,21.8,0,-1,-1,0,0,-1,-2,-2
"3171",2019-01-29,"Brush Creek Trailhead","w1819","Motorized",0,"Tue","weekday","sled","2","2","2",8.3,0,38,0,16,21.8,0,-1,-1,0,0,-1,-2,-2
"3172",2019-01-29,"Brush Creek Trailhead","w1819","Hybrid",0,"Tue","weekday","sled","2","2","2",8.3,0,38,0,16,21.8,0,-1,-1,0,0,-1,-2,-2
"3173",2019-01-30,"Brush Creek Trailhead","w1819","Non.motorized",0,"Wed","weekday","no_sled","2","2","1",8.3,0,37,-1,20,22.4,0,0,-1,-1,-1,-1,-2,-3
"3174",2019-01-30,"Brush Creek Trailhead","w1819","Mechanized",0,"Wed","weekday","no_sled","2","2","1",8.3,0,37,-1,20,22.4,0,0,-1,-1,-1,-1,-2,-3
"3175",2019-01-30,"Brush Creek Trailhead","w1819","Motorized",0,"Wed","weekday","sled","2","2","1",8.3,0,37,-1,20,22.4,0,0,-1,-1,-1,-1,-2,-3
"3176",2019-01-30,"Brush Creek Trailhead","w1819","Hybrid",0,"Wed","weekday","sled","2","2","1",8.3,0,37,-1,20,22.4,0,0,-1,-1,-1,-1,-2,-3
"3177",2019-01-31,"Brush Creek Trailhead","w1819","Non.motorized",0,"Thu","weekday","no_sled","2","2","1",8.3,0,36,-1,24,23.1,-1,0,0,-1,-2,-2,-2,-3
"3178",2019-01-31,"Brush Creek Trailhead","w1819","Mechanized",0,"Thu","weekday","no_sled","2","2","1",8.3,0,36,-1,24,23.1,-1,0,0,-1,-2,-2,-2,-3
"3179",2019-01-31,"Brush Creek Trailhead","w1819","Motorized",0,"Thu","weekday","sled","2","2","1",8.3,0,36,-1,24,23.1,-1,0,0,-1,-2,-2,-2,-3
"3180",2019-01-31,"Brush Creek Trailhead","w1819","Hybrid",0,"Thu","weekday","sled","2","2","1",8.3,0,36,-1,24,23.1,-1,0,0,-1,-2,-2,-2,-3
"3181",2019-02-01,"Brush Creek Trailhead","w1819","Non.motorized",5,"Fri","weekday","no_sled","2","2","1",8.3,0,36,0,25,23.1,-1,-1,0,0,-1,-2,-2,-2
"3182",2019-02-01,"Brush Creek Trailhead","w1819","Mechanized",0,"Fri","weekday","no_sled","2","2","1",8.3,0,36,0,25,23.1,-1,-1,0,0,-1,-2,-2,-2
"3183",2019-02-01,"Brush Creek Trailhead","w1819","Motorized",0,"Fri","weekday","sled","2","2","1",8.3,0,36,0,25,23.1,-1,-1,0,0,-1,-2,-2,-2
"3184",2019-02-01,"Brush Creek Trailhead","w1819","Hybrid",0,"Fri","weekday","sled","2","2","1",8.3,0,36,0,25,23.1,-1,-1,0,0,-1,-2,-2,-2
"3185",2019-02-02,"Brush Creek Trailhead","w1819","Non.motorized",27,"Sat","weekend","no_sled","2","2","1",8.3,0,36,0,26,23.1,0,-1,-1,0,0,-1,-2,-2
"3186",2019-02-02,"Brush Creek Trailhead","w1819","Mechanized",2,"Sat","weekend","no_sled","2","2","1",8.3,0,36,0,26,23.1,0,-1,-1,0,0,-1,-2,-2
"3187",2019-02-02,"Brush Creek Trailhead","w1819","Motorized",0,"Sat","weekend","sled","2","2","1",8.3,0,36,0,26,23.1,0,-1,-1,0,0,-1,-2,-2
"3188",2019-02-02,"Brush Creek Trailhead","w1819","Hybrid",0,"Sat","weekend","sled","2","2","1",8.3,0,36,0,26,23.1,0,-1,-1,0,0,-1,-2,-2
"3189",2019-02-03,"Brush Creek Trailhead","w1819","Non.motorized",8,"Sun","weekend","no_sled","3","3","2",8.4,0.1,36,0,28,23.3,0,0,-1,-1,0,0,-1,-2
"3190",2019-02-03,"Brush Creek Trailhead","w1819","Mechanized",0,"Sun","weekend","no_sled","3","3","2",8.4,0.1,36,0,28,23.3,0,0,-1,-1,0,0,-1,-2
"3191",2019-02-03,"Brush Creek Trailhead","w1819","Motorized",0,"Sun","weekend","sled","3","3","2",8.4,0.1,36,0,28,23.3,0,0,-1,-1,0,0,-1,-2
"3192",2019-02-03,"Brush Creek Trailhead","w1819","Hybrid",0,"Sun","weekend","sled","3","3","2",8.4,0.1,36,0,28,23.3,0,0,-1,-1,0,0,-1,-2
"3193",2019-02-04,"Brush Creek Trailhead","w1819","Non.motorized",4,"Mon","weekday","no_sled","3","3","2",8.8,0.4,39,3,28,22.6,0,0,0,-1,3,3,3,2
"3194",2019-02-04,"Brush Creek Trailhead","w1819","Mechanized",0,"Mon","weekday","no_sled","3","3","2",8.8,0.4,39,3,28,22.6,0,0,0,-1,3,3,3,2
"3195",2019-02-04,"Brush Creek Trailhead","w1819","Motorized",0,"Mon","weekday","sled","3","3","2",8.8,0.4,39,3,28,22.6,0,0,0,-1,3,3,3,2
"3196",2019-02-04,"Brush Creek Trailhead","w1819","Hybrid",0,"Mon","weekday","sled","3","3","2",8.8,0.4,39,3,28,22.6,0,0,0,-1,3,3,3,2
"3197",2019-02-05,"Brush Creek Trailhead","w1819","Non.motorized",6,"Tue","weekday","no_sled","3","2","2",9,0.2,40,1,26,22.5,3,0,0,0,4,4,4,4
"3198",2019-02-05,"Brush Creek Trailhead","w1819","Mechanized",1,"Tue","weekday","no_sled","3","2","2",9,0.2,40,1,26,22.5,3,0,0,0,4,4,4,4
"3199",2019-02-05,"Brush Creek Trailhead","w1819","Motorized",0,"Tue","weekday","sled","3","2","2",9,0.2,40,1,26,22.5,3,0,0,0,4,4,4,4
"3200",2019-02-05,"Brush Creek Trailhead","w1819","Hybrid",0,"Tue","weekday","sled","3","2","2",9,0.2,40,1,26,22.5,3,0,0,0,4,4,4,4
"3201",2019-02-06,"Brush Creek Trailhead","w1819","Non.motorized",2,"Wed","weekday","no_sled","4","4","3",9,0,40,0,16,22.5,1,3,0,0,1,4,4,4
"3202",2019-02-06,"Brush Creek Trailhead","w1819","Mechanized",0,"Wed","weekday","no_sled","4","4","3",9,0,40,0,16,22.5,1,3,0,0,1,4,4,4
"3203",2019-02-06,"Brush Creek Trailhead","w1819","Motorized",0,"Wed","weekday","sled","4","4","3",9,0,40,0,16,22.5,1,3,0,0,1,4,4,4
"3204",2019-02-06,"Brush Creek Trailhead","w1819","Hybrid",0,"Wed","weekday","sled","4","4","3",9,0,40,0,16,22.5,1,3,0,0,1,4,4,4
"3205",2019-02-07,"Brush Creek Trailhead","w1819","Non.motorized",0,"Thu","weekday","no_sled","3","3","2",9.2,0.2,43,3,4,21.4,0,1,3,0,3,4,7,7
"3206",2019-02-07,"Brush Creek Trailhead","w1819","Mechanized",0,"Thu","weekday","no_sled","3","3","2",9.2,0.2,43,3,4,21.4,0,1,3,0,3,4,7,7
"3207",2019-02-07,"Brush Creek Trailhead","w1819","Motorized",0,"Thu","weekday","sled","3","3","2",9.2,0.2,43,3,4,21.4,0,1,3,0,3,4,7,7
"3208",2019-02-07,"Brush Creek Trailhead","w1819","Hybrid",0,"Thu","weekday","sled","3","3","2",9.2,0.2,43,3,4,21.4,0,1,3,0,3,4,7,7
"3209",2019-02-08,"Brush Creek Trailhead","w1819","Non.motorized",2,"Fri","weekday","no_sled","3","2","2",9.2,0,42,-1,10,21.9,3,0,1,3,2,2,3,6
"3210",2019-02-08,"Brush Creek Trailhead","w1819","Mechanized",0,"Fri","weekday","no_sled","3","2","2",9.2,0,42,-1,10,21.9,3,0,1,3,2,2,3,6
"3211",2019-02-08,"Brush Creek Trailhead","w1819","Motorized",0,"Fri","weekday","sled","3","2","2",9.2,0,42,-1,10,21.9,3,0,1,3,2,2,3,6
"3212",2019-02-08,"Brush Creek Trailhead","w1819","Hybrid",0,"Fri","weekday","sled","3","2","2",9.2,0,42,-1,10,21.9,3,0,1,3,2,2,3,6
"3213",2019-02-09,"Brush Creek Trailhead","w1819","Non.motorized",7,"Sat","weekend","no_sled","3","2","2",9.2,0,41,-1,20,22.4,-1,3,0,1,-2,1,1,2
"3214",2019-02-09,"Brush Creek Trailhead","w1819","Mechanized",0,"Sat","weekend","no_sled","3","2","2",9.2,0,41,-1,20,22.4,-1,3,0,1,-2,1,1,2
"3215",2019-02-09,"Brush Creek Trailhead","w1819","Motorized",0,"Sat","weekend","sled","3","2","2",9.2,0,41,-1,20,22.4,-1,3,0,1,-2,1,1,2
"3216",2019-02-09,"Brush Creek Trailhead","w1819","Hybrid",0,"Sat","weekend","sled","3","2","2",9.2,0,41,-1,20,22.4,-1,3,0,1,-2,1,1,2
"3217",2019-02-10,"Brush Creek Trailhead","w1819","Non.motorized",21,"Sun","weekend","no_sled","2","2","2",9.3,0.1,40,-1,20,23.2,-1,-1,3,0,-2,-3,0,0
"3218",2019-02-10,"Brush Creek Trailhead","w1819","Mechanized",0,"Sun","weekend","no_sled","2","2","2",9.3,0.1,40,-1,20,23.2,-1,-1,3,0,-2,-3,0,0
"3219",2019-02-10,"Brush Creek Trailhead","w1819","Motorized",0,"Sun","weekend","sled","2","2","2",9.3,0.1,40,-1,20,23.2,-1,-1,3,0,-2,-3,0,0
"3220",2019-02-10,"Brush Creek Trailhead","w1819","Hybrid",0,"Sun","weekend","sled","2","2","2",9.3,0.1,40,-1,20,23.2,-1,-1,3,0,-2,-3,0,0
"3221",2019-02-11,"Brush Creek Trailhead","w1819","Non.motorized",7,"Mon","weekday","no_sled","2","2","1",9.3,0,40,0,15,23.2,-1,-1,-1,3,-1,-2,-3,0
"3222",2019-02-11,"Brush Creek Trailhead","w1819","Mechanized",0,"Mon","weekday","no_sled","2","2","1",9.3,0,40,0,15,23.2,-1,-1,-1,3,-1,-2,-3,0
"3223",2019-02-11,"Brush Creek Trailhead","w1819","Motorized",0,"Mon","weekday","sled","2","2","1",9.3,0,40,0,15,23.2,-1,-1,-1,3,-1,-2,-3,0
"3224",2019-02-11,"Brush Creek Trailhead","w1819","Hybrid",0,"Mon","weekday","sled","2","2","1",9.3,0,40,0,15,23.2,-1,-1,-1,3,-1,-2,-3,0
"3225",2019-02-12,"Brush Creek Trailhead","w1819","Non.motorized",7,"Tue","weekday","no_sled","2","2","1",9.3,0,40,0,18,23.2,0,-1,-1,-1,0,-1,-2,-3
"3226",2019-02-12,"Brush Creek Trailhead","w1819","Mechanized",0,"Tue","weekday","no_sled","2","2","1",9.3,0,40,0,18,23.2,0,-1,-1,-1,0,-1,-2,-3
"3227",2019-02-12,"Brush Creek Trailhead","w1819","Motorized",0,"Tue","weekday","sled","2","2","1",9.3,0,40,0,18,23.2,0,-1,-1,-1,0,-1,-2,-3
"3228",2019-02-12,"Brush Creek Trailhead","w1819","Hybrid",0,"Tue","weekday","sled","2","2","1",9.3,0,40,0,18,23.2,0,-1,-1,-1,0,-1,-2,-3
"3229",2019-02-13,"Brush Creek Trailhead","w1819","Non.motorized",NA,"Wed","weekday","no_sled","2","2","1",9.4,0.1,40,0,26,23.5,0,0,-1,-1,0,0,-1,-2
"3230",2019-02-13,"Brush Creek Trailhead","w1819","Mechanized",NA,"Wed","weekday","no_sled","2","2","1",9.4,0.1,40,0,26,23.5,0,0,-1,-1,0,0,-1,-2
"3231",2019-02-13,"Brush Creek Trailhead","w1819","Motorized",NA,"Wed","weekday","sled","2","2","1",9.4,0.1,40,0,26,23.5,0,0,-1,-1,0,0,-1,-2
"3232",2019-02-13,"Brush Creek Trailhead","w1819","Hybrid",NA,"Wed","weekday","sled","2","2","1",9.4,0.1,40,0,26,23.5,0,0,-1,-1,0,0,-1,-2
"3233",2019-02-14,"Brush Creek Trailhead","w1819","Non.motorized",5,"Thu","weekday","no_sled","3","2","2",9.7,0.3,41,1,29,23.7,0,0,0,-1,1,1,1,0
"3234",2019-02-14,"Brush Creek Trailhead","w1819","Mechanized",0,"Thu","weekday","no_sled","3","2","2",9.7,0.3,41,1,29,23.7,0,0,0,-1,1,1,1,0
"3235",2019-02-14,"Brush Creek Trailhead","w1819","Motorized",0,"Thu","weekday","sled","3","2","2",9.7,0.3,41,1,29,23.7,0,0,0,-1,1,1,1,0
"3236",2019-02-14,"Brush Creek Trailhead","w1819","Hybrid",0,"Thu","weekday","sled","3","2","2",9.7,0.3,41,1,29,23.7,0,0,0,-1,1,1,1,0
"3237",2019-02-15,"Brush Creek Trailhead","w1819","Non.motorized",2,"Fri","weekday","no_sled","4","4","3",10.8,1.1,51,10,27,21.2,1,0,0,0,11,11,11,11
"3238",2019-02-15,"Brush Creek Trailhead","w1819","Mechanized",0,"Fri","weekday","no_sled","4","4","3",10.8,1.1,51,10,27,21.2,1,0,0,0,11,11,11,11
"3239",2019-02-15,"Brush Creek Trailhead","w1819","Motorized",0,"Fri","weekday","sled","4","4","3",10.8,1.1,51,10,27,21.2,1,0,0,0,11,11,11,11
"3240",2019-02-15,"Brush Creek Trailhead","w1819","Hybrid",0,"Fri","weekday","sled","4","4","3",10.8,1.1,51,10,27,21.2,1,0,0,0,11,11,11,11
"3241",2019-02-16,"Brush Creek Trailhead","w1819","Non.motorized",0,"Sat","weekend","no_sled","3","3","3",11.1,0.3,52,1,14,21.3,10,1,0,0,11,12,12,12
"3242",2019-02-16,"Brush Creek Trailhead","w1819","Mechanized",0,"Sat","weekend","no_sled","3","3","3",11.1,0.3,52,1,14,21.3,10,1,0,0,11,12,12,12
"3243",2019-02-16,"Brush Creek Trailhead","w1819","Motorized",0,"Sat","weekend","sled","3","3","3",11.1,0.3,52,1,14,21.3,10,1,0,0,11,12,12,12
"3244",2019-02-16,"Brush Creek Trailhead","w1819","Hybrid",0,"Sat","weekend","sled","3","3","3",11.1,0.3,52,1,14,21.3,10,1,0,0,11,12,12,12
"3245",2019-02-17,"Brush Creek Trailhead","w1819","Non.motorized",5,"Sun","weekend","no_sled","3","3","3",11.3,0.2,55,3,10,20.5,1,10,1,0,4,14,15,15
"3246",2019-02-17,"Brush Creek Trailhead","w1819","Mechanized",0,"Sun","weekend","no_sled","3","3","3",11.3,0.2,55,3,10,20.5,1,10,1,0,4,14,15,15
"3247",2019-02-17,"Brush Creek Trailhead","w1819","Motorized",0,"Sun","weekend","sled","3","3","3",11.3,0.2,55,3,10,20.5,1,10,1,0,4,14,15,15
"3248",2019-02-17,"Brush Creek Trailhead","w1819","Hybrid",0,"Sun","weekend","sled","3","3","3",11.3,0.2,55,3,10,20.5,1,10,1,0,4,14,15,15
"3249",2019-02-18,"Brush Creek Trailhead","w1819","Non.motorized",6,"Mon","weekday","no_sled","3","3","2",11.4,0.1,53,-2,13,21.5,3,1,10,1,1,2,12,13
"3250",2019-02-18,"Brush Creek Trailhead","w1819","Mechanized",0,"Mon","weekday","no_sled","3","3","2",11.4,0.1,53,-2,13,21.5,3,1,10,1,1,2,12,13
"3251",2019-02-18,"Brush Creek Trailhead","w1819","Motorized",0,"Mon","weekday","sled","3","3","2",11.4,0.1,53,-2,13,21.5,3,1,10,1,1,2,12,13
"3252",2019-02-18,"Brush Creek Trailhead","w1819","Hybrid",0,"Mon","weekday","sled","3","3","2",11.4,0.1,53,-2,13,21.5,3,1,10,1,1,2,12,13
"3253",2019-02-19,"Brush Creek Trailhead","w1819","Non.motorized",0,"Tue","weekday","no_sled","3","3","2",11.5,0.1,53,0,11,21.7,-2,3,1,10,-2,1,2,12
"3254",2019-02-19,"Brush Creek Trailhead","w1819","Mechanized",0,"Tue","weekday","no_sled","3","3","2",11.5,0.1,53,0,11,21.7,-2,3,1,10,-2,1,2,12
"3255",2019-02-19,"Brush Creek Trailhead","w1819","Motorized",0,"Tue","weekday","sled","3","3","2",11.5,0.1,53,0,11,21.7,-2,3,1,10,-2,1,2,12
"3256",2019-02-19,"Brush Creek Trailhead","w1819","Hybrid",0,"Tue","weekday","sled","3","3","2",11.5,0.1,53,0,11,21.7,-2,3,1,10,-2,1,2,12
"3257",2019-02-20,"Brush Creek Trailhead","w1819","Non.motorized",0,"Wed","weekday","no_sled","3","3","2",11.6,0.1,53,0,7,21.9,0,-2,3,1,0,-2,1,2
"3258",2019-02-20,"Brush Creek Trailhead","w1819","Mechanized",0,"Wed","weekday","no_sled","3","3","2",11.6,0.1,53,0,7,21.9,0,-2,3,1,0,-2,1,2
"3259",2019-02-20,"Brush Creek Trailhead","w1819","Motorized",0,"Wed","weekday","sled","3","3","2",11.6,0.1,53,0,7,21.9,0,-2,3,1,0,-2,1,2
"3260",2019-02-20,"Brush Creek Trailhead","w1819","Hybrid",0,"Wed","weekday","sled","3","3","2",11.6,0.1,53,0,7,21.9,0,-2,3,1,0,-2,1,2
"3261",2019-02-21,"Brush Creek Trailhead","w1819","Non.motorized",0,"Thu","weekday","no_sled","3","3","3",11.6,0,52,-1,15,22.3,0,0,-2,3,-1,-1,-3,0
"3262",2019-02-21,"Brush Creek Trailhead","w1819","Mechanized",0,"Thu","weekday","no_sled","3","3","3",11.6,0,52,-1,15,22.3,0,0,-2,3,-1,-1,-3,0
"3263",2019-02-21,"Brush Creek Trailhead","w1819","Motorized",0,"Thu","weekday","sled","3","3","3",11.6,0,52,-1,15,22.3,0,0,-2,3,-1,-1,-3,0
"3264",2019-02-21,"Brush Creek Trailhead","w1819","Hybrid",0,"Thu","weekday","sled","3","3","3",11.6,0,52,-1,15,22.3,0,0,-2,3,-1,-1,-3,0
"3265",2019-02-22,"Brush Creek Trailhead","w1819","Non.motorized",0,"Fri","weekday","no_sled","3","3","3",11.8,0.2,52,0,20,22.7,-1,0,0,-2,-1,-1,-1,-3
"3266",2019-02-22,"Brush Creek Trailhead","w1819","Mechanized",0,"Fri","weekday","no_sled","3","3","3",11.8,0.2,52,0,20,22.7,-1,0,0,-2,-1,-1,-1,-3
"3267",2019-02-22,"Brush Creek Trailhead","w1819","Motorized",0,"Fri","weekday","sled","3","3","3",11.8,0.2,52,0,20,22.7,-1,0,0,-2,-1,-1,-1,-3
"3268",2019-02-22,"Brush Creek Trailhead","w1819","Hybrid",0,"Fri","weekday","sled","3","3","3",11.8,0.2,52,0,20,22.7,-1,0,0,-2,-1,-1,-1,-3
"3269",2019-02-23,"Brush Creek Trailhead","w1819","Non.motorized",8,"Sat","weekend","no_sled","3","3","3",12.1,0.3,53,1,13,22.8,0,-1,0,0,1,0,0,0
"3270",2019-02-23,"Brush Creek Trailhead","w1819","Mechanized",0,"Sat","weekend","no_sled","3","3","3",12.1,0.3,53,1,13,22.8,0,-1,0,0,1,0,0,0
"3271",2019-02-23,"Brush Creek Trailhead","w1819","Motorized",0,"Sat","weekend","sled","3","3","3",12.1,0.3,53,1,13,22.8,0,-1,0,0,1,0,0,0
"3272",2019-02-23,"Brush Creek Trailhead","w1819","Hybrid",0,"Sat","weekend","sled","3","3","3",12.1,0.3,53,1,13,22.8,0,-1,0,0,1,0,0,0
"3273",2019-02-24,"Brush Creek Trailhead","w1819","Non.motorized",13,"Sun","weekend","no_sled","3","3","2",12.1,0,52,-1,14,23.3,1,0,-1,0,0,0,-1,-1
"3274",2019-02-24,"Brush Creek Trailhead","w1819","Mechanized",0,"Sun","weekend","no_sled","3","3","2",12.1,0,52,-1,14,23.3,1,0,-1,0,0,0,-1,-1
"3275",2019-02-24,"Brush Creek Trailhead","w1819","Motorized",0,"Sun","weekend","sled","3","3","2",12.1,0,52,-1,14,23.3,1,0,-1,0,0,0,-1,-1
"3276",2019-02-24,"Brush Creek Trailhead","w1819","Hybrid",0,"Sun","weekend","sled","3","3","2",12.1,0,52,-1,14,23.3,1,0,-1,0,0,0,-1,-1
"3277",2019-02-25,"Brush Creek Trailhead","w1819","Non.motorized",10,"Mon","weekday","no_sled","3","3","2",12.1,0,51,-1,22,23.7,-1,1,0,-1,-2,-1,-1,-2
"3278",2019-02-25,"Brush Creek Trailhead","w1819","Mechanized",0,"Mon","weekday","no_sled","3","3","2",12.1,0,51,-1,22,23.7,-1,1,0,-1,-2,-1,-1,-2
"3279",2019-02-25,"Brush Creek Trailhead","w1819","Motorized",0,"Mon","weekday","sled","3","3","2",12.1,0,51,-1,22,23.7,-1,1,0,-1,-2,-1,-1,-2
"3280",2019-02-25,"Brush Creek Trailhead","w1819","Hybrid",0,"Mon","weekday","sled","3","3","2",12.1,0,51,-1,22,23.7,-1,1,0,-1,-2,-1,-1,-2
"3281",2019-02-26,"Brush Creek Trailhead","w1819","Non.motorized",8,"Tue","weekday","no_sled","2","2","2",12.1,0,50,-1,27,24.2,-1,-1,1,0,-2,-3,-2,-2
"3282",2019-02-26,"Brush Creek Trailhead","w1819","Mechanized",0,"Tue","weekday","no_sled","2","2","2",12.1,0,50,-1,27,24.2,-1,-1,1,0,-2,-3,-2,-2
"3283",2019-02-26,"Brush Creek Trailhead","w1819","Motorized",0,"Tue","weekday","sled","2","2","2",12.1,0,50,-1,27,24.2,-1,-1,1,0,-2,-3,-2,-2
"3284",2019-02-26,"Brush Creek Trailhead","w1819","Hybrid",0,"Tue","weekday","sled","2","2","2",12.1,0,50,-1,27,24.2,-1,-1,1,0,-2,-3,-2,-2
"3285",2019-02-27,"Brush Creek Trailhead","w1819","Non.motorized",1,"Wed","weekday","no_sled","2","2","2",12.1,0,50,0,30,24.2,-1,-1,-1,1,-1,-2,-3,-2
"3286",2019-02-27,"Brush Creek Trailhead","w1819","Mechanized",0,"Wed","weekday","no_sled","2","2","2",12.1,0,50,0,30,24.2,-1,-1,-1,1,-1,-2,-3,-2
"3287",2019-02-27,"Brush Creek Trailhead","w1819","Motorized",0,"Wed","weekday","sled","2","2","2",12.1,0,50,0,30,24.2,-1,-1,-1,1,-1,-2,-3,-2
"3288",2019-02-27,"Brush Creek Trailhead","w1819","Hybrid",0,"Wed","weekday","sled","2","2","2",12.1,0,50,0,30,24.2,-1,-1,-1,1,-1,-2,-3,-2
"3289",2019-02-28,"Brush Creek Trailhead","w1819","Non.motorized",6,"Thu","weekday","no_sled","2","2","2",12.2,0.1,49,-1,30,24.9,0,-1,-1,-1,-1,-2,-3,-4
"3290",2019-02-28,"Brush Creek Trailhead","w1819","Mechanized",0,"Thu","weekday","no_sled","2","2","2",12.2,0.1,49,-1,30,24.9,0,-1,-1,-1,-1,-2,-3,-4
"3291",2019-02-28,"Brush Creek Trailhead","w1819","Motorized",0,"Thu","weekday","sled","2","2","2",12.2,0.1,49,-1,30,24.9,0,-1,-1,-1,-1,-2,-3,-4
"3292",2019-02-28,"Brush Creek Trailhead","w1819","Hybrid",0,"Thu","weekday","sled","2","2","2",12.2,0.1,49,-1,30,24.9,0,-1,-1,-1,-1,-2,-3,-4
"3293",2019-03-01,"Brush Creek Trailhead","w1819","Non.motorized",0,"Fri","weekday","no_sled","2","2","1",12.3,0.1,49,0,29,25.1,-1,0,-1,-1,-1,-1,-2,-3
"3294",2019-03-01,"Brush Creek Trailhead","w1819","Mechanized",0,"Fri","weekday","no_sled","2","2","1",12.3,0.1,49,0,29,25.1,-1,0,-1,-1,-1,-1,-2,-3
"3295",2019-03-01,"Brush Creek Trailhead","w1819","Motorized",0,"Fri","weekday","sled","2","2","1",12.3,0.1,49,0,29,25.1,-1,0,-1,-1,-1,-1,-2,-3
"3296",2019-03-01,"Brush Creek Trailhead","w1819","Hybrid",0,"Fri","weekday","sled","2","2","1",12.3,0.1,49,0,29,25.1,-1,0,-1,-1,-1,-1,-2,-3
"3297",2019-03-02,"Brush Creek Trailhead","w1819","Non.motorized",0,"Sat","weekend","no_sled","3","3","2",13,0.7,58,9,30,22.4,0,-1,0,-1,9,8,8,7
"3298",2019-03-02,"Brush Creek Trailhead","w1819","Mechanized",0,"Sat","weekend","no_sled","3","3","2",13,0.7,58,9,30,22.4,0,-1,0,-1,9,8,8,7
"3299",2019-03-02,"Brush Creek Trailhead","w1819","Motorized",0,"Sat","weekend","sled","3","3","2",13,0.7,58,9,30,22.4,0,-1,0,-1,9,8,8,7
"3300",2019-03-02,"Brush Creek Trailhead","w1819","Hybrid",0,"Sat","weekend","sled","3","3","2",13,0.7,58,9,30,22.4,0,-1,0,-1,9,8,8,7
"3301",2019-03-03,"Brush Creek Trailhead","w1819","Non.motorized",0,"Sun","weekend","no_sled","3","3","3",13.7,0.7,64,6,27,21.4,9,0,-1,0,15,15,14,14
"3302",2019-03-03,"Brush Creek Trailhead","w1819","Mechanized",0,"Sun","weekend","no_sled","3","3","3",13.7,0.7,64,6,27,21.4,9,0,-1,0,15,15,14,14
"3303",2019-03-03,"Brush Creek Trailhead","w1819","Motorized",0,"Sun","weekend","sled","3","3","3",13.7,0.7,64,6,27,21.4,9,0,-1,0,15,15,14,14
"3304",2019-03-03,"Brush Creek Trailhead","w1819","Hybrid",0,"Sun","weekend","sled","3","3","3",13.7,0.7,64,6,27,21.4,9,0,-1,0,15,15,14,14
"3305",2019-03-04,"Brush Creek Trailhead","w1819","Non.motorized",10,"Mon","weekday","no_sled","3","3","3",14.4,0.7,66,2,23,21.8,6,9,0,-1,8,17,17,16
"3306",2019-03-04,"Brush Creek Trailhead","w1819","Mechanized",0,"Mon","weekday","no_sled","3","3","3",14.4,0.7,66,2,23,21.8,6,9,0,-1,8,17,17,16
"3307",2019-03-04,"Brush Creek Trailhead","w1819","Motorized",0,"Mon","weekday","sled","3","3","3",14.4,0.7,66,2,23,21.8,6,9,0,-1,8,17,17,16
"3308",2019-03-04,"Brush Creek Trailhead","w1819","Hybrid",0,"Mon","weekday","sled","3","3","3",14.4,0.7,66,2,23,21.8,6,9,0,-1,8,17,17,16
"3309",2019-03-05,"Brush Creek Trailhead","w1819","Non.motorized",5,"Tue","weekday","no_sled","3","3","3",14.4,0,64,-2,24,22.5,2,6,9,0,0,6,15,15
"3310",2019-03-05,"Brush Creek Trailhead","w1819","Mechanized",0,"Tue","weekday","no_sled","3","3","3",14.4,0,64,-2,24,22.5,2,6,9,0,0,6,15,15
"3311",2019-03-05,"Brush Creek Trailhead","w1819","Motorized",0,"Tue","weekday","sled","3","3","3",14.4,0,64,-2,24,22.5,2,6,9,0,0,6,15,15
"3312",2019-03-05,"Brush Creek Trailhead","w1819","Hybrid",0,"Tue","weekday","sled","3","3","3",14.4,0,64,-2,24,22.5,2,6,9,0,0,6,15,15
"3313",2019-03-06,"Brush Creek Trailhead","w1819","Non.motorized",1,"Wed","weekday","no_sled","3","3","2",14.5,0.1,62,-2,31,23.4,-2,2,6,9,-4,-2,4,13
"3314",2019-03-06,"Brush Creek Trailhead","w1819","Non.motorized",1,"Wed","weekday","no_sled","4","4","3",14.5,0.1,62,-2,31,23.4,-2,2,6,9,-4,-2,4,13
"3315",2019-03-06,"Brush Creek Trailhead","w1819","Mechanized",0,"Wed","weekday","no_sled","3","3","2",14.5,0.1,62,-2,31,23.4,-2,2,6,9,-4,-2,4,13
"3316",2019-03-06,"Brush Creek Trailhead","w1819","Mechanized",0,"Wed","weekday","no_sled","4","4","3",14.5,0.1,62,-2,31,23.4,-2,2,6,9,-4,-2,4,13
"3317",2019-03-06,"Brush Creek Trailhead","w1819","Motorized",0,"Wed","weekday","sled","3","3","2",14.5,0.1,62,-2,31,23.4,-2,2,6,9,-4,-2,4,13
"3318",2019-03-06,"Brush Creek Trailhead","w1819","Motorized",0,"Wed","weekday","sled","4","4","3",14.5,0.1,62,-2,31,23.4,-2,2,6,9,-4,-2,4,13
"3319",2019-03-06,"Brush Creek Trailhead","w1819","Hybrid",0,"Wed","weekday","sled","3","3","2",14.5,0.1,62,-2,31,23.4,-2,2,6,9,-4,-2,4,13
"3320",2019-03-06,"Brush Creek Trailhead","w1819","Hybrid",0,"Wed","weekday","sled","4","4","3",14.5,0.1,62,-2,31,23.4,-2,2,6,9,-4,-2,4,13
"3321",2019-03-07,"Brush Creek Trailhead","w1819","Non.motorized",1,"Thu","weekday","no_sled","4","4","3",16.2,1.7,71,9,30,22.8,-2,-2,2,6,7,5,7,13
"3322",2019-03-07,"Brush Creek Trailhead","w1819","Mechanized",0,"Thu","weekday","no_sled","4","4","3",16.2,1.7,71,9,30,22.8,-2,-2,2,6,7,5,7,13
"3323",2019-03-07,"Brush Creek Trailhead","w1819","Motorized",0,"Thu","weekday","sled","4","4","3",16.2,1.7,71,9,30,22.8,-2,-2,2,6,7,5,7,13
"3324",2019-03-07,"Brush Creek Trailhead","w1819","Hybrid",0,"Thu","weekday","sled","4","4","3",16.2,1.7,71,9,30,22.8,-2,-2,2,6,7,5,7,13
"3325",2019-03-08,"Brush Creek Trailhead","w1819","Non.motorized",1,"Fri","weekday","no_sled","3","3","3",16.6,0.4,71,0,27,23.4,9,-2,-2,2,9,7,5,7
"3326",2019-03-08,"Brush Creek Trailhead","w1819","Mechanized",0,"Fri","weekday","no_sled","3","3","3",16.6,0.4,71,0,27,23.4,9,-2,-2,2,9,7,5,7
"3327",2019-03-08,"Brush Creek Trailhead","w1819","Motorized",0,"Fri","weekday","sled","3","3","3",16.6,0.4,71,0,27,23.4,9,-2,-2,2,9,7,5,7
"3328",2019-03-08,"Brush Creek Trailhead","w1819","Hybrid",0,"Fri","weekday","sled","3","3","3",16.6,0.4,71,0,27,23.4,9,-2,-2,2,9,7,5,7
"3329",2019-03-09,"Brush Creek Trailhead","w1819","Non.motorized",0,"Sat","weekend","no_sled","4","4","3",17.2,0.6,76,5,22,22.6,0,9,-2,-2,5,14,12,10
"3330",2019-03-09,"Brush Creek Trailhead","w1819","Mechanized",0,"Sat","weekend","no_sled","4","4","3",17.2,0.6,76,5,22,22.6,0,9,-2,-2,5,14,12,10
"3331",2019-03-09,"Brush Creek Trailhead","w1819","Motorized",0,"Sat","weekend","sled","4","4","3",17.2,0.6,76,5,22,22.6,0,9,-2,-2,5,14,12,10
"3332",2019-03-09,"Brush Creek Trailhead","w1819","Hybrid",0,"Sat","weekend","sled","4","4","3",17.2,0.6,76,5,22,22.6,0,9,-2,-2,5,14,12,10
"3333",2019-03-10,"Brush Creek Trailhead","w1819","Non.motorized",10,"Sun","weekend","no_sled","3","3","3",17.3,0.1,73,-3,25,23.7,5,0,9,-2,2,2,11,9
"3334",2019-03-10,"Brush Creek Trailhead","w1819","Mechanized",0,"Sun","weekend","no_sled","3","3","3",17.3,0.1,73,-3,25,23.7,5,0,9,-2,2,2,11,9
"3335",2019-03-10,"Brush Creek Trailhead","w1819","Motorized",2,"Sun","weekend","sled","3","3","3",17.3,0.1,73,-3,25,23.7,5,0,9,-2,2,2,11,9
"3336",2019-03-10,"Brush Creek Trailhead","w1819","Hybrid",0,"Sun","weekend","sled","3","3","3",17.3,0.1,73,-3,25,23.7,5,0,9,-2,2,2,11,9
"3337",2019-03-11,"Brush Creek Trailhead","w1819","Non.motorized",1,"Mon","weekday","no_sled","3","3","2",17.3,0,71,-2,29,24.4,-3,5,0,9,-5,0,0,9
"3338",2019-03-11,"Brush Creek Trailhead","w1819","Mechanized",0,"Mon","weekday","no_sled","3","3","2",17.3,0,71,-2,29,24.4,-3,5,0,9,-5,0,0,9
"3339",2019-03-11,"Brush Creek Trailhead","w1819","Motorized",0,"Mon","weekday","sled","3","3","2",17.3,0,71,-2,29,24.4,-3,5,0,9,-5,0,0,9
"3340",2019-03-11,"Brush Creek Trailhead","w1819","Hybrid",0,"Mon","weekday","sled","3","3","2",17.3,0,71,-2,29,24.4,-3,5,0,9,-5,0,0,9
"3341",2019-03-12,"Brush Creek Trailhead","w1819","Non.motorized",0,"Tue","weekday","no_sled","3","3","3",17.4,0.1,70,-1,32,24.9,-2,-3,5,0,-3,-6,-1,-1
"3342",2019-03-12,"Brush Creek Trailhead","w1819","Non.motorized",0,"Tue","weekday","no_sled","4","4","4",17.4,0.1,70,-1,32,24.9,-2,-3,5,0,-3,-6,-1,-1
"3343",2019-03-12,"Brush Creek Trailhead","w1819","Mechanized",0,"Tue","weekday","no_sled","3","3","3",17.4,0.1,70,-1,32,24.9,-2,-3,5,0,-3,-6,-1,-1
"3344",2019-03-12,"Brush Creek Trailhead","w1819","Mechanized",0,"Tue","weekday","no_sled","4","4","4",17.4,0.1,70,-1,32,24.9,-2,-3,5,0,-3,-6,-1,-1
"3345",2019-03-12,"Brush Creek Trailhead","w1819","Motorized",0,"Tue","weekday","sled","3","3","3",17.4,0.1,70,-1,32,24.9,-2,-3,5,0,-3,-6,-1,-1
"3346",2019-03-12,"Brush Creek Trailhead","w1819","Motorized",0,"Tue","weekday","sled","4","4","4",17.4,0.1,70,-1,32,24.9,-2,-3,5,0,-3,-6,-1,-1
"3347",2019-03-12,"Brush Creek Trailhead","w1819","Hybrid",0,"Tue","weekday","sled","3","3","3",17.4,0.1,70,-1,32,24.9,-2,-3,5,0,-3,-6,-1,-1
"3348",2019-03-12,"Brush Creek Trailhead","w1819","Hybrid",0,"Tue","weekday","sled","4","4","4",17.4,0.1,70,-1,32,24.9,-2,-3,5,0,-3,-6,-1,-1
"3349",2019-03-13,"Brush Creek Trailhead","w1819","Non.motorized",1,"Wed","weekday","no_sled","4","4","3",18.1,0.7,74,4,24,24.5,-1,-2,-3,5,3,1,-2,3
"3350",2019-03-13,"Brush Creek Trailhead","w1819","Mechanized",0,"Wed","weekday","no_sled","4","4","3",18.1,0.7,74,4,24,24.5,-1,-2,-3,5,3,1,-2,3
"3351",2019-03-13,"Brush Creek Trailhead","w1819","Motorized",0,"Wed","weekday","sled","4","4","3",18.1,0.7,74,4,24,24.5,-1,-2,-3,5,3,1,-2,3
"3352",2019-03-13,"Brush Creek Trailhead","w1819","Hybrid",0,"Wed","weekday","sled","4","4","3",18.1,0.7,74,4,24,24.5,-1,-2,-3,5,3,1,-2,3
"3353",2019-03-14,"Brush Creek Trailhead","w1819","Non.motorized",0,"Thu","weekday","no_sled","4","4","3",18.1,0,74,0,17,24.5,4,-1,-2,-3,4,3,1,-2
"3354",2019-03-14,"Brush Creek Trailhead","w1819","Mechanized",0,"Thu","weekday","no_sled","4","4","3",18.1,0,74,0,17,24.5,4,-1,-2,-3,4,3,1,-2
"3355",2019-03-14,"Brush Creek Trailhead","w1819","Motorized",0,"Thu","weekday","sled","4","4","3",18.1,0,74,0,17,24.5,4,-1,-2,-3,4,3,1,-2
"3356",2019-03-14,"Brush Creek Trailhead","w1819","Hybrid",0,"Thu","weekday","sled","4","4","3",18.1,0,74,0,17,24.5,4,-1,-2,-3,4,3,1,-2
"3357",2019-03-15,"Brush Creek Trailhead","w1819","Non.motorized",3,"Fri","weekday","no_sled","3","3","2",18.1,0,72,-2,18,25.1,0,4,-1,-2,-2,2,1,-1
"3358",2019-03-15,"Brush Creek Trailhead","w1819","Mechanized",0,"Fri","weekday","no_sled","3","3","2",18.1,0,72,-2,18,25.1,0,4,-1,-2,-2,2,1,-1
"3359",2019-03-15,"Brush Creek Trailhead","w1819","Motorized",0,"Fri","weekday","sled","3","3","2",18.1,0,72,-2,18,25.1,0,4,-1,-2,-2,2,1,-1
"3360",2019-03-15,"Brush Creek Trailhead","w1819","Hybrid",0,"Fri","weekday","sled","3","3","2",18.1,0,72,-2,18,25.1,0,4,-1,-2,-2,2,1,-1
"3361",2019-03-16,"Brush Creek Trailhead","w1819","Non.motorized",8,"Sat","weekend","no_sled","3","3","2",18.2,0.1,70,-2,26,26,-2,0,4,-1,-4,-4,0,-1
"3362",2019-03-16,"Brush Creek Trailhead","w1819","Mechanized",0,"Sat","weekend","no_sled","3","3","2",18.2,0.1,70,-2,26,26,-2,0,4,-1,-4,-4,0,-1
"3363",2019-03-16,"Brush Creek Trailhead","w1819","Motorized",0,"Sat","weekend","sled","3","3","2",18.2,0.1,70,-2,26,26,-2,0,4,-1,-4,-4,0,-1
"3364",2019-03-16,"Brush Creek Trailhead","w1819","Hybrid",0,"Sat","weekend","sled","3","3","2",18.2,0.1,70,-2,26,26,-2,0,4,-1,-4,-4,0,-1
"3365",2019-03-17,"Brush Creek Trailhead","w1819","Non.motorized",13,"Sun","weekend","no_sled","3","3","2",18.2,0,69,-1,28,26.4,-2,-2,0,4,-3,-5,-5,-1
"3366",2019-03-17,"Brush Creek Trailhead","w1819","Mechanized",0,"Sun","weekend","no_sled","3","3","2",18.2,0,69,-1,28,26.4,-2,-2,0,4,-3,-5,-5,-1
"3367",2019-03-17,"Brush Creek Trailhead","w1819","Motorized",0,"Sun","weekend","sled","3","3","2",18.2,0,69,-1,28,26.4,-2,-2,0,4,-3,-5,-5,-1
"3368",2019-03-17,"Brush Creek Trailhead","w1819","Hybrid",0,"Sun","weekend","sled","3","3","2",18.2,0,69,-1,28,26.4,-2,-2,0,4,-3,-5,-5,-1
"3369",2019-03-18,"Brush Creek Trailhead","w1819","Non.motorized",4,"Mon","weekday","no_sled","2","2","2",18.3,0.1,68,-1,29,26.9,-1,-2,-2,0,-2,-4,-6,-6
"3370",2019-03-18,"Brush Creek Trailhead","w1819","Mechanized",0,"Mon","weekday","no_sled","2","2","2",18.3,0.1,68,-1,29,26.9,-1,-2,-2,0,-2,-4,-6,-6
"3371",2019-03-18,"Brush Creek Trailhead","w1819","Motorized",0,"Mon","weekday","sled","2","2","2",18.3,0.1,68,-1,29,26.9,-1,-2,-2,0,-2,-4,-6,-6
"3372",2019-03-18,"Brush Creek Trailhead","w1819","Hybrid",0,"Mon","weekday","sled","2","2","2",18.3,0.1,68,-1,29,26.9,-1,-2,-2,0,-2,-4,-6,-6
"3373",2019-03-19,"Brush Creek Trailhead","w1819","Non.motorized",5,"Tue","weekday","no_sled","2","2","2",18.3,0,67,-1,28,27.3,-1,-1,-2,-2,-2,-3,-5,-7
"3374",2019-03-19,"Brush Creek Trailhead","w1819","Mechanized",0,"Tue","weekday","no_sled","2","2","2",18.3,0,67,-1,28,27.3,-1,-1,-2,-2,-2,-3,-5,-7
"3375",2019-03-19,"Brush Creek Trailhead","w1819","Motorized",0,"Tue","weekday","sled","2","2","2",18.3,0,67,-1,28,27.3,-1,-1,-2,-2,-2,-3,-5,-7
"3376",2019-03-19,"Brush Creek Trailhead","w1819","Hybrid",0,"Tue","weekday","sled","2","2","2",18.3,0,67,-1,28,27.3,-1,-1,-2,-2,-2,-3,-5,-7
"3377",2019-03-20,"Brush Creek Trailhead","w1819","Non.motorized",0,"Wed","weekday","no_sled","2","2","2",18.3,0,66,-1,30,27.7,-1,-1,-1,-2,-2,-3,-4,-6
"3378",2019-03-20,"Brush Creek Trailhead","w1819","Mechanized",0,"Wed","weekday","no_sled","2","2","2",18.3,0,66,-1,30,27.7,-1,-1,-1,-2,-2,-3,-4,-6
"3379",2019-03-20,"Brush Creek Trailhead","w1819","Motorized",0,"Wed","weekday","sled","2","2","2",18.3,0,66,-1,30,27.7,-1,-1,-1,-2,-2,-3,-4,-6
"3380",2019-03-20,"Brush Creek Trailhead","w1819","Hybrid",0,"Wed","weekday","sled","2","2","2",18.3,0,66,-1,30,27.7,-1,-1,-1,-2,-2,-3,-4,-6
"3381",2019-03-21,"Brush Creek Trailhead","w1819","Non.motorized",1,"Thu","weekday","no_sled","2","2","2",18.4,0.1,65,-1,33,28.3,-1,-1,-1,-1,-2,-3,-4,-5
"3382",2019-03-21,"Brush Creek Trailhead","w1819","Mechanized",0,"Thu","weekday","no_sled","2","2","2",18.4,0.1,65,-1,33,28.3,-1,-1,-1,-1,-2,-3,-4,-5
"3383",2019-03-21,"Brush Creek Trailhead","w1819","Motorized",0,"Thu","weekday","sled","2","2","2",18.4,0.1,65,-1,33,28.3,-1,-1,-1,-1,-2,-3,-4,-5
"3384",2019-03-21,"Brush Creek Trailhead","w1819","Hybrid",0,"Thu","weekday","sled","2","2","2",18.4,0.1,65,-1,33,28.3,-1,-1,-1,-1,-2,-3,-4,-5
"3385",2019-03-22,"Brush Creek Trailhead","w1819","Non.motorized",5,"Fri","weekday","no_sled","3","3","2",18.4,0,64,-1,28,28.8,-1,-1,-1,-1,-2,-3,-4,-5
"3386",2019-03-22,"Brush Creek Trailhead","w1819","Mechanized",0,"Fri","weekday","no_sled","3","3","2",18.4,0,64,-1,28,28.8,-1,-1,-1,-1,-2,-3,-4,-5
"3387",2019-03-22,"Brush Creek Trailhead","w1819","Motorized",1,"Fri","weekday","sled","3","3","2",18.4,0,64,-1,28,28.8,-1,-1,-1,-1,-2,-3,-4,-5
"3388",2019-03-22,"Brush Creek Trailhead","w1819","Hybrid",0,"Fri","weekday","sled","3","3","2",18.4,0,64,-1,28,28.8,-1,-1,-1,-1,-2,-3,-4,-5
"3389",2019-03-23,"Brush Creek Trailhead","w1819","Non.motorized",6,"Sat","weekend","no_sled","2","2","1",18.4,0,65,1,28,28.3,-1,-1,-1,-1,0,-1,-2,-3
"3390",2019-03-23,"Brush Creek Trailhead","w1819","Mechanized",0,"Sat","weekend","no_sled","2","2","1",18.4,0,65,1,28,28.3,-1,-1,-1,-1,0,-1,-2,-3
"3391",2019-03-23,"Brush Creek Trailhead","w1819","Motorized",0,"Sat","weekend","sled","2","2","1",18.4,0,65,1,28,28.3,-1,-1,-1,-1,0,-1,-2,-3
"3392",2019-03-23,"Brush Creek Trailhead","w1819","Hybrid",0,"Sat","weekend","sled","2","2","1",18.4,0,65,1,28,28.3,-1,-1,-1,-1,0,-1,-2,-3
"3393",2019-03-24,"Brush Creek Trailhead","w1819","Non.motorized",8,"Sun","weekend","no_sled","2","2","1",18.4,0,64,-1,29,28.8,1,-1,-1,-1,0,-1,-2,-3
"3394",2019-03-24,"Brush Creek Trailhead","w1819","Mechanized",0,"Sun","weekend","no_sled","2","2","1",18.4,0,64,-1,29,28.8,1,-1,-1,-1,0,-1,-2,-3
"3395",2019-03-24,"Brush Creek Trailhead","w1819","Motorized",0,"Sun","weekend","sled","2","2","1",18.4,0,64,-1,29,28.8,1,-1,-1,-1,0,-1,-2,-3
"3396",2019-03-24,"Brush Creek Trailhead","w1819","Hybrid",0,"Sun","weekend","sled","2","2","1",18.4,0,64,-1,29,28.8,1,-1,-1,-1,0,-1,-2,-3
"3397",2019-03-25,"Brush Creek Trailhead","w1819","Non.motorized",3,"Mon","weekday","no_sled","2","2","2",18.6,0.2,64,0,31,29.1,-1,1,-1,-1,-1,0,-1,-2
"3398",2019-03-25,"Brush Creek Trailhead","w1819","Mechanized",0,"Mon","weekday","no_sled","2","2","2",18.6,0.2,64,0,31,29.1,-1,1,-1,-1,-1,0,-1,-2
"3399",2019-03-25,"Brush Creek Trailhead","w1819","Motorized",0,"Mon","weekday","sled","2","2","2",18.6,0.2,64,0,31,29.1,-1,1,-1,-1,-1,0,-1,-2
"3400",2019-03-25,"Brush Creek Trailhead","w1819","Hybrid",0,"Mon","weekday","sled","2","2","2",18.6,0.2,64,0,31,29.1,-1,1,-1,-1,-1,0,-1,-2
"3401",2019-03-26,"Brush Creek Trailhead","w1819","Non.motorized",0,"Tue","weekday","no_sled","2","2","2",18.9,0.3,63,-1,36,30,0,-1,1,-1,-1,-2,-1,-2
"3402",2019-03-26,"Brush Creek Trailhead","w1819","Mechanized",0,"Tue","weekday","no_sled","2","2","2",18.9,0.3,63,-1,36,30,0,-1,1,-1,-1,-2,-1,-2
"3403",2019-03-26,"Brush Creek Trailhead","w1819","Motorized",0,"Tue","weekday","sled","2","2","2",18.9,0.3,63,-1,36,30,0,-1,1,-1,-1,-2,-1,-2
"3404",2019-03-26,"Brush Creek Trailhead","w1819","Hybrid",0,"Tue","weekday","sled","2","2","2",18.9,0.3,63,-1,36,30,0,-1,1,-1,-1,-2,-1,-2
"3405",2019-03-27,"Brush Creek Trailhead","w1819","Non.motorized",7,"Wed","weekday","no_sled","1","2","2",18.9,0,62,-1,42,30.5,-1,0,-1,1,-2,-2,-3,-2
"3406",2019-03-27,"Brush Creek Trailhead","w1819","Mechanized",0,"Wed","weekday","no_sled","1","2","2",18.9,0,62,-1,42,30.5,-1,0,-1,1,-2,-2,-3,-2
"3407",2019-03-27,"Brush Creek Trailhead","w1819","Motorized",0,"Wed","weekday","sled","1","2","2",18.9,0,62,-1,42,30.5,-1,0,-1,1,-2,-2,-3,-2
"3408",2019-03-27,"Brush Creek Trailhead","w1819","Hybrid",0,"Wed","weekday","sled","1","2","2",18.9,0,62,-1,42,30.5,-1,0,-1,1,-2,-2,-3,-2
"3409",2019-03-28,"Brush Creek Trailhead","w1819","Non.motorized",2,"Thu","weekday","no_sled","1","2","2",18.9,0,60,-2,40,31.5,-1,-1,0,-1,-3,-4,-4,-5
"3410",2019-03-28,"Brush Creek Trailhead","w1819","Mechanized",0,"Thu","weekday","no_sled","1","2","2",18.9,0,60,-2,40,31.5,-1,-1,0,-1,-3,-4,-4,-5
"3411",2019-03-28,"Brush Creek Trailhead","w1819","Motorized",0,"Thu","weekday","sled","1","2","2",18.9,0,60,-2,40,31.5,-1,-1,0,-1,-3,-4,-4,-5
"3412",2019-03-28,"Brush Creek Trailhead","w1819","Hybrid",0,"Thu","weekday","sled","1","2","2",18.9,0,60,-2,40,31.5,-1,-1,0,-1,-3,-4,-4,-5
"3413",2019-03-29,"Brush Creek Trailhead","w1819","Non.motorized",4,"Fri","weekday","no_sled","1","1","1",19,0.1,58,-2,26,32.8,-2,-1,-1,0,-4,-5,-6,-6
"3414",2019-03-29,"Brush Creek Trailhead","w1819","Mechanized",0,"Fri","weekday","no_sled","1","1","1",19,0.1,58,-2,26,32.8,-2,-1,-1,0,-4,-5,-6,-6
"3415",2019-03-29,"Brush Creek Trailhead","w1819","Motorized",0,"Fri","weekday","sled","1","1","1",19,0.1,58,-2,26,32.8,-2,-1,-1,0,-4,-5,-6,-6
"3416",2019-03-29,"Brush Creek Trailhead","w1819","Hybrid",0,"Fri","weekday","sled","1","1","1",19,0.1,58,-2,26,32.8,-2,-1,-1,0,-4,-5,-6,-6
"3417",2019-03-30,"Brush Creek Trailhead","w1819","Non.motorized",12,"Sat","weekend","no_sled","1","1","1",19.1,0.1,61,3,24,31.3,-2,-2,-1,-1,1,-1,-2,-3
"3418",2019-03-30,"Brush Creek Trailhead","w1819","Mechanized",0,"Sat","weekend","no_sled","1","1","1",19.1,0.1,61,3,24,31.3,-2,-2,-1,-1,1,-1,-2,-3
"3419",2019-03-30,"Brush Creek Trailhead","w1819","Motorized",0,"Sat","weekend","sled","1","1","1",19.1,0.1,61,3,24,31.3,-2,-2,-1,-1,1,-1,-2,-3
"3420",2019-03-30,"Brush Creek Trailhead","w1819","Hybrid",0,"Sat","weekend","sled","1","1","1",19.1,0.1,61,3,24,31.3,-2,-2,-1,-1,1,-1,-2,-3
"3421",2019-03-31,"Brush Creek Trailhead","w1819","Non.motorized",4,"Sun","weekend","no_sled","1","1","1",19.1,0,59,-2,24,32.4,3,-2,-2,-1,1,-1,-3,-4
"3422",2019-03-31,"Brush Creek Trailhead","w1819","Mechanized",0,"Sun","weekend","no_sled","1","1","1",19.1,0,59,-2,24,32.4,3,-2,-2,-1,1,-1,-3,-4
"3423",2019-03-31,"Brush Creek Trailhead","w1819","Motorized",0,"Sun","weekend","sled","1","1","1",19.1,0,59,-2,24,32.4,3,-2,-2,-1,1,-1,-3,-4
"3424",2019-03-31,"Brush Creek Trailhead","w1819","Hybrid",0,"Sun","weekend","sled","1","1","1",19.1,0,59,-2,24,32.4,3,-2,-2,-1,1,-1,-3,-4
"3425",2019-04-01,"Brush Creek Trailhead","w1819","Non.motorized",6,"Mon","weekday","no_sled","2","1","1",19.1,0,58,-1,29,32.9,-2,3,-2,-2,-3,0,-2,-4
"3426",2019-04-01,"Brush Creek Trailhead","w1819","Mechanized",0,"Mon","weekday","no_sled","2","1","1",19.1,0,58,-1,29,32.9,-2,3,-2,-2,-3,0,-2,-4
"3427",2019-04-01,"Brush Creek Trailhead","w1819","Motorized",2,"Mon","weekday","sled","2","1","1",19.1,0,58,-1,29,32.9,-2,3,-2,-2,-3,0,-2,-4
"3428",2019-04-01,"Brush Creek Trailhead","w1819","Hybrid",2,"Mon","weekday","sled","2","1","1",19.1,0,58,-1,29,32.9,-2,3,-2,-2,-3,0,-2,-4
"3429",2019-04-02,"Brush Creek Trailhead","w1819","Non.motorized",4,"Tue","weekday","no_sled","1","1","1",19.1,0,58,0,33,32.9,-1,-2,3,-2,-1,-3,0,-2
"3430",2019-04-02,"Brush Creek Trailhead","w1819","Mechanized",0,"Tue","weekday","no_sled","1","1","1",19.1,0,58,0,33,32.9,-1,-2,3,-2,-1,-3,0,-2
"3431",2019-04-02,"Brush Creek Trailhead","w1819","Motorized",0,"Tue","weekday","sled","1","1","1",19.1,0,58,0,33,32.9,-1,-2,3,-2,-1,-3,0,-2
"3432",2019-04-02,"Brush Creek Trailhead","w1819","Hybrid",0,"Tue","weekday","sled","1","1","1",19.1,0,58,0,33,32.9,-1,-2,3,-2,-1,-3,0,-2
"3433",2019-04-03,"Brush Creek Trailhead","w1819","Non.motorized",5,"Wed","weekday","no_sled","2","1","1",19.2,0.1,58,0,31,33.1,0,-1,-2,3,0,-1,-3,0
"3434",2019-04-03,"Brush Creek Trailhead","w1819","Mechanized",0,"Wed","weekday","no_sled","2","1","1",19.2,0.1,58,0,31,33.1,0,-1,-2,3,0,-1,-3,0
"3435",2019-04-03,"Brush Creek Trailhead","w1819","Motorized",0,"Wed","weekday","sled","2","1","1",19.2,0.1,58,0,31,33.1,0,-1,-2,3,0,-1,-3,0
"3436",2019-04-03,"Brush Creek Trailhead","w1819","Hybrid",0,"Wed","weekday","sled","2","1","1",19.2,0.1,58,0,31,33.1,0,-1,-2,3,0,-1,-3,0
"3437",2019-04-04,"Brush Creek Trailhead","w1819","Non.motorized",5,"Thu","weekday","no_sled","2","1","1",19.4,0.2,59,1,35,32.9,0,0,-1,-2,1,1,0,-2
"3438",2019-04-04,"Brush Creek Trailhead","w1819","Mechanized",0,"Thu","weekday","no_sled","2","1","1",19.4,0.2,59,1,35,32.9,0,0,-1,-2,1,1,0,-2
"3439",2019-04-04,"Brush Creek Trailhead","w1819","Motorized",0,"Thu","weekday","sled","2","1","1",19.4,0.2,59,1,35,32.9,0,0,-1,-2,1,1,0,-2
"3440",2019-04-04,"Brush Creek Trailhead","w1819","Hybrid",0,"Thu","weekday","sled","2","1","1",19.4,0.2,59,1,35,32.9,0,0,-1,-2,1,1,0,-2
"3441",2019-04-05,"Brush Creek Trailhead","w1819","Non.motorized",6,"Fri","weekday","no_sled","1","1","1",19.4,0,57,-2,38,34,1,0,0,-1,-1,-1,-1,-2
"3442",2019-04-05,"Brush Creek Trailhead","w1819","Mechanized",0,"Fri","weekday","no_sled","1","1","1",19.4,0,57,-2,38,34,1,0,0,-1,-1,-1,-1,-2
"3443",2019-04-05,"Brush Creek Trailhead","w1819","Motorized",0,"Fri","weekday","sled","1","1","1",19.4,0,57,-2,38,34,1,0,0,-1,-1,-1,-1,-2
"3444",2019-04-05,"Brush Creek Trailhead","w1819","Hybrid",0,"Fri","weekday","sled","1","1","1",19.4,0,57,-2,38,34,1,0,0,-1,-1,-1,-1,-2
"3445",2019-04-06,"Brush Creek Trailhead","w1819","Non.motorized",6,"Sat","weekend","no_sled","1","1","1",19.3,-0.1,57,0,35,33.9,-2,1,0,0,-2,-1,-1,-1
"3446",2019-04-06,"Brush Creek Trailhead","w1819","Mechanized",0,"Sat","weekend","no_sled","1","1","1",19.3,-0.1,57,0,35,33.9,-2,1,0,0,-2,-1,-1,-1
"3447",2019-04-06,"Brush Creek Trailhead","w1819","Motorized",1,"Sat","weekend","sled","1","1","1",19.3,-0.1,57,0,35,33.9,-2,1,0,0,-2,-1,-1,-1
"3448",2019-04-06,"Brush Creek Trailhead","w1819","Hybrid",1,"Sat","weekend","sled","1","1","1",19.3,-0.1,57,0,35,33.9,-2,1,0,0,-2,-1,-1,-1
"3449",2019-04-07,"Brush Creek Trailhead","w1819","Non.motorized",14,"Sun","weekend","no_sled","1","1","1",19.1,-0.2,57,0,37,33.5,0,-2,1,0,0,-2,-1,-1
"3450",2019-04-07,"Brush Creek Trailhead","w1819","Mechanized",0,"Sun","weekend","no_sled","1","1","1",19.1,-0.2,57,0,37,33.5,0,-2,1,0,0,-2,-1,-1
"3451",2019-04-07,"Brush Creek Trailhead","w1819","Motorized",1,"Sun","weekend","sled","1","1","1",19.1,-0.2,57,0,37,33.5,0,-2,1,0,0,-2,-1,-1
"3452",2019-04-07,"Brush Creek Trailhead","w1819","Hybrid",1,"Sun","weekend","sled","1","1","1",19.1,-0.2,57,0,37,33.5,0,-2,1,0,0,-2,-1,-1
"3453",2019-04-08,"Brush Creek Trailhead","w1819","Non.motorized",7,"Mon","weekday","no_sled","1","2","2",19.3,0.2,54,-3,41,35.7,0,0,-2,1,-3,-3,-5,-4
"3454",2019-04-08,"Brush Creek Trailhead","w1819","Mechanized",0,"Mon","weekday","no_sled","1","2","2",19.3,0.2,54,-3,41,35.7,0,0,-2,1,-3,-3,-5,-4
"3455",2019-04-08,"Brush Creek Trailhead","w1819","Motorized",3,"Mon","weekday","sled","1","2","2",19.3,0.2,54,-3,41,35.7,0,0,-2,1,-3,-3,-5,-4
"3456",2019-04-08,"Brush Creek Trailhead","w1819","Hybrid",2,"Mon","weekday","sled","1","2","2",19.3,0.2,54,-3,41,35.7,0,0,-2,1,-3,-3,-5,-4
"3457",2019-04-09,"Brush Creek Trailhead","w1819","Non.motorized",2,"Tue","weekday","no_sled","1","2","2",19.3,0,53,-1,43,36.4,-3,0,0,-2,-4,-4,-4,-6
"3458",2019-04-09,"Brush Creek Trailhead","w1819","Mechanized",0,"Tue","weekday","no_sled","1","2","2",19.3,0,53,-1,43,36.4,-3,0,0,-2,-4,-4,-4,-6
"3459",2019-04-09,"Brush Creek Trailhead","w1819","Motorized",0,"Tue","weekday","sled","1","2","2",19.3,0,53,-1,43,36.4,-3,0,0,-2,-4,-4,-4,-6
"3460",2019-04-09,"Brush Creek Trailhead","w1819","Hybrid",0,"Tue","weekday","sled","1","2","2",19.3,0,53,-1,43,36.4,-3,0,0,-2,-4,-4,-4,-6
"3461",2019-04-10,"Brush Creek Trailhead","w1819","Non.motorized",0,"Wed","weekday","no_sled","2","2","1",19,-0.3,51,-2,30,37.3,-1,-3,0,0,-3,-6,-6,-6
"3462",2019-04-10,"Brush Creek Trailhead","w1819","Mechanized",0,"Wed","weekday","no_sled","2","2","1",19,-0.3,51,-2,30,37.3,-1,-3,0,0,-3,-6,-6,-6
"3463",2019-04-10,"Brush Creek Trailhead","w1819","Motorized",0,"Wed","weekday","sled","2","2","1",19,-0.3,51,-2,30,37.3,-1,-3,0,0,-3,-6,-6,-6
"3464",2019-04-10,"Brush Creek Trailhead","w1819","Hybrid",0,"Wed","weekday","sled","2","2","1",19,-0.3,51,-2,30,37.3,-1,-3,0,0,-3,-6,-6,-6
"3465",2019-04-11,"Brush Creek Trailhead","w1819","Non.motorized",1,"Thu","weekday","no_sled","3","3","2",18.9,-0.1,53,2,20,35.7,-2,-1,-3,0,0,-1,-4,-4
"3466",2019-04-11,"Brush Creek Trailhead","w1819","Mechanized",0,"Thu","weekday","no_sled","3","3","2",18.9,-0.1,53,2,20,35.7,-2,-1,-3,0,0,-1,-4,-4
"3467",2019-04-11,"Brush Creek Trailhead","w1819","Motorized",0,"Thu","weekday","sled","3","3","2",18.9,-0.1,53,2,20,35.7,-2,-1,-3,0,0,-1,-4,-4
"3468",2019-04-11,"Brush Creek Trailhead","w1819","Hybrid",0,"Thu","weekday","sled","3","3","2",18.9,-0.1,53,2,20,35.7,-2,-1,-3,0,0,-1,-4,-4
"3469",2019-04-12,"Brush Creek Trailhead","w1819","Non.motorized",6,"Fri","weekday","no_sled","2","2","1",18.7,-0.2,53,0,24,35.3,2,-2,-1,-3,2,0,-1,-4
"3470",2019-04-12,"Brush Creek Trailhead","w1819","Mechanized",0,"Fri","weekday","no_sled","2","2","1",18.7,-0.2,53,0,24,35.3,2,-2,-1,-3,2,0,-1,-4
"3471",2019-04-12,"Brush Creek Trailhead","w1819","Motorized",0,"Fri","weekday","sled","2","2","1",18.7,-0.2,53,0,24,35.3,2,-2,-1,-3,2,0,-1,-4
"3472",2019-04-12,"Brush Creek Trailhead","w1819","Hybrid",0,"Fri","weekday","sled","2","2","1",18.7,-0.2,53,0,24,35.3,2,-2,-1,-3,2,0,-1,-4
"3473",2019-04-13,"Brush Creek Trailhead","w1819","Non.motorized",9,"Sat","weekend","no_sled","1","1","1",18.8,0.1,52,-1,27,36.2,0,2,-2,-1,-1,1,-1,-2
"3474",2019-04-13,"Brush Creek Trailhead","w1819","Mechanized",0,"Sat","weekend","no_sled","1","1","1",18.8,0.1,52,-1,27,36.2,0,2,-2,-1,-1,1,-1,-2
"3475",2019-04-13,"Brush Creek Trailhead","w1819","Motorized",0,"Sat","weekend","sled","1","1","1",18.8,0.1,52,-1,27,36.2,0,2,-2,-1,-1,1,-1,-2
"3476",2019-04-13,"Brush Creek Trailhead","w1819","Hybrid",0,"Sat","weekend","sled","1","1","1",18.8,0.1,52,-1,27,36.2,0,2,-2,-1,-1,1,-1,-2
"3477",2019-04-14,"Brush Creek Trailhead","w1819","Non.motorized",3,"Sun","weekend","no_sled","1","1","1",18.7,-0.1,51,-1,35,36.7,-1,0,2,-2,-2,-2,0,-2
"3478",2019-04-14,"Brush Creek Trailhead","w1819","Mechanized",1,"Sun","weekend","no_sled","1","1","1",18.7,-0.1,51,-1,35,36.7,-1,0,2,-2,-2,-2,0,-2
"3479",2019-04-14,"Brush Creek Trailhead","w1819","Motorized",0,"Sun","weekend","sled","1","1","1",18.7,-0.1,51,-1,35,36.7,-1,0,2,-2,-2,-2,0,-2
"3480",2019-04-14,"Brush Creek Trailhead","w1819","Hybrid",0,"Sun","weekend","sled","1","1","1",18.7,-0.1,51,-1,35,36.7,-1,0,2,-2,-2,-2,0,-2
"3481",2019-04-15,"Brush Creek Trailhead","w1819","Non.motorized",6,"Mon","weekday","no_sled",NA,NA,NA,18.6,-0.1,50,-1,41,37.2,-1,-1,0,2,-2,-3,-3,-1
"3482",2019-04-15,"Brush Creek Trailhead","w1819","Mechanized",0,"Mon","weekday","no_sled",NA,NA,NA,18.6,-0.1,50,-1,41,37.2,-1,-1,0,2,-2,-3,-3,-1
"3483",2019-04-15,"Brush Creek Trailhead","w1819","Motorized",0,"Mon","weekday","sled",NA,NA,NA,18.6,-0.1,50,-1,41,37.2,-1,-1,0,2,-2,-3,-3,-1
"3484",2019-04-15,"Brush Creek Trailhead","w1819","Hybrid",0,"Mon","weekday","sled",NA,NA,NA,18.6,-0.1,50,-1,41,37.2,-1,-1,0,2,-2,-3,-3,-1
"3485",2018-12-01,"Cement Creek","w1819","Non.motorized",0,"Sat","weekend","no_sled","3","3","2",3.3,0.2,19,1,16,17.4,0,0,0,0,1,1,1,1
"3486",2018-12-01,"Cement Creek","w1819","Mechanized",0,"Sat","weekend","no_sled","3","3","2",3.3,0.2,19,1,16,17.4,0,0,0,0,1,1,1,1
"3487",2018-12-01,"Cement Creek","w1819","Motorized",0,"Sat","weekend","sled","3","3","2",3.3,0.2,19,1,16,17.4,0,0,0,0,1,1,1,1
"3488",2018-12-01,"Cement Creek","w1819","Hybrid",0,"Sat","weekend","sled","3","3","2",3.3,0.2,19,1,16,17.4,0,0,0,0,1,1,1,1
"3489",2018-12-02,"Cement Creek","w1819","Non.motorized",0,"Sun","weekend","no_sled","3","3","3",3.3,0,20,1,14,16.5,1,0,0,0,2,2,2,2
"3490",2018-12-02,"Cement Creek","w1819","Mechanized",0,"Sun","weekend","no_sled","3","3","3",3.3,0,20,1,14,16.5,1,0,0,0,2,2,2,2
"3491",2018-12-02,"Cement Creek","w1819","Motorized",0,"Sun","weekend","sled","3","3","3",3.3,0,20,1,14,16.5,1,0,0,0,2,2,2,2
"3492",2018-12-02,"Cement Creek","w1819","Hybrid",0,"Sun","weekend","sled","3","3","3",3.3,0,20,1,14,16.5,1,0,0,0,2,2,2,2
"3493",2018-12-03,"Cement Creek","w1819","Non.motorized",0,"Mon","weekday","no_sled","3","3","2",3.4,0.1,19,-1,13,17.9,1,1,0,0,0,1,1,1
"3494",2018-12-03,"Cement Creek","w1819","Mechanized",0,"Mon","weekday","no_sled","3","3","2",3.4,0.1,19,-1,13,17.9,1,1,0,0,0,1,1,1
"3495",2018-12-03,"Cement Creek","w1819","Motorized",0,"Mon","weekday","sled","3","3","2",3.4,0.1,19,-1,13,17.9,1,1,0,0,0,1,1,1
"3496",2018-12-03,"Cement Creek","w1819","Hybrid",0,"Mon","weekday","sled","3","3","2",3.4,0.1,19,-1,13,17.9,1,1,0,0,0,1,1,1
"3497",2018-12-04,"Cement Creek","w1819","Non.motorized",0,"Tue","weekday","no_sled","3","3","2",3.5,0.1,20,1,8,17.5,-1,1,1,0,0,1,2,2
"3498",2018-12-04,"Cement Creek","w1819","Mechanized",0,"Tue","weekday","no_sled","3","3","2",3.5,0.1,20,1,8,17.5,-1,1,1,0,0,1,2,2
"3499",2018-12-04,"Cement Creek","w1819","Motorized",0,"Tue","weekday","sled","3","3","2",3.5,0.1,20,1,8,17.5,-1,1,1,0,0,1,2,2
"3500",2018-12-04,"Cement Creek","w1819","Hybrid",0,"Tue","weekday","sled","3","3","2",3.5,0.1,20,1,8,17.5,-1,1,1,0,0,1,2,2
"3501",2018-12-05,"Cement Creek","w1819","Non.motorized",17,"Wed","weekday","no_sled","3","3","2",3.5,0,19,-1,21,18.4,1,-1,1,1,0,-1,0,1
"3502",2018-12-05,"Cement Creek","w1819","Mechanized",0,"Wed","weekday","no_sled","3","3","2",3.5,0,19,-1,21,18.4,1,-1,1,1,0,-1,0,1
"3503",2018-12-05,"Cement Creek","w1819","Motorized",1,"Wed","weekday","sled","3","3","2",3.5,0,19,-1,21,18.4,1,-1,1,1,0,-1,0,1
"3504",2018-12-05,"Cement Creek","w1819","Hybrid",0,"Wed","weekday","sled","3","3","2",3.5,0,19,-1,21,18.4,1,-1,1,1,0,-1,0,1
"3505",2018-12-06,"Cement Creek","w1819","Non.motorized",3,"Thu","weekday","no_sled","2","2","2",3.7,0.2,18,-1,25,20.6,-1,1,-1,1,-2,-1,-2,-1
"3506",2018-12-06,"Cement Creek","w1819","Mechanized",0,"Thu","weekday","no_sled","2","2","2",3.7,0.2,18,-1,25,20.6,-1,1,-1,1,-2,-1,-2,-1
"3507",2018-12-06,"Cement Creek","w1819","Motorized",4,"Thu","weekday","sled","2","2","2",3.7,0.2,18,-1,25,20.6,-1,1,-1,1,-2,-1,-2,-1
"3508",2018-12-06,"Cement Creek","w1819","Hybrid",0,"Thu","weekday","sled","2","2","2",3.7,0.2,18,-1,25,20.6,-1,1,-1,1,-2,-1,-2,-1
"3509",2018-12-07,"Cement Creek","w1819","Non.motorized",6,"Fri","weekday","no_sled","2","2","2",3.8,0.1,21,3,23,18.1,-1,-1,1,-1,2,1,2,1
"3510",2018-12-07,"Cement Creek","w1819","Mechanized",4,"Fri","weekday","no_sled","2","2","2",3.8,0.1,21,3,23,18.1,-1,-1,1,-1,2,1,2,1
"3511",2018-12-07,"Cement Creek","w1819","Motorized",5,"Fri","weekday","sled","2","2","2",3.8,0.1,21,3,23,18.1,-1,-1,1,-1,2,1,2,1
"3512",2018-12-07,"Cement Creek","w1819","Hybrid",0,"Fri","weekday","sled","2","2","2",3.8,0.1,21,3,23,18.1,-1,-1,1,-1,2,1,2,1
"3513",2018-12-08,"Cement Creek","w1819","Non.motorized",20,"Sat","weekend","no_sled","2","2","2",3.8,0,20,-1,23,19,3,-1,-1,1,2,1,0,1
"3514",2018-12-08,"Cement Creek","w1819","Mechanized",3,"Sat","weekend","no_sled","2","2","2",3.8,0,20,-1,23,19,3,-1,-1,1,2,1,0,1
"3515",2018-12-08,"Cement Creek","w1819","Motorized",15,"Sat","weekend","sled","2","2","2",3.8,0,20,-1,23,19,3,-1,-1,1,2,1,0,1
"3516",2018-12-08,"Cement Creek","w1819","Hybrid",0,"Sat","weekend","sled","2","2","2",3.8,0,20,-1,23,19,3,-1,-1,1,2,1,0,1
"3517",2018-12-09,"Cement Creek","w1819","Non.motorized",32,"Sun","weekend","no_sled","2","2","2",3.8,0,20,0,19,19,-1,3,-1,-1,-1,2,1,0
"3518",2018-12-09,"Cement Creek","w1819","Mechanized",3,"Sun","weekend","no_sled","2","2","2",3.8,0,20,0,19,19,-1,3,-1,-1,-1,2,1,0
"3519",2018-12-09,"Cement Creek","w1819","Motorized",10,"Sun","weekend","sled","2","2","2",3.8,0,20,0,19,19,-1,3,-1,-1,-1,2,1,0
"3520",2018-12-09,"Cement Creek","w1819","Hybrid",2,"Sun","weekend","sled","2","2","2",3.8,0,20,0,19,19,-1,3,-1,-1,-1,2,1,0
"3521",2018-12-10,"Cement Creek","w1819","Non.motorized",10,"Mon","weekday","no_sled","2","2","2",3.8,0,20,0,21,19,0,-1,3,-1,0,-1,2,1
"3522",2018-12-10,"Cement Creek","w1819","Mechanized",0,"Mon","weekday","no_sled","2","2","2",3.8,0,20,0,21,19,0,-1,3,-1,0,-1,2,1
"3523",2018-12-10,"Cement Creek","w1819","Motorized",7,"Mon","weekday","sled","2","2","2",3.8,0,20,0,21,19,0,-1,3,-1,0,-1,2,1
"3524",2018-12-10,"Cement Creek","w1819","Hybrid",0,"Mon","weekday","sled","2","2","2",3.8,0,20,0,21,19,0,-1,3,-1,0,-1,2,1
"3525",2018-12-11,"Cement Creek","w1819","Non.motorized",10,"Tue","weekday","no_sled","2","2","2",3.9,0.1,19,-1,27,20.5,0,0,-1,3,-1,-1,-2,1
"3526",2018-12-11,"Cement Creek","w1819","Mechanized",0,"Tue","weekday","no_sled","2","2","2",3.9,0.1,19,-1,27,20.5,0,0,-1,3,-1,-1,-2,1
"3527",2018-12-11,"Cement Creek","w1819","Motorized",2,"Tue","weekday","sled","2","2","2",3.9,0.1,19,-1,27,20.5,0,0,-1,3,-1,-1,-2,1
"3528",2018-12-11,"Cement Creek","w1819","Hybrid",0,"Tue","weekday","sled","2","2","2",3.9,0.1,19,-1,27,20.5,0,0,-1,3,-1,-1,-2,1
"3529",2018-12-12,"Cement Creek","w1819","Non.motorized",20,"Wed","weekday","no_sled","2","2","1",3.9,0,19,0,21,20.5,-1,0,0,-1,-1,-1,-1,-2
"3530",2018-12-12,"Cement Creek","w1819","Mechanized",1,"Wed","weekday","no_sled","2","2","1",3.9,0,19,0,21,20.5,-1,0,0,-1,-1,-1,-1,-2
"3531",2018-12-12,"Cement Creek","w1819","Motorized",2,"Wed","weekday","sled","2","2","1",3.9,0,19,0,21,20.5,-1,0,0,-1,-1,-1,-1,-2
"3532",2018-12-12,"Cement Creek","w1819","Hybrid",0,"Wed","weekday","sled","2","2","1",3.9,0,19,0,21,20.5,-1,0,0,-1,-1,-1,-1,-2
"3533",2018-12-13,"Cement Creek","w1819","Non.motorized",7,"Thu","weekday","no_sled","3","3","2",4,0.1,21,2,15,19,0,-1,0,0,2,1,1,1
"3534",2018-12-13,"Cement Creek","w1819","Mechanized",0,"Thu","weekday","no_sled","3","3","2",4,0.1,21,2,15,19,0,-1,0,0,2,1,1,1
"3535",2018-12-13,"Cement Creek","w1819","Motorized",5,"Thu","weekday","sled","3","3","2",4,0.1,21,2,15,19,0,-1,0,0,2,1,1,1
"3536",2018-12-13,"Cement Creek","w1819","Hybrid",0,"Thu","weekday","sled","3","3","2",4,0.1,21,2,15,19,0,-1,0,0,2,1,1,1
"3537",2018-12-14,"Cement Creek","w1819","Non.motorized",3,"Fri","weekday","no_sled","3","3","2",4,0,20,-1,24,20,2,0,-1,0,1,1,0,0
"3538",2018-12-14,"Cement Creek","w1819","Mechanized",0,"Fri","weekday","no_sled","3","3","2",4,0,20,-1,24,20,2,0,-1,0,1,1,0,0
"3539",2018-12-14,"Cement Creek","w1819","Motorized",3,"Fri","weekday","sled","3","3","2",4,0,20,-1,24,20,2,0,-1,0,1,1,0,0
"3540",2018-12-14,"Cement Creek","w1819","Hybrid",0,"Fri","weekday","sled","3","3","2",4,0,20,-1,24,20,2,0,-1,0,1,1,0,0
"3541",2018-12-15,"Cement Creek","w1819","Non.motorized",45,"Sat","weekend","no_sled","2","2","2",4,0,20,0,29,20,-1,2,0,-1,-1,1,1,0
"3542",2018-12-15,"Cement Creek","w1819","Mechanized",1,"Sat","weekend","no_sled","2","2","2",4,0,20,0,29,20,-1,2,0,-1,-1,1,1,0
"3543",2018-12-15,"Cement Creek","w1819","Motorized",6,"Sat","weekend","sled","2","2","2",4,0,20,0,29,20,-1,2,0,-1,-1,1,1,0
"3544",2018-12-15,"Cement Creek","w1819","Hybrid",0,"Sat","weekend","sled","2","2","2",4,0,20,0,29,20,-1,2,0,-1,-1,1,1,0
"3545",2018-12-16,"Cement Creek","w1819","Non.motorized",12,"Sun","weekend","no_sled","2","2","2",4.1,0.1,19,-1,28,21.6,0,-1,2,0,-1,-2,0,0
"3546",2018-12-16,"Cement Creek","w1819","Mechanized",1,"Sun","weekend","no_sled","2","2","2",4.1,0.1,19,-1,28,21.6,0,-1,2,0,-1,-2,0,0
"3547",2018-12-16,"Cement Creek","w1819","Motorized",9,"Sun","weekend","sled","2","2","2",4.1,0.1,19,-1,28,21.6,0,-1,2,0,-1,-2,0,0
"3548",2018-12-16,"Cement Creek","w1819","Hybrid",0,"Sun","weekend","sled","2","2","2",4.1,0.1,19,-1,28,21.6,0,-1,2,0,-1,-2,0,0
"3549",2018-12-17,"Cement Creek","w1819","Non.motorized",4,"Mon","weekday","no_sled","2","2","2",4.1,0,19,0,29,21.6,-1,0,-1,2,-1,-1,-2,0
"3550",2018-12-17,"Cement Creek","w1819","Mechanized",3,"Mon","weekday","no_sled","2","2","2",4.1,0,19,0,29,21.6,-1,0,-1,2,-1,-1,-2,0
"3551",2018-12-17,"Cement Creek","w1819","Motorized",9,"Mon","weekday","sled","2","2","2",4.1,0,19,0,29,21.6,-1,0,-1,2,-1,-1,-2,0
"3552",2018-12-17,"Cement Creek","w1819","Hybrid",0,"Mon","weekday","sled","2","2","2",4.1,0,19,0,29,21.6,-1,0,-1,2,-1,-1,-2,0
"3553",2018-12-18,"Cement Creek","w1819","Non.motorized",10,"Tue","weekday","no_sled","2","2","2",4.1,0,19,0,27,21.6,0,-1,0,-1,0,-1,-1,-2
"3554",2018-12-18,"Cement Creek","w1819","Mechanized",1,"Tue","weekday","no_sled","2","2","2",4.1,0,19,0,27,21.6,0,-1,0,-1,0,-1,-1,-2
"3555",2018-12-18,"Cement Creek","w1819","Motorized",5,"Tue","weekday","sled","2","2","2",4.1,0,19,0,27,21.6,0,-1,0,-1,0,-1,-1,-2
"3556",2018-12-18,"Cement Creek","w1819","Hybrid",0,"Tue","weekday","sled","2","2","2",4.1,0,19,0,27,21.6,0,-1,0,-1,0,-1,-1,-2
"3557",2018-12-19,"Cement Creek","w1819","Non.motorized",9,"Wed","weekday","no_sled","2","2","2",4.1,0,19,0,24,21.6,0,0,-1,0,0,0,-1,-1
"3558",2018-12-19,"Cement Creek","w1819","Mechanized",0,"Wed","weekday","no_sled","2","2","2",4.1,0,19,0,24,21.6,0,0,-1,0,0,0,-1,-1
"3559",2018-12-19,"Cement Creek","w1819","Motorized",1,"Wed","weekday","sled","2","2","2",4.1,0,19,0,24,21.6,0,0,-1,0,0,0,-1,-1
"3560",2018-12-19,"Cement Creek","w1819","Hybrid",0,"Wed","weekday","sled","2","2","2",4.1,0,19,0,24,21.6,0,0,-1,0,0,0,-1,-1
"3561",2018-12-20,"Cement Creek","w1819","Non.motorized",14,"Thu","weekday","no_sled","2","2","1",4.1,0,20,1,25,20.5,0,0,0,-1,1,1,1,0
"3562",2018-12-20,"Cement Creek","w1819","Mechanized",2,"Thu","weekday","no_sled","2","2","1",4.1,0,20,1,25,20.5,0,0,0,-1,1,1,1,0
"3563",2018-12-20,"Cement Creek","w1819","Motorized",10,"Thu","weekday","sled","2","2","1",4.1,0,20,1,25,20.5,0,0,0,-1,1,1,1,0
"3564",2018-12-20,"Cement Creek","w1819","Hybrid",0,"Thu","weekday","sled","2","2","1",4.1,0,20,1,25,20.5,0,0,0,-1,1,1,1,0
"3565",2018-12-21,"Cement Creek","w1819","Non.motorized",14,"Fri","weekday","no_sled","2","2","1",4.1,0,19,-1,28,21.6,1,0,0,0,0,0,0,0
"3566",2018-12-21,"Cement Creek","w1819","Mechanized",1,"Fri","weekday","no_sled","2","2","1",4.1,0,19,-1,28,21.6,1,0,0,0,0,0,0,0
"3567",2018-12-21,"Cement Creek","w1819","Motorized",8,"Fri","weekday","sled","2","2","1",4.1,0,19,-1,28,21.6,1,0,0,0,0,0,0,0
"3568",2018-12-21,"Cement Creek","w1819","Hybrid",0,"Fri","weekday","sled","2","2","1",4.1,0,19,-1,28,21.6,1,0,0,0,0,0,0,0
"3569",2018-12-22,"Cement Creek","w1819","Non.motorized",10,"Sat","weekend","no_sled","2","2","1",4.2,0.1,19,0,20,22.1,-1,1,0,0,-1,0,0,0
"3570",2018-12-22,"Cement Creek","w1819","Mechanized",1,"Sat","weekend","no_sled","2","2","1",4.2,0.1,19,0,20,22.1,-1,1,0,0,-1,0,0,0
"3571",2018-12-22,"Cement Creek","w1819","Motorized",7,"Sat","weekend","sled","2","2","1",4.2,0.1,19,0,20,22.1,-1,1,0,0,-1,0,0,0
"3572",2018-12-22,"Cement Creek","w1819","Hybrid",0,"Sat","weekend","sled","2","2","1",4.2,0.1,19,0,20,22.1,-1,1,0,0,-1,0,0,0
"3573",2018-12-23,"Cement Creek","w1819","Non.motorized",67,"Sun","weekend","no_sled","2","2","1",4.2,0,21,2,19,20,0,-1,1,0,2,1,2,2
"3574",2018-12-23,"Cement Creek","w1819","Mechanized",4,"Sun","weekend","no_sled","2","2","1",4.2,0,21,2,19,20,0,-1,1,0,2,1,2,2
"3575",2018-12-23,"Cement Creek","w1819","Motorized",6,"Sun","weekend","sled","2","2","1",4.2,0,21,2,19,20,0,-1,1,0,2,1,2,2
"3576",2018-12-23,"Cement Creek","w1819","Hybrid",0,"Sun","weekend","sled","2","2","1",4.2,0,21,2,19,20,0,-1,1,0,2,1,2,2
"3577",2018-12-24,"Cement Creek","w1819","Non.motorized",23,"Mon","weekday","no_sled","2","2","2",4.3,0.1,20,-1,21,21.5,2,0,-1,1,1,1,0,1
"3578",2018-12-24,"Cement Creek","w1819","Mechanized",0,"Mon","weekday","no_sled","2","2","2",4.3,0.1,20,-1,21,21.5,2,0,-1,1,1,1,0,1
"3579",2018-12-24,"Cement Creek","w1819","Motorized",5,"Mon","weekday","sled","2","2","2",4.3,0.1,20,-1,21,21.5,2,0,-1,1,1,1,0,1
"3580",2018-12-24,"Cement Creek","w1819","Hybrid",0,"Mon","weekday","sled","2","2","2",4.3,0.1,20,-1,21,21.5,2,0,-1,1,1,1,0,1
"3581",2018-12-25,"Cement Creek","w1819","Non.motorized",40,"Tue","weekday","no_sled","2","2","2",4.7,0.4,25,5,25,18.8,-1,2,0,-1,4,6,6,5
"3582",2018-12-25,"Cement Creek","w1819","Mechanized",0,"Tue","weekday","no_sled","2","2","2",4.7,0.4,25,5,25,18.8,-1,2,0,-1,4,6,6,5
"3583",2018-12-25,"Cement Creek","w1819","Motorized",13,"Tue","weekday","sled","2","2","2",4.7,0.4,25,5,25,18.8,-1,2,0,-1,4,6,6,5
"3584",2018-12-25,"Cement Creek","w1819","Hybrid",0,"Tue","weekday","sled","2","2","2",4.7,0.4,25,5,25,18.8,-1,2,0,-1,4,6,6,5
"3585",2018-12-26,"Cement Creek","w1819","Non.motorized",24,"Wed","weekday","no_sled","3","3","3",4.7,0,23,-2,24,20.4,5,-1,2,0,3,2,4,4
"3586",2018-12-26,"Cement Creek","w1819","Mechanized",2,"Wed","weekday","no_sled","3","3","3",4.7,0,23,-2,24,20.4,5,-1,2,0,3,2,4,4
"3587",2018-12-26,"Cement Creek","w1819","Motorized",8,"Wed","weekday","sled","3","3","3",4.7,0,23,-2,24,20.4,5,-1,2,0,3,2,4,4
"3588",2018-12-26,"Cement Creek","w1819","Hybrid",0,"Wed","weekday","sled","3","3","3",4.7,0,23,-2,24,20.4,5,-1,2,0,3,2,4,4
"3589",2018-12-27,"Cement Creek","w1819","Non.motorized",26,"Thu","weekday","no_sled","3","3","2",4.7,0,24,1,12,19.6,-2,5,-1,2,-1,4,3,5
"3590",2018-12-27,"Cement Creek","w1819","Mechanized",0,"Thu","weekday","no_sled","3","3","2",4.7,0,24,1,12,19.6,-2,5,-1,2,-1,4,3,5
"3591",2018-12-27,"Cement Creek","w1819","Motorized",8,"Thu","weekday","sled","3","3","2",4.7,0,24,1,12,19.6,-2,5,-1,2,-1,4,3,5
"3592",2018-12-27,"Cement Creek","w1819","Hybrid",0,"Thu","weekday","sled","3","3","2",4.7,0,24,1,12,19.6,-2,5,-1,2,-1,4,3,5
"3593",2018-12-28,"Cement Creek","w1819","Non.motorized",38,"Fri","weekday","no_sled","3","3","2",4.7,0,24,0,12,19.6,1,-2,5,-1,1,-1,4,3
"3594",2018-12-28,"Cement Creek","w1819","Mechanized",4,"Fri","weekday","no_sled","3","3","2",4.7,0,24,0,12,19.6,1,-2,5,-1,1,-1,4,3
"3595",2018-12-28,"Cement Creek","w1819","Motorized",13,"Fri","weekday","sled","3","3","2",4.7,0,24,0,12,19.6,1,-2,5,-1,1,-1,4,3
"3596",2018-12-28,"Cement Creek","w1819","Hybrid",3,"Fri","weekday","sled","3","3","2",4.7,0,24,0,12,19.6,1,-2,5,-1,1,-1,4,3
"3597",2018-12-29,"Cement Creek","w1819","Non.motorized",39,"Sat","weekend","no_sled","3","3","2",4.7,0,24,0,8,19.6,0,1,-2,5,0,1,-1,4
"3598",2018-12-29,"Cement Creek","w1819","Mechanized",3,"Sat","weekend","no_sled","3","3","2",4.7,0,24,0,8,19.6,0,1,-2,5,0,1,-1,4
"3599",2018-12-29,"Cement Creek","w1819","Motorized",9,"Sat","weekend","sled","3","3","2",4.7,0,24,0,8,19.6,0,1,-2,5,0,1,-1,4
"3600",2018-12-29,"Cement Creek","w1819","Hybrid",2,"Sat","weekend","sled","3","3","2",4.7,0,24,0,8,19.6,0,1,-2,5,0,1,-1,4
"3601",2018-12-30,"Cement Creek","w1819","Non.motorized",29,"Sun","weekend","no_sled","3","3","2",4.7,0,24,0,16,19.6,0,0,1,-2,0,0,1,-1
"3602",2018-12-30,"Cement Creek","w1819","Mechanized",2,"Sun","weekend","no_sled","3","3","2",4.7,0,24,0,16,19.6,0,0,1,-2,0,0,1,-1
"3603",2018-12-30,"Cement Creek","w1819","Motorized",9,"Sun","weekend","sled","3","3","2",4.7,0,24,0,16,19.6,0,0,1,-2,0,0,1,-1
"3604",2018-12-30,"Cement Creek","w1819","Hybrid",0,"Sun","weekend","sled","3","3","2",4.7,0,24,0,16,19.6,0,0,1,-2,0,0,1,-1
"3605",2018-12-31,"Cement Creek","w1819","Non.motorized",33,"Mon","weekday","no_sled","3","3","3",4.9,0.2,23,-1,14,21.3,0,0,0,1,-1,-1,-1,0
"3606",2018-12-31,"Cement Creek","w1819","Mechanized",0,"Mon","weekday","no_sled","3","3","3",4.9,0.2,23,-1,14,21.3,0,0,0,1,-1,-1,-1,0
"3607",2018-12-31,"Cement Creek","w1819","Motorized",11,"Mon","weekday","sled","3","3","3",4.9,0.2,23,-1,14,21.3,0,0,0,1,-1,-1,-1,0
"3608",2018-12-31,"Cement Creek","w1819","Hybrid",0,"Mon","weekday","sled","3","3","3",4.9,0.2,23,-1,14,21.3,0,0,0,1,-1,-1,-1,0
"3609",2019-01-01,"Cement Creek","w1819","Non.motorized",20,"Tue","weekday","no_sled","3","3","3",5.1,0.2,29,6,11,17.6,-1,0,0,0,5,5,5,5
"3610",2019-01-01,"Cement Creek","w1819","Mechanized",1,"Tue","weekday","no_sled","3","3","3",5.1,0.2,29,6,11,17.6,-1,0,0,0,5,5,5,5
"3611",2019-01-01,"Cement Creek","w1819","Motorized",2,"Tue","weekday","sled","3","3","3",5.1,0.2,29,6,11,17.6,-1,0,0,0,5,5,5,5
"3612",2019-01-01,"Cement Creek","w1819","Hybrid",0,"Tue","weekday","sled","3","3","3",5.1,0.2,29,6,11,17.6,-1,0,0,0,5,5,5,5
"3613",2019-01-02,"Cement Creek","w1819","Non.motorized",13,"Wed","weekday","no_sled","3","3","2",5.1,0,28,-1,10,18.2,6,-1,0,0,5,4,4,4
"3614",2019-01-02,"Cement Creek","w1819","Mechanized",0,"Wed","weekday","no_sled","3","3","2",5.1,0,28,-1,10,18.2,6,-1,0,0,5,4,4,4
"3615",2019-01-02,"Cement Creek","w1819","Motorized",3,"Wed","weekday","sled","3","3","2",5.1,0,28,-1,10,18.2,6,-1,0,0,5,4,4,4
"3616",2019-01-02,"Cement Creek","w1819","Hybrid",0,"Wed","weekday","sled","3","3","2",5.1,0,28,-1,10,18.2,6,-1,0,0,5,4,4,4
"3617",2019-01-03,"Cement Creek","w1819","Non.motorized",19,"Thu","weekday","no_sled","3","3","2",5.1,0,27,-1,22,18.9,-1,6,-1,0,-2,4,3,3
"3618",2019-01-03,"Cement Creek","w1819","Mechanized",1,"Thu","weekday","no_sled","3","3","2",5.1,0,27,-1,22,18.9,-1,6,-1,0,-2,4,3,3
"3619",2019-01-03,"Cement Creek","w1819","Motorized",2,"Thu","weekday","sled","3","3","2",5.1,0,27,-1,22,18.9,-1,6,-1,0,-2,4,3,3
"3620",2019-01-03,"Cement Creek","w1819","Hybrid",0,"Thu","weekday","sled","3","3","2",5.1,0,27,-1,22,18.9,-1,6,-1,0,-2,4,3,3
"3621",2019-01-04,"Cement Creek","w1819","Non.motorized",30,"Fri","weekday","no_sled","3","3","2",5.3,0.2,26,-1,29,20.4,-1,-1,6,-1,-2,-3,3,2
"3622",2019-01-04,"Cement Creek","w1819","Mechanized",5,"Fri","weekday","no_sled","3","3","2",5.3,0.2,26,-1,29,20.4,-1,-1,6,-1,-2,-3,3,2
"3623",2019-01-04,"Cement Creek","w1819","Motorized",8,"Fri","weekday","sled","3","3","2",5.3,0.2,26,-1,29,20.4,-1,-1,6,-1,-2,-3,3,2
"3624",2019-01-04,"Cement Creek","w1819","Hybrid",0,"Fri","weekday","sled","3","3","2",5.3,0.2,26,-1,29,20.4,-1,-1,6,-1,-2,-3,3,2
"3625",2019-01-05,"Cement Creek","w1819","Non.motorized",32,"Sat","weekend","no_sled","2","2","2",5.3,0,25,-1,30,21.2,-1,-1,-1,6,-2,-3,-4,2
"3626",2019-01-05,"Cement Creek","w1819","Mechanized",0,"Sat","weekend","no_sled","2","2","2",5.3,0,25,-1,30,21.2,-1,-1,-1,6,-2,-3,-4,2
"3627",2019-01-05,"Cement Creek","w1819","Motorized",6,"Sat","weekend","sled","2","2","2",5.3,0,25,-1,30,21.2,-1,-1,-1,6,-2,-3,-4,2
"3628",2019-01-05,"Cement Creek","w1819","Hybrid",0,"Sat","weekend","sled","2","2","2",5.3,0,25,-1,30,21.2,-1,-1,-1,6,-2,-3,-4,2
"3629",2019-01-06,"Cement Creek","w1819","Non.motorized",22,"Sun","weekend","no_sled","3","3","3",5.3,0,25,0,26,21.2,-1,-1,-1,-1,-1,-2,-3,-4
"3630",2019-01-06,"Cement Creek","w1819","Mechanized",0,"Sun","weekend","no_sled","3","3","3",5.3,0,25,0,26,21.2,-1,-1,-1,-1,-1,-2,-3,-4
"3631",2019-01-06,"Cement Creek","w1819","Motorized",2,"Sun","weekend","sled","3","3","3",5.3,0,25,0,26,21.2,-1,-1,-1,-1,-1,-2,-3,-4
"3632",2019-01-06,"Cement Creek","w1819","Hybrid",0,"Sun","weekend","sled","3","3","3",5.3,0,25,0,26,21.2,-1,-1,-1,-1,-1,-2,-3,-4
"3633",2019-01-07,"Cement Creek","w1819","Non.motorized",7,"Mon","weekday","no_sled","3","3","3",5.8,0.5,32,7,21,18.1,0,-1,-1,-1,7,6,5,4
"3634",2019-01-07,"Cement Creek","w1819","Mechanized",0,"Mon","weekday","no_sled","3","3","3",5.8,0.5,32,7,21,18.1,0,-1,-1,-1,7,6,5,4
"3635",2019-01-07,"Cement Creek","w1819","Motorized",2,"Mon","weekday","sled","3","3","3",5.8,0.5,32,7,21,18.1,0,-1,-1,-1,7,6,5,4
"3636",2019-01-07,"Cement Creek","w1819","Hybrid",0,"Mon","weekday","sled","3","3","3",5.8,0.5,32,7,21,18.1,0,-1,-1,-1,7,6,5,4
"3637",2019-01-08,"Cement Creek","w1819","Non.motorized",9,"Tue","weekday","no_sled","3","3","3",5.9,0.1,32,0,24,18.4,7,0,-1,-1,7,7,6,5
"3638",2019-01-08,"Cement Creek","w1819","Mechanized",0,"Tue","weekday","no_sled","3","3","3",5.9,0.1,32,0,24,18.4,7,0,-1,-1,7,7,6,5
"3639",2019-01-08,"Cement Creek","w1819","Motorized",3,"Tue","weekday","sled","3","3","3",5.9,0.1,32,0,24,18.4,7,0,-1,-1,7,7,6,5
"3640",2019-01-08,"Cement Creek","w1819","Hybrid",0,"Tue","weekday","sled","3","3","3",5.9,0.1,32,0,24,18.4,7,0,-1,-1,7,7,6,5
"3641",2019-01-09,"Cement Creek","w1819","Non.motorized",8,"Wed","weekday","no_sled","3","3","3",6,0.1,30,-2,29,20,0,7,0,-1,-2,5,5,4
"3642",2019-01-09,"Cement Creek","w1819","Mechanized",3,"Wed","weekday","no_sled","3","3","3",6,0.1,30,-2,29,20,0,7,0,-1,-2,5,5,4
"3643",2019-01-09,"Cement Creek","w1819","Motorized",1,"Wed","weekday","sled","3","3","3",6,0.1,30,-2,29,20,0,7,0,-1,-2,5,5,4
"3644",2019-01-09,"Cement Creek","w1819","Hybrid",0,"Wed","weekday","sled","3","3","3",6,0.1,30,-2,29,20,0,7,0,-1,-2,5,5,4
"3645",2019-01-10,"Cement Creek","w1819","Non.motorized",10,"Thu","weekday","no_sled","3","3","3",6,0,29,-1,29,20.7,-2,0,7,0,-3,-3,4,4
"3646",2019-01-10,"Cement Creek","w1819","Mechanized",0,"Thu","weekday","no_sled","3","3","3",6,0,29,-1,29,20.7,-2,0,7,0,-3,-3,4,4
"3647",2019-01-10,"Cement Creek","w1819","Motorized",2,"Thu","weekday","sled","3","3","3",6,0,29,-1,29,20.7,-2,0,7,0,-3,-3,4,4
"3648",2019-01-10,"Cement Creek","w1819","Hybrid",0,"Thu","weekday","sled","3","3","3",6,0,29,-1,29,20.7,-2,0,7,0,-3,-3,4,4
"3649",2019-01-11,"Cement Creek","w1819","Non.motorized",18,"Fri","weekday","no_sled","2","2","2",6.1,0.1,29,0,25,21,-1,-2,0,7,-1,-3,-3,4
"3650",2019-01-11,"Cement Creek","w1819","Mechanized",2,"Fri","weekday","no_sled","2","2","2",6.1,0.1,29,0,25,21,-1,-2,0,7,-1,-3,-3,4
"3651",2019-01-11,"Cement Creek","w1819","Motorized",6,"Fri","weekday","sled","2","2","2",6.1,0.1,29,0,25,21,-1,-2,0,7,-1,-3,-3,4
"3652",2019-01-11,"Cement Creek","w1819","Hybrid",0,"Fri","weekday","sled","2","2","2",6.1,0.1,29,0,25,21,-1,-2,0,7,-1,-3,-3,4
"3653",2019-01-12,"Cement Creek","w1819","Non.motorized",32,"Sat","weekend","no_sled","3","3","2",6.1,0,28,-1,21,21.8,0,-1,-2,0,-1,-2,-4,-4
"3654",2019-01-12,"Cement Creek","w1819","Mechanized",0,"Sat","weekend","no_sled","3","3","2",6.1,0,28,-1,21,21.8,0,-1,-2,0,-1,-2,-4,-4
"3655",2019-01-12,"Cement Creek","w1819","Motorized",6,"Sat","weekend","sled","3","3","2",6.1,0,28,-1,21,21.8,0,-1,-2,0,-1,-2,-4,-4
"3656",2019-01-12,"Cement Creek","w1819","Hybrid",0,"Sat","weekend","sled","3","3","2",6.1,0,28,-1,21,21.8,0,-1,-2,0,-1,-2,-4,-4
"3657",2019-01-13,"Cement Creek","w1819","Non.motorized",32,"Sun","weekend","no_sled","2","2","2",6.2,0.1,30,2,18,20.7,-1,0,-1,-2,1,1,0,-2
"3658",2019-01-13,"Cement Creek","w1819","Mechanized",2,"Sun","weekend","no_sled","2","2","2",6.2,0.1,30,2,18,20.7,-1,0,-1,-2,1,1,0,-2
"3659",2019-01-13,"Cement Creek","w1819","Motorized",5,"Sun","weekend","sled","2","2","2",6.2,0.1,30,2,18,20.7,-1,0,-1,-2,1,1,0,-2
"3660",2019-01-13,"Cement Creek","w1819","Hybrid",0,"Sun","weekend","sled","2","2","2",6.2,0.1,30,2,18,20.7,-1,0,-1,-2,1,1,0,-2
"3661",2019-01-14,"Cement Creek","w1819","Non.motorized",7,"Mon","weekday","no_sled","2","2","2",6.2,0,30,0,18,20.7,2,-1,0,-1,2,1,1,0
"3662",2019-01-14,"Cement Creek","w1819","Mechanized",1,"Mon","weekday","no_sled","2","2","2",6.2,0,30,0,18,20.7,2,-1,0,-1,2,1,1,0
"3663",2019-01-14,"Cement Creek","w1819","Motorized",4,"Mon","weekday","sled","2","2","2",6.2,0,30,0,18,20.7,2,-1,0,-1,2,1,1,0
"3664",2019-01-14,"Cement Creek","w1819","Hybrid",0,"Mon","weekday","sled","2","2","2",6.2,0,30,0,18,20.7,2,-1,0,-1,2,1,1,0
"3665",2019-01-15,"Cement Creek","w1819","Non.motorized",13,"Tue","weekday","no_sled","2","2","2",6.2,0,29,-1,24,21.4,0,2,-1,0,-1,1,0,0
"3666",2019-01-15,"Cement Creek","w1819","Mechanized",1,"Tue","weekday","no_sled","2","2","2",6.2,0,29,-1,24,21.4,0,2,-1,0,-1,1,0,0
"3667",2019-01-15,"Cement Creek","w1819","Motorized",3,"Tue","weekday","sled","2","2","2",6.2,0,29,-1,24,21.4,0,2,-1,0,-1,1,0,0
"3668",2019-01-15,"Cement Creek","w1819","Hybrid",0,"Tue","weekday","sled","2","2","2",6.2,0,29,-1,24,21.4,0,2,-1,0,-1,1,0,0
"3669",2019-01-16,"Cement Creek","w1819","Non.motorized",0,"Wed","weekday","no_sled","4","4","3",6.3,0.1,29,0,26,21.7,-1,0,2,-1,-1,-1,1,0
"3670",2019-01-16,"Cement Creek","w1819","Mechanized",0,"Wed","weekday","no_sled","4","4","3",6.3,0.1,29,0,26,21.7,-1,0,2,-1,-1,-1,1,0
"3671",2019-01-16,"Cement Creek","w1819","Motorized",2,"Wed","weekday","sled","4","4","3",6.3,0.1,29,0,26,21.7,-1,0,2,-1,-1,-1,1,0
"3672",2019-01-16,"Cement Creek","w1819","Hybrid",0,"Wed","weekday","sled","4","4","3",6.3,0.1,29,0,26,21.7,-1,0,2,-1,-1,-1,1,0
"3673",2019-01-17,"Cement Creek","w1819","Non.motorized",0,"Thu","weekday","no_sled","3","3","2",7,0.7,38,9,28,18.4,0,-1,0,2,9,8,8,10
"3674",2019-01-17,"Cement Creek","w1819","Mechanized",0,"Thu","weekday","no_sled","3","3","2",7,0.7,38,9,28,18.4,0,-1,0,2,9,8,8,10
"3675",2019-01-17,"Cement Creek","w1819","Motorized",0,"Thu","weekday","sled","3","3","2",7,0.7,38,9,28,18.4,0,-1,0,2,9,8,8,10
"3676",2019-01-17,"Cement Creek","w1819","Hybrid",0,"Thu","weekday","sled","3","3","2",7,0.7,38,9,28,18.4,0,-1,0,2,9,8,8,10
"3677",2019-01-18,"Cement Creek","w1819","Non.motorized",0,"Fri","weekday","no_sled","4","4","4",7.5,0.5,41,3,22,18.3,9,0,-1,0,12,12,11,11
"3678",2019-01-18,"Cement Creek","w1819","Mechanized",0,"Fri","weekday","no_sled","4","4","4",7.5,0.5,41,3,22,18.3,9,0,-1,0,12,12,11,11
"3679",2019-01-18,"Cement Creek","w1819","Motorized",0,"Fri","weekday","sled","4","4","4",7.5,0.5,41,3,22,18.3,9,0,-1,0,12,12,11,11
"3680",2019-01-18,"Cement Creek","w1819","Hybrid",0,"Fri","weekday","sled","4","4","4",7.5,0.5,41,3,22,18.3,9,0,-1,0,12,12,11,11
"3681",2019-01-19,"Cement Creek","w1819","Non.motorized",0,"Sat","weekend","no_sled","3","3","3",7.8,0.3,43,2,20,18.1,3,9,0,-1,5,14,14,13
"3682",2019-01-19,"Cement Creek","w1819","Mechanized",0,"Sat","weekend","no_sled","3","3","3",7.8,0.3,43,2,20,18.1,3,9,0,-1,5,14,14,13
"3683",2019-01-19,"Cement Creek","w1819","Motorized",0,"Sat","weekend","sled","3","3","3",7.8,0.3,43,2,20,18.1,3,9,0,-1,5,14,14,13
"3684",2019-01-19,"Cement Creek","w1819","Hybrid",0,"Sat","weekend","sled","3","3","3",7.8,0.3,43,2,20,18.1,3,9,0,-1,5,14,14,13
"3685",2019-01-20,"Cement Creek","w1819","Non.motorized",0,"Sun","weekend","no_sled","3","3","3",7.9,0.1,41,-2,27,19.3,2,3,9,0,0,3,12,12
"3686",2019-01-20,"Cement Creek","w1819","Mechanized",0,"Sun","weekend","no_sled","3","3","3",7.9,0.1,41,-2,27,19.3,2,3,9,0,0,3,12,12
"3687",2019-01-20,"Cement Creek","w1819","Motorized",0,"Sun","weekend","sled","3","3","3",7.9,0.1,41,-2,27,19.3,2,3,9,0,0,3,12,12
"3688",2019-01-20,"Cement Creek","w1819","Hybrid",0,"Sun","weekend","sled","3","3","3",7.9,0.1,41,-2,27,19.3,2,3,9,0,0,3,12,12
"3689",2019-01-21,"Cement Creek","w1819","Non.motorized",1,"Mon","weekday","no_sled","3","3","3",7.9,0,39,-2,23,20.3,-2,2,3,9,-4,-2,1,10
"3690",2019-01-21,"Cement Creek","w1819","Mechanized",0,"Mon","weekday","no_sled","3","3","3",7.9,0,39,-2,23,20.3,-2,2,3,9,-4,-2,1,10
"3691",2019-01-21,"Cement Creek","w1819","Motorized",1,"Mon","weekday","sled","3","3","3",7.9,0,39,-2,23,20.3,-2,2,3,9,-4,-2,1,10
"3692",2019-01-21,"Cement Creek","w1819","Hybrid",0,"Mon","weekday","sled","3","3","3",7.9,0,39,-2,23,20.3,-2,2,3,9,-4,-2,1,10
"3693",2019-01-22,"Cement Creek","w1819","Non.motorized",6,"Tue","weekday","no_sled","3","3","3",8,0.1,41,2,12,19.5,-2,-2,2,3,0,-2,0,3
"3694",2019-01-22,"Cement Creek","w1819","Mechanized",0,"Tue","weekday","no_sled","3","3","3",8,0.1,41,2,12,19.5,-2,-2,2,3,0,-2,0,3
"3695",2019-01-22,"Cement Creek","w1819","Motorized",4,"Tue","weekday","sled","3","3","3",8,0.1,41,2,12,19.5,-2,-2,2,3,0,-2,0,3
"3696",2019-01-22,"Cement Creek","w1819","Hybrid",0,"Tue","weekday","sled","3","3","3",8,0.1,41,2,12,19.5,-2,-2,2,3,0,-2,0,3
"3697",2019-01-23,"Cement Creek","w1819","Non.motorized",12,"Wed","weekday","no_sled","3","3","2",8,0,40,-1,14,20,2,-2,-2,2,1,-1,-3,-1
"3698",2019-01-23,"Cement Creek","w1819","Mechanized",2,"Wed","weekday","no_sled","3","3","2",8,0,40,-1,14,20,2,-2,-2,2,1,-1,-3,-1
"3699",2019-01-23,"Cement Creek","w1819","Motorized",5,"Wed","weekday","sled","3","3","2",8,0,40,-1,14,20,2,-2,-2,2,1,-1,-3,-1
"3700",2019-01-23,"Cement Creek","w1819","Hybrid",0,"Wed","weekday","sled","3","3","2",8,0,40,-1,14,20,2,-2,-2,2,1,-1,-3,-1
"3701",2019-01-24,"Cement Creek","w1819","Non.motorized",7,"Thu","weekday","no_sled","3","3","2",8.2,0.2,40,0,17,20.5,-1,2,-2,-2,-1,1,-1,-3
"3702",2019-01-24,"Cement Creek","w1819","Mechanized",0,"Thu","weekday","no_sled","3","3","2",8.2,0.2,40,0,17,20.5,-1,2,-2,-2,-1,1,-1,-3
"3703",2019-01-24,"Cement Creek","w1819","Motorized",1,"Thu","weekday","sled","3","3","2",8.2,0.2,40,0,17,20.5,-1,2,-2,-2,-1,1,-1,-3
"3704",2019-01-24,"Cement Creek","w1819","Hybrid",0,"Thu","weekday","sled","3","3","2",8.2,0.2,40,0,17,20.5,-1,2,-2,-2,-1,1,-1,-3
"3705",2019-01-25,"Cement Creek","w1819","Non.motorized",15,"Fri","weekday","no_sled","3","3","2",8.3,0.1,40,0,15,20.8,0,-1,2,-2,0,-1,1,-1
"3706",2019-01-25,"Cement Creek","w1819","Mechanized",0,"Fri","weekday","no_sled","3","3","2",8.3,0.1,40,0,15,20.8,0,-1,2,-2,0,-1,1,-1
"3707",2019-01-25,"Cement Creek","w1819","Motorized",3,"Fri","weekday","sled","3","3","2",8.3,0.1,40,0,15,20.8,0,-1,2,-2,0,-1,1,-1
"3708",2019-01-25,"Cement Creek","w1819","Hybrid",0,"Fri","weekday","sled","3","3","2",8.3,0.1,40,0,15,20.8,0,-1,2,-2,0,-1,1,-1
"3709",2019-01-26,"Cement Creek","w1819","Non.motorized",41,"Sat","weekend","no_sled","3","3","2",8.3,0,39,-1,19,21.3,0,0,-1,2,-1,-1,-2,0
"3710",2019-01-26,"Cement Creek","w1819","Mechanized",0,"Sat","weekend","no_sled","3","3","2",8.3,0,39,-1,19,21.3,0,0,-1,2,-1,-1,-2,0
"3711",2019-01-26,"Cement Creek","w1819","Motorized",8,"Sat","weekend","sled","3","3","2",8.3,0,39,-1,19,21.3,0,0,-1,2,-1,-1,-2,0
"3712",2019-01-26,"Cement Creek","w1819","Hybrid",0,"Sat","weekend","sled","3","3","2",8.3,0,39,-1,19,21.3,0,0,-1,2,-1,-1,-2,0
"3713",2019-01-27,"Cement Creek","w1819","Non.motorized",27,"Sun","weekend","no_sled","3","3","2",8.3,0,38,-1,24,21.8,-1,0,0,-1,-2,-2,-2,-3
"3714",2019-01-27,"Cement Creek","w1819","Mechanized",2,"Sun","weekend","no_sled","3","3","2",8.3,0,38,-1,24,21.8,-1,0,0,-1,-2,-2,-2,-3
"3715",2019-01-27,"Cement Creek","w1819","Motorized",4,"Sun","weekend","sled","3","3","2",8.3,0,38,-1,24,21.8,-1,0,0,-1,-2,-2,-2,-3
"3716",2019-01-27,"Cement Creek","w1819","Hybrid",0,"Sun","weekend","sled","3","3","2",8.3,0,38,-1,24,21.8,-1,0,0,-1,-2,-2,-2,-3
"3717",2019-01-28,"Cement Creek","w1819","Non.motorized",8,"Mon","weekday","no_sled","2","2","2",8.3,0,38,0,17,21.8,-1,-1,0,0,-1,-2,-2,-2
"3718",2019-01-28,"Cement Creek","w1819","Mechanized",0,"Mon","weekday","no_sled","2","2","2",8.3,0,38,0,17,21.8,-1,-1,0,0,-1,-2,-2,-2
"3719",2019-01-28,"Cement Creek","w1819","Motorized",4,"Mon","weekday","sled","2","2","2",8.3,0,38,0,17,21.8,-1,-1,0,0,-1,-2,-2,-2
"3720",2019-01-28,"Cement Creek","w1819","Hybrid",0,"Mon","weekday","sled","2","2","2",8.3,0,38,0,17,21.8,-1,-1,0,0,-1,-2,-2,-2
"3721",2019-01-29,"Cement Creek","w1819","Non.motorized",12,"Tue","weekday","no_sled","2","2","2",8.3,0,38,0,16,21.8,0,-1,-1,0,0,-1,-2,-2
"3722",2019-01-29,"Cement Creek","w1819","Mechanized",1,"Tue","weekday","no_sled","2","2","2",8.3,0,38,0,16,21.8,0,-1,-1,0,0,-1,-2,-2
"3723",2019-01-29,"Cement Creek","w1819","Motorized",3,"Tue","weekday","sled","2","2","2",8.3,0,38,0,16,21.8,0,-1,-1,0,0,-1,-2,-2
"3724",2019-01-29,"Cement Creek","w1819","Hybrid",0,"Tue","weekday","sled","2","2","2",8.3,0,38,0,16,21.8,0,-1,-1,0,0,-1,-2,-2
"3725",2019-01-30,"Cement Creek","w1819","Non.motorized",11,"Wed","weekday","no_sled","2","2","1",8.3,0,37,-1,20,22.4,0,0,-1,-1,-1,-1,-2,-3
"3726",2019-01-30,"Cement Creek","w1819","Mechanized",1,"Wed","weekday","no_sled","2","2","1",8.3,0,37,-1,20,22.4,0,0,-1,-1,-1,-1,-2,-3
"3727",2019-01-30,"Cement Creek","w1819","Motorized",3,"Wed","weekday","sled","2","2","1",8.3,0,37,-1,20,22.4,0,0,-1,-1,-1,-1,-2,-3
"3728",2019-01-30,"Cement Creek","w1819","Hybrid",0,"Wed","weekday","sled","2","2","1",8.3,0,37,-1,20,22.4,0,0,-1,-1,-1,-1,-2,-3
"3729",2019-01-31,"Cement Creek","w1819","Non.motorized",9,"Thu","weekday","no_sled","2","2","1",8.3,0,36,-1,24,23.1,-1,0,0,-1,-2,-2,-2,-3
"3730",2019-01-31,"Cement Creek","w1819","Mechanized",0,"Thu","weekday","no_sled","2","2","1",8.3,0,36,-1,24,23.1,-1,0,0,-1,-2,-2,-2,-3
"3731",2019-01-31,"Cement Creek","w1819","Motorized",1,"Thu","weekday","sled","2","2","1",8.3,0,36,-1,24,23.1,-1,0,0,-1,-2,-2,-2,-3
"3732",2019-01-31,"Cement Creek","w1819","Hybrid",0,"Thu","weekday","sled","2","2","1",8.3,0,36,-1,24,23.1,-1,0,0,-1,-2,-2,-2,-3
"3733",2019-02-01,"Cement Creek","w1819","Non.motorized",23,"Fri","weekday","no_sled","2","2","1",8.3,0,36,0,25,23.1,-1,-1,0,0,-1,-2,-2,-2
"3734",2019-02-01,"Cement Creek","w1819","Mechanized",3,"Fri","weekday","no_sled","2","2","1",8.3,0,36,0,25,23.1,-1,-1,0,0,-1,-2,-2,-2
"3735",2019-02-01,"Cement Creek","w1819","Motorized",2,"Fri","weekday","sled","2","2","1",8.3,0,36,0,25,23.1,-1,-1,0,0,-1,-2,-2,-2
"3736",2019-02-01,"Cement Creek","w1819","Hybrid",0,"Fri","weekday","sled","2","2","1",8.3,0,36,0,25,23.1,-1,-1,0,0,-1,-2,-2,-2
"3737",2019-02-02,"Cement Creek","w1819","Non.motorized",33,"Sat","weekend","no_sled","2","2","1",8.3,0,36,0,26,23.1,0,-1,-1,0,0,-1,-2,-2
"3738",2019-02-02,"Cement Creek","w1819","Mechanized",5,"Sat","weekend","no_sled","2","2","1",8.3,0,36,0,26,23.1,0,-1,-1,0,0,-1,-2,-2
"3739",2019-02-02,"Cement Creek","w1819","Motorized",3,"Sat","weekend","sled","2","2","1",8.3,0,36,0,26,23.1,0,-1,-1,0,0,-1,-2,-2
"3740",2019-02-02,"Cement Creek","w1819","Hybrid",0,"Sat","weekend","sled","2","2","1",8.3,0,36,0,26,23.1,0,-1,-1,0,0,-1,-2,-2
"3741",2019-02-03,"Cement Creek","w1819","Non.motorized",24,"Sun","weekend","no_sled","3","3","2",8.4,0.1,36,0,28,23.3,0,0,-1,-1,0,0,-1,-2
"3742",2019-02-03,"Cement Creek","w1819","Mechanized",2,"Sun","weekend","no_sled","3","3","2",8.4,0.1,36,0,28,23.3,0,0,-1,-1,0,0,-1,-2
"3743",2019-02-03,"Cement Creek","w1819","Motorized",2,"Sun","weekend","sled","3","3","2",8.4,0.1,36,0,28,23.3,0,0,-1,-1,0,0,-1,-2
"3744",2019-02-03,"Cement Creek","w1819","Hybrid",0,"Sun","weekend","sled","3","3","2",8.4,0.1,36,0,28,23.3,0,0,-1,-1,0,0,-1,-2
"3745",2019-02-04,"Cement Creek","w1819","Non.motorized",10,"Mon","weekday","no_sled","3","3","2",8.8,0.4,39,3,28,22.6,0,0,0,-1,3,3,3,2
"3746",2019-02-04,"Cement Creek","w1819","Mechanized",1,"Mon","weekday","no_sled","3","3","2",8.8,0.4,39,3,28,22.6,0,0,0,-1,3,3,3,2
"3747",2019-02-04,"Cement Creek","w1819","Motorized",4,"Mon","weekday","sled","3","3","2",8.8,0.4,39,3,28,22.6,0,0,0,-1,3,3,3,2
"3748",2019-02-04,"Cement Creek","w1819","Hybrid",0,"Mon","weekday","sled","3","3","2",8.8,0.4,39,3,28,22.6,0,0,0,-1,3,3,3,2
"3749",2019-02-05,"Cement Creek","w1819","Non.motorized",15,"Tue","weekday","no_sled","3","2","2",9,0.2,40,1,26,22.5,3,0,0,0,4,4,4,4
"3750",2019-02-05,"Cement Creek","w1819","Mechanized",0,"Tue","weekday","no_sled","3","2","2",9,0.2,40,1,26,22.5,3,0,0,0,4,4,4,4
"3751",2019-02-05,"Cement Creek","w1819","Motorized",4,"Tue","weekday","sled","3","2","2",9,0.2,40,1,26,22.5,3,0,0,0,4,4,4,4
"3752",2019-02-05,"Cement Creek","w1819","Hybrid",0,"Tue","weekday","sled","3","2","2",9,0.2,40,1,26,22.5,3,0,0,0,4,4,4,4
"3753",2019-02-06,"Cement Creek","w1819","Non.motorized",7,"Wed","weekday","no_sled","4","4","3",9,0,40,0,16,22.5,1,3,0,0,1,4,4,4
"3754",2019-02-06,"Cement Creek","w1819","Mechanized",0,"Wed","weekday","no_sled","4","4","3",9,0,40,0,16,22.5,1,3,0,0,1,4,4,4
"3755",2019-02-06,"Cement Creek","w1819","Motorized",3,"Wed","weekday","sled","4","4","3",9,0,40,0,16,22.5,1,3,0,0,1,4,4,4
"3756",2019-02-06,"Cement Creek","w1819","Hybrid",0,"Wed","weekday","sled","4","4","3",9,0,40,0,16,22.5,1,3,0,0,1,4,4,4
"3757",2019-02-07,"Cement Creek","w1819","Non.motorized",4,"Thu","weekday","no_sled","3","3","2",9.2,0.2,43,3,4,21.4,0,1,3,0,3,4,7,7
"3758",2019-02-07,"Cement Creek","w1819","Mechanized",0,"Thu","weekday","no_sled","3","3","2",9.2,0.2,43,3,4,21.4,0,1,3,0,3,4,7,7
"3759",2019-02-07,"Cement Creek","w1819","Motorized",3,"Thu","weekday","sled","3","3","2",9.2,0.2,43,3,4,21.4,0,1,3,0,3,4,7,7
"3760",2019-02-07,"Cement Creek","w1819","Hybrid",0,"Thu","weekday","sled","3","3","2",9.2,0.2,43,3,4,21.4,0,1,3,0,3,4,7,7
"3761",2019-02-08,"Cement Creek","w1819","Non.motorized",20,"Fri","weekday","no_sled","3","2","2",9.2,0,42,-1,10,21.9,3,0,1,3,2,2,3,6
"3762",2019-02-08,"Cement Creek","w1819","Mechanized",0,"Fri","weekday","no_sled","3","2","2",9.2,0,42,-1,10,21.9,3,0,1,3,2,2,3,6
"3763",2019-02-08,"Cement Creek","w1819","Motorized",1,"Fri","weekday","sled","3","2","2",9.2,0,42,-1,10,21.9,3,0,1,3,2,2,3,6
"3764",2019-02-08,"Cement Creek","w1819","Hybrid",0,"Fri","weekday","sled","3","2","2",9.2,0,42,-1,10,21.9,3,0,1,3,2,2,3,6
"3765",2019-02-09,"Cement Creek","w1819","Non.motorized",25,"Sat","weekend","no_sled","3","2","2",9.2,0,41,-1,20,22.4,-1,3,0,1,-2,1,1,2
"3766",2019-02-09,"Cement Creek","w1819","Mechanized",0,"Sat","weekend","no_sled","3","2","2",9.2,0,41,-1,20,22.4,-1,3,0,1,-2,1,1,2
"3767",2019-02-09,"Cement Creek","w1819","Motorized",4,"Sat","weekend","sled","3","2","2",9.2,0,41,-1,20,22.4,-1,3,0,1,-2,1,1,2
"3768",2019-02-09,"Cement Creek","w1819","Hybrid",0,"Sat","weekend","sled","3","2","2",9.2,0,41,-1,20,22.4,-1,3,0,1,-2,1,1,2
"3769",2019-02-10,"Cement Creek","w1819","Non.motorized",0,"Sun","weekend","no_sled","2","2","2",9.3,0.1,40,-1,20,23.2,-1,-1,3,0,-2,-3,0,0
"3770",2019-02-10,"Cement Creek","w1819","Mechanized",0,"Sun","weekend","no_sled","2","2","2",9.3,0.1,40,-1,20,23.2,-1,-1,3,0,-2,-3,0,0
"3771",2019-02-10,"Cement Creek","w1819","Motorized",0,"Sun","weekend","sled","2","2","2",9.3,0.1,40,-1,20,23.2,-1,-1,3,0,-2,-3,0,0
"3772",2019-02-10,"Cement Creek","w1819","Hybrid",0,"Sun","weekend","sled","2","2","2",9.3,0.1,40,-1,20,23.2,-1,-1,3,0,-2,-3,0,0
"3773",2019-02-11,"Cement Creek","w1819","Non.motorized",5,"Mon","weekday","no_sled","2","2","1",9.3,0,40,0,15,23.2,-1,-1,-1,3,-1,-2,-3,0
"3774",2019-02-11,"Cement Creek","w1819","Mechanized",0,"Mon","weekday","no_sled","2","2","1",9.3,0,40,0,15,23.2,-1,-1,-1,3,-1,-2,-3,0
"3775",2019-02-11,"Cement Creek","w1819","Motorized",3,"Mon","weekday","sled","2","2","1",9.3,0,40,0,15,23.2,-1,-1,-1,3,-1,-2,-3,0
"3776",2019-02-11,"Cement Creek","w1819","Hybrid",0,"Mon","weekday","sled","2","2","1",9.3,0,40,0,15,23.2,-1,-1,-1,3,-1,-2,-3,0
"3777",2019-02-12,"Cement Creek","w1819","Non.motorized",17,"Tue","weekday","no_sled","2","2","1",9.3,0,40,0,18,23.2,0,-1,-1,-1,0,-1,-2,-3
"3778",2019-02-12,"Cement Creek","w1819","Mechanized",0,"Tue","weekday","no_sled","2","2","1",9.3,0,40,0,18,23.2,0,-1,-1,-1,0,-1,-2,-3
"3779",2019-02-12,"Cement Creek","w1819","Motorized",8,"Tue","weekday","sled","2","2","1",9.3,0,40,0,18,23.2,0,-1,-1,-1,0,-1,-2,-3
"3780",2019-02-12,"Cement Creek","w1819","Hybrid",0,"Tue","weekday","sled","2","2","1",9.3,0,40,0,18,23.2,0,-1,-1,-1,0,-1,-2,-3
"3781",2019-02-13,"Cement Creek","w1819","Non.motorized",16,"Wed","weekday","no_sled","2","2","1",9.4,0.1,40,0,26,23.5,0,0,-1,-1,0,0,-1,-2
"3782",2019-02-13,"Cement Creek","w1819","Mechanized",1,"Wed","weekday","no_sled","2","2","1",9.4,0.1,40,0,26,23.5,0,0,-1,-1,0,0,-1,-2
"3783",2019-02-13,"Cement Creek","w1819","Motorized",2,"Wed","weekday","sled","2","2","1",9.4,0.1,40,0,26,23.5,0,0,-1,-1,0,0,-1,-2
"3784",2019-02-13,"Cement Creek","w1819","Hybrid",0,"Wed","weekday","sled","2","2","1",9.4,0.1,40,0,26,23.5,0,0,-1,-1,0,0,-1,-2
"3785",2019-02-14,"Cement Creek","w1819","Non.motorized",4,"Thu","weekday","no_sled","3","2","2",9.7,0.3,41,1,29,23.7,0,0,0,-1,1,1,1,0
"3786",2019-02-14,"Cement Creek","w1819","Mechanized",0,"Thu","weekday","no_sled","3","2","2",9.7,0.3,41,1,29,23.7,0,0,0,-1,1,1,1,0
"3787",2019-02-14,"Cement Creek","w1819","Motorized",12,"Thu","weekday","sled","3","2","2",9.7,0.3,41,1,29,23.7,0,0,0,-1,1,1,1,0
"3788",2019-02-14,"Cement Creek","w1819","Hybrid",0,"Thu","weekday","sled","3","2","2",9.7,0.3,41,1,29,23.7,0,0,0,-1,1,1,1,0
"3789",2019-02-15,"Cement Creek","w1819","Non.motorized",18,"Fri","weekday","no_sled","4","4","3",10.8,1.1,51,10,27,21.2,1,0,0,0,11,11,11,11
"3790",2019-02-15,"Cement Creek","w1819","Mechanized",0,"Fri","weekday","no_sled","4","4","3",10.8,1.1,51,10,27,21.2,1,0,0,0,11,11,11,11
"3791",2019-02-15,"Cement Creek","w1819","Motorized",7,"Fri","weekday","sled","4","4","3",10.8,1.1,51,10,27,21.2,1,0,0,0,11,11,11,11
"3792",2019-02-15,"Cement Creek","w1819","Hybrid",0,"Fri","weekday","sled","4","4","3",10.8,1.1,51,10,27,21.2,1,0,0,0,11,11,11,11
"3793",2019-02-16,"Cement Creek","w1819","Non.motorized",0,"Sat","weekend","no_sled","3","3","3",11.1,0.3,52,1,14,21.3,10,1,0,0,11,12,12,12
"3794",2019-02-16,"Cement Creek","w1819","Mechanized",0,"Sat","weekend","no_sled","3","3","3",11.1,0.3,52,1,14,21.3,10,1,0,0,11,12,12,12
"3795",2019-02-16,"Cement Creek","w1819","Motorized",0,"Sat","weekend","sled","3","3","3",11.1,0.3,52,1,14,21.3,10,1,0,0,11,12,12,12
"3796",2019-02-16,"Cement Creek","w1819","Hybrid",0,"Sat","weekend","sled","3","3","3",11.1,0.3,52,1,14,21.3,10,1,0,0,11,12,12,12
"3797",2019-02-17,"Cement Creek","w1819","Non.motorized",21,"Sun","weekend","no_sled","3","3","3",11.3,0.2,55,3,10,20.5,1,10,1,0,4,14,15,15
"3798",2019-02-17,"Cement Creek","w1819","Mechanized",1,"Sun","weekend","no_sled","3","3","3",11.3,0.2,55,3,10,20.5,1,10,1,0,4,14,15,15
"3799",2019-02-17,"Cement Creek","w1819","Motorized",6,"Sun","weekend","sled","3","3","3",11.3,0.2,55,3,10,20.5,1,10,1,0,4,14,15,15
"3800",2019-02-17,"Cement Creek","w1819","Hybrid",0,"Sun","weekend","sled","3","3","3",11.3,0.2,55,3,10,20.5,1,10,1,0,4,14,15,15
"3801",2019-02-18,"Cement Creek","w1819","Non.motorized",9,"Mon","weekday","no_sled","3","3","2",11.4,0.1,53,-2,13,21.5,3,1,10,1,1,2,12,13
"3802",2019-02-18,"Cement Creek","w1819","Mechanized",0,"Mon","weekday","no_sled","3","3","2",11.4,0.1,53,-2,13,21.5,3,1,10,1,1,2,12,13
"3803",2019-02-18,"Cement Creek","w1819","Motorized",5,"Mon","weekday","sled","3","3","2",11.4,0.1,53,-2,13,21.5,3,1,10,1,1,2,12,13
"3804",2019-02-18,"Cement Creek","w1819","Hybrid",0,"Mon","weekday","sled","3","3","2",11.4,0.1,53,-2,13,21.5,3,1,10,1,1,2,12,13
"3805",2019-02-19,"Cement Creek","w1819","Non.motorized",0,"Tue","weekday","no_sled","3","3","2",11.5,0.1,53,0,11,21.7,-2,3,1,10,-2,1,2,12
"3806",2019-02-19,"Cement Creek","w1819","Mechanized",0,"Tue","weekday","no_sled","3","3","2",11.5,0.1,53,0,11,21.7,-2,3,1,10,-2,1,2,12
"3807",2019-02-19,"Cement Creek","w1819","Motorized",0,"Tue","weekday","sled","3","3","2",11.5,0.1,53,0,11,21.7,-2,3,1,10,-2,1,2,12
"3808",2019-02-19,"Cement Creek","w1819","Hybrid",0,"Tue","weekday","sled","3","3","2",11.5,0.1,53,0,11,21.7,-2,3,1,10,-2,1,2,12
"3809",2019-02-20,"Cement Creek","w1819","Non.motorized",0,"Wed","weekday","no_sled","3","3","2",11.6,0.1,53,0,7,21.9,0,-2,3,1,0,-2,1,2
"3810",2019-02-20,"Cement Creek","w1819","Mechanized",0,"Wed","weekday","no_sled","3","3","2",11.6,0.1,53,0,7,21.9,0,-2,3,1,0,-2,1,2
"3811",2019-02-20,"Cement Creek","w1819","Motorized",0,"Wed","weekday","sled","3","3","2",11.6,0.1,53,0,7,21.9,0,-2,3,1,0,-2,1,2
"3812",2019-02-20,"Cement Creek","w1819","Hybrid",0,"Wed","weekday","sled","3","3","2",11.6,0.1,53,0,7,21.9,0,-2,3,1,0,-2,1,2
"3813",2019-02-21,"Cement Creek","w1819","Non.motorized",0,"Thu","weekday","no_sled","3","3","3",11.6,0,52,-1,15,22.3,0,0,-2,3,-1,-1,-3,0
"3814",2019-02-21,"Cement Creek","w1819","Mechanized",0,"Thu","weekday","no_sled","3","3","3",11.6,0,52,-1,15,22.3,0,0,-2,3,-1,-1,-3,0
"3815",2019-02-21,"Cement Creek","w1819","Motorized",0,"Thu","weekday","sled","3","3","3",11.6,0,52,-1,15,22.3,0,0,-2,3,-1,-1,-3,0
"3816",2019-02-21,"Cement Creek","w1819","Hybrid",0,"Thu","weekday","sled","3","3","3",11.6,0,52,-1,15,22.3,0,0,-2,3,-1,-1,-3,0
"3817",2019-02-22,"Cement Creek","w1819","Non.motorized",2,"Fri","weekday","no_sled","3","3","3",11.8,0.2,52,0,20,22.7,-1,0,0,-2,-1,-1,-1,-3
"3818",2019-02-22,"Cement Creek","w1819","Mechanized",0,"Fri","weekday","no_sled","3","3","3",11.8,0.2,52,0,20,22.7,-1,0,0,-2,-1,-1,-1,-3
"3819",2019-02-22,"Cement Creek","w1819","Motorized",0,"Fri","weekday","sled","3","3","3",11.8,0.2,52,0,20,22.7,-1,0,0,-2,-1,-1,-1,-3
"3820",2019-02-22,"Cement Creek","w1819","Hybrid",0,"Fri","weekday","sled","3","3","3",11.8,0.2,52,0,20,22.7,-1,0,0,-2,-1,-1,-1,-3
"3821",2019-02-23,"Cement Creek","w1819","Non.motorized",29,"Sat","weekend","no_sled","3","3","3",12.1,0.3,53,1,13,22.8,0,-1,0,0,1,0,0,0
"3822",2019-02-23,"Cement Creek","w1819","Mechanized",0,"Sat","weekend","no_sled","3","3","3",12.1,0.3,53,1,13,22.8,0,-1,0,0,1,0,0,0
"3823",2019-02-23,"Cement Creek","w1819","Motorized",6,"Sat","weekend","sled","3","3","3",12.1,0.3,53,1,13,22.8,0,-1,0,0,1,0,0,0
"3824",2019-02-23,"Cement Creek","w1819","Hybrid",0,"Sat","weekend","sled","3","3","3",12.1,0.3,53,1,13,22.8,0,-1,0,0,1,0,0,0
"3825",2019-02-24,"Cement Creek","w1819","Non.motorized",29,"Sun","weekend","no_sled","3","3","2",12.1,0,52,-1,14,23.3,1,0,-1,0,0,0,-1,-1
"3826",2019-02-24,"Cement Creek","w1819","Mechanized",1,"Sun","weekend","no_sled","3","3","2",12.1,0,52,-1,14,23.3,1,0,-1,0,0,0,-1,-1
"3827",2019-02-24,"Cement Creek","w1819","Motorized",13,"Sun","weekend","sled","3","3","2",12.1,0,52,-1,14,23.3,1,0,-1,0,0,0,-1,-1
"3828",2019-02-24,"Cement Creek","w1819","Hybrid",0,"Sun","weekend","sled","3","3","2",12.1,0,52,-1,14,23.3,1,0,-1,0,0,0,-1,-1
"3829",2019-02-25,"Cement Creek","w1819","Non.motorized",13,"Mon","weekday","no_sled","3","3","2",12.1,0,51,-1,22,23.7,-1,1,0,-1,-2,-1,-1,-2
"3830",2019-02-25,"Cement Creek","w1819","Mechanized",5,"Mon","weekday","no_sled","3","3","2",12.1,0,51,-1,22,23.7,-1,1,0,-1,-2,-1,-1,-2
"3831",2019-02-25,"Cement Creek","w1819","Motorized",10,"Mon","weekday","sled","3","3","2",12.1,0,51,-1,22,23.7,-1,1,0,-1,-2,-1,-1,-2
"3832",2019-02-25,"Cement Creek","w1819","Hybrid",0,"Mon","weekday","sled","3","3","2",12.1,0,51,-1,22,23.7,-1,1,0,-1,-2,-1,-1,-2
"3833",2019-02-26,"Cement Creek","w1819","Non.motorized",13,"Tue","weekday","no_sled","2","2","2",12.1,0,50,-1,27,24.2,-1,-1,1,0,-2,-3,-2,-2
"3834",2019-02-26,"Cement Creek","w1819","Mechanized",0,"Tue","weekday","no_sled","2","2","2",12.1,0,50,-1,27,24.2,-1,-1,1,0,-2,-3,-2,-2
"3835",2019-02-26,"Cement Creek","w1819","Motorized",2,"Tue","weekday","sled","2","2","2",12.1,0,50,-1,27,24.2,-1,-1,1,0,-2,-3,-2,-2
"3836",2019-02-26,"Cement Creek","w1819","Hybrid",0,"Tue","weekday","sled","2","2","2",12.1,0,50,-1,27,24.2,-1,-1,1,0,-2,-3,-2,-2
"3837",2019-02-27,"Cement Creek","w1819","Non.motorized",10,"Wed","weekday","no_sled","2","2","2",12.1,0,50,0,30,24.2,-1,-1,-1,1,-1,-2,-3,-2
"3838",2019-02-27,"Cement Creek","w1819","Mechanized",1,"Wed","weekday","no_sled","2","2","2",12.1,0,50,0,30,24.2,-1,-1,-1,1,-1,-2,-3,-2
"3839",2019-02-27,"Cement Creek","w1819","Motorized",10,"Wed","weekday","sled","2","2","2",12.1,0,50,0,30,24.2,-1,-1,-1,1,-1,-2,-3,-2
"3840",2019-02-27,"Cement Creek","w1819","Hybrid",0,"Wed","weekday","sled","2","2","2",12.1,0,50,0,30,24.2,-1,-1,-1,1,-1,-2,-3,-2
"3841",2019-02-28,"Cement Creek","w1819","Non.motorized",20,"Thu","weekday","no_sled","2","2","2",12.2,0.1,49,-1,30,24.9,0,-1,-1,-1,-1,-2,-3,-4
"3842",2019-02-28,"Cement Creek","w1819","Mechanized",2,"Thu","weekday","no_sled","2","2","2",12.2,0.1,49,-1,30,24.9,0,-1,-1,-1,-1,-2,-3,-4
"3843",2019-02-28,"Cement Creek","w1819","Motorized",2,"Thu","weekday","sled","2","2","2",12.2,0.1,49,-1,30,24.9,0,-1,-1,-1,-1,-2,-3,-4
"3844",2019-02-28,"Cement Creek","w1819","Hybrid",0,"Thu","weekday","sled","2","2","2",12.2,0.1,49,-1,30,24.9,0,-1,-1,-1,-1,-2,-3,-4
"3845",2019-03-01,"Cement Creek","w1819","Non.motorized",0,"Fri","weekday","no_sled","2","2","1",12.3,0.1,49,0,29,25.1,-1,0,-1,-1,-1,-1,-2,-3
"3846",2019-03-01,"Cement Creek","w1819","Mechanized",0,"Fri","weekday","no_sled","2","2","1",12.3,0.1,49,0,29,25.1,-1,0,-1,-1,-1,-1,-2,-3
"3847",2019-03-01,"Cement Creek","w1819","Motorized",2,"Fri","weekday","sled","2","2","1",12.3,0.1,49,0,29,25.1,-1,0,-1,-1,-1,-1,-2,-3
"3848",2019-03-01,"Cement Creek","w1819","Hybrid",0,"Fri","weekday","sled","2","2","1",12.3,0.1,49,0,29,25.1,-1,0,-1,-1,-1,-1,-2,-3
"3849",2019-03-02,"Cement Creek","w1819","Non.motorized",12,"Sat","weekend","no_sled","3","3","2",13,0.7,58,9,30,22.4,0,-1,0,-1,9,8,8,7
"3850",2019-03-02,"Cement Creek","w1819","Mechanized",0,"Sat","weekend","no_sled","3","3","2",13,0.7,58,9,30,22.4,0,-1,0,-1,9,8,8,7
"3851",2019-03-02,"Cement Creek","w1819","Motorized",2,"Sat","weekend","sled","3","3","2",13,0.7,58,9,30,22.4,0,-1,0,-1,9,8,8,7
"3852",2019-03-02,"Cement Creek","w1819","Hybrid",0,"Sat","weekend","sled","3","3","2",13,0.7,58,9,30,22.4,0,-1,0,-1,9,8,8,7
"3853",2019-03-03,"Cement Creek","w1819","Non.motorized",3,"Sun","weekend","no_sled","3","3","3",13.7,0.7,64,6,27,21.4,9,0,-1,0,15,15,14,14
"3854",2019-03-03,"Cement Creek","w1819","Mechanized",0,"Sun","weekend","no_sled","3","3","3",13.7,0.7,64,6,27,21.4,9,0,-1,0,15,15,14,14
"3855",2019-03-03,"Cement Creek","w1819","Motorized",0,"Sun","weekend","sled","3","3","3",13.7,0.7,64,6,27,21.4,9,0,-1,0,15,15,14,14
"3856",2019-03-03,"Cement Creek","w1819","Hybrid",0,"Sun","weekend","sled","3","3","3",13.7,0.7,64,6,27,21.4,9,0,-1,0,15,15,14,14
"3857",2019-03-04,"Cement Creek","w1819","Non.motorized",9,"Mon","weekday","no_sled","3","3","3",14.4,0.7,66,2,23,21.8,6,9,0,-1,8,17,17,16
"3858",2019-03-04,"Cement Creek","w1819","Mechanized",0,"Mon","weekday","no_sled","3","3","3",14.4,0.7,66,2,23,21.8,6,9,0,-1,8,17,17,16
"3859",2019-03-04,"Cement Creek","w1819","Motorized",4,"Mon","weekday","sled","3","3","3",14.4,0.7,66,2,23,21.8,6,9,0,-1,8,17,17,16
"3860",2019-03-04,"Cement Creek","w1819","Hybrid",0,"Mon","weekday","sled","3","3","3",14.4,0.7,66,2,23,21.8,6,9,0,-1,8,17,17,16
"3861",2019-03-05,"Cement Creek","w1819","Non.motorized",13,"Tue","weekday","no_sled","3","3","3",14.4,0,64,-2,24,22.5,2,6,9,0,0,6,15,15
"3862",2019-03-05,"Cement Creek","w1819","Mechanized",0,"Tue","weekday","no_sled","3","3","3",14.4,0,64,-2,24,22.5,2,6,9,0,0,6,15,15
"3863",2019-03-05,"Cement Creek","w1819","Motorized",3,"Tue","weekday","sled","3","3","3",14.4,0,64,-2,24,22.5,2,6,9,0,0,6,15,15
"3864",2019-03-05,"Cement Creek","w1819","Hybrid",0,"Tue","weekday","sled","3","3","3",14.4,0,64,-2,24,22.5,2,6,9,0,0,6,15,15
"3865",2019-03-06,"Cement Creek","w1819","Non.motorized",0,"Wed","weekday","no_sled","3","3","2",14.5,0.1,62,-2,31,23.4,-2,2,6,9,-4,-2,4,13
"3866",2019-03-06,"Cement Creek","w1819","Non.motorized",0,"Wed","weekday","no_sled","4","4","3",14.5,0.1,62,-2,31,23.4,-2,2,6,9,-4,-2,4,13
"3867",2019-03-06,"Cement Creek","w1819","Mechanized",0,"Wed","weekday","no_sled","3","3","2",14.5,0.1,62,-2,31,23.4,-2,2,6,9,-4,-2,4,13
"3868",2019-03-06,"Cement Creek","w1819","Mechanized",0,"Wed","weekday","no_sled","4","4","3",14.5,0.1,62,-2,31,23.4,-2,2,6,9,-4,-2,4,13
"3869",2019-03-06,"Cement Creek","w1819","Motorized",0,"Wed","weekday","sled","3","3","2",14.5,0.1,62,-2,31,23.4,-2,2,6,9,-4,-2,4,13
"3870",2019-03-06,"Cement Creek","w1819","Motorized",0,"Wed","weekday","sled","4","4","3",14.5,0.1,62,-2,31,23.4,-2,2,6,9,-4,-2,4,13
"3871",2019-03-06,"Cement Creek","w1819","Hybrid",0,"Wed","weekday","sled","3","3","2",14.5,0.1,62,-2,31,23.4,-2,2,6,9,-4,-2,4,13
"3872",2019-03-06,"Cement Creek","w1819","Hybrid",0,"Wed","weekday","sled","4","4","3",14.5,0.1,62,-2,31,23.4,-2,2,6,9,-4,-2,4,13
"3873",2019-03-07,"Cement Creek","w1819","Non.motorized",0,"Thu","weekday","no_sled","4","4","3",16.2,1.7,71,9,30,22.8,-2,-2,2,6,7,5,7,13
"3874",2019-03-07,"Cement Creek","w1819","Mechanized",0,"Thu","weekday","no_sled","4","4","3",16.2,1.7,71,9,30,22.8,-2,-2,2,6,7,5,7,13
"3875",2019-03-07,"Cement Creek","w1819","Motorized",0,"Thu","weekday","sled","4","4","3",16.2,1.7,71,9,30,22.8,-2,-2,2,6,7,5,7,13
"3876",2019-03-07,"Cement Creek","w1819","Hybrid",0,"Thu","weekday","sled","4","4","3",16.2,1.7,71,9,30,22.8,-2,-2,2,6,7,5,7,13
"3877",2019-03-08,"Cement Creek","w1819","Non.motorized",0,"Fri","weekday","no_sled","3","3","3",16.6,0.4,71,0,27,23.4,9,-2,-2,2,9,7,5,7
"3878",2019-03-08,"Cement Creek","w1819","Mechanized",0,"Fri","weekday","no_sled","3","3","3",16.6,0.4,71,0,27,23.4,9,-2,-2,2,9,7,5,7
"3879",2019-03-08,"Cement Creek","w1819","Motorized",0,"Fri","weekday","sled","3","3","3",16.6,0.4,71,0,27,23.4,9,-2,-2,2,9,7,5,7
"3880",2019-03-08,"Cement Creek","w1819","Hybrid",0,"Fri","weekday","sled","3","3","3",16.6,0.4,71,0,27,23.4,9,-2,-2,2,9,7,5,7
"3881",2019-03-09,"Cement Creek","w1819","Non.motorized",0,"Sat","weekend","no_sled","4","4","3",17.2,0.6,76,5,22,22.6,0,9,-2,-2,5,14,12,10
"3882",2019-03-09,"Cement Creek","w1819","Mechanized",0,"Sat","weekend","no_sled","4","4","3",17.2,0.6,76,5,22,22.6,0,9,-2,-2,5,14,12,10
"3883",2019-03-09,"Cement Creek","w1819","Motorized",1,"Sat","weekend","sled","4","4","3",17.2,0.6,76,5,22,22.6,0,9,-2,-2,5,14,12,10
"3884",2019-03-09,"Cement Creek","w1819","Hybrid",0,"Sat","weekend","sled","4","4","3",17.2,0.6,76,5,22,22.6,0,9,-2,-2,5,14,12,10
"3885",2019-03-10,"Cement Creek","w1819","Non.motorized",11,"Sun","weekend","no_sled","3","3","3",17.3,0.1,73,-3,25,23.7,5,0,9,-2,2,2,11,9
"3886",2019-03-10,"Cement Creek","w1819","Mechanized",0,"Sun","weekend","no_sled","3","3","3",17.3,0.1,73,-3,25,23.7,5,0,9,-2,2,2,11,9
"3887",2019-03-10,"Cement Creek","w1819","Motorized",3,"Sun","weekend","sled","3","3","3",17.3,0.1,73,-3,25,23.7,5,0,9,-2,2,2,11,9
"3888",2019-03-10,"Cement Creek","w1819","Hybrid",0,"Sun","weekend","sled","3","3","3",17.3,0.1,73,-3,25,23.7,5,0,9,-2,2,2,11,9
"3889",2019-03-11,"Cement Creek","w1819","Non.motorized",6,"Mon","weekday","no_sled","3","3","2",17.3,0,71,-2,29,24.4,-3,5,0,9,-5,0,0,9
"3890",2019-03-11,"Cement Creek","w1819","Mechanized",1,"Mon","weekday","no_sled","3","3","2",17.3,0,71,-2,29,24.4,-3,5,0,9,-5,0,0,9
"3891",2019-03-11,"Cement Creek","w1819","Motorized",2,"Mon","weekday","sled","3","3","2",17.3,0,71,-2,29,24.4,-3,5,0,9,-5,0,0,9
"3892",2019-03-11,"Cement Creek","w1819","Hybrid",0,"Mon","weekday","sled","3","3","2",17.3,0,71,-2,29,24.4,-3,5,0,9,-5,0,0,9
"3893",2019-03-12,"Cement Creek","w1819","Non.motorized",1,"Tue","weekday","no_sled","3","3","3",17.4,0.1,70,-1,32,24.9,-2,-3,5,0,-3,-6,-1,-1
"3894",2019-03-12,"Cement Creek","w1819","Non.motorized",1,"Tue","weekday","no_sled","4","4","4",17.4,0.1,70,-1,32,24.9,-2,-3,5,0,-3,-6,-1,-1
"3895",2019-03-12,"Cement Creek","w1819","Mechanized",0,"Tue","weekday","no_sled","3","3","3",17.4,0.1,70,-1,32,24.9,-2,-3,5,0,-3,-6,-1,-1
"3896",2019-03-12,"Cement Creek","w1819","Mechanized",0,"Tue","weekday","no_sled","4","4","4",17.4,0.1,70,-1,32,24.9,-2,-3,5,0,-3,-6,-1,-1
"3897",2019-03-12,"Cement Creek","w1819","Motorized",2,"Tue","weekday","sled","3","3","3",17.4,0.1,70,-1,32,24.9,-2,-3,5,0,-3,-6,-1,-1
"3898",2019-03-12,"Cement Creek","w1819","Motorized",2,"Tue","weekday","sled","4","4","4",17.4,0.1,70,-1,32,24.9,-2,-3,5,0,-3,-6,-1,-1
"3899",2019-03-12,"Cement Creek","w1819","Hybrid",0,"Tue","weekday","sled","3","3","3",17.4,0.1,70,-1,32,24.9,-2,-3,5,0,-3,-6,-1,-1
"3900",2019-03-12,"Cement Creek","w1819","Hybrid",0,"Tue","weekday","sled","4","4","4",17.4,0.1,70,-1,32,24.9,-2,-3,5,0,-3,-6,-1,-1
"3901",2019-03-13,"Cement Creek","w1819","Non.motorized",0,"Wed","weekday","no_sled","4","4","3",18.1,0.7,74,4,24,24.5,-1,-2,-3,5,3,1,-2,3
"3902",2019-03-13,"Cement Creek","w1819","Mechanized",0,"Wed","weekday","no_sled","4","4","3",18.1,0.7,74,4,24,24.5,-1,-2,-3,5,3,1,-2,3
"3903",2019-03-13,"Cement Creek","w1819","Motorized",0,"Wed","weekday","sled","4","4","3",18.1,0.7,74,4,24,24.5,-1,-2,-3,5,3,1,-2,3
"3904",2019-03-13,"Cement Creek","w1819","Hybrid",0,"Wed","weekday","sled","4","4","3",18.1,0.7,74,4,24,24.5,-1,-2,-3,5,3,1,-2,3
"3905",2019-03-14,"Cement Creek","w1819","Non.motorized",3,"Thu","weekday","no_sled","4","4","3",18.1,0,74,0,17,24.5,4,-1,-2,-3,4,3,1,-2
"3906",2019-03-14,"Cement Creek","w1819","Mechanized",0,"Thu","weekday","no_sled","4","4","3",18.1,0,74,0,17,24.5,4,-1,-2,-3,4,3,1,-2
"3907",2019-03-14,"Cement Creek","w1819","Motorized",2,"Thu","weekday","sled","4","4","3",18.1,0,74,0,17,24.5,4,-1,-2,-3,4,3,1,-2
"3908",2019-03-14,"Cement Creek","w1819","Hybrid",0,"Thu","weekday","sled","4","4","3",18.1,0,74,0,17,24.5,4,-1,-2,-3,4,3,1,-2
"3909",2019-03-15,"Cement Creek","w1819","Non.motorized",13,"Fri","weekday","no_sled","3","3","2",18.1,0,72,-2,18,25.1,0,4,-1,-2,-2,2,1,-1
"3910",2019-03-15,"Cement Creek","w1819","Mechanized",1,"Fri","weekday","no_sled","3","3","2",18.1,0,72,-2,18,25.1,0,4,-1,-2,-2,2,1,-1
"3911",2019-03-15,"Cement Creek","w1819","Motorized",2,"Fri","weekday","sled","3","3","2",18.1,0,72,-2,18,25.1,0,4,-1,-2,-2,2,1,-1
"3912",2019-03-15,"Cement Creek","w1819","Hybrid",0,"Fri","weekday","sled","3","3","2",18.1,0,72,-2,18,25.1,0,4,-1,-2,-2,2,1,-1
"3913",2019-03-16,"Cement Creek","w1819","Non.motorized",37,"Sat","weekend","no_sled","3","3","2",18.2,0.1,70,-2,26,26,-2,0,4,-1,-4,-4,0,-1
"3914",2019-03-16,"Cement Creek","w1819","Mechanized",0,"Sat","weekend","no_sled","3","3","2",18.2,0.1,70,-2,26,26,-2,0,4,-1,-4,-4,0,-1
"3915",2019-03-16,"Cement Creek","w1819","Motorized",8,"Sat","weekend","sled","3","3","2",18.2,0.1,70,-2,26,26,-2,0,4,-1,-4,-4,0,-1
"3916",2019-03-16,"Cement Creek","w1819","Hybrid",0,"Sat","weekend","sled","3","3","2",18.2,0.1,70,-2,26,26,-2,0,4,-1,-4,-4,0,-1
"3917",2019-03-17,"Cement Creek","w1819","Non.motorized",30,"Sun","weekend","no_sled","3","3","2",18.2,0,69,-1,28,26.4,-2,-2,0,4,-3,-5,-5,-1
"3918",2019-03-17,"Cement Creek","w1819","Mechanized",0,"Sun","weekend","no_sled","3","3","2",18.2,0,69,-1,28,26.4,-2,-2,0,4,-3,-5,-5,-1
"3919",2019-03-17,"Cement Creek","w1819","Motorized",6,"Sun","weekend","sled","3","3","2",18.2,0,69,-1,28,26.4,-2,-2,0,4,-3,-5,-5,-1
"3920",2019-03-17,"Cement Creek","w1819","Hybrid",0,"Sun","weekend","sled","3","3","2",18.2,0,69,-1,28,26.4,-2,-2,0,4,-3,-5,-5,-1
"3921",2019-03-18,"Cement Creek","w1819","Non.motorized",14,"Mon","weekday","no_sled","2","2","2",18.3,0.1,68,-1,29,26.9,-1,-2,-2,0,-2,-4,-6,-6
"3922",2019-03-18,"Cement Creek","w1819","Mechanized",0,"Mon","weekday","no_sled","2","2","2",18.3,0.1,68,-1,29,26.9,-1,-2,-2,0,-2,-4,-6,-6
"3923",2019-03-18,"Cement Creek","w1819","Motorized",1,"Mon","weekday","sled","2","2","2",18.3,0.1,68,-1,29,26.9,-1,-2,-2,0,-2,-4,-6,-6
"3924",2019-03-18,"Cement Creek","w1819","Hybrid",0,"Mon","weekday","sled","2","2","2",18.3,0.1,68,-1,29,26.9,-1,-2,-2,0,-2,-4,-6,-6
"3925",2019-03-19,"Cement Creek","w1819","Non.motorized",12,"Tue","weekday","no_sled","2","2","2",18.3,0,67,-1,28,27.3,-1,-1,-2,-2,-2,-3,-5,-7
"3926",2019-03-19,"Cement Creek","w1819","Mechanized",1,"Tue","weekday","no_sled","2","2","2",18.3,0,67,-1,28,27.3,-1,-1,-2,-2,-2,-3,-5,-7
"3927",2019-03-19,"Cement Creek","w1819","Motorized",4,"Tue","weekday","sled","2","2","2",18.3,0,67,-1,28,27.3,-1,-1,-2,-2,-2,-3,-5,-7
"3928",2019-03-19,"Cement Creek","w1819","Hybrid",0,"Tue","weekday","sled","2","2","2",18.3,0,67,-1,28,27.3,-1,-1,-2,-2,-2,-3,-5,-7
"3929",2019-03-20,"Cement Creek","w1819","Non.motorized",6,"Wed","weekday","no_sled","2","2","2",18.3,0,66,-1,30,27.7,-1,-1,-1,-2,-2,-3,-4,-6
"3930",2019-03-20,"Cement Creek","w1819","Mechanized",0,"Wed","weekday","no_sled","2","2","2",18.3,0,66,-1,30,27.7,-1,-1,-1,-2,-2,-3,-4,-6
"3931",2019-03-20,"Cement Creek","w1819","Motorized",2,"Wed","weekday","sled","2","2","2",18.3,0,66,-1,30,27.7,-1,-1,-1,-2,-2,-3,-4,-6
"3932",2019-03-20,"Cement Creek","w1819","Hybrid",0,"Wed","weekday","sled","2","2","2",18.3,0,66,-1,30,27.7,-1,-1,-1,-2,-2,-3,-4,-6
"3933",2019-03-21,"Cement Creek","w1819","Non.motorized",6,"Thu","weekday","no_sled","2","2","2",18.4,0.1,65,-1,33,28.3,-1,-1,-1,-1,-2,-3,-4,-5
"3934",2019-03-21,"Cement Creek","w1819","Mechanized",0,"Thu","weekday","no_sled","2","2","2",18.4,0.1,65,-1,33,28.3,-1,-1,-1,-1,-2,-3,-4,-5
"3935",2019-03-21,"Cement Creek","w1819","Motorized",3,"Thu","weekday","sled","2","2","2",18.4,0.1,65,-1,33,28.3,-1,-1,-1,-1,-2,-3,-4,-5
"3936",2019-03-21,"Cement Creek","w1819","Hybrid",0,"Thu","weekday","sled","2","2","2",18.4,0.1,65,-1,33,28.3,-1,-1,-1,-1,-2,-3,-4,-5
"3937",2019-03-22,"Cement Creek","w1819","Non.motorized",13,"Fri","weekday","no_sled","3","3","2",18.4,0,64,-1,28,28.8,-1,-1,-1,-1,-2,-3,-4,-5
"3938",2019-03-22,"Cement Creek","w1819","Mechanized",0,"Fri","weekday","no_sled","3","3","2",18.4,0,64,-1,28,28.8,-1,-1,-1,-1,-2,-3,-4,-5
"3939",2019-03-22,"Cement Creek","w1819","Motorized",5,"Fri","weekday","sled","3","3","2",18.4,0,64,-1,28,28.8,-1,-1,-1,-1,-2,-3,-4,-5
"3940",2019-03-22,"Cement Creek","w1819","Hybrid",0,"Fri","weekday","sled","3","3","2",18.4,0,64,-1,28,28.8,-1,-1,-1,-1,-2,-3,-4,-5
"3941",2019-03-23,"Cement Creek","w1819","Non.motorized",35,"Sat","weekend","no_sled","2","2","1",18.4,0,65,1,28,28.3,-1,-1,-1,-1,0,-1,-2,-3
"3942",2019-03-23,"Cement Creek","w1819","Mechanized",0,"Sat","weekend","no_sled","2","2","1",18.4,0,65,1,28,28.3,-1,-1,-1,-1,0,-1,-2,-3
"3943",2019-03-23,"Cement Creek","w1819","Motorized",7,"Sat","weekend","sled","2","2","1",18.4,0,65,1,28,28.3,-1,-1,-1,-1,0,-1,-2,-3
"3944",2019-03-23,"Cement Creek","w1819","Hybrid",2,"Sat","weekend","sled","2","2","1",18.4,0,65,1,28,28.3,-1,-1,-1,-1,0,-1,-2,-3
"3945",2019-03-24,"Cement Creek","w1819","Non.motorized",28,"Sun","weekend","no_sled","2","2","1",18.4,0,64,-1,29,28.8,1,-1,-1,-1,0,-1,-2,-3
"3946",2019-03-24,"Cement Creek","w1819","Mechanized",4,"Sun","weekend","no_sled","2","2","1",18.4,0,64,-1,29,28.8,1,-1,-1,-1,0,-1,-2,-3
"3947",2019-03-24,"Cement Creek","w1819","Motorized",1,"Sun","weekend","sled","2","2","1",18.4,0,64,-1,29,28.8,1,-1,-1,-1,0,-1,-2,-3
"3948",2019-03-24,"Cement Creek","w1819","Hybrid",0,"Sun","weekend","sled","2","2","1",18.4,0,64,-1,29,28.8,1,-1,-1,-1,0,-1,-2,-3
"3949",2019-03-25,"Cement Creek","w1819","Non.motorized",13,"Mon","weekday","no_sled","2","2","2",18.6,0.2,64,0,31,29.1,-1,1,-1,-1,-1,0,-1,-2
"3950",2019-03-25,"Cement Creek","w1819","Mechanized",0,"Mon","weekday","no_sled","2","2","2",18.6,0.2,64,0,31,29.1,-1,1,-1,-1,-1,0,-1,-2
"3951",2019-03-25,"Cement Creek","w1819","Motorized",4,"Mon","weekday","sled","2","2","2",18.6,0.2,64,0,31,29.1,-1,1,-1,-1,-1,0,-1,-2
"3952",2019-03-25,"Cement Creek","w1819","Hybrid",0,"Mon","weekday","sled","2","2","2",18.6,0.2,64,0,31,29.1,-1,1,-1,-1,-1,0,-1,-2
"3953",2019-03-26,"Cement Creek","w1819","Non.motorized",6,"Tue","weekday","no_sled","2","2","2",18.9,0.3,63,-1,36,30,0,-1,1,-1,-1,-2,-1,-2
"3954",2019-03-26,"Cement Creek","w1819","Mechanized",0,"Tue","weekday","no_sled","2","2","2",18.9,0.3,63,-1,36,30,0,-1,1,-1,-1,-2,-1,-2
"3955",2019-03-26,"Cement Creek","w1819","Motorized",5,"Tue","weekday","sled","2","2","2",18.9,0.3,63,-1,36,30,0,-1,1,-1,-1,-2,-1,-2
"3956",2019-03-26,"Cement Creek","w1819","Hybrid",0,"Tue","weekday","sled","2","2","2",18.9,0.3,63,-1,36,30,0,-1,1,-1,-1,-2,-1,-2
"3957",2019-03-27,"Cement Creek","w1819","Non.motorized",20,"Wed","weekday","no_sled","1","2","2",18.9,0,62,-1,42,30.5,-1,0,-1,1,-2,-2,-3,-2
"3958",2019-03-27,"Cement Creek","w1819","Mechanized",0,"Wed","weekday","no_sled","1","2","2",18.9,0,62,-1,42,30.5,-1,0,-1,1,-2,-2,-3,-2
"3959",2019-03-27,"Cement Creek","w1819","Motorized",6,"Wed","weekday","sled","1","2","2",18.9,0,62,-1,42,30.5,-1,0,-1,1,-2,-2,-3,-2
"3960",2019-03-27,"Cement Creek","w1819","Hybrid",0,"Wed","weekday","sled","1","2","2",18.9,0,62,-1,42,30.5,-1,0,-1,1,-2,-2,-3,-2
"3961",2019-03-28,"Cement Creek","w1819","Non.motorized",17,"Thu","weekday","no_sled","1","2","2",18.9,0,60,-2,40,31.5,-1,-1,0,-1,-3,-4,-4,-5
"3962",2019-03-28,"Cement Creek","w1819","Mechanized",0,"Thu","weekday","no_sled","1","2","2",18.9,0,60,-2,40,31.5,-1,-1,0,-1,-3,-4,-4,-5
"3963",2019-03-28,"Cement Creek","w1819","Motorized",1,"Thu","weekday","sled","1","2","2",18.9,0,60,-2,40,31.5,-1,-1,0,-1,-3,-4,-4,-5
"3964",2019-03-28,"Cement Creek","w1819","Hybrid",0,"Thu","weekday","sled","1","2","2",18.9,0,60,-2,40,31.5,-1,-1,0,-1,-3,-4,-4,-5
"3965",2019-03-29,"Cement Creek","w1819","Non.motorized",19,"Fri","weekday","no_sled","1","1","1",19,0.1,58,-2,26,32.8,-2,-1,-1,0,-4,-5,-6,-6
"3966",2019-03-29,"Cement Creek","w1819","Mechanized",1,"Fri","weekday","no_sled","1","1","1",19,0.1,58,-2,26,32.8,-2,-1,-1,0,-4,-5,-6,-6
"3967",2019-03-29,"Cement Creek","w1819","Motorized",1,"Fri","weekday","sled","1","1","1",19,0.1,58,-2,26,32.8,-2,-1,-1,0,-4,-5,-6,-6
"3968",2019-03-29,"Cement Creek","w1819","Hybrid",0,"Fri","weekday","sled","1","1","1",19,0.1,58,-2,26,32.8,-2,-1,-1,0,-4,-5,-6,-6
"3969",2019-03-30,"Cement Creek","w1819","Non.motorized",35,"Sat","weekend","no_sled","1","1","1",19.1,0.1,61,3,24,31.3,-2,-2,-1,-1,1,-1,-2,-3
"3970",2019-03-30,"Cement Creek","w1819","Mechanized",0,"Sat","weekend","no_sled","1","1","1",19.1,0.1,61,3,24,31.3,-2,-2,-1,-1,1,-1,-2,-3
"3971",2019-03-30,"Cement Creek","w1819","Motorized",1,"Sat","weekend","sled","1","1","1",19.1,0.1,61,3,24,31.3,-2,-2,-1,-1,1,-1,-2,-3
"3972",2019-03-30,"Cement Creek","w1819","Hybrid",0,"Sat","weekend","sled","1","1","1",19.1,0.1,61,3,24,31.3,-2,-2,-1,-1,1,-1,-2,-3
"3973",2019-03-31,"Cement Creek","w1819","Non.motorized",13,"Sun","weekend","no_sled","1","1","1",19.1,0,59,-2,24,32.4,3,-2,-2,-1,1,-1,-3,-4
"3974",2019-03-31,"Cement Creek","w1819","Mechanized",3,"Sun","weekend","no_sled","1","1","1",19.1,0,59,-2,24,32.4,3,-2,-2,-1,1,-1,-3,-4
"3975",2019-03-31,"Cement Creek","w1819","Motorized",2,"Sun","weekend","sled","1","1","1",19.1,0,59,-2,24,32.4,3,-2,-2,-1,1,-1,-3,-4
"3976",2019-03-31,"Cement Creek","w1819","Hybrid",0,"Sun","weekend","sled","1","1","1",19.1,0,59,-2,24,32.4,3,-2,-2,-1,1,-1,-3,-4
"3977",2019-04-01,"Cement Creek","w1819","Non.motorized",13,"Mon","weekday","no_sled","2","1","1",19.1,0,58,-1,29,32.9,-2,3,-2,-2,-3,0,-2,-4
"3978",2019-04-01,"Cement Creek","w1819","Mechanized",0,"Mon","weekday","no_sled","2","1","1",19.1,0,58,-1,29,32.9,-2,3,-2,-2,-3,0,-2,-4
"3979",2019-04-01,"Cement Creek","w1819","Motorized",3,"Mon","weekday","sled","2","1","1",19.1,0,58,-1,29,32.9,-2,3,-2,-2,-3,0,-2,-4
"3980",2019-04-01,"Cement Creek","w1819","Hybrid",0,"Mon","weekday","sled","2","1","1",19.1,0,58,-1,29,32.9,-2,3,-2,-2,-3,0,-2,-4
"3981",2019-04-02,"Cement Creek","w1819","Non.motorized",9,"Tue","weekday","no_sled","1","1","1",19.1,0,58,0,33,32.9,-1,-2,3,-2,-1,-3,0,-2
"3982",2019-04-02,"Cement Creek","w1819","Mechanized",1,"Tue","weekday","no_sled","1","1","1",19.1,0,58,0,33,32.9,-1,-2,3,-2,-1,-3,0,-2
"3983",2019-04-02,"Cement Creek","w1819","Motorized",0,"Tue","weekday","sled","1","1","1",19.1,0,58,0,33,32.9,-1,-2,3,-2,-1,-3,0,-2
"3984",2019-04-02,"Cement Creek","w1819","Hybrid",0,"Tue","weekday","sled","1","1","1",19.1,0,58,0,33,32.9,-1,-2,3,-2,-1,-3,0,-2
"3985",2019-04-03,"Cement Creek","w1819","Non.motorized",10,"Wed","weekday","no_sled","2","1","1",19.2,0.1,58,0,31,33.1,0,-1,-2,3,0,-1,-3,0
"3986",2019-04-03,"Cement Creek","w1819","Mechanized",0,"Wed","weekday","no_sled","2","1","1",19.2,0.1,58,0,31,33.1,0,-1,-2,3,0,-1,-3,0
"3987",2019-04-03,"Cement Creek","w1819","Motorized",3,"Wed","weekday","sled","2","1","1",19.2,0.1,58,0,31,33.1,0,-1,-2,3,0,-1,-3,0
"3988",2019-04-03,"Cement Creek","w1819","Hybrid",0,"Wed","weekday","sled","2","1","1",19.2,0.1,58,0,31,33.1,0,-1,-2,3,0,-1,-3,0
"3989",2019-04-04,"Cement Creek","w1819","Non.motorized",8,"Thu","weekday","no_sled","2","1","1",19.4,0.2,59,1,35,32.9,0,0,-1,-2,1,1,0,-2
"3990",2019-04-04,"Cement Creek","w1819","Mechanized",0,"Thu","weekday","no_sled","2","1","1",19.4,0.2,59,1,35,32.9,0,0,-1,-2,1,1,0,-2
"3991",2019-04-04,"Cement Creek","w1819","Motorized",1,"Thu","weekday","sled","2","1","1",19.4,0.2,59,1,35,32.9,0,0,-1,-2,1,1,0,-2
"3992",2019-04-04,"Cement Creek","w1819","Hybrid",0,"Thu","weekday","sled","2","1","1",19.4,0.2,59,1,35,32.9,0,0,-1,-2,1,1,0,-2
"3993",2019-04-05,"Cement Creek","w1819","Non.motorized",11,"Fri","weekday","no_sled","1","1","1",19.4,0,57,-2,38,34,1,0,0,-1,-1,-1,-1,-2
"3994",2019-04-05,"Cement Creek","w1819","Mechanized",5,"Fri","weekday","no_sled","1","1","1",19.4,0,57,-2,38,34,1,0,0,-1,-1,-1,-1,-2
"3995",2019-04-05,"Cement Creek","w1819","Motorized",2,"Fri","weekday","sled","1","1","1",19.4,0,57,-2,38,34,1,0,0,-1,-1,-1,-1,-2
"3996",2019-04-05,"Cement Creek","w1819","Hybrid",0,"Fri","weekday","sled","1","1","1",19.4,0,57,-2,38,34,1,0,0,-1,-1,-1,-1,-2
"3997",2019-04-06,"Cement Creek","w1819","Non.motorized",27,"Sat","weekend","no_sled","1","1","1",19.3,-0.1,57,0,35,33.9,-2,1,0,0,-2,-1,-1,-1
"3998",2019-04-06,"Cement Creek","w1819","Mechanized",2,"Sat","weekend","no_sled","1","1","1",19.3,-0.1,57,0,35,33.9,-2,1,0,0,-2,-1,-1,-1
"3999",2019-04-06,"Cement Creek","w1819","Motorized",5,"Sat","weekend","sled","1","1","1",19.3,-0.1,57,0,35,33.9,-2,1,0,0,-2,-1,-1,-1
"4000",2019-04-06,"Cement Creek","w1819","Hybrid",0,"Sat","weekend","sled","1","1","1",19.3,-0.1,57,0,35,33.9,-2,1,0,0,-2,-1,-1,-1
"4001",2019-04-07,"Cement Creek","w1819","Non.motorized",12,"Sun","weekend","no_sled","1","1","1",19.1,-0.2,57,0,37,33.5,0,-2,1,0,0,-2,-1,-1
"4002",2019-04-07,"Cement Creek","w1819","Mechanized",2,"Sun","weekend","no_sled","1","1","1",19.1,-0.2,57,0,37,33.5,0,-2,1,0,0,-2,-1,-1
"4003",2019-04-07,"Cement Creek","w1819","Motorized",2,"Sun","weekend","sled","1","1","1",19.1,-0.2,57,0,37,33.5,0,-2,1,0,0,-2,-1,-1
"4004",2019-04-07,"Cement Creek","w1819","Hybrid",0,"Sun","weekend","sled","1","1","1",19.1,-0.2,57,0,37,33.5,0,-2,1,0,0,-2,-1,-1
"4005",2019-04-08,"Cement Creek","w1819","Non.motorized",14,"Mon","weekday","no_sled","1","2","2",19.3,0.2,54,-3,41,35.7,0,0,-2,1,-3,-3,-5,-4
"4006",2019-04-08,"Cement Creek","w1819","Mechanized",0,"Mon","weekday","no_sled","1","2","2",19.3,0.2,54,-3,41,35.7,0,0,-2,1,-3,-3,-5,-4
"4007",2019-04-08,"Cement Creek","w1819","Motorized",1,"Mon","weekday","sled","1","2","2",19.3,0.2,54,-3,41,35.7,0,0,-2,1,-3,-3,-5,-4
"4008",2019-04-08,"Cement Creek","w1819","Hybrid",0,"Mon","weekday","sled","1","2","2",19.3,0.2,54,-3,41,35.7,0,0,-2,1,-3,-3,-5,-4
"4009",2019-04-09,"Cement Creek","w1819","Non.motorized",6,"Tue","weekday","no_sled","1","2","2",19.3,0,53,-1,43,36.4,-3,0,0,-2,-4,-4,-4,-6
"4010",2019-04-09,"Cement Creek","w1819","Mechanized",0,"Tue","weekday","no_sled","1","2","2",19.3,0,53,-1,43,36.4,-3,0,0,-2,-4,-4,-4,-6
"4011",2019-04-09,"Cement Creek","w1819","Motorized",2,"Tue","weekday","sled","1","2","2",19.3,0,53,-1,43,36.4,-3,0,0,-2,-4,-4,-4,-6
"4012",2019-04-09,"Cement Creek","w1819","Hybrid",0,"Tue","weekday","sled","1","2","2",19.3,0,53,-1,43,36.4,-3,0,0,-2,-4,-4,-4,-6
"4013",2019-04-10,"Cement Creek","w1819","Non.motorized",2,"Wed","weekday","no_sled","2","2","1",19,-0.3,51,-2,30,37.3,-1,-3,0,0,-3,-6,-6,-6
"4014",2019-04-10,"Cement Creek","w1819","Mechanized",0,"Wed","weekday","no_sled","2","2","1",19,-0.3,51,-2,30,37.3,-1,-3,0,0,-3,-6,-6,-6
"4015",2019-04-10,"Cement Creek","w1819","Motorized",0,"Wed","weekday","sled","2","2","1",19,-0.3,51,-2,30,37.3,-1,-3,0,0,-3,-6,-6,-6
"4016",2019-04-10,"Cement Creek","w1819","Hybrid",0,"Wed","weekday","sled","2","2","1",19,-0.3,51,-2,30,37.3,-1,-3,0,0,-3,-6,-6,-6
"4017",2019-04-11,"Cement Creek","w1819","Non.motorized",4,"Thu","weekday","no_sled","3","3","2",18.9,-0.1,53,2,20,35.7,-2,-1,-3,0,0,-1,-4,-4
"4018",2019-04-11,"Cement Creek","w1819","Mechanized",0,"Thu","weekday","no_sled","3","3","2",18.9,-0.1,53,2,20,35.7,-2,-1,-3,0,0,-1,-4,-4
"4019",2019-04-11,"Cement Creek","w1819","Motorized",4,"Thu","weekday","sled","3","3","2",18.9,-0.1,53,2,20,35.7,-2,-1,-3,0,0,-1,-4,-4
"4020",2019-04-11,"Cement Creek","w1819","Hybrid",0,"Thu","weekday","sled","3","3","2",18.9,-0.1,53,2,20,35.7,-2,-1,-3,0,0,-1,-4,-4
"4021",2019-04-12,"Cement Creek","w1819","Non.motorized",13,"Fri","weekday","no_sled","2","2","1",18.7,-0.2,53,0,24,35.3,2,-2,-1,-3,2,0,-1,-4
"4022",2019-04-12,"Cement Creek","w1819","Mechanized",1,"Fri","weekday","no_sled","2","2","1",18.7,-0.2,53,0,24,35.3,2,-2,-1,-3,2,0,-1,-4
"4023",2019-04-12,"Cement Creek","w1819","Motorized",0,"Fri","weekday","sled","2","2","1",18.7,-0.2,53,0,24,35.3,2,-2,-1,-3,2,0,-1,-4
"4024",2019-04-12,"Cement Creek","w1819","Hybrid",0,"Fri","weekday","sled","2","2","1",18.7,-0.2,53,0,24,35.3,2,-2,-1,-3,2,0,-1,-4
"4025",2019-04-13,"Cement Creek","w1819","Non.motorized",17,"Sat","weekend","no_sled","1","1","1",18.8,0.1,52,-1,27,36.2,0,2,-2,-1,-1,1,-1,-2
"4026",2019-04-13,"Cement Creek","w1819","Mechanized",3,"Sat","weekend","no_sled","1","1","1",18.8,0.1,52,-1,27,36.2,0,2,-2,-1,-1,1,-1,-2
"4027",2019-04-13,"Cement Creek","w1819","Motorized",3,"Sat","weekend","sled","1","1","1",18.8,0.1,52,-1,27,36.2,0,2,-2,-1,-1,1,-1,-2
"4028",2019-04-13,"Cement Creek","w1819","Hybrid",1,"Sat","weekend","sled","1","1","1",18.8,0.1,52,-1,27,36.2,0,2,-2,-1,-1,1,-1,-2
"4029",2019-04-14,"Cement Creek","w1819","Non.motorized",10,"Sun","weekend","no_sled","1","1","1",18.7,-0.1,51,-1,35,36.7,-1,0,2,-2,-2,-2,0,-2
"4030",2019-04-14,"Cement Creek","w1819","Mechanized",1,"Sun","weekend","no_sled","1","1","1",18.7,-0.1,51,-1,35,36.7,-1,0,2,-2,-2,-2,0,-2
"4031",2019-04-14,"Cement Creek","w1819","Motorized",8,"Sun","weekend","sled","1","1","1",18.7,-0.1,51,-1,35,36.7,-1,0,2,-2,-2,-2,0,-2
"4032",2019-04-14,"Cement Creek","w1819","Hybrid",5,"Sun","weekend","sled","1","1","1",18.7,-0.1,51,-1,35,36.7,-1,0,2,-2,-2,-2,0,-2
"4033",2019-04-15,"Cement Creek","w1819","Non.motorized",6,"Mon","weekday","no_sled",NA,NA,NA,18.6,-0.1,50,-1,41,37.2,-1,-1,0,2,-2,-3,-3,-1
"4034",2019-04-15,"Cement Creek","w1819","Mechanized",0,"Mon","weekday","no_sled",NA,NA,NA,18.6,-0.1,50,-1,41,37.2,-1,-1,0,2,-2,-3,-3,-1
"4035",2019-04-15,"Cement Creek","w1819","Motorized",1,"Mon","weekday","sled",NA,NA,NA,18.6,-0.1,50,-1,41,37.2,-1,-1,0,2,-2,-3,-3,-1
"4036",2019-04-15,"Cement Creek","w1819","Hybrid",0,"Mon","weekday","sled",NA,NA,NA,18.6,-0.1,50,-1,41,37.2,-1,-1,0,2,-2,-3,-3,-1
"4037",2018-12-01,"Gothic Rd","w1819","Non.motorized",23,"Sat","weekend","no_sled","3","3","2",3.3,0.2,19,1,16,17.4,0,0,0,0,1,1,1,1
"4038",2018-12-01,"Gothic Rd","w1819","Mechanized",1,"Sat","weekend","no_sled","3","3","2",3.3,0.2,19,1,16,17.4,0,0,0,0,1,1,1,1
"4039",2018-12-01,"Gothic Rd","w1819","Motorized",0,"Sat","weekend","sled","3","3","2",3.3,0.2,19,1,16,17.4,0,0,0,0,1,1,1,1
"4040",2018-12-01,"Gothic Rd","w1819","Hybrid",0,"Sat","weekend","sled","3","3","2",3.3,0.2,19,1,16,17.4,0,0,0,0,1,1,1,1
"4041",2018-12-02,"Gothic Rd","w1819","Non.motorized",25,"Sun","weekend","no_sled","3","3","3",3.3,0,20,1,14,16.5,1,0,0,0,2,2,2,2
"4042",2018-12-02,"Gothic Rd","w1819","Mechanized",0,"Sun","weekend","no_sled","3","3","3",3.3,0,20,1,14,16.5,1,0,0,0,2,2,2,2
"4043",2018-12-02,"Gothic Rd","w1819","Motorized",0,"Sun","weekend","sled","3","3","3",3.3,0,20,1,14,16.5,1,0,0,0,2,2,2,2
"4044",2018-12-02,"Gothic Rd","w1819","Hybrid",0,"Sun","weekend","sled","3","3","3",3.3,0,20,1,14,16.5,1,0,0,0,2,2,2,2
"4045",2018-12-03,"Gothic Rd","w1819","Non.motorized",14,"Mon","weekday","no_sled","3","3","2",3.4,0.1,19,-1,13,17.9,1,1,0,0,0,1,1,1
"4046",2018-12-03,"Gothic Rd","w1819","Mechanized",0,"Mon","weekday","no_sled","3","3","2",3.4,0.1,19,-1,13,17.9,1,1,0,0,0,1,1,1
"4047",2018-12-03,"Gothic Rd","w1819","Motorized",1,"Mon","weekday","sled","3","3","2",3.4,0.1,19,-1,13,17.9,1,1,0,0,0,1,1,1
"4048",2018-12-03,"Gothic Rd","w1819","Hybrid",0,"Mon","weekday","sled","3","3","2",3.4,0.1,19,-1,13,17.9,1,1,0,0,0,1,1,1
"4049",2018-12-04,"Gothic Rd","w1819","Non.motorized",9,"Tue","weekday","no_sled","3","3","2",3.5,0.1,20,1,8,17.5,-1,1,1,0,0,1,2,2
"4050",2018-12-04,"Gothic Rd","w1819","Mechanized",1,"Tue","weekday","no_sled","3","3","2",3.5,0.1,20,1,8,17.5,-1,1,1,0,0,1,2,2
"4051",2018-12-04,"Gothic Rd","w1819","Motorized",1,"Tue","weekday","sled","3","3","2",3.5,0.1,20,1,8,17.5,-1,1,1,0,0,1,2,2
"4052",2018-12-04,"Gothic Rd","w1819","Hybrid",1,"Tue","weekday","sled","3","3","2",3.5,0.1,20,1,8,17.5,-1,1,1,0,0,1,2,2
"4053",2018-12-05,"Gothic Rd","w1819","Non.motorized",19,"Wed","weekday","no_sled","3","3","2",3.5,0,19,-1,21,18.4,1,-1,1,1,0,-1,0,1
"4054",2018-12-05,"Gothic Rd","w1819","Mechanized",0,"Wed","weekday","no_sled","3","3","2",3.5,0,19,-1,21,18.4,1,-1,1,1,0,-1,0,1
"4055",2018-12-05,"Gothic Rd","w1819","Motorized",0,"Wed","weekday","sled","3","3","2",3.5,0,19,-1,21,18.4,1,-1,1,1,0,-1,0,1
"4056",2018-12-05,"Gothic Rd","w1819","Hybrid",0,"Wed","weekday","sled","3","3","2",3.5,0,19,-1,21,18.4,1,-1,1,1,0,-1,0,1
"4057",2018-12-06,"Gothic Rd","w1819","Non.motorized",14,"Thu","weekday","no_sled","2","2","2",3.7,0.2,18,-1,25,20.6,-1,1,-1,1,-2,-1,-2,-1
"4058",2018-12-06,"Gothic Rd","w1819","Mechanized",0,"Thu","weekday","no_sled","2","2","2",3.7,0.2,18,-1,25,20.6,-1,1,-1,1,-2,-1,-2,-1
"4059",2018-12-06,"Gothic Rd","w1819","Motorized",2,"Thu","weekday","sled","2","2","2",3.7,0.2,18,-1,25,20.6,-1,1,-1,1,-2,-1,-2,-1
"4060",2018-12-06,"Gothic Rd","w1819","Hybrid",2,"Thu","weekday","sled","2","2","2",3.7,0.2,18,-1,25,20.6,-1,1,-1,1,-2,-1,-2,-1
"4061",2018-12-07,"Gothic Rd","w1819","Non.motorized",13,"Fri","weekday","no_sled","2","2","2",3.8,0.1,21,3,23,18.1,-1,-1,1,-1,2,1,2,1
"4062",2018-12-07,"Gothic Rd","w1819","Mechanized",0,"Fri","weekday","no_sled","2","2","2",3.8,0.1,21,3,23,18.1,-1,-1,1,-1,2,1,2,1
"4063",2018-12-07,"Gothic Rd","w1819","Motorized",1,"Fri","weekday","sled","2","2","2",3.8,0.1,21,3,23,18.1,-1,-1,1,-1,2,1,2,1
"4064",2018-12-07,"Gothic Rd","w1819","Hybrid",0,"Fri","weekday","sled","2","2","2",3.8,0.1,21,3,23,18.1,-1,-1,1,-1,2,1,2,1
"4065",2018-12-08,"Gothic Rd","w1819","Non.motorized",38,"Sat","weekend","no_sled","2","2","2",3.8,0,20,-1,23,19,3,-1,-1,1,2,1,0,1
"4066",2018-12-08,"Gothic Rd","w1819","Mechanized",5,"Sat","weekend","no_sled","2","2","2",3.8,0,20,-1,23,19,3,-1,-1,1,2,1,0,1
"4067",2018-12-08,"Gothic Rd","w1819","Motorized",1,"Sat","weekend","sled","2","2","2",3.8,0,20,-1,23,19,3,-1,-1,1,2,1,0,1
"4068",2018-12-08,"Gothic Rd","w1819","Hybrid",0,"Sat","weekend","sled","2","2","2",3.8,0,20,-1,23,19,3,-1,-1,1,2,1,0,1
"4069",2018-12-09,"Gothic Rd","w1819","Non.motorized",32,"Sun","weekend","no_sled","2","2","2",3.8,0,20,0,19,19,-1,3,-1,-1,-1,2,1,0
"4070",2018-12-09,"Gothic Rd","w1819","Mechanized",6,"Sun","weekend","no_sled","2","2","2",3.8,0,20,0,19,19,-1,3,-1,-1,-1,2,1,0
"4071",2018-12-09,"Gothic Rd","w1819","Motorized",0,"Sun","weekend","sled","2","2","2",3.8,0,20,0,19,19,-1,3,-1,-1,-1,2,1,0
"4072",2018-12-09,"Gothic Rd","w1819","Hybrid",0,"Sun","weekend","sled","2","2","2",3.8,0,20,0,19,19,-1,3,-1,-1,-1,2,1,0
"4073",2018-12-10,"Gothic Rd","w1819","Non.motorized",12,"Mon","weekday","no_sled","2","2","2",3.8,0,20,0,21,19,0,-1,3,-1,0,-1,2,1
"4074",2018-12-10,"Gothic Rd","w1819","Mechanized",2,"Mon","weekday","no_sled","2","2","2",3.8,0,20,0,21,19,0,-1,3,-1,0,-1,2,1
"4075",2018-12-10,"Gothic Rd","w1819","Motorized",2,"Mon","weekday","sled","2","2","2",3.8,0,20,0,21,19,0,-1,3,-1,0,-1,2,1
"4076",2018-12-10,"Gothic Rd","w1819","Hybrid",0,"Mon","weekday","sled","2","2","2",3.8,0,20,0,21,19,0,-1,3,-1,0,-1,2,1
"4077",2018-12-11,"Gothic Rd","w1819","Non.motorized",18,"Tue","weekday","no_sled","2","2","2",3.9,0.1,19,-1,27,20.5,0,0,-1,3,-1,-1,-2,1
"4078",2018-12-11,"Gothic Rd","w1819","Mechanized",1,"Tue","weekday","no_sled","2","2","2",3.9,0.1,19,-1,27,20.5,0,0,-1,3,-1,-1,-2,1
"4079",2018-12-11,"Gothic Rd","w1819","Motorized",1,"Tue","weekday","sled","2","2","2",3.9,0.1,19,-1,27,20.5,0,0,-1,3,-1,-1,-2,1
"4080",2018-12-11,"Gothic Rd","w1819","Hybrid",0,"Tue","weekday","sled","2","2","2",3.9,0.1,19,-1,27,20.5,0,0,-1,3,-1,-1,-2,1
"4081",2018-12-12,"Gothic Rd","w1819","Non.motorized",13,"Wed","weekday","no_sled","2","2","1",3.9,0,19,0,21,20.5,-1,0,0,-1,-1,-1,-1,-2
"4082",2018-12-12,"Gothic Rd","w1819","Mechanized",1,"Wed","weekday","no_sled","2","2","1",3.9,0,19,0,21,20.5,-1,0,0,-1,-1,-1,-1,-2
"4083",2018-12-12,"Gothic Rd","w1819","Motorized",0,"Wed","weekday","sled","2","2","1",3.9,0,19,0,21,20.5,-1,0,0,-1,-1,-1,-1,-2
"4084",2018-12-12,"Gothic Rd","w1819","Hybrid",0,"Wed","weekday","sled","2","2","1",3.9,0,19,0,21,20.5,-1,0,0,-1,-1,-1,-1,-2
"4085",2018-12-13,"Gothic Rd","w1819","Non.motorized",9,"Thu","weekday","no_sled","3","3","2",4,0.1,21,2,15,19,0,-1,0,0,2,1,1,1
"4086",2018-12-13,"Gothic Rd","w1819","Mechanized",2,"Thu","weekday","no_sled","3","3","2",4,0.1,21,2,15,19,0,-1,0,0,2,1,1,1
"4087",2018-12-13,"Gothic Rd","w1819","Motorized",0,"Thu","weekday","sled","3","3","2",4,0.1,21,2,15,19,0,-1,0,0,2,1,1,1
"4088",2018-12-13,"Gothic Rd","w1819","Hybrid",0,"Thu","weekday","sled","3","3","2",4,0.1,21,2,15,19,0,-1,0,0,2,1,1,1
"4089",2018-12-14,"Gothic Rd","w1819","Non.motorized",0,"Fri","weekday","no_sled","3","3","2",4,0,20,-1,24,20,2,0,-1,0,1,1,0,0
"4090",2018-12-14,"Gothic Rd","w1819","Mechanized",0,"Fri","weekday","no_sled","3","3","2",4,0,20,-1,24,20,2,0,-1,0,1,1,0,0
"4091",2018-12-14,"Gothic Rd","w1819","Motorized",0,"Fri","weekday","sled","3","3","2",4,0,20,-1,24,20,2,0,-1,0,1,1,0,0
"4092",2018-12-14,"Gothic Rd","w1819","Hybrid",0,"Fri","weekday","sled","3","3","2",4,0,20,-1,24,20,2,0,-1,0,1,1,0,0
"4093",2018-12-15,"Gothic Rd","w1819","Non.motorized",9,"Sat","weekend","no_sled","2","2","2",4,0,20,0,29,20,-1,2,0,-1,-1,1,1,0
"4094",2018-12-15,"Gothic Rd","w1819","Mechanized",6,"Sat","weekend","no_sled","2","2","2",4,0,20,0,29,20,-1,2,0,-1,-1,1,1,0
"4095",2018-12-15,"Gothic Rd","w1819","Motorized",1,"Sat","weekend","sled","2","2","2",4,0,20,0,29,20,-1,2,0,-1,-1,1,1,0
"4096",2018-12-15,"Gothic Rd","w1819","Hybrid",1,"Sat","weekend","sled","2","2","2",4,0,20,0,29,20,-1,2,0,-1,-1,1,1,0
"4097",2018-12-16,"Gothic Rd","w1819","Non.motorized",63,"Sun","weekend","no_sled","2","2","2",4.1,0.1,19,-1,28,21.6,0,-1,2,0,-1,-2,0,0
"4098",2018-12-16,"Gothic Rd","w1819","Mechanized",6,"Sun","weekend","no_sled","2","2","2",4.1,0.1,19,-1,28,21.6,0,-1,2,0,-1,-2,0,0
"4099",2018-12-16,"Gothic Rd","w1819","Motorized",0,"Sun","weekend","sled","2","2","2",4.1,0.1,19,-1,28,21.6,0,-1,2,0,-1,-2,0,0
"4100",2018-12-16,"Gothic Rd","w1819","Hybrid",0,"Sun","weekend","sled","2","2","2",4.1,0.1,19,-1,28,21.6,0,-1,2,0,-1,-2,0,0
"4101",2018-12-17,"Gothic Rd","w1819","Non.motorized",16,"Mon","weekday","no_sled","2","2","2",4.1,0,19,0,29,21.6,-1,0,-1,2,-1,-1,-2,0
"4102",2018-12-17,"Gothic Rd","w1819","Mechanized",4,"Mon","weekday","no_sled","2","2","2",4.1,0,19,0,29,21.6,-1,0,-1,2,-1,-1,-2,0
"4103",2018-12-17,"Gothic Rd","w1819","Motorized",0,"Mon","weekday","sled","2","2","2",4.1,0,19,0,29,21.6,-1,0,-1,2,-1,-1,-2,0
"4104",2018-12-17,"Gothic Rd","w1819","Hybrid",0,"Mon","weekday","sled","2","2","2",4.1,0,19,0,29,21.6,-1,0,-1,2,-1,-1,-2,0
"4105",2018-12-18,"Gothic Rd","w1819","Non.motorized",0,"Tue","weekday","no_sled","2","2","2",4.1,0,19,0,27,21.6,0,-1,0,-1,0,-1,-1,-2
"4106",2018-12-18,"Gothic Rd","w1819","Mechanized",0,"Tue","weekday","no_sled","2","2","2",4.1,0,19,0,27,21.6,0,-1,0,-1,0,-1,-1,-2
"4107",2018-12-18,"Gothic Rd","w1819","Motorized",0,"Tue","weekday","sled","2","2","2",4.1,0,19,0,27,21.6,0,-1,0,-1,0,-1,-1,-2
"4108",2018-12-18,"Gothic Rd","w1819","Hybrid",0,"Tue","weekday","sled","2","2","2",4.1,0,19,0,27,21.6,0,-1,0,-1,0,-1,-1,-2
"4109",2018-12-19,"Gothic Rd","w1819","Non.motorized",28,"Wed","weekday","no_sled","2","2","2",4.1,0,19,0,24,21.6,0,0,-1,0,0,0,-1,-1
"4110",2018-12-19,"Gothic Rd","w1819","Mechanized",0,"Wed","weekday","no_sled","2","2","2",4.1,0,19,0,24,21.6,0,0,-1,0,0,0,-1,-1
"4111",2018-12-19,"Gothic Rd","w1819","Motorized",0,"Wed","weekday","sled","2","2","2",4.1,0,19,0,24,21.6,0,0,-1,0,0,0,-1,-1
"4112",2018-12-19,"Gothic Rd","w1819","Hybrid",0,"Wed","weekday","sled","2","2","2",4.1,0,19,0,24,21.6,0,0,-1,0,0,0,-1,-1
"4113",2018-12-20,"Gothic Rd","w1819","Non.motorized",42,"Thu","weekday","no_sled","2","2","1",4.1,0,20,1,25,20.5,0,0,0,-1,1,1,1,0
"4114",2018-12-20,"Gothic Rd","w1819","Mechanized",2,"Thu","weekday","no_sled","2","2","1",4.1,0,20,1,25,20.5,0,0,0,-1,1,1,1,0
"4115",2018-12-20,"Gothic Rd","w1819","Motorized",1,"Thu","weekday","sled","2","2","1",4.1,0,20,1,25,20.5,0,0,0,-1,1,1,1,0
"4116",2018-12-20,"Gothic Rd","w1819","Hybrid",0,"Thu","weekday","sled","2","2","1",4.1,0,20,1,25,20.5,0,0,0,-1,1,1,1,0
"4117",2018-12-21,"Gothic Rd","w1819","Non.motorized",46,"Fri","weekday","no_sled","2","2","1",4.1,0,19,-1,28,21.6,1,0,0,0,0,0,0,0
"4118",2018-12-21,"Gothic Rd","w1819","Mechanized",6,"Fri","weekday","no_sled","2","2","1",4.1,0,19,-1,28,21.6,1,0,0,0,0,0,0,0
"4119",2018-12-21,"Gothic Rd","w1819","Motorized",0,"Fri","weekday","sled","2","2","1",4.1,0,19,-1,28,21.6,1,0,0,0,0,0,0,0
"4120",2018-12-21,"Gothic Rd","w1819","Hybrid",0,"Fri","weekday","sled","2","2","1",4.1,0,19,-1,28,21.6,1,0,0,0,0,0,0,0
"4121",2018-12-22,"Gothic Rd","w1819","Non.motorized",54,"Sat","weekend","no_sled","2","2","1",4.2,0.1,19,0,20,22.1,-1,1,0,0,-1,0,0,0
"4122",2018-12-22,"Gothic Rd","w1819","Mechanized",0,"Sat","weekend","no_sled","2","2","1",4.2,0.1,19,0,20,22.1,-1,1,0,0,-1,0,0,0
"4123",2018-12-22,"Gothic Rd","w1819","Motorized",0,"Sat","weekend","sled","2","2","1",4.2,0.1,19,0,20,22.1,-1,1,0,0,-1,0,0,0
"4124",2018-12-22,"Gothic Rd","w1819","Hybrid",0,"Sat","weekend","sled","2","2","1",4.2,0.1,19,0,20,22.1,-1,1,0,0,-1,0,0,0
"4125",2018-12-23,"Gothic Rd","w1819","Non.motorized",44,"Sun","weekend","no_sled","2","2","1",4.2,0,21,2,19,20,0,-1,1,0,2,1,2,2
"4126",2018-12-23,"Gothic Rd","w1819","Mechanized",4,"Sun","weekend","no_sled","2","2","1",4.2,0,21,2,19,20,0,-1,1,0,2,1,2,2
"4127",2018-12-23,"Gothic Rd","w1819","Motorized",0,"Sun","weekend","sled","2","2","1",4.2,0,21,2,19,20,0,-1,1,0,2,1,2,2
"4128",2018-12-23,"Gothic Rd","w1819","Hybrid",0,"Sun","weekend","sled","2","2","1",4.2,0,21,2,19,20,0,-1,1,0,2,1,2,2
"4129",2018-12-24,"Gothic Rd","w1819","Non.motorized",NA,"Mon","weekday","no_sled","2","2","2",4.3,0.1,20,-1,21,21.5,2,0,-1,1,1,1,0,1
"4130",2018-12-24,"Gothic Rd","w1819","Mechanized",NA,"Mon","weekday","no_sled","2","2","2",4.3,0.1,20,-1,21,21.5,2,0,-1,1,1,1,0,1
"4131",2018-12-24,"Gothic Rd","w1819","Motorized",NA,"Mon","weekday","sled","2","2","2",4.3,0.1,20,-1,21,21.5,2,0,-1,1,1,1,0,1
"4132",2018-12-24,"Gothic Rd","w1819","Hybrid",NA,"Mon","weekday","sled","2","2","2",4.3,0.1,20,-1,21,21.5,2,0,-1,1,1,1,0,1
"4133",2018-12-25,"Gothic Rd","w1819","Non.motorized",NA,"Tue","weekday","no_sled","2","2","2",4.7,0.4,25,5,25,18.8,-1,2,0,-1,4,6,6,5
"4134",2018-12-25,"Gothic Rd","w1819","Mechanized",NA,"Tue","weekday","no_sled","2","2","2",4.7,0.4,25,5,25,18.8,-1,2,0,-1,4,6,6,5
"4135",2018-12-25,"Gothic Rd","w1819","Motorized",NA,"Tue","weekday","sled","2","2","2",4.7,0.4,25,5,25,18.8,-1,2,0,-1,4,6,6,5
"4136",2018-12-25,"Gothic Rd","w1819","Hybrid",NA,"Tue","weekday","sled","2","2","2",4.7,0.4,25,5,25,18.8,-1,2,0,-1,4,6,6,5
"4137",2018-12-26,"Gothic Rd","w1819","Non.motorized",NA,"Wed","weekday","no_sled","3","3","3",4.7,0,23,-2,24,20.4,5,-1,2,0,3,2,4,4
"4138",2018-12-26,"Gothic Rd","w1819","Mechanized",NA,"Wed","weekday","no_sled","3","3","3",4.7,0,23,-2,24,20.4,5,-1,2,0,3,2,4,4
"4139",2018-12-26,"Gothic Rd","w1819","Motorized",NA,"Wed","weekday","sled","3","3","3",4.7,0,23,-2,24,20.4,5,-1,2,0,3,2,4,4
"4140",2018-12-26,"Gothic Rd","w1819","Hybrid",NA,"Wed","weekday","sled","3","3","3",4.7,0,23,-2,24,20.4,5,-1,2,0,3,2,4,4
"4141",2018-12-27,"Gothic Rd","w1819","Non.motorized",NA,"Thu","weekday","no_sled","3","3","2",4.7,0,24,1,12,19.6,-2,5,-1,2,-1,4,3,5
"4142",2018-12-27,"Gothic Rd","w1819","Mechanized",NA,"Thu","weekday","no_sled","3","3","2",4.7,0,24,1,12,19.6,-2,5,-1,2,-1,4,3,5
"4143",2018-12-27,"Gothic Rd","w1819","Motorized",NA,"Thu","weekday","sled","3","3","2",4.7,0,24,1,12,19.6,-2,5,-1,2,-1,4,3,5
"4144",2018-12-27,"Gothic Rd","w1819","Hybrid",NA,"Thu","weekday","sled","3","3","2",4.7,0,24,1,12,19.6,-2,5,-1,2,-1,4,3,5
"4145",2018-12-28,"Gothic Rd","w1819","Non.motorized",1,"Fri","weekday","no_sled","3","3","2",4.7,0,24,0,12,19.6,1,-2,5,-1,1,-1,4,3
"4146",2018-12-28,"Gothic Rd","w1819","Mechanized",0,"Fri","weekday","no_sled","3","3","2",4.7,0,24,0,12,19.6,1,-2,5,-1,1,-1,4,3
"4147",2018-12-28,"Gothic Rd","w1819","Motorized",0,"Fri","weekday","sled","3","3","2",4.7,0,24,0,12,19.6,1,-2,5,-1,1,-1,4,3
"4148",2018-12-28,"Gothic Rd","w1819","Hybrid",0,"Fri","weekday","sled","3","3","2",4.7,0,24,0,12,19.6,1,-2,5,-1,1,-1,4,3
"4149",2018-12-29,"Gothic Rd","w1819","Non.motorized",126,"Sat","weekend","no_sled","3","3","2",4.7,0,24,0,8,19.6,0,1,-2,5,0,1,-1,4
"4150",2018-12-29,"Gothic Rd","w1819","Mechanized",6,"Sat","weekend","no_sled","3","3","2",4.7,0,24,0,8,19.6,0,1,-2,5,0,1,-1,4
"4151",2018-12-29,"Gothic Rd","w1819","Motorized",8,"Sat","weekend","sled","3","3","2",4.7,0,24,0,8,19.6,0,1,-2,5,0,1,-1,4
"4152",2018-12-29,"Gothic Rd","w1819","Hybrid",0,"Sat","weekend","sled","3","3","2",4.7,0,24,0,8,19.6,0,1,-2,5,0,1,-1,4
"4153",2018-12-30,"Gothic Rd","w1819","Non.motorized",79,"Sun","weekend","no_sled","3","3","2",4.7,0,24,0,16,19.6,0,0,1,-2,0,0,1,-1
"4154",2018-12-30,"Gothic Rd","w1819","Mechanized",13,"Sun","weekend","no_sled","3","3","2",4.7,0,24,0,16,19.6,0,0,1,-2,0,0,1,-1
"4155",2018-12-30,"Gothic Rd","w1819","Motorized",0,"Sun","weekend","sled","3","3","2",4.7,0,24,0,16,19.6,0,0,1,-2,0,0,1,-1
"4156",2018-12-30,"Gothic Rd","w1819","Hybrid",0,"Sun","weekend","sled","3","3","2",4.7,0,24,0,16,19.6,0,0,1,-2,0,0,1,-1
"4157",2018-12-31,"Gothic Rd","w1819","Non.motorized",4,"Mon","weekday","no_sled","3","3","3",4.9,0.2,23,-1,14,21.3,0,0,0,1,-1,-1,-1,0
"4158",2018-12-31,"Gothic Rd","w1819","Mechanized",0,"Mon","weekday","no_sled","3","3","3",4.9,0.2,23,-1,14,21.3,0,0,0,1,-1,-1,-1,0
"4159",2018-12-31,"Gothic Rd","w1819","Motorized",0,"Mon","weekday","sled","3","3","3",4.9,0.2,23,-1,14,21.3,0,0,0,1,-1,-1,-1,0
"4160",2018-12-31,"Gothic Rd","w1819","Hybrid",0,"Mon","weekday","sled","3","3","3",4.9,0.2,23,-1,14,21.3,0,0,0,1,-1,-1,-1,0
"4161",2019-01-01,"Gothic Rd","w1819","Non.motorized",60,"Tue","weekday","no_sled","3","3","3",5.1,0.2,29,6,11,17.6,-1,0,0,0,5,5,5,5
"4162",2019-01-01,"Gothic Rd","w1819","Mechanized",3,"Tue","weekday","no_sled","3","3","3",5.1,0.2,29,6,11,17.6,-1,0,0,0,5,5,5,5
"4163",2019-01-01,"Gothic Rd","w1819","Motorized",0,"Tue","weekday","sled","3","3","3",5.1,0.2,29,6,11,17.6,-1,0,0,0,5,5,5,5
"4164",2019-01-01,"Gothic Rd","w1819","Hybrid",0,"Tue","weekday","sled","3","3","3",5.1,0.2,29,6,11,17.6,-1,0,0,0,5,5,5,5
"4165",2019-01-02,"Gothic Rd","w1819","Non.motorized",48,"Wed","weekday","no_sled","3","3","2",5.1,0,28,-1,10,18.2,6,-1,0,0,5,4,4,4
"4166",2019-01-02,"Gothic Rd","w1819","Mechanized",1,"Wed","weekday","no_sled","3","3","2",5.1,0,28,-1,10,18.2,6,-1,0,0,5,4,4,4
"4167",2019-01-02,"Gothic Rd","w1819","Motorized",1,"Wed","weekday","sled","3","3","2",5.1,0,28,-1,10,18.2,6,-1,0,0,5,4,4,4
"4168",2019-01-02,"Gothic Rd","w1819","Hybrid",0,"Wed","weekday","sled","3","3","2",5.1,0,28,-1,10,18.2,6,-1,0,0,5,4,4,4
"4169",2019-01-03,"Gothic Rd","w1819","Non.motorized",53,"Thu","weekday","no_sled","3","3","2",5.1,0,27,-1,22,18.9,-1,6,-1,0,-2,4,3,3
"4170",2019-01-03,"Gothic Rd","w1819","Mechanized",0,"Thu","weekday","no_sled","3","3","2",5.1,0,27,-1,22,18.9,-1,6,-1,0,-2,4,3,3
"4171",2019-01-03,"Gothic Rd","w1819","Motorized",0,"Thu","weekday","sled","3","3","2",5.1,0,27,-1,22,18.9,-1,6,-1,0,-2,4,3,3
"4172",2019-01-03,"Gothic Rd","w1819","Hybrid",0,"Thu","weekday","sled","3","3","2",5.1,0,27,-1,22,18.9,-1,6,-1,0,-2,4,3,3
"4173",2019-01-04,"Gothic Rd","w1819","Non.motorized",7,"Fri","weekday","no_sled","3","3","2",5.3,0.2,26,-1,29,20.4,-1,-1,6,-1,-2,-3,3,2
"4174",2019-01-04,"Gothic Rd","w1819","Mechanized",2,"Fri","weekday","no_sled","3","3","2",5.3,0.2,26,-1,29,20.4,-1,-1,6,-1,-2,-3,3,2
"4175",2019-01-04,"Gothic Rd","w1819","Motorized",0,"Fri","weekday","sled","3","3","2",5.3,0.2,26,-1,29,20.4,-1,-1,6,-1,-2,-3,3,2
"4176",2019-01-04,"Gothic Rd","w1819","Hybrid",0,"Fri","weekday","sled","3","3","2",5.3,0.2,26,-1,29,20.4,-1,-1,6,-1,-2,-3,3,2
"4177",2019-01-05,"Gothic Rd","w1819","Non.motorized",0,"Sat","weekend","no_sled","2","2","2",5.3,0,25,-1,30,21.2,-1,-1,-1,6,-2,-3,-4,2
"4178",2019-01-05,"Gothic Rd","w1819","Mechanized",0,"Sat","weekend","no_sled","2","2","2",5.3,0,25,-1,30,21.2,-1,-1,-1,6,-2,-3,-4,2
"4179",2019-01-05,"Gothic Rd","w1819","Motorized",0,"Sat","weekend","sled","2","2","2",5.3,0,25,-1,30,21.2,-1,-1,-1,6,-2,-3,-4,2
"4180",2019-01-05,"Gothic Rd","w1819","Hybrid",0,"Sat","weekend","sled","2","2","2",5.3,0,25,-1,30,21.2,-1,-1,-1,6,-2,-3,-4,2
"4181",2019-01-06,"Gothic Rd","w1819","Non.motorized",0,"Sun","weekend","no_sled","3","3","3",5.3,0,25,0,26,21.2,-1,-1,-1,-1,-1,-2,-3,-4
"4182",2019-01-06,"Gothic Rd","w1819","Mechanized",0,"Sun","weekend","no_sled","3","3","3",5.3,0,25,0,26,21.2,-1,-1,-1,-1,-1,-2,-3,-4
"4183",2019-01-06,"Gothic Rd","w1819","Motorized",0,"Sun","weekend","sled","3","3","3",5.3,0,25,0,26,21.2,-1,-1,-1,-1,-1,-2,-3,-4
"4184",2019-01-06,"Gothic Rd","w1819","Hybrid",0,"Sun","weekend","sled","3","3","3",5.3,0,25,0,26,21.2,-1,-1,-1,-1,-1,-2,-3,-4
"4185",2019-01-07,"Gothic Rd","w1819","Non.motorized",0,"Mon","weekday","no_sled","3","3","3",5.8,0.5,32,7,21,18.1,0,-1,-1,-1,7,6,5,4
"4186",2019-01-07,"Gothic Rd","w1819","Mechanized",0,"Mon","weekday","no_sled","3","3","3",5.8,0.5,32,7,21,18.1,0,-1,-1,-1,7,6,5,4
"4187",2019-01-07,"Gothic Rd","w1819","Motorized",0,"Mon","weekday","sled","3","3","3",5.8,0.5,32,7,21,18.1,0,-1,-1,-1,7,6,5,4
"4188",2019-01-07,"Gothic Rd","w1819","Hybrid",0,"Mon","weekday","sled","3","3","3",5.8,0.5,32,7,21,18.1,0,-1,-1,-1,7,6,5,4
"4189",2019-01-08,"Gothic Rd","w1819","Non.motorized",0,"Tue","weekday","no_sled","3","3","3",5.9,0.1,32,0,24,18.4,7,0,-1,-1,7,7,6,5
"4190",2019-01-08,"Gothic Rd","w1819","Mechanized",0,"Tue","weekday","no_sled","3","3","3",5.9,0.1,32,0,24,18.4,7,0,-1,-1,7,7,6,5
"4191",2019-01-08,"Gothic Rd","w1819","Motorized",0,"Tue","weekday","sled","3","3","3",5.9,0.1,32,0,24,18.4,7,0,-1,-1,7,7,6,5
"4192",2019-01-08,"Gothic Rd","w1819","Hybrid",0,"Tue","weekday","sled","3","3","3",5.9,0.1,32,0,24,18.4,7,0,-1,-1,7,7,6,5
"4193",2019-01-09,"Gothic Rd","w1819","Non.motorized",22,"Wed","weekday","no_sled","3","3","3",6,0.1,30,-2,29,20,0,7,0,-1,-2,5,5,4
"4194",2019-01-09,"Gothic Rd","w1819","Mechanized",0,"Wed","weekday","no_sled","3","3","3",6,0.1,30,-2,29,20,0,7,0,-1,-2,5,5,4
"4195",2019-01-09,"Gothic Rd","w1819","Motorized",0,"Wed","weekday","sled","3","3","3",6,0.1,30,-2,29,20,0,7,0,-1,-2,5,5,4
"4196",2019-01-09,"Gothic Rd","w1819","Hybrid",0,"Wed","weekday","sled","3","3","3",6,0.1,30,-2,29,20,0,7,0,-1,-2,5,5,4
"4197",2019-01-10,"Gothic Rd","w1819","Non.motorized",37,"Thu","weekday","no_sled","3","3","3",6,0,29,-1,29,20.7,-2,0,7,0,-3,-3,4,4
"4198",2019-01-10,"Gothic Rd","w1819","Mechanized",3,"Thu","weekday","no_sled","3","3","3",6,0,29,-1,29,20.7,-2,0,7,0,-3,-3,4,4
"4199",2019-01-10,"Gothic Rd","w1819","Motorized",0,"Thu","weekday","sled","3","3","3",6,0,29,-1,29,20.7,-2,0,7,0,-3,-3,4,4
"4200",2019-01-10,"Gothic Rd","w1819","Hybrid",0,"Thu","weekday","sled","3","3","3",6,0,29,-1,29,20.7,-2,0,7,0,-3,-3,4,4
"4201",2019-01-11,"Gothic Rd","w1819","Non.motorized",47,"Fri","weekday","no_sled","2","2","2",6.1,0.1,29,0,25,21,-1,-2,0,7,-1,-3,-3,4
"4202",2019-01-11,"Gothic Rd","w1819","Mechanized",2,"Fri","weekday","no_sled","2","2","2",6.1,0.1,29,0,25,21,-1,-2,0,7,-1,-3,-3,4
"4203",2019-01-11,"Gothic Rd","w1819","Motorized",0,"Fri","weekday","sled","2","2","2",6.1,0.1,29,0,25,21,-1,-2,0,7,-1,-3,-3,4
"4204",2019-01-11,"Gothic Rd","w1819","Hybrid",0,"Fri","weekday","sled","2","2","2",6.1,0.1,29,0,25,21,-1,-2,0,7,-1,-3,-3,4
"4205",2019-01-12,"Gothic Rd","w1819","Non.motorized",48,"Sat","weekend","no_sled","3","3","2",6.1,0,28,-1,21,21.8,0,-1,-2,0,-1,-2,-4,-4
"4206",2019-01-12,"Gothic Rd","w1819","Mechanized",1,"Sat","weekend","no_sled","3","3","2",6.1,0,28,-1,21,21.8,0,-1,-2,0,-1,-2,-4,-4
"4207",2019-01-12,"Gothic Rd","w1819","Motorized",0,"Sat","weekend","sled","3","3","2",6.1,0,28,-1,21,21.8,0,-1,-2,0,-1,-2,-4,-4
"4208",2019-01-12,"Gothic Rd","w1819","Hybrid",0,"Sat","weekend","sled","3","3","2",6.1,0,28,-1,21,21.8,0,-1,-2,0,-1,-2,-4,-4
"4209",2019-01-13,"Gothic Rd","w1819","Non.motorized",0,"Sun","weekend","no_sled","2","2","2",6.2,0.1,30,2,18,20.7,-1,0,-1,-2,1,1,0,-2
"4210",2019-01-13,"Gothic Rd","w1819","Mechanized",0,"Sun","weekend","no_sled","2","2","2",6.2,0.1,30,2,18,20.7,-1,0,-1,-2,1,1,0,-2
"4211",2019-01-13,"Gothic Rd","w1819","Motorized",0,"Sun","weekend","sled","2","2","2",6.2,0.1,30,2,18,20.7,-1,0,-1,-2,1,1,0,-2
"4212",2019-01-13,"Gothic Rd","w1819","Hybrid",0,"Sun","weekend","sled","2","2","2",6.2,0.1,30,2,18,20.7,-1,0,-1,-2,1,1,0,-2
"4213",2019-01-14,"Gothic Rd","w1819","Non.motorized",11,"Mon","weekday","no_sled","2","2","2",6.2,0,30,0,18,20.7,2,-1,0,-1,2,1,1,0
"4214",2019-01-14,"Gothic Rd","w1819","Mechanized",0,"Mon","weekday","no_sled","2","2","2",6.2,0,30,0,18,20.7,2,-1,0,-1,2,1,1,0
"4215",2019-01-14,"Gothic Rd","w1819","Motorized",1,"Mon","weekday","sled","2","2","2",6.2,0,30,0,18,20.7,2,-1,0,-1,2,1,1,0
"4216",2019-01-14,"Gothic Rd","w1819","Hybrid",0,"Mon","weekday","sled","2","2","2",6.2,0,30,0,18,20.7,2,-1,0,-1,2,1,1,0
"4217",2019-01-15,"Gothic Rd","w1819","Non.motorized",40,"Tue","weekday","no_sled","2","2","2",6.2,0,29,-1,24,21.4,0,2,-1,0,-1,1,0,0
"4218",2019-01-15,"Gothic Rd","w1819","Mechanized",1,"Tue","weekday","no_sled","2","2","2",6.2,0,29,-1,24,21.4,0,2,-1,0,-1,1,0,0
"4219",2019-01-15,"Gothic Rd","w1819","Motorized",0,"Tue","weekday","sled","2","2","2",6.2,0,29,-1,24,21.4,0,2,-1,0,-1,1,0,0
"4220",2019-01-15,"Gothic Rd","w1819","Hybrid",0,"Tue","weekday","sled","2","2","2",6.2,0,29,-1,24,21.4,0,2,-1,0,-1,1,0,0
"4221",2019-01-16,"Gothic Rd","w1819","Non.motorized",9,"Wed","weekday","no_sled","4","4","3",6.3,0.1,29,0,26,21.7,-1,0,2,-1,-1,-1,1,0
"4222",2019-01-16,"Gothic Rd","w1819","Mechanized",0,"Wed","weekday","no_sled","4","4","3",6.3,0.1,29,0,26,21.7,-1,0,2,-1,-1,-1,1,0
"4223",2019-01-16,"Gothic Rd","w1819","Motorized",0,"Wed","weekday","sled","4","4","3",6.3,0.1,29,0,26,21.7,-1,0,2,-1,-1,-1,1,0
"4224",2019-01-16,"Gothic Rd","w1819","Hybrid",0,"Wed","weekday","sled","4","4","3",6.3,0.1,29,0,26,21.7,-1,0,2,-1,-1,-1,1,0
"4225",2019-01-17,"Gothic Rd","w1819","Non.motorized",14,"Thu","weekday","no_sled","3","3","2",7,0.7,38,9,28,18.4,0,-1,0,2,9,8,8,10
"4226",2019-01-17,"Gothic Rd","w1819","Mechanized",0,"Thu","weekday","no_sled","3","3","2",7,0.7,38,9,28,18.4,0,-1,0,2,9,8,8,10
"4227",2019-01-17,"Gothic Rd","w1819","Motorized",0,"Thu","weekday","sled","3","3","2",7,0.7,38,9,28,18.4,0,-1,0,2,9,8,8,10
"4228",2019-01-17,"Gothic Rd","w1819","Hybrid",0,"Thu","weekday","sled","3","3","2",7,0.7,38,9,28,18.4,0,-1,0,2,9,8,8,10
"4229",2019-01-18,"Gothic Rd","w1819","Non.motorized",1,"Fri","weekday","no_sled","4","4","4",7.5,0.5,41,3,22,18.3,9,0,-1,0,12,12,11,11
"4230",2019-01-18,"Gothic Rd","w1819","Mechanized",0,"Fri","weekday","no_sled","4","4","4",7.5,0.5,41,3,22,18.3,9,0,-1,0,12,12,11,11
"4231",2019-01-18,"Gothic Rd","w1819","Motorized",0,"Fri","weekday","sled","4","4","4",7.5,0.5,41,3,22,18.3,9,0,-1,0,12,12,11,11
"4232",2019-01-18,"Gothic Rd","w1819","Hybrid",0,"Fri","weekday","sled","4","4","4",7.5,0.5,41,3,22,18.3,9,0,-1,0,12,12,11,11
"4233",2019-01-19,"Gothic Rd","w1819","Non.motorized",105,"Sat","weekend","no_sled","3","3","3",7.8,0.3,43,2,20,18.1,3,9,0,-1,5,14,14,13
"4234",2019-01-19,"Gothic Rd","w1819","Mechanized",0,"Sat","weekend","no_sled","3","3","3",7.8,0.3,43,2,20,18.1,3,9,0,-1,5,14,14,13
"4235",2019-01-19,"Gothic Rd","w1819","Motorized",2,"Sat","weekend","sled","3","3","3",7.8,0.3,43,2,20,18.1,3,9,0,-1,5,14,14,13
"4236",2019-01-19,"Gothic Rd","w1819","Hybrid",0,"Sat","weekend","sled","3","3","3",7.8,0.3,43,2,20,18.1,3,9,0,-1,5,14,14,13
"4237",2019-01-20,"Gothic Rd","w1819","Non.motorized",137,"Sun","weekend","no_sled","3","3","3",7.9,0.1,41,-2,27,19.3,2,3,9,0,0,3,12,12
"4238",2019-01-20,"Gothic Rd","w1819","Mechanized",3,"Sun","weekend","no_sled","3","3","3",7.9,0.1,41,-2,27,19.3,2,3,9,0,0,3,12,12
"4239",2019-01-20,"Gothic Rd","w1819","Motorized",12,"Sun","weekend","sled","3","3","3",7.9,0.1,41,-2,27,19.3,2,3,9,0,0,3,12,12
"4240",2019-01-20,"Gothic Rd","w1819","Hybrid",0,"Sun","weekend","sled","3","3","3",7.9,0.1,41,-2,27,19.3,2,3,9,0,0,3,12,12
"4241",2019-01-21,"Gothic Rd","w1819","Non.motorized",NA,"Mon","weekday","no_sled","3","3","3",7.9,0,39,-2,23,20.3,-2,2,3,9,-4,-2,1,10
"4242",2019-01-21,"Gothic Rd","w1819","Mechanized",NA,"Mon","weekday","no_sled","3","3","3",7.9,0,39,-2,23,20.3,-2,2,3,9,-4,-2,1,10
"4243",2019-01-21,"Gothic Rd","w1819","Motorized",NA,"Mon","weekday","sled","3","3","3",7.9,0,39,-2,23,20.3,-2,2,3,9,-4,-2,1,10
"4244",2019-01-21,"Gothic Rd","w1819","Hybrid",NA,"Mon","weekday","sled","3","3","3",7.9,0,39,-2,23,20.3,-2,2,3,9,-4,-2,1,10
"4245",2019-01-22,"Gothic Rd","w1819","Non.motorized",19,"Tue","weekday","no_sled","3","3","3",8,0.1,41,2,12,19.5,-2,-2,2,3,0,-2,0,3
"4246",2019-01-22,"Gothic Rd","w1819","Mechanized",0,"Tue","weekday","no_sled","3","3","3",8,0.1,41,2,12,19.5,-2,-2,2,3,0,-2,0,3
"4247",2019-01-22,"Gothic Rd","w1819","Motorized",2,"Tue","weekday","sled","3","3","3",8,0.1,41,2,12,19.5,-2,-2,2,3,0,-2,0,3
"4248",2019-01-22,"Gothic Rd","w1819","Hybrid",0,"Tue","weekday","sled","3","3","3",8,0.1,41,2,12,19.5,-2,-2,2,3,0,-2,0,3
"4249",2019-01-23,"Gothic Rd","w1819","Non.motorized",17,"Wed","weekday","no_sled","3","3","2",8,0,40,-1,14,20,2,-2,-2,2,1,-1,-3,-1
"4250",2019-01-23,"Gothic Rd","w1819","Mechanized",0,"Wed","weekday","no_sled","3","3","2",8,0,40,-1,14,20,2,-2,-2,2,1,-1,-3,-1
"4251",2019-01-23,"Gothic Rd","w1819","Motorized",0,"Wed","weekday","sled","3","3","2",8,0,40,-1,14,20,2,-2,-2,2,1,-1,-3,-1
"4252",2019-01-23,"Gothic Rd","w1819","Hybrid",0,"Wed","weekday","sled","3","3","2",8,0,40,-1,14,20,2,-2,-2,2,1,-1,-3,-1
"4253",2019-01-24,"Gothic Rd","w1819","Non.motorized",8,"Thu","weekday","no_sled","3","3","2",8.2,0.2,40,0,17,20.5,-1,2,-2,-2,-1,1,-1,-3
"4254",2019-01-24,"Gothic Rd","w1819","Mechanized",12,"Thu","weekday","no_sled","3","3","2",8.2,0.2,40,0,17,20.5,-1,2,-2,-2,-1,1,-1,-3
"4255",2019-01-24,"Gothic Rd","w1819","Motorized",1,"Thu","weekday","sled","3","3","2",8.2,0.2,40,0,17,20.5,-1,2,-2,-2,-1,1,-1,-3
"4256",2019-01-24,"Gothic Rd","w1819","Hybrid",0,"Thu","weekday","sled","3","3","2",8.2,0.2,40,0,17,20.5,-1,2,-2,-2,-1,1,-1,-3
"4257",2019-01-25,"Gothic Rd","w1819","Non.motorized",38,"Fri","weekday","no_sled","3","3","2",8.3,0.1,40,0,15,20.8,0,-1,2,-2,0,-1,1,-1
"4258",2019-01-25,"Gothic Rd","w1819","Mechanized",50,"Fri","weekday","no_sled","3","3","2",8.3,0.1,40,0,15,20.8,0,-1,2,-2,0,-1,1,-1
"4259",2019-01-25,"Gothic Rd","w1819","Motorized",0,"Fri","weekday","sled","3","3","2",8.3,0.1,40,0,15,20.8,0,-1,2,-2,0,-1,1,-1
"4260",2019-01-25,"Gothic Rd","w1819","Hybrid",0,"Fri","weekday","sled","3","3","2",8.3,0.1,40,0,15,20.8,0,-1,2,-2,0,-1,1,-1
"4261",2019-01-26,"Gothic Rd","w1819","Non.motorized",111,"Sat","weekend","no_sled","3","3","2",8.3,0,39,-1,19,21.3,0,0,-1,2,-1,-1,-2,0
"4262",2019-01-26,"Gothic Rd","w1819","Mechanized",6,"Sat","weekend","no_sled","3","3","2",8.3,0,39,-1,19,21.3,0,0,-1,2,-1,-1,-2,0
"4263",2019-01-26,"Gothic Rd","w1819","Motorized",3,"Sat","weekend","sled","3","3","2",8.3,0,39,-1,19,21.3,0,0,-1,2,-1,-1,-2,0
"4264",2019-01-26,"Gothic Rd","w1819","Hybrid",0,"Sat","weekend","sled","3","3","2",8.3,0,39,-1,19,21.3,0,0,-1,2,-1,-1,-2,0
"4265",2019-01-27,"Gothic Rd","w1819","Non.motorized",61,"Sun","weekend","no_sled","3","3","2",8.3,0,38,-1,24,21.8,-1,0,0,-1,-2,-2,-2,-3
"4266",2019-01-27,"Gothic Rd","w1819","Mechanized",2,"Sun","weekend","no_sled","3","3","2",8.3,0,38,-1,24,21.8,-1,0,0,-1,-2,-2,-2,-3
"4267",2019-01-27,"Gothic Rd","w1819","Motorized",0,"Sun","weekend","sled","3","3","2",8.3,0,38,-1,24,21.8,-1,0,0,-1,-2,-2,-2,-3
"4268",2019-01-27,"Gothic Rd","w1819","Hybrid",0,"Sun","weekend","sled","3","3","2",8.3,0,38,-1,24,21.8,-1,0,0,-1,-2,-2,-2,-3
"4269",2019-01-28,"Gothic Rd","w1819","Non.motorized",3,"Mon","weekday","no_sled","2","2","2",8.3,0,38,0,17,21.8,-1,-1,0,0,-1,-2,-2,-2
"4270",2019-01-28,"Gothic Rd","w1819","Mechanized",0,"Mon","weekday","no_sled","2","2","2",8.3,0,38,0,17,21.8,-1,-1,0,0,-1,-2,-2,-2
"4271",2019-01-28,"Gothic Rd","w1819","Motorized",0,"Mon","weekday","sled","2","2","2",8.3,0,38,0,17,21.8,-1,-1,0,0,-1,-2,-2,-2
"4272",2019-01-28,"Gothic Rd","w1819","Hybrid",0,"Mon","weekday","sled","2","2","2",8.3,0,38,0,17,21.8,-1,-1,0,0,-1,-2,-2,-2
"4273",2019-01-29,"Gothic Rd","w1819","Non.motorized",0,"Tue","weekday","no_sled","2","2","2",8.3,0,38,0,16,21.8,0,-1,-1,0,0,-1,-2,-2
"4274",2019-01-29,"Gothic Rd","w1819","Mechanized",0,"Tue","weekday","no_sled","2","2","2",8.3,0,38,0,16,21.8,0,-1,-1,0,0,-1,-2,-2
"4275",2019-01-29,"Gothic Rd","w1819","Motorized",0,"Tue","weekday","sled","2","2","2",8.3,0,38,0,16,21.8,0,-1,-1,0,0,-1,-2,-2
"4276",2019-01-29,"Gothic Rd","w1819","Hybrid",0,"Tue","weekday","sled","2","2","2",8.3,0,38,0,16,21.8,0,-1,-1,0,0,-1,-2,-2
"4277",2019-01-30,"Gothic Rd","w1819","Non.motorized",0,"Wed","weekday","no_sled","2","2","1",8.3,0,37,-1,20,22.4,0,0,-1,-1,-1,-1,-2,-3
"4278",2019-01-30,"Gothic Rd","w1819","Mechanized",0,"Wed","weekday","no_sled","2","2","1",8.3,0,37,-1,20,22.4,0,0,-1,-1,-1,-1,-2,-3
"4279",2019-01-30,"Gothic Rd","w1819","Motorized",0,"Wed","weekday","sled","2","2","1",8.3,0,37,-1,20,22.4,0,0,-1,-1,-1,-1,-2,-3
"4280",2019-01-30,"Gothic Rd","w1819","Hybrid",0,"Wed","weekday","sled","2","2","1",8.3,0,37,-1,20,22.4,0,0,-1,-1,-1,-1,-2,-3
"4281",2019-01-31,"Gothic Rd","w1819","Non.motorized",0,"Thu","weekday","no_sled","2","2","1",8.3,0,36,-1,24,23.1,-1,0,0,-1,-2,-2,-2,-3
"4282",2019-01-31,"Gothic Rd","w1819","Mechanized",0,"Thu","weekday","no_sled","2","2","1",8.3,0,36,-1,24,23.1,-1,0,0,-1,-2,-2,-2,-3
"4283",2019-01-31,"Gothic Rd","w1819","Motorized",0,"Thu","weekday","sled","2","2","1",8.3,0,36,-1,24,23.1,-1,0,0,-1,-2,-2,-2,-3
"4284",2019-01-31,"Gothic Rd","w1819","Hybrid",0,"Thu","weekday","sled","2","2","1",8.3,0,36,-1,24,23.1,-1,0,0,-1,-2,-2,-2,-3
"4285",2019-02-01,"Gothic Rd","w1819","Non.motorized",6,"Fri","weekday","no_sled","2","2","1",8.3,0,36,0,25,23.1,-1,-1,0,0,-1,-2,-2,-2
"4286",2019-02-01,"Gothic Rd","w1819","Mechanized",1,"Fri","weekday","no_sled","2","2","1",8.3,0,36,0,25,23.1,-1,-1,0,0,-1,-2,-2,-2
"4287",2019-02-01,"Gothic Rd","w1819","Motorized",0,"Fri","weekday","sled","2","2","1",8.3,0,36,0,25,23.1,-1,-1,0,0,-1,-2,-2,-2
"4288",2019-02-01,"Gothic Rd","w1819","Hybrid",0,"Fri","weekday","sled","2","2","1",8.3,0,36,0,25,23.1,-1,-1,0,0,-1,-2,-2,-2
"4289",2019-02-02,"Gothic Rd","w1819","Non.motorized",72,"Sat","weekend","no_sled","2","2","1",8.3,0,36,0,26,23.1,0,-1,-1,0,0,-1,-2,-2
"4290",2019-02-02,"Gothic Rd","w1819","Mechanized",9,"Sat","weekend","no_sled","2","2","1",8.3,0,36,0,26,23.1,0,-1,-1,0,0,-1,-2,-2
"4291",2019-02-02,"Gothic Rd","w1819","Motorized",0,"Sat","weekend","sled","2","2","1",8.3,0,36,0,26,23.1,0,-1,-1,0,0,-1,-2,-2
"4292",2019-02-02,"Gothic Rd","w1819","Hybrid",0,"Sat","weekend","sled","2","2","1",8.3,0,36,0,26,23.1,0,-1,-1,0,0,-1,-2,-2
"4293",2019-02-03,"Gothic Rd","w1819","Non.motorized",25,"Sun","weekend","no_sled","3","3","2",8.4,0.1,36,0,28,23.3,0,0,-1,-1,0,0,-1,-2
"4294",2019-02-03,"Gothic Rd","w1819","Mechanized",2,"Sun","weekend","no_sled","3","3","2",8.4,0.1,36,0,28,23.3,0,0,-1,-1,0,0,-1,-2
"4295",2019-02-03,"Gothic Rd","w1819","Motorized",0,"Sun","weekend","sled","3","3","2",8.4,0.1,36,0,28,23.3,0,0,-1,-1,0,0,-1,-2
"4296",2019-02-03,"Gothic Rd","w1819","Hybrid",0,"Sun","weekend","sled","3","3","2",8.4,0.1,36,0,28,23.3,0,0,-1,-1,0,0,-1,-2
"4297",2019-02-04,"Gothic Rd","w1819","Non.motorized",22,"Mon","weekday","no_sled","3","3","2",8.8,0.4,39,3,28,22.6,0,0,0,-1,3,3,3,2
"4298",2019-02-04,"Gothic Rd","w1819","Mechanized",0,"Mon","weekday","no_sled","3","3","2",8.8,0.4,39,3,28,22.6,0,0,0,-1,3,3,3,2
"4299",2019-02-04,"Gothic Rd","w1819","Motorized",0,"Mon","weekday","sled","3","3","2",8.8,0.4,39,3,28,22.6,0,0,0,-1,3,3,3,2
"4300",2019-02-04,"Gothic Rd","w1819","Hybrid",0,"Mon","weekday","sled","3","3","2",8.8,0.4,39,3,28,22.6,0,0,0,-1,3,3,3,2
"4301",2019-02-05,"Gothic Rd","w1819","Non.motorized",6,"Tue","weekday","no_sled","3","2","2",9,0.2,40,1,26,22.5,3,0,0,0,4,4,4,4
"4302",2019-02-05,"Gothic Rd","w1819","Mechanized",0,"Tue","weekday","no_sled","3","2","2",9,0.2,40,1,26,22.5,3,0,0,0,4,4,4,4
"4303",2019-02-05,"Gothic Rd","w1819","Motorized",0,"Tue","weekday","sled","3","2","2",9,0.2,40,1,26,22.5,3,0,0,0,4,4,4,4
"4304",2019-02-05,"Gothic Rd","w1819","Hybrid",0,"Tue","weekday","sled","3","2","2",9,0.2,40,1,26,22.5,3,0,0,0,4,4,4,4
"4305",2019-02-06,"Gothic Rd","w1819","Non.motorized",18,"Wed","weekday","no_sled","4","4","3",9,0,40,0,16,22.5,1,3,0,0,1,4,4,4
"4306",2019-02-06,"Gothic Rd","w1819","Mechanized",0,"Wed","weekday","no_sled","4","4","3",9,0,40,0,16,22.5,1,3,0,0,1,4,4,4
"4307",2019-02-06,"Gothic Rd","w1819","Motorized",0,"Wed","weekday","sled","4","4","3",9,0,40,0,16,22.5,1,3,0,0,1,4,4,4
"4308",2019-02-06,"Gothic Rd","w1819","Hybrid",0,"Wed","weekday","sled","4","4","3",9,0,40,0,16,22.5,1,3,0,0,1,4,4,4
"4309",2019-02-07,"Gothic Rd","w1819","Non.motorized",10,"Thu","weekday","no_sled","3","3","2",9.2,0.2,43,3,4,21.4,0,1,3,0,3,4,7,7
"4310",2019-02-07,"Gothic Rd","w1819","Mechanized",0,"Thu","weekday","no_sled","3","3","2",9.2,0.2,43,3,4,21.4,0,1,3,0,3,4,7,7
"4311",2019-02-07,"Gothic Rd","w1819","Motorized",0,"Thu","weekday","sled","3","3","2",9.2,0.2,43,3,4,21.4,0,1,3,0,3,4,7,7
"4312",2019-02-07,"Gothic Rd","w1819","Hybrid",0,"Thu","weekday","sled","3","3","2",9.2,0.2,43,3,4,21.4,0,1,3,0,3,4,7,7
"4313",2019-02-08,"Gothic Rd","w1819","Non.motorized",24,"Fri","weekday","no_sled","3","2","2",9.2,0,42,-1,10,21.9,3,0,1,3,2,2,3,6
"4314",2019-02-08,"Gothic Rd","w1819","Mechanized",0,"Fri","weekday","no_sled","3","2","2",9.2,0,42,-1,10,21.9,3,0,1,3,2,2,3,6
"4315",2019-02-08,"Gothic Rd","w1819","Motorized",0,"Fri","weekday","sled","3","2","2",9.2,0,42,-1,10,21.9,3,0,1,3,2,2,3,6
"4316",2019-02-08,"Gothic Rd","w1819","Hybrid",0,"Fri","weekday","sled","3","2","2",9.2,0,42,-1,10,21.9,3,0,1,3,2,2,3,6
"4317",2019-02-09,"Gothic Rd","w1819","Non.motorized",59,"Sat","weekend","no_sled","3","2","2",9.2,0,41,-1,20,22.4,-1,3,0,1,-2,1,1,2
"4318",2019-02-09,"Gothic Rd","w1819","Mechanized",2,"Sat","weekend","no_sled","3","2","2",9.2,0,41,-1,20,22.4,-1,3,0,1,-2,1,1,2
"4319",2019-02-09,"Gothic Rd","w1819","Motorized",0,"Sat","weekend","sled","3","2","2",9.2,0,41,-1,20,22.4,-1,3,0,1,-2,1,1,2
"4320",2019-02-09,"Gothic Rd","w1819","Hybrid",0,"Sat","weekend","sled","3","2","2",9.2,0,41,-1,20,22.4,-1,3,0,1,-2,1,1,2
"4321",2019-02-10,"Gothic Rd","w1819","Non.motorized",68,"Sun","weekend","no_sled","2","2","2",9.3,0.1,40,-1,20,23.2,-1,-1,3,0,-2,-3,0,0
"4322",2019-02-10,"Gothic Rd","w1819","Mechanized",5,"Sun","weekend","no_sled","2","2","2",9.3,0.1,40,-1,20,23.2,-1,-1,3,0,-2,-3,0,0
"4323",2019-02-10,"Gothic Rd","w1819","Motorized",0,"Sun","weekend","sled","2","2","2",9.3,0.1,40,-1,20,23.2,-1,-1,3,0,-2,-3,0,0
"4324",2019-02-10,"Gothic Rd","w1819","Hybrid",0,"Sun","weekend","sled","2","2","2",9.3,0.1,40,-1,20,23.2,-1,-1,3,0,-2,-3,0,0
"4325",2019-02-11,"Gothic Rd","w1819","Non.motorized",31,"Mon","weekday","no_sled","2","2","1",9.3,0,40,0,15,23.2,-1,-1,-1,3,-1,-2,-3,0
"4326",2019-02-11,"Gothic Rd","w1819","Mechanized",0,"Mon","weekday","no_sled","2","2","1",9.3,0,40,0,15,23.2,-1,-1,-1,3,-1,-2,-3,0
"4327",2019-02-11,"Gothic Rd","w1819","Motorized",0,"Mon","weekday","sled","2","2","1",9.3,0,40,0,15,23.2,-1,-1,-1,3,-1,-2,-3,0
"4328",2019-02-11,"Gothic Rd","w1819","Hybrid",0,"Mon","weekday","sled","2","2","1",9.3,0,40,0,15,23.2,-1,-1,-1,3,-1,-2,-3,0
"4329",2019-02-12,"Gothic Rd","w1819","Non.motorized",31,"Tue","weekday","no_sled","2","2","1",9.3,0,40,0,18,23.2,0,-1,-1,-1,0,-1,-2,-3
"4330",2019-02-12,"Gothic Rd","w1819","Mechanized",3,"Tue","weekday","no_sled","2","2","1",9.3,0,40,0,18,23.2,0,-1,-1,-1,0,-1,-2,-3
"4331",2019-02-12,"Gothic Rd","w1819","Motorized",0,"Tue","weekday","sled","2","2","1",9.3,0,40,0,18,23.2,0,-1,-1,-1,0,-1,-2,-3
"4332",2019-02-12,"Gothic Rd","w1819","Hybrid",0,"Tue","weekday","sled","2","2","1",9.3,0,40,0,18,23.2,0,-1,-1,-1,0,-1,-2,-3
"4333",2019-02-13,"Gothic Rd","w1819","Non.motorized",21,"Wed","weekday","no_sled","2","2","1",9.4,0.1,40,0,26,23.5,0,0,-1,-1,0,0,-1,-2
"4334",2019-02-13,"Gothic Rd","w1819","Mechanized",2,"Wed","weekday","no_sled","2","2","1",9.4,0.1,40,0,26,23.5,0,0,-1,-1,0,0,-1,-2
"4335",2019-02-13,"Gothic Rd","w1819","Motorized",0,"Wed","weekday","sled","2","2","1",9.4,0.1,40,0,26,23.5,0,0,-1,-1,0,0,-1,-2
"4336",2019-02-13,"Gothic Rd","w1819","Hybrid",0,"Wed","weekday","sled","2","2","1",9.4,0.1,40,0,26,23.5,0,0,-1,-1,0,0,-1,-2
"4337",2019-02-14,"Gothic Rd","w1819","Non.motorized",19,"Thu","weekday","no_sled","3","2","2",9.7,0.3,41,1,29,23.7,0,0,0,-1,1,1,1,0
"4338",2019-02-14,"Gothic Rd","w1819","Mechanized",0,"Thu","weekday","no_sled","3","2","2",9.7,0.3,41,1,29,23.7,0,0,0,-1,1,1,1,0
"4339",2019-02-14,"Gothic Rd","w1819","Motorized",0,"Thu","weekday","sled","3","2","2",9.7,0.3,41,1,29,23.7,0,0,0,-1,1,1,1,0
"4340",2019-02-14,"Gothic Rd","w1819","Hybrid",0,"Thu","weekday","sled","3","2","2",9.7,0.3,41,1,29,23.7,0,0,0,-1,1,1,1,0
"4341",2019-02-15,"Gothic Rd","w1819","Non.motorized",3,"Fri","weekday","no_sled","4","4","3",10.8,1.1,51,10,27,21.2,1,0,0,0,11,11,11,11
"4342",2019-02-15,"Gothic Rd","w1819","Mechanized",0,"Fri","weekday","no_sled","4","4","3",10.8,1.1,51,10,27,21.2,1,0,0,0,11,11,11,11
"4343",2019-02-15,"Gothic Rd","w1819","Motorized",0,"Fri","weekday","sled","4","4","3",10.8,1.1,51,10,27,21.2,1,0,0,0,11,11,11,11
"4344",2019-02-15,"Gothic Rd","w1819","Hybrid",0,"Fri","weekday","sled","4","4","3",10.8,1.1,51,10,27,21.2,1,0,0,0,11,11,11,11
"4345",2019-02-16,"Gothic Rd","w1819","Non.motorized",3,"Sat","weekend","no_sled","3","3","3",11.1,0.3,52,1,14,21.3,10,1,0,0,11,12,12,12
"4346",2019-02-16,"Gothic Rd","w1819","Mechanized",0,"Sat","weekend","no_sled","3","3","3",11.1,0.3,52,1,14,21.3,10,1,0,0,11,12,12,12
"4347",2019-02-16,"Gothic Rd","w1819","Motorized",0,"Sat","weekend","sled","3","3","3",11.1,0.3,52,1,14,21.3,10,1,0,0,11,12,12,12
"4348",2019-02-16,"Gothic Rd","w1819","Hybrid",0,"Sat","weekend","sled","3","3","3",11.1,0.3,52,1,14,21.3,10,1,0,0,11,12,12,12
"4349",2019-02-17,"Gothic Rd","w1819","Non.motorized",38,"Sun","weekend","no_sled","3","3","3",11.3,0.2,55,3,10,20.5,1,10,1,0,4,14,15,15
"4350",2019-02-17,"Gothic Rd","w1819","Mechanized",2,"Sun","weekend","no_sled","3","3","3",11.3,0.2,55,3,10,20.5,1,10,1,0,4,14,15,15
"4351",2019-02-17,"Gothic Rd","w1819","Motorized",0,"Sun","weekend","sled","3","3","3",11.3,0.2,55,3,10,20.5,1,10,1,0,4,14,15,15
"4352",2019-02-17,"Gothic Rd","w1819","Hybrid",0,"Sun","weekend","sled","3","3","3",11.3,0.2,55,3,10,20.5,1,10,1,0,4,14,15,15
"4353",2019-02-18,"Gothic Rd","w1819","Non.motorized",16,"Mon","weekday","no_sled","3","3","2",11.4,0.1,53,-2,13,21.5,3,1,10,1,1,2,12,13
"4354",2019-02-18,"Gothic Rd","w1819","Mechanized",0,"Mon","weekday","no_sled","3","3","2",11.4,0.1,53,-2,13,21.5,3,1,10,1,1,2,12,13
"4355",2019-02-18,"Gothic Rd","w1819","Motorized",0,"Mon","weekday","sled","3","3","2",11.4,0.1,53,-2,13,21.5,3,1,10,1,1,2,12,13
"4356",2019-02-18,"Gothic Rd","w1819","Hybrid",0,"Mon","weekday","sled","3","3","2",11.4,0.1,53,-2,13,21.5,3,1,10,1,1,2,12,13
"4357",2019-02-19,"Gothic Rd","w1819","Non.motorized",13,"Tue","weekday","no_sled","3","3","2",11.5,0.1,53,0,11,21.7,-2,3,1,10,-2,1,2,12
"4358",2019-02-19,"Gothic Rd","w1819","Mechanized",0,"Tue","weekday","no_sled","3","3","2",11.5,0.1,53,0,11,21.7,-2,3,1,10,-2,1,2,12
"4359",2019-02-19,"Gothic Rd","w1819","Motorized",1,"Tue","weekday","sled","3","3","2",11.5,0.1,53,0,11,21.7,-2,3,1,10,-2,1,2,12
"4360",2019-02-19,"Gothic Rd","w1819","Hybrid",0,"Tue","weekday","sled","3","3","2",11.5,0.1,53,0,11,21.7,-2,3,1,10,-2,1,2,12
"4361",2019-02-20,"Gothic Rd","w1819","Non.motorized",15,"Wed","weekday","no_sled","3","3","2",11.6,0.1,53,0,7,21.9,0,-2,3,1,0,-2,1,2
"4362",2019-02-20,"Gothic Rd","w1819","Mechanized",0,"Wed","weekday","no_sled","3","3","2",11.6,0.1,53,0,7,21.9,0,-2,3,1,0,-2,1,2
"4363",2019-02-20,"Gothic Rd","w1819","Motorized",0,"Wed","weekday","sled","3","3","2",11.6,0.1,53,0,7,21.9,0,-2,3,1,0,-2,1,2
"4364",2019-02-20,"Gothic Rd","w1819","Hybrid",0,"Wed","weekday","sled","3","3","2",11.6,0.1,53,0,7,21.9,0,-2,3,1,0,-2,1,2
"4365",2019-02-21,"Gothic Rd","w1819","Non.motorized",24,"Thu","weekday","no_sled","3","3","3",11.6,0,52,-1,15,22.3,0,0,-2,3,-1,-1,-3,0
"4366",2019-02-21,"Gothic Rd","w1819","Mechanized",0,"Thu","weekday","no_sled","3","3","3",11.6,0,52,-1,15,22.3,0,0,-2,3,-1,-1,-3,0
"4367",2019-02-21,"Gothic Rd","w1819","Motorized",0,"Thu","weekday","sled","3","3","3",11.6,0,52,-1,15,22.3,0,0,-2,3,-1,-1,-3,0
"4368",2019-02-21,"Gothic Rd","w1819","Hybrid",0,"Thu","weekday","sled","3","3","3",11.6,0,52,-1,15,22.3,0,0,-2,3,-1,-1,-3,0
"4369",2019-02-22,"Gothic Rd","w1819","Non.motorized",24,"Fri","weekday","no_sled","3","3","3",11.8,0.2,52,0,20,22.7,-1,0,0,-2,-1,-1,-1,-3
"4370",2019-02-22,"Gothic Rd","w1819","Mechanized",0,"Fri","weekday","no_sled","3","3","3",11.8,0.2,52,0,20,22.7,-1,0,0,-2,-1,-1,-1,-3
"4371",2019-02-22,"Gothic Rd","w1819","Motorized",0,"Fri","weekday","sled","3","3","3",11.8,0.2,52,0,20,22.7,-1,0,0,-2,-1,-1,-1,-3
"4372",2019-02-22,"Gothic Rd","w1819","Hybrid",0,"Fri","weekday","sled","3","3","3",11.8,0.2,52,0,20,22.7,-1,0,0,-2,-1,-1,-1,-3
"4373",2019-02-23,"Gothic Rd","w1819","Non.motorized",140,"Sat","weekend","no_sled","3","3","3",12.1,0.3,53,1,13,22.8,0,-1,0,0,1,0,0,0
"4374",2019-02-23,"Gothic Rd","w1819","Mechanized",1,"Sat","weekend","no_sled","3","3","3",12.1,0.3,53,1,13,22.8,0,-1,0,0,1,0,0,0
"4375",2019-02-23,"Gothic Rd","w1819","Motorized",0,"Sat","weekend","sled","3","3","3",12.1,0.3,53,1,13,22.8,0,-1,0,0,1,0,0,0
"4376",2019-02-23,"Gothic Rd","w1819","Hybrid",0,"Sat","weekend","sled","3","3","3",12.1,0.3,53,1,13,22.8,0,-1,0,0,1,0,0,0
"4377",2019-02-24,"Gothic Rd","w1819","Non.motorized",50,"Sun","weekend","no_sled","3","3","2",12.1,0,52,-1,14,23.3,1,0,-1,0,0,0,-1,-1
"4378",2019-02-24,"Gothic Rd","w1819","Mechanized",1,"Sun","weekend","no_sled","3","3","2",12.1,0,52,-1,14,23.3,1,0,-1,0,0,0,-1,-1
"4379",2019-02-24,"Gothic Rd","w1819","Motorized",1,"Sun","weekend","sled","3","3","2",12.1,0,52,-1,14,23.3,1,0,-1,0,0,0,-1,-1
"4380",2019-02-24,"Gothic Rd","w1819","Hybrid",0,"Sun","weekend","sled","3","3","2",12.1,0,52,-1,14,23.3,1,0,-1,0,0,0,-1,-1
"4381",2019-02-25,"Gothic Rd","w1819","Non.motorized",36,"Mon","weekday","no_sled","3","3","2",12.1,0,51,-1,22,23.7,-1,1,0,-1,-2,-1,-1,-2
"4382",2019-02-25,"Gothic Rd","w1819","Mechanized",2,"Mon","weekday","no_sled","3","3","2",12.1,0,51,-1,22,23.7,-1,1,0,-1,-2,-1,-1,-2
"4383",2019-02-25,"Gothic Rd","w1819","Motorized",0,"Mon","weekday","sled","3","3","2",12.1,0,51,-1,22,23.7,-1,1,0,-1,-2,-1,-1,-2
"4384",2019-02-25,"Gothic Rd","w1819","Hybrid",0,"Mon","weekday","sled","3","3","2",12.1,0,51,-1,22,23.7,-1,1,0,-1,-2,-1,-1,-2
"4385",2019-02-26,"Gothic Rd","w1819","Non.motorized",34,"Tue","weekday","no_sled","2","2","2",12.1,0,50,-1,27,24.2,-1,-1,1,0,-2,-3,-2,-2
"4386",2019-02-26,"Gothic Rd","w1819","Mechanized",2,"Tue","weekday","no_sled","2","2","2",12.1,0,50,-1,27,24.2,-1,-1,1,0,-2,-3,-2,-2
"4387",2019-02-26,"Gothic Rd","w1819","Motorized",0,"Tue","weekday","sled","2","2","2",12.1,0,50,-1,27,24.2,-1,-1,1,0,-2,-3,-2,-2
"4388",2019-02-26,"Gothic Rd","w1819","Hybrid",0,"Tue","weekday","sled","2","2","2",12.1,0,50,-1,27,24.2,-1,-1,1,0,-2,-3,-2,-2
"4389",2019-02-27,"Gothic Rd","w1819","Non.motorized",51,"Wed","weekday","no_sled","2","2","2",12.1,0,50,0,30,24.2,-1,-1,-1,1,-1,-2,-3,-2
"4390",2019-02-27,"Gothic Rd","w1819","Mechanized",6,"Wed","weekday","no_sled","2","2","2",12.1,0,50,0,30,24.2,-1,-1,-1,1,-1,-2,-3,-2
"4391",2019-02-27,"Gothic Rd","w1819","Motorized",0,"Wed","weekday","sled","2","2","2",12.1,0,50,0,30,24.2,-1,-1,-1,1,-1,-2,-3,-2
"4392",2019-02-27,"Gothic Rd","w1819","Hybrid",0,"Wed","weekday","sled","2","2","2",12.1,0,50,0,30,24.2,-1,-1,-1,1,-1,-2,-3,-2
"4393",2019-02-28,"Gothic Rd","w1819","Non.motorized",28,"Thu","weekday","no_sled","2","2","2",12.2,0.1,49,-1,30,24.9,0,-1,-1,-1,-1,-2,-3,-4
"4394",2019-02-28,"Gothic Rd","w1819","Mechanized",0,"Thu","weekday","no_sled","2","2","2",12.2,0.1,49,-1,30,24.9,0,-1,-1,-1,-1,-2,-3,-4
"4395",2019-02-28,"Gothic Rd","w1819","Motorized",0,"Thu","weekday","sled","2","2","2",12.2,0.1,49,-1,30,24.9,0,-1,-1,-1,-1,-2,-3,-4
"4396",2019-02-28,"Gothic Rd","w1819","Hybrid",0,"Thu","weekday","sled","2","2","2",12.2,0.1,49,-1,30,24.9,0,-1,-1,-1,-1,-2,-3,-4
"4397",2019-03-01,"Gothic Rd","w1819","Non.motorized",17,"Fri","weekday","no_sled","2","2","1",12.3,0.1,49,0,29,25.1,-1,0,-1,-1,-1,-1,-2,-3
"4398",2019-03-01,"Gothic Rd","w1819","Mechanized",0,"Fri","weekday","no_sled","2","2","1",12.3,0.1,49,0,29,25.1,-1,0,-1,-1,-1,-1,-2,-3
"4399",2019-03-01,"Gothic Rd","w1819","Motorized",0,"Fri","weekday","sled","2","2","1",12.3,0.1,49,0,29,25.1,-1,0,-1,-1,-1,-1,-2,-3
"4400",2019-03-01,"Gothic Rd","w1819","Hybrid",0,"Fri","weekday","sled","2","2","1",12.3,0.1,49,0,29,25.1,-1,0,-1,-1,-1,-1,-2,-3
"4401",2019-03-02,"Gothic Rd","w1819","Non.motorized",20,"Sat","weekend","no_sled","3","3","2",13,0.7,58,9,30,22.4,0,-1,0,-1,9,8,8,7
"4402",2019-03-02,"Gothic Rd","w1819","Mechanized",0,"Sat","weekend","no_sled","3","3","2",13,0.7,58,9,30,22.4,0,-1,0,-1,9,8,8,7
"4403",2019-03-02,"Gothic Rd","w1819","Motorized",0,"Sat","weekend","sled","3","3","2",13,0.7,58,9,30,22.4,0,-1,0,-1,9,8,8,7
"4404",2019-03-02,"Gothic Rd","w1819","Hybrid",0,"Sat","weekend","sled","3","3","2",13,0.7,58,9,30,22.4,0,-1,0,-1,9,8,8,7
"4405",2019-03-03,"Gothic Rd","w1819","Non.motorized",6,"Sun","weekend","no_sled","3","3","3",13.7,0.7,64,6,27,21.4,9,0,-1,0,15,15,14,14
"4406",2019-03-03,"Gothic Rd","w1819","Mechanized",0,"Sun","weekend","no_sled","3","3","3",13.7,0.7,64,6,27,21.4,9,0,-1,0,15,15,14,14
"4407",2019-03-03,"Gothic Rd","w1819","Motorized",0,"Sun","weekend","sled","3","3","3",13.7,0.7,64,6,27,21.4,9,0,-1,0,15,15,14,14
"4408",2019-03-03,"Gothic Rd","w1819","Hybrid",0,"Sun","weekend","sled","3","3","3",13.7,0.7,64,6,27,21.4,9,0,-1,0,15,15,14,14
"4409",2019-03-04,"Gothic Rd","w1819","Non.motorized",0,"Mon","weekday","no_sled","3","3","3",14.4,0.7,66,2,23,21.8,6,9,0,-1,8,17,17,16
"4410",2019-03-04,"Gothic Rd","w1819","Mechanized",0,"Mon","weekday","no_sled","3","3","3",14.4,0.7,66,2,23,21.8,6,9,0,-1,8,17,17,16
"4411",2019-03-04,"Gothic Rd","w1819","Motorized",0,"Mon","weekday","sled","3","3","3",14.4,0.7,66,2,23,21.8,6,9,0,-1,8,17,17,16
"4412",2019-03-04,"Gothic Rd","w1819","Hybrid",0,"Mon","weekday","sled","3","3","3",14.4,0.7,66,2,23,21.8,6,9,0,-1,8,17,17,16
"4413",2019-03-05,"Gothic Rd","w1819","Non.motorized",8,"Tue","weekday","no_sled","3","3","3",14.4,0,64,-2,24,22.5,2,6,9,0,0,6,15,15
"4414",2019-03-05,"Gothic Rd","w1819","Mechanized",0,"Tue","weekday","no_sled","3","3","3",14.4,0,64,-2,24,22.5,2,6,9,0,0,6,15,15
"4415",2019-03-05,"Gothic Rd","w1819","Motorized",0,"Tue","weekday","sled","3","3","3",14.4,0,64,-2,24,22.5,2,6,9,0,0,6,15,15
"4416",2019-03-05,"Gothic Rd","w1819","Hybrid",0,"Tue","weekday","sled","3","3","3",14.4,0,64,-2,24,22.5,2,6,9,0,0,6,15,15
"4417",2019-03-06,"Gothic Rd","w1819","Non.motorized",12,"Wed","weekday","no_sled","3","3","2",14.5,0.1,62,-2,31,23.4,-2,2,6,9,-4,-2,4,13
"4418",2019-03-06,"Gothic Rd","w1819","Non.motorized",12,"Wed","weekday","no_sled","4","4","3",14.5,0.1,62,-2,31,23.4,-2,2,6,9,-4,-2,4,13
"4419",2019-03-06,"Gothic Rd","w1819","Mechanized",0,"Wed","weekday","no_sled","3","3","2",14.5,0.1,62,-2,31,23.4,-2,2,6,9,-4,-2,4,13
"4420",2019-03-06,"Gothic Rd","w1819","Mechanized",0,"Wed","weekday","no_sled","4","4","3",14.5,0.1,62,-2,31,23.4,-2,2,6,9,-4,-2,4,13
"4421",2019-03-06,"Gothic Rd","w1819","Motorized",0,"Wed","weekday","sled","3","3","2",14.5,0.1,62,-2,31,23.4,-2,2,6,9,-4,-2,4,13
"4422",2019-03-06,"Gothic Rd","w1819","Motorized",0,"Wed","weekday","sled","4","4","3",14.5,0.1,62,-2,31,23.4,-2,2,6,9,-4,-2,4,13
"4423",2019-03-06,"Gothic Rd","w1819","Hybrid",0,"Wed","weekday","sled","3","3","2",14.5,0.1,62,-2,31,23.4,-2,2,6,9,-4,-2,4,13
"4424",2019-03-06,"Gothic Rd","w1819","Hybrid",0,"Wed","weekday","sled","4","4","3",14.5,0.1,62,-2,31,23.4,-2,2,6,9,-4,-2,4,13
"4425",2019-03-07,"Gothic Rd","w1819","Non.motorized",0,"Thu","weekday","no_sled","4","4","3",16.2,1.7,71,9,30,22.8,-2,-2,2,6,7,5,7,13
"4426",2019-03-07,"Gothic Rd","w1819","Mechanized",0,"Thu","weekday","no_sled","4","4","3",16.2,1.7,71,9,30,22.8,-2,-2,2,6,7,5,7,13
"4427",2019-03-07,"Gothic Rd","w1819","Motorized",0,"Thu","weekday","sled","4","4","3",16.2,1.7,71,9,30,22.8,-2,-2,2,6,7,5,7,13
"4428",2019-03-07,"Gothic Rd","w1819","Hybrid",0,"Thu","weekday","sled","4","4","3",16.2,1.7,71,9,30,22.8,-2,-2,2,6,7,5,7,13
"4429",2019-03-08,"Gothic Rd","w1819","Non.motorized",0,"Fri","weekday","no_sled","3","3","3",16.6,0.4,71,0,27,23.4,9,-2,-2,2,9,7,5,7
"4430",2019-03-08,"Gothic Rd","w1819","Mechanized",0,"Fri","weekday","no_sled","3","3","3",16.6,0.4,71,0,27,23.4,9,-2,-2,2,9,7,5,7
"4431",2019-03-08,"Gothic Rd","w1819","Motorized",0,"Fri","weekday","sled","3","3","3",16.6,0.4,71,0,27,23.4,9,-2,-2,2,9,7,5,7
"4432",2019-03-08,"Gothic Rd","w1819","Hybrid",0,"Fri","weekday","sled","3","3","3",16.6,0.4,71,0,27,23.4,9,-2,-2,2,9,7,5,7
"4433",2019-03-09,"Gothic Rd","w1819","Non.motorized",0,"Sat","weekend","no_sled","4","4","3",17.2,0.6,76,5,22,22.6,0,9,-2,-2,5,14,12,10
"4434",2019-03-09,"Gothic Rd","w1819","Mechanized",0,"Sat","weekend","no_sled","4","4","3",17.2,0.6,76,5,22,22.6,0,9,-2,-2,5,14,12,10
"4435",2019-03-09,"Gothic Rd","w1819","Motorized",0,"Sat","weekend","sled","4","4","3",17.2,0.6,76,5,22,22.6,0,9,-2,-2,5,14,12,10
"4436",2019-03-09,"Gothic Rd","w1819","Hybrid",0,"Sat","weekend","sled","4","4","3",17.2,0.6,76,5,22,22.6,0,9,-2,-2,5,14,12,10
"4437",2019-03-10,"Gothic Rd","w1819","Non.motorized",0,"Sun","weekend","no_sled","3","3","3",17.3,0.1,73,-3,25,23.7,5,0,9,-2,2,2,11,9
"4438",2019-03-10,"Gothic Rd","w1819","Mechanized",0,"Sun","weekend","no_sled","3","3","3",17.3,0.1,73,-3,25,23.7,5,0,9,-2,2,2,11,9
"4439",2019-03-10,"Gothic Rd","w1819","Motorized",0,"Sun","weekend","sled","3","3","3",17.3,0.1,73,-3,25,23.7,5,0,9,-2,2,2,11,9
"4440",2019-03-10,"Gothic Rd","w1819","Hybrid",0,"Sun","weekend","sled","3","3","3",17.3,0.1,73,-3,25,23.7,5,0,9,-2,2,2,11,9
"4441",2019-03-11,"Gothic Rd","w1819","Non.motorized",9,"Mon","weekday","no_sled","3","3","2",17.3,0,71,-2,29,24.4,-3,5,0,9,-5,0,0,9
"4442",2019-03-11,"Gothic Rd","w1819","Mechanized",0,"Mon","weekday","no_sled","3","3","2",17.3,0,71,-2,29,24.4,-3,5,0,9,-5,0,0,9
"4443",2019-03-11,"Gothic Rd","w1819","Motorized",0,"Mon","weekday","sled","3","3","2",17.3,0,71,-2,29,24.4,-3,5,0,9,-5,0,0,9
"4444",2019-03-11,"Gothic Rd","w1819","Hybrid",0,"Mon","weekday","sled","3","3","2",17.3,0,71,-2,29,24.4,-3,5,0,9,-5,0,0,9
"4445",2019-03-12,"Gothic Rd","w1819","Non.motorized",7,"Tue","weekday","no_sled","3","3","3",17.4,0.1,70,-1,32,24.9,-2,-3,5,0,-3,-6,-1,-1
"4446",2019-03-12,"Gothic Rd","w1819","Non.motorized",7,"Tue","weekday","no_sled","4","4","4",17.4,0.1,70,-1,32,24.9,-2,-3,5,0,-3,-6,-1,-1
"4447",2019-03-12,"Gothic Rd","w1819","Mechanized",1,"Tue","weekday","no_sled","3","3","3",17.4,0.1,70,-1,32,24.9,-2,-3,5,0,-3,-6,-1,-1
"4448",2019-03-12,"Gothic Rd","w1819","Mechanized",1,"Tue","weekday","no_sled","4","4","4",17.4,0.1,70,-1,32,24.9,-2,-3,5,0,-3,-6,-1,-1
"4449",2019-03-12,"Gothic Rd","w1819","Motorized",0,"Tue","weekday","sled","3","3","3",17.4,0.1,70,-1,32,24.9,-2,-3,5,0,-3,-6,-1,-1
"4450",2019-03-12,"Gothic Rd","w1819","Motorized",0,"Tue","weekday","sled","4","4","4",17.4,0.1,70,-1,32,24.9,-2,-3,5,0,-3,-6,-1,-1
"4451",2019-03-12,"Gothic Rd","w1819","Hybrid",0,"Tue","weekday","sled","3","3","3",17.4,0.1,70,-1,32,24.9,-2,-3,5,0,-3,-6,-1,-1
"4452",2019-03-12,"Gothic Rd","w1819","Hybrid",0,"Tue","weekday","sled","4","4","4",17.4,0.1,70,-1,32,24.9,-2,-3,5,0,-3,-6,-1,-1
"4453",2019-03-13,"Gothic Rd","w1819","Non.motorized",0,"Wed","weekday","no_sled","4","4","3",18.1,0.7,74,4,24,24.5,-1,-2,-3,5,3,1,-2,3
"4454",2019-03-13,"Gothic Rd","w1819","Mechanized",0,"Wed","weekday","no_sled","4","4","3",18.1,0.7,74,4,24,24.5,-1,-2,-3,5,3,1,-2,3
"4455",2019-03-13,"Gothic Rd","w1819","Motorized",0,"Wed","weekday","sled","4","4","3",18.1,0.7,74,4,24,24.5,-1,-2,-3,5,3,1,-2,3
"4456",2019-03-13,"Gothic Rd","w1819","Hybrid",0,"Wed","weekday","sled","4","4","3",18.1,0.7,74,4,24,24.5,-1,-2,-3,5,3,1,-2,3
"4457",2019-03-14,"Gothic Rd","w1819","Non.motorized",9,"Thu","weekday","no_sled","4","4","3",18.1,0,74,0,17,24.5,4,-1,-2,-3,4,3,1,-2
"4458",2019-03-14,"Gothic Rd","w1819","Mechanized",0,"Thu","weekday","no_sled","4","4","3",18.1,0,74,0,17,24.5,4,-1,-2,-3,4,3,1,-2
"4459",2019-03-14,"Gothic Rd","w1819","Motorized",0,"Thu","weekday","sled","4","4","3",18.1,0,74,0,17,24.5,4,-1,-2,-3,4,3,1,-2
"4460",2019-03-14,"Gothic Rd","w1819","Hybrid",0,"Thu","weekday","sled","4","4","3",18.1,0,74,0,17,24.5,4,-1,-2,-3,4,3,1,-2
"4461",2019-03-15,"Gothic Rd","w1819","Non.motorized",7,"Fri","weekday","no_sled","3","3","2",18.1,0,72,-2,18,25.1,0,4,-1,-2,-2,2,1,-1
"4462",2019-03-15,"Gothic Rd","w1819","Mechanized",0,"Fri","weekday","no_sled","3","3","2",18.1,0,72,-2,18,25.1,0,4,-1,-2,-2,2,1,-1
"4463",2019-03-15,"Gothic Rd","w1819","Motorized",0,"Fri","weekday","sled","3","3","2",18.1,0,72,-2,18,25.1,0,4,-1,-2,-2,2,1,-1
"4464",2019-03-15,"Gothic Rd","w1819","Hybrid",0,"Fri","weekday","sled","3","3","2",18.1,0,72,-2,18,25.1,0,4,-1,-2,-2,2,1,-1
"4465",2019-03-16,"Gothic Rd","w1819","Non.motorized",17,"Sat","weekend","no_sled","3","3","2",18.2,0.1,70,-2,26,26,-2,0,4,-1,-4,-4,0,-1
"4466",2019-03-16,"Gothic Rd","w1819","Mechanized",1,"Sat","weekend","no_sled","3","3","2",18.2,0.1,70,-2,26,26,-2,0,4,-1,-4,-4,0,-1
"4467",2019-03-16,"Gothic Rd","w1819","Motorized",0,"Sat","weekend","sled","3","3","2",18.2,0.1,70,-2,26,26,-2,0,4,-1,-4,-4,0,-1
"4468",2019-03-16,"Gothic Rd","w1819","Hybrid",0,"Sat","weekend","sled","3","3","2",18.2,0.1,70,-2,26,26,-2,0,4,-1,-4,-4,0,-1
"4469",2019-03-17,"Gothic Rd","w1819","Non.motorized",26,"Sun","weekend","no_sled","3","3","2",18.2,0,69,-1,28,26.4,-2,-2,0,4,-3,-5,-5,-1
"4470",2019-03-17,"Gothic Rd","w1819","Mechanized",2,"Sun","weekend","no_sled","3","3","2",18.2,0,69,-1,28,26.4,-2,-2,0,4,-3,-5,-5,-1
"4471",2019-03-17,"Gothic Rd","w1819","Motorized",0,"Sun","weekend","sled","3","3","2",18.2,0,69,-1,28,26.4,-2,-2,0,4,-3,-5,-5,-1
"4472",2019-03-17,"Gothic Rd","w1819","Hybrid",0,"Sun","weekend","sled","3","3","2",18.2,0,69,-1,28,26.4,-2,-2,0,4,-3,-5,-5,-1
"4473",2019-03-18,"Gothic Rd","w1819","Non.motorized",19,"Mon","weekday","no_sled","2","2","2",18.3,0.1,68,-1,29,26.9,-1,-2,-2,0,-2,-4,-6,-6
"4474",2019-03-18,"Gothic Rd","w1819","Mechanized",0,"Mon","weekday","no_sled","2","2","2",18.3,0.1,68,-1,29,26.9,-1,-2,-2,0,-2,-4,-6,-6
"4475",2019-03-18,"Gothic Rd","w1819","Motorized",1,"Mon","weekday","sled","2","2","2",18.3,0.1,68,-1,29,26.9,-1,-2,-2,0,-2,-4,-6,-6
"4476",2019-03-18,"Gothic Rd","w1819","Hybrid",0,"Mon","weekday","sled","2","2","2",18.3,0.1,68,-1,29,26.9,-1,-2,-2,0,-2,-4,-6,-6
"4477",2019-03-19,"Gothic Rd","w1819","Non.motorized",0,"Tue","weekday","no_sled","2","2","2",18.3,0,67,-1,28,27.3,-1,-1,-2,-2,-2,-3,-5,-7
"4478",2019-03-19,"Gothic Rd","w1819","Mechanized",0,"Tue","weekday","no_sled","2","2","2",18.3,0,67,-1,28,27.3,-1,-1,-2,-2,-2,-3,-5,-7
"4479",2019-03-19,"Gothic Rd","w1819","Motorized",0,"Tue","weekday","sled","2","2","2",18.3,0,67,-1,28,27.3,-1,-1,-2,-2,-2,-3,-5,-7
"4480",2019-03-19,"Gothic Rd","w1819","Hybrid",0,"Tue","weekday","sled","2","2","2",18.3,0,67,-1,28,27.3,-1,-1,-2,-2,-2,-3,-5,-7
"4481",2019-03-20,"Gothic Rd","w1819","Non.motorized",0,"Wed","weekday","no_sled","2","2","2",18.3,0,66,-1,30,27.7,-1,-1,-1,-2,-2,-3,-4,-6
"4482",2019-03-20,"Gothic Rd","w1819","Mechanized",0,"Wed","weekday","no_sled","2","2","2",18.3,0,66,-1,30,27.7,-1,-1,-1,-2,-2,-3,-4,-6
"4483",2019-03-20,"Gothic Rd","w1819","Motorized",0,"Wed","weekday","sled","2","2","2",18.3,0,66,-1,30,27.7,-1,-1,-1,-2,-2,-3,-4,-6
"4484",2019-03-20,"Gothic Rd","w1819","Hybrid",0,"Wed","weekday","sled","2","2","2",18.3,0,66,-1,30,27.7,-1,-1,-1,-2,-2,-3,-4,-6
"4485",2019-03-21,"Gothic Rd","w1819","Non.motorized",0,"Thu","weekday","no_sled","2","2","2",18.4,0.1,65,-1,33,28.3,-1,-1,-1,-1,-2,-3,-4,-5
"4486",2019-03-21,"Gothic Rd","w1819","Mechanized",0,"Thu","weekday","no_sled","2","2","2",18.4,0.1,65,-1,33,28.3,-1,-1,-1,-1,-2,-3,-4,-5
"4487",2019-03-21,"Gothic Rd","w1819","Motorized",0,"Thu","weekday","sled","2","2","2",18.4,0.1,65,-1,33,28.3,-1,-1,-1,-1,-2,-3,-4,-5
"4488",2019-03-21,"Gothic Rd","w1819","Hybrid",0,"Thu","weekday","sled","2","2","2",18.4,0.1,65,-1,33,28.3,-1,-1,-1,-1,-2,-3,-4,-5
"4489",2019-03-22,"Gothic Rd","w1819","Non.motorized",0,"Fri","weekday","no_sled","3","3","2",18.4,0,64,-1,28,28.8,-1,-1,-1,-1,-2,-3,-4,-5
"4490",2019-03-22,"Gothic Rd","w1819","Mechanized",0,"Fri","weekday","no_sled","3","3","2",18.4,0,64,-1,28,28.8,-1,-1,-1,-1,-2,-3,-4,-5
"4491",2019-03-22,"Gothic Rd","w1819","Motorized",0,"Fri","weekday","sled","3","3","2",18.4,0,64,-1,28,28.8,-1,-1,-1,-1,-2,-3,-4,-5
"4492",2019-03-22,"Gothic Rd","w1819","Hybrid",0,"Fri","weekday","sled","3","3","2",18.4,0,64,-1,28,28.8,-1,-1,-1,-1,-2,-3,-4,-5
"4493",2019-03-23,"Gothic Rd","w1819","Non.motorized",0,"Sat","weekend","no_sled","2","2","1",18.4,0,65,1,28,28.3,-1,-1,-1,-1,0,-1,-2,-3
"4494",2019-03-23,"Gothic Rd","w1819","Mechanized",0,"Sat","weekend","no_sled","2","2","1",18.4,0,65,1,28,28.3,-1,-1,-1,-1,0,-1,-2,-3
"4495",2019-03-23,"Gothic Rd","w1819","Motorized",0,"Sat","weekend","sled","2","2","1",18.4,0,65,1,28,28.3,-1,-1,-1,-1,0,-1,-2,-3
"4496",2019-03-23,"Gothic Rd","w1819","Hybrid",0,"Sat","weekend","sled","2","2","1",18.4,0,65,1,28,28.3,-1,-1,-1,-1,0,-1,-2,-3
"4497",2019-03-24,"Gothic Rd","w1819","Non.motorized",0,"Sun","weekend","no_sled","2","2","1",18.4,0,64,-1,29,28.8,1,-1,-1,-1,0,-1,-2,-3
"4498",2019-03-24,"Gothic Rd","w1819","Mechanized",0,"Sun","weekend","no_sled","2","2","1",18.4,0,64,-1,29,28.8,1,-1,-1,-1,0,-1,-2,-3
"4499",2019-03-24,"Gothic Rd","w1819","Motorized",0,"Sun","weekend","sled","2","2","1",18.4,0,64,-1,29,28.8,1,-1,-1,-1,0,-1,-2,-3
"4500",2019-03-24,"Gothic Rd","w1819","Hybrid",0,"Sun","weekend","sled","2","2","1",18.4,0,64,-1,29,28.8,1,-1,-1,-1,0,-1,-2,-3
"4501",2019-03-25,"Gothic Rd","w1819","Non.motorized",4,"Mon","weekday","no_sled","2","2","2",18.6,0.2,64,0,31,29.1,-1,1,-1,-1,-1,0,-1,-2
"4502",2019-03-25,"Gothic Rd","w1819","Mechanized",0,"Mon","weekday","no_sled","2","2","2",18.6,0.2,64,0,31,29.1,-1,1,-1,-1,-1,0,-1,-2
"4503",2019-03-25,"Gothic Rd","w1819","Motorized",0,"Mon","weekday","sled","2","2","2",18.6,0.2,64,0,31,29.1,-1,1,-1,-1,-1,0,-1,-2
"4504",2019-03-25,"Gothic Rd","w1819","Hybrid",0,"Mon","weekday","sled","2","2","2",18.6,0.2,64,0,31,29.1,-1,1,-1,-1,-1,0,-1,-2
"4505",2019-03-26,"Gothic Rd","w1819","Non.motorized",31,"Tue","weekday","no_sled","2","2","2",18.9,0.3,63,-1,36,30,0,-1,1,-1,-1,-2,-1,-2
"4506",2019-03-26,"Gothic Rd","w1819","Mechanized",0,"Tue","weekday","no_sled","2","2","2",18.9,0.3,63,-1,36,30,0,-1,1,-1,-1,-2,-1,-2
"4507",2019-03-26,"Gothic Rd","w1819","Motorized",0,"Tue","weekday","sled","2","2","2",18.9,0.3,63,-1,36,30,0,-1,1,-1,-1,-2,-1,-2
"4508",2019-03-26,"Gothic Rd","w1819","Hybrid",0,"Tue","weekday","sled","2","2","2",18.9,0.3,63,-1,36,30,0,-1,1,-1,-1,-2,-1,-2
"4509",2019-03-27,"Gothic Rd","w1819","Non.motorized",21,"Wed","weekday","no_sled","1","2","2",18.9,0,62,-1,42,30.5,-1,0,-1,1,-2,-2,-3,-2
"4510",2019-03-27,"Gothic Rd","w1819","Mechanized",5,"Wed","weekday","no_sled","1","2","2",18.9,0,62,-1,42,30.5,-1,0,-1,1,-2,-2,-3,-2
"4511",2019-03-27,"Gothic Rd","w1819","Motorized",0,"Wed","weekday","sled","1","2","2",18.9,0,62,-1,42,30.5,-1,0,-1,1,-2,-2,-3,-2
"4512",2019-03-27,"Gothic Rd","w1819","Hybrid",0,"Wed","weekday","sled","1","2","2",18.9,0,62,-1,42,30.5,-1,0,-1,1,-2,-2,-3,-2
"4513",2019-03-28,"Gothic Rd","w1819","Non.motorized",21,"Thu","weekday","no_sled","1","2","2",18.9,0,60,-2,40,31.5,-1,-1,0,-1,-3,-4,-4,-5
"4514",2019-03-28,"Gothic Rd","w1819","Mechanized",1,"Thu","weekday","no_sled","1","2","2",18.9,0,60,-2,40,31.5,-1,-1,0,-1,-3,-4,-4,-5
"4515",2019-03-28,"Gothic Rd","w1819","Motorized",0,"Thu","weekday","sled","1","2","2",18.9,0,60,-2,40,31.5,-1,-1,0,-1,-3,-4,-4,-5
"4516",2019-03-28,"Gothic Rd","w1819","Hybrid",0,"Thu","weekday","sled","1","2","2",18.9,0,60,-2,40,31.5,-1,-1,0,-1,-3,-4,-4,-5
"4517",2019-03-29,"Gothic Rd","w1819","Non.motorized",16,"Fri","weekday","no_sled","1","1","1",19,0.1,58,-2,26,32.8,-2,-1,-1,0,-4,-5,-6,-6
"4518",2019-03-29,"Gothic Rd","w1819","Mechanized",1,"Fri","weekday","no_sled","1","1","1",19,0.1,58,-2,26,32.8,-2,-1,-1,0,-4,-5,-6,-6
"4519",2019-03-29,"Gothic Rd","w1819","Motorized",0,"Fri","weekday","sled","1","1","1",19,0.1,58,-2,26,32.8,-2,-1,-1,0,-4,-5,-6,-6
"4520",2019-03-29,"Gothic Rd","w1819","Hybrid",0,"Fri","weekday","sled","1","1","1",19,0.1,58,-2,26,32.8,-2,-1,-1,0,-4,-5,-6,-6
"4521",2019-03-30,"Gothic Rd","w1819","Non.motorized",37,"Sat","weekend","no_sled","1","1","1",19.1,0.1,61,3,24,31.3,-2,-2,-1,-1,1,-1,-2,-3
"4522",2019-03-30,"Gothic Rd","w1819","Mechanized",3,"Sat","weekend","no_sled","1","1","1",19.1,0.1,61,3,24,31.3,-2,-2,-1,-1,1,-1,-2,-3
"4523",2019-03-30,"Gothic Rd","w1819","Motorized",0,"Sat","weekend","sled","1","1","1",19.1,0.1,61,3,24,31.3,-2,-2,-1,-1,1,-1,-2,-3
"4524",2019-03-30,"Gothic Rd","w1819","Hybrid",0,"Sat","weekend","sled","1","1","1",19.1,0.1,61,3,24,31.3,-2,-2,-1,-1,1,-1,-2,-3
"4525",2019-03-31,"Gothic Rd","w1819","Non.motorized",10,"Sun","weekend","no_sled","1","1","1",19.1,0,59,-2,24,32.4,3,-2,-2,-1,1,-1,-3,-4
"4526",2019-03-31,"Gothic Rd","w1819","Mechanized",0,"Sun","weekend","no_sled","1","1","1",19.1,0,59,-2,24,32.4,3,-2,-2,-1,1,-1,-3,-4
"4527",2019-03-31,"Gothic Rd","w1819","Motorized",0,"Sun","weekend","sled","1","1","1",19.1,0,59,-2,24,32.4,3,-2,-2,-1,1,-1,-3,-4
"4528",2019-03-31,"Gothic Rd","w1819","Hybrid",0,"Sun","weekend","sled","1","1","1",19.1,0,59,-2,24,32.4,3,-2,-2,-1,1,-1,-3,-4
"4529",2019-04-01,"Gothic Rd","w1819","Non.motorized",0,"Mon","weekday","no_sled","2","1","1",19.1,0,58,-1,29,32.9,-2,3,-2,-2,-3,0,-2,-4
"4530",2019-04-01,"Gothic Rd","w1819","Mechanized",0,"Mon","weekday","no_sled","2","1","1",19.1,0,58,-1,29,32.9,-2,3,-2,-2,-3,0,-2,-4
"4531",2019-04-01,"Gothic Rd","w1819","Motorized",0,"Mon","weekday","sled","2","1","1",19.1,0,58,-1,29,32.9,-2,3,-2,-2,-3,0,-2,-4
"4532",2019-04-01,"Gothic Rd","w1819","Hybrid",0,"Mon","weekday","sled","2","1","1",19.1,0,58,-1,29,32.9,-2,3,-2,-2,-3,0,-2,-4
"4533",2019-04-02,"Gothic Rd","w1819","Non.motorized",0,"Tue","weekday","no_sled","1","1","1",19.1,0,58,0,33,32.9,-1,-2,3,-2,-1,-3,0,-2
"4534",2019-04-02,"Gothic Rd","w1819","Mechanized",0,"Tue","weekday","no_sled","1","1","1",19.1,0,58,0,33,32.9,-1,-2,3,-2,-1,-3,0,-2
"4535",2019-04-02,"Gothic Rd","w1819","Motorized",0,"Tue","weekday","sled","1","1","1",19.1,0,58,0,33,32.9,-1,-2,3,-2,-1,-3,0,-2
"4536",2019-04-02,"Gothic Rd","w1819","Hybrid",0,"Tue","weekday","sled","1","1","1",19.1,0,58,0,33,32.9,-1,-2,3,-2,-1,-3,0,-2
"4537",2019-04-03,"Gothic Rd","w1819","Non.motorized",0,"Wed","weekday","no_sled","2","1","1",19.2,0.1,58,0,31,33.1,0,-1,-2,3,0,-1,-3,0
"4538",2019-04-03,"Gothic Rd","w1819","Mechanized",0,"Wed","weekday","no_sled","2","1","1",19.2,0.1,58,0,31,33.1,0,-1,-2,3,0,-1,-3,0
"4539",2019-04-03,"Gothic Rd","w1819","Motorized",0,"Wed","weekday","sled","2","1","1",19.2,0.1,58,0,31,33.1,0,-1,-2,3,0,-1,-3,0
"4540",2019-04-03,"Gothic Rd","w1819","Hybrid",0,"Wed","weekday","sled","2","1","1",19.2,0.1,58,0,31,33.1,0,-1,-2,3,0,-1,-3,0
"4541",2019-04-04,"Gothic Rd","w1819","Non.motorized",0,"Thu","weekday","no_sled","2","1","1",19.4,0.2,59,1,35,32.9,0,0,-1,-2,1,1,0,-2
"4542",2019-04-04,"Gothic Rd","w1819","Mechanized",0,"Thu","weekday","no_sled","2","1","1",19.4,0.2,59,1,35,32.9,0,0,-1,-2,1,1,0,-2
"4543",2019-04-04,"Gothic Rd","w1819","Motorized",0,"Thu","weekday","sled","2","1","1",19.4,0.2,59,1,35,32.9,0,0,-1,-2,1,1,0,-2
"4544",2019-04-04,"Gothic Rd","w1819","Hybrid",0,"Thu","weekday","sled","2","1","1",19.4,0.2,59,1,35,32.9,0,0,-1,-2,1,1,0,-2
"4545",2019-04-05,"Gothic Rd","w1819","Non.motorized",0,"Fri","weekday","no_sled","1","1","1",19.4,0,57,-2,38,34,1,0,0,-1,-1,-1,-1,-2
"4546",2019-04-05,"Gothic Rd","w1819","Mechanized",0,"Fri","weekday","no_sled","1","1","1",19.4,0,57,-2,38,34,1,0,0,-1,-1,-1,-1,-2
"4547",2019-04-05,"Gothic Rd","w1819","Motorized",0,"Fri","weekday","sled","1","1","1",19.4,0,57,-2,38,34,1,0,0,-1,-1,-1,-1,-2
"4548",2019-04-05,"Gothic Rd","w1819","Hybrid",0,"Fri","weekday","sled","1","1","1",19.4,0,57,-2,38,34,1,0,0,-1,-1,-1,-1,-2
"4549",2019-04-06,"Gothic Rd","w1819","Non.motorized",0,"Sat","weekend","no_sled","1","1","1",19.3,-0.1,57,0,35,33.9,-2,1,0,0,-2,-1,-1,-1
"4550",2019-04-06,"Gothic Rd","w1819","Mechanized",0,"Sat","weekend","no_sled","1","1","1",19.3,-0.1,57,0,35,33.9,-2,1,0,0,-2,-1,-1,-1
"4551",2019-04-06,"Gothic Rd","w1819","Motorized",0,"Sat","weekend","sled","1","1","1",19.3,-0.1,57,0,35,33.9,-2,1,0,0,-2,-1,-1,-1
"4552",2019-04-06,"Gothic Rd","w1819","Hybrid",0,"Sat","weekend","sled","1","1","1",19.3,-0.1,57,0,35,33.9,-2,1,0,0,-2,-1,-1,-1
"4553",2019-04-07,"Gothic Rd","w1819","Non.motorized",0,"Sun","weekend","no_sled","1","1","1",19.1,-0.2,57,0,37,33.5,0,-2,1,0,0,-2,-1,-1
"4554",2019-04-07,"Gothic Rd","w1819","Mechanized",0,"Sun","weekend","no_sled","1","1","1",19.1,-0.2,57,0,37,33.5,0,-2,1,0,0,-2,-1,-1
"4555",2019-04-07,"Gothic Rd","w1819","Motorized",0,"Sun","weekend","sled","1","1","1",19.1,-0.2,57,0,37,33.5,0,-2,1,0,0,-2,-1,-1
"4556",2019-04-07,"Gothic Rd","w1819","Hybrid",0,"Sun","weekend","sled","1","1","1",19.1,-0.2,57,0,37,33.5,0,-2,1,0,0,-2,-1,-1
"4557",2019-04-08,"Gothic Rd","w1819","Non.motorized",0,"Mon","weekday","no_sled","1","2","2",19.3,0.2,54,-3,41,35.7,0,0,-2,1,-3,-3,-5,-4
"4558",2019-04-08,"Gothic Rd","w1819","Mechanized",0,"Mon","weekday","no_sled","1","2","2",19.3,0.2,54,-3,41,35.7,0,0,-2,1,-3,-3,-5,-4
"4559",2019-04-08,"Gothic Rd","w1819","Motorized",0,"Mon","weekday","sled","1","2","2",19.3,0.2,54,-3,41,35.7,0,0,-2,1,-3,-3,-5,-4
"4560",2019-04-08,"Gothic Rd","w1819","Hybrid",0,"Mon","weekday","sled","1","2","2",19.3,0.2,54,-3,41,35.7,0,0,-2,1,-3,-3,-5,-4
"4561",2019-04-09,"Gothic Rd","w1819","Non.motorized",0,"Tue","weekday","no_sled","1","2","2",19.3,0,53,-1,43,36.4,-3,0,0,-2,-4,-4,-4,-6
"4562",2019-04-09,"Gothic Rd","w1819","Mechanized",0,"Tue","weekday","no_sled","1","2","2",19.3,0,53,-1,43,36.4,-3,0,0,-2,-4,-4,-4,-6
"4563",2019-04-09,"Gothic Rd","w1819","Motorized",0,"Tue","weekday","sled","1","2","2",19.3,0,53,-1,43,36.4,-3,0,0,-2,-4,-4,-4,-6
"4564",2019-04-09,"Gothic Rd","w1819","Hybrid",0,"Tue","weekday","sled","1","2","2",19.3,0,53,-1,43,36.4,-3,0,0,-2,-4,-4,-4,-6
"4565",2019-04-10,"Gothic Rd","w1819","Non.motorized",0,"Wed","weekday","no_sled","2","2","1",19,-0.3,51,-2,30,37.3,-1,-3,0,0,-3,-6,-6,-6
"4566",2019-04-10,"Gothic Rd","w1819","Mechanized",0,"Wed","weekday","no_sled","2","2","1",19,-0.3,51,-2,30,37.3,-1,-3,0,0,-3,-6,-6,-6
"4567",2019-04-10,"Gothic Rd","w1819","Motorized",0,"Wed","weekday","sled","2","2","1",19,-0.3,51,-2,30,37.3,-1,-3,0,0,-3,-6,-6,-6
"4568",2019-04-10,"Gothic Rd","w1819","Hybrid",0,"Wed","weekday","sled","2","2","1",19,-0.3,51,-2,30,37.3,-1,-3,0,0,-3,-6,-6,-6
"4569",2019-04-11,"Gothic Rd","w1819","Non.motorized",0,"Thu","weekday","no_sled","3","3","2",18.9,-0.1,53,2,20,35.7,-2,-1,-3,0,0,-1,-4,-4
"4570",2019-04-11,"Gothic Rd","w1819","Mechanized",0,"Thu","weekday","no_sled","3","3","2",18.9,-0.1,53,2,20,35.7,-2,-1,-3,0,0,-1,-4,-4
"4571",2019-04-11,"Gothic Rd","w1819","Motorized",0,"Thu","weekday","sled","3","3","2",18.9,-0.1,53,2,20,35.7,-2,-1,-3,0,0,-1,-4,-4
"4572",2019-04-11,"Gothic Rd","w1819","Hybrid",0,"Thu","weekday","sled","3","3","2",18.9,-0.1,53,2,20,35.7,-2,-1,-3,0,0,-1,-4,-4
"4573",2019-04-12,"Gothic Rd","w1819","Non.motorized",0,"Fri","weekday","no_sled","2","2","1",18.7,-0.2,53,0,24,35.3,2,-2,-1,-3,2,0,-1,-4
"4574",2019-04-12,"Gothic Rd","w1819","Mechanized",0,"Fri","weekday","no_sled","2","2","1",18.7,-0.2,53,0,24,35.3,2,-2,-1,-3,2,0,-1,-4
"4575",2019-04-12,"Gothic Rd","w1819","Motorized",0,"Fri","weekday","sled","2","2","1",18.7,-0.2,53,0,24,35.3,2,-2,-1,-3,2,0,-1,-4
"4576",2019-04-12,"Gothic Rd","w1819","Hybrid",0,"Fri","weekday","sled","2","2","1",18.7,-0.2,53,0,24,35.3,2,-2,-1,-3,2,0,-1,-4
"4577",2019-04-13,"Gothic Rd","w1819","Non.motorized",0,"Sat","weekend","no_sled","1","1","1",18.8,0.1,52,-1,27,36.2,0,2,-2,-1,-1,1,-1,-2
"4578",2019-04-13,"Gothic Rd","w1819","Mechanized",0,"Sat","weekend","no_sled","1","1","1",18.8,0.1,52,-1,27,36.2,0,2,-2,-1,-1,1,-1,-2
"4579",2019-04-13,"Gothic Rd","w1819","Motorized",0,"Sat","weekend","sled","1","1","1",18.8,0.1,52,-1,27,36.2,0,2,-2,-1,-1,1,-1,-2
"4580",2019-04-13,"Gothic Rd","w1819","Hybrid",0,"Sat","weekend","sled","1","1","1",18.8,0.1,52,-1,27,36.2,0,2,-2,-1,-1,1,-1,-2
"4581",2019-04-14,"Gothic Rd","w1819","Non.motorized",0,"Sun","weekend","no_sled","1","1","1",18.7,-0.1,51,-1,35,36.7,-1,0,2,-2,-2,-2,0,-2
"4582",2019-04-14,"Gothic Rd","w1819","Mechanized",0,"Sun","weekend","no_sled","1","1","1",18.7,-0.1,51,-1,35,36.7,-1,0,2,-2,-2,-2,0,-2
"4583",2019-04-14,"Gothic Rd","w1819","Motorized",0,"Sun","weekend","sled","1","1","1",18.7,-0.1,51,-1,35,36.7,-1,0,2,-2,-2,-2,0,-2
"4584",2019-04-14,"Gothic Rd","w1819","Hybrid",0,"Sun","weekend","sled","1","1","1",18.7,-0.1,51,-1,35,36.7,-1,0,2,-2,-2,-2,0,-2
"4585",2019-04-15,"Gothic Rd","w1819","Non.motorized",0,"Mon","weekday","no_sled",NA,NA,NA,18.6,-0.1,50,-1,41,37.2,-1,-1,0,2,-2,-3,-3,-1
"4586",2019-04-15,"Gothic Rd","w1819","Mechanized",0,"Mon","weekday","no_sled",NA,NA,NA,18.6,-0.1,50,-1,41,37.2,-1,-1,0,2,-2,-3,-3,-1
"4587",2019-04-15,"Gothic Rd","w1819","Motorized",0,"Mon","weekday","sled",NA,NA,NA,18.6,-0.1,50,-1,41,37.2,-1,-1,0,2,-2,-3,-3,-1
"4588",2019-04-15,"Gothic Rd","w1819","Hybrid",0,"Mon","weekday","sled",NA,NA,NA,18.6,-0.1,50,-1,41,37.2,-1,-1,0,2,-2,-3,-3,-1
"4589",2018-12-01,"Kebler","w1819","Non.motorized",NA,"Sat","weekend","no_sled","3","3","2",3.3,0.2,19,1,16,17.4,0,0,0,0,1,1,1,1
"4590",2018-12-01,"Kebler","w1819","Mechanized",NA,"Sat","weekend","no_sled","3","3","2",3.3,0.2,19,1,16,17.4,0,0,0,0,1,1,1,1
"4591",2018-12-01,"Kebler","w1819","Motorized",NA,"Sat","weekend","sled","3","3","2",3.3,0.2,19,1,16,17.4,0,0,0,0,1,1,1,1
"4592",2018-12-01,"Kebler","w1819","Hybrid",NA,"Sat","weekend","sled","3","3","2",3.3,0.2,19,1,16,17.4,0,0,0,0,1,1,1,1
"4593",2018-12-02,"Kebler","w1819","Non.motorized",NA,"Sun","weekend","no_sled","3","3","3",3.3,0,20,1,14,16.5,1,0,0,0,2,2,2,2
"4594",2018-12-02,"Kebler","w1819","Mechanized",NA,"Sun","weekend","no_sled","3","3","3",3.3,0,20,1,14,16.5,1,0,0,0,2,2,2,2
"4595",2018-12-02,"Kebler","w1819","Motorized",NA,"Sun","weekend","sled","3","3","3",3.3,0,20,1,14,16.5,1,0,0,0,2,2,2,2
"4596",2018-12-02,"Kebler","w1819","Hybrid",NA,"Sun","weekend","sled","3","3","3",3.3,0,20,1,14,16.5,1,0,0,0,2,2,2,2
"4597",2018-12-03,"Kebler","w1819","Non.motorized",NA,"Mon","weekday","no_sled","3","3","2",3.4,0.1,19,-1,13,17.9,1,1,0,0,0,1,1,1
"4598",2018-12-03,"Kebler","w1819","Mechanized",NA,"Mon","weekday","no_sled","3","3","2",3.4,0.1,19,-1,13,17.9,1,1,0,0,0,1,1,1
"4599",2018-12-03,"Kebler","w1819","Motorized",NA,"Mon","weekday","sled","3","3","2",3.4,0.1,19,-1,13,17.9,1,1,0,0,0,1,1,1
"4600",2018-12-03,"Kebler","w1819","Hybrid",NA,"Mon","weekday","sled","3","3","2",3.4,0.1,19,-1,13,17.9,1,1,0,0,0,1,1,1
"4601",2018-12-04,"Kebler","w1819","Non.motorized",NA,"Tue","weekday","no_sled","3","3","2",3.5,0.1,20,1,8,17.5,-1,1,1,0,0,1,2,2
"4602",2018-12-04,"Kebler","w1819","Mechanized",NA,"Tue","weekday","no_sled","3","3","2",3.5,0.1,20,1,8,17.5,-1,1,1,0,0,1,2,2
"4603",2018-12-04,"Kebler","w1819","Motorized",NA,"Tue","weekday","sled","3","3","2",3.5,0.1,20,1,8,17.5,-1,1,1,0,0,1,2,2
"4604",2018-12-04,"Kebler","w1819","Hybrid",NA,"Tue","weekday","sled","3","3","2",3.5,0.1,20,1,8,17.5,-1,1,1,0,0,1,2,2
"4605",2018-12-05,"Kebler","w1819","Non.motorized",0,"Wed","weekday","no_sled","3","3","2",3.5,0,19,-1,21,18.4,1,-1,1,1,0,-1,0,1
"4606",2018-12-05,"Kebler","w1819","Mechanized",0,"Wed","weekday","no_sled","3","3","2",3.5,0,19,-1,21,18.4,1,-1,1,1,0,-1,0,1
"4607",2018-12-05,"Kebler","w1819","Motorized",4,"Wed","weekday","sled","3","3","2",3.5,0,19,-1,21,18.4,1,-1,1,1,0,-1,0,1
"4608",2018-12-05,"Kebler","w1819","Hybrid",0,"Wed","weekday","sled","3","3","2",3.5,0,19,-1,21,18.4,1,-1,1,1,0,-1,0,1
"4609",2018-12-06,"Kebler","w1819","Non.motorized",0,"Thu","weekday","no_sled","2","2","2",3.7,0.2,18,-1,25,20.6,-1,1,-1,1,-2,-1,-2,-1
"4610",2018-12-06,"Kebler","w1819","Mechanized",0,"Thu","weekday","no_sled","2","2","2",3.7,0.2,18,-1,25,20.6,-1,1,-1,1,-2,-1,-2,-1
"4611",2018-12-06,"Kebler","w1819","Motorized",7,"Thu","weekday","sled","2","2","2",3.7,0.2,18,-1,25,20.6,-1,1,-1,1,-2,-1,-2,-1
"4612",2018-12-06,"Kebler","w1819","Hybrid",0,"Thu","weekday","sled","2","2","2",3.7,0.2,18,-1,25,20.6,-1,1,-1,1,-2,-1,-2,-1
"4613",2018-12-07,"Kebler","w1819","Non.motorized",4,"Fri","weekday","no_sled","2","2","2",3.8,0.1,21,3,23,18.1,-1,-1,1,-1,2,1,2,1
"4614",2018-12-07,"Kebler","w1819","Mechanized",0,"Fri","weekday","no_sled","2","2","2",3.8,0.1,21,3,23,18.1,-1,-1,1,-1,2,1,2,1
"4615",2018-12-07,"Kebler","w1819","Motorized",8,"Fri","weekday","sled","2","2","2",3.8,0.1,21,3,23,18.1,-1,-1,1,-1,2,1,2,1
"4616",2018-12-07,"Kebler","w1819","Hybrid",0,"Fri","weekday","sled","2","2","2",3.8,0.1,21,3,23,18.1,-1,-1,1,-1,2,1,2,1
"4617",2018-12-08,"Kebler","w1819","Non.motorized",9,"Sat","weekend","no_sled","2","2","2",3.8,0,20,-1,23,19,3,-1,-1,1,2,1,0,1
"4618",2018-12-08,"Kebler","w1819","Mechanized",0,"Sat","weekend","no_sled","2","2","2",3.8,0,20,-1,23,19,3,-1,-1,1,2,1,0,1
"4619",2018-12-08,"Kebler","w1819","Motorized",30,"Sat","weekend","sled","2","2","2",3.8,0,20,-1,23,19,3,-1,-1,1,2,1,0,1
"4620",2018-12-08,"Kebler","w1819","Hybrid",0,"Sat","weekend","sled","2","2","2",3.8,0,20,-1,23,19,3,-1,-1,1,2,1,0,1
"4621",2018-12-09,"Kebler","w1819","Non.motorized",0,"Sun","weekend","no_sled","2","2","2",3.8,0,20,0,19,19,-1,3,-1,-1,-1,2,1,0
"4622",2018-12-09,"Kebler","w1819","Mechanized",1,"Sun","weekend","no_sled","2","2","2",3.8,0,20,0,19,19,-1,3,-1,-1,-1,2,1,0
"4623",2018-12-09,"Kebler","w1819","Motorized",26,"Sun","weekend","sled","2","2","2",3.8,0,20,0,19,19,-1,3,-1,-1,-1,2,1,0
"4624",2018-12-09,"Kebler","w1819","Hybrid",0,"Sun","weekend","sled","2","2","2",3.8,0,20,0,19,19,-1,3,-1,-1,-1,2,1,0
"4625",2018-12-10,"Kebler","w1819","Non.motorized",0,"Mon","weekday","no_sled","2","2","2",3.8,0,20,0,21,19,0,-1,3,-1,0,-1,2,1
"4626",2018-12-10,"Kebler","w1819","Mechanized",0,"Mon","weekday","no_sled","2","2","2",3.8,0,20,0,21,19,0,-1,3,-1,0,-1,2,1
"4627",2018-12-10,"Kebler","w1819","Motorized",19,"Mon","weekday","sled","2","2","2",3.8,0,20,0,21,19,0,-1,3,-1,0,-1,2,1
"4628",2018-12-10,"Kebler","w1819","Hybrid",0,"Mon","weekday","sled","2","2","2",3.8,0,20,0,21,19,0,-1,3,-1,0,-1,2,1
"4629",2018-12-11,"Kebler","w1819","Non.motorized",1,"Tue","weekday","no_sled","2","2","2",3.9,0.1,19,-1,27,20.5,0,0,-1,3,-1,-1,-2,1
"4630",2018-12-11,"Kebler","w1819","Mechanized",0,"Tue","weekday","no_sled","2","2","2",3.9,0.1,19,-1,27,20.5,0,0,-1,3,-1,-1,-2,1
"4631",2018-12-11,"Kebler","w1819","Motorized",10,"Tue","weekday","sled","2","2","2",3.9,0.1,19,-1,27,20.5,0,0,-1,3,-1,-1,-2,1
"4632",2018-12-11,"Kebler","w1819","Hybrid",0,"Tue","weekday","sled","2","2","2",3.9,0.1,19,-1,27,20.5,0,0,-1,3,-1,-1,-2,1
"4633",2018-12-12,"Kebler","w1819","Non.motorized",3,"Wed","weekday","no_sled","2","2","1",3.9,0,19,0,21,20.5,-1,0,0,-1,-1,-1,-1,-2
"4634",2018-12-12,"Kebler","w1819","Mechanized",0,"Wed","weekday","no_sled","2","2","1",3.9,0,19,0,21,20.5,-1,0,0,-1,-1,-1,-1,-2
"4635",2018-12-12,"Kebler","w1819","Motorized",6,"Wed","weekday","sled","2","2","1",3.9,0,19,0,21,20.5,-1,0,0,-1,-1,-1,-1,-2
"4636",2018-12-12,"Kebler","w1819","Hybrid",0,"Wed","weekday","sled","2","2","1",3.9,0,19,0,21,20.5,-1,0,0,-1,-1,-1,-1,-2
"4637",2018-12-13,"Kebler","w1819","Non.motorized",0,"Thu","weekday","no_sled","3","3","2",4,0.1,21,2,15,19,0,-1,0,0,2,1,1,1
"4638",2018-12-13,"Kebler","w1819","Mechanized",0,"Thu","weekday","no_sled","3","3","2",4,0.1,21,2,15,19,0,-1,0,0,2,1,1,1
"4639",2018-12-13,"Kebler","w1819","Motorized",13,"Thu","weekday","sled","3","3","2",4,0.1,21,2,15,19,0,-1,0,0,2,1,1,1
"4640",2018-12-13,"Kebler","w1819","Hybrid",0,"Thu","weekday","sled","3","3","2",4,0.1,21,2,15,19,0,-1,0,0,2,1,1,1
"4641",2018-12-14,"Kebler","w1819","Non.motorized",1,"Fri","weekday","no_sled","3","3","2",4,0,20,-1,24,20,2,0,-1,0,1,1,0,0
"4642",2018-12-14,"Kebler","w1819","Mechanized",0,"Fri","weekday","no_sled","3","3","2",4,0,20,-1,24,20,2,0,-1,0,1,1,0,0
"4643",2018-12-14,"Kebler","w1819","Motorized",23,"Fri","weekday","sled","3","3","2",4,0,20,-1,24,20,2,0,-1,0,1,1,0,0
"4644",2018-12-14,"Kebler","w1819","Hybrid",0,"Fri","weekday","sled","3","3","2",4,0,20,-1,24,20,2,0,-1,0,1,1,0,0
"4645",2018-12-15,"Kebler","w1819","Non.motorized",1,"Sat","weekend","no_sled","2","2","2",4,0,20,0,29,20,-1,2,0,-1,-1,1,1,0
"4646",2018-12-15,"Kebler","w1819","Mechanized",0,"Sat","weekend","no_sled","2","2","2",4,0,20,0,29,20,-1,2,0,-1,-1,1,1,0
"4647",2018-12-15,"Kebler","w1819","Motorized",20,"Sat","weekend","sled","2","2","2",4,0,20,0,29,20,-1,2,0,-1,-1,1,1,0
"4648",2018-12-15,"Kebler","w1819","Hybrid",0,"Sat","weekend","sled","2","2","2",4,0,20,0,29,20,-1,2,0,-1,-1,1,1,0
"4649",2018-12-16,"Kebler","w1819","Non.motorized",6,"Sun","weekend","no_sled","2","2","2",4.1,0.1,19,-1,28,21.6,0,-1,2,0,-1,-2,0,0
"4650",2018-12-16,"Kebler","w1819","Mechanized",0,"Sun","weekend","no_sled","2","2","2",4.1,0.1,19,-1,28,21.6,0,-1,2,0,-1,-2,0,0
"4651",2018-12-16,"Kebler","w1819","Motorized",20,"Sun","weekend","sled","2","2","2",4.1,0.1,19,-1,28,21.6,0,-1,2,0,-1,-2,0,0
"4652",2018-12-16,"Kebler","w1819","Hybrid",0,"Sun","weekend","sled","2","2","2",4.1,0.1,19,-1,28,21.6,0,-1,2,0,-1,-2,0,0
"4653",2018-12-17,"Kebler","w1819","Non.motorized",1,"Mon","weekday","no_sled","2","2","2",4.1,0,19,0,29,21.6,-1,0,-1,2,-1,-1,-2,0
"4654",2018-12-17,"Kebler","w1819","Mechanized",0,"Mon","weekday","no_sled","2","2","2",4.1,0,19,0,29,21.6,-1,0,-1,2,-1,-1,-2,0
"4655",2018-12-17,"Kebler","w1819","Motorized",15,"Mon","weekday","sled","2","2","2",4.1,0,19,0,29,21.6,-1,0,-1,2,-1,-1,-2,0
"4656",2018-12-17,"Kebler","w1819","Hybrid",0,"Mon","weekday","sled","2","2","2",4.1,0,19,0,29,21.6,-1,0,-1,2,-1,-1,-2,0
"4657",2018-12-18,"Kebler","w1819","Non.motorized",1,"Tue","weekday","no_sled","2","2","2",4.1,0,19,0,27,21.6,0,-1,0,-1,0,-1,-1,-2
"4658",2018-12-18,"Kebler","w1819","Mechanized",0,"Tue","weekday","no_sled","2","2","2",4.1,0,19,0,27,21.6,0,-1,0,-1,0,-1,-1,-2
"4659",2018-12-18,"Kebler","w1819","Motorized",18,"Tue","weekday","sled","2","2","2",4.1,0,19,0,27,21.6,0,-1,0,-1,0,-1,-1,-2
"4660",2018-12-18,"Kebler","w1819","Hybrid",0,"Tue","weekday","sled","2","2","2",4.1,0,19,0,27,21.6,0,-1,0,-1,0,-1,-1,-2
"4661",2018-12-19,"Kebler","w1819","Non.motorized",0,"Wed","weekday","no_sled","2","2","2",4.1,0,19,0,24,21.6,0,0,-1,0,0,0,-1,-1
"4662",2018-12-19,"Kebler","w1819","Mechanized",0,"Wed","weekday","no_sled","2","2","2",4.1,0,19,0,24,21.6,0,0,-1,0,0,0,-1,-1
"4663",2018-12-19,"Kebler","w1819","Motorized",12,"Wed","weekday","sled","2","2","2",4.1,0,19,0,24,21.6,0,0,-1,0,0,0,-1,-1
"4664",2018-12-19,"Kebler","w1819","Hybrid",0,"Wed","weekday","sled","2","2","2",4.1,0,19,0,24,21.6,0,0,-1,0,0,0,-1,-1
"4665",2018-12-20,"Kebler","w1819","Non.motorized",0,"Thu","weekday","no_sled","2","2","1",4.1,0,20,1,25,20.5,0,0,0,-1,1,1,1,0
"4666",2018-12-20,"Kebler","w1819","Mechanized",0,"Thu","weekday","no_sled","2","2","1",4.1,0,20,1,25,20.5,0,0,0,-1,1,1,1,0
"4667",2018-12-20,"Kebler","w1819","Motorized",5,"Thu","weekday","sled","2","2","1",4.1,0,20,1,25,20.5,0,0,0,-1,1,1,1,0
"4668",2018-12-20,"Kebler","w1819","Hybrid",0,"Thu","weekday","sled","2","2","1",4.1,0,20,1,25,20.5,0,0,0,-1,1,1,1,0
"4669",2018-12-21,"Kebler","w1819","Non.motorized",6,"Fri","weekday","no_sled","2","2","1",4.1,0,19,-1,28,21.6,1,0,0,0,0,0,0,0
"4670",2018-12-21,"Kebler","w1819","Mechanized",0,"Fri","weekday","no_sled","2","2","1",4.1,0,19,-1,28,21.6,1,0,0,0,0,0,0,0
"4671",2018-12-21,"Kebler","w1819","Motorized",24,"Fri","weekday","sled","2","2","1",4.1,0,19,-1,28,21.6,1,0,0,0,0,0,0,0
"4672",2018-12-21,"Kebler","w1819","Hybrid",0,"Fri","weekday","sled","2","2","1",4.1,0,19,-1,28,21.6,1,0,0,0,0,0,0,0
"4673",2018-12-22,"Kebler","w1819","Non.motorized",NA,"Sat","weekend","no_sled","2","2","1",4.2,0.1,19,0,20,22.1,-1,1,0,0,-1,0,0,0
"4674",2018-12-22,"Kebler","w1819","Mechanized",NA,"Sat","weekend","no_sled","2","2","1",4.2,0.1,19,0,20,22.1,-1,1,0,0,-1,0,0,0
"4675",2018-12-22,"Kebler","w1819","Motorized",NA,"Sat","weekend","sled","2","2","1",4.2,0.1,19,0,20,22.1,-1,1,0,0,-1,0,0,0
"4676",2018-12-22,"Kebler","w1819","Hybrid",NA,"Sat","weekend","sled","2","2","1",4.2,0.1,19,0,20,22.1,-1,1,0,0,-1,0,0,0
"4677",2018-12-23,"Kebler","w1819","Non.motorized",18,"Sun","weekend","no_sled","2","2","1",4.2,0,21,2,19,20,0,-1,1,0,2,1,2,2
"4678",2018-12-23,"Kebler","w1819","Mechanized",0,"Sun","weekend","no_sled","2","2","1",4.2,0,21,2,19,20,0,-1,1,0,2,1,2,2
"4679",2018-12-23,"Kebler","w1819","Motorized",44,"Sun","weekend","sled","2","2","1",4.2,0,21,2,19,20,0,-1,1,0,2,1,2,2
"4680",2018-12-23,"Kebler","w1819","Hybrid",0,"Sun","weekend","sled","2","2","1",4.2,0,21,2,19,20,0,-1,1,0,2,1,2,2
"4681",2018-12-24,"Kebler","w1819","Non.motorized",0,"Mon","weekday","no_sled","2","2","2",4.3,0.1,20,-1,21,21.5,2,0,-1,1,1,1,0,1
"4682",2018-12-24,"Kebler","w1819","Mechanized",1,"Mon","weekday","no_sled","2","2","2",4.3,0.1,20,-1,21,21.5,2,0,-1,1,1,1,0,1
"4683",2018-12-24,"Kebler","w1819","Motorized",12,"Mon","weekday","sled","2","2","2",4.3,0.1,20,-1,21,21.5,2,0,-1,1,1,1,0,1
"4684",2018-12-24,"Kebler","w1819","Hybrid",0,"Mon","weekday","sled","2","2","2",4.3,0.1,20,-1,21,21.5,2,0,-1,1,1,1,0,1
"4685",2018-12-25,"Kebler","w1819","Non.motorized",0,"Tue","weekday","no_sled","2","2","2",4.7,0.4,25,5,25,18.8,-1,2,0,-1,4,6,6,5
"4686",2018-12-25,"Kebler","w1819","Mechanized",0,"Tue","weekday","no_sled","2","2","2",4.7,0.4,25,5,25,18.8,-1,2,0,-1,4,6,6,5
"4687",2018-12-25,"Kebler","w1819","Motorized",69,"Tue","weekday","sled","2","2","2",4.7,0.4,25,5,25,18.8,-1,2,0,-1,4,6,6,5
"4688",2018-12-25,"Kebler","w1819","Hybrid",0,"Tue","weekday","sled","2","2","2",4.7,0.4,25,5,25,18.8,-1,2,0,-1,4,6,6,5
"4689",2018-12-26,"Kebler","w1819","Non.motorized",2,"Wed","weekday","no_sled","3","3","3",4.7,0,23,-2,24,20.4,5,-1,2,0,3,2,4,4
"4690",2018-12-26,"Kebler","w1819","Mechanized",0,"Wed","weekday","no_sled","3","3","3",4.7,0,23,-2,24,20.4,5,-1,2,0,3,2,4,4
"4691",2018-12-26,"Kebler","w1819","Motorized",89,"Wed","weekday","sled","3","3","3",4.7,0,23,-2,24,20.4,5,-1,2,0,3,2,4,4
"4692",2018-12-26,"Kebler","w1819","Hybrid",0,"Wed","weekday","sled","3","3","3",4.7,0,23,-2,24,20.4,5,-1,2,0,3,2,4,4
"4693",2018-12-27,"Kebler","w1819","Non.motorized",6,"Thu","weekday","no_sled","3","3","2",4.7,0,24,1,12,19.6,-2,5,-1,2,-1,4,3,5
"4694",2018-12-27,"Kebler","w1819","Mechanized",0,"Thu","weekday","no_sled","3","3","2",4.7,0,24,1,12,19.6,-2,5,-1,2,-1,4,3,5
"4695",2018-12-27,"Kebler","w1819","Motorized",46,"Thu","weekday","sled","3","3","2",4.7,0,24,1,12,19.6,-2,5,-1,2,-1,4,3,5
"4696",2018-12-27,"Kebler","w1819","Hybrid",0,"Thu","weekday","sled","3","3","2",4.7,0,24,1,12,19.6,-2,5,-1,2,-1,4,3,5
"4697",2018-12-28,"Kebler","w1819","Non.motorized",3,"Fri","weekday","no_sled","3","3","2",4.7,0,24,0,12,19.6,1,-2,5,-1,1,-1,4,3
"4698",2018-12-28,"Kebler","w1819","Mechanized",0,"Fri","weekday","no_sled","3","3","2",4.7,0,24,0,12,19.6,1,-2,5,-1,1,-1,4,3
"4699",2018-12-28,"Kebler","w1819","Motorized",62,"Fri","weekday","sled","3","3","2",4.7,0,24,0,12,19.6,1,-2,5,-1,1,-1,4,3
"4700",2018-12-28,"Kebler","w1819","Hybrid",0,"Fri","weekday","sled","3","3","2",4.7,0,24,0,12,19.6,1,-2,5,-1,1,-1,4,3
"4701",2018-12-29,"Kebler","w1819","Non.motorized",6,"Sat","weekend","no_sled","3","3","2",4.7,0,24,0,8,19.6,0,1,-2,5,0,1,-1,4
"4702",2018-12-29,"Kebler","w1819","Mechanized",0,"Sat","weekend","no_sled","3","3","2",4.7,0,24,0,8,19.6,0,1,-2,5,0,1,-1,4
"4703",2018-12-29,"Kebler","w1819","Motorized",179,"Sat","weekend","sled","3","3","2",4.7,0,24,0,8,19.6,0,1,-2,5,0,1,-1,4
"4704",2018-12-29,"Kebler","w1819","Hybrid",2,"Sat","weekend","sled","3","3","2",4.7,0,24,0,8,19.6,0,1,-2,5,0,1,-1,4
"4705",2018-12-30,"Kebler","w1819","Non.motorized",13,"Sun","weekend","no_sled","3","3","2",4.7,0,24,0,16,19.6,0,0,1,-2,0,0,1,-1
"4706",2018-12-30,"Kebler","w1819","Mechanized",0,"Sun","weekend","no_sled","3","3","2",4.7,0,24,0,16,19.6,0,0,1,-2,0,0,1,-1
"4707",2018-12-30,"Kebler","w1819","Motorized",167,"Sun","weekend","sled","3","3","2",4.7,0,24,0,16,19.6,0,0,1,-2,0,0,1,-1
"4708",2018-12-30,"Kebler","w1819","Hybrid",0,"Sun","weekend","sled","3","3","2",4.7,0,24,0,16,19.6,0,0,1,-2,0,0,1,-1
"4709",2018-12-31,"Kebler","w1819","Non.motorized",1,"Mon","weekday","no_sled","3","3","3",4.9,0.2,23,-1,14,21.3,0,0,0,1,-1,-1,-1,0
"4710",2018-12-31,"Kebler","w1819","Mechanized",0,"Mon","weekday","no_sled","3","3","3",4.9,0.2,23,-1,14,21.3,0,0,0,1,-1,-1,-1,0
"4711",2018-12-31,"Kebler","w1819","Motorized",38,"Mon","weekday","sled","3","3","3",4.9,0.2,23,-1,14,21.3,0,0,0,1,-1,-1,-1,0
"4712",2018-12-31,"Kebler","w1819","Hybrid",0,"Mon","weekday","sled","3","3","3",4.9,0.2,23,-1,14,21.3,0,0,0,1,-1,-1,-1,0
"4713",2019-01-01,"Kebler","w1819","Non.motorized",2,"Tue","weekday","no_sled","3","3","3",5.1,0.2,29,6,11,17.6,-1,0,0,0,5,5,5,5
"4714",2019-01-01,"Kebler","w1819","Mechanized",0,"Tue","weekday","no_sled","3","3","3",5.1,0.2,29,6,11,17.6,-1,0,0,0,5,5,5,5
"4715",2019-01-01,"Kebler","w1819","Motorized",88,"Tue","weekday","sled","3","3","3",5.1,0.2,29,6,11,17.6,-1,0,0,0,5,5,5,5
"4716",2019-01-01,"Kebler","w1819","Hybrid",0,"Tue","weekday","sled","3","3","3",5.1,0.2,29,6,11,17.6,-1,0,0,0,5,5,5,5
"4717",2019-01-02,"Kebler","w1819","Non.motorized",2,"Wed","weekday","no_sled","3","3","2",5.1,0,28,-1,10,18.2,6,-1,0,0,5,4,4,4
"4718",2019-01-02,"Kebler","w1819","Mechanized",0,"Wed","weekday","no_sled","3","3","2",5.1,0,28,-1,10,18.2,6,-1,0,0,5,4,4,4
"4719",2019-01-02,"Kebler","w1819","Motorized",116,"Wed","weekday","sled","3","3","2",5.1,0,28,-1,10,18.2,6,-1,0,0,5,4,4,4
"4720",2019-01-02,"Kebler","w1819","Hybrid",0,"Wed","weekday","sled","3","3","2",5.1,0,28,-1,10,18.2,6,-1,0,0,5,4,4,4
"4721",2019-01-03,"Kebler","w1819","Non.motorized",0,"Thu","weekday","no_sled","3","3","2",5.1,0,27,-1,22,18.9,-1,6,-1,0,-2,4,3,3
"4722",2019-01-03,"Kebler","w1819","Mechanized",0,"Thu","weekday","no_sled","3","3","2",5.1,0,27,-1,22,18.9,-1,6,-1,0,-2,4,3,3
"4723",2019-01-03,"Kebler","w1819","Motorized",172,"Thu","weekday","sled","3","3","2",5.1,0,27,-1,22,18.9,-1,6,-1,0,-2,4,3,3
"4724",2019-01-03,"Kebler","w1819","Hybrid",8,"Thu","weekday","sled","3","3","2",5.1,0,27,-1,22,18.9,-1,6,-1,0,-2,4,3,3
"4725",2019-01-04,"Kebler","w1819","Non.motorized",0,"Fri","weekday","no_sled","3","3","2",5.3,0.2,26,-1,29,20.4,-1,-1,6,-1,-2,-3,3,2
"4726",2019-01-04,"Kebler","w1819","Mechanized",0,"Fri","weekday","no_sled","3","3","2",5.3,0.2,26,-1,29,20.4,-1,-1,6,-1,-2,-3,3,2
"4727",2019-01-04,"Kebler","w1819","Motorized",148,"Fri","weekday","sled","3","3","2",5.3,0.2,26,-1,29,20.4,-1,-1,6,-1,-2,-3,3,2
"4728",2019-01-04,"Kebler","w1819","Hybrid",9,"Fri","weekday","sled","3","3","2",5.3,0.2,26,-1,29,20.4,-1,-1,6,-1,-2,-3,3,2
"4729",2019-01-05,"Kebler","w1819","Non.motorized",5,"Sat","weekend","no_sled","2","2","2",5.3,0,25,-1,30,21.2,-1,-1,-1,6,-2,-3,-4,2
"4730",2019-01-05,"Kebler","w1819","Mechanized",2,"Sat","weekend","no_sled","2","2","2",5.3,0,25,-1,30,21.2,-1,-1,-1,6,-2,-3,-4,2
"4731",2019-01-05,"Kebler","w1819","Motorized",96,"Sat","weekend","sled","2","2","2",5.3,0,25,-1,30,21.2,-1,-1,-1,6,-2,-3,-4,2
"4732",2019-01-05,"Kebler","w1819","Hybrid",3,"Sat","weekend","sled","2","2","2",5.3,0,25,-1,30,21.2,-1,-1,-1,6,-2,-3,-4,2
"4733",2019-01-06,"Kebler","w1819","Non.motorized",NA,"Sun","weekend","no_sled","3","3","3",5.3,0,25,0,26,21.2,-1,-1,-1,-1,-1,-2,-3,-4
"4734",2019-01-06,"Kebler","w1819","Mechanized",NA,"Sun","weekend","no_sled","3","3","3",5.3,0,25,0,26,21.2,-1,-1,-1,-1,-1,-2,-3,-4
"4735",2019-01-06,"Kebler","w1819","Motorized",NA,"Sun","weekend","sled","3","3","3",5.3,0,25,0,26,21.2,-1,-1,-1,-1,-1,-2,-3,-4
"4736",2019-01-06,"Kebler","w1819","Hybrid",NA,"Sun","weekend","sled","3","3","3",5.3,0,25,0,26,21.2,-1,-1,-1,-1,-1,-2,-3,-4
"4737",2019-01-07,"Kebler","w1819","Non.motorized",NA,"Mon","weekday","no_sled","3","3","3",5.8,0.5,32,7,21,18.1,0,-1,-1,-1,7,6,5,4
"4738",2019-01-07,"Kebler","w1819","Mechanized",NA,"Mon","weekday","no_sled","3","3","3",5.8,0.5,32,7,21,18.1,0,-1,-1,-1,7,6,5,4
"4739",2019-01-07,"Kebler","w1819","Motorized",NA,"Mon","weekday","sled","3","3","3",5.8,0.5,32,7,21,18.1,0,-1,-1,-1,7,6,5,4
"4740",2019-01-07,"Kebler","w1819","Hybrid",NA,"Mon","weekday","sled","3","3","3",5.8,0.5,32,7,21,18.1,0,-1,-1,-1,7,6,5,4
"4741",2019-01-08,"Kebler","w1819","Non.motorized",3,"Tue","weekday","no_sled","3","3","3",5.9,0.1,32,0,24,18.4,7,0,-1,-1,7,7,6,5
"4742",2019-01-08,"Kebler","w1819","Mechanized",0,"Tue","weekday","no_sled","3","3","3",5.9,0.1,32,0,24,18.4,7,0,-1,-1,7,7,6,5
"4743",2019-01-08,"Kebler","w1819","Motorized",48,"Tue","weekday","sled","3","3","3",5.9,0.1,32,0,24,18.4,7,0,-1,-1,7,7,6,5
"4744",2019-01-08,"Kebler","w1819","Hybrid",2,"Tue","weekday","sled","3","3","3",5.9,0.1,32,0,24,18.4,7,0,-1,-1,7,7,6,5
"4745",2019-01-09,"Kebler","w1819","Non.motorized",7,"Wed","weekday","no_sled","3","3","3",6,0.1,30,-2,29,20,0,7,0,-1,-2,5,5,4
"4746",2019-01-09,"Kebler","w1819","Mechanized",0,"Wed","weekday","no_sled","3","3","3",6,0.1,30,-2,29,20,0,7,0,-1,-2,5,5,4
"4747",2019-01-09,"Kebler","w1819","Motorized",56,"Wed","weekday","sled","3","3","3",6,0.1,30,-2,29,20,0,7,0,-1,-2,5,5,4
"4748",2019-01-09,"Kebler","w1819","Hybrid",7,"Wed","weekday","sled","3","3","3",6,0.1,30,-2,29,20,0,7,0,-1,-2,5,5,4
"4749",2019-01-10,"Kebler","w1819","Non.motorized",4,"Thu","weekday","no_sled","3","3","3",6,0,29,-1,29,20.7,-2,0,7,0,-3,-3,4,4
"4750",2019-01-10,"Kebler","w1819","Mechanized",4,"Thu","weekday","no_sled","3","3","3",6,0,29,-1,29,20.7,-2,0,7,0,-3,-3,4,4
"4751",2019-01-10,"Kebler","w1819","Motorized",72,"Thu","weekday","sled","3","3","3",6,0,29,-1,29,20.7,-2,0,7,0,-3,-3,4,4
"4752",2019-01-10,"Kebler","w1819","Hybrid",1,"Thu","weekday","sled","3","3","3",6,0,29,-1,29,20.7,-2,0,7,0,-3,-3,4,4
"4753",2019-01-11,"Kebler","w1819","Non.motorized",0,"Fri","weekday","no_sled","2","2","2",6.1,0.1,29,0,25,21,-1,-2,0,7,-1,-3,-3,4
"4754",2019-01-11,"Kebler","w1819","Mechanized",1,"Fri","weekday","no_sled","2","2","2",6.1,0.1,29,0,25,21,-1,-2,0,7,-1,-3,-3,4
"4755",2019-01-11,"Kebler","w1819","Motorized",41,"Fri","weekday","sled","2","2","2",6.1,0.1,29,0,25,21,-1,-2,0,7,-1,-3,-3,4
"4756",2019-01-11,"Kebler","w1819","Hybrid",2,"Fri","weekday","sled","2","2","2",6.1,0.1,29,0,25,21,-1,-2,0,7,-1,-3,-3,4
"4757",2019-01-12,"Kebler","w1819","Non.motorized",0,"Sat","weekend","no_sled","3","3","2",6.1,0,28,-1,21,21.8,0,-1,-2,0,-1,-2,-4,-4
"4758",2019-01-12,"Kebler","w1819","Mechanized",1,"Sat","weekend","no_sled","3","3","2",6.1,0,28,-1,21,21.8,0,-1,-2,0,-1,-2,-4,-4
"4759",2019-01-12,"Kebler","w1819","Motorized",26,"Sat","weekend","sled","3","3","2",6.1,0,28,-1,21,21.8,0,-1,-2,0,-1,-2,-4,-4
"4760",2019-01-12,"Kebler","w1819","Hybrid",2,"Sat","weekend","sled","3","3","2",6.1,0,28,-1,21,21.8,0,-1,-2,0,-1,-2,-4,-4
"4761",2019-01-13,"Kebler","w1819","Non.motorized",2,"Sun","weekend","no_sled","2","2","2",6.2,0.1,30,2,18,20.7,-1,0,-1,-2,1,1,0,-2
"4762",2019-01-13,"Kebler","w1819","Mechanized",1,"Sun","weekend","no_sled","2","2","2",6.2,0.1,30,2,18,20.7,-1,0,-1,-2,1,1,0,-2
"4763",2019-01-13,"Kebler","w1819","Motorized",41,"Sun","weekend","sled","2","2","2",6.2,0.1,30,2,18,20.7,-1,0,-1,-2,1,1,0,-2
"4764",2019-01-13,"Kebler","w1819","Hybrid",3,"Sun","weekend","sled","2","2","2",6.2,0.1,30,2,18,20.7,-1,0,-1,-2,1,1,0,-2
"4765",2019-01-14,"Kebler","w1819","Non.motorized",0,"Mon","weekday","no_sled","2","2","2",6.2,0,30,0,18,20.7,2,-1,0,-1,2,1,1,0
"4766",2019-01-14,"Kebler","w1819","Mechanized",0,"Mon","weekday","no_sled","2","2","2",6.2,0,30,0,18,20.7,2,-1,0,-1,2,1,1,0
"4767",2019-01-14,"Kebler","w1819","Motorized",25,"Mon","weekday","sled","2","2","2",6.2,0,30,0,18,20.7,2,-1,0,-1,2,1,1,0
"4768",2019-01-14,"Kebler","w1819","Hybrid",2,"Mon","weekday","sled","2","2","2",6.2,0,30,0,18,20.7,2,-1,0,-1,2,1,1,0
"4769",2019-01-15,"Kebler","w1819","Non.motorized",8,"Tue","weekday","no_sled","2","2","2",6.2,0,29,-1,24,21.4,0,2,-1,0,-1,1,0,0
"4770",2019-01-15,"Kebler","w1819","Mechanized",0,"Tue","weekday","no_sled","2","2","2",6.2,0,29,-1,24,21.4,0,2,-1,0,-1,1,0,0
"4771",2019-01-15,"Kebler","w1819","Motorized",54,"Tue","weekday","sled","2","2","2",6.2,0,29,-1,24,21.4,0,2,-1,0,-1,1,0,0
"4772",2019-01-15,"Kebler","w1819","Hybrid",7,"Tue","weekday","sled","2","2","2",6.2,0,29,-1,24,21.4,0,2,-1,0,-1,1,0,0
"4773",2019-01-16,"Kebler","w1819","Non.motorized",NA,"Wed","weekday","no_sled","4","4","3",6.3,0.1,29,0,26,21.7,-1,0,2,-1,-1,-1,1,0
"4774",2019-01-16,"Kebler","w1819","Mechanized",NA,"Wed","weekday","no_sled","4","4","3",6.3,0.1,29,0,26,21.7,-1,0,2,-1,-1,-1,1,0
"4775",2019-01-16,"Kebler","w1819","Motorized",NA,"Wed","weekday","sled","4","4","3",6.3,0.1,29,0,26,21.7,-1,0,2,-1,-1,-1,1,0
"4776",2019-01-16,"Kebler","w1819","Hybrid",NA,"Wed","weekday","sled","4","4","3",6.3,0.1,29,0,26,21.7,-1,0,2,-1,-1,-1,1,0
"4777",2019-01-17,"Kebler","w1819","Non.motorized",5,"Thu","weekday","no_sled","3","3","2",7,0.7,38,9,28,18.4,0,-1,0,2,9,8,8,10
"4778",2019-01-17,"Kebler","w1819","Mechanized",0,"Thu","weekday","no_sled","3","3","2",7,0.7,38,9,28,18.4,0,-1,0,2,9,8,8,10
"4779",2019-01-17,"Kebler","w1819","Motorized",19,"Thu","weekday","sled","3","3","2",7,0.7,38,9,28,18.4,0,-1,0,2,9,8,8,10
"4780",2019-01-17,"Kebler","w1819","Hybrid",5,"Thu","weekday","sled","3","3","2",7,0.7,38,9,28,18.4,0,-1,0,2,9,8,8,10
"4781",2019-01-18,"Kebler","w1819","Non.motorized",9,"Fri","weekday","no_sled","4","4","4",7.5,0.5,41,3,22,18.3,9,0,-1,0,12,12,11,11
"4782",2019-01-18,"Kebler","w1819","Mechanized",0,"Fri","weekday","no_sled","4","4","4",7.5,0.5,41,3,22,18.3,9,0,-1,0,12,12,11,11
"4783",2019-01-18,"Kebler","w1819","Motorized",8,"Fri","weekday","sled","4","4","4",7.5,0.5,41,3,22,18.3,9,0,-1,0,12,12,11,11
"4784",2019-01-18,"Kebler","w1819","Hybrid",0,"Fri","weekday","sled","4","4","4",7.5,0.5,41,3,22,18.3,9,0,-1,0,12,12,11,11
"4785",2019-01-19,"Kebler","w1819","Non.motorized",14,"Sat","weekend","no_sled","3","3","3",7.8,0.3,43,2,20,18.1,3,9,0,-1,5,14,14,13
"4786",2019-01-19,"Kebler","w1819","Mechanized",0,"Sat","weekend","no_sled","3","3","3",7.8,0.3,43,2,20,18.1,3,9,0,-1,5,14,14,13
"4787",2019-01-19,"Kebler","w1819","Motorized",81,"Sat","weekend","sled","3","3","3",7.8,0.3,43,2,20,18.1,3,9,0,-1,5,14,14,13
"4788",2019-01-19,"Kebler","w1819","Hybrid",6,"Sat","weekend","sled","3","3","3",7.8,0.3,43,2,20,18.1,3,9,0,-1,5,14,14,13
"4789",2019-01-20,"Kebler","w1819","Non.motorized",5,"Sun","weekend","no_sled","3","3","3",7.9,0.1,41,-2,27,19.3,2,3,9,0,0,3,12,12
"4790",2019-01-20,"Kebler","w1819","Mechanized",0,"Sun","weekend","no_sled","3","3","3",7.9,0.1,41,-2,27,19.3,2,3,9,0,0,3,12,12
"4791",2019-01-20,"Kebler","w1819","Motorized",98,"Sun","weekend","sled","3","3","3",7.9,0.1,41,-2,27,19.3,2,3,9,0,0,3,12,12
"4792",2019-01-20,"Kebler","w1819","Hybrid",8,"Sun","weekend","sled","3","3","3",7.9,0.1,41,-2,27,19.3,2,3,9,0,0,3,12,12
"4793",2019-01-21,"Kebler","w1819","Non.motorized",0,"Mon","weekday","no_sled","3","3","3",7.9,0,39,-2,23,20.3,-2,2,3,9,-4,-2,1,10
"4794",2019-01-21,"Kebler","w1819","Mechanized",0,"Mon","weekday","no_sled","3","3","3",7.9,0,39,-2,23,20.3,-2,2,3,9,-4,-2,1,10
"4795",2019-01-21,"Kebler","w1819","Motorized",12,"Mon","weekday","sled","3","3","3",7.9,0,39,-2,23,20.3,-2,2,3,9,-4,-2,1,10
"4796",2019-01-21,"Kebler","w1819","Hybrid",0,"Mon","weekday","sled","3","3","3",7.9,0,39,-2,23,20.3,-2,2,3,9,-4,-2,1,10
"4797",2019-01-22,"Kebler","w1819","Non.motorized",NA,"Tue","weekday","no_sled","3","3","3",8,0.1,41,2,12,19.5,-2,-2,2,3,0,-2,0,3
"4798",2019-01-22,"Kebler","w1819","Mechanized",NA,"Tue","weekday","no_sled","3","3","3",8,0.1,41,2,12,19.5,-2,-2,2,3,0,-2,0,3
"4799",2019-01-22,"Kebler","w1819","Motorized",NA,"Tue","weekday","sled","3","3","3",8,0.1,41,2,12,19.5,-2,-2,2,3,0,-2,0,3
"4800",2019-01-22,"Kebler","w1819","Hybrid",NA,"Tue","weekday","sled","3","3","3",8,0.1,41,2,12,19.5,-2,-2,2,3,0,-2,0,3
"4801",2019-01-23,"Kebler","w1819","Non.motorized",NA,"Wed","weekday","no_sled","3","3","2",8,0,40,-1,14,20,2,-2,-2,2,1,-1,-3,-1
"4802",2019-01-23,"Kebler","w1819","Mechanized",NA,"Wed","weekday","no_sled","3","3","2",8,0,40,-1,14,20,2,-2,-2,2,1,-1,-3,-1
"4803",2019-01-23,"Kebler","w1819","Motorized",NA,"Wed","weekday","sled","3","3","2",8,0,40,-1,14,20,2,-2,-2,2,1,-1,-3,-1
"4804",2019-01-23,"Kebler","w1819","Hybrid",NA,"Wed","weekday","sled","3","3","2",8,0,40,-1,14,20,2,-2,-2,2,1,-1,-3,-1
"4805",2019-01-24,"Kebler","w1819","Non.motorized",NA,"Thu","weekday","no_sled","3","3","2",8.2,0.2,40,0,17,20.5,-1,2,-2,-2,-1,1,-1,-3
"4806",2019-01-24,"Kebler","w1819","Mechanized",NA,"Thu","weekday","no_sled","3","3","2",8.2,0.2,40,0,17,20.5,-1,2,-2,-2,-1,1,-1,-3
"4807",2019-01-24,"Kebler","w1819","Motorized",NA,"Thu","weekday","sled","3","3","2",8.2,0.2,40,0,17,20.5,-1,2,-2,-2,-1,1,-1,-3
"4808",2019-01-24,"Kebler","w1819","Hybrid",NA,"Thu","weekday","sled","3","3","2",8.2,0.2,40,0,17,20.5,-1,2,-2,-2,-1,1,-1,-3
"4809",2019-01-25,"Kebler","w1819","Non.motorized",NA,"Fri","weekday","no_sled","3","3","2",8.3,0.1,40,0,15,20.8,0,-1,2,-2,0,-1,1,-1
"4810",2019-01-25,"Kebler","w1819","Mechanized",NA,"Fri","weekday","no_sled","3","3","2",8.3,0.1,40,0,15,20.8,0,-1,2,-2,0,-1,1,-1
"4811",2019-01-25,"Kebler","w1819","Motorized",NA,"Fri","weekday","sled","3","3","2",8.3,0.1,40,0,15,20.8,0,-1,2,-2,0,-1,1,-1
"4812",2019-01-25,"Kebler","w1819","Hybrid",NA,"Fri","weekday","sled","3","3","2",8.3,0.1,40,0,15,20.8,0,-1,2,-2,0,-1,1,-1
"4813",2019-01-26,"Kebler","w1819","Non.motorized",NA,"Sat","weekend","no_sled","3","3","2",8.3,0,39,-1,19,21.3,0,0,-1,2,-1,-1,-2,0
"4814",2019-01-26,"Kebler","w1819","Mechanized",NA,"Sat","weekend","no_sled","3","3","2",8.3,0,39,-1,19,21.3,0,0,-1,2,-1,-1,-2,0
"4815",2019-01-26,"Kebler","w1819","Motorized",NA,"Sat","weekend","sled","3","3","2",8.3,0,39,-1,19,21.3,0,0,-1,2,-1,-1,-2,0
"4816",2019-01-26,"Kebler","w1819","Hybrid",NA,"Sat","weekend","sled","3","3","2",8.3,0,39,-1,19,21.3,0,0,-1,2,-1,-1,-2,0
"4817",2019-01-27,"Kebler","w1819","Non.motorized",NA,"Sun","weekend","no_sled","3","3","2",8.3,0,38,-1,24,21.8,-1,0,0,-1,-2,-2,-2,-3
"4818",2019-01-27,"Kebler","w1819","Mechanized",NA,"Sun","weekend","no_sled","3","3","2",8.3,0,38,-1,24,21.8,-1,0,0,-1,-2,-2,-2,-3
"4819",2019-01-27,"Kebler","w1819","Motorized",NA,"Sun","weekend","sled","3","3","2",8.3,0,38,-1,24,21.8,-1,0,0,-1,-2,-2,-2,-3
"4820",2019-01-27,"Kebler","w1819","Hybrid",NA,"Sun","weekend","sled","3","3","2",8.3,0,38,-1,24,21.8,-1,0,0,-1,-2,-2,-2,-3
"4821",2019-01-28,"Kebler","w1819","Non.motorized",NA,"Mon","weekday","no_sled","2","2","2",8.3,0,38,0,17,21.8,-1,-1,0,0,-1,-2,-2,-2
"4822",2019-01-28,"Kebler","w1819","Mechanized",NA,"Mon","weekday","no_sled","2","2","2",8.3,0,38,0,17,21.8,-1,-1,0,0,-1,-2,-2,-2
"4823",2019-01-28,"Kebler","w1819","Motorized",NA,"Mon","weekday","sled","2","2","2",8.3,0,38,0,17,21.8,-1,-1,0,0,-1,-2,-2,-2
"4824",2019-01-28,"Kebler","w1819","Hybrid",NA,"Mon","weekday","sled","2","2","2",8.3,0,38,0,17,21.8,-1,-1,0,0,-1,-2,-2,-2
"4825",2019-01-29,"Kebler","w1819","Non.motorized",0,"Tue","weekday","no_sled","2","2","2",8.3,0,38,0,16,21.8,0,-1,-1,0,0,-1,-2,-2
"4826",2019-01-29,"Kebler","w1819","Mechanized",0,"Tue","weekday","no_sled","2","2","2",8.3,0,38,0,16,21.8,0,-1,-1,0,0,-1,-2,-2
"4827",2019-01-29,"Kebler","w1819","Motorized",79,"Tue","weekday","sled","2","2","2",8.3,0,38,0,16,21.8,0,-1,-1,0,0,-1,-2,-2
"4828",2019-01-29,"Kebler","w1819","Hybrid",0,"Tue","weekday","sled","2","2","2",8.3,0,38,0,16,21.8,0,-1,-1,0,0,-1,-2,-2
"4829",2019-01-30,"Kebler","w1819","Non.motorized",4,"Wed","weekday","no_sled","2","2","1",8.3,0,37,-1,20,22.4,0,0,-1,-1,-1,-1,-2,-3
"4830",2019-01-30,"Kebler","w1819","Mechanized",0,"Wed","weekday","no_sled","2","2","1",8.3,0,37,-1,20,22.4,0,0,-1,-1,-1,-1,-2,-3
"4831",2019-01-30,"Kebler","w1819","Motorized",74,"Wed","weekday","sled","2","2","1",8.3,0,37,-1,20,22.4,0,0,-1,-1,-1,-1,-2,-3
"4832",2019-01-30,"Kebler","w1819","Hybrid",12,"Wed","weekday","sled","2","2","1",8.3,0,37,-1,20,22.4,0,0,-1,-1,-1,-1,-2,-3
"4833",2019-01-31,"Kebler","w1819","Non.motorized",3,"Thu","weekday","no_sled","2","2","1",8.3,0,36,-1,24,23.1,-1,0,0,-1,-2,-2,-2,-3
"4834",2019-01-31,"Kebler","w1819","Mechanized",0,"Thu","weekday","no_sled","2","2","1",8.3,0,36,-1,24,23.1,-1,0,0,-1,-2,-2,-2,-3
"4835",2019-01-31,"Kebler","w1819","Motorized",91,"Thu","weekday","sled","2","2","1",8.3,0,36,-1,24,23.1,-1,0,0,-1,-2,-2,-2,-3
"4836",2019-01-31,"Kebler","w1819","Hybrid",20,"Thu","weekday","sled","2","2","1",8.3,0,36,-1,24,23.1,-1,0,0,-1,-2,-2,-2,-3
"4837",2019-02-01,"Kebler","w1819","Non.motorized",0,"Fri","weekday","no_sled","2","2","1",8.3,0,36,0,25,23.1,-1,-1,0,0,-1,-2,-2,-2
"4838",2019-02-01,"Kebler","w1819","Mechanized",1,"Fri","weekday","no_sled","2","2","1",8.3,0,36,0,25,23.1,-1,-1,0,0,-1,-2,-2,-2
"4839",2019-02-01,"Kebler","w1819","Motorized",99,"Fri","weekday","sled","2","2","1",8.3,0,36,0,25,23.1,-1,-1,0,0,-1,-2,-2,-2
"4840",2019-02-01,"Kebler","w1819","Hybrid",8,"Fri","weekday","sled","2","2","1",8.3,0,36,0,25,23.1,-1,-1,0,0,-1,-2,-2,-2
"4841",2019-02-02,"Kebler","w1819","Non.motorized",1,"Sat","weekend","no_sled","2","2","1",8.3,0,36,0,26,23.1,0,-1,-1,0,0,-1,-2,-2
"4842",2019-02-02,"Kebler","w1819","Mechanized",0,"Sat","weekend","no_sled","2","2","1",8.3,0,36,0,26,23.1,0,-1,-1,0,0,-1,-2,-2
"4843",2019-02-02,"Kebler","w1819","Motorized",113,"Sat","weekend","sled","2","2","1",8.3,0,36,0,26,23.1,0,-1,-1,0,0,-1,-2,-2
"4844",2019-02-02,"Kebler","w1819","Hybrid",10,"Sat","weekend","sled","2","2","1",8.3,0,36,0,26,23.1,0,-1,-1,0,0,-1,-2,-2
"4845",2019-02-03,"Kebler","w1819","Non.motorized",2,"Sun","weekend","no_sled","3","3","2",8.4,0.1,36,0,28,23.3,0,0,-1,-1,0,0,-1,-2
"4846",2019-02-03,"Kebler","w1819","Mechanized",0,"Sun","weekend","no_sled","3","3","2",8.4,0.1,36,0,28,23.3,0,0,-1,-1,0,0,-1,-2
"4847",2019-02-03,"Kebler","w1819","Motorized",64,"Sun","weekend","sled","3","3","2",8.4,0.1,36,0,28,23.3,0,0,-1,-1,0,0,-1,-2
"4848",2019-02-03,"Kebler","w1819","Hybrid",2,"Sun","weekend","sled","3","3","2",8.4,0.1,36,0,28,23.3,0,0,-1,-1,0,0,-1,-2
"4849",2019-02-04,"Kebler","w1819","Non.motorized",2,"Mon","weekday","no_sled","3","3","2",8.8,0.4,39,3,28,22.6,0,0,0,-1,3,3,3,2
"4850",2019-02-04,"Kebler","w1819","Mechanized",0,"Mon","weekday","no_sled","3","3","2",8.8,0.4,39,3,28,22.6,0,0,0,-1,3,3,3,2
"4851",2019-02-04,"Kebler","w1819","Motorized",77,"Mon","weekday","sled","3","3","2",8.8,0.4,39,3,28,22.6,0,0,0,-1,3,3,3,2
"4852",2019-02-04,"Kebler","w1819","Hybrid",11,"Mon","weekday","sled","3","3","2",8.8,0.4,39,3,28,22.6,0,0,0,-1,3,3,3,2
"4853",2019-02-05,"Kebler","w1819","Non.motorized",1,"Tue","weekday","no_sled","3","2","2",9,0.2,40,1,26,22.5,3,0,0,0,4,4,4,4
"4854",2019-02-05,"Kebler","w1819","Mechanized",0,"Tue","weekday","no_sled","3","2","2",9,0.2,40,1,26,22.5,3,0,0,0,4,4,4,4
"4855",2019-02-05,"Kebler","w1819","Motorized",49,"Tue","weekday","sled","3","2","2",9,0.2,40,1,26,22.5,3,0,0,0,4,4,4,4
"4856",2019-02-05,"Kebler","w1819","Hybrid",6,"Tue","weekday","sled","3","2","2",9,0.2,40,1,26,22.5,3,0,0,0,4,4,4,4
"4857",2019-02-06,"Kebler","w1819","Non.motorized",0,"Wed","weekday","no_sled","4","4","3",9,0,40,0,16,22.5,1,3,0,0,1,4,4,4
"4858",2019-02-06,"Kebler","w1819","Mechanized",0,"Wed","weekday","no_sled","4","4","3",9,0,40,0,16,22.5,1,3,0,0,1,4,4,4
"4859",2019-02-06,"Kebler","w1819","Motorized",0,"Wed","weekday","sled","4","4","3",9,0,40,0,16,22.5,1,3,0,0,1,4,4,4
"4860",2019-02-06,"Kebler","w1819","Hybrid",0,"Wed","weekday","sled","4","4","3",9,0,40,0,16,22.5,1,3,0,0,1,4,4,4
"4861",2019-02-07,"Kebler","w1819","Non.motorized",0,"Thu","weekday","no_sled","3","3","2",9.2,0.2,43,3,4,21.4,0,1,3,0,3,4,7,7
"4862",2019-02-07,"Kebler","w1819","Mechanized",0,"Thu","weekday","no_sled","3","3","2",9.2,0.2,43,3,4,21.4,0,1,3,0,3,4,7,7
"4863",2019-02-07,"Kebler","w1819","Motorized",25,"Thu","weekday","sled","3","3","2",9.2,0.2,43,3,4,21.4,0,1,3,0,3,4,7,7
"4864",2019-02-07,"Kebler","w1819","Hybrid",3,"Thu","weekday","sled","3","3","2",9.2,0.2,43,3,4,21.4,0,1,3,0,3,4,7,7
"4865",2019-02-08,"Kebler","w1819","Non.motorized",0,"Fri","weekday","no_sled","3","2","2",9.2,0,42,-1,10,21.9,3,0,1,3,2,2,3,6
"4866",2019-02-08,"Kebler","w1819","Mechanized",0,"Fri","weekday","no_sled","3","2","2",9.2,0,42,-1,10,21.9,3,0,1,3,2,2,3,6
"4867",2019-02-08,"Kebler","w1819","Motorized",59,"Fri","weekday","sled","3","2","2",9.2,0,42,-1,10,21.9,3,0,1,3,2,2,3,6
"4868",2019-02-08,"Kebler","w1819","Hybrid",5,"Fri","weekday","sled","3","2","2",9.2,0,42,-1,10,21.9,3,0,1,3,2,2,3,6
"4869",2019-02-09,"Kebler","w1819","Non.motorized",0,"Sat","weekend","no_sled","3","2","2",9.2,0,41,-1,20,22.4,-1,3,0,1,-2,1,1,2
"4870",2019-02-09,"Kebler","w1819","Mechanized",0,"Sat","weekend","no_sled","3","2","2",9.2,0,41,-1,20,22.4,-1,3,0,1,-2,1,1,2
"4871",2019-02-09,"Kebler","w1819","Motorized",0,"Sat","weekend","sled","3","2","2",9.2,0,41,-1,20,22.4,-1,3,0,1,-2,1,1,2
"4872",2019-02-09,"Kebler","w1819","Hybrid",0,"Sat","weekend","sled","3","2","2",9.2,0,41,-1,20,22.4,-1,3,0,1,-2,1,1,2
"4873",2019-02-10,"Kebler","w1819","Non.motorized",0,"Sun","weekend","no_sled","2","2","2",9.3,0.1,40,-1,20,23.2,-1,-1,3,0,-2,-3,0,0
"4874",2019-02-10,"Kebler","w1819","Mechanized",0,"Sun","weekend","no_sled","2","2","2",9.3,0.1,40,-1,20,23.2,-1,-1,3,0,-2,-3,0,0
"4875",2019-02-10,"Kebler","w1819","Motorized",0,"Sun","weekend","sled","2","2","2",9.3,0.1,40,-1,20,23.2,-1,-1,3,0,-2,-3,0,0
"4876",2019-02-10,"Kebler","w1819","Hybrid",0,"Sun","weekend","sled","2","2","2",9.3,0.1,40,-1,20,23.2,-1,-1,3,0,-2,-3,0,0
"4877",2019-02-11,"Kebler","w1819","Non.motorized",0,"Mon","weekday","no_sled","2","2","1",9.3,0,40,0,15,23.2,-1,-1,-1,3,-1,-2,-3,0
"4878",2019-02-11,"Kebler","w1819","Mechanized",0,"Mon","weekday","no_sled","2","2","1",9.3,0,40,0,15,23.2,-1,-1,-1,3,-1,-2,-3,0
"4879",2019-02-11,"Kebler","w1819","Motorized",7,"Mon","weekday","sled","2","2","1",9.3,0,40,0,15,23.2,-1,-1,-1,3,-1,-2,-3,0
"4880",2019-02-11,"Kebler","w1819","Hybrid",0,"Mon","weekday","sled","2","2","1",9.3,0,40,0,15,23.2,-1,-1,-1,3,-1,-2,-3,0
"4881",2019-02-12,"Kebler","w1819","Non.motorized",1,"Tue","weekday","no_sled","2","2","1",9.3,0,40,0,18,23.2,0,-1,-1,-1,0,-1,-2,-3
"4882",2019-02-12,"Kebler","w1819","Mechanized",0,"Tue","weekday","no_sled","2","2","1",9.3,0,40,0,18,23.2,0,-1,-1,-1,0,-1,-2,-3
"4883",2019-02-12,"Kebler","w1819","Motorized",21,"Tue","weekday","sled","2","2","1",9.3,0,40,0,18,23.2,0,-1,-1,-1,0,-1,-2,-3
"4884",2019-02-12,"Kebler","w1819","Hybrid",0,"Tue","weekday","sled","2","2","1",9.3,0,40,0,18,23.2,0,-1,-1,-1,0,-1,-2,-3
"4885",2019-02-13,"Kebler","w1819","Non.motorized",0,"Wed","weekday","no_sled","2","2","1",9.4,0.1,40,0,26,23.5,0,0,-1,-1,0,0,-1,-2
"4886",2019-02-13,"Kebler","w1819","Mechanized",0,"Wed","weekday","no_sled","2","2","1",9.4,0.1,40,0,26,23.5,0,0,-1,-1,0,0,-1,-2
"4887",2019-02-13,"Kebler","w1819","Motorized",45,"Wed","weekday","sled","2","2","1",9.4,0.1,40,0,26,23.5,0,0,-1,-1,0,0,-1,-2
"4888",2019-02-13,"Kebler","w1819","Hybrid",0,"Wed","weekday","sled","2","2","1",9.4,0.1,40,0,26,23.5,0,0,-1,-1,0,0,-1,-2
"4889",2019-02-14,"Kebler","w1819","Non.motorized",1,"Thu","weekday","no_sled","3","2","2",9.7,0.3,41,1,29,23.7,0,0,0,-1,1,1,1,0
"4890",2019-02-14,"Kebler","w1819","Mechanized",0,"Thu","weekday","no_sled","3","2","2",9.7,0.3,41,1,29,23.7,0,0,0,-1,1,1,1,0
"4891",2019-02-14,"Kebler","w1819","Motorized",7,"Thu","weekday","sled","3","2","2",9.7,0.3,41,1,29,23.7,0,0,0,-1,1,1,1,0
"4892",2019-02-14,"Kebler","w1819","Hybrid",0,"Thu","weekday","sled","3","2","2",9.7,0.3,41,1,29,23.7,0,0,0,-1,1,1,1,0
"4893",2019-02-15,"Kebler","w1819","Non.motorized",1,"Fri","weekday","no_sled","4","4","3",10.8,1.1,51,10,27,21.2,1,0,0,0,11,11,11,11
"4894",2019-02-15,"Kebler","w1819","Mechanized",0,"Fri","weekday","no_sled","4","4","3",10.8,1.1,51,10,27,21.2,1,0,0,0,11,11,11,11
"4895",2019-02-15,"Kebler","w1819","Motorized",38,"Fri","weekday","sled","4","4","3",10.8,1.1,51,10,27,21.2,1,0,0,0,11,11,11,11
"4896",2019-02-15,"Kebler","w1819","Hybrid",0,"Fri","weekday","sled","4","4","3",10.8,1.1,51,10,27,21.2,1,0,0,0,11,11,11,11
"4897",2019-02-16,"Kebler","w1819","Non.motorized",0,"Sat","weekend","no_sled","3","3","3",11.1,0.3,52,1,14,21.3,10,1,0,0,11,12,12,12
"4898",2019-02-16,"Kebler","w1819","Mechanized",0,"Sat","weekend","no_sled","3","3","3",11.1,0.3,52,1,14,21.3,10,1,0,0,11,12,12,12
"4899",2019-02-16,"Kebler","w1819","Motorized",0,"Sat","weekend","sled","3","3","3",11.1,0.3,52,1,14,21.3,10,1,0,0,11,12,12,12
"4900",2019-02-16,"Kebler","w1819","Hybrid",0,"Sat","weekend","sled","3","3","3",11.1,0.3,52,1,14,21.3,10,1,0,0,11,12,12,12
"4901",2019-02-17,"Kebler","w1819","Non.motorized",9,"Sun","weekend","no_sled","3","3","3",11.3,0.2,55,3,10,20.5,1,10,1,0,4,14,15,15
"4902",2019-02-17,"Kebler","w1819","Mechanized",0,"Sun","weekend","no_sled","3","3","3",11.3,0.2,55,3,10,20.5,1,10,1,0,4,14,15,15
"4903",2019-02-17,"Kebler","w1819","Motorized",117,"Sun","weekend","sled","3","3","3",11.3,0.2,55,3,10,20.5,1,10,1,0,4,14,15,15
"4904",2019-02-17,"Kebler","w1819","Hybrid",5,"Sun","weekend","sled","3","3","3",11.3,0.2,55,3,10,20.5,1,10,1,0,4,14,15,15
"4905",2019-02-18,"Kebler","w1819","Non.motorized",6,"Mon","weekday","no_sled","3","3","2",11.4,0.1,53,-2,13,21.5,3,1,10,1,1,2,12,13
"4906",2019-02-18,"Kebler","w1819","Mechanized",0,"Mon","weekday","no_sled","3","3","2",11.4,0.1,53,-2,13,21.5,3,1,10,1,1,2,12,13
"4907",2019-02-18,"Kebler","w1819","Motorized",75,"Mon","weekday","sled","3","3","2",11.4,0.1,53,-2,13,21.5,3,1,10,1,1,2,12,13
"4908",2019-02-18,"Kebler","w1819","Hybrid",5,"Mon","weekday","sled","3","3","2",11.4,0.1,53,-2,13,21.5,3,1,10,1,1,2,12,13
"4909",2019-02-19,"Kebler","w1819","Non.motorized",0,"Tue","weekday","no_sled","3","3","2",11.5,0.1,53,0,11,21.7,-2,3,1,10,-2,1,2,12
"4910",2019-02-19,"Kebler","w1819","Mechanized",0,"Tue","weekday","no_sled","3","3","2",11.5,0.1,53,0,11,21.7,-2,3,1,10,-2,1,2,12
"4911",2019-02-19,"Kebler","w1819","Motorized",0,"Tue","weekday","sled","3","3","2",11.5,0.1,53,0,11,21.7,-2,3,1,10,-2,1,2,12
"4912",2019-02-19,"Kebler","w1819","Hybrid",0,"Tue","weekday","sled","3","3","2",11.5,0.1,53,0,11,21.7,-2,3,1,10,-2,1,2,12
"4913",2019-02-20,"Kebler","w1819","Non.motorized",0,"Wed","weekday","no_sled","3","3","2",11.6,0.1,53,0,7,21.9,0,-2,3,1,0,-2,1,2
"4914",2019-02-20,"Kebler","w1819","Mechanized",0,"Wed","weekday","no_sled","3","3","2",11.6,0.1,53,0,7,21.9,0,-2,3,1,0,-2,1,2
"4915",2019-02-20,"Kebler","w1819","Motorized",0,"Wed","weekday","sled","3","3","2",11.6,0.1,53,0,7,21.9,0,-2,3,1,0,-2,1,2
"4916",2019-02-20,"Kebler","w1819","Hybrid",0,"Wed","weekday","sled","3","3","2",11.6,0.1,53,0,7,21.9,0,-2,3,1,0,-2,1,2
"4917",2019-02-21,"Kebler","w1819","Non.motorized",0,"Thu","weekday","no_sled","3","3","3",11.6,0,52,-1,15,22.3,0,0,-2,3,-1,-1,-3,0
"4918",2019-02-21,"Kebler","w1819","Mechanized",0,"Thu","weekday","no_sled","3","3","3",11.6,0,52,-1,15,22.3,0,0,-2,3,-1,-1,-3,0
"4919",2019-02-21,"Kebler","w1819","Motorized",0,"Thu","weekday","sled","3","3","3",11.6,0,52,-1,15,22.3,0,0,-2,3,-1,-1,-3,0
"4920",2019-02-21,"Kebler","w1819","Hybrid",0,"Thu","weekday","sled","3","3","3",11.6,0,52,-1,15,22.3,0,0,-2,3,-1,-1,-3,0
"4921",2019-02-22,"Kebler","w1819","Non.motorized",0,"Fri","weekday","no_sled","3","3","3",11.8,0.2,52,0,20,22.7,-1,0,0,-2,-1,-1,-1,-3
"4922",2019-02-22,"Kebler","w1819","Mechanized",0,"Fri","weekday","no_sled","3","3","3",11.8,0.2,52,0,20,22.7,-1,0,0,-2,-1,-1,-1,-3
"4923",2019-02-22,"Kebler","w1819","Motorized",0,"Fri","weekday","sled","3","3","3",11.8,0.2,52,0,20,22.7,-1,0,0,-2,-1,-1,-1,-3
"4924",2019-02-22,"Kebler","w1819","Hybrid",0,"Fri","weekday","sled","3","3","3",11.8,0.2,52,0,20,22.7,-1,0,0,-2,-1,-1,-1,-3
"4925",2019-02-23,"Kebler","w1819","Non.motorized",1,"Sat","weekend","no_sled","3","3","3",12.1,0.3,53,1,13,22.8,0,-1,0,0,1,0,0,0
"4926",2019-02-23,"Kebler","w1819","Mechanized",0,"Sat","weekend","no_sled","3","3","3",12.1,0.3,53,1,13,22.8,0,-1,0,0,1,0,0,0
"4927",2019-02-23,"Kebler","w1819","Motorized",66,"Sat","weekend","sled","3","3","3",12.1,0.3,53,1,13,22.8,0,-1,0,0,1,0,0,0
"4928",2019-02-23,"Kebler","w1819","Hybrid",4,"Sat","weekend","sled","3","3","3",12.1,0.3,53,1,13,22.8,0,-1,0,0,1,0,0,0
"4929",2019-02-24,"Kebler","w1819","Non.motorized",0,"Sun","weekend","no_sled","3","3","2",12.1,0,52,-1,14,23.3,1,0,-1,0,0,0,-1,-1
"4930",2019-02-24,"Kebler","w1819","Mechanized",0,"Sun","weekend","no_sled","3","3","2",12.1,0,52,-1,14,23.3,1,0,-1,0,0,0,-1,-1
"4931",2019-02-24,"Kebler","w1819","Motorized",0,"Sun","weekend","sled","3","3","2",12.1,0,52,-1,14,23.3,1,0,-1,0,0,0,-1,-1
"4932",2019-02-24,"Kebler","w1819","Hybrid",0,"Sun","weekend","sled","3","3","2",12.1,0,52,-1,14,23.3,1,0,-1,0,0,0,-1,-1
"4933",2019-02-25,"Kebler","w1819","Non.motorized",0,"Mon","weekday","no_sled","3","3","2",12.1,0,51,-1,22,23.7,-1,1,0,-1,-2,-1,-1,-2
"4934",2019-02-25,"Kebler","w1819","Mechanized",0,"Mon","weekday","no_sled","3","3","2",12.1,0,51,-1,22,23.7,-1,1,0,-1,-2,-1,-1,-2
"4935",2019-02-25,"Kebler","w1819","Motorized",22,"Mon","weekday","sled","3","3","2",12.1,0,51,-1,22,23.7,-1,1,0,-1,-2,-1,-1,-2
"4936",2019-02-25,"Kebler","w1819","Hybrid",2,"Mon","weekday","sled","3","3","2",12.1,0,51,-1,22,23.7,-1,1,0,-1,-2,-1,-1,-2
"4937",2019-02-26,"Kebler","w1819","Non.motorized",1,"Tue","weekday","no_sled","2","2","2",12.1,0,50,-1,27,24.2,-1,-1,1,0,-2,-3,-2,-2
"4938",2019-02-26,"Kebler","w1819","Mechanized",0,"Tue","weekday","no_sled","2","2","2",12.1,0,50,-1,27,24.2,-1,-1,1,0,-2,-3,-2,-2
"4939",2019-02-26,"Kebler","w1819","Motorized",77,"Tue","weekday","sled","2","2","2",12.1,0,50,-1,27,24.2,-1,-1,1,0,-2,-3,-2,-2
"4940",2019-02-26,"Kebler","w1819","Hybrid",10,"Tue","weekday","sled","2","2","2",12.1,0,50,-1,27,24.2,-1,-1,1,0,-2,-3,-2,-2
"4941",2019-02-27,"Kebler","w1819","Non.motorized",2,"Wed","weekday","no_sled","2","2","2",12.1,0,50,0,30,24.2,-1,-1,-1,1,-1,-2,-3,-2
"4942",2019-02-27,"Kebler","w1819","Mechanized",0,"Wed","weekday","no_sled","2","2","2",12.1,0,50,0,30,24.2,-1,-1,-1,1,-1,-2,-3,-2
"4943",2019-02-27,"Kebler","w1819","Motorized",102,"Wed","weekday","sled","2","2","2",12.1,0,50,0,30,24.2,-1,-1,-1,1,-1,-2,-3,-2
"4944",2019-02-27,"Kebler","w1819","Hybrid",5,"Wed","weekday","sled","2","2","2",12.1,0,50,0,30,24.2,-1,-1,-1,1,-1,-2,-3,-2
"4945",2019-02-28,"Kebler","w1819","Non.motorized",1,"Thu","weekday","no_sled","2","2","2",12.2,0.1,49,-1,30,24.9,0,-1,-1,-1,-1,-2,-3,-4
"4946",2019-02-28,"Kebler","w1819","Mechanized",0,"Thu","weekday","no_sled","2","2","2",12.2,0.1,49,-1,30,24.9,0,-1,-1,-1,-1,-2,-3,-4
"4947",2019-02-28,"Kebler","w1819","Motorized",60,"Thu","weekday","sled","2","2","2",12.2,0.1,49,-1,30,24.9,0,-1,-1,-1,-1,-2,-3,-4
"4948",2019-02-28,"Kebler","w1819","Hybrid",6,"Thu","weekday","sled","2","2","2",12.2,0.1,49,-1,30,24.9,0,-1,-1,-1,-1,-2,-3,-4
"4949",2019-03-01,"Kebler","w1819","Non.motorized",0,"Fri","weekday","no_sled","2","2","1",12.3,0.1,49,0,29,25.1,-1,0,-1,-1,-1,-1,-2,-3
"4950",2019-03-01,"Kebler","w1819","Mechanized",1,"Fri","weekday","no_sled","2","2","1",12.3,0.1,49,0,29,25.1,-1,0,-1,-1,-1,-1,-2,-3
"4951",2019-03-01,"Kebler","w1819","Motorized",34,"Fri","weekday","sled","2","2","1",12.3,0.1,49,0,29,25.1,-1,0,-1,-1,-1,-1,-2,-3
"4952",2019-03-01,"Kebler","w1819","Hybrid",1,"Fri","weekday","sled","2","2","1",12.3,0.1,49,0,29,25.1,-1,0,-1,-1,-1,-1,-2,-3
"4953",2019-03-02,"Kebler","w1819","Non.motorized",4,"Sat","weekend","no_sled","3","3","2",13,0.7,58,9,30,22.4,0,-1,0,-1,9,8,8,7
"4954",2019-03-02,"Kebler","w1819","Mechanized",0,"Sat","weekend","no_sled","3","3","2",13,0.7,58,9,30,22.4,0,-1,0,-1,9,8,8,7
"4955",2019-03-02,"Kebler","w1819","Motorized",113,"Sat","weekend","sled","3","3","2",13,0.7,58,9,30,22.4,0,-1,0,-1,9,8,8,7
"4956",2019-03-02,"Kebler","w1819","Hybrid",0,"Sat","weekend","sled","3","3","2",13,0.7,58,9,30,22.4,0,-1,0,-1,9,8,8,7
"4957",2019-03-03,"Kebler","w1819","Non.motorized",0,"Sun","weekend","no_sled","3","3","3",13.7,0.7,64,6,27,21.4,9,0,-1,0,15,15,14,14
"4958",2019-03-03,"Kebler","w1819","Mechanized",0,"Sun","weekend","no_sled","3","3","3",13.7,0.7,64,6,27,21.4,9,0,-1,0,15,15,14,14
"4959",2019-03-03,"Kebler","w1819","Motorized",49,"Sun","weekend","sled","3","3","3",13.7,0.7,64,6,27,21.4,9,0,-1,0,15,15,14,14
"4960",2019-03-03,"Kebler","w1819","Hybrid",0,"Sun","weekend","sled","3","3","3",13.7,0.7,64,6,27,21.4,9,0,-1,0,15,15,14,14
"4961",2019-03-04,"Kebler","w1819","Non.motorized",0,"Mon","weekday","no_sled","3","3","3",14.4,0.7,66,2,23,21.8,6,9,0,-1,8,17,17,16
"4962",2019-03-04,"Kebler","w1819","Mechanized",0,"Mon","weekday","no_sled","3","3","3",14.4,0.7,66,2,23,21.8,6,9,0,-1,8,17,17,16
"4963",2019-03-04,"Kebler","w1819","Motorized",27,"Mon","weekday","sled","3","3","3",14.4,0.7,66,2,23,21.8,6,9,0,-1,8,17,17,16
"4964",2019-03-04,"Kebler","w1819","Hybrid",0,"Mon","weekday","sled","3","3","3",14.4,0.7,66,2,23,21.8,6,9,0,-1,8,17,17,16
"4965",2019-03-05,"Kebler","w1819","Non.motorized",3,"Tue","weekday","no_sled","3","3","3",14.4,0,64,-2,24,22.5,2,6,9,0,0,6,15,15
"4966",2019-03-05,"Kebler","w1819","Mechanized",1,"Tue","weekday","no_sled","3","3","3",14.4,0,64,-2,24,22.5,2,6,9,0,0,6,15,15
"4967",2019-03-05,"Kebler","w1819","Motorized",96,"Tue","weekday","sled","3","3","3",14.4,0,64,-2,24,22.5,2,6,9,0,0,6,15,15
"4968",2019-03-05,"Kebler","w1819","Hybrid",5,"Tue","weekday","sled","3","3","3",14.4,0,64,-2,24,22.5,2,6,9,0,0,6,15,15
"4969",2019-03-06,"Kebler","w1819","Non.motorized",0,"Wed","weekday","no_sled","3","3","2",14.5,0.1,62,-2,31,23.4,-2,2,6,9,-4,-2,4,13
"4970",2019-03-06,"Kebler","w1819","Non.motorized",0,"Wed","weekday","no_sled","4","4","3",14.5,0.1,62,-2,31,23.4,-2,2,6,9,-4,-2,4,13
"4971",2019-03-06,"Kebler","w1819","Mechanized",0,"Wed","weekday","no_sled","3","3","2",14.5,0.1,62,-2,31,23.4,-2,2,6,9,-4,-2,4,13
"4972",2019-03-06,"Kebler","w1819","Mechanized",0,"Wed","weekday","no_sled","4","4","3",14.5,0.1,62,-2,31,23.4,-2,2,6,9,-4,-2,4,13
"4973",2019-03-06,"Kebler","w1819","Motorized",82,"Wed","weekday","sled","3","3","2",14.5,0.1,62,-2,31,23.4,-2,2,6,9,-4,-2,4,13
"4974",2019-03-06,"Kebler","w1819","Motorized",82,"Wed","weekday","sled","4","4","3",14.5,0.1,62,-2,31,23.4,-2,2,6,9,-4,-2,4,13
"4975",2019-03-06,"Kebler","w1819","Hybrid",5,"Wed","weekday","sled","3","3","2",14.5,0.1,62,-2,31,23.4,-2,2,6,9,-4,-2,4,13
"4976",2019-03-06,"Kebler","w1819","Hybrid",5,"Wed","weekday","sled","4","4","3",14.5,0.1,62,-2,31,23.4,-2,2,6,9,-4,-2,4,13
"4977",2019-03-07,"Kebler","w1819","Non.motorized",0,"Thu","weekday","no_sled","4","4","3",16.2,1.7,71,9,30,22.8,-2,-2,2,6,7,5,7,13
"4978",2019-03-07,"Kebler","w1819","Mechanized",0,"Thu","weekday","no_sled","4","4","3",16.2,1.7,71,9,30,22.8,-2,-2,2,6,7,5,7,13
"4979",2019-03-07,"Kebler","w1819","Motorized",0,"Thu","weekday","sled","4","4","3",16.2,1.7,71,9,30,22.8,-2,-2,2,6,7,5,7,13
"4980",2019-03-07,"Kebler","w1819","Hybrid",0,"Thu","weekday","sled","4","4","3",16.2,1.7,71,9,30,22.8,-2,-2,2,6,7,5,7,13
"4981",2019-03-08,"Kebler","w1819","Non.motorized",0,"Fri","weekday","no_sled","3","3","3",16.6,0.4,71,0,27,23.4,9,-2,-2,2,9,7,5,7
"4982",2019-03-08,"Kebler","w1819","Mechanized",0,"Fri","weekday","no_sled","3","3","3",16.6,0.4,71,0,27,23.4,9,-2,-2,2,9,7,5,7
"4983",2019-03-08,"Kebler","w1819","Motorized",10,"Fri","weekday","sled","3","3","3",16.6,0.4,71,0,27,23.4,9,-2,-2,2,9,7,5,7
"4984",2019-03-08,"Kebler","w1819","Hybrid",0,"Fri","weekday","sled","3","3","3",16.6,0.4,71,0,27,23.4,9,-2,-2,2,9,7,5,7
"4985",2019-03-09,"Kebler","w1819","Non.motorized",2,"Sat","weekend","no_sled","4","4","3",17.2,0.6,76,5,22,22.6,0,9,-2,-2,5,14,12,10
"4986",2019-03-09,"Kebler","w1819","Mechanized",0,"Sat","weekend","no_sled","4","4","3",17.2,0.6,76,5,22,22.6,0,9,-2,-2,5,14,12,10
"4987",2019-03-09,"Kebler","w1819","Motorized",29,"Sat","weekend","sled","4","4","3",17.2,0.6,76,5,22,22.6,0,9,-2,-2,5,14,12,10
"4988",2019-03-09,"Kebler","w1819","Hybrid",0,"Sat","weekend","sled","4","4","3",17.2,0.6,76,5,22,22.6,0,9,-2,-2,5,14,12,10
"4989",2019-03-10,"Kebler","w1819","Non.motorized",7,"Sun","weekend","no_sled","3","3","3",17.3,0.1,73,-3,25,23.7,5,0,9,-2,2,2,11,9
"4990",2019-03-10,"Kebler","w1819","Mechanized",0,"Sun","weekend","no_sled","3","3","3",17.3,0.1,73,-3,25,23.7,5,0,9,-2,2,2,11,9
"4991",2019-03-10,"Kebler","w1819","Motorized",64,"Sun","weekend","sled","3","3","3",17.3,0.1,73,-3,25,23.7,5,0,9,-2,2,2,11,9
"4992",2019-03-10,"Kebler","w1819","Hybrid",6,"Sun","weekend","sled","3","3","3",17.3,0.1,73,-3,25,23.7,5,0,9,-2,2,2,11,9
"4993",2019-03-11,"Kebler","w1819","Non.motorized",0,"Mon","weekday","no_sled","3","3","2",17.3,0,71,-2,29,24.4,-3,5,0,9,-5,0,0,9
"4994",2019-03-11,"Kebler","w1819","Mechanized",0,"Mon","weekday","no_sled","3","3","2",17.3,0,71,-2,29,24.4,-3,5,0,9,-5,0,0,9
"4995",2019-03-11,"Kebler","w1819","Motorized",89,"Mon","weekday","sled","3","3","2",17.3,0,71,-2,29,24.4,-3,5,0,9,-5,0,0,9
"4996",2019-03-11,"Kebler","w1819","Hybrid",1,"Mon","weekday","sled","3","3","2",17.3,0,71,-2,29,24.4,-3,5,0,9,-5,0,0,9
"4997",2019-03-12,"Kebler","w1819","Non.motorized",0,"Tue","weekday","no_sled","3","3","3",17.4,0.1,70,-1,32,24.9,-2,-3,5,0,-3,-6,-1,-1
"4998",2019-03-12,"Kebler","w1819","Non.motorized",0,"Tue","weekday","no_sled","4","4","4",17.4,0.1,70,-1,32,24.9,-2,-3,5,0,-3,-6,-1,-1
"4999",2019-03-12,"Kebler","w1819","Mechanized",0,"Tue","weekday","no_sled","3","3","3",17.4,0.1,70,-1,32,24.9,-2,-3,5,0,-3,-6,-1,-1
"5000",2019-03-12,"Kebler","w1819","Mechanized",0,"Tue","weekday","no_sled","4","4","4",17.4,0.1,70,-1,32,24.9,-2,-3,5,0,-3,-6,-1,-1
"5001",2019-03-12,"Kebler","w1819","Motorized",70,"Tue","weekday","sled","3","3","3",17.4,0.1,70,-1,32,24.9,-2,-3,5,0,-3,-6,-1,-1
"5002",2019-03-12,"Kebler","w1819","Motorized",70,"Tue","weekday","sled","4","4","4",17.4,0.1,70,-1,32,24.9,-2,-3,5,0,-3,-6,-1,-1
"5003",2019-03-12,"Kebler","w1819","Hybrid",1,"Tue","weekday","sled","3","3","3",17.4,0.1,70,-1,32,24.9,-2,-3,5,0,-3,-6,-1,-1
"5004",2019-03-12,"Kebler","w1819","Hybrid",1,"Tue","weekday","sled","4","4","4",17.4,0.1,70,-1,32,24.9,-2,-3,5,0,-3,-6,-1,-1
"5005",2019-03-13,"Kebler","w1819","Non.motorized",0,"Wed","weekday","no_sled","4","4","3",18.1,0.7,74,4,24,24.5,-1,-2,-3,5,3,1,-2,3
"5006",2019-03-13,"Kebler","w1819","Mechanized",0,"Wed","weekday","no_sled","4","4","3",18.1,0.7,74,4,24,24.5,-1,-2,-3,5,3,1,-2,3
"5007",2019-03-13,"Kebler","w1819","Motorized",0,"Wed","weekday","sled","4","4","3",18.1,0.7,74,4,24,24.5,-1,-2,-3,5,3,1,-2,3
"5008",2019-03-13,"Kebler","w1819","Hybrid",0,"Wed","weekday","sled","4","4","3",18.1,0.7,74,4,24,24.5,-1,-2,-3,5,3,1,-2,3
"5009",2019-03-14,"Kebler","w1819","Non.motorized",0,"Thu","weekday","no_sled","4","4","3",18.1,0,74,0,17,24.5,4,-1,-2,-3,4,3,1,-2
"5010",2019-03-14,"Kebler","w1819","Mechanized",0,"Thu","weekday","no_sled","4","4","3",18.1,0,74,0,17,24.5,4,-1,-2,-3,4,3,1,-2
"5011",2019-03-14,"Kebler","w1819","Motorized",2,"Thu","weekday","sled","4","4","3",18.1,0,74,0,17,24.5,4,-1,-2,-3,4,3,1,-2
"5012",2019-03-14,"Kebler","w1819","Hybrid",0,"Thu","weekday","sled","4","4","3",18.1,0,74,0,17,24.5,4,-1,-2,-3,4,3,1,-2
"5013",2019-03-15,"Kebler","w1819","Non.motorized",0,"Fri","weekday","no_sled","3","3","2",18.1,0,72,-2,18,25.1,0,4,-1,-2,-2,2,1,-1
"5014",2019-03-15,"Kebler","w1819","Mechanized",0,"Fri","weekday","no_sled","3","3","2",18.1,0,72,-2,18,25.1,0,4,-1,-2,-2,2,1,-1
"5015",2019-03-15,"Kebler","w1819","Motorized",36,"Fri","weekday","sled","3","3","2",18.1,0,72,-2,18,25.1,0,4,-1,-2,-2,2,1,-1
"5016",2019-03-15,"Kebler","w1819","Hybrid",1,"Fri","weekday","sled","3","3","2",18.1,0,72,-2,18,25.1,0,4,-1,-2,-2,2,1,-1
"5017",2019-03-16,"Kebler","w1819","Non.motorized",1,"Sat","weekend","no_sled","3","3","2",18.2,0.1,70,-2,26,26,-2,0,4,-1,-4,-4,0,-1
"5018",2019-03-16,"Kebler","w1819","Mechanized",0,"Sat","weekend","no_sled","3","3","2",18.2,0.1,70,-2,26,26,-2,0,4,-1,-4,-4,0,-1
"5019",2019-03-16,"Kebler","w1819","Motorized",103,"Sat","weekend","sled","3","3","2",18.2,0.1,70,-2,26,26,-2,0,4,-1,-4,-4,0,-1
"5020",2019-03-16,"Kebler","w1819","Hybrid",0,"Sat","weekend","sled","3","3","2",18.2,0.1,70,-2,26,26,-2,0,4,-1,-4,-4,0,-1
"5021",2019-03-17,"Kebler","w1819","Non.motorized",7,"Sun","weekend","no_sled","3","3","2",18.2,0,69,-1,28,26.4,-2,-2,0,4,-3,-5,-5,-1
"5022",2019-03-17,"Kebler","w1819","Mechanized",1,"Sun","weekend","no_sled","3","3","2",18.2,0,69,-1,28,26.4,-2,-2,0,4,-3,-5,-5,-1
"5023",2019-03-17,"Kebler","w1819","Motorized",103,"Sun","weekend","sled","3","3","2",18.2,0,69,-1,28,26.4,-2,-2,0,4,-3,-5,-5,-1
"5024",2019-03-17,"Kebler","w1819","Hybrid",0,"Sun","weekend","sled","3","3","2",18.2,0,69,-1,28,26.4,-2,-2,0,4,-3,-5,-5,-1
"5025",2019-03-18,"Kebler","w1819","Non.motorized",0,"Mon","weekday","no_sled","2","2","2",18.3,0.1,68,-1,29,26.9,-1,-2,-2,0,-2,-4,-6,-6
"5026",2019-03-18,"Kebler","w1819","Mechanized",0,"Mon","weekday","no_sled","2","2","2",18.3,0.1,68,-1,29,26.9,-1,-2,-2,0,-2,-4,-6,-6
"5027",2019-03-18,"Kebler","w1819","Motorized",85,"Mon","weekday","sled","2","2","2",18.3,0.1,68,-1,29,26.9,-1,-2,-2,0,-2,-4,-6,-6
"5028",2019-03-18,"Kebler","w1819","Hybrid",2,"Mon","weekday","sled","2","2","2",18.3,0.1,68,-1,29,26.9,-1,-2,-2,0,-2,-4,-6,-6
"5029",2019-03-19,"Kebler","w1819","Non.motorized",2,"Tue","weekday","no_sled","2","2","2",18.3,0,67,-1,28,27.3,-1,-1,-2,-2,-2,-3,-5,-7
"5030",2019-03-19,"Kebler","w1819","Mechanized",0,"Tue","weekday","no_sled","2","2","2",18.3,0,67,-1,28,27.3,-1,-1,-2,-2,-2,-3,-5,-7
"5031",2019-03-19,"Kebler","w1819","Motorized",138,"Tue","weekday","sled","2","2","2",18.3,0,67,-1,28,27.3,-1,-1,-2,-2,-2,-3,-5,-7
"5032",2019-03-19,"Kebler","w1819","Hybrid",2,"Tue","weekday","sled","2","2","2",18.3,0,67,-1,28,27.3,-1,-1,-2,-2,-2,-3,-5,-7
"5033",2019-03-20,"Kebler","w1819","Non.motorized",2,"Wed","weekday","no_sled","2","2","2",18.3,0,66,-1,30,27.7,-1,-1,-1,-2,-2,-3,-4,-6
"5034",2019-03-20,"Kebler","w1819","Mechanized",0,"Wed","weekday","no_sled","2","2","2",18.3,0,66,-1,30,27.7,-1,-1,-1,-2,-2,-3,-4,-6
"5035",2019-03-20,"Kebler","w1819","Motorized",194,"Wed","weekday","sled","2","2","2",18.3,0,66,-1,30,27.7,-1,-1,-1,-2,-2,-3,-4,-6
"5036",2019-03-20,"Kebler","w1819","Hybrid",2,"Wed","weekday","sled","2","2","2",18.3,0,66,-1,30,27.7,-1,-1,-1,-2,-2,-3,-4,-6
"5037",2019-03-21,"Kebler","w1819","Non.motorized",3,"Thu","weekday","no_sled","2","2","2",18.4,0.1,65,-1,33,28.3,-1,-1,-1,-1,-2,-3,-4,-5
"5038",2019-03-21,"Kebler","w1819","Mechanized",2,"Thu","weekday","no_sled","2","2","2",18.4,0.1,65,-1,33,28.3,-1,-1,-1,-1,-2,-3,-4,-5
"5039",2019-03-21,"Kebler","w1819","Motorized",167,"Thu","weekday","sled","2","2","2",18.4,0.1,65,-1,33,28.3,-1,-1,-1,-1,-2,-3,-4,-5
"5040",2019-03-21,"Kebler","w1819","Hybrid",7,"Thu","weekday","sled","2","2","2",18.4,0.1,65,-1,33,28.3,-1,-1,-1,-1,-2,-3,-4,-5
"5041",2019-03-22,"Kebler","w1819","Non.motorized",1,"Fri","weekday","no_sled","3","3","2",18.4,0,64,-1,28,28.8,-1,-1,-1,-1,-2,-3,-4,-5
"5042",2019-03-22,"Kebler","w1819","Mechanized",1,"Fri","weekday","no_sled","3","3","2",18.4,0,64,-1,28,28.8,-1,-1,-1,-1,-2,-3,-4,-5
"5043",2019-03-22,"Kebler","w1819","Motorized",46,"Fri","weekday","sled","3","3","2",18.4,0,64,-1,28,28.8,-1,-1,-1,-1,-2,-3,-4,-5
"5044",2019-03-22,"Kebler","w1819","Hybrid",9,"Fri","weekday","sled","3","3","2",18.4,0,64,-1,28,28.8,-1,-1,-1,-1,-2,-3,-4,-5
"5045",2019-03-23,"Kebler","w1819","Non.motorized",3,"Sat","weekend","no_sled","2","2","1",18.4,0,65,1,28,28.3,-1,-1,-1,-1,0,-1,-2,-3
"5046",2019-03-23,"Kebler","w1819","Mechanized",0,"Sat","weekend","no_sled","2","2","1",18.4,0,65,1,28,28.3,-1,-1,-1,-1,0,-1,-2,-3
"5047",2019-03-23,"Kebler","w1819","Motorized",128,"Sat","weekend","sled","2","2","1",18.4,0,65,1,28,28.3,-1,-1,-1,-1,0,-1,-2,-3
"5048",2019-03-23,"Kebler","w1819","Hybrid",12,"Sat","weekend","sled","2","2","1",18.4,0,65,1,28,28.3,-1,-1,-1,-1,0,-1,-2,-3
"5049",2019-03-24,"Kebler","w1819","Non.motorized",4,"Sun","weekend","no_sled","2","2","1",18.4,0,64,-1,29,28.8,1,-1,-1,-1,0,-1,-2,-3
"5050",2019-03-24,"Kebler","w1819","Mechanized",2,"Sun","weekend","no_sled","2","2","1",18.4,0,64,-1,29,28.8,1,-1,-1,-1,0,-1,-2,-3
"5051",2019-03-24,"Kebler","w1819","Motorized",63,"Sun","weekend","sled","2","2","1",18.4,0,64,-1,29,28.8,1,-1,-1,-1,0,-1,-2,-3
"5052",2019-03-24,"Kebler","w1819","Hybrid",7,"Sun","weekend","sled","2","2","1",18.4,0,64,-1,29,28.8,1,-1,-1,-1,0,-1,-2,-3
"5053",2019-03-25,"Kebler","w1819","Non.motorized",2,"Mon","weekday","no_sled","2","2","2",18.6,0.2,64,0,31,29.1,-1,1,-1,-1,-1,0,-1,-2
"5054",2019-03-25,"Kebler","w1819","Mechanized",2,"Mon","weekday","no_sled","2","2","2",18.6,0.2,64,0,31,29.1,-1,1,-1,-1,-1,0,-1,-2
"5055",2019-03-25,"Kebler","w1819","Motorized",110,"Mon","weekday","sled","2","2","2",18.6,0.2,64,0,31,29.1,-1,1,-1,-1,-1,0,-1,-2
"5056",2019-03-25,"Kebler","w1819","Hybrid",17,"Mon","weekday","sled","2","2","2",18.6,0.2,64,0,31,29.1,-1,1,-1,-1,-1,0,-1,-2
"5057",2019-03-26,"Kebler","w1819","Non.motorized",4,"Tue","weekday","no_sled","2","2","2",18.9,0.3,63,-1,36,30,0,-1,1,-1,-1,-2,-1,-2
"5058",2019-03-26,"Kebler","w1819","Mechanized",0,"Tue","weekday","no_sled","2","2","2",18.9,0.3,63,-1,36,30,0,-1,1,-1,-1,-2,-1,-2
"5059",2019-03-26,"Kebler","w1819","Motorized",67,"Tue","weekday","sled","2","2","2",18.9,0.3,63,-1,36,30,0,-1,1,-1,-1,-2,-1,-2
"5060",2019-03-26,"Kebler","w1819","Hybrid",0,"Tue","weekday","sled","2","2","2",18.9,0.3,63,-1,36,30,0,-1,1,-1,-1,-2,-1,-2
"5061",2019-03-27,"Kebler","w1819","Non.motorized",9,"Wed","weekday","no_sled","1","2","2",18.9,0,62,-1,42,30.5,-1,0,-1,1,-2,-2,-3,-2
"5062",2019-03-27,"Kebler","w1819","Mechanized",0,"Wed","weekday","no_sled","1","2","2",18.9,0,62,-1,42,30.5,-1,0,-1,1,-2,-2,-3,-2
"5063",2019-03-27,"Kebler","w1819","Motorized",82,"Wed","weekday","sled","1","2","2",18.9,0,62,-1,42,30.5,-1,0,-1,1,-2,-2,-3,-2
"5064",2019-03-27,"Kebler","w1819","Hybrid",0,"Wed","weekday","sled","1","2","2",18.9,0,62,-1,42,30.5,-1,0,-1,1,-2,-2,-3,-2
"5065",2019-03-28,"Kebler","w1819","Non.motorized",2,"Thu","weekday","no_sled","1","2","2",18.9,0,60,-2,40,31.5,-1,-1,0,-1,-3,-4,-4,-5
"5066",2019-03-28,"Kebler","w1819","Mechanized",0,"Thu","weekday","no_sled","1","2","2",18.9,0,60,-2,40,31.5,-1,-1,0,-1,-3,-4,-4,-5
"5067",2019-03-28,"Kebler","w1819","Motorized",91,"Thu","weekday","sled","1","2","2",18.9,0,60,-2,40,31.5,-1,-1,0,-1,-3,-4,-4,-5
"5068",2019-03-28,"Kebler","w1819","Hybrid",2,"Thu","weekday","sled","1","2","2",18.9,0,60,-2,40,31.5,-1,-1,0,-1,-3,-4,-4,-5
"5069",2019-03-29,"Kebler","w1819","Non.motorized",0,"Fri","weekday","no_sled","1","1","1",19,0.1,58,-2,26,32.8,-2,-1,-1,0,-4,-5,-6,-6
"5070",2019-03-29,"Kebler","w1819","Mechanized",0,"Fri","weekday","no_sled","1","1","1",19,0.1,58,-2,26,32.8,-2,-1,-1,0,-4,-5,-6,-6
"5071",2019-03-29,"Kebler","w1819","Motorized",19,"Fri","weekday","sled","1","1","1",19,0.1,58,-2,26,32.8,-2,-1,-1,0,-4,-5,-6,-6
"5072",2019-03-29,"Kebler","w1819","Hybrid",2,"Fri","weekday","sled","1","1","1",19,0.1,58,-2,26,32.8,-2,-1,-1,0,-4,-5,-6,-6
"5073",2019-03-30,"Kebler","w1819","Non.motorized",1,"Sat","weekend","no_sled","1","1","1",19.1,0.1,61,3,24,31.3,-2,-2,-1,-1,1,-1,-2,-3
"5074",2019-03-30,"Kebler","w1819","Mechanized",0,"Sat","weekend","no_sled","1","1","1",19.1,0.1,61,3,24,31.3,-2,-2,-1,-1,1,-1,-2,-3
"5075",2019-03-30,"Kebler","w1819","Motorized",81,"Sat","weekend","sled","1","1","1",19.1,0.1,61,3,24,31.3,-2,-2,-1,-1,1,-1,-2,-3
"5076",2019-03-30,"Kebler","w1819","Hybrid",2,"Sat","weekend","sled","1","1","1",19.1,0.1,61,3,24,31.3,-2,-2,-1,-1,1,-1,-2,-3
"5077",2019-03-31,"Kebler","w1819","Non.motorized",4,"Sun","weekend","no_sled","1","1","1",19.1,0,59,-2,24,32.4,3,-2,-2,-1,1,-1,-3,-4
"5078",2019-03-31,"Kebler","w1819","Mechanized",2,"Sun","weekend","no_sled","1","1","1",19.1,0,59,-2,24,32.4,3,-2,-2,-1,1,-1,-3,-4
"5079",2019-03-31,"Kebler","w1819","Motorized",94,"Sun","weekend","sled","1","1","1",19.1,0,59,-2,24,32.4,3,-2,-2,-1,1,-1,-3,-4
"5080",2019-03-31,"Kebler","w1819","Hybrid",16,"Sun","weekend","sled","1","1","1",19.1,0,59,-2,24,32.4,3,-2,-2,-1,1,-1,-3,-4
"5081",2019-04-01,"Kebler","w1819","Non.motorized",0,"Mon","weekday","no_sled","2","1","1",19.1,0,58,-1,29,32.9,-2,3,-2,-2,-3,0,-2,-4
"5082",2019-04-01,"Kebler","w1819","Mechanized",0,"Mon","weekday","no_sled","2","1","1",19.1,0,58,-1,29,32.9,-2,3,-2,-2,-3,0,-2,-4
"5083",2019-04-01,"Kebler","w1819","Motorized",59,"Mon","weekday","sled","2","1","1",19.1,0,58,-1,29,32.9,-2,3,-2,-2,-3,0,-2,-4
"5084",2019-04-01,"Kebler","w1819","Hybrid",17,"Mon","weekday","sled","2","1","1",19.1,0,58,-1,29,32.9,-2,3,-2,-2,-3,0,-2,-4
"5085",2019-04-02,"Kebler","w1819","Non.motorized",0,"Tue","weekday","no_sled","1","1","1",19.1,0,58,0,33,32.9,-1,-2,3,-2,-1,-3,0,-2
"5086",2019-04-02,"Kebler","w1819","Mechanized",0,"Tue","weekday","no_sled","1","1","1",19.1,0,58,0,33,32.9,-1,-2,3,-2,-1,-3,0,-2
"5087",2019-04-02,"Kebler","w1819","Motorized",42,"Tue","weekday","sled","1","1","1",19.1,0,58,0,33,32.9,-1,-2,3,-2,-1,-3,0,-2
"5088",2019-04-02,"Kebler","w1819","Hybrid",13,"Tue","weekday","sled","1","1","1",19.1,0,58,0,33,32.9,-1,-2,3,-2,-1,-3,0,-2
"5089",2019-04-03,"Kebler","w1819","Non.motorized",3,"Wed","weekday","no_sled","2","1","1",19.2,0.1,58,0,31,33.1,0,-1,-2,3,0,-1,-3,0
"5090",2019-04-03,"Kebler","w1819","Mechanized",0,"Wed","weekday","no_sled","2","1","1",19.2,0.1,58,0,31,33.1,0,-1,-2,3,0,-1,-3,0
"5091",2019-04-03,"Kebler","w1819","Motorized",46,"Wed","weekday","sled","2","1","1",19.2,0.1,58,0,31,33.1,0,-1,-2,3,0,-1,-3,0
"5092",2019-04-03,"Kebler","w1819","Hybrid",21,"Wed","weekday","sled","2","1","1",19.2,0.1,58,0,31,33.1,0,-1,-2,3,0,-1,-3,0
"5093",2019-04-04,"Kebler","w1819","Non.motorized",1,"Thu","weekday","no_sled","2","1","1",19.4,0.2,59,1,35,32.9,0,0,-1,-2,1,1,0,-2
"5094",2019-04-04,"Kebler","w1819","Mechanized",0,"Thu","weekday","no_sled","2","1","1",19.4,0.2,59,1,35,32.9,0,0,-1,-2,1,1,0,-2
"5095",2019-04-04,"Kebler","w1819","Motorized",45,"Thu","weekday","sled","2","1","1",19.4,0.2,59,1,35,32.9,0,0,-1,-2,1,1,0,-2
"5096",2019-04-04,"Kebler","w1819","Hybrid",6,"Thu","weekday","sled","2","1","1",19.4,0.2,59,1,35,32.9,0,0,-1,-2,1,1,0,-2
"5097",2019-04-05,"Kebler","w1819","Non.motorized",0,"Fri","weekday","no_sled","1","1","1",19.4,0,57,-2,38,34,1,0,0,-1,-1,-1,-1,-2
"5098",2019-04-05,"Kebler","w1819","Mechanized",0,"Fri","weekday","no_sled","1","1","1",19.4,0,57,-2,38,34,1,0,0,-1,-1,-1,-1,-2
"5099",2019-04-05,"Kebler","w1819","Motorized",47,"Fri","weekday","sled","1","1","1",19.4,0,57,-2,38,34,1,0,0,-1,-1,-1,-1,-2
"5100",2019-04-05,"Kebler","w1819","Hybrid",7,"Fri","weekday","sled","1","1","1",19.4,0,57,-2,38,34,1,0,0,-1,-1,-1,-1,-2
"5101",2019-04-06,"Kebler","w1819","Non.motorized",1,"Sat","weekend","no_sled","1","1","1",19.3,-0.1,57,0,35,33.9,-2,1,0,0,-2,-1,-1,-1
"5102",2019-04-06,"Kebler","w1819","Mechanized",0,"Sat","weekend","no_sled","1","1","1",19.3,-0.1,57,0,35,33.9,-2,1,0,0,-2,-1,-1,-1
"5103",2019-04-06,"Kebler","w1819","Motorized",55,"Sat","weekend","sled","1","1","1",19.3,-0.1,57,0,35,33.9,-2,1,0,0,-2,-1,-1,-1
"5104",2019-04-06,"Kebler","w1819","Hybrid",16,"Sat","weekend","sled","1","1","1",19.3,-0.1,57,0,35,33.9,-2,1,0,0,-2,-1,-1,-1
"5105",2019-04-07,"Kebler","w1819","Non.motorized",0,"Sun","weekend","no_sled","1","1","1",19.1,-0.2,57,0,37,33.5,0,-2,1,0,0,-2,-1,-1
"5106",2019-04-07,"Kebler","w1819","Mechanized",0,"Sun","weekend","no_sled","1","1","1",19.1,-0.2,57,0,37,33.5,0,-2,1,0,0,-2,-1,-1
"5107",2019-04-07,"Kebler","w1819","Motorized",31,"Sun","weekend","sled","1","1","1",19.1,-0.2,57,0,37,33.5,0,-2,1,0,0,-2,-1,-1
"5108",2019-04-07,"Kebler","w1819","Hybrid",0,"Sun","weekend","sled","1","1","1",19.1,-0.2,57,0,37,33.5,0,-2,1,0,0,-2,-1,-1
"5109",2019-04-08,"Kebler","w1819","Non.motorized",3,"Mon","weekday","no_sled","1","2","2",19.3,0.2,54,-3,41,35.7,0,0,-2,1,-3,-3,-5,-4
"5110",2019-04-08,"Kebler","w1819","Mechanized",3,"Mon","weekday","no_sled","1","2","2",19.3,0.2,54,-3,41,35.7,0,0,-2,1,-3,-3,-5,-4
"5111",2019-04-08,"Kebler","w1819","Motorized",32,"Mon","weekday","sled","1","2","2",19.3,0.2,54,-3,41,35.7,0,0,-2,1,-3,-3,-5,-4
"5112",2019-04-08,"Kebler","w1819","Hybrid",7,"Mon","weekday","sled","1","2","2",19.3,0.2,54,-3,41,35.7,0,0,-2,1,-3,-3,-5,-4
"5113",2019-04-09,"Kebler","w1819","Non.motorized",0,"Tue","weekday","no_sled","1","2","2",19.3,0,53,-1,43,36.4,-3,0,0,-2,-4,-4,-4,-6
"5114",2019-04-09,"Kebler","w1819","Mechanized",1,"Tue","weekday","no_sled","1","2","2",19.3,0,53,-1,43,36.4,-3,0,0,-2,-4,-4,-4,-6
"5115",2019-04-09,"Kebler","w1819","Motorized",32,"Tue","weekday","sled","1","2","2",19.3,0,53,-1,43,36.4,-3,0,0,-2,-4,-4,-4,-6
"5116",2019-04-09,"Kebler","w1819","Hybrid",2,"Tue","weekday","sled","1","2","2",19.3,0,53,-1,43,36.4,-3,0,0,-2,-4,-4,-4,-6
"5117",2019-04-10,"Kebler","w1819","Non.motorized",0,"Wed","weekday","no_sled","2","2","1",19,-0.3,51,-2,30,37.3,-1,-3,0,0,-3,-6,-6,-6
"5118",2019-04-10,"Kebler","w1819","Mechanized",0,"Wed","weekday","no_sled","2","2","1",19,-0.3,51,-2,30,37.3,-1,-3,0,0,-3,-6,-6,-6
"5119",2019-04-10,"Kebler","w1819","Motorized",7,"Wed","weekday","sled","2","2","1",19,-0.3,51,-2,30,37.3,-1,-3,0,0,-3,-6,-6,-6
"5120",2019-04-10,"Kebler","w1819","Hybrid",0,"Wed","weekday","sled","2","2","1",19,-0.3,51,-2,30,37.3,-1,-3,0,0,-3,-6,-6,-6
"5121",2019-04-11,"Kebler","w1819","Non.motorized",0,"Thu","weekday","no_sled","3","3","2",18.9,-0.1,53,2,20,35.7,-2,-1,-3,0,0,-1,-4,-4
"5122",2019-04-11,"Kebler","w1819","Mechanized",0,"Thu","weekday","no_sled","3","3","2",18.9,-0.1,53,2,20,35.7,-2,-1,-3,0,0,-1,-4,-4
"5123",2019-04-11,"Kebler","w1819","Motorized",0,"Thu","weekday","sled","3","3","2",18.9,-0.1,53,2,20,35.7,-2,-1,-3,0,0,-1,-4,-4
"5124",2019-04-11,"Kebler","w1819","Hybrid",0,"Thu","weekday","sled","3","3","2",18.9,-0.1,53,2,20,35.7,-2,-1,-3,0,0,-1,-4,-4
"5125",2019-04-12,"Kebler","w1819","Non.motorized",0,"Fri","weekday","no_sled","2","2","1",18.7,-0.2,53,0,24,35.3,2,-2,-1,-3,2,0,-1,-4
"5126",2019-04-12,"Kebler","w1819","Mechanized",0,"Fri","weekday","no_sled","2","2","1",18.7,-0.2,53,0,24,35.3,2,-2,-1,-3,2,0,-1,-4
"5127",2019-04-12,"Kebler","w1819","Motorized",31,"Fri","weekday","sled","2","2","1",18.7,-0.2,53,0,24,35.3,2,-2,-1,-3,2,0,-1,-4
"5128",2019-04-12,"Kebler","w1819","Hybrid",4,"Fri","weekday","sled","2","2","1",18.7,-0.2,53,0,24,35.3,2,-2,-1,-3,2,0,-1,-4
"5129",2019-04-13,"Kebler","w1819","Non.motorized",4,"Sat","weekend","no_sled","1","1","1",18.8,0.1,52,-1,27,36.2,0,2,-2,-1,-1,1,-1,-2
"5130",2019-04-13,"Kebler","w1819","Mechanized",0,"Sat","weekend","no_sled","1","1","1",18.8,0.1,52,-1,27,36.2,0,2,-2,-1,-1,1,-1,-2
"5131",2019-04-13,"Kebler","w1819","Motorized",61,"Sat","weekend","sled","1","1","1",18.8,0.1,52,-1,27,36.2,0,2,-2,-1,-1,1,-1,-2
"5132",2019-04-13,"Kebler","w1819","Hybrid",29,"Sat","weekend","sled","1","1","1",18.8,0.1,52,-1,27,36.2,0,2,-2,-1,-1,1,-1,-2
"5133",2019-04-14,"Kebler","w1819","Non.motorized",1,"Sun","weekend","no_sled","1","1","1",18.7,-0.1,51,-1,35,36.7,-1,0,2,-2,-2,-2,0,-2
"5134",2019-04-14,"Kebler","w1819","Mechanized",0,"Sun","weekend","no_sled","1","1","1",18.7,-0.1,51,-1,35,36.7,-1,0,2,-2,-2,-2,0,-2
"5135",2019-04-14,"Kebler","w1819","Motorized",45,"Sun","weekend","sled","1","1","1",18.7,-0.1,51,-1,35,36.7,-1,0,2,-2,-2,-2,0,-2
"5136",2019-04-14,"Kebler","w1819","Hybrid",14,"Sun","weekend","sled","1","1","1",18.7,-0.1,51,-1,35,36.7,-1,0,2,-2,-2,-2,0,-2
"5137",2019-04-15,"Kebler","w1819","Non.motorized",2,"Mon","weekday","no_sled",NA,NA,NA,18.6,-0.1,50,-1,41,37.2,-1,-1,0,2,-2,-3,-3,-1
"5138",2019-04-15,"Kebler","w1819","Mechanized",0,"Mon","weekday","no_sled",NA,NA,NA,18.6,-0.1,50,-1,41,37.2,-1,-1,0,2,-2,-3,-3,-1
"5139",2019-04-15,"Kebler","w1819","Motorized",16,"Mon","weekday","sled",NA,NA,NA,18.6,-0.1,50,-1,41,37.2,-1,-1,0,2,-2,-3,-3,-1
"5140",2019-04-15,"Kebler","w1819","Hybrid",5,"Mon","weekday","sled",NA,NA,NA,18.6,-0.1,50,-1,41,37.2,-1,-1,0,2,-2,-3,-3,-1
"5141",2018-12-01,"Slate River Rd","w1819","Non.motorized",NA,"Sat","weekend","no_sled","3","3","2",3.3,0.2,19,1,16,17.4,0,0,0,0,1,1,1,1
"5142",2018-12-01,"Slate River Rd","w1819","Mechanized",NA,"Sat","weekend","no_sled","3","3","2",3.3,0.2,19,1,16,17.4,0,0,0,0,1,1,1,1
"5143",2018-12-01,"Slate River Rd","w1819","Motorized",NA,"Sat","weekend","sled","3","3","2",3.3,0.2,19,1,16,17.4,0,0,0,0,1,1,1,1
"5144",2018-12-01,"Slate River Rd","w1819","Hybrid",NA,"Sat","weekend","sled","3","3","2",3.3,0.2,19,1,16,17.4,0,0,0,0,1,1,1,1
"5145",2018-12-02,"Slate River Rd","w1819","Non.motorized",NA,"Sun","weekend","no_sled","3","3","3",3.3,0,20,1,14,16.5,1,0,0,0,2,2,2,2
"5146",2018-12-02,"Slate River Rd","w1819","Mechanized",NA,"Sun","weekend","no_sled","3","3","3",3.3,0,20,1,14,16.5,1,0,0,0,2,2,2,2
"5147",2018-12-02,"Slate River Rd","w1819","Motorized",NA,"Sun","weekend","sled","3","3","3",3.3,0,20,1,14,16.5,1,0,0,0,2,2,2,2
"5148",2018-12-02,"Slate River Rd","w1819","Hybrid",NA,"Sun","weekend","sled","3","3","3",3.3,0,20,1,14,16.5,1,0,0,0,2,2,2,2
"5149",2018-12-03,"Slate River Rd","w1819","Non.motorized",NA,"Mon","weekday","no_sled","3","3","2",3.4,0.1,19,-1,13,17.9,1,1,0,0,0,1,1,1
"5150",2018-12-03,"Slate River Rd","w1819","Mechanized",NA,"Mon","weekday","no_sled","3","3","2",3.4,0.1,19,-1,13,17.9,1,1,0,0,0,1,1,1
"5151",2018-12-03,"Slate River Rd","w1819","Motorized",NA,"Mon","weekday","sled","3","3","2",3.4,0.1,19,-1,13,17.9,1,1,0,0,0,1,1,1
"5152",2018-12-03,"Slate River Rd","w1819","Hybrid",NA,"Mon","weekday","sled","3","3","2",3.4,0.1,19,-1,13,17.9,1,1,0,0,0,1,1,1
"5153",2018-12-04,"Slate River Rd","w1819","Non.motorized",NA,"Tue","weekday","no_sled","3","3","2",3.5,0.1,20,1,8,17.5,-1,1,1,0,0,1,2,2
"5154",2018-12-04,"Slate River Rd","w1819","Mechanized",NA,"Tue","weekday","no_sled","3","3","2",3.5,0.1,20,1,8,17.5,-1,1,1,0,0,1,2,2
"5155",2018-12-04,"Slate River Rd","w1819","Motorized",NA,"Tue","weekday","sled","3","3","2",3.5,0.1,20,1,8,17.5,-1,1,1,0,0,1,2,2
"5156",2018-12-04,"Slate River Rd","w1819","Hybrid",NA,"Tue","weekday","sled","3","3","2",3.5,0.1,20,1,8,17.5,-1,1,1,0,0,1,2,2
"5157",2018-12-05,"Slate River Rd","w1819","Non.motorized",14,"Wed","weekday","no_sled","3","3","2",3.5,0,19,-1,21,18.4,1,-1,1,1,0,-1,0,1
"5158",2018-12-05,"Slate River Rd","w1819","Mechanized",0,"Wed","weekday","no_sled","3","3","2",3.5,0,19,-1,21,18.4,1,-1,1,1,0,-1,0,1
"5159",2018-12-05,"Slate River Rd","w1819","Motorized",10,"Wed","weekday","sled","3","3","2",3.5,0,19,-1,21,18.4,1,-1,1,1,0,-1,0,1
"5160",2018-12-05,"Slate River Rd","w1819","Hybrid",10,"Wed","weekday","sled","3","3","2",3.5,0,19,-1,21,18.4,1,-1,1,1,0,-1,0,1
"5161",2018-12-06,"Slate River Rd","w1819","Non.motorized",5,"Thu","weekday","no_sled","2","2","2",3.7,0.2,18,-1,25,20.6,-1,1,-1,1,-2,-1,-2,-1
"5162",2018-12-06,"Slate River Rd","w1819","Mechanized",0,"Thu","weekday","no_sled","2","2","2",3.7,0.2,18,-1,25,20.6,-1,1,-1,1,-2,-1,-2,-1
"5163",2018-12-06,"Slate River Rd","w1819","Motorized",6,"Thu","weekday","sled","2","2","2",3.7,0.2,18,-1,25,20.6,-1,1,-1,1,-2,-1,-2,-1
"5164",2018-12-06,"Slate River Rd","w1819","Hybrid",6,"Thu","weekday","sled","2","2","2",3.7,0.2,18,-1,25,20.6,-1,1,-1,1,-2,-1,-2,-1
"5165",2018-12-07,"Slate River Rd","w1819","Non.motorized",11,"Fri","weekday","no_sled","2","2","2",3.8,0.1,21,3,23,18.1,-1,-1,1,-1,2,1,2,1
"5166",2018-12-07,"Slate River Rd","w1819","Mechanized",0,"Fri","weekday","no_sled","2","2","2",3.8,0.1,21,3,23,18.1,-1,-1,1,-1,2,1,2,1
"5167",2018-12-07,"Slate River Rd","w1819","Motorized",13,"Fri","weekday","sled","2","2","2",3.8,0.1,21,3,23,18.1,-1,-1,1,-1,2,1,2,1
"5168",2018-12-07,"Slate River Rd","w1819","Hybrid",13,"Fri","weekday","sled","2","2","2",3.8,0.1,21,3,23,18.1,-1,-1,1,-1,2,1,2,1
"5169",2018-12-08,"Slate River Rd","w1819","Non.motorized",24,"Sat","weekend","no_sled","2","2","2",3.8,0,20,-1,23,19,3,-1,-1,1,2,1,0,1
"5170",2018-12-08,"Slate River Rd","w1819","Mechanized",0,"Sat","weekend","no_sled","2","2","2",3.8,0,20,-1,23,19,3,-1,-1,1,2,1,0,1
"5171",2018-12-08,"Slate River Rd","w1819","Motorized",23,"Sat","weekend","sled","2","2","2",3.8,0,20,-1,23,19,3,-1,-1,1,2,1,0,1
"5172",2018-12-08,"Slate River Rd","w1819","Hybrid",22,"Sat","weekend","sled","2","2","2",3.8,0,20,-1,23,19,3,-1,-1,1,2,1,0,1
"5173",2018-12-09,"Slate River Rd","w1819","Non.motorized",39,"Sun","weekend","no_sled","2","2","2",3.8,0,20,0,19,19,-1,3,-1,-1,-1,2,1,0
"5174",2018-12-09,"Slate River Rd","w1819","Mechanized",0,"Sun","weekend","no_sled","2","2","2",3.8,0,20,0,19,19,-1,3,-1,-1,-1,2,1,0
"5175",2018-12-09,"Slate River Rd","w1819","Motorized",10,"Sun","weekend","sled","2","2","2",3.8,0,20,0,19,19,-1,3,-1,-1,-1,2,1,0
"5176",2018-12-09,"Slate River Rd","w1819","Hybrid",10,"Sun","weekend","sled","2","2","2",3.8,0,20,0,19,19,-1,3,-1,-1,-1,2,1,0
"5177",2018-12-10,"Slate River Rd","w1819","Non.motorized",10,"Mon","weekday","no_sled","2","2","2",3.8,0,20,0,21,19,0,-1,3,-1,0,-1,2,1
"5178",2018-12-10,"Slate River Rd","w1819","Mechanized",0,"Mon","weekday","no_sled","2","2","2",3.8,0,20,0,21,19,0,-1,3,-1,0,-1,2,1
"5179",2018-12-10,"Slate River Rd","w1819","Motorized",10,"Mon","weekday","sled","2","2","2",3.8,0,20,0,21,19,0,-1,3,-1,0,-1,2,1
"5180",2018-12-10,"Slate River Rd","w1819","Hybrid",10,"Mon","weekday","sled","2","2","2",3.8,0,20,0,21,19,0,-1,3,-1,0,-1,2,1
"5181",2018-12-11,"Slate River Rd","w1819","Non.motorized",8,"Tue","weekday","no_sled","2","2","2",3.9,0.1,19,-1,27,20.5,0,0,-1,3,-1,-1,-2,1
"5182",2018-12-11,"Slate River Rd","w1819","Mechanized",0,"Tue","weekday","no_sled","2","2","2",3.9,0.1,19,-1,27,20.5,0,0,-1,3,-1,-1,-2,1
"5183",2018-12-11,"Slate River Rd","w1819","Motorized",7,"Tue","weekday","sled","2","2","2",3.9,0.1,19,-1,27,20.5,0,0,-1,3,-1,-1,-2,1
"5184",2018-12-11,"Slate River Rd","w1819","Hybrid",7,"Tue","weekday","sled","2","2","2",3.9,0.1,19,-1,27,20.5,0,0,-1,3,-1,-1,-2,1
"5185",2018-12-12,"Slate River Rd","w1819","Non.motorized",6,"Wed","weekday","no_sled","2","2","1",3.9,0,19,0,21,20.5,-1,0,0,-1,-1,-1,-1,-2
"5186",2018-12-12,"Slate River Rd","w1819","Mechanized",0,"Wed","weekday","no_sled","2","2","1",3.9,0,19,0,21,20.5,-1,0,0,-1,-1,-1,-1,-2
"5187",2018-12-12,"Slate River Rd","w1819","Motorized",4,"Wed","weekday","sled","2","2","1",3.9,0,19,0,21,20.5,-1,0,0,-1,-1,-1,-1,-2
"5188",2018-12-12,"Slate River Rd","w1819","Hybrid",4,"Wed","weekday","sled","2","2","1",3.9,0,19,0,21,20.5,-1,0,0,-1,-1,-1,-1,-2
"5189",2018-12-13,"Slate River Rd","w1819","Non.motorized",0,"Thu","weekday","no_sled","3","3","2",4,0.1,21,2,15,19,0,-1,0,0,2,1,1,1
"5190",2018-12-13,"Slate River Rd","w1819","Mechanized",0,"Thu","weekday","no_sled","3","3","2",4,0.1,21,2,15,19,0,-1,0,0,2,1,1,1
"5191",2018-12-13,"Slate River Rd","w1819","Motorized",0,"Thu","weekday","sled","3","3","2",4,0.1,21,2,15,19,0,-1,0,0,2,1,1,1
"5192",2018-12-13,"Slate River Rd","w1819","Hybrid",0,"Thu","weekday","sled","3","3","2",4,0.1,21,2,15,19,0,-1,0,0,2,1,1,1
"5193",2018-12-14,"Slate River Rd","w1819","Non.motorized",12,"Fri","weekday","no_sled","3","3","2",4,0,20,-1,24,20,2,0,-1,0,1,1,0,0
"5194",2018-12-14,"Slate River Rd","w1819","Mechanized",0,"Fri","weekday","no_sled","3","3","2",4,0,20,-1,24,20,2,0,-1,0,1,1,0,0
"5195",2018-12-14,"Slate River Rd","w1819","Motorized",6,"Fri","weekday","sled","3","3","2",4,0,20,-1,24,20,2,0,-1,0,1,1,0,0
"5196",2018-12-14,"Slate River Rd","w1819","Hybrid",6,"Fri","weekday","sled","3","3","2",4,0,20,-1,24,20,2,0,-1,0,1,1,0,0
"5197",2018-12-15,"Slate River Rd","w1819","Non.motorized",42,"Sat","weekend","no_sled","2","2","2",4,0,20,0,29,20,-1,2,0,-1,-1,1,1,0
"5198",2018-12-15,"Slate River Rd","w1819","Mechanized",0,"Sat","weekend","no_sled","2","2","2",4,0,20,0,29,20,-1,2,0,-1,-1,1,1,0
"5199",2018-12-15,"Slate River Rd","w1819","Motorized",14,"Sat","weekend","sled","2","2","2",4,0,20,0,29,20,-1,2,0,-1,-1,1,1,0
"5200",2018-12-15,"Slate River Rd","w1819","Hybrid",8,"Sat","weekend","sled","2","2","2",4,0,20,0,29,20,-1,2,0,-1,-1,1,1,0
"5201",2018-12-16,"Slate River Rd","w1819","Non.motorized",29,"Sun","weekend","no_sled","2","2","2",4.1,0.1,19,-1,28,21.6,0,-1,2,0,-1,-2,0,0
"5202",2018-12-16,"Slate River Rd","w1819","Mechanized",0,"Sun","weekend","no_sled","2","2","2",4.1,0.1,19,-1,28,21.6,0,-1,2,0,-1,-2,0,0
"5203",2018-12-16,"Slate River Rd","w1819","Motorized",21,"Sun","weekend","sled","2","2","2",4.1,0.1,19,-1,28,21.6,0,-1,2,0,-1,-2,0,0
"5204",2018-12-16,"Slate River Rd","w1819","Hybrid",21,"Sun","weekend","sled","2","2","2",4.1,0.1,19,-1,28,21.6,0,-1,2,0,-1,-2,0,0
"5205",2018-12-17,"Slate River Rd","w1819","Non.motorized",14,"Mon","weekday","no_sled","2","2","2",4.1,0,19,0,29,21.6,-1,0,-1,2,-1,-1,-2,0
"5206",2018-12-17,"Slate River Rd","w1819","Mechanized",0,"Mon","weekday","no_sled","2","2","2",4.1,0,19,0,29,21.6,-1,0,-1,2,-1,-1,-2,0
"5207",2018-12-17,"Slate River Rd","w1819","Motorized",2,"Mon","weekday","sled","2","2","2",4.1,0,19,0,29,21.6,-1,0,-1,2,-1,-1,-2,0
"5208",2018-12-17,"Slate River Rd","w1819","Hybrid",2,"Mon","weekday","sled","2","2","2",4.1,0,19,0,29,21.6,-1,0,-1,2,-1,-1,-2,0
"5209",2018-12-18,"Slate River Rd","w1819","Non.motorized",21,"Tue","weekday","no_sled","2","2","2",4.1,0,19,0,27,21.6,0,-1,0,-1,0,-1,-1,-2
"5210",2018-12-18,"Slate River Rd","w1819","Mechanized",0,"Tue","weekday","no_sled","2","2","2",4.1,0,19,0,27,21.6,0,-1,0,-1,0,-1,-1,-2
"5211",2018-12-18,"Slate River Rd","w1819","Motorized",7,"Tue","weekday","sled","2","2","2",4.1,0,19,0,27,21.6,0,-1,0,-1,0,-1,-1,-2
"5212",2018-12-18,"Slate River Rd","w1819","Hybrid",7,"Tue","weekday","sled","2","2","2",4.1,0,19,0,27,21.6,0,-1,0,-1,0,-1,-1,-2
"5213",2018-12-19,"Slate River Rd","w1819","Non.motorized",10,"Wed","weekday","no_sled","2","2","2",4.1,0,19,0,24,21.6,0,0,-1,0,0,0,-1,-1
"5214",2018-12-19,"Slate River Rd","w1819","Mechanized",0,"Wed","weekday","no_sled","2","2","2",4.1,0,19,0,24,21.6,0,0,-1,0,0,0,-1,-1
"5215",2018-12-19,"Slate River Rd","w1819","Motorized",3,"Wed","weekday","sled","2","2","2",4.1,0,19,0,24,21.6,0,0,-1,0,0,0,-1,-1
"5216",2018-12-19,"Slate River Rd","w1819","Hybrid",3,"Wed","weekday","sled","2","2","2",4.1,0,19,0,24,21.6,0,0,-1,0,0,0,-1,-1
"5217",2018-12-20,"Slate River Rd","w1819","Non.motorized",24,"Thu","weekday","no_sled","2","2","1",4.1,0,20,1,25,20.5,0,0,0,-1,1,1,1,0
"5218",2018-12-20,"Slate River Rd","w1819","Mechanized",0,"Thu","weekday","no_sled","2","2","1",4.1,0,20,1,25,20.5,0,0,0,-1,1,1,1,0
"5219",2018-12-20,"Slate River Rd","w1819","Motorized",7,"Thu","weekday","sled","2","2","1",4.1,0,20,1,25,20.5,0,0,0,-1,1,1,1,0
"5220",2018-12-20,"Slate River Rd","w1819","Hybrid",7,"Thu","weekday","sled","2","2","1",4.1,0,20,1,25,20.5,0,0,0,-1,1,1,1,0
"5221",2018-12-21,"Slate River Rd","w1819","Non.motorized",9,"Fri","weekday","no_sled","2","2","1",4.1,0,19,-1,28,21.6,1,0,0,0,0,0,0,0
"5222",2018-12-21,"Slate River Rd","w1819","Mechanized",0,"Fri","weekday","no_sled","2","2","1",4.1,0,19,-1,28,21.6,1,0,0,0,0,0,0,0
"5223",2018-12-21,"Slate River Rd","w1819","Motorized",6,"Fri","weekday","sled","2","2","1",4.1,0,19,-1,28,21.6,1,0,0,0,0,0,0,0
"5224",2018-12-21,"Slate River Rd","w1819","Hybrid",6,"Fri","weekday","sled","2","2","1",4.1,0,19,-1,28,21.6,1,0,0,0,0,0,0,0
"5225",2018-12-22,"Slate River Rd","w1819","Non.motorized",29,"Sat","weekend","no_sled","2","2","1",4.2,0.1,19,0,20,22.1,-1,1,0,0,-1,0,0,0
"5226",2018-12-22,"Slate River Rd","w1819","Mechanized",0,"Sat","weekend","no_sled","2","2","1",4.2,0.1,19,0,20,22.1,-1,1,0,0,-1,0,0,0
"5227",2018-12-22,"Slate River Rd","w1819","Motorized",8,"Sat","weekend","sled","2","2","1",4.2,0.1,19,0,20,22.1,-1,1,0,0,-1,0,0,0
"5228",2018-12-22,"Slate River Rd","w1819","Hybrid",8,"Sat","weekend","sled","2","2","1",4.2,0.1,19,0,20,22.1,-1,1,0,0,-1,0,0,0
"5229",2018-12-23,"Slate River Rd","w1819","Non.motorized",39,"Sun","weekend","no_sled","2","2","1",4.2,0,21,2,19,20,0,-1,1,0,2,1,2,2
"5230",2018-12-23,"Slate River Rd","w1819","Mechanized",0,"Sun","weekend","no_sled","2","2","1",4.2,0,21,2,19,20,0,-1,1,0,2,1,2,2
"5231",2018-12-23,"Slate River Rd","w1819","Motorized",16,"Sun","weekend","sled","2","2","1",4.2,0,21,2,19,20,0,-1,1,0,2,1,2,2
"5232",2018-12-23,"Slate River Rd","w1819","Hybrid",16,"Sun","weekend","sled","2","2","1",4.2,0,21,2,19,20,0,-1,1,0,2,1,2,2
"5233",2018-12-24,"Slate River Rd","w1819","Non.motorized",37,"Mon","weekday","no_sled","2","2","2",4.3,0.1,20,-1,21,21.5,2,0,-1,1,1,1,0,1
"5234",2018-12-24,"Slate River Rd","w1819","Mechanized",1,"Mon","weekday","no_sled","2","2","2",4.3,0.1,20,-1,21,21.5,2,0,-1,1,1,1,0,1
"5235",2018-12-24,"Slate River Rd","w1819","Motorized",11,"Mon","weekday","sled","2","2","2",4.3,0.1,20,-1,21,21.5,2,0,-1,1,1,1,0,1
"5236",2018-12-24,"Slate River Rd","w1819","Hybrid",11,"Mon","weekday","sled","2","2","2",4.3,0.1,20,-1,21,21.5,2,0,-1,1,1,1,0,1
"5237",2018-12-25,"Slate River Rd","w1819","Non.motorized",61,"Tue","weekday","no_sled","2","2","2",4.7,0.4,25,5,25,18.8,-1,2,0,-1,4,6,6,5
"5238",2018-12-25,"Slate River Rd","w1819","Mechanized",0,"Tue","weekday","no_sled","2","2","2",4.7,0.4,25,5,25,18.8,-1,2,0,-1,4,6,6,5
"5239",2018-12-25,"Slate River Rd","w1819","Motorized",15,"Tue","weekday","sled","2","2","2",4.7,0.4,25,5,25,18.8,-1,2,0,-1,4,6,6,5
"5240",2018-12-25,"Slate River Rd","w1819","Hybrid",15,"Tue","weekday","sled","2","2","2",4.7,0.4,25,5,25,18.8,-1,2,0,-1,4,6,6,5
"5241",2018-12-26,"Slate River Rd","w1819","Non.motorized",35,"Wed","weekday","no_sled","3","3","3",4.7,0,23,-2,24,20.4,5,-1,2,0,3,2,4,4
"5242",2018-12-26,"Slate River Rd","w1819","Mechanized",0,"Wed","weekday","no_sled","3","3","3",4.7,0,23,-2,24,20.4,5,-1,2,0,3,2,4,4
"5243",2018-12-26,"Slate River Rd","w1819","Motorized",16,"Wed","weekday","sled","3","3","3",4.7,0,23,-2,24,20.4,5,-1,2,0,3,2,4,4
"5244",2018-12-26,"Slate River Rd","w1819","Hybrid",11,"Wed","weekday","sled","3","3","3",4.7,0,23,-2,24,20.4,5,-1,2,0,3,2,4,4
"5245",2018-12-27,"Slate River Rd","w1819","Non.motorized",19,"Thu","weekday","no_sled","3","3","2",4.7,0,24,1,12,19.6,-2,5,-1,2,-1,4,3,5
"5246",2018-12-27,"Slate River Rd","w1819","Mechanized",1,"Thu","weekday","no_sled","3","3","2",4.7,0,24,1,12,19.6,-2,5,-1,2,-1,4,3,5
"5247",2018-12-27,"Slate River Rd","w1819","Motorized",7,"Thu","weekday","sled","3","3","2",4.7,0,24,1,12,19.6,-2,5,-1,2,-1,4,3,5
"5248",2018-12-27,"Slate River Rd","w1819","Hybrid",5,"Thu","weekday","sled","3","3","2",4.7,0,24,1,12,19.6,-2,5,-1,2,-1,4,3,5
"5249",2018-12-28,"Slate River Rd","w1819","Non.motorized",60,"Fri","weekday","no_sled","3","3","2",4.7,0,24,0,12,19.6,1,-2,5,-1,1,-1,4,3
"5250",2018-12-28,"Slate River Rd","w1819","Mechanized",0,"Fri","weekday","no_sled","3","3","2",4.7,0,24,0,12,19.6,1,-2,5,-1,1,-1,4,3
"5251",2018-12-28,"Slate River Rd","w1819","Motorized",10,"Fri","weekday","sled","3","3","2",4.7,0,24,0,12,19.6,1,-2,5,-1,1,-1,4,3
"5252",2018-12-28,"Slate River Rd","w1819","Hybrid",8,"Fri","weekday","sled","3","3","2",4.7,0,24,0,12,19.6,1,-2,5,-1,1,-1,4,3
"5253",2018-12-29,"Slate River Rd","w1819","Non.motorized",50,"Sat","weekend","no_sled","3","3","2",4.7,0,24,0,8,19.6,0,1,-2,5,0,1,-1,4
"5254",2018-12-29,"Slate River Rd","w1819","Mechanized",2,"Sat","weekend","no_sled","3","3","2",4.7,0,24,0,8,19.6,0,1,-2,5,0,1,-1,4
"5255",2018-12-29,"Slate River Rd","w1819","Motorized",51,"Sat","weekend","sled","3","3","2",4.7,0,24,0,8,19.6,0,1,-2,5,0,1,-1,4
"5256",2018-12-29,"Slate River Rd","w1819","Hybrid",10,"Sat","weekend","sled","3","3","2",4.7,0,24,0,8,19.6,0,1,-2,5,0,1,-1,4
"5257",2018-12-30,"Slate River Rd","w1819","Non.motorized",54,"Sun","weekend","no_sled","3","3","2",4.7,0,24,0,16,19.6,0,0,1,-2,0,0,1,-1
"5258",2018-12-30,"Slate River Rd","w1819","Mechanized",1,"Sun","weekend","no_sled","3","3","2",4.7,0,24,0,16,19.6,0,0,1,-2,0,0,1,-1
"5259",2018-12-30,"Slate River Rd","w1819","Motorized",26,"Sun","weekend","sled","3","3","2",4.7,0,24,0,16,19.6,0,0,1,-2,0,0,1,-1
"5260",2018-12-30,"Slate River Rd","w1819","Hybrid",20,"Sun","weekend","sled","3","3","2",4.7,0,24,0,16,19.6,0,0,1,-2,0,0,1,-1
"5261",2018-12-31,"Slate River Rd","w1819","Non.motorized",36,"Mon","weekday","no_sled","3","3","3",4.9,0.2,23,-1,14,21.3,0,0,0,1,-1,-1,-1,0
"5262",2018-12-31,"Slate River Rd","w1819","Mechanized",0,"Mon","weekday","no_sled","3","3","3",4.9,0.2,23,-1,14,21.3,0,0,0,1,-1,-1,-1,0
"5263",2018-12-31,"Slate River Rd","w1819","Motorized",6,"Mon","weekday","sled","3","3","3",4.9,0.2,23,-1,14,21.3,0,0,0,1,-1,-1,-1,0
"5264",2018-12-31,"Slate River Rd","w1819","Hybrid",6,"Mon","weekday","sled","3","3","3",4.9,0.2,23,-1,14,21.3,0,0,0,1,-1,-1,-1,0
"5265",2019-01-01,"Slate River Rd","w1819","Non.motorized",29,"Tue","weekday","no_sled","3","3","3",5.1,0.2,29,6,11,17.6,-1,0,0,0,5,5,5,5
"5266",2019-01-01,"Slate River Rd","w1819","Mechanized",2,"Tue","weekday","no_sled","3","3","3",5.1,0.2,29,6,11,17.6,-1,0,0,0,5,5,5,5
"5267",2019-01-01,"Slate River Rd","w1819","Motorized",23,"Tue","weekday","sled","3","3","3",5.1,0.2,29,6,11,17.6,-1,0,0,0,5,5,5,5
"5268",2019-01-01,"Slate River Rd","w1819","Hybrid",23,"Tue","weekday","sled","3","3","3",5.1,0.2,29,6,11,17.6,-1,0,0,0,5,5,5,5
"5269",2019-01-02,"Slate River Rd","w1819","Non.motorized",25,"Wed","weekday","no_sled","3","3","2",5.1,0,28,-1,10,18.2,6,-1,0,0,5,4,4,4
"5270",2019-01-02,"Slate River Rd","w1819","Mechanized",0,"Wed","weekday","no_sled","3","3","2",5.1,0,28,-1,10,18.2,6,-1,0,0,5,4,4,4
"5271",2019-01-02,"Slate River Rd","w1819","Motorized",4,"Wed","weekday","sled","3","3","2",5.1,0,28,-1,10,18.2,6,-1,0,0,5,4,4,4
"5272",2019-01-02,"Slate River Rd","w1819","Hybrid",4,"Wed","weekday","sled","3","3","2",5.1,0,28,-1,10,18.2,6,-1,0,0,5,4,4,4
"5273",2019-01-03,"Slate River Rd","w1819","Non.motorized",45,"Thu","weekday","no_sled","3","3","2",5.1,0,27,-1,22,18.9,-1,6,-1,0,-2,4,3,3
"5274",2019-01-03,"Slate River Rd","w1819","Mechanized",1,"Thu","weekday","no_sled","3","3","2",5.1,0,27,-1,22,18.9,-1,6,-1,0,-2,4,3,3
"5275",2019-01-03,"Slate River Rd","w1819","Motorized",2,"Thu","weekday","sled","3","3","2",5.1,0,27,-1,22,18.9,-1,6,-1,0,-2,4,3,3
"5276",2019-01-03,"Slate River Rd","w1819","Hybrid",1,"Thu","weekday","sled","3","3","2",5.1,0,27,-1,22,18.9,-1,6,-1,0,-2,4,3,3
"5277",2019-01-04,"Slate River Rd","w1819","Non.motorized",18,"Fri","weekday","no_sled","3","3","2",5.3,0.2,26,-1,29,20.4,-1,-1,6,-1,-2,-3,3,2
"5278",2019-01-04,"Slate River Rd","w1819","Mechanized",1,"Fri","weekday","no_sled","3","3","2",5.3,0.2,26,-1,29,20.4,-1,-1,6,-1,-2,-3,3,2
"5279",2019-01-04,"Slate River Rd","w1819","Motorized",8,"Fri","weekday","sled","3","3","2",5.3,0.2,26,-1,29,20.4,-1,-1,6,-1,-2,-3,3,2
"5280",2019-01-04,"Slate River Rd","w1819","Hybrid",8,"Fri","weekday","sled","3","3","2",5.3,0.2,26,-1,29,20.4,-1,-1,6,-1,-2,-3,3,2
"5281",2019-01-05,"Slate River Rd","w1819","Non.motorized",49,"Sat","weekend","no_sled","2","2","2",5.3,0,25,-1,30,21.2,-1,-1,-1,6,-2,-3,-4,2
"5282",2019-01-05,"Slate River Rd","w1819","Mechanized",4,"Sat","weekend","no_sled","2","2","2",5.3,0,25,-1,30,21.2,-1,-1,-1,6,-2,-3,-4,2
"5283",2019-01-05,"Slate River Rd","w1819","Motorized",16,"Sat","weekend","sled","2","2","2",5.3,0,25,-1,30,21.2,-1,-1,-1,6,-2,-3,-4,2
"5284",2019-01-05,"Slate River Rd","w1819","Hybrid",16,"Sat","weekend","sled","2","2","2",5.3,0,25,-1,30,21.2,-1,-1,-1,6,-2,-3,-4,2
"5285",2019-01-06,"Slate River Rd","w1819","Non.motorized",23,"Sun","weekend","no_sled","3","3","3",5.3,0,25,0,26,21.2,-1,-1,-1,-1,-1,-2,-3,-4
"5286",2019-01-06,"Slate River Rd","w1819","Mechanized",0,"Sun","weekend","no_sled","3","3","3",5.3,0,25,0,26,21.2,-1,-1,-1,-1,-1,-2,-3,-4
"5287",2019-01-06,"Slate River Rd","w1819","Motorized",10,"Sun","weekend","sled","3","3","3",5.3,0,25,0,26,21.2,-1,-1,-1,-1,-1,-2,-3,-4
"5288",2019-01-06,"Slate River Rd","w1819","Hybrid",8,"Sun","weekend","sled","3","3","3",5.3,0,25,0,26,21.2,-1,-1,-1,-1,-1,-2,-3,-4
"5289",2019-01-07,"Slate River Rd","w1819","Non.motorized",5,"Mon","weekday","no_sled","3","3","3",5.8,0.5,32,7,21,18.1,0,-1,-1,-1,7,6,5,4
"5290",2019-01-07,"Slate River Rd","w1819","Mechanized",0,"Mon","weekday","no_sled","3","3","3",5.8,0.5,32,7,21,18.1,0,-1,-1,-1,7,6,5,4
"5291",2019-01-07,"Slate River Rd","w1819","Motorized",7,"Mon","weekday","sled","3","3","3",5.8,0.5,32,7,21,18.1,0,-1,-1,-1,7,6,5,4
"5292",2019-01-07,"Slate River Rd","w1819","Hybrid",7,"Mon","weekday","sled","3","3","3",5.8,0.5,32,7,21,18.1,0,-1,-1,-1,7,6,5,4
"5293",2019-01-08,"Slate River Rd","w1819","Non.motorized",17,"Tue","weekday","no_sled","3","3","3",5.9,0.1,32,0,24,18.4,7,0,-1,-1,7,7,6,5
"5294",2019-01-08,"Slate River Rd","w1819","Mechanized",0,"Tue","weekday","no_sled","3","3","3",5.9,0.1,32,0,24,18.4,7,0,-1,-1,7,7,6,5
"5295",2019-01-08,"Slate River Rd","w1819","Motorized",3,"Tue","weekday","sled","3","3","3",5.9,0.1,32,0,24,18.4,7,0,-1,-1,7,7,6,5
"5296",2019-01-08,"Slate River Rd","w1819","Hybrid",3,"Tue","weekday","sled","3","3","3",5.9,0.1,32,0,24,18.4,7,0,-1,-1,7,7,6,5
"5297",2019-01-09,"Slate River Rd","w1819","Non.motorized",25,"Wed","weekday","no_sled","3","3","3",6,0.1,30,-2,29,20,0,7,0,-1,-2,5,5,4
"5298",2019-01-09,"Slate River Rd","w1819","Mechanized",0,"Wed","weekday","no_sled","3","3","3",6,0.1,30,-2,29,20,0,7,0,-1,-2,5,5,4
"5299",2019-01-09,"Slate River Rd","w1819","Motorized",7,"Wed","weekday","sled","3","3","3",6,0.1,30,-2,29,20,0,7,0,-1,-2,5,5,4
"5300",2019-01-09,"Slate River Rd","w1819","Hybrid",7,"Wed","weekday","sled","3","3","3",6,0.1,30,-2,29,20,0,7,0,-1,-2,5,5,4
"5301",2019-01-10,"Slate River Rd","w1819","Non.motorized",20,"Thu","weekday","no_sled","3","3","3",6,0,29,-1,29,20.7,-2,0,7,0,-3,-3,4,4
"5302",2019-01-10,"Slate River Rd","w1819","Mechanized",0,"Thu","weekday","no_sled","3","3","3",6,0,29,-1,29,20.7,-2,0,7,0,-3,-3,4,4
"5303",2019-01-10,"Slate River Rd","w1819","Motorized",10,"Thu","weekday","sled","3","3","3",6,0,29,-1,29,20.7,-2,0,7,0,-3,-3,4,4
"5304",2019-01-10,"Slate River Rd","w1819","Hybrid",10,"Thu","weekday","sled","3","3","3",6,0,29,-1,29,20.7,-2,0,7,0,-3,-3,4,4
"5305",2019-01-11,"Slate River Rd","w1819","Non.motorized",17,"Fri","weekday","no_sled","2","2","2",6.1,0.1,29,0,25,21,-1,-2,0,7,-1,-3,-3,4
"5306",2019-01-11,"Slate River Rd","w1819","Mechanized",0,"Fri","weekday","no_sled","2","2","2",6.1,0.1,29,0,25,21,-1,-2,0,7,-1,-3,-3,4
"5307",2019-01-11,"Slate River Rd","w1819","Motorized",13,"Fri","weekday","sled","2","2","2",6.1,0.1,29,0,25,21,-1,-2,0,7,-1,-3,-3,4
"5308",2019-01-11,"Slate River Rd","w1819","Hybrid",12,"Fri","weekday","sled","2","2","2",6.1,0.1,29,0,25,21,-1,-2,0,7,-1,-3,-3,4
"5309",2019-01-12,"Slate River Rd","w1819","Non.motorized",14,"Sat","weekend","no_sled","3","3","2",6.1,0,28,-1,21,21.8,0,-1,-2,0,-1,-2,-4,-4
"5310",2019-01-12,"Slate River Rd","w1819","Mechanized",0,"Sat","weekend","no_sled","3","3","2",6.1,0,28,-1,21,21.8,0,-1,-2,0,-1,-2,-4,-4
"5311",2019-01-12,"Slate River Rd","w1819","Motorized",14,"Sat","weekend","sled","3","3","2",6.1,0,28,-1,21,21.8,0,-1,-2,0,-1,-2,-4,-4
"5312",2019-01-12,"Slate River Rd","w1819","Hybrid",14,"Sat","weekend","sled","3","3","2",6.1,0,28,-1,21,21.8,0,-1,-2,0,-1,-2,-4,-4
"5313",2019-01-13,"Slate River Rd","w1819","Non.motorized",23,"Sun","weekend","no_sled","2","2","2",6.2,0.1,30,2,18,20.7,-1,0,-1,-2,1,1,0,-2
"5314",2019-01-13,"Slate River Rd","w1819","Mechanized",0,"Sun","weekend","no_sled","2","2","2",6.2,0.1,30,2,18,20.7,-1,0,-1,-2,1,1,0,-2
"5315",2019-01-13,"Slate River Rd","w1819","Motorized",6,"Sun","weekend","sled","2","2","2",6.2,0.1,30,2,18,20.7,-1,0,-1,-2,1,1,0,-2
"5316",2019-01-13,"Slate River Rd","w1819","Hybrid",6,"Sun","weekend","sled","2","2","2",6.2,0.1,30,2,18,20.7,-1,0,-1,-2,1,1,0,-2
"5317",2019-01-14,"Slate River Rd","w1819","Non.motorized",22,"Mon","weekday","no_sled","2","2","2",6.2,0,30,0,18,20.7,2,-1,0,-1,2,1,1,0
"5318",2019-01-14,"Slate River Rd","w1819","Mechanized",0,"Mon","weekday","no_sled","2","2","2",6.2,0,30,0,18,20.7,2,-1,0,-1,2,1,1,0
"5319",2019-01-14,"Slate River Rd","w1819","Motorized",9,"Mon","weekday","sled","2","2","2",6.2,0,30,0,18,20.7,2,-1,0,-1,2,1,1,0
"5320",2019-01-14,"Slate River Rd","w1819","Hybrid",8,"Mon","weekday","sled","2","2","2",6.2,0,30,0,18,20.7,2,-1,0,-1,2,1,1,0
"5321",2019-01-15,"Slate River Rd","w1819","Non.motorized",18,"Tue","weekday","no_sled","2","2","2",6.2,0,29,-1,24,21.4,0,2,-1,0,-1,1,0,0
"5322",2019-01-15,"Slate River Rd","w1819","Mechanized",0,"Tue","weekday","no_sled","2","2","2",6.2,0,29,-1,24,21.4,0,2,-1,0,-1,1,0,0
"5323",2019-01-15,"Slate River Rd","w1819","Motorized",4,"Tue","weekday","sled","2","2","2",6.2,0,29,-1,24,21.4,0,2,-1,0,-1,1,0,0
"5324",2019-01-15,"Slate River Rd","w1819","Hybrid",4,"Tue","weekday","sled","2","2","2",6.2,0,29,-1,24,21.4,0,2,-1,0,-1,1,0,0
"5325",2019-01-16,"Slate River Rd","w1819","Non.motorized",3,"Wed","weekday","no_sled","4","4","3",6.3,0.1,29,0,26,21.7,-1,0,2,-1,-1,-1,1,0
"5326",2019-01-16,"Slate River Rd","w1819","Mechanized",0,"Wed","weekday","no_sled","4","4","3",6.3,0.1,29,0,26,21.7,-1,0,2,-1,-1,-1,1,0
"5327",2019-01-16,"Slate River Rd","w1819","Motorized",0,"Wed","weekday","sled","4","4","3",6.3,0.1,29,0,26,21.7,-1,0,2,-1,-1,-1,1,0
"5328",2019-01-16,"Slate River Rd","w1819","Hybrid",0,"Wed","weekday","sled","4","4","3",6.3,0.1,29,0,26,21.7,-1,0,2,-1,-1,-1,1,0
"5329",2019-01-17,"Slate River Rd","w1819","Non.motorized",8,"Thu","weekday","no_sled","3","3","2",7,0.7,38,9,28,18.4,0,-1,0,2,9,8,8,10
"5330",2019-01-17,"Slate River Rd","w1819","Mechanized",0,"Thu","weekday","no_sled","3","3","2",7,0.7,38,9,28,18.4,0,-1,0,2,9,8,8,10
"5331",2019-01-17,"Slate River Rd","w1819","Motorized",4,"Thu","weekday","sled","3","3","2",7,0.7,38,9,28,18.4,0,-1,0,2,9,8,8,10
"5332",2019-01-17,"Slate River Rd","w1819","Hybrid",3,"Thu","weekday","sled","3","3","2",7,0.7,38,9,28,18.4,0,-1,0,2,9,8,8,10
"5333",2019-01-18,"Slate River Rd","w1819","Non.motorized",10,"Fri","weekday","no_sled","4","4","4",7.5,0.5,41,3,22,18.3,9,0,-1,0,12,12,11,11
"5334",2019-01-18,"Slate River Rd","w1819","Mechanized",0,"Fri","weekday","no_sled","4","4","4",7.5,0.5,41,3,22,18.3,9,0,-1,0,12,12,11,11
"5335",2019-01-18,"Slate River Rd","w1819","Motorized",1,"Fri","weekday","sled","4","4","4",7.5,0.5,41,3,22,18.3,9,0,-1,0,12,12,11,11
"5336",2019-01-18,"Slate River Rd","w1819","Hybrid",1,"Fri","weekday","sled","4","4","4",7.5,0.5,41,3,22,18.3,9,0,-1,0,12,12,11,11
"5337",2019-01-19,"Slate River Rd","w1819","Non.motorized",0,"Sat","weekend","no_sled","3","3","3",7.8,0.3,43,2,20,18.1,3,9,0,-1,5,14,14,13
"5338",2019-01-19,"Slate River Rd","w1819","Mechanized",0,"Sat","weekend","no_sled","3","3","3",7.8,0.3,43,2,20,18.1,3,9,0,-1,5,14,14,13
"5339",2019-01-19,"Slate River Rd","w1819","Motorized",0,"Sat","weekend","sled","3","3","3",7.8,0.3,43,2,20,18.1,3,9,0,-1,5,14,14,13
"5340",2019-01-19,"Slate River Rd","w1819","Hybrid",0,"Sat","weekend","sled","3","3","3",7.8,0.3,43,2,20,18.1,3,9,0,-1,5,14,14,13
"5341",2019-01-20,"Slate River Rd","w1819","Non.motorized",0,"Sun","weekend","no_sled","3","3","3",7.9,0.1,41,-2,27,19.3,2,3,9,0,0,3,12,12
"5342",2019-01-20,"Slate River Rd","w1819","Mechanized",0,"Sun","weekend","no_sled","3","3","3",7.9,0.1,41,-2,27,19.3,2,3,9,0,0,3,12,12
"5343",2019-01-20,"Slate River Rd","w1819","Motorized",0,"Sun","weekend","sled","3","3","3",7.9,0.1,41,-2,27,19.3,2,3,9,0,0,3,12,12
"5344",2019-01-20,"Slate River Rd","w1819","Hybrid",0,"Sun","weekend","sled","3","3","3",7.9,0.1,41,-2,27,19.3,2,3,9,0,0,3,12,12
"5345",2019-01-21,"Slate River Rd","w1819","Non.motorized",1,"Mon","weekday","no_sled","3","3","3",7.9,0,39,-2,23,20.3,-2,2,3,9,-4,-2,1,10
"5346",2019-01-21,"Slate River Rd","w1819","Mechanized",0,"Mon","weekday","no_sled","3","3","3",7.9,0,39,-2,23,20.3,-2,2,3,9,-4,-2,1,10
"5347",2019-01-21,"Slate River Rd","w1819","Motorized",2,"Mon","weekday","sled","3","3","3",7.9,0,39,-2,23,20.3,-2,2,3,9,-4,-2,1,10
"5348",2019-01-21,"Slate River Rd","w1819","Hybrid",0,"Mon","weekday","sled","3","3","3",7.9,0,39,-2,23,20.3,-2,2,3,9,-4,-2,1,10
"5349",2019-01-22,"Slate River Rd","w1819","Non.motorized",28,"Tue","weekday","no_sled","3","3","3",8,0.1,41,2,12,19.5,-2,-2,2,3,0,-2,0,3
"5350",2019-01-22,"Slate River Rd","w1819","Mechanized",0,"Tue","weekday","no_sled","3","3","3",8,0.1,41,2,12,19.5,-2,-2,2,3,0,-2,0,3
"5351",2019-01-22,"Slate River Rd","w1819","Motorized",4,"Tue","weekday","sled","3","3","3",8,0.1,41,2,12,19.5,-2,-2,2,3,0,-2,0,3
"5352",2019-01-22,"Slate River Rd","w1819","Hybrid",0,"Tue","weekday","sled","3","3","3",8,0.1,41,2,12,19.5,-2,-2,2,3,0,-2,0,3
"5353",2019-01-23,"Slate River Rd","w1819","Non.motorized",9,"Wed","weekday","no_sled","3","3","2",8,0,40,-1,14,20,2,-2,-2,2,1,-1,-3,-1
"5354",2019-01-23,"Slate River Rd","w1819","Mechanized",0,"Wed","weekday","no_sled","3","3","2",8,0,40,-1,14,20,2,-2,-2,2,1,-1,-3,-1
"5355",2019-01-23,"Slate River Rd","w1819","Motorized",5,"Wed","weekday","sled","3","3","2",8,0,40,-1,14,20,2,-2,-2,2,1,-1,-3,-1
"5356",2019-01-23,"Slate River Rd","w1819","Hybrid",0,"Wed","weekday","sled","3","3","2",8,0,40,-1,14,20,2,-2,-2,2,1,-1,-3,-1
"5357",2019-01-24,"Slate River Rd","w1819","Non.motorized",21,"Thu","weekday","no_sled","3","3","2",8.2,0.2,40,0,17,20.5,-1,2,-2,-2,-1,1,-1,-3
"5358",2019-01-24,"Slate River Rd","w1819","Mechanized",0,"Thu","weekday","no_sled","3","3","2",8.2,0.2,40,0,17,20.5,-1,2,-2,-2,-1,1,-1,-3
"5359",2019-01-24,"Slate River Rd","w1819","Motorized",0,"Thu","weekday","sled","3","3","2",8.2,0.2,40,0,17,20.5,-1,2,-2,-2,-1,1,-1,-3
"5360",2019-01-24,"Slate River Rd","w1819","Hybrid",0,"Thu","weekday","sled","3","3","2",8.2,0.2,40,0,17,20.5,-1,2,-2,-2,-1,1,-1,-3
"5361",2019-01-25,"Slate River Rd","w1819","Non.motorized",28,"Fri","weekday","no_sled","3","3","2",8.3,0.1,40,0,15,20.8,0,-1,2,-2,0,-1,1,-1
"5362",2019-01-25,"Slate River Rd","w1819","Mechanized",0,"Fri","weekday","no_sled","3","3","2",8.3,0.1,40,0,15,20.8,0,-1,2,-2,0,-1,1,-1
"5363",2019-01-25,"Slate River Rd","w1819","Motorized",5,"Fri","weekday","sled","3","3","2",8.3,0.1,40,0,15,20.8,0,-1,2,-2,0,-1,1,-1
"5364",2019-01-25,"Slate River Rd","w1819","Hybrid",0,"Fri","weekday","sled","3","3","2",8.3,0.1,40,0,15,20.8,0,-1,2,-2,0,-1,1,-1
"5365",2019-01-26,"Slate River Rd","w1819","Non.motorized",45,"Sat","weekend","no_sled","3","3","2",8.3,0,39,-1,19,21.3,0,0,-1,2,-1,-1,-2,0
"5366",2019-01-26,"Slate River Rd","w1819","Mechanized",0,"Sat","weekend","no_sled","3","3","2",8.3,0,39,-1,19,21.3,0,0,-1,2,-1,-1,-2,0
"5367",2019-01-26,"Slate River Rd","w1819","Motorized",13,"Sat","weekend","sled","3","3","2",8.3,0,39,-1,19,21.3,0,0,-1,2,-1,-1,-2,0
"5368",2019-01-26,"Slate River Rd","w1819","Hybrid",13,"Sat","weekend","sled","3","3","2",8.3,0,39,-1,19,21.3,0,0,-1,2,-1,-1,-2,0
"5369",2019-01-27,"Slate River Rd","w1819","Non.motorized",16,"Sun","weekend","no_sled","3","3","2",8.3,0,38,-1,24,21.8,-1,0,0,-1,-2,-2,-2,-3
"5370",2019-01-27,"Slate River Rd","w1819","Mechanized",3,"Sun","weekend","no_sled","3","3","2",8.3,0,38,-1,24,21.8,-1,0,0,-1,-2,-2,-2,-3
"5371",2019-01-27,"Slate River Rd","w1819","Motorized",5,"Sun","weekend","sled","3","3","2",8.3,0,38,-1,24,21.8,-1,0,0,-1,-2,-2,-2,-3
"5372",2019-01-27,"Slate River Rd","w1819","Hybrid",5,"Sun","weekend","sled","3","3","2",8.3,0,38,-1,24,21.8,-1,0,0,-1,-2,-2,-2,-3
"5373",2019-01-28,"Slate River Rd","w1819","Non.motorized",2,"Mon","weekday","no_sled","2","2","2",8.3,0,38,0,17,21.8,-1,-1,0,0,-1,-2,-2,-2
"5374",2019-01-28,"Slate River Rd","w1819","Mechanized",0,"Mon","weekday","no_sled","2","2","2",8.3,0,38,0,17,21.8,-1,-1,0,0,-1,-2,-2,-2
"5375",2019-01-28,"Slate River Rd","w1819","Motorized",1,"Mon","weekday","sled","2","2","2",8.3,0,38,0,17,21.8,-1,-1,0,0,-1,-2,-2,-2
"5376",2019-01-28,"Slate River Rd","w1819","Hybrid",1,"Mon","weekday","sled","2","2","2",8.3,0,38,0,17,21.8,-1,-1,0,0,-1,-2,-2,-2
"5377",2019-01-29,"Slate River Rd","w1819","Non.motorized",0,"Tue","weekday","no_sled","2","2","2",8.3,0,38,0,16,21.8,0,-1,-1,0,0,-1,-2,-2
"5378",2019-01-29,"Slate River Rd","w1819","Mechanized",0,"Tue","weekday","no_sled","2","2","2",8.3,0,38,0,16,21.8,0,-1,-1,0,0,-1,-2,-2
"5379",2019-01-29,"Slate River Rd","w1819","Motorized",0,"Tue","weekday","sled","2","2","2",8.3,0,38,0,16,21.8,0,-1,-1,0,0,-1,-2,-2
"5380",2019-01-29,"Slate River Rd","w1819","Hybrid",0,"Tue","weekday","sled","2","2","2",8.3,0,38,0,16,21.8,0,-1,-1,0,0,-1,-2,-2
"5381",2019-01-30,"Slate River Rd","w1819","Non.motorized",0,"Wed","weekday","no_sled","2","2","1",8.3,0,37,-1,20,22.4,0,0,-1,-1,-1,-1,-2,-3
"5382",2019-01-30,"Slate River Rd","w1819","Mechanized",0,"Wed","weekday","no_sled","2","2","1",8.3,0,37,-1,20,22.4,0,0,-1,-1,-1,-1,-2,-3
"5383",2019-01-30,"Slate River Rd","w1819","Motorized",0,"Wed","weekday","sled","2","2","1",8.3,0,37,-1,20,22.4,0,0,-1,-1,-1,-1,-2,-3
"5384",2019-01-30,"Slate River Rd","w1819","Hybrid",0,"Wed","weekday","sled","2","2","1",8.3,0,37,-1,20,22.4,0,0,-1,-1,-1,-1,-2,-3
"5385",2019-01-31,"Slate River Rd","w1819","Non.motorized",0,"Thu","weekday","no_sled","2","2","1",8.3,0,36,-1,24,23.1,-1,0,0,-1,-2,-2,-2,-3
"5386",2019-01-31,"Slate River Rd","w1819","Mechanized",0,"Thu","weekday","no_sled","2","2","1",8.3,0,36,-1,24,23.1,-1,0,0,-1,-2,-2,-2,-3
"5387",2019-01-31,"Slate River Rd","w1819","Motorized",0,"Thu","weekday","sled","2","2","1",8.3,0,36,-1,24,23.1,-1,0,0,-1,-2,-2,-2,-3
"5388",2019-01-31,"Slate River Rd","w1819","Hybrid",0,"Thu","weekday","sled","2","2","1",8.3,0,36,-1,24,23.1,-1,0,0,-1,-2,-2,-2,-3
"5389",2019-02-01,"Slate River Rd","w1819","Non.motorized",12,"Fri","weekday","no_sled","2","2","1",8.3,0,36,0,25,23.1,-1,-1,0,0,-1,-2,-2,-2
"5390",2019-02-01,"Slate River Rd","w1819","Mechanized",0,"Fri","weekday","no_sled","2","2","1",8.3,0,36,0,25,23.1,-1,-1,0,0,-1,-2,-2,-2
"5391",2019-02-01,"Slate River Rd","w1819","Motorized",0,"Fri","weekday","sled","2","2","1",8.3,0,36,0,25,23.1,-1,-1,0,0,-1,-2,-2,-2
"5392",2019-02-01,"Slate River Rd","w1819","Hybrid",0,"Fri","weekday","sled","2","2","1",8.3,0,36,0,25,23.1,-1,-1,0,0,-1,-2,-2,-2
"5393",2019-02-02,"Slate River Rd","w1819","Non.motorized",45,"Sat","weekend","no_sled","2","2","1",8.3,0,36,0,26,23.1,0,-1,-1,0,0,-1,-2,-2
"5394",2019-02-02,"Slate River Rd","w1819","Mechanized",0,"Sat","weekend","no_sled","2","2","1",8.3,0,36,0,26,23.1,0,-1,-1,0,0,-1,-2,-2
"5395",2019-02-02,"Slate River Rd","w1819","Motorized",15,"Sat","weekend","sled","2","2","1",8.3,0,36,0,26,23.1,0,-1,-1,0,0,-1,-2,-2
"5396",2019-02-02,"Slate River Rd","w1819","Hybrid",11,"Sat","weekend","sled","2","2","1",8.3,0,36,0,26,23.1,0,-1,-1,0,0,-1,-2,-2
"5397",2019-02-03,"Slate River Rd","w1819","Non.motorized",11,"Sun","weekend","no_sled","3","3","2",8.4,0.1,36,0,28,23.3,0,0,-1,-1,0,0,-1,-2
"5398",2019-02-03,"Slate River Rd","w1819","Mechanized",0,"Sun","weekend","no_sled","3","3","2",8.4,0.1,36,0,28,23.3,0,0,-1,-1,0,0,-1,-2
"5399",2019-02-03,"Slate River Rd","w1819","Motorized",5,"Sun","weekend","sled","3","3","2",8.4,0.1,36,0,28,23.3,0,0,-1,-1,0,0,-1,-2
"5400",2019-02-03,"Slate River Rd","w1819","Hybrid",5,"Sun","weekend","sled","3","3","2",8.4,0.1,36,0,28,23.3,0,0,-1,-1,0,0,-1,-2
"5401",2019-02-04,"Slate River Rd","w1819","Non.motorized",15,"Mon","weekday","no_sled","3","3","2",8.8,0.4,39,3,28,22.6,0,0,0,-1,3,3,3,2
"5402",2019-02-04,"Slate River Rd","w1819","Mechanized",0,"Mon","weekday","no_sled","3","3","2",8.8,0.4,39,3,28,22.6,0,0,0,-1,3,3,3,2
"5403",2019-02-04,"Slate River Rd","w1819","Motorized",3,"Mon","weekday","sled","3","3","2",8.8,0.4,39,3,28,22.6,0,0,0,-1,3,3,3,2
"5404",2019-02-04,"Slate River Rd","w1819","Hybrid",3,"Mon","weekday","sled","3","3","2",8.8,0.4,39,3,28,22.6,0,0,0,-1,3,3,3,2
"5405",2019-02-05,"Slate River Rd","w1819","Non.motorized",15,"Tue","weekday","no_sled","3","2","2",9,0.2,40,1,26,22.5,3,0,0,0,4,4,4,4
"5406",2019-02-05,"Slate River Rd","w1819","Mechanized",0,"Tue","weekday","no_sled","3","2","2",9,0.2,40,1,26,22.5,3,0,0,0,4,4,4,4
"5407",2019-02-05,"Slate River Rd","w1819","Motorized",4,"Tue","weekday","sled","3","2","2",9,0.2,40,1,26,22.5,3,0,0,0,4,4,4,4
"5408",2019-02-05,"Slate River Rd","w1819","Hybrid",4,"Tue","weekday","sled","3","2","2",9,0.2,40,1,26,22.5,3,0,0,0,4,4,4,4
"5409",2019-02-06,"Slate River Rd","w1819","Non.motorized",3,"Wed","weekday","no_sled","4","4","3",9,0,40,0,16,22.5,1,3,0,0,1,4,4,4
"5410",2019-02-06,"Slate River Rd","w1819","Mechanized",0,"Wed","weekday","no_sled","4","4","3",9,0,40,0,16,22.5,1,3,0,0,1,4,4,4
"5411",2019-02-06,"Slate River Rd","w1819","Motorized",3,"Wed","weekday","sled","4","4","3",9,0,40,0,16,22.5,1,3,0,0,1,4,4,4
"5412",2019-02-06,"Slate River Rd","w1819","Hybrid",3,"Wed","weekday","sled","4","4","3",9,0,40,0,16,22.5,1,3,0,0,1,4,4,4
"5413",2019-02-07,"Slate River Rd","w1819","Non.motorized",0,"Thu","weekday","no_sled","3","3","2",9.2,0.2,43,3,4,21.4,0,1,3,0,3,4,7,7
"5414",2019-02-07,"Slate River Rd","w1819","Mechanized",0,"Thu","weekday","no_sled","3","3","2",9.2,0.2,43,3,4,21.4,0,1,3,0,3,4,7,7
"5415",2019-02-07,"Slate River Rd","w1819","Motorized",0,"Thu","weekday","sled","3","3","2",9.2,0.2,43,3,4,21.4,0,1,3,0,3,4,7,7
"5416",2019-02-07,"Slate River Rd","w1819","Hybrid",0,"Thu","weekday","sled","3","3","2",9.2,0.2,43,3,4,21.4,0,1,3,0,3,4,7,7
"5417",2019-02-08,"Slate River Rd","w1819","Non.motorized",20,"Fri","weekday","no_sled","3","2","2",9.2,0,42,-1,10,21.9,3,0,1,3,2,2,3,6
"5418",2019-02-08,"Slate River Rd","w1819","Mechanized",0,"Fri","weekday","no_sled","3","2","2",9.2,0,42,-1,10,21.9,3,0,1,3,2,2,3,6
"5419",2019-02-08,"Slate River Rd","w1819","Motorized",4,"Fri","weekday","sled","3","2","2",9.2,0,42,-1,10,21.9,3,0,1,3,2,2,3,6
"5420",2019-02-08,"Slate River Rd","w1819","Hybrid",4,"Fri","weekday","sled","3","2","2",9.2,0,42,-1,10,21.9,3,0,1,3,2,2,3,6
"5421",2019-02-09,"Slate River Rd","w1819","Non.motorized",38,"Sat","weekend","no_sled","3","2","2",9.2,0,41,-1,20,22.4,-1,3,0,1,-2,1,1,2
"5422",2019-02-09,"Slate River Rd","w1819","Mechanized",0,"Sat","weekend","no_sled","3","2","2",9.2,0,41,-1,20,22.4,-1,3,0,1,-2,1,1,2
"5423",2019-02-09,"Slate River Rd","w1819","Motorized",13,"Sat","weekend","sled","3","2","2",9.2,0,41,-1,20,22.4,-1,3,0,1,-2,1,1,2
"5424",2019-02-09,"Slate River Rd","w1819","Hybrid",10,"Sat","weekend","sled","3","2","2",9.2,0,41,-1,20,22.4,-1,3,0,1,-2,1,1,2
"5425",2019-02-10,"Slate River Rd","w1819","Non.motorized",35,"Sun","weekend","no_sled","2","2","2",9.3,0.1,40,-1,20,23.2,-1,-1,3,0,-2,-3,0,0
"5426",2019-02-10,"Slate River Rd","w1819","Mechanized",0,"Sun","weekend","no_sled","2","2","2",9.3,0.1,40,-1,20,23.2,-1,-1,3,0,-2,-3,0,0
"5427",2019-02-10,"Slate River Rd","w1819","Motorized",19,"Sun","weekend","sled","2","2","2",9.3,0.1,40,-1,20,23.2,-1,-1,3,0,-2,-3,0,0
"5428",2019-02-10,"Slate River Rd","w1819","Hybrid",17,"Sun","weekend","sled","2","2","2",9.3,0.1,40,-1,20,23.2,-1,-1,3,0,-2,-3,0,0
"5429",2019-02-11,"Slate River Rd","w1819","Non.motorized",13,"Mon","weekday","no_sled","2","2","1",9.3,0,40,0,15,23.2,-1,-1,-1,3,-1,-2,-3,0
"5430",2019-02-11,"Slate River Rd","w1819","Mechanized",1,"Mon","weekday","no_sled","2","2","1",9.3,0,40,0,15,23.2,-1,-1,-1,3,-1,-2,-3,0
"5431",2019-02-11,"Slate River Rd","w1819","Motorized",1,"Mon","weekday","sled","2","2","1",9.3,0,40,0,15,23.2,-1,-1,-1,3,-1,-2,-3,0
"5432",2019-02-11,"Slate River Rd","w1819","Hybrid",1,"Mon","weekday","sled","2","2","1",9.3,0,40,0,15,23.2,-1,-1,-1,3,-1,-2,-3,0
"5433",2019-02-12,"Slate River Rd","w1819","Non.motorized",18,"Tue","weekday","no_sled","2","2","1",9.3,0,40,0,18,23.2,0,-1,-1,-1,0,-1,-2,-3
"5434",2019-02-12,"Slate River Rd","w1819","Mechanized",0,"Tue","weekday","no_sled","2","2","1",9.3,0,40,0,18,23.2,0,-1,-1,-1,0,-1,-2,-3
"5435",2019-02-12,"Slate River Rd","w1819","Motorized",3,"Tue","weekday","sled","2","2","1",9.3,0,40,0,18,23.2,0,-1,-1,-1,0,-1,-2,-3
"5436",2019-02-12,"Slate River Rd","w1819","Hybrid",0,"Tue","weekday","sled","2","2","1",9.3,0,40,0,18,23.2,0,-1,-1,-1,0,-1,-2,-3
"5437",2019-02-13,"Slate River Rd","w1819","Non.motorized",21,"Wed","weekday","no_sled","2","2","1",9.4,0.1,40,0,26,23.5,0,0,-1,-1,0,0,-1,-2
"5438",2019-02-13,"Slate River Rd","w1819","Mechanized",0,"Wed","weekday","no_sled","2","2","1",9.4,0.1,40,0,26,23.5,0,0,-1,-1,0,0,-1,-2
"5439",2019-02-13,"Slate River Rd","w1819","Motorized",8,"Wed","weekday","sled","2","2","1",9.4,0.1,40,0,26,23.5,0,0,-1,-1,0,0,-1,-2
"5440",2019-02-13,"Slate River Rd","w1819","Hybrid",0,"Wed","weekday","sled","2","2","1",9.4,0.1,40,0,26,23.5,0,0,-1,-1,0,0,-1,-2
"5441",2019-02-14,"Slate River Rd","w1819","Non.motorized",16,"Thu","weekday","no_sled","3","2","2",9.7,0.3,41,1,29,23.7,0,0,0,-1,1,1,1,0
"5442",2019-02-14,"Slate River Rd","w1819","Mechanized",0,"Thu","weekday","no_sled","3","2","2",9.7,0.3,41,1,29,23.7,0,0,0,-1,1,1,1,0
"5443",2019-02-14,"Slate River Rd","w1819","Motorized",3,"Thu","weekday","sled","3","2","2",9.7,0.3,41,1,29,23.7,0,0,0,-1,1,1,1,0
"5444",2019-02-14,"Slate River Rd","w1819","Hybrid",0,"Thu","weekday","sled","3","2","2",9.7,0.3,41,1,29,23.7,0,0,0,-1,1,1,1,0
"5445",2019-02-15,"Slate River Rd","w1819","Non.motorized",6,"Fri","weekday","no_sled","4","4","3",10.8,1.1,51,10,27,21.2,1,0,0,0,11,11,11,11
"5446",2019-02-15,"Slate River Rd","w1819","Mechanized",0,"Fri","weekday","no_sled","4","4","3",10.8,1.1,51,10,27,21.2,1,0,0,0,11,11,11,11
"5447",2019-02-15,"Slate River Rd","w1819","Motorized",0,"Fri","weekday","sled","4","4","3",10.8,1.1,51,10,27,21.2,1,0,0,0,11,11,11,11
"5448",2019-02-15,"Slate River Rd","w1819","Hybrid",0,"Fri","weekday","sled","4","4","3",10.8,1.1,51,10,27,21.2,1,0,0,0,11,11,11,11
"5449",2019-02-16,"Slate River Rd","w1819","Non.motorized",0,"Sat","weekend","no_sled","3","3","3",11.1,0.3,52,1,14,21.3,10,1,0,0,11,12,12,12
"5450",2019-02-16,"Slate River Rd","w1819","Mechanized",0,"Sat","weekend","no_sled","3","3","3",11.1,0.3,52,1,14,21.3,10,1,0,0,11,12,12,12
"5451",2019-02-16,"Slate River Rd","w1819","Motorized",0,"Sat","weekend","sled","3","3","3",11.1,0.3,52,1,14,21.3,10,1,0,0,11,12,12,12
"5452",2019-02-16,"Slate River Rd","w1819","Hybrid",0,"Sat","weekend","sled","3","3","3",11.1,0.3,52,1,14,21.3,10,1,0,0,11,12,12,12
"5453",2019-02-17,"Slate River Rd","w1819","Non.motorized",0,"Sun","weekend","no_sled","3","3","3",11.3,0.2,55,3,10,20.5,1,10,1,0,4,14,15,15
"5454",2019-02-17,"Slate River Rd","w1819","Mechanized",0,"Sun","weekend","no_sled","3","3","3",11.3,0.2,55,3,10,20.5,1,10,1,0,4,14,15,15
"5455",2019-02-17,"Slate River Rd","w1819","Motorized",0,"Sun","weekend","sled","3","3","3",11.3,0.2,55,3,10,20.5,1,10,1,0,4,14,15,15
"5456",2019-02-17,"Slate River Rd","w1819","Hybrid",0,"Sun","weekend","sled","3","3","3",11.3,0.2,55,3,10,20.5,1,10,1,0,4,14,15,15
"5457",2019-02-18,"Slate River Rd","w1819","Non.motorized",0,"Mon","weekday","no_sled","3","3","2",11.4,0.1,53,-2,13,21.5,3,1,10,1,1,2,12,13
"5458",2019-02-18,"Slate River Rd","w1819","Mechanized",0,"Mon","weekday","no_sled","3","3","2",11.4,0.1,53,-2,13,21.5,3,1,10,1,1,2,12,13
"5459",2019-02-18,"Slate River Rd","w1819","Motorized",0,"Mon","weekday","sled","3","3","2",11.4,0.1,53,-2,13,21.5,3,1,10,1,1,2,12,13
"5460",2019-02-18,"Slate River Rd","w1819","Hybrid",0,"Mon","weekday","sled","3","3","2",11.4,0.1,53,-2,13,21.5,3,1,10,1,1,2,12,13
"5461",2019-02-19,"Slate River Rd","w1819","Non.motorized",0,"Tue","weekday","no_sled","3","3","2",11.5,0.1,53,0,11,21.7,-2,3,1,10,-2,1,2,12
"5462",2019-02-19,"Slate River Rd","w1819","Mechanized",0,"Tue","weekday","no_sled","3","3","2",11.5,0.1,53,0,11,21.7,-2,3,1,10,-2,1,2,12
"5463",2019-02-19,"Slate River Rd","w1819","Motorized",0,"Tue","weekday","sled","3","3","2",11.5,0.1,53,0,11,21.7,-2,3,1,10,-2,1,2,12
"5464",2019-02-19,"Slate River Rd","w1819","Hybrid",0,"Tue","weekday","sled","3","3","2",11.5,0.1,53,0,11,21.7,-2,3,1,10,-2,1,2,12
"5465",2019-02-20,"Slate River Rd","w1819","Non.motorized",0,"Wed","weekday","no_sled","3","3","2",11.6,0.1,53,0,7,21.9,0,-2,3,1,0,-2,1,2
"5466",2019-02-20,"Slate River Rd","w1819","Mechanized",0,"Wed","weekday","no_sled","3","3","2",11.6,0.1,53,0,7,21.9,0,-2,3,1,0,-2,1,2
"5467",2019-02-20,"Slate River Rd","w1819","Motorized",0,"Wed","weekday","sled","3","3","2",11.6,0.1,53,0,7,21.9,0,-2,3,1,0,-2,1,2
"5468",2019-02-20,"Slate River Rd","w1819","Hybrid",0,"Wed","weekday","sled","3","3","2",11.6,0.1,53,0,7,21.9,0,-2,3,1,0,-2,1,2
"5469",2019-02-21,"Slate River Rd","w1819","Non.motorized",0,"Thu","weekday","no_sled","3","3","3",11.6,0,52,-1,15,22.3,0,0,-2,3,-1,-1,-3,0
"5470",2019-02-21,"Slate River Rd","w1819","Mechanized",0,"Thu","weekday","no_sled","3","3","3",11.6,0,52,-1,15,22.3,0,0,-2,3,-1,-1,-3,0
"5471",2019-02-21,"Slate River Rd","w1819","Motorized",0,"Thu","weekday","sled","3","3","3",11.6,0,52,-1,15,22.3,0,0,-2,3,-1,-1,-3,0
"5472",2019-02-21,"Slate River Rd","w1819","Hybrid",0,"Thu","weekday","sled","3","3","3",11.6,0,52,-1,15,22.3,0,0,-2,3,-1,-1,-3,0
"5473",2019-02-22,"Slate River Rd","w1819","Non.motorized",3,"Fri","weekday","no_sled","3","3","3",11.8,0.2,52,0,20,22.7,-1,0,0,-2,-1,-1,-1,-3
"5474",2019-02-22,"Slate River Rd","w1819","Mechanized",0,"Fri","weekday","no_sled","3","3","3",11.8,0.2,52,0,20,22.7,-1,0,0,-2,-1,-1,-1,-3
"5475",2019-02-22,"Slate River Rd","w1819","Motorized",5,"Fri","weekday","sled","3","3","3",11.8,0.2,52,0,20,22.7,-1,0,0,-2,-1,-1,-1,-3
"5476",2019-02-22,"Slate River Rd","w1819","Hybrid",5,"Fri","weekday","sled","3","3","3",11.8,0.2,52,0,20,22.7,-1,0,0,-2,-1,-1,-1,-3
"5477",2019-02-23,"Slate River Rd","w1819","Non.motorized",38,"Sat","weekend","no_sled","3","3","3",12.1,0.3,53,1,13,22.8,0,-1,0,0,1,0,0,0
"5478",2019-02-23,"Slate River Rd","w1819","Mechanized",3,"Sat","weekend","no_sled","3","3","3",12.1,0.3,53,1,13,22.8,0,-1,0,0,1,0,0,0
"5479",2019-02-23,"Slate River Rd","w1819","Motorized",9,"Sat","weekend","sled","3","3","3",12.1,0.3,53,1,13,22.8,0,-1,0,0,1,0,0,0
"5480",2019-02-23,"Slate River Rd","w1819","Hybrid",9,"Sat","weekend","sled","3","3","3",12.1,0.3,53,1,13,22.8,0,-1,0,0,1,0,0,0
"5481",2019-02-24,"Slate River Rd","w1819","Non.motorized",22,"Sun","weekend","no_sled","3","3","2",12.1,0,52,-1,14,23.3,1,0,-1,0,0,0,-1,-1
"5482",2019-02-24,"Slate River Rd","w1819","Mechanized",0,"Sun","weekend","no_sled","3","3","2",12.1,0,52,-1,14,23.3,1,0,-1,0,0,0,-1,-1
"5483",2019-02-24,"Slate River Rd","w1819","Motorized",7,"Sun","weekend","sled","3","3","2",12.1,0,52,-1,14,23.3,1,0,-1,0,0,0,-1,-1
"5484",2019-02-24,"Slate River Rd","w1819","Hybrid",7,"Sun","weekend","sled","3","3","2",12.1,0,52,-1,14,23.3,1,0,-1,0,0,0,-1,-1
"5485",2019-02-25,"Slate River Rd","w1819","Non.motorized",12,"Mon","weekday","no_sled","3","3","2",12.1,0,51,-1,22,23.7,-1,1,0,-1,-2,-1,-1,-2
"5486",2019-02-25,"Slate River Rd","w1819","Mechanized",0,"Mon","weekday","no_sled","3","3","2",12.1,0,51,-1,22,23.7,-1,1,0,-1,-2,-1,-1,-2
"5487",2019-02-25,"Slate River Rd","w1819","Motorized",0,"Mon","weekday","sled","3","3","2",12.1,0,51,-1,22,23.7,-1,1,0,-1,-2,-1,-1,-2
"5488",2019-02-25,"Slate River Rd","w1819","Hybrid",0,"Mon","weekday","sled","3","3","2",12.1,0,51,-1,22,23.7,-1,1,0,-1,-2,-1,-1,-2
"5489",2019-02-26,"Slate River Rd","w1819","Non.motorized",30,"Tue","weekday","no_sled","2","2","2",12.1,0,50,-1,27,24.2,-1,-1,1,0,-2,-3,-2,-2
"5490",2019-02-26,"Slate River Rd","w1819","Mechanized",0,"Tue","weekday","no_sled","2","2","2",12.1,0,50,-1,27,24.2,-1,-1,1,0,-2,-3,-2,-2
"5491",2019-02-26,"Slate River Rd","w1819","Motorized",8,"Tue","weekday","sled","2","2","2",12.1,0,50,-1,27,24.2,-1,-1,1,0,-2,-3,-2,-2
"5492",2019-02-26,"Slate River Rd","w1819","Hybrid",7,"Tue","weekday","sled","2","2","2",12.1,0,50,-1,27,24.2,-1,-1,1,0,-2,-3,-2,-2
"5493",2019-02-27,"Slate River Rd","w1819","Non.motorized",20,"Wed","weekday","no_sled","2","2","2",12.1,0,50,0,30,24.2,-1,-1,-1,1,-1,-2,-3,-2
"5494",2019-02-27,"Slate River Rd","w1819","Mechanized",0,"Wed","weekday","no_sled","2","2","2",12.1,0,50,0,30,24.2,-1,-1,-1,1,-1,-2,-3,-2
"5495",2019-02-27,"Slate River Rd","w1819","Motorized",4,"Wed","weekday","sled","2","2","2",12.1,0,50,0,30,24.2,-1,-1,-1,1,-1,-2,-3,-2
"5496",2019-02-27,"Slate River Rd","w1819","Hybrid",4,"Wed","weekday","sled","2","2","2",12.1,0,50,0,30,24.2,-1,-1,-1,1,-1,-2,-3,-2
"5497",2019-02-28,"Slate River Rd","w1819","Non.motorized",20,"Thu","weekday","no_sled","2","2","2",12.2,0.1,49,-1,30,24.9,0,-1,-1,-1,-1,-2,-3,-4
"5498",2019-02-28,"Slate River Rd","w1819","Mechanized",0,"Thu","weekday","no_sled","2","2","2",12.2,0.1,49,-1,30,24.9,0,-1,-1,-1,-1,-2,-3,-4
"5499",2019-02-28,"Slate River Rd","w1819","Motorized",2,"Thu","weekday","sled","2","2","2",12.2,0.1,49,-1,30,24.9,0,-1,-1,-1,-1,-2,-3,-4
"5500",2019-02-28,"Slate River Rd","w1819","Hybrid",2,"Thu","weekday","sled","2","2","2",12.2,0.1,49,-1,30,24.9,0,-1,-1,-1,-1,-2,-3,-4
"5501",2019-03-01,"Slate River Rd","w1819","Non.motorized",13,"Fri","weekday","no_sled","2","2","1",12.3,0.1,49,0,29,25.1,-1,0,-1,-1,-1,-1,-2,-3
"5502",2019-03-01,"Slate River Rd","w1819","Mechanized",0,"Fri","weekday","no_sled","2","2","1",12.3,0.1,49,0,29,25.1,-1,0,-1,-1,-1,-1,-2,-3
"5503",2019-03-01,"Slate River Rd","w1819","Motorized",1,"Fri","weekday","sled","2","2","1",12.3,0.1,49,0,29,25.1,-1,0,-1,-1,-1,-1,-2,-3
"5504",2019-03-01,"Slate River Rd","w1819","Hybrid",0,"Fri","weekday","sled","2","2","1",12.3,0.1,49,0,29,25.1,-1,0,-1,-1,-1,-1,-2,-3
"5505",2019-03-02,"Slate River Rd","w1819","Non.motorized",11,"Sat","weekend","no_sled","3","3","2",13,0.7,58,9,30,22.4,0,-1,0,-1,9,8,8,7
"5506",2019-03-02,"Slate River Rd","w1819","Mechanized",0,"Sat","weekend","no_sled","3","3","2",13,0.7,58,9,30,22.4,0,-1,0,-1,9,8,8,7
"5507",2019-03-02,"Slate River Rd","w1819","Motorized",5,"Sat","weekend","sled","3","3","2",13,0.7,58,9,30,22.4,0,-1,0,-1,9,8,8,7
"5508",2019-03-02,"Slate River Rd","w1819","Hybrid",4,"Sat","weekend","sled","3","3","2",13,0.7,58,9,30,22.4,0,-1,0,-1,9,8,8,7
"5509",2019-03-03,"Slate River Rd","w1819","Non.motorized",5,"Sun","weekend","no_sled","3","3","3",13.7,0.7,64,6,27,21.4,9,0,-1,0,15,15,14,14
"5510",2019-03-03,"Slate River Rd","w1819","Mechanized",0,"Sun","weekend","no_sled","3","3","3",13.7,0.7,64,6,27,21.4,9,0,-1,0,15,15,14,14
"5511",2019-03-03,"Slate River Rd","w1819","Motorized",0,"Sun","weekend","sled","3","3","3",13.7,0.7,64,6,27,21.4,9,0,-1,0,15,15,14,14
"5512",2019-03-03,"Slate River Rd","w1819","Hybrid",0,"Sun","weekend","sled","3","3","3",13.7,0.7,64,6,27,21.4,9,0,-1,0,15,15,14,14
"5513",2019-03-04,"Slate River Rd","w1819","Non.motorized",9,"Mon","weekday","no_sled","3","3","3",14.4,0.7,66,2,23,21.8,6,9,0,-1,8,17,17,16
"5514",2019-03-04,"Slate River Rd","w1819","Mechanized",0,"Mon","weekday","no_sled","3","3","3",14.4,0.7,66,2,23,21.8,6,9,0,-1,8,17,17,16
"5515",2019-03-04,"Slate River Rd","w1819","Motorized",0,"Mon","weekday","sled","3","3","3",14.4,0.7,66,2,23,21.8,6,9,0,-1,8,17,17,16
"5516",2019-03-04,"Slate River Rd","w1819","Hybrid",0,"Mon","weekday","sled","3","3","3",14.4,0.7,66,2,23,21.8,6,9,0,-1,8,17,17,16
"5517",2019-03-05,"Slate River Rd","w1819","Non.motorized",4,"Tue","weekday","no_sled","3","3","3",14.4,0,64,-2,24,22.5,2,6,9,0,0,6,15,15
"5518",2019-03-05,"Slate River Rd","w1819","Mechanized",0,"Tue","weekday","no_sled","3","3","3",14.4,0,64,-2,24,22.5,2,6,9,0,0,6,15,15
"5519",2019-03-05,"Slate River Rd","w1819","Motorized",0,"Tue","weekday","sled","3","3","3",14.4,0,64,-2,24,22.5,2,6,9,0,0,6,15,15
"5520",2019-03-05,"Slate River Rd","w1819","Hybrid",0,"Tue","weekday","sled","3","3","3",14.4,0,64,-2,24,22.5,2,6,9,0,0,6,15,15
"5521",2019-03-06,"Slate River Rd","w1819","Non.motorized",5,"Wed","weekday","no_sled","3","3","2",14.5,0.1,62,-2,31,23.4,-2,2,6,9,-4,-2,4,13
"5522",2019-03-06,"Slate River Rd","w1819","Non.motorized",5,"Wed","weekday","no_sled","4","4","3",14.5,0.1,62,-2,31,23.4,-2,2,6,9,-4,-2,4,13
"5523",2019-03-06,"Slate River Rd","w1819","Mechanized",0,"Wed","weekday","no_sled","3","3","2",14.5,0.1,62,-2,31,23.4,-2,2,6,9,-4,-2,4,13
"5524",2019-03-06,"Slate River Rd","w1819","Mechanized",0,"Wed","weekday","no_sled","4","4","3",14.5,0.1,62,-2,31,23.4,-2,2,6,9,-4,-2,4,13
"5525",2019-03-06,"Slate River Rd","w1819","Motorized",0,"Wed","weekday","sled","3","3","2",14.5,0.1,62,-2,31,23.4,-2,2,6,9,-4,-2,4,13
"5526",2019-03-06,"Slate River Rd","w1819","Motorized",0,"Wed","weekday","sled","4","4","3",14.5,0.1,62,-2,31,23.4,-2,2,6,9,-4,-2,4,13
"5527",2019-03-06,"Slate River Rd","w1819","Hybrid",0,"Wed","weekday","sled","3","3","2",14.5,0.1,62,-2,31,23.4,-2,2,6,9,-4,-2,4,13
"5528",2019-03-06,"Slate River Rd","w1819","Hybrid",0,"Wed","weekday","sled","4","4","3",14.5,0.1,62,-2,31,23.4,-2,2,6,9,-4,-2,4,13
"5529",2019-03-07,"Slate River Rd","w1819","Non.motorized",5,"Thu","weekday","no_sled","4","4","3",16.2,1.7,71,9,30,22.8,-2,-2,2,6,7,5,7,13
"5530",2019-03-07,"Slate River Rd","w1819","Mechanized",0,"Thu","weekday","no_sled","4","4","3",16.2,1.7,71,9,30,22.8,-2,-2,2,6,7,5,7,13
"5531",2019-03-07,"Slate River Rd","w1819","Motorized",0,"Thu","weekday","sled","4","4","3",16.2,1.7,71,9,30,22.8,-2,-2,2,6,7,5,7,13
"5532",2019-03-07,"Slate River Rd","w1819","Hybrid",0,"Thu","weekday","sled","4","4","3",16.2,1.7,71,9,30,22.8,-2,-2,2,6,7,5,7,13
"5533",2019-03-08,"Slate River Rd","w1819","Non.motorized",3,"Fri","weekday","no_sled","3","3","3",16.6,0.4,71,0,27,23.4,9,-2,-2,2,9,7,5,7
"5534",2019-03-08,"Slate River Rd","w1819","Mechanized",0,"Fri","weekday","no_sled","3","3","3",16.6,0.4,71,0,27,23.4,9,-2,-2,2,9,7,5,7
"5535",2019-03-08,"Slate River Rd","w1819","Motorized",0,"Fri","weekday","sled","3","3","3",16.6,0.4,71,0,27,23.4,9,-2,-2,2,9,7,5,7
"5536",2019-03-08,"Slate River Rd","w1819","Hybrid",0,"Fri","weekday","sled","3","3","3",16.6,0.4,71,0,27,23.4,9,-2,-2,2,9,7,5,7
"5537",2019-03-09,"Slate River Rd","w1819","Non.motorized",12,"Sat","weekend","no_sled","4","4","3",17.2,0.6,76,5,22,22.6,0,9,-2,-2,5,14,12,10
"5538",2019-03-09,"Slate River Rd","w1819","Mechanized",0,"Sat","weekend","no_sled","4","4","3",17.2,0.6,76,5,22,22.6,0,9,-2,-2,5,14,12,10
"5539",2019-03-09,"Slate River Rd","w1819","Motorized",0,"Sat","weekend","sled","4","4","3",17.2,0.6,76,5,22,22.6,0,9,-2,-2,5,14,12,10
"5540",2019-03-09,"Slate River Rd","w1819","Hybrid",0,"Sat","weekend","sled","4","4","3",17.2,0.6,76,5,22,22.6,0,9,-2,-2,5,14,12,10
"5541",2019-03-10,"Slate River Rd","w1819","Non.motorized",18,"Sun","weekend","no_sled","3","3","3",17.3,0.1,73,-3,25,23.7,5,0,9,-2,2,2,11,9
"5542",2019-03-10,"Slate River Rd","w1819","Mechanized",0,"Sun","weekend","no_sled","3","3","3",17.3,0.1,73,-3,25,23.7,5,0,9,-2,2,2,11,9
"5543",2019-03-10,"Slate River Rd","w1819","Motorized",0,"Sun","weekend","sled","3","3","3",17.3,0.1,73,-3,25,23.7,5,0,9,-2,2,2,11,9
"5544",2019-03-10,"Slate River Rd","w1819","Hybrid",0,"Sun","weekend","sled","3","3","3",17.3,0.1,73,-3,25,23.7,5,0,9,-2,2,2,11,9
"5545",2019-03-11,"Slate River Rd","w1819","Non.motorized",6,"Mon","weekday","no_sled","3","3","2",17.3,0,71,-2,29,24.4,-3,5,0,9,-5,0,0,9
"5546",2019-03-11,"Slate River Rd","w1819","Mechanized",0,"Mon","weekday","no_sled","3","3","2",17.3,0,71,-2,29,24.4,-3,5,0,9,-5,0,0,9
"5547",2019-03-11,"Slate River Rd","w1819","Motorized",0,"Mon","weekday","sled","3","3","2",17.3,0,71,-2,29,24.4,-3,5,0,9,-5,0,0,9
"5548",2019-03-11,"Slate River Rd","w1819","Hybrid",0,"Mon","weekday","sled","3","3","2",17.3,0,71,-2,29,24.4,-3,5,0,9,-5,0,0,9
"5549",2019-03-12,"Slate River Rd","w1819","Non.motorized",27,"Tue","weekday","no_sled","3","3","3",17.4,0.1,70,-1,32,24.9,-2,-3,5,0,-3,-6,-1,-1
"5550",2019-03-12,"Slate River Rd","w1819","Non.motorized",27,"Tue","weekday","no_sled","4","4","4",17.4,0.1,70,-1,32,24.9,-2,-3,5,0,-3,-6,-1,-1
"5551",2019-03-12,"Slate River Rd","w1819","Mechanized",0,"Tue","weekday","no_sled","3","3","3",17.4,0.1,70,-1,32,24.9,-2,-3,5,0,-3,-6,-1,-1
"5552",2019-03-12,"Slate River Rd","w1819","Mechanized",0,"Tue","weekday","no_sled","4","4","4",17.4,0.1,70,-1,32,24.9,-2,-3,5,0,-3,-6,-1,-1
"5553",2019-03-12,"Slate River Rd","w1819","Motorized",3,"Tue","weekday","sled","3","3","3",17.4,0.1,70,-1,32,24.9,-2,-3,5,0,-3,-6,-1,-1
"5554",2019-03-12,"Slate River Rd","w1819","Motorized",3,"Tue","weekday","sled","4","4","4",17.4,0.1,70,-1,32,24.9,-2,-3,5,0,-3,-6,-1,-1
"5555",2019-03-12,"Slate River Rd","w1819","Hybrid",0,"Tue","weekday","sled","3","3","3",17.4,0.1,70,-1,32,24.9,-2,-3,5,0,-3,-6,-1,-1
"5556",2019-03-12,"Slate River Rd","w1819","Hybrid",0,"Tue","weekday","sled","4","4","4",17.4,0.1,70,-1,32,24.9,-2,-3,5,0,-3,-6,-1,-1
"5557",2019-03-13,"Slate River Rd","w1819","Non.motorized",0,"Wed","weekday","no_sled","4","4","3",18.1,0.7,74,4,24,24.5,-1,-2,-3,5,3,1,-2,3
"5558",2019-03-13,"Slate River Rd","w1819","Mechanized",0,"Wed","weekday","no_sled","4","4","3",18.1,0.7,74,4,24,24.5,-1,-2,-3,5,3,1,-2,3
"5559",2019-03-13,"Slate River Rd","w1819","Motorized",0,"Wed","weekday","sled","4","4","3",18.1,0.7,74,4,24,24.5,-1,-2,-3,5,3,1,-2,3
"5560",2019-03-13,"Slate River Rd","w1819","Hybrid",0,"Wed","weekday","sled","4","4","3",18.1,0.7,74,4,24,24.5,-1,-2,-3,5,3,1,-2,3
"5561",2019-03-14,"Slate River Rd","w1819","Non.motorized",5,"Thu","weekday","no_sled","4","4","3",18.1,0,74,0,17,24.5,4,-1,-2,-3,4,3,1,-2
"5562",2019-03-14,"Slate River Rd","w1819","Mechanized",0,"Thu","weekday","no_sled","4","4","3",18.1,0,74,0,17,24.5,4,-1,-2,-3,4,3,1,-2
"5563",2019-03-14,"Slate River Rd","w1819","Motorized",0,"Thu","weekday","sled","4","4","3",18.1,0,74,0,17,24.5,4,-1,-2,-3,4,3,1,-2
"5564",2019-03-14,"Slate River Rd","w1819","Hybrid",0,"Thu","weekday","sled","4","4","3",18.1,0,74,0,17,24.5,4,-1,-2,-3,4,3,1,-2
"5565",2019-03-15,"Slate River Rd","w1819","Non.motorized",7,"Fri","weekday","no_sled","3","3","2",18.1,0,72,-2,18,25.1,0,4,-1,-2,-2,2,1,-1
"5566",2019-03-15,"Slate River Rd","w1819","Mechanized",0,"Fri","weekday","no_sled","3","3","2",18.1,0,72,-2,18,25.1,0,4,-1,-2,-2,2,1,-1
"5567",2019-03-15,"Slate River Rd","w1819","Motorized",1,"Fri","weekday","sled","3","3","2",18.1,0,72,-2,18,25.1,0,4,-1,-2,-2,2,1,-1
"5568",2019-03-15,"Slate River Rd","w1819","Hybrid",0,"Fri","weekday","sled","3","3","2",18.1,0,72,-2,18,25.1,0,4,-1,-2,-2,2,1,-1
"5569",2019-03-16,"Slate River Rd","w1819","Non.motorized",33,"Sat","weekend","no_sled","3","3","2",18.2,0.1,70,-2,26,26,-2,0,4,-1,-4,-4,0,-1
"5570",2019-03-16,"Slate River Rd","w1819","Mechanized",0,"Sat","weekend","no_sled","3","3","2",18.2,0.1,70,-2,26,26,-2,0,4,-1,-4,-4,0,-1
"5571",2019-03-16,"Slate River Rd","w1819","Motorized",12,"Sat","weekend","sled","3","3","2",18.2,0.1,70,-2,26,26,-2,0,4,-1,-4,-4,0,-1
"5572",2019-03-16,"Slate River Rd","w1819","Hybrid",0,"Sat","weekend","sled","3","3","2",18.2,0.1,70,-2,26,26,-2,0,4,-1,-4,-4,0,-1
"5573",2019-03-17,"Slate River Rd","w1819","Non.motorized",28,"Sun","weekend","no_sled","3","3","2",18.2,0,69,-1,28,26.4,-2,-2,0,4,-3,-5,-5,-1
"5574",2019-03-17,"Slate River Rd","w1819","Mechanized",1,"Sun","weekend","no_sled","3","3","2",18.2,0,69,-1,28,26.4,-2,-2,0,4,-3,-5,-5,-1
"5575",2019-03-17,"Slate River Rd","w1819","Motorized",6,"Sun","weekend","sled","3","3","2",18.2,0,69,-1,28,26.4,-2,-2,0,4,-3,-5,-5,-1
"5576",2019-03-17,"Slate River Rd","w1819","Hybrid",0,"Sun","weekend","sled","3","3","2",18.2,0,69,-1,28,26.4,-2,-2,0,4,-3,-5,-5,-1
"5577",2019-03-18,"Slate River Rd","w1819","Non.motorized",17,"Mon","weekday","no_sled","2","2","2",18.3,0.1,68,-1,29,26.9,-1,-2,-2,0,-2,-4,-6,-6
"5578",2019-03-18,"Slate River Rd","w1819","Mechanized",0,"Mon","weekday","no_sled","2","2","2",18.3,0.1,68,-1,29,26.9,-1,-2,-2,0,-2,-4,-6,-6
"5579",2019-03-18,"Slate River Rd","w1819","Motorized",4,"Mon","weekday","sled","2","2","2",18.3,0.1,68,-1,29,26.9,-1,-2,-2,0,-2,-4,-6,-6
"5580",2019-03-18,"Slate River Rd","w1819","Hybrid",0,"Mon","weekday","sled","2","2","2",18.3,0.1,68,-1,29,26.9,-1,-2,-2,0,-2,-4,-6,-6
"5581",2019-03-19,"Slate River Rd","w1819","Non.motorized",13,"Tue","weekday","no_sled","2","2","2",18.3,0,67,-1,28,27.3,-1,-1,-2,-2,-2,-3,-5,-7
"5582",2019-03-19,"Slate River Rd","w1819","Mechanized",0,"Tue","weekday","no_sled","2","2","2",18.3,0,67,-1,28,27.3,-1,-1,-2,-2,-2,-3,-5,-7
"5583",2019-03-19,"Slate River Rd","w1819","Motorized",0,"Tue","weekday","sled","2","2","2",18.3,0,67,-1,28,27.3,-1,-1,-2,-2,-2,-3,-5,-7
"5584",2019-03-19,"Slate River Rd","w1819","Hybrid",0,"Tue","weekday","sled","2","2","2",18.3,0,67,-1,28,27.3,-1,-1,-2,-2,-2,-3,-5,-7
"5585",2019-03-20,"Slate River Rd","w1819","Non.motorized",27,"Wed","weekday","no_sled","2","2","2",18.3,0,66,-1,30,27.7,-1,-1,-1,-2,-2,-3,-4,-6
"5586",2019-03-20,"Slate River Rd","w1819","Mechanized",0,"Wed","weekday","no_sled","2","2","2",18.3,0,66,-1,30,27.7,-1,-1,-1,-2,-2,-3,-4,-6
"5587",2019-03-20,"Slate River Rd","w1819","Motorized",1,"Wed","weekday","sled","2","2","2",18.3,0,66,-1,30,27.7,-1,-1,-1,-2,-2,-3,-4,-6
"5588",2019-03-20,"Slate River Rd","w1819","Hybrid",0,"Wed","weekday","sled","2","2","2",18.3,0,66,-1,30,27.7,-1,-1,-1,-2,-2,-3,-4,-6
"5589",2019-03-21,"Slate River Rd","w1819","Non.motorized",16,"Thu","weekday","no_sled","2","2","2",18.4,0.1,65,-1,33,28.3,-1,-1,-1,-1,-2,-3,-4,-5
"5590",2019-03-21,"Slate River Rd","w1819","Mechanized",0,"Thu","weekday","no_sled","2","2","2",18.4,0.1,65,-1,33,28.3,-1,-1,-1,-1,-2,-3,-4,-5
"5591",2019-03-21,"Slate River Rd","w1819","Motorized",0,"Thu","weekday","sled","2","2","2",18.4,0.1,65,-1,33,28.3,-1,-1,-1,-1,-2,-3,-4,-5
"5592",2019-03-21,"Slate River Rd","w1819","Hybrid",0,"Thu","weekday","sled","2","2","2",18.4,0.1,65,-1,33,28.3,-1,-1,-1,-1,-2,-3,-4,-5
"5593",2019-03-22,"Slate River Rd","w1819","Non.motorized",16,"Fri","weekday","no_sled","3","3","2",18.4,0,64,-1,28,28.8,-1,-1,-1,-1,-2,-3,-4,-5
"5594",2019-03-22,"Slate River Rd","w1819","Mechanized",0,"Fri","weekday","no_sled","3","3","2",18.4,0,64,-1,28,28.8,-1,-1,-1,-1,-2,-3,-4,-5
"5595",2019-03-22,"Slate River Rd","w1819","Motorized",1,"Fri","weekday","sled","3","3","2",18.4,0,64,-1,28,28.8,-1,-1,-1,-1,-2,-3,-4,-5
"5596",2019-03-22,"Slate River Rd","w1819","Hybrid",1,"Fri","weekday","sled","3","3","2",18.4,0,64,-1,28,28.8,-1,-1,-1,-1,-2,-3,-4,-5
"5597",2019-03-23,"Slate River Rd","w1819","Non.motorized",43,"Sat","weekend","no_sled","2","2","1",18.4,0,65,1,28,28.3,-1,-1,-1,-1,0,-1,-2,-3
"5598",2019-03-23,"Slate River Rd","w1819","Mechanized",0,"Sat","weekend","no_sled","2","2","1",18.4,0,65,1,28,28.3,-1,-1,-1,-1,0,-1,-2,-3
"5599",2019-03-23,"Slate River Rd","w1819","Motorized",6,"Sat","weekend","sled","2","2","1",18.4,0,65,1,28,28.3,-1,-1,-1,-1,0,-1,-2,-3
"5600",2019-03-23,"Slate River Rd","w1819","Hybrid",6,"Sat","weekend","sled","2","2","1",18.4,0,65,1,28,28.3,-1,-1,-1,-1,0,-1,-2,-3
"5601",2019-03-24,"Slate River Rd","w1819","Non.motorized",20,"Sun","weekend","no_sled","2","2","1",18.4,0,64,-1,29,28.8,1,-1,-1,-1,0,-1,-2,-3
"5602",2019-03-24,"Slate River Rd","w1819","Mechanized",0,"Sun","weekend","no_sled","2","2","1",18.4,0,64,-1,29,28.8,1,-1,-1,-1,0,-1,-2,-3
"5603",2019-03-24,"Slate River Rd","w1819","Motorized",7,"Sun","weekend","sled","2","2","1",18.4,0,64,-1,29,28.8,1,-1,-1,-1,0,-1,-2,-3
"5604",2019-03-24,"Slate River Rd","w1819","Hybrid",7,"Sun","weekend","sled","2","2","1",18.4,0,64,-1,29,28.8,1,-1,-1,-1,0,-1,-2,-3
"5605",2019-03-25,"Slate River Rd","w1819","Non.motorized",28,"Mon","weekday","no_sled","2","2","2",18.6,0.2,64,0,31,29.1,-1,1,-1,-1,-1,0,-1,-2
"5606",2019-03-25,"Slate River Rd","w1819","Mechanized",0,"Mon","weekday","no_sled","2","2","2",18.6,0.2,64,0,31,29.1,-1,1,-1,-1,-1,0,-1,-2
"5607",2019-03-25,"Slate River Rd","w1819","Motorized",9,"Mon","weekday","sled","2","2","2",18.6,0.2,64,0,31,29.1,-1,1,-1,-1,-1,0,-1,-2
"5608",2019-03-25,"Slate River Rd","w1819","Hybrid",7,"Mon","weekday","sled","2","2","2",18.6,0.2,64,0,31,29.1,-1,1,-1,-1,-1,0,-1,-2
"5609",2019-03-26,"Slate River Rd","w1819","Non.motorized",38,"Tue","weekday","no_sled","2","2","2",18.9,0.3,63,-1,36,30,0,-1,1,-1,-1,-2,-1,-2
"5610",2019-03-26,"Slate River Rd","w1819","Mechanized",0,"Tue","weekday","no_sled","2","2","2",18.9,0.3,63,-1,36,30,0,-1,1,-1,-1,-2,-1,-2
"5611",2019-03-26,"Slate River Rd","w1819","Motorized",8,"Tue","weekday","sled","2","2","2",18.9,0.3,63,-1,36,30,0,-1,1,-1,-1,-2,-1,-2
"5612",2019-03-26,"Slate River Rd","w1819","Hybrid",0,"Tue","weekday","sled","2","2","2",18.9,0.3,63,-1,36,30,0,-1,1,-1,-1,-2,-1,-2
"5613",2019-03-27,"Slate River Rd","w1819","Non.motorized",17,"Wed","weekday","no_sled","1","2","2",18.9,0,62,-1,42,30.5,-1,0,-1,1,-2,-2,-3,-2
"5614",2019-03-27,"Slate River Rd","w1819","Mechanized",0,"Wed","weekday","no_sled","1","2","2",18.9,0,62,-1,42,30.5,-1,0,-1,1,-2,-2,-3,-2
"5615",2019-03-27,"Slate River Rd","w1819","Motorized",0,"Wed","weekday","sled","1","2","2",18.9,0,62,-1,42,30.5,-1,0,-1,1,-2,-2,-3,-2
"5616",2019-03-27,"Slate River Rd","w1819","Hybrid",0,"Wed","weekday","sled","1","2","2",18.9,0,62,-1,42,30.5,-1,0,-1,1,-2,-2,-3,-2
"5617",2019-03-28,"Slate River Rd","w1819","Non.motorized",13,"Thu","weekday","no_sled","1","2","2",18.9,0,60,-2,40,31.5,-1,-1,0,-1,-3,-4,-4,-5
"5618",2019-03-28,"Slate River Rd","w1819","Mechanized",0,"Thu","weekday","no_sled","1","2","2",18.9,0,60,-2,40,31.5,-1,-1,0,-1,-3,-4,-4,-5
"5619",2019-03-28,"Slate River Rd","w1819","Motorized",6,"Thu","weekday","sled","1","2","2",18.9,0,60,-2,40,31.5,-1,-1,0,-1,-3,-4,-4,-5
"5620",2019-03-28,"Slate River Rd","w1819","Hybrid",0,"Thu","weekday","sled","1","2","2",18.9,0,60,-2,40,31.5,-1,-1,0,-1,-3,-4,-4,-5
"5621",2019-03-29,"Slate River Rd","w1819","Non.motorized",34,"Fri","weekday","no_sled","1","1","1",19,0.1,58,-2,26,32.8,-2,-1,-1,0,-4,-5,-6,-6
"5622",2019-03-29,"Slate River Rd","w1819","Mechanized",0,"Fri","weekday","no_sled","1","1","1",19,0.1,58,-2,26,32.8,-2,-1,-1,0,-4,-5,-6,-6
"5623",2019-03-29,"Slate River Rd","w1819","Motorized",8,"Fri","weekday","sled","1","1","1",19,0.1,58,-2,26,32.8,-2,-1,-1,0,-4,-5,-6,-6
"5624",2019-03-29,"Slate River Rd","w1819","Hybrid",0,"Fri","weekday","sled","1","1","1",19,0.1,58,-2,26,32.8,-2,-1,-1,0,-4,-5,-6,-6
"5625",2019-03-30,"Slate River Rd","w1819","Non.motorized",42,"Sat","weekend","no_sled","1","1","1",19.1,0.1,61,3,24,31.3,-2,-2,-1,-1,1,-1,-2,-3
"5626",2019-03-30,"Slate River Rd","w1819","Mechanized",0,"Sat","weekend","no_sled","1","1","1",19.1,0.1,61,3,24,31.3,-2,-2,-1,-1,1,-1,-2,-3
"5627",2019-03-30,"Slate River Rd","w1819","Motorized",18,"Sat","weekend","sled","1","1","1",19.1,0.1,61,3,24,31.3,-2,-2,-1,-1,1,-1,-2,-3
"5628",2019-03-30,"Slate River Rd","w1819","Hybrid",17,"Sat","weekend","sled","1","1","1",19.1,0.1,61,3,24,31.3,-2,-2,-1,-1,1,-1,-2,-3
"5629",2019-03-31,"Slate River Rd","w1819","Non.motorized",25,"Sun","weekend","no_sled","1","1","1",19.1,0,59,-2,24,32.4,3,-2,-2,-1,1,-1,-3,-4
"5630",2019-03-31,"Slate River Rd","w1819","Mechanized",2,"Sun","weekend","no_sled","1","1","1",19.1,0,59,-2,24,32.4,3,-2,-2,-1,1,-1,-3,-4
"5631",2019-03-31,"Slate River Rd","w1819","Motorized",4,"Sun","weekend","sled","1","1","1",19.1,0,59,-2,24,32.4,3,-2,-2,-1,1,-1,-3,-4
"5632",2019-03-31,"Slate River Rd","w1819","Hybrid",4,"Sun","weekend","sled","1","1","1",19.1,0,59,-2,24,32.4,3,-2,-2,-1,1,-1,-3,-4
"5633",2019-04-01,"Slate River Rd","w1819","Non.motorized",15,"Mon","weekday","no_sled","2","1","1",19.1,0,58,-1,29,32.9,-2,3,-2,-2,-3,0,-2,-4
"5634",2019-04-01,"Slate River Rd","w1819","Mechanized",0,"Mon","weekday","no_sled","2","1","1",19.1,0,58,-1,29,32.9,-2,3,-2,-2,-3,0,-2,-4
"5635",2019-04-01,"Slate River Rd","w1819","Motorized",10,"Mon","weekday","sled","2","1","1",19.1,0,58,-1,29,32.9,-2,3,-2,-2,-3,0,-2,-4
"5636",2019-04-01,"Slate River Rd","w1819","Hybrid",10,"Mon","weekday","sled","2","1","1",19.1,0,58,-1,29,32.9,-2,3,-2,-2,-3,0,-2,-4
"5637",2019-04-02,"Slate River Rd","w1819","Non.motorized",10,"Tue","weekday","no_sled","1","1","1",19.1,0,58,0,33,32.9,-1,-2,3,-2,-1,-3,0,-2
"5638",2019-04-02,"Slate River Rd","w1819","Mechanized",0,"Tue","weekday","no_sled","1","1","1",19.1,0,58,0,33,32.9,-1,-2,3,-2,-1,-3,0,-2
"5639",2019-04-02,"Slate River Rd","w1819","Motorized",0,"Tue","weekday","sled","1","1","1",19.1,0,58,0,33,32.9,-1,-2,3,-2,-1,-3,0,-2
"5640",2019-04-02,"Slate River Rd","w1819","Hybrid",0,"Tue","weekday","sled","1","1","1",19.1,0,58,0,33,32.9,-1,-2,3,-2,-1,-3,0,-2
"5641",2019-04-03,"Slate River Rd","w1819","Non.motorized",12,"Wed","weekday","no_sled","2","1","1",19.2,0.1,58,0,31,33.1,0,-1,-2,3,0,-1,-3,0
"5642",2019-04-03,"Slate River Rd","w1819","Mechanized",0,"Wed","weekday","no_sled","2","1","1",19.2,0.1,58,0,31,33.1,0,-1,-2,3,0,-1,-3,0
"5643",2019-04-03,"Slate River Rd","w1819","Motorized",1,"Wed","weekday","sled","2","1","1",19.2,0.1,58,0,31,33.1,0,-1,-2,3,0,-1,-3,0
"5644",2019-04-03,"Slate River Rd","w1819","Hybrid",0,"Wed","weekday","sled","2","1","1",19.2,0.1,58,0,31,33.1,0,-1,-2,3,0,-1,-3,0
"5645",2019-04-04,"Slate River Rd","w1819","Non.motorized",27,"Thu","weekday","no_sled","2","1","1",19.4,0.2,59,1,35,32.9,0,0,-1,-2,1,1,0,-2
"5646",2019-04-04,"Slate River Rd","w1819","Mechanized",0,"Thu","weekday","no_sled","2","1","1",19.4,0.2,59,1,35,32.9,0,0,-1,-2,1,1,0,-2
"5647",2019-04-04,"Slate River Rd","w1819","Motorized",5,"Thu","weekday","sled","2","1","1",19.4,0.2,59,1,35,32.9,0,0,-1,-2,1,1,0,-2
"5648",2019-04-04,"Slate River Rd","w1819","Hybrid",4,"Thu","weekday","sled","2","1","1",19.4,0.2,59,1,35,32.9,0,0,-1,-2,1,1,0,-2
"5649",2019-04-05,"Slate River Rd","w1819","Non.motorized",20,"Fri","weekday","no_sled","1","1","1",19.4,0,57,-2,38,34,1,0,0,-1,-1,-1,-1,-2
"5650",2019-04-05,"Slate River Rd","w1819","Mechanized",0,"Fri","weekday","no_sled","1","1","1",19.4,0,57,-2,38,34,1,0,0,-1,-1,-1,-1,-2
"5651",2019-04-05,"Slate River Rd","w1819","Motorized",1,"Fri","weekday","sled","1","1","1",19.4,0,57,-2,38,34,1,0,0,-1,-1,-1,-1,-2
"5652",2019-04-05,"Slate River Rd","w1819","Hybrid",1,"Fri","weekday","sled","1","1","1",19.4,0,57,-2,38,34,1,0,0,-1,-1,-1,-1,-2
"5653",2019-04-06,"Slate River Rd","w1819","Non.motorized",17,"Sat","weekend","no_sled","1","1","1",19.3,-0.1,57,0,35,33.9,-2,1,0,0,-2,-1,-1,-1
"5654",2019-04-06,"Slate River Rd","w1819","Mechanized",1,"Sat","weekend","no_sled","1","1","1",19.3,-0.1,57,0,35,33.9,-2,1,0,0,-2,-1,-1,-1
"5655",2019-04-06,"Slate River Rd","w1819","Motorized",6,"Sat","weekend","sled","1","1","1",19.3,-0.1,57,0,35,33.9,-2,1,0,0,-2,-1,-1,-1
"5656",2019-04-06,"Slate River Rd","w1819","Hybrid",4,"Sat","weekend","sled","1","1","1",19.3,-0.1,57,0,35,33.9,-2,1,0,0,-2,-1,-1,-1
"5657",2019-04-07,"Slate River Rd","w1819","Non.motorized",21,"Sun","weekend","no_sled","1","1","1",19.1,-0.2,57,0,37,33.5,0,-2,1,0,0,-2,-1,-1
"5658",2019-04-07,"Slate River Rd","w1819","Mechanized",0,"Sun","weekend","no_sled","1","1","1",19.1,-0.2,57,0,37,33.5,0,-2,1,0,0,-2,-1,-1
"5659",2019-04-07,"Slate River Rd","w1819","Motorized",15,"Sun","weekend","sled","1","1","1",19.1,-0.2,57,0,37,33.5,0,-2,1,0,0,-2,-1,-1
"5660",2019-04-07,"Slate River Rd","w1819","Hybrid",7,"Sun","weekend","sled","1","1","1",19.1,-0.2,57,0,37,33.5,0,-2,1,0,0,-2,-1,-1
"5661",2019-04-08,"Slate River Rd","w1819","Non.motorized",7,"Mon","weekday","no_sled","1","2","2",19.3,0.2,54,-3,41,35.7,0,0,-2,1,-3,-3,-5,-4
"5662",2019-04-08,"Slate River Rd","w1819","Mechanized",0,"Mon","weekday","no_sled","1","2","2",19.3,0.2,54,-3,41,35.7,0,0,-2,1,-3,-3,-5,-4
"5663",2019-04-08,"Slate River Rd","w1819","Motorized",3,"Mon","weekday","sled","1","2","2",19.3,0.2,54,-3,41,35.7,0,0,-2,1,-3,-3,-5,-4
"5664",2019-04-08,"Slate River Rd","w1819","Hybrid",3,"Mon","weekday","sled","1","2","2",19.3,0.2,54,-3,41,35.7,0,0,-2,1,-3,-3,-5,-4
"5665",2019-04-09,"Slate River Rd","w1819","Non.motorized",9,"Tue","weekday","no_sled","1","2","2",19.3,0,53,-1,43,36.4,-3,0,0,-2,-4,-4,-4,-6
"5666",2019-04-09,"Slate River Rd","w1819","Mechanized",0,"Tue","weekday","no_sled","1","2","2",19.3,0,53,-1,43,36.4,-3,0,0,-2,-4,-4,-4,-6
"5667",2019-04-09,"Slate River Rd","w1819","Motorized",5,"Tue","weekday","sled","1","2","2",19.3,0,53,-1,43,36.4,-3,0,0,-2,-4,-4,-4,-6
"5668",2019-04-09,"Slate River Rd","w1819","Hybrid",2,"Tue","weekday","sled","1","2","2",19.3,0,53,-1,43,36.4,-3,0,0,-2,-4,-4,-4,-6
"5669",2019-04-10,"Slate River Rd","w1819","Non.motorized",9,"Wed","weekday","no_sled","2","2","1",19,-0.3,51,-2,30,37.3,-1,-3,0,0,-3,-6,-6,-6
"5670",2019-04-10,"Slate River Rd","w1819","Mechanized",0,"Wed","weekday","no_sled","2","2","1",19,-0.3,51,-2,30,37.3,-1,-3,0,0,-3,-6,-6,-6
"5671",2019-04-10,"Slate River Rd","w1819","Motorized",2,"Wed","weekday","sled","2","2","1",19,-0.3,51,-2,30,37.3,-1,-3,0,0,-3,-6,-6,-6
"5672",2019-04-10,"Slate River Rd","w1819","Hybrid",2,"Wed","weekday","sled","2","2","1",19,-0.3,51,-2,30,37.3,-1,-3,0,0,-3,-6,-6,-6
"5673",2019-04-11,"Slate River Rd","w1819","Non.motorized",5,"Thu","weekday","no_sled","3","3","2",18.9,-0.1,53,2,20,35.7,-2,-1,-3,0,0,-1,-4,-4
"5674",2019-04-11,"Slate River Rd","w1819","Mechanized",0,"Thu","weekday","no_sled","3","3","2",18.9,-0.1,53,2,20,35.7,-2,-1,-3,0,0,-1,-4,-4
"5675",2019-04-11,"Slate River Rd","w1819","Motorized",2,"Thu","weekday","sled","3","3","2",18.9,-0.1,53,2,20,35.7,-2,-1,-3,0,0,-1,-4,-4
"5676",2019-04-11,"Slate River Rd","w1819","Hybrid",1,"Thu","weekday","sled","3","3","2",18.9,-0.1,53,2,20,35.7,-2,-1,-3,0,0,-1,-4,-4
"5677",2019-04-12,"Slate River Rd","w1819","Non.motorized",13,"Fri","weekday","no_sled","2","2","1",18.7,-0.2,53,0,24,35.3,2,-2,-1,-3,2,0,-1,-4
"5678",2019-04-12,"Slate River Rd","w1819","Mechanized",1,"Fri","weekday","no_sled","2","2","1",18.7,-0.2,53,0,24,35.3,2,-2,-1,-3,2,0,-1,-4
"5679",2019-04-12,"Slate River Rd","w1819","Motorized",6,"Fri","weekday","sled","2","2","1",18.7,-0.2,53,0,24,35.3,2,-2,-1,-3,2,0,-1,-4
"5680",2019-04-12,"Slate River Rd","w1819","Hybrid",4,"Fri","weekday","sled","2","2","1",18.7,-0.2,53,0,24,35.3,2,-2,-1,-3,2,0,-1,-4
"5681",2019-04-13,"Slate River Rd","w1819","Non.motorized",17,"Sat","weekend","no_sled","1","1","1",18.8,0.1,52,-1,27,36.2,0,2,-2,-1,-1,1,-1,-2
"5682",2019-04-13,"Slate River Rd","w1819","Mechanized",0,"Sat","weekend","no_sled","1","1","1",18.8,0.1,52,-1,27,36.2,0,2,-2,-1,-1,1,-1,-2
"5683",2019-04-13,"Slate River Rd","w1819","Motorized",9,"Sat","weekend","sled","1","1","1",18.8,0.1,52,-1,27,36.2,0,2,-2,-1,-1,1,-1,-2
"5684",2019-04-13,"Slate River Rd","w1819","Hybrid",8,"Sat","weekend","sled","1","1","1",18.8,0.1,52,-1,27,36.2,0,2,-2,-1,-1,1,-1,-2
"5685",2019-04-14,"Slate River Rd","w1819","Non.motorized",9,"Sun","weekend","no_sled","1","1","1",18.7,-0.1,51,-1,35,36.7,-1,0,2,-2,-2,-2,0,-2
"5686",2019-04-14,"Slate River Rd","w1819","Mechanized",0,"Sun","weekend","no_sled","1","1","1",18.7,-0.1,51,-1,35,36.7,-1,0,2,-2,-2,-2,0,-2
"5687",2019-04-14,"Slate River Rd","w1819","Motorized",5,"Sun","weekend","sled","1","1","1",18.7,-0.1,51,-1,35,36.7,-1,0,2,-2,-2,-2,0,-2
"5688",2019-04-14,"Slate River Rd","w1819","Hybrid",5,"Sun","weekend","sled","1","1","1",18.7,-0.1,51,-1,35,36.7,-1,0,2,-2,-2,-2,0,-2
"5689",2019-04-15,"Slate River Rd","w1819","Non.motorized",4,"Mon","weekday","no_sled",NA,NA,NA,18.6,-0.1,50,-1,41,37.2,-1,-1,0,2,-2,-3,-3,-1
"5690",2019-04-15,"Slate River Rd","w1819","Mechanized",0,"Mon","weekday","no_sled",NA,NA,NA,18.6,-0.1,50,-1,41,37.2,-1,-1,0,2,-2,-3,-3,-1
"5691",2019-04-15,"Slate River Rd","w1819","Motorized",4,"Mon","weekday","sled",NA,NA,NA,18.6,-0.1,50,-1,41,37.2,-1,-1,0,2,-2,-3,-3,-1
"5692",2019-04-15,"Slate River Rd","w1819","Hybrid",4,"Mon","weekday","sled",NA,NA,NA,18.6,-0.1,50,-1,41,37.2,-1,-1,0,2,-2,-3,-3,-1
"5693",2018-12-01,"Snodgrass","w1819","Non.motorized",81,"Sat","weekend","no_sled","3","3","2",3.3,0.2,19,1,16,17.4,0,0,0,0,1,1,1,1
"5694",2018-12-01,"Snodgrass","w1819","Mechanized",0,"Sat","weekend","no_sled","3","3","2",3.3,0.2,19,1,16,17.4,0,0,0,0,1,1,1,1
"5695",2018-12-01,"Snodgrass","w1819","Motorized",0,"Sat","weekend","sled","3","3","2",3.3,0.2,19,1,16,17.4,0,0,0,0,1,1,1,1
"5696",2018-12-01,"Snodgrass","w1819","Hybrid",0,"Sat","weekend","sled","3","3","2",3.3,0.2,19,1,16,17.4,0,0,0,0,1,1,1,1
"5697",2018-12-02,"Snodgrass","w1819","Non.motorized",0,"Sun","weekend","no_sled","3","3","3",3.3,0,20,1,14,16.5,1,0,0,0,2,2,2,2
"5698",2018-12-02,"Snodgrass","w1819","Mechanized",0,"Sun","weekend","no_sled","3","3","3",3.3,0,20,1,14,16.5,1,0,0,0,2,2,2,2
"5699",2018-12-02,"Snodgrass","w1819","Motorized",0,"Sun","weekend","sled","3","3","3",3.3,0,20,1,14,16.5,1,0,0,0,2,2,2,2
"5700",2018-12-02,"Snodgrass","w1819","Hybrid",0,"Sun","weekend","sled","3","3","3",3.3,0,20,1,14,16.5,1,0,0,0,2,2,2,2
"5701",2018-12-03,"Snodgrass","w1819","Non.motorized",0,"Mon","weekday","no_sled","3","3","2",3.4,0.1,19,-1,13,17.9,1,1,0,0,0,1,1,1
"5702",2018-12-03,"Snodgrass","w1819","Mechanized",0,"Mon","weekday","no_sled","3","3","2",3.4,0.1,19,-1,13,17.9,1,1,0,0,0,1,1,1
"5703",2018-12-03,"Snodgrass","w1819","Motorized",0,"Mon","weekday","sled","3","3","2",3.4,0.1,19,-1,13,17.9,1,1,0,0,0,1,1,1
"5704",2018-12-03,"Snodgrass","w1819","Hybrid",0,"Mon","weekday","sled","3","3","2",3.4,0.1,19,-1,13,17.9,1,1,0,0,0,1,1,1
"5705",2018-12-04,"Snodgrass","w1819","Non.motorized",0,"Tue","weekday","no_sled","3","3","2",3.5,0.1,20,1,8,17.5,-1,1,1,0,0,1,2,2
"5706",2018-12-04,"Snodgrass","w1819","Mechanized",0,"Tue","weekday","no_sled","3","3","2",3.5,0.1,20,1,8,17.5,-1,1,1,0,0,1,2,2
"5707",2018-12-04,"Snodgrass","w1819","Motorized",0,"Tue","weekday","sled","3","3","2",3.5,0.1,20,1,8,17.5,-1,1,1,0,0,1,2,2
"5708",2018-12-04,"Snodgrass","w1819","Hybrid",0,"Tue","weekday","sled","3","3","2",3.5,0.1,20,1,8,17.5,-1,1,1,0,0,1,2,2
"5709",2018-12-05,"Snodgrass","w1819","Non.motorized",0,"Wed","weekday","no_sled","3","3","2",3.5,0,19,-1,21,18.4,1,-1,1,1,0,-1,0,1
"5710",2018-12-05,"Snodgrass","w1819","Mechanized",0,"Wed","weekday","no_sled","3","3","2",3.5,0,19,-1,21,18.4,1,-1,1,1,0,-1,0,1
"5711",2018-12-05,"Snodgrass","w1819","Motorized",0,"Wed","weekday","sled","3","3","2",3.5,0,19,-1,21,18.4,1,-1,1,1,0,-1,0,1
"5712",2018-12-05,"Snodgrass","w1819","Hybrid",0,"Wed","weekday","sled","3","3","2",3.5,0,19,-1,21,18.4,1,-1,1,1,0,-1,0,1
"5713",2018-12-06,"Snodgrass","w1819","Non.motorized",0,"Thu","weekday","no_sled","2","2","2",3.7,0.2,18,-1,25,20.6,-1,1,-1,1,-2,-1,-2,-1
"5714",2018-12-06,"Snodgrass","w1819","Mechanized",0,"Thu","weekday","no_sled","2","2","2",3.7,0.2,18,-1,25,20.6,-1,1,-1,1,-2,-1,-2,-1
"5715",2018-12-06,"Snodgrass","w1819","Motorized",0,"Thu","weekday","sled","2","2","2",3.7,0.2,18,-1,25,20.6,-1,1,-1,1,-2,-1,-2,-1
"5716",2018-12-06,"Snodgrass","w1819","Hybrid",0,"Thu","weekday","sled","2","2","2",3.7,0.2,18,-1,25,20.6,-1,1,-1,1,-2,-1,-2,-1
"5717",2018-12-07,"Snodgrass","w1819","Non.motorized",0,"Fri","weekday","no_sled","2","2","2",3.8,0.1,21,3,23,18.1,-1,-1,1,-1,2,1,2,1
"5718",2018-12-07,"Snodgrass","w1819","Mechanized",0,"Fri","weekday","no_sled","2","2","2",3.8,0.1,21,3,23,18.1,-1,-1,1,-1,2,1,2,1
"5719",2018-12-07,"Snodgrass","w1819","Motorized",0,"Fri","weekday","sled","2","2","2",3.8,0.1,21,3,23,18.1,-1,-1,1,-1,2,1,2,1
"5720",2018-12-07,"Snodgrass","w1819","Hybrid",0,"Fri","weekday","sled","2","2","2",3.8,0.1,21,3,23,18.1,-1,-1,1,-1,2,1,2,1
"5721",2018-12-08,"Snodgrass","w1819","Non.motorized",0,"Sat","weekend","no_sled","2","2","2",3.8,0,20,-1,23,19,3,-1,-1,1,2,1,0,1
"5722",2018-12-08,"Snodgrass","w1819","Mechanized",0,"Sat","weekend","no_sled","2","2","2",3.8,0,20,-1,23,19,3,-1,-1,1,2,1,0,1
"5723",2018-12-08,"Snodgrass","w1819","Motorized",0,"Sat","weekend","sled","2","2","2",3.8,0,20,-1,23,19,3,-1,-1,1,2,1,0,1
"5724",2018-12-08,"Snodgrass","w1819","Hybrid",0,"Sat","weekend","sled","2","2","2",3.8,0,20,-1,23,19,3,-1,-1,1,2,1,0,1
"5725",2018-12-09,"Snodgrass","w1819","Non.motorized",0,"Sun","weekend","no_sled","2","2","2",3.8,0,20,0,19,19,-1,3,-1,-1,-1,2,1,0
"5726",2018-12-09,"Snodgrass","w1819","Mechanized",0,"Sun","weekend","no_sled","2","2","2",3.8,0,20,0,19,19,-1,3,-1,-1,-1,2,1,0
"5727",2018-12-09,"Snodgrass","w1819","Motorized",0,"Sun","weekend","sled","2","2","2",3.8,0,20,0,19,19,-1,3,-1,-1,-1,2,1,0
"5728",2018-12-09,"Snodgrass","w1819","Hybrid",0,"Sun","weekend","sled","2","2","2",3.8,0,20,0,19,19,-1,3,-1,-1,-1,2,1,0
"5729",2018-12-10,"Snodgrass","w1819","Non.motorized",0,"Mon","weekday","no_sled","2","2","2",3.8,0,20,0,21,19,0,-1,3,-1,0,-1,2,1
"5730",2018-12-10,"Snodgrass","w1819","Mechanized",0,"Mon","weekday","no_sled","2","2","2",3.8,0,20,0,21,19,0,-1,3,-1,0,-1,2,1
"5731",2018-12-10,"Snodgrass","w1819","Motorized",0,"Mon","weekday","sled","2","2","2",3.8,0,20,0,21,19,0,-1,3,-1,0,-1,2,1
"5732",2018-12-10,"Snodgrass","w1819","Hybrid",0,"Mon","weekday","sled","2","2","2",3.8,0,20,0,21,19,0,-1,3,-1,0,-1,2,1
"5733",2018-12-11,"Snodgrass","w1819","Non.motorized",0,"Tue","weekday","no_sled","2","2","2",3.9,0.1,19,-1,27,20.5,0,0,-1,3,-1,-1,-2,1
"5734",2018-12-11,"Snodgrass","w1819","Mechanized",0,"Tue","weekday","no_sled","2","2","2",3.9,0.1,19,-1,27,20.5,0,0,-1,3,-1,-1,-2,1
"5735",2018-12-11,"Snodgrass","w1819","Motorized",0,"Tue","weekday","sled","2","2","2",3.9,0.1,19,-1,27,20.5,0,0,-1,3,-1,-1,-2,1
"5736",2018-12-11,"Snodgrass","w1819","Hybrid",0,"Tue","weekday","sled","2","2","2",3.9,0.1,19,-1,27,20.5,0,0,-1,3,-1,-1,-2,1
"5737",2018-12-12,"Snodgrass","w1819","Non.motorized",0,"Wed","weekday","no_sled","2","2","1",3.9,0,19,0,21,20.5,-1,0,0,-1,-1,-1,-1,-2
"5738",2018-12-12,"Snodgrass","w1819","Mechanized",0,"Wed","weekday","no_sled","2","2","1",3.9,0,19,0,21,20.5,-1,0,0,-1,-1,-1,-1,-2
"5739",2018-12-12,"Snodgrass","w1819","Motorized",0,"Wed","weekday","sled","2","2","1",3.9,0,19,0,21,20.5,-1,0,0,-1,-1,-1,-1,-2
"5740",2018-12-12,"Snodgrass","w1819","Hybrid",0,"Wed","weekday","sled","2","2","1",3.9,0,19,0,21,20.5,-1,0,0,-1,-1,-1,-1,-2
"5741",2018-12-13,"Snodgrass","w1819","Non.motorized",0,"Thu","weekday","no_sled","3","3","2",4,0.1,21,2,15,19,0,-1,0,0,2,1,1,1
"5742",2018-12-13,"Snodgrass","w1819","Mechanized",0,"Thu","weekday","no_sled","3","3","2",4,0.1,21,2,15,19,0,-1,0,0,2,1,1,1
"5743",2018-12-13,"Snodgrass","w1819","Motorized",0,"Thu","weekday","sled","3","3","2",4,0.1,21,2,15,19,0,-1,0,0,2,1,1,1
"5744",2018-12-13,"Snodgrass","w1819","Hybrid",0,"Thu","weekday","sled","3","3","2",4,0.1,21,2,15,19,0,-1,0,0,2,1,1,1
"5745",2018-12-14,"Snodgrass","w1819","Non.motorized",0,"Fri","weekday","no_sled","3","3","2",4,0,20,-1,24,20,2,0,-1,0,1,1,0,0
"5746",2018-12-14,"Snodgrass","w1819","Mechanized",0,"Fri","weekday","no_sled","3","3","2",4,0,20,-1,24,20,2,0,-1,0,1,1,0,0
"5747",2018-12-14,"Snodgrass","w1819","Motorized",0,"Fri","weekday","sled","3","3","2",4,0,20,-1,24,20,2,0,-1,0,1,1,0,0
"5748",2018-12-14,"Snodgrass","w1819","Hybrid",0,"Fri","weekday","sled","3","3","2",4,0,20,-1,24,20,2,0,-1,0,1,1,0,0
"5749",2018-12-15,"Snodgrass","w1819","Non.motorized",0,"Sat","weekend","no_sled","2","2","2",4,0,20,0,29,20,-1,2,0,-1,-1,1,1,0
"5750",2018-12-15,"Snodgrass","w1819","Mechanized",0,"Sat","weekend","no_sled","2","2","2",4,0,20,0,29,20,-1,2,0,-1,-1,1,1,0
"5751",2018-12-15,"Snodgrass","w1819","Motorized",0,"Sat","weekend","sled","2","2","2",4,0,20,0,29,20,-1,2,0,-1,-1,1,1,0
"5752",2018-12-15,"Snodgrass","w1819","Hybrid",0,"Sat","weekend","sled","2","2","2",4,0,20,0,29,20,-1,2,0,-1,-1,1,1,0
"5753",2018-12-16,"Snodgrass","w1819","Non.motorized",0,"Sun","weekend","no_sled","2","2","2",4.1,0.1,19,-1,28,21.6,0,-1,2,0,-1,-2,0,0
"5754",2018-12-16,"Snodgrass","w1819","Mechanized",0,"Sun","weekend","no_sled","2","2","2",4.1,0.1,19,-1,28,21.6,0,-1,2,0,-1,-2,0,0
"5755",2018-12-16,"Snodgrass","w1819","Motorized",0,"Sun","weekend","sled","2","2","2",4.1,0.1,19,-1,28,21.6,0,-1,2,0,-1,-2,0,0
"5756",2018-12-16,"Snodgrass","w1819","Hybrid",0,"Sun","weekend","sled","2","2","2",4.1,0.1,19,-1,28,21.6,0,-1,2,0,-1,-2,0,0
"5757",2018-12-17,"Snodgrass","w1819","Non.motorized",0,"Mon","weekday","no_sled","2","2","2",4.1,0,19,0,29,21.6,-1,0,-1,2,-1,-1,-2,0
"5758",2018-12-17,"Snodgrass","w1819","Mechanized",0,"Mon","weekday","no_sled","2","2","2",4.1,0,19,0,29,21.6,-1,0,-1,2,-1,-1,-2,0
"5759",2018-12-17,"Snodgrass","w1819","Motorized",0,"Mon","weekday","sled","2","2","2",4.1,0,19,0,29,21.6,-1,0,-1,2,-1,-1,-2,0
"5760",2018-12-17,"Snodgrass","w1819","Hybrid",0,"Mon","weekday","sled","2","2","2",4.1,0,19,0,29,21.6,-1,0,-1,2,-1,-1,-2,0
"5761",2018-12-18,"Snodgrass","w1819","Non.motorized",0,"Tue","weekday","no_sled","2","2","2",4.1,0,19,0,27,21.6,0,-1,0,-1,0,-1,-1,-2
"5762",2018-12-18,"Snodgrass","w1819","Mechanized",0,"Tue","weekday","no_sled","2","2","2",4.1,0,19,0,27,21.6,0,-1,0,-1,0,-1,-1,-2
"5763",2018-12-18,"Snodgrass","w1819","Motorized",0,"Tue","weekday","sled","2","2","2",4.1,0,19,0,27,21.6,0,-1,0,-1,0,-1,-1,-2
"5764",2018-12-18,"Snodgrass","w1819","Hybrid",0,"Tue","weekday","sled","2","2","2",4.1,0,19,0,27,21.6,0,-1,0,-1,0,-1,-1,-2
"5765",2018-12-19,"Snodgrass","w1819","Non.motorized",0,"Wed","weekday","no_sled","2","2","2",4.1,0,19,0,24,21.6,0,0,-1,0,0,0,-1,-1
"5766",2018-12-19,"Snodgrass","w1819","Mechanized",0,"Wed","weekday","no_sled","2","2","2",4.1,0,19,0,24,21.6,0,0,-1,0,0,0,-1,-1
"5767",2018-12-19,"Snodgrass","w1819","Motorized",0,"Wed","weekday","sled","2","2","2",4.1,0,19,0,24,21.6,0,0,-1,0,0,0,-1,-1
"5768",2018-12-19,"Snodgrass","w1819","Hybrid",0,"Wed","weekday","sled","2","2","2",4.1,0,19,0,24,21.6,0,0,-1,0,0,0,-1,-1
"5769",2018-12-20,"Snodgrass","w1819","Non.motorized",0,"Thu","weekday","no_sled","2","2","1",4.1,0,20,1,25,20.5,0,0,0,-1,1,1,1,0
"5770",2018-12-20,"Snodgrass","w1819","Mechanized",0,"Thu","weekday","no_sled","2","2","1",4.1,0,20,1,25,20.5,0,0,0,-1,1,1,1,0
"5771",2018-12-20,"Snodgrass","w1819","Motorized",0,"Thu","weekday","sled","2","2","1",4.1,0,20,1,25,20.5,0,0,0,-1,1,1,1,0
"5772",2018-12-20,"Snodgrass","w1819","Hybrid",0,"Thu","weekday","sled","2","2","1",4.1,0,20,1,25,20.5,0,0,0,-1,1,1,1,0
"5773",2018-12-21,"Snodgrass","w1819","Non.motorized",0,"Fri","weekday","no_sled","2","2","1",4.1,0,19,-1,28,21.6,1,0,0,0,0,0,0,0
"5774",2018-12-21,"Snodgrass","w1819","Mechanized",0,"Fri","weekday","no_sled","2","2","1",4.1,0,19,-1,28,21.6,1,0,0,0,0,0,0,0
"5775",2018-12-21,"Snodgrass","w1819","Motorized",0,"Fri","weekday","sled","2","2","1",4.1,0,19,-1,28,21.6,1,0,0,0,0,0,0,0
"5776",2018-12-21,"Snodgrass","w1819","Hybrid",0,"Fri","weekday","sled","2","2","1",4.1,0,19,-1,28,21.6,1,0,0,0,0,0,0,0
"5777",2018-12-22,"Snodgrass","w1819","Non.motorized",0,"Sat","weekend","no_sled","2","2","1",4.2,0.1,19,0,20,22.1,-1,1,0,0,-1,0,0,0
"5778",2018-12-22,"Snodgrass","w1819","Mechanized",0,"Sat","weekend","no_sled","2","2","1",4.2,0.1,19,0,20,22.1,-1,1,0,0,-1,0,0,0
"5779",2018-12-22,"Snodgrass","w1819","Motorized",0,"Sat","weekend","sled","2","2","1",4.2,0.1,19,0,20,22.1,-1,1,0,0,-1,0,0,0
"5780",2018-12-22,"Snodgrass","w1819","Hybrid",0,"Sat","weekend","sled","2","2","1",4.2,0.1,19,0,20,22.1,-1,1,0,0,-1,0,0,0
"5781",2018-12-23,"Snodgrass","w1819","Non.motorized",0,"Sun","weekend","no_sled","2","2","1",4.2,0,21,2,19,20,0,-1,1,0,2,1,2,2
"5782",2018-12-23,"Snodgrass","w1819","Mechanized",0,"Sun","weekend","no_sled","2","2","1",4.2,0,21,2,19,20,0,-1,1,0,2,1,2,2
"5783",2018-12-23,"Snodgrass","w1819","Motorized",0,"Sun","weekend","sled","2","2","1",4.2,0,21,2,19,20,0,-1,1,0,2,1,2,2
"5784",2018-12-23,"Snodgrass","w1819","Hybrid",0,"Sun","weekend","sled","2","2","1",4.2,0,21,2,19,20,0,-1,1,0,2,1,2,2
"5785",2018-12-24,"Snodgrass","w1819","Non.motorized",0,"Mon","weekday","no_sled","2","2","2",4.3,0.1,20,-1,21,21.5,2,0,-1,1,1,1,0,1
"5786",2018-12-24,"Snodgrass","w1819","Mechanized",0,"Mon","weekday","no_sled","2","2","2",4.3,0.1,20,-1,21,21.5,2,0,-1,1,1,1,0,1
"5787",2018-12-24,"Snodgrass","w1819","Motorized",0,"Mon","weekday","sled","2","2","2",4.3,0.1,20,-1,21,21.5,2,0,-1,1,1,1,0,1
"5788",2018-12-24,"Snodgrass","w1819","Hybrid",0,"Mon","weekday","sled","2","2","2",4.3,0.1,20,-1,21,21.5,2,0,-1,1,1,1,0,1
"5789",2018-12-25,"Snodgrass","w1819","Non.motorized",0,"Tue","weekday","no_sled","2","2","2",4.7,0.4,25,5,25,18.8,-1,2,0,-1,4,6,6,5
"5790",2018-12-25,"Snodgrass","w1819","Mechanized",0,"Tue","weekday","no_sled","2","2","2",4.7,0.4,25,5,25,18.8,-1,2,0,-1,4,6,6,5
"5791",2018-12-25,"Snodgrass","w1819","Motorized",0,"Tue","weekday","sled","2","2","2",4.7,0.4,25,5,25,18.8,-1,2,0,-1,4,6,6,5
"5792",2018-12-25,"Snodgrass","w1819","Hybrid",0,"Tue","weekday","sled","2","2","2",4.7,0.4,25,5,25,18.8,-1,2,0,-1,4,6,6,5
"5793",2018-12-26,"Snodgrass","w1819","Non.motorized",0,"Wed","weekday","no_sled","3","3","3",4.7,0,23,-2,24,20.4,5,-1,2,0,3,2,4,4
"5794",2018-12-26,"Snodgrass","w1819","Mechanized",0,"Wed","weekday","no_sled","3","3","3",4.7,0,23,-2,24,20.4,5,-1,2,0,3,2,4,4
"5795",2018-12-26,"Snodgrass","w1819","Motorized",0,"Wed","weekday","sled","3","3","3",4.7,0,23,-2,24,20.4,5,-1,2,0,3,2,4,4
"5796",2018-12-26,"Snodgrass","w1819","Hybrid",0,"Wed","weekday","sled","3","3","3",4.7,0,23,-2,24,20.4,5,-1,2,0,3,2,4,4
"5797",2018-12-27,"Snodgrass","w1819","Non.motorized",0,"Thu","weekday","no_sled","3","3","2",4.7,0,24,1,12,19.6,-2,5,-1,2,-1,4,3,5
"5798",2018-12-27,"Snodgrass","w1819","Mechanized",0,"Thu","weekday","no_sled","3","3","2",4.7,0,24,1,12,19.6,-2,5,-1,2,-1,4,3,5
"5799",2018-12-27,"Snodgrass","w1819","Motorized",0,"Thu","weekday","sled","3","3","2",4.7,0,24,1,12,19.6,-2,5,-1,2,-1,4,3,5
"5800",2018-12-27,"Snodgrass","w1819","Hybrid",0,"Thu","weekday","sled","3","3","2",4.7,0,24,1,12,19.6,-2,5,-1,2,-1,4,3,5
"5801",2018-12-28,"Snodgrass","w1819","Non.motorized",0,"Fri","weekday","no_sled","3","3","2",4.7,0,24,0,12,19.6,1,-2,5,-1,1,-1,4,3
"5802",2018-12-28,"Snodgrass","w1819","Mechanized",0,"Fri","weekday","no_sled","3","3","2",4.7,0,24,0,12,19.6,1,-2,5,-1,1,-1,4,3
"5803",2018-12-28,"Snodgrass","w1819","Motorized",0,"Fri","weekday","sled","3","3","2",4.7,0,24,0,12,19.6,1,-2,5,-1,1,-1,4,3
"5804",2018-12-28,"Snodgrass","w1819","Hybrid",0,"Fri","weekday","sled","3","3","2",4.7,0,24,0,12,19.6,1,-2,5,-1,1,-1,4,3
"5805",2018-12-29,"Snodgrass","w1819","Non.motorized",0,"Sat","weekend","no_sled","3","3","2",4.7,0,24,0,8,19.6,0,1,-2,5,0,1,-1,4
"5806",2018-12-29,"Snodgrass","w1819","Mechanized",0,"Sat","weekend","no_sled","3","3","2",4.7,0,24,0,8,19.6,0,1,-2,5,0,1,-1,4
"5807",2018-12-29,"Snodgrass","w1819","Motorized",0,"Sat","weekend","sled","3","3","2",4.7,0,24,0,8,19.6,0,1,-2,5,0,1,-1,4
"5808",2018-12-29,"Snodgrass","w1819","Hybrid",0,"Sat","weekend","sled","3","3","2",4.7,0,24,0,8,19.6,0,1,-2,5,0,1,-1,4
"5809",2018-12-30,"Snodgrass","w1819","Non.motorized",0,"Sun","weekend","no_sled","3","3","2",4.7,0,24,0,16,19.6,0,0,1,-2,0,0,1,-1
"5810",2018-12-30,"Snodgrass","w1819","Mechanized",0,"Sun","weekend","no_sled","3","3","2",4.7,0,24,0,16,19.6,0,0,1,-2,0,0,1,-1
"5811",2018-12-30,"Snodgrass","w1819","Motorized",0,"Sun","weekend","sled","3","3","2",4.7,0,24,0,16,19.6,0,0,1,-2,0,0,1,-1
"5812",2018-12-30,"Snodgrass","w1819","Hybrid",0,"Sun","weekend","sled","3","3","2",4.7,0,24,0,16,19.6,0,0,1,-2,0,0,1,-1
"5813",2018-12-31,"Snodgrass","w1819","Non.motorized",0,"Mon","weekday","no_sled","3","3","3",4.9,0.2,23,-1,14,21.3,0,0,0,1,-1,-1,-1,0
"5814",2018-12-31,"Snodgrass","w1819","Mechanized",0,"Mon","weekday","no_sled","3","3","3",4.9,0.2,23,-1,14,21.3,0,0,0,1,-1,-1,-1,0
"5815",2018-12-31,"Snodgrass","w1819","Motorized",0,"Mon","weekday","sled","3","3","3",4.9,0.2,23,-1,14,21.3,0,0,0,1,-1,-1,-1,0
"5816",2018-12-31,"Snodgrass","w1819","Hybrid",0,"Mon","weekday","sled","3","3","3",4.9,0.2,23,-1,14,21.3,0,0,0,1,-1,-1,-1,0
"5817",2019-01-01,"Snodgrass","w1819","Non.motorized",0,"Tue","weekday","no_sled","3","3","3",5.1,0.2,29,6,11,17.6,-1,0,0,0,5,5,5,5
"5818",2019-01-01,"Snodgrass","w1819","Mechanized",0,"Tue","weekday","no_sled","3","3","3",5.1,0.2,29,6,11,17.6,-1,0,0,0,5,5,5,5
"5819",2019-01-01,"Snodgrass","w1819","Motorized",0,"Tue","weekday","sled","3","3","3",5.1,0.2,29,6,11,17.6,-1,0,0,0,5,5,5,5
"5820",2019-01-01,"Snodgrass","w1819","Hybrid",0,"Tue","weekday","sled","3","3","3",5.1,0.2,29,6,11,17.6,-1,0,0,0,5,5,5,5
"5821",2019-01-02,"Snodgrass","w1819","Non.motorized",5,"Wed","weekday","no_sled","3","3","2",5.1,0,28,-1,10,18.2,6,-1,0,0,5,4,4,4
"5822",2019-01-02,"Snodgrass","w1819","Mechanized",0,"Wed","weekday","no_sled","3","3","2",5.1,0,28,-1,10,18.2,6,-1,0,0,5,4,4,4
"5823",2019-01-02,"Snodgrass","w1819","Motorized",1,"Wed","weekday","sled","3","3","2",5.1,0,28,-1,10,18.2,6,-1,0,0,5,4,4,4
"5824",2019-01-02,"Snodgrass","w1819","Hybrid",0,"Wed","weekday","sled","3","3","2",5.1,0,28,-1,10,18.2,6,-1,0,0,5,4,4,4
"5825",2019-01-03,"Snodgrass","w1819","Non.motorized",94,"Thu","weekday","no_sled","3","3","2",5.1,0,27,-1,22,18.9,-1,6,-1,0,-2,4,3,3
"5826",2019-01-03,"Snodgrass","w1819","Mechanized",0,"Thu","weekday","no_sled","3","3","2",5.1,0,27,-1,22,18.9,-1,6,-1,0,-2,4,3,3
"5827",2019-01-03,"Snodgrass","w1819","Motorized",7,"Thu","weekday","sled","3","3","2",5.1,0,27,-1,22,18.9,-1,6,-1,0,-2,4,3,3
"5828",2019-01-03,"Snodgrass","w1819","Hybrid",0,"Thu","weekday","sled","3","3","2",5.1,0,27,-1,22,18.9,-1,6,-1,0,-2,4,3,3
"5829",2019-01-04,"Snodgrass","w1819","Non.motorized",119,"Fri","weekday","no_sled","3","3","2",5.3,0.2,26,-1,29,20.4,-1,-1,6,-1,-2,-3,3,2
"5830",2019-01-04,"Snodgrass","w1819","Mechanized",11,"Fri","weekday","no_sled","3","3","2",5.3,0.2,26,-1,29,20.4,-1,-1,6,-1,-2,-3,3,2
"5831",2019-01-04,"Snodgrass","w1819","Motorized",9,"Fri","weekday","sled","3","3","2",5.3,0.2,26,-1,29,20.4,-1,-1,6,-1,-2,-3,3,2
"5832",2019-01-04,"Snodgrass","w1819","Hybrid",0,"Fri","weekday","sled","3","3","2",5.3,0.2,26,-1,29,20.4,-1,-1,6,-1,-2,-3,3,2
"5833",2019-01-05,"Snodgrass","w1819","Non.motorized",123,"Sat","weekend","no_sled","2","2","2",5.3,0,25,-1,30,21.2,-1,-1,-1,6,-2,-3,-4,2
"5834",2019-01-05,"Snodgrass","w1819","Mechanized",9,"Sat","weekend","no_sled","2","2","2",5.3,0,25,-1,30,21.2,-1,-1,-1,6,-2,-3,-4,2
"5835",2019-01-05,"Snodgrass","w1819","Motorized",2,"Sat","weekend","sled","2","2","2",5.3,0,25,-1,30,21.2,-1,-1,-1,6,-2,-3,-4,2
"5836",2019-01-05,"Snodgrass","w1819","Hybrid",0,"Sat","weekend","sled","2","2","2",5.3,0,25,-1,30,21.2,-1,-1,-1,6,-2,-3,-4,2
"5837",2019-01-06,"Snodgrass","w1819","Non.motorized",69,"Sun","weekend","no_sled","3","3","3",5.3,0,25,0,26,21.2,-1,-1,-1,-1,-1,-2,-3,-4
"5838",2019-01-06,"Snodgrass","w1819","Mechanized",0,"Sun","weekend","no_sled","3","3","3",5.3,0,25,0,26,21.2,-1,-1,-1,-1,-1,-2,-3,-4
"5839",2019-01-06,"Snodgrass","w1819","Motorized",1,"Sun","weekend","sled","3","3","3",5.3,0,25,0,26,21.2,-1,-1,-1,-1,-1,-2,-3,-4
"5840",2019-01-06,"Snodgrass","w1819","Hybrid",0,"Sun","weekend","sled","3","3","3",5.3,0,25,0,26,21.2,-1,-1,-1,-1,-1,-2,-3,-4
"5841",2019-01-07,"Snodgrass","w1819","Non.motorized",0,"Mon","weekday","no_sled","3","3","3",5.8,0.5,32,7,21,18.1,0,-1,-1,-1,7,6,5,4
"5842",2019-01-07,"Snodgrass","w1819","Mechanized",0,"Mon","weekday","no_sled","3","3","3",5.8,0.5,32,7,21,18.1,0,-1,-1,-1,7,6,5,4
"5843",2019-01-07,"Snodgrass","w1819","Motorized",0,"Mon","weekday","sled","3","3","3",5.8,0.5,32,7,21,18.1,0,-1,-1,-1,7,6,5,4
"5844",2019-01-07,"Snodgrass","w1819","Hybrid",0,"Mon","weekday","sled","3","3","3",5.8,0.5,32,7,21,18.1,0,-1,-1,-1,7,6,5,4
"5845",2019-01-08,"Snodgrass","w1819","Non.motorized",68,"Tue","weekday","no_sled","3","3","3",5.9,0.1,32,0,24,18.4,7,0,-1,-1,7,7,6,5
"5846",2019-01-08,"Snodgrass","w1819","Mechanized",1,"Tue","weekday","no_sled","3","3","3",5.9,0.1,32,0,24,18.4,7,0,-1,-1,7,7,6,5
"5847",2019-01-08,"Snodgrass","w1819","Motorized",0,"Tue","weekday","sled","3","3","3",5.9,0.1,32,0,24,18.4,7,0,-1,-1,7,7,6,5
"5848",2019-01-08,"Snodgrass","w1819","Hybrid",0,"Tue","weekday","sled","3","3","3",5.9,0.1,32,0,24,18.4,7,0,-1,-1,7,7,6,5
"5849",2019-01-09,"Snodgrass","w1819","Non.motorized",62,"Wed","weekday","no_sled","3","3","3",6,0.1,30,-2,29,20,0,7,0,-1,-2,5,5,4
"5850",2019-01-09,"Snodgrass","w1819","Mechanized",1,"Wed","weekday","no_sled","3","3","3",6,0.1,30,-2,29,20,0,7,0,-1,-2,5,5,4
"5851",2019-01-09,"Snodgrass","w1819","Motorized",0,"Wed","weekday","sled","3","3","3",6,0.1,30,-2,29,20,0,7,0,-1,-2,5,5,4
"5852",2019-01-09,"Snodgrass","w1819","Hybrid",0,"Wed","weekday","sled","3","3","3",6,0.1,30,-2,29,20,0,7,0,-1,-2,5,5,4
"5853",2019-01-10,"Snodgrass","w1819","Non.motorized",78,"Thu","weekday","no_sled","3","3","3",6,0,29,-1,29,20.7,-2,0,7,0,-3,-3,4,4
"5854",2019-01-10,"Snodgrass","w1819","Mechanized",7,"Thu","weekday","no_sled","3","3","3",6,0,29,-1,29,20.7,-2,0,7,0,-3,-3,4,4
"5855",2019-01-10,"Snodgrass","w1819","Motorized",0,"Thu","weekday","sled","3","3","3",6,0,29,-1,29,20.7,-2,0,7,0,-3,-3,4,4
"5856",2019-01-10,"Snodgrass","w1819","Hybrid",0,"Thu","weekday","sled","3","3","3",6,0,29,-1,29,20.7,-2,0,7,0,-3,-3,4,4
"5857",2019-01-11,"Snodgrass","w1819","Non.motorized",47,"Fri","weekday","no_sled","2","2","2",6.1,0.1,29,0,25,21,-1,-2,0,7,-1,-3,-3,4
"5858",2019-01-11,"Snodgrass","w1819","Mechanized",0,"Fri","weekday","no_sled","2","2","2",6.1,0.1,29,0,25,21,-1,-2,0,7,-1,-3,-3,4
"5859",2019-01-11,"Snodgrass","w1819","Motorized",1,"Fri","weekday","sled","2","2","2",6.1,0.1,29,0,25,21,-1,-2,0,7,-1,-3,-3,4
"5860",2019-01-11,"Snodgrass","w1819","Hybrid",0,"Fri","weekday","sled","2","2","2",6.1,0.1,29,0,25,21,-1,-2,0,7,-1,-3,-3,4
"5861",2019-01-12,"Snodgrass","w1819","Non.motorized",88,"Sat","weekend","no_sled","3","3","2",6.1,0,28,-1,21,21.8,0,-1,-2,0,-1,-2,-4,-4
"5862",2019-01-12,"Snodgrass","w1819","Mechanized",6,"Sat","weekend","no_sled","3","3","2",6.1,0,28,-1,21,21.8,0,-1,-2,0,-1,-2,-4,-4
"5863",2019-01-12,"Snodgrass","w1819","Motorized",2,"Sat","weekend","sled","3","3","2",6.1,0,28,-1,21,21.8,0,-1,-2,0,-1,-2,-4,-4
"5864",2019-01-12,"Snodgrass","w1819","Hybrid",0,"Sat","weekend","sled","3","3","2",6.1,0,28,-1,21,21.8,0,-1,-2,0,-1,-2,-4,-4
"5865",2019-01-13,"Snodgrass","w1819","Non.motorized",112,"Sun","weekend","no_sled","2","2","2",6.2,0.1,30,2,18,20.7,-1,0,-1,-2,1,1,0,-2
"5866",2019-01-13,"Snodgrass","w1819","Mechanized",2,"Sun","weekend","no_sled","2","2","2",6.2,0.1,30,2,18,20.7,-1,0,-1,-2,1,1,0,-2
"5867",2019-01-13,"Snodgrass","w1819","Motorized",4,"Sun","weekend","sled","2","2","2",6.2,0.1,30,2,18,20.7,-1,0,-1,-2,1,1,0,-2
"5868",2019-01-13,"Snodgrass","w1819","Hybrid",0,"Sun","weekend","sled","2","2","2",6.2,0.1,30,2,18,20.7,-1,0,-1,-2,1,1,0,-2
"5869",2019-01-14,"Snodgrass","w1819","Non.motorized",47,"Mon","weekday","no_sled","2","2","2",6.2,0,30,0,18,20.7,2,-1,0,-1,2,1,1,0
"5870",2019-01-14,"Snodgrass","w1819","Mechanized",0,"Mon","weekday","no_sled","2","2","2",6.2,0,30,0,18,20.7,2,-1,0,-1,2,1,1,0
"5871",2019-01-14,"Snodgrass","w1819","Motorized",1,"Mon","weekday","sled","2","2","2",6.2,0,30,0,18,20.7,2,-1,0,-1,2,1,1,0
"5872",2019-01-14,"Snodgrass","w1819","Hybrid",0,"Mon","weekday","sled","2","2","2",6.2,0,30,0,18,20.7,2,-1,0,-1,2,1,1,0
"5873",2019-01-15,"Snodgrass","w1819","Non.motorized",41,"Tue","weekday","no_sled","2","2","2",6.2,0,29,-1,24,21.4,0,2,-1,0,-1,1,0,0
"5874",2019-01-15,"Snodgrass","w1819","Mechanized",0,"Tue","weekday","no_sled","2","2","2",6.2,0,29,-1,24,21.4,0,2,-1,0,-1,1,0,0
"5875",2019-01-15,"Snodgrass","w1819","Motorized",0,"Tue","weekday","sled","2","2","2",6.2,0,29,-1,24,21.4,0,2,-1,0,-1,1,0,0
"5876",2019-01-15,"Snodgrass","w1819","Hybrid",0,"Tue","weekday","sled","2","2","2",6.2,0,29,-1,24,21.4,0,2,-1,0,-1,1,0,0
"5877",2019-01-16,"Snodgrass","w1819","Non.motorized",22,"Wed","weekday","no_sled","4","4","3",6.3,0.1,29,0,26,21.7,-1,0,2,-1,-1,-1,1,0
"5878",2019-01-16,"Snodgrass","w1819","Mechanized",0,"Wed","weekday","no_sled","4","4","3",6.3,0.1,29,0,26,21.7,-1,0,2,-1,-1,-1,1,0
"5879",2019-01-16,"Snodgrass","w1819","Motorized",0,"Wed","weekday","sled","4","4","3",6.3,0.1,29,0,26,21.7,-1,0,2,-1,-1,-1,1,0
"5880",2019-01-16,"Snodgrass","w1819","Hybrid",0,"Wed","weekday","sled","4","4","3",6.3,0.1,29,0,26,21.7,-1,0,2,-1,-1,-1,1,0
"5881",2019-01-17,"Snodgrass","w1819","Non.motorized",35,"Thu","weekday","no_sled","3","3","2",7,0.7,38,9,28,18.4,0,-1,0,2,9,8,8,10
"5882",2019-01-17,"Snodgrass","w1819","Mechanized",0,"Thu","weekday","no_sled","3","3","2",7,0.7,38,9,28,18.4,0,-1,0,2,9,8,8,10
"5883",2019-01-17,"Snodgrass","w1819","Motorized",0,"Thu","weekday","sled","3","3","2",7,0.7,38,9,28,18.4,0,-1,0,2,9,8,8,10
"5884",2019-01-17,"Snodgrass","w1819","Hybrid",0,"Thu","weekday","sled","3","3","2",7,0.7,38,9,28,18.4,0,-1,0,2,9,8,8,10
"5885",2019-01-18,"Snodgrass","w1819","Non.motorized",4,"Fri","weekday","no_sled","4","4","4",7.5,0.5,41,3,22,18.3,9,0,-1,0,12,12,11,11
"5886",2019-01-18,"Snodgrass","w1819","Mechanized",0,"Fri","weekday","no_sled","4","4","4",7.5,0.5,41,3,22,18.3,9,0,-1,0,12,12,11,11
"5887",2019-01-18,"Snodgrass","w1819","Motorized",0,"Fri","weekday","sled","4","4","4",7.5,0.5,41,3,22,18.3,9,0,-1,0,12,12,11,11
"5888",2019-01-18,"Snodgrass","w1819","Hybrid",0,"Fri","weekday","sled","4","4","4",7.5,0.5,41,3,22,18.3,9,0,-1,0,12,12,11,11
"5889",2019-01-19,"Snodgrass","w1819","Non.motorized",0,"Sat","weekend","no_sled","3","3","3",7.8,0.3,43,2,20,18.1,3,9,0,-1,5,14,14,13
"5890",2019-01-19,"Snodgrass","w1819","Mechanized",0,"Sat","weekend","no_sled","3","3","3",7.8,0.3,43,2,20,18.1,3,9,0,-1,5,14,14,13
"5891",2019-01-19,"Snodgrass","w1819","Motorized",0,"Sat","weekend","sled","3","3","3",7.8,0.3,43,2,20,18.1,3,9,0,-1,5,14,14,13
"5892",2019-01-19,"Snodgrass","w1819","Hybrid",0,"Sat","weekend","sled","3","3","3",7.8,0.3,43,2,20,18.1,3,9,0,-1,5,14,14,13
"5893",2019-01-20,"Snodgrass","w1819","Non.motorized",0,"Sun","weekend","no_sled","3","3","3",7.9,0.1,41,-2,27,19.3,2,3,9,0,0,3,12,12
"5894",2019-01-20,"Snodgrass","w1819","Mechanized",0,"Sun","weekend","no_sled","3","3","3",7.9,0.1,41,-2,27,19.3,2,3,9,0,0,3,12,12
"5895",2019-01-20,"Snodgrass","w1819","Motorized",0,"Sun","weekend","sled","3","3","3",7.9,0.1,41,-2,27,19.3,2,3,9,0,0,3,12,12
"5896",2019-01-20,"Snodgrass","w1819","Hybrid",0,"Sun","weekend","sled","3","3","3",7.9,0.1,41,-2,27,19.3,2,3,9,0,0,3,12,12
"5897",2019-01-21,"Snodgrass","w1819","Non.motorized",NA,"Mon","weekday","no_sled","3","3","3",7.9,0,39,-2,23,20.3,-2,2,3,9,-4,-2,1,10
"5898",2019-01-21,"Snodgrass","w1819","Mechanized",NA,"Mon","weekday","no_sled","3","3","3",7.9,0,39,-2,23,20.3,-2,2,3,9,-4,-2,1,10
"5899",2019-01-21,"Snodgrass","w1819","Motorized",NA,"Mon","weekday","sled","3","3","3",7.9,0,39,-2,23,20.3,-2,2,3,9,-4,-2,1,10
"5900",2019-01-21,"Snodgrass","w1819","Hybrid",NA,"Mon","weekday","sled","3","3","3",7.9,0,39,-2,23,20.3,-2,2,3,9,-4,-2,1,10
"5901",2019-01-22,"Snodgrass","w1819","Non.motorized",47,"Tue","weekday","no_sled","3","3","3",8,0.1,41,2,12,19.5,-2,-2,2,3,0,-2,0,3
"5902",2019-01-22,"Snodgrass","w1819","Mechanized",1,"Tue","weekday","no_sled","3","3","3",8,0.1,41,2,12,19.5,-2,-2,2,3,0,-2,0,3
"5903",2019-01-22,"Snodgrass","w1819","Motorized",2,"Tue","weekday","sled","3","3","3",8,0.1,41,2,12,19.5,-2,-2,2,3,0,-2,0,3
"5904",2019-01-22,"Snodgrass","w1819","Hybrid",0,"Tue","weekday","sled","3","3","3",8,0.1,41,2,12,19.5,-2,-2,2,3,0,-2,0,3
"5905",2019-01-23,"Snodgrass","w1819","Non.motorized",42,"Wed","weekday","no_sled","3","3","2",8,0,40,-1,14,20,2,-2,-2,2,1,-1,-3,-1
"5906",2019-01-23,"Snodgrass","w1819","Mechanized",1,"Wed","weekday","no_sled","3","3","2",8,0,40,-1,14,20,2,-2,-2,2,1,-1,-3,-1
"5907",2019-01-23,"Snodgrass","w1819","Motorized",0,"Wed","weekday","sled","3","3","2",8,0,40,-1,14,20,2,-2,-2,2,1,-1,-3,-1
"5908",2019-01-23,"Snodgrass","w1819","Hybrid",0,"Wed","weekday","sled","3","3","2",8,0,40,-1,14,20,2,-2,-2,2,1,-1,-3,-1
"5909",2019-01-24,"Snodgrass","w1819","Non.motorized",19,"Thu","weekday","no_sled","3","3","2",8.2,0.2,40,0,17,20.5,-1,2,-2,-2,-1,1,-1,-3
"5910",2019-01-24,"Snodgrass","w1819","Mechanized",0,"Thu","weekday","no_sled","3","3","2",8.2,0.2,40,0,17,20.5,-1,2,-2,-2,-1,1,-1,-3
"5911",2019-01-24,"Snodgrass","w1819","Motorized",1,"Thu","weekday","sled","3","3","2",8.2,0.2,40,0,17,20.5,-1,2,-2,-2,-1,1,-1,-3
"5912",2019-01-24,"Snodgrass","w1819","Hybrid",0,"Thu","weekday","sled","3","3","2",8.2,0.2,40,0,17,20.5,-1,2,-2,-2,-1,1,-1,-3
"5913",2019-01-25,"Snodgrass","w1819","Non.motorized",71,"Fri","weekday","no_sled","3","3","2",8.3,0.1,40,0,15,20.8,0,-1,2,-2,0,-1,1,-1
"5914",2019-01-25,"Snodgrass","w1819","Mechanized",4,"Fri","weekday","no_sled","3","3","2",8.3,0.1,40,0,15,20.8,0,-1,2,-2,0,-1,1,-1
"5915",2019-01-25,"Snodgrass","w1819","Motorized",9,"Fri","weekday","sled","3","3","2",8.3,0.1,40,0,15,20.8,0,-1,2,-2,0,-1,1,-1
"5916",2019-01-25,"Snodgrass","w1819","Hybrid",0,"Fri","weekday","sled","3","3","2",8.3,0.1,40,0,15,20.8,0,-1,2,-2,0,-1,1,-1
"5917",2019-01-26,"Snodgrass","w1819","Non.motorized",102,"Sat","weekend","no_sled","3","3","2",8.3,0,39,-1,19,21.3,0,0,-1,2,-1,-1,-2,0
"5918",2019-01-26,"Snodgrass","w1819","Mechanized",7,"Sat","weekend","no_sled","3","3","2",8.3,0,39,-1,19,21.3,0,0,-1,2,-1,-1,-2,0
"5919",2019-01-26,"Snodgrass","w1819","Motorized",3,"Sat","weekend","sled","3","3","2",8.3,0,39,-1,19,21.3,0,0,-1,2,-1,-1,-2,0
"5920",2019-01-26,"Snodgrass","w1819","Hybrid",0,"Sat","weekend","sled","3","3","2",8.3,0,39,-1,19,21.3,0,0,-1,2,-1,-1,-2,0
"5921",2019-01-27,"Snodgrass","w1819","Non.motorized",85,"Sun","weekend","no_sled","3","3","2",8.3,0,38,-1,24,21.8,-1,0,0,-1,-2,-2,-2,-3
"5922",2019-01-27,"Snodgrass","w1819","Mechanized",2,"Sun","weekend","no_sled","3","3","2",8.3,0,38,-1,24,21.8,-1,0,0,-1,-2,-2,-2,-3
"5923",2019-01-27,"Snodgrass","w1819","Motorized",0,"Sun","weekend","sled","3","3","2",8.3,0,38,-1,24,21.8,-1,0,0,-1,-2,-2,-2,-3
"5924",2019-01-27,"Snodgrass","w1819","Hybrid",0,"Sun","weekend","sled","3","3","2",8.3,0,38,-1,24,21.8,-1,0,0,-1,-2,-2,-2,-3
"5925",2019-01-28,"Snodgrass","w1819","Non.motorized",13,"Mon","weekday","no_sled","2","2","2",8.3,0,38,0,17,21.8,-1,-1,0,0,-1,-2,-2,-2
"5926",2019-01-28,"Snodgrass","w1819","Mechanized",0,"Mon","weekday","no_sled","2","2","2",8.3,0,38,0,17,21.8,-1,-1,0,0,-1,-2,-2,-2
"5927",2019-01-28,"Snodgrass","w1819","Motorized",0,"Mon","weekday","sled","2","2","2",8.3,0,38,0,17,21.8,-1,-1,0,0,-1,-2,-2,-2
"5928",2019-01-28,"Snodgrass","w1819","Hybrid",0,"Mon","weekday","sled","2","2","2",8.3,0,38,0,17,21.8,-1,-1,0,0,-1,-2,-2,-2
"5929",2019-01-29,"Snodgrass","w1819","Non.motorized",39,"Tue","weekday","no_sled","2","2","2",8.3,0,38,0,16,21.8,0,-1,-1,0,0,-1,-2,-2
"5930",2019-01-29,"Snodgrass","w1819","Mechanized",1,"Tue","weekday","no_sled","2","2","2",8.3,0,38,0,16,21.8,0,-1,-1,0,0,-1,-2,-2
"5931",2019-01-29,"Snodgrass","w1819","Motorized",0,"Tue","weekday","sled","2","2","2",8.3,0,38,0,16,21.8,0,-1,-1,0,0,-1,-2,-2
"5932",2019-01-29,"Snodgrass","w1819","Hybrid",0,"Tue","weekday","sled","2","2","2",8.3,0,38,0,16,21.8,0,-1,-1,0,0,-1,-2,-2
"5933",2019-01-30,"Snodgrass","w1819","Non.motorized",41,"Wed","weekday","no_sled","2","2","1",8.3,0,37,-1,20,22.4,0,0,-1,-1,-1,-1,-2,-3
"5934",2019-01-30,"Snodgrass","w1819","Mechanized",0,"Wed","weekday","no_sled","2","2","1",8.3,0,37,-1,20,22.4,0,0,-1,-1,-1,-1,-2,-3
"5935",2019-01-30,"Snodgrass","w1819","Motorized",2,"Wed","weekday","sled","2","2","1",8.3,0,37,-1,20,22.4,0,0,-1,-1,-1,-1,-2,-3
"5936",2019-01-30,"Snodgrass","w1819","Hybrid",0,"Wed","weekday","sled","2","2","1",8.3,0,37,-1,20,22.4,0,0,-1,-1,-1,-1,-2,-3
"5937",2019-01-31,"Snodgrass","w1819","Non.motorized",49,"Thu","weekday","no_sled","2","2","1",8.3,0,36,-1,24,23.1,-1,0,0,-1,-2,-2,-2,-3
"5938",2019-01-31,"Snodgrass","w1819","Mechanized",1,"Thu","weekday","no_sled","2","2","1",8.3,0,36,-1,24,23.1,-1,0,0,-1,-2,-2,-2,-3
"5939",2019-01-31,"Snodgrass","w1819","Motorized",0,"Thu","weekday","sled","2","2","1",8.3,0,36,-1,24,23.1,-1,0,0,-1,-2,-2,-2,-3
"5940",2019-01-31,"Snodgrass","w1819","Hybrid",0,"Thu","weekday","sled","2","2","1",8.3,0,36,-1,24,23.1,-1,0,0,-1,-2,-2,-2,-3
"5941",2019-02-01,"Snodgrass","w1819","Non.motorized",67,"Fri","weekday","no_sled","2","2","1",8.3,0,36,0,25,23.1,-1,-1,0,0,-1,-2,-2,-2
"5942",2019-02-01,"Snodgrass","w1819","Mechanized",0,"Fri","weekday","no_sled","2","2","1",8.3,0,36,0,25,23.1,-1,-1,0,0,-1,-2,-2,-2
"5943",2019-02-01,"Snodgrass","w1819","Motorized",0,"Fri","weekday","sled","2","2","1",8.3,0,36,0,25,23.1,-1,-1,0,0,-1,-2,-2,-2
"5944",2019-02-01,"Snodgrass","w1819","Hybrid",0,"Fri","weekday","sled","2","2","1",8.3,0,36,0,25,23.1,-1,-1,0,0,-1,-2,-2,-2
"5945",2019-02-02,"Snodgrass","w1819","Non.motorized",141,"Sat","weekend","no_sled","2","2","1",8.3,0,36,0,26,23.1,0,-1,-1,0,0,-1,-2,-2
"5946",2019-02-02,"Snodgrass","w1819","Mechanized",4,"Sat","weekend","no_sled","2","2","1",8.3,0,36,0,26,23.1,0,-1,-1,0,0,-1,-2,-2
"5947",2019-02-02,"Snodgrass","w1819","Motorized",1,"Sat","weekend","sled","2","2","1",8.3,0,36,0,26,23.1,0,-1,-1,0,0,-1,-2,-2
"5948",2019-02-02,"Snodgrass","w1819","Hybrid",0,"Sat","weekend","sled","2","2","1",8.3,0,36,0,26,23.1,0,-1,-1,0,0,-1,-2,-2
"5949",2019-02-03,"Snodgrass","w1819","Non.motorized",56,"Sun","weekend","no_sled","3","3","2",8.4,0.1,36,0,28,23.3,0,0,-1,-1,0,0,-1,-2
"5950",2019-02-03,"Snodgrass","w1819","Mechanized",0,"Sun","weekend","no_sled","3","3","2",8.4,0.1,36,0,28,23.3,0,0,-1,-1,0,0,-1,-2
"5951",2019-02-03,"Snodgrass","w1819","Motorized",0,"Sun","weekend","sled","3","3","2",8.4,0.1,36,0,28,23.3,0,0,-1,-1,0,0,-1,-2
"5952",2019-02-03,"Snodgrass","w1819","Hybrid",0,"Sun","weekend","sled","3","3","2",8.4,0.1,36,0,28,23.3,0,0,-1,-1,0,0,-1,-2
"5953",2019-02-04,"Snodgrass","w1819","Non.motorized",51,"Mon","weekday","no_sled","3","3","2",8.8,0.4,39,3,28,22.6,0,0,0,-1,3,3,3,2
"5954",2019-02-04,"Snodgrass","w1819","Mechanized",0,"Mon","weekday","no_sled","3","3","2",8.8,0.4,39,3,28,22.6,0,0,0,-1,3,3,3,2
"5955",2019-02-04,"Snodgrass","w1819","Motorized",0,"Mon","weekday","sled","3","3","2",8.8,0.4,39,3,28,22.6,0,0,0,-1,3,3,3,2
"5956",2019-02-04,"Snodgrass","w1819","Hybrid",0,"Mon","weekday","sled","3","3","2",8.8,0.4,39,3,28,22.6,0,0,0,-1,3,3,3,2
"5957",2019-02-05,"Snodgrass","w1819","Non.motorized",48,"Tue","weekday","no_sled","3","2","2",9,0.2,40,1,26,22.5,3,0,0,0,4,4,4,4
"5958",2019-02-05,"Snodgrass","w1819","Mechanized",0,"Tue","weekday","no_sled","3","2","2",9,0.2,40,1,26,22.5,3,0,0,0,4,4,4,4
"5959",2019-02-05,"Snodgrass","w1819","Motorized",0,"Tue","weekday","sled","3","2","2",9,0.2,40,1,26,22.5,3,0,0,0,4,4,4,4
"5960",2019-02-05,"Snodgrass","w1819","Hybrid",0,"Tue","weekday","sled","3","2","2",9,0.2,40,1,26,22.5,3,0,0,0,4,4,4,4
"5961",2019-02-06,"Snodgrass","w1819","Non.motorized",18,"Wed","weekday","no_sled","4","4","3",9,0,40,0,16,22.5,1,3,0,0,1,4,4,4
"5962",2019-02-06,"Snodgrass","w1819","Mechanized",0,"Wed","weekday","no_sled","4","4","3",9,0,40,0,16,22.5,1,3,0,0,1,4,4,4
"5963",2019-02-06,"Snodgrass","w1819","Motorized",0,"Wed","weekday","sled","4","4","3",9,0,40,0,16,22.5,1,3,0,0,1,4,4,4
"5964",2019-02-06,"Snodgrass","w1819","Hybrid",0,"Wed","weekday","sled","4","4","3",9,0,40,0,16,22.5,1,3,0,0,1,4,4,4
"5965",2019-02-07,"Snodgrass","w1819","Non.motorized",32,"Thu","weekday","no_sled","3","3","2",9.2,0.2,43,3,4,21.4,0,1,3,0,3,4,7,7
"5966",2019-02-07,"Snodgrass","w1819","Mechanized",0,"Thu","weekday","no_sled","3","3","2",9.2,0.2,43,3,4,21.4,0,1,3,0,3,4,7,7
"5967",2019-02-07,"Snodgrass","w1819","Motorized",0,"Thu","weekday","sled","3","3","2",9.2,0.2,43,3,4,21.4,0,1,3,0,3,4,7,7
"5968",2019-02-07,"Snodgrass","w1819","Hybrid",0,"Thu","weekday","sled","3","3","2",9.2,0.2,43,3,4,21.4,0,1,3,0,3,4,7,7
"5969",2019-02-08,"Snodgrass","w1819","Non.motorized",59,"Fri","weekday","no_sled","3","2","2",9.2,0,42,-1,10,21.9,3,0,1,3,2,2,3,6
"5970",2019-02-08,"Snodgrass","w1819","Mechanized",0,"Fri","weekday","no_sled","3","2","2",9.2,0,42,-1,10,21.9,3,0,1,3,2,2,3,6
"5971",2019-02-08,"Snodgrass","w1819","Motorized",0,"Fri","weekday","sled","3","2","2",9.2,0,42,-1,10,21.9,3,0,1,3,2,2,3,6
"5972",2019-02-08,"Snodgrass","w1819","Hybrid",0,"Fri","weekday","sled","3","2","2",9.2,0,42,-1,10,21.9,3,0,1,3,2,2,3,6
"5973",2019-02-09,"Snodgrass","w1819","Non.motorized",108,"Sat","weekend","no_sled","3","2","2",9.2,0,41,-1,20,22.4,-1,3,0,1,-2,1,1,2
"5974",2019-02-09,"Snodgrass","w1819","Mechanized",3,"Sat","weekend","no_sled","3","2","2",9.2,0,41,-1,20,22.4,-1,3,0,1,-2,1,1,2
"5975",2019-02-09,"Snodgrass","w1819","Motorized",0,"Sat","weekend","sled","3","2","2",9.2,0,41,-1,20,22.4,-1,3,0,1,-2,1,1,2
"5976",2019-02-09,"Snodgrass","w1819","Hybrid",0,"Sat","weekend","sled","3","2","2",9.2,0,41,-1,20,22.4,-1,3,0,1,-2,1,1,2
"5977",2019-02-10,"Snodgrass","w1819","Non.motorized",99,"Sun","weekend","no_sled","2","2","2",9.3,0.1,40,-1,20,23.2,-1,-1,3,0,-2,-3,0,0
"5978",2019-02-10,"Snodgrass","w1819","Mechanized",2,"Sun","weekend","no_sled","2","2","2",9.3,0.1,40,-1,20,23.2,-1,-1,3,0,-2,-3,0,0
"5979",2019-02-10,"Snodgrass","w1819","Motorized",0,"Sun","weekend","sled","2","2","2",9.3,0.1,40,-1,20,23.2,-1,-1,3,0,-2,-3,0,0
"5980",2019-02-10,"Snodgrass","w1819","Hybrid",0,"Sun","weekend","sled","2","2","2",9.3,0.1,40,-1,20,23.2,-1,-1,3,0,-2,-3,0,0
"5981",2019-02-11,"Snodgrass","w1819","Non.motorized",31,"Mon","weekday","no_sled","2","2","1",9.3,0,40,0,15,23.2,-1,-1,-1,3,-1,-2,-3,0
"5982",2019-02-11,"Snodgrass","w1819","Mechanized",1,"Mon","weekday","no_sled","2","2","1",9.3,0,40,0,15,23.2,-1,-1,-1,3,-1,-2,-3,0
"5983",2019-02-11,"Snodgrass","w1819","Motorized",0,"Mon","weekday","sled","2","2","1",9.3,0,40,0,15,23.2,-1,-1,-1,3,-1,-2,-3,0
"5984",2019-02-11,"Snodgrass","w1819","Hybrid",0,"Mon","weekday","sled","2","2","1",9.3,0,40,0,15,23.2,-1,-1,-1,3,-1,-2,-3,0
"5985",2019-02-12,"Snodgrass","w1819","Non.motorized",54,"Tue","weekday","no_sled","2","2","1",9.3,0,40,0,18,23.2,0,-1,-1,-1,0,-1,-2,-3
"5986",2019-02-12,"Snodgrass","w1819","Mechanized",2,"Tue","weekday","no_sled","2","2","1",9.3,0,40,0,18,23.2,0,-1,-1,-1,0,-1,-2,-3
"5987",2019-02-12,"Snodgrass","w1819","Motorized",0,"Tue","weekday","sled","2","2","1",9.3,0,40,0,18,23.2,0,-1,-1,-1,0,-1,-2,-3
"5988",2019-02-12,"Snodgrass","w1819","Hybrid",0,"Tue","weekday","sled","2","2","1",9.3,0,40,0,18,23.2,0,-1,-1,-1,0,-1,-2,-3
"5989",2019-02-13,"Snodgrass","w1819","Non.motorized",36,"Wed","weekday","no_sled","2","2","1",9.4,0.1,40,0,26,23.5,0,0,-1,-1,0,0,-1,-2
"5990",2019-02-13,"Snodgrass","w1819","Mechanized",4,"Wed","weekday","no_sled","2","2","1",9.4,0.1,40,0,26,23.5,0,0,-1,-1,0,0,-1,-2
"5991",2019-02-13,"Snodgrass","w1819","Motorized",0,"Wed","weekday","sled","2","2","1",9.4,0.1,40,0,26,23.5,0,0,-1,-1,0,0,-1,-2
"5992",2019-02-13,"Snodgrass","w1819","Hybrid",0,"Wed","weekday","sled","2","2","1",9.4,0.1,40,0,26,23.5,0,0,-1,-1,0,0,-1,-2
"5993",2019-02-14,"Snodgrass","w1819","Non.motorized",15,"Thu","weekday","no_sled","3","2","2",9.7,0.3,41,1,29,23.7,0,0,0,-1,1,1,1,0
"5994",2019-02-14,"Snodgrass","w1819","Mechanized",4,"Thu","weekday","no_sled","3","2","2",9.7,0.3,41,1,29,23.7,0,0,0,-1,1,1,1,0
"5995",2019-02-14,"Snodgrass","w1819","Motorized",0,"Thu","weekday","sled","3","2","2",9.7,0.3,41,1,29,23.7,0,0,0,-1,1,1,1,0
"5996",2019-02-14,"Snodgrass","w1819","Hybrid",0,"Thu","weekday","sled","3","2","2",9.7,0.3,41,1,29,23.7,0,0,0,-1,1,1,1,0
"5997",2019-02-15,"Snodgrass","w1819","Non.motorized",49,"Fri","weekday","no_sled","4","4","3",10.8,1.1,51,10,27,21.2,1,0,0,0,11,11,11,11
"5998",2019-02-15,"Snodgrass","w1819","Mechanized",0,"Fri","weekday","no_sled","4","4","3",10.8,1.1,51,10,27,21.2,1,0,0,0,11,11,11,11
"5999",2019-02-15,"Snodgrass","w1819","Motorized",1,"Fri","weekday","sled","4","4","3",10.8,1.1,51,10,27,21.2,1,0,0,0,11,11,11,11
"6000",2019-02-15,"Snodgrass","w1819","Hybrid",0,"Fri","weekday","sled","4","4","3",10.8,1.1,51,10,27,21.2,1,0,0,0,11,11,11,11
"6001",2019-02-16,"Snodgrass","w1819","Non.motorized",0,"Sat","weekend","no_sled","3","3","3",11.1,0.3,52,1,14,21.3,10,1,0,0,11,12,12,12
"6002",2019-02-16,"Snodgrass","w1819","Mechanized",0,"Sat","weekend","no_sled","3","3","3",11.1,0.3,52,1,14,21.3,10,1,0,0,11,12,12,12
"6003",2019-02-16,"Snodgrass","w1819","Motorized",0,"Sat","weekend","sled","3","3","3",11.1,0.3,52,1,14,21.3,10,1,0,0,11,12,12,12
"6004",2019-02-16,"Snodgrass","w1819","Hybrid",0,"Sat","weekend","sled","3","3","3",11.1,0.3,52,1,14,21.3,10,1,0,0,11,12,12,12
"6005",2019-02-17,"Snodgrass","w1819","Non.motorized",0,"Sun","weekend","no_sled","3","3","3",11.3,0.2,55,3,10,20.5,1,10,1,0,4,14,15,15
"6006",2019-02-17,"Snodgrass","w1819","Mechanized",0,"Sun","weekend","no_sled","3","3","3",11.3,0.2,55,3,10,20.5,1,10,1,0,4,14,15,15
"6007",2019-02-17,"Snodgrass","w1819","Motorized",0,"Sun","weekend","sled","3","3","3",11.3,0.2,55,3,10,20.5,1,10,1,0,4,14,15,15
"6008",2019-02-17,"Snodgrass","w1819","Hybrid",0,"Sun","weekend","sled","3","3","3",11.3,0.2,55,3,10,20.5,1,10,1,0,4,14,15,15
"6009",2019-02-18,"Snodgrass","w1819","Non.motorized",0,"Mon","weekday","no_sled","3","3","2",11.4,0.1,53,-2,13,21.5,3,1,10,1,1,2,12,13
"6010",2019-02-18,"Snodgrass","w1819","Mechanized",0,"Mon","weekday","no_sled","3","3","2",11.4,0.1,53,-2,13,21.5,3,1,10,1,1,2,12,13
"6011",2019-02-18,"Snodgrass","w1819","Motorized",0,"Mon","weekday","sled","3","3","2",11.4,0.1,53,-2,13,21.5,3,1,10,1,1,2,12,13
"6012",2019-02-18,"Snodgrass","w1819","Hybrid",0,"Mon","weekday","sled","3","3","2",11.4,0.1,53,-2,13,21.5,3,1,10,1,1,2,12,13
"6013",2019-02-19,"Snodgrass","w1819","Non.motorized",0,"Tue","weekday","no_sled","3","3","2",11.5,0.1,53,0,11,21.7,-2,3,1,10,-2,1,2,12
"6014",2019-02-19,"Snodgrass","w1819","Mechanized",0,"Tue","weekday","no_sled","3","3","2",11.5,0.1,53,0,11,21.7,-2,3,1,10,-2,1,2,12
"6015",2019-02-19,"Snodgrass","w1819","Motorized",0,"Tue","weekday","sled","3","3","2",11.5,0.1,53,0,11,21.7,-2,3,1,10,-2,1,2,12
"6016",2019-02-19,"Snodgrass","w1819","Hybrid",0,"Tue","weekday","sled","3","3","2",11.5,0.1,53,0,11,21.7,-2,3,1,10,-2,1,2,12
"6017",2019-02-20,"Snodgrass","w1819","Non.motorized",0,"Wed","weekday","no_sled","3","3","2",11.6,0.1,53,0,7,21.9,0,-2,3,1,0,-2,1,2
"6018",2019-02-20,"Snodgrass","w1819","Mechanized",0,"Wed","weekday","no_sled","3","3","2",11.6,0.1,53,0,7,21.9,0,-2,3,1,0,-2,1,2
"6019",2019-02-20,"Snodgrass","w1819","Motorized",0,"Wed","weekday","sled","3","3","2",11.6,0.1,53,0,7,21.9,0,-2,3,1,0,-2,1,2
"6020",2019-02-20,"Snodgrass","w1819","Hybrid",0,"Wed","weekday","sled","3","3","2",11.6,0.1,53,0,7,21.9,0,-2,3,1,0,-2,1,2
"6021",2019-02-21,"Snodgrass","w1819","Non.motorized",0,"Thu","weekday","no_sled","3","3","3",11.6,0,52,-1,15,22.3,0,0,-2,3,-1,-1,-3,0
"6022",2019-02-21,"Snodgrass","w1819","Mechanized",0,"Thu","weekday","no_sled","3","3","3",11.6,0,52,-1,15,22.3,0,0,-2,3,-1,-1,-3,0
"6023",2019-02-21,"Snodgrass","w1819","Motorized",0,"Thu","weekday","sled","3","3","3",11.6,0,52,-1,15,22.3,0,0,-2,3,-1,-1,-3,0
"6024",2019-02-21,"Snodgrass","w1819","Hybrid",0,"Thu","weekday","sled","3","3","3",11.6,0,52,-1,15,22.3,0,0,-2,3,-1,-1,-3,0
"6025",2019-02-22,"Snodgrass","w1819","Non.motorized",21,"Fri","weekday","no_sled","3","3","3",11.8,0.2,52,0,20,22.7,-1,0,0,-2,-1,-1,-1,-3
"6026",2019-02-22,"Snodgrass","w1819","Mechanized",0,"Fri","weekday","no_sled","3","3","3",11.8,0.2,52,0,20,22.7,-1,0,0,-2,-1,-1,-1,-3
"6027",2019-02-22,"Snodgrass","w1819","Motorized",0,"Fri","weekday","sled","3","3","3",11.8,0.2,52,0,20,22.7,-1,0,0,-2,-1,-1,-1,-3
"6028",2019-02-22,"Snodgrass","w1819","Hybrid",0,"Fri","weekday","sled","3","3","3",11.8,0.2,52,0,20,22.7,-1,0,0,-2,-1,-1,-1,-3
"6029",2019-02-23,"Snodgrass","w1819","Non.motorized",218,"Sat","weekend","no_sled","3","3","3",12.1,0.3,53,1,13,22.8,0,-1,0,0,1,0,0,0
"6030",2019-02-23,"Snodgrass","w1819","Mechanized",0,"Sat","weekend","no_sled","3","3","3",12.1,0.3,53,1,13,22.8,0,-1,0,0,1,0,0,0
"6031",2019-02-23,"Snodgrass","w1819","Motorized",6,"Sat","weekend","sled","3","3","3",12.1,0.3,53,1,13,22.8,0,-1,0,0,1,0,0,0
"6032",2019-02-23,"Snodgrass","w1819","Hybrid",0,"Sat","weekend","sled","3","3","3",12.1,0.3,53,1,13,22.8,0,-1,0,0,1,0,0,0
"6033",2019-02-24,"Snodgrass","w1819","Non.motorized",92,"Sun","weekend","no_sled","3","3","2",12.1,0,52,-1,14,23.3,1,0,-1,0,0,0,-1,-1
"6034",2019-02-24,"Snodgrass","w1819","Mechanized",0,"Sun","weekend","no_sled","3","3","2",12.1,0,52,-1,14,23.3,1,0,-1,0,0,0,-1,-1
"6035",2019-02-24,"Snodgrass","w1819","Motorized",0,"Sun","weekend","sled","3","3","2",12.1,0,52,-1,14,23.3,1,0,-1,0,0,0,-1,-1
"6036",2019-02-24,"Snodgrass","w1819","Hybrid",0,"Sun","weekend","sled","3","3","2",12.1,0,52,-1,14,23.3,1,0,-1,0,0,0,-1,-1
"6037",2019-02-25,"Snodgrass","w1819","Non.motorized",45,"Mon","weekday","no_sled","3","3","2",12.1,0,51,-1,22,23.7,-1,1,0,-1,-2,-1,-1,-2
"6038",2019-02-25,"Snodgrass","w1819","Mechanized",0,"Mon","weekday","no_sled","3","3","2",12.1,0,51,-1,22,23.7,-1,1,0,-1,-2,-1,-1,-2
"6039",2019-02-25,"Snodgrass","w1819","Motorized",0,"Mon","weekday","sled","3","3","2",12.1,0,51,-1,22,23.7,-1,1,0,-1,-2,-1,-1,-2
"6040",2019-02-25,"Snodgrass","w1819","Hybrid",0,"Mon","weekday","sled","3","3","2",12.1,0,51,-1,22,23.7,-1,1,0,-1,-2,-1,-1,-2
"6041",2019-02-26,"Snodgrass","w1819","Non.motorized",54,"Tue","weekday","no_sled","2","2","2",12.1,0,50,-1,27,24.2,-1,-1,1,0,-2,-3,-2,-2
"6042",2019-02-26,"Snodgrass","w1819","Mechanized",2,"Tue","weekday","no_sled","2","2","2",12.1,0,50,-1,27,24.2,-1,-1,1,0,-2,-3,-2,-2
"6043",2019-02-26,"Snodgrass","w1819","Motorized",0,"Tue","weekday","sled","2","2","2",12.1,0,50,-1,27,24.2,-1,-1,1,0,-2,-3,-2,-2
"6044",2019-02-26,"Snodgrass","w1819","Hybrid",0,"Tue","weekday","sled","2","2","2",12.1,0,50,-1,27,24.2,-1,-1,1,0,-2,-3,-2,-2
"6045",2019-02-27,"Snodgrass","w1819","Non.motorized",43,"Wed","weekday","no_sled","2","2","2",12.1,0,50,0,30,24.2,-1,-1,-1,1,-1,-2,-3,-2
"6046",2019-02-27,"Snodgrass","w1819","Mechanized",9,"Wed","weekday","no_sled","2","2","2",12.1,0,50,0,30,24.2,-1,-1,-1,1,-1,-2,-3,-2
"6047",2019-02-27,"Snodgrass","w1819","Motorized",0,"Wed","weekday","sled","2","2","2",12.1,0,50,0,30,24.2,-1,-1,-1,1,-1,-2,-3,-2
"6048",2019-02-27,"Snodgrass","w1819","Hybrid",0,"Wed","weekday","sled","2","2","2",12.1,0,50,0,30,24.2,-1,-1,-1,1,-1,-2,-3,-2
"6049",2019-02-28,"Snodgrass","w1819","Non.motorized",84,"Thu","weekday","no_sled","2","2","2",12.2,0.1,49,-1,30,24.9,0,-1,-1,-1,-1,-2,-3,-4
"6050",2019-02-28,"Snodgrass","w1819","Mechanized",0,"Thu","weekday","no_sled","2","2","2",12.2,0.1,49,-1,30,24.9,0,-1,-1,-1,-1,-2,-3,-4
"6051",2019-02-28,"Snodgrass","w1819","Motorized",0,"Thu","weekday","sled","2","2","2",12.2,0.1,49,-1,30,24.9,0,-1,-1,-1,-1,-2,-3,-4
"6052",2019-02-28,"Snodgrass","w1819","Hybrid",0,"Thu","weekday","sled","2","2","2",12.2,0.1,49,-1,30,24.9,0,-1,-1,-1,-1,-2,-3,-4
"6053",2019-03-01,"Snodgrass","w1819","Non.motorized",22,"Fri","weekday","no_sled","2","2","1",12.3,0.1,49,0,29,25.1,-1,0,-1,-1,-1,-1,-2,-3
"6054",2019-03-01,"Snodgrass","w1819","Mechanized",0,"Fri","weekday","no_sled","2","2","1",12.3,0.1,49,0,29,25.1,-1,0,-1,-1,-1,-1,-2,-3
"6055",2019-03-01,"Snodgrass","w1819","Motorized",0,"Fri","weekday","sled","2","2","1",12.3,0.1,49,0,29,25.1,-1,0,-1,-1,-1,-1,-2,-3
"6056",2019-03-01,"Snodgrass","w1819","Hybrid",0,"Fri","weekday","sled","2","2","1",12.3,0.1,49,0,29,25.1,-1,0,-1,-1,-1,-1,-2,-3
"6057",2019-03-02,"Snodgrass","w1819","Non.motorized",64,"Sat","weekend","no_sled","3","3","2",13,0.7,58,9,30,22.4,0,-1,0,-1,9,8,8,7
"6058",2019-03-02,"Snodgrass","w1819","Mechanized",0,"Sat","weekend","no_sled","3","3","2",13,0.7,58,9,30,22.4,0,-1,0,-1,9,8,8,7
"6059",2019-03-02,"Snodgrass","w1819","Motorized",0,"Sat","weekend","sled","3","3","2",13,0.7,58,9,30,22.4,0,-1,0,-1,9,8,8,7
"6060",2019-03-02,"Snodgrass","w1819","Hybrid",0,"Sat","weekend","sled","3","3","2",13,0.7,58,9,30,22.4,0,-1,0,-1,9,8,8,7
"6061",2019-03-03,"Snodgrass","w1819","Non.motorized",8,"Sun","weekend","no_sled","3","3","3",13.7,0.7,64,6,27,21.4,9,0,-1,0,15,15,14,14
"6062",2019-03-03,"Snodgrass","w1819","Mechanized",0,"Sun","weekend","no_sled","3","3","3",13.7,0.7,64,6,27,21.4,9,0,-1,0,15,15,14,14
"6063",2019-03-03,"Snodgrass","w1819","Motorized",0,"Sun","weekend","sled","3","3","3",13.7,0.7,64,6,27,21.4,9,0,-1,0,15,15,14,14
"6064",2019-03-03,"Snodgrass","w1819","Hybrid",0,"Sun","weekend","sled","3","3","3",13.7,0.7,64,6,27,21.4,9,0,-1,0,15,15,14,14
"6065",2019-03-04,"Snodgrass","w1819","Non.motorized",10,"Mon","weekday","no_sled","3","3","3",14.4,0.7,66,2,23,21.8,6,9,0,-1,8,17,17,16
"6066",2019-03-04,"Snodgrass","w1819","Mechanized",0,"Mon","weekday","no_sled","3","3","3",14.4,0.7,66,2,23,21.8,6,9,0,-1,8,17,17,16
"6067",2019-03-04,"Snodgrass","w1819","Motorized",0,"Mon","weekday","sled","3","3","3",14.4,0.7,66,2,23,21.8,6,9,0,-1,8,17,17,16
"6068",2019-03-04,"Snodgrass","w1819","Hybrid",0,"Mon","weekday","sled","3","3","3",14.4,0.7,66,2,23,21.8,6,9,0,-1,8,17,17,16
"6069",2019-03-05,"Snodgrass","w1819","Non.motorized",42,"Tue","weekday","no_sled","3","3","3",14.4,0,64,-2,24,22.5,2,6,9,0,0,6,15,15
"6070",2019-03-05,"Snodgrass","w1819","Mechanized",0,"Tue","weekday","no_sled","3","3","3",14.4,0,64,-2,24,22.5,2,6,9,0,0,6,15,15
"6071",2019-03-05,"Snodgrass","w1819","Motorized",0,"Tue","weekday","sled","3","3","3",14.4,0,64,-2,24,22.5,2,6,9,0,0,6,15,15
"6072",2019-03-05,"Snodgrass","w1819","Hybrid",0,"Tue","weekday","sled","3","3","3",14.4,0,64,-2,24,22.5,2,6,9,0,0,6,15,15
"6073",2019-03-06,"Snodgrass","w1819","Non.motorized",6,"Wed","weekday","no_sled","3","3","2",14.5,0.1,62,-2,31,23.4,-2,2,6,9,-4,-2,4,13
"6074",2019-03-06,"Snodgrass","w1819","Non.motorized",6,"Wed","weekday","no_sled","4","4","3",14.5,0.1,62,-2,31,23.4,-2,2,6,9,-4,-2,4,13
"6075",2019-03-06,"Snodgrass","w1819","Mechanized",0,"Wed","weekday","no_sled","3","3","2",14.5,0.1,62,-2,31,23.4,-2,2,6,9,-4,-2,4,13
"6076",2019-03-06,"Snodgrass","w1819","Mechanized",0,"Wed","weekday","no_sled","4","4","3",14.5,0.1,62,-2,31,23.4,-2,2,6,9,-4,-2,4,13
"6077",2019-03-06,"Snodgrass","w1819","Motorized",0,"Wed","weekday","sled","3","3","2",14.5,0.1,62,-2,31,23.4,-2,2,6,9,-4,-2,4,13
"6078",2019-03-06,"Snodgrass","w1819","Motorized",0,"Wed","weekday","sled","4","4","3",14.5,0.1,62,-2,31,23.4,-2,2,6,9,-4,-2,4,13
"6079",2019-03-06,"Snodgrass","w1819","Hybrid",0,"Wed","weekday","sled","3","3","2",14.5,0.1,62,-2,31,23.4,-2,2,6,9,-4,-2,4,13
"6080",2019-03-06,"Snodgrass","w1819","Hybrid",0,"Wed","weekday","sled","4","4","3",14.5,0.1,62,-2,31,23.4,-2,2,6,9,-4,-2,4,13
"6081",2019-03-07,"Snodgrass","w1819","Non.motorized",3,"Thu","weekday","no_sled","4","4","3",16.2,1.7,71,9,30,22.8,-2,-2,2,6,7,5,7,13
"6082",2019-03-07,"Snodgrass","w1819","Mechanized",0,"Thu","weekday","no_sled","4","4","3",16.2,1.7,71,9,30,22.8,-2,-2,2,6,7,5,7,13
"6083",2019-03-07,"Snodgrass","w1819","Motorized",0,"Thu","weekday","sled","4","4","3",16.2,1.7,71,9,30,22.8,-2,-2,2,6,7,5,7,13
"6084",2019-03-07,"Snodgrass","w1819","Hybrid",0,"Thu","weekday","sled","4","4","3",16.2,1.7,71,9,30,22.8,-2,-2,2,6,7,5,7,13
"6085",2019-03-08,"Snodgrass","w1819","Non.motorized",29,"Fri","weekday","no_sled","3","3","3",16.6,0.4,71,0,27,23.4,9,-2,-2,2,9,7,5,7
"6086",2019-03-08,"Snodgrass","w1819","Mechanized",0,"Fri","weekday","no_sled","3","3","3",16.6,0.4,71,0,27,23.4,9,-2,-2,2,9,7,5,7
"6087",2019-03-08,"Snodgrass","w1819","Motorized",0,"Fri","weekday","sled","3","3","3",16.6,0.4,71,0,27,23.4,9,-2,-2,2,9,7,5,7
"6088",2019-03-08,"Snodgrass","w1819","Hybrid",0,"Fri","weekday","sled","3","3","3",16.6,0.4,71,0,27,23.4,9,-2,-2,2,9,7,5,7
"6089",2019-03-09,"Snodgrass","w1819","Non.motorized",10,"Sat","weekend","no_sled","4","4","3",17.2,0.6,76,5,22,22.6,0,9,-2,-2,5,14,12,10
"6090",2019-03-09,"Snodgrass","w1819","Mechanized",0,"Sat","weekend","no_sled","4","4","3",17.2,0.6,76,5,22,22.6,0,9,-2,-2,5,14,12,10
"6091",2019-03-09,"Snodgrass","w1819","Motorized",0,"Sat","weekend","sled","4","4","3",17.2,0.6,76,5,22,22.6,0,9,-2,-2,5,14,12,10
"6092",2019-03-09,"Snodgrass","w1819","Hybrid",0,"Sat","weekend","sled","4","4","3",17.2,0.6,76,5,22,22.6,0,9,-2,-2,5,14,12,10
"6093",2019-03-10,"Snodgrass","w1819","Non.motorized",40,"Sun","weekend","no_sled","3","3","3",17.3,0.1,73,-3,25,23.7,5,0,9,-2,2,2,11,9
"6094",2019-03-10,"Snodgrass","w1819","Mechanized",0,"Sun","weekend","no_sled","3","3","3",17.3,0.1,73,-3,25,23.7,5,0,9,-2,2,2,11,9
"6095",2019-03-10,"Snodgrass","w1819","Motorized",0,"Sun","weekend","sled","3","3","3",17.3,0.1,73,-3,25,23.7,5,0,9,-2,2,2,11,9
"6096",2019-03-10,"Snodgrass","w1819","Hybrid",0,"Sun","weekend","sled","3","3","3",17.3,0.1,73,-3,25,23.7,5,0,9,-2,2,2,11,9
"6097",2019-03-11,"Snodgrass","w1819","Non.motorized",41,"Mon","weekday","no_sled","3","3","2",17.3,0,71,-2,29,24.4,-3,5,0,9,-5,0,0,9
"6098",2019-03-11,"Snodgrass","w1819","Mechanized",0,"Mon","weekday","no_sled","3","3","2",17.3,0,71,-2,29,24.4,-3,5,0,9,-5,0,0,9
"6099",2019-03-11,"Snodgrass","w1819","Motorized",0,"Mon","weekday","sled","3","3","2",17.3,0,71,-2,29,24.4,-3,5,0,9,-5,0,0,9
"6100",2019-03-11,"Snodgrass","w1819","Hybrid",0,"Mon","weekday","sled","3","3","2",17.3,0,71,-2,29,24.4,-3,5,0,9,-5,0,0,9
"6101",2019-03-12,"Snodgrass","w1819","Non.motorized",35,"Tue","weekday","no_sled","3","3","3",17.4,0.1,70,-1,32,24.9,-2,-3,5,0,-3,-6,-1,-1
"6102",2019-03-12,"Snodgrass","w1819","Non.motorized",35,"Tue","weekday","no_sled","4","4","4",17.4,0.1,70,-1,32,24.9,-2,-3,5,0,-3,-6,-1,-1
"6103",2019-03-12,"Snodgrass","w1819","Mechanized",1,"Tue","weekday","no_sled","3","3","3",17.4,0.1,70,-1,32,24.9,-2,-3,5,0,-3,-6,-1,-1
"6104",2019-03-12,"Snodgrass","w1819","Mechanized",1,"Tue","weekday","no_sled","4","4","4",17.4,0.1,70,-1,32,24.9,-2,-3,5,0,-3,-6,-1,-1
"6105",2019-03-12,"Snodgrass","w1819","Motorized",0,"Tue","weekday","sled","3","3","3",17.4,0.1,70,-1,32,24.9,-2,-3,5,0,-3,-6,-1,-1
"6106",2019-03-12,"Snodgrass","w1819","Motorized",0,"Tue","weekday","sled","4","4","4",17.4,0.1,70,-1,32,24.9,-2,-3,5,0,-3,-6,-1,-1
"6107",2019-03-12,"Snodgrass","w1819","Hybrid",0,"Tue","weekday","sled","3","3","3",17.4,0.1,70,-1,32,24.9,-2,-3,5,0,-3,-6,-1,-1
"6108",2019-03-12,"Snodgrass","w1819","Hybrid",0,"Tue","weekday","sled","4","4","4",17.4,0.1,70,-1,32,24.9,-2,-3,5,0,-3,-6,-1,-1
"6109",2019-03-13,"Snodgrass","w1819","Non.motorized",21,"Wed","weekday","no_sled","4","4","3",18.1,0.7,74,4,24,24.5,-1,-2,-3,5,3,1,-2,3
"6110",2019-03-13,"Snodgrass","w1819","Mechanized",0,"Wed","weekday","no_sled","4","4","3",18.1,0.7,74,4,24,24.5,-1,-2,-3,5,3,1,-2,3
"6111",2019-03-13,"Snodgrass","w1819","Motorized",0,"Wed","weekday","sled","4","4","3",18.1,0.7,74,4,24,24.5,-1,-2,-3,5,3,1,-2,3
"6112",2019-03-13,"Snodgrass","w1819","Hybrid",0,"Wed","weekday","sled","4","4","3",18.1,0.7,74,4,24,24.5,-1,-2,-3,5,3,1,-2,3
"6113",2019-03-14,"Snodgrass","w1819","Non.motorized",31,"Thu","weekday","no_sled","4","4","3",18.1,0,74,0,17,24.5,4,-1,-2,-3,4,3,1,-2
"6114",2019-03-14,"Snodgrass","w1819","Mechanized",0,"Thu","weekday","no_sled","4","4","3",18.1,0,74,0,17,24.5,4,-1,-2,-3,4,3,1,-2
"6115",2019-03-14,"Snodgrass","w1819","Motorized",3,"Thu","weekday","sled","4","4","3",18.1,0,74,0,17,24.5,4,-1,-2,-3,4,3,1,-2
"6116",2019-03-14,"Snodgrass","w1819","Hybrid",0,"Thu","weekday","sled","4","4","3",18.1,0,74,0,17,24.5,4,-1,-2,-3,4,3,1,-2
"6117",2019-03-15,"Snodgrass","w1819","Non.motorized",65,"Fri","weekday","no_sled","3","3","2",18.1,0,72,-2,18,25.1,0,4,-1,-2,-2,2,1,-1
"6118",2019-03-15,"Snodgrass","w1819","Mechanized",0,"Fri","weekday","no_sled","3","3","2",18.1,0,72,-2,18,25.1,0,4,-1,-2,-2,2,1,-1
"6119",2019-03-15,"Snodgrass","w1819","Motorized",0,"Fri","weekday","sled","3","3","2",18.1,0,72,-2,18,25.1,0,4,-1,-2,-2,2,1,-1
"6120",2019-03-15,"Snodgrass","w1819","Hybrid",0,"Fri","weekday","sled","3","3","2",18.1,0,72,-2,18,25.1,0,4,-1,-2,-2,2,1,-1
"6121",2019-03-16,"Snodgrass","w1819","Non.motorized",114,"Sat","weekend","no_sled","3","3","2",18.2,0.1,70,-2,26,26,-2,0,4,-1,-4,-4,0,-1
"6122",2019-03-16,"Snodgrass","w1819","Mechanized",1,"Sat","weekend","no_sled","3","3","2",18.2,0.1,70,-2,26,26,-2,0,4,-1,-4,-4,0,-1
"6123",2019-03-16,"Snodgrass","w1819","Motorized",4,"Sat","weekend","sled","3","3","2",18.2,0.1,70,-2,26,26,-2,0,4,-1,-4,-4,0,-1
"6124",2019-03-16,"Snodgrass","w1819","Hybrid",0,"Sat","weekend","sled","3","3","2",18.2,0.1,70,-2,26,26,-2,0,4,-1,-4,-4,0,-1
"6125",2019-03-17,"Snodgrass","w1819","Non.motorized",106,"Sun","weekend","no_sled","3","3","2",18.2,0,69,-1,28,26.4,-2,-2,0,4,-3,-5,-5,-1
"6126",2019-03-17,"Snodgrass","w1819","Mechanized",11,"Sun","weekend","no_sled","3","3","2",18.2,0,69,-1,28,26.4,-2,-2,0,4,-3,-5,-5,-1
"6127",2019-03-17,"Snodgrass","w1819","Motorized",1,"Sun","weekend","sled","3","3","2",18.2,0,69,-1,28,26.4,-2,-2,0,4,-3,-5,-5,-1
"6128",2019-03-17,"Snodgrass","w1819","Hybrid",0,"Sun","weekend","sled","3","3","2",18.2,0,69,-1,28,26.4,-2,-2,0,4,-3,-5,-5,-1
"6129",2019-03-18,"Snodgrass","w1819","Non.motorized",47,"Mon","weekday","no_sled","2","2","2",18.3,0.1,68,-1,29,26.9,-1,-2,-2,0,-2,-4,-6,-6
"6130",2019-03-18,"Snodgrass","w1819","Mechanized",0,"Mon","weekday","no_sled","2","2","2",18.3,0.1,68,-1,29,26.9,-1,-2,-2,0,-2,-4,-6,-6
"6131",2019-03-18,"Snodgrass","w1819","Motorized",0,"Mon","weekday","sled","2","2","2",18.3,0.1,68,-1,29,26.9,-1,-2,-2,0,-2,-4,-6,-6
"6132",2019-03-18,"Snodgrass","w1819","Hybrid",0,"Mon","weekday","sled","2","2","2",18.3,0.1,68,-1,29,26.9,-1,-2,-2,0,-2,-4,-6,-6
"6133",2019-03-19,"Snodgrass","w1819","Non.motorized",39,"Tue","weekday","no_sled","2","2","2",18.3,0,67,-1,28,27.3,-1,-1,-2,-2,-2,-3,-5,-7
"6134",2019-03-19,"Snodgrass","w1819","Mechanized",3,"Tue","weekday","no_sled","2","2","2",18.3,0,67,-1,28,27.3,-1,-1,-2,-2,-2,-3,-5,-7
"6135",2019-03-19,"Snodgrass","w1819","Motorized",3,"Tue","weekday","sled","2","2","2",18.3,0,67,-1,28,27.3,-1,-1,-2,-2,-2,-3,-5,-7
"6136",2019-03-19,"Snodgrass","w1819","Hybrid",0,"Tue","weekday","sled","2","2","2",18.3,0,67,-1,28,27.3,-1,-1,-2,-2,-2,-3,-5,-7
"6137",2019-03-20,"Snodgrass","w1819","Non.motorized",65,"Wed","weekday","no_sled","2","2","2",18.3,0,66,-1,30,27.7,-1,-1,-1,-2,-2,-3,-4,-6
"6138",2019-03-20,"Snodgrass","w1819","Mechanized",6,"Wed","weekday","no_sled","2","2","2",18.3,0,66,-1,30,27.7,-1,-1,-1,-2,-2,-3,-4,-6
"6139",2019-03-20,"Snodgrass","w1819","Motorized",0,"Wed","weekday","sled","2","2","2",18.3,0,66,-1,30,27.7,-1,-1,-1,-2,-2,-3,-4,-6
"6140",2019-03-20,"Snodgrass","w1819","Hybrid",0,"Wed","weekday","sled","2","2","2",18.3,0,66,-1,30,27.7,-1,-1,-1,-2,-2,-3,-4,-6
"6141",2019-03-21,"Snodgrass","w1819","Non.motorized",73,"Thu","weekday","no_sled","2","2","2",18.4,0.1,65,-1,33,28.3,-1,-1,-1,-1,-2,-3,-4,-5
"6142",2019-03-21,"Snodgrass","w1819","Mechanized",0,"Thu","weekday","no_sled","2","2","2",18.4,0.1,65,-1,33,28.3,-1,-1,-1,-1,-2,-3,-4,-5
"6143",2019-03-21,"Snodgrass","w1819","Motorized",3,"Thu","weekday","sled","2","2","2",18.4,0.1,65,-1,33,28.3,-1,-1,-1,-1,-2,-3,-4,-5
"6144",2019-03-21,"Snodgrass","w1819","Hybrid",0,"Thu","weekday","sled","2","2","2",18.4,0.1,65,-1,33,28.3,-1,-1,-1,-1,-2,-3,-4,-5
"6145",2019-03-22,"Snodgrass","w1819","Non.motorized",51,"Fri","weekday","no_sled","3","3","2",18.4,0,64,-1,28,28.8,-1,-1,-1,-1,-2,-3,-4,-5
"6146",2019-03-22,"Snodgrass","w1819","Mechanized",1,"Fri","weekday","no_sled","3","3","2",18.4,0,64,-1,28,28.8,-1,-1,-1,-1,-2,-3,-4,-5
"6147",2019-03-22,"Snodgrass","w1819","Motorized",0,"Fri","weekday","sled","3","3","2",18.4,0,64,-1,28,28.8,-1,-1,-1,-1,-2,-3,-4,-5
"6148",2019-03-22,"Snodgrass","w1819","Hybrid",0,"Fri","weekday","sled","3","3","2",18.4,0,64,-1,28,28.8,-1,-1,-1,-1,-2,-3,-4,-5
"6149",2019-03-23,"Snodgrass","w1819","Non.motorized",94,"Sat","weekend","no_sled","2","2","1",18.4,0,65,1,28,28.3,-1,-1,-1,-1,0,-1,-2,-3
"6150",2019-03-23,"Snodgrass","w1819","Mechanized",2,"Sat","weekend","no_sled","2","2","1",18.4,0,65,1,28,28.3,-1,-1,-1,-1,0,-1,-2,-3
"6151",2019-03-23,"Snodgrass","w1819","Motorized",0,"Sat","weekend","sled","2","2","1",18.4,0,65,1,28,28.3,-1,-1,-1,-1,0,-1,-2,-3
"6152",2019-03-23,"Snodgrass","w1819","Hybrid",0,"Sat","weekend","sled","2","2","1",18.4,0,65,1,28,28.3,-1,-1,-1,-1,0,-1,-2,-3
"6153",2019-03-24,"Snodgrass","w1819","Non.motorized",53,"Sun","weekend","no_sled","2","2","1",18.4,0,64,-1,29,28.8,1,-1,-1,-1,0,-1,-2,-3
"6154",2019-03-24,"Snodgrass","w1819","Mechanized",3,"Sun","weekend","no_sled","2","2","1",18.4,0,64,-1,29,28.8,1,-1,-1,-1,0,-1,-2,-3
"6155",2019-03-24,"Snodgrass","w1819","Motorized",0,"Sun","weekend","sled","2","2","1",18.4,0,64,-1,29,28.8,1,-1,-1,-1,0,-1,-2,-3
"6156",2019-03-24,"Snodgrass","w1819","Hybrid",0,"Sun","weekend","sled","2","2","1",18.4,0,64,-1,29,28.8,1,-1,-1,-1,0,-1,-2,-3
"6157",2019-03-25,"Snodgrass","w1819","Non.motorized",33,"Mon","weekday","no_sled","2","2","2",18.6,0.2,64,0,31,29.1,-1,1,-1,-1,-1,0,-1,-2
"6158",2019-03-25,"Snodgrass","w1819","Mechanized",0,"Mon","weekday","no_sled","2","2","2",18.6,0.2,64,0,31,29.1,-1,1,-1,-1,-1,0,-1,-2
"6159",2019-03-25,"Snodgrass","w1819","Motorized",1,"Mon","weekday","sled","2","2","2",18.6,0.2,64,0,31,29.1,-1,1,-1,-1,-1,0,-1,-2
"6160",2019-03-25,"Snodgrass","w1819","Hybrid",0,"Mon","weekday","sled","2","2","2",18.6,0.2,64,0,31,29.1,-1,1,-1,-1,-1,0,-1,-2
"6161",2019-03-26,"Snodgrass","w1819","Non.motorized",70,"Tue","weekday","no_sled","2","2","2",18.9,0.3,63,-1,36,30,0,-1,1,-1,-1,-2,-1,-2
"6162",2019-03-26,"Snodgrass","w1819","Mechanized",0,"Tue","weekday","no_sled","2","2","2",18.9,0.3,63,-1,36,30,0,-1,1,-1,-1,-2,-1,-2
"6163",2019-03-26,"Snodgrass","w1819","Motorized",0,"Tue","weekday","sled","2","2","2",18.9,0.3,63,-1,36,30,0,-1,1,-1,-1,-2,-1,-2
"6164",2019-03-26,"Snodgrass","w1819","Hybrid",0,"Tue","weekday","sled","2","2","2",18.9,0.3,63,-1,36,30,0,-1,1,-1,-1,-2,-1,-2
"6165",2019-03-27,"Snodgrass","w1819","Non.motorized",64,"Wed","weekday","no_sled","1","2","2",18.9,0,62,-1,42,30.5,-1,0,-1,1,-2,-2,-3,-2
"6166",2019-03-27,"Snodgrass","w1819","Mechanized",5,"Wed","weekday","no_sled","1","2","2",18.9,0,62,-1,42,30.5,-1,0,-1,1,-2,-2,-3,-2
"6167",2019-03-27,"Snodgrass","w1819","Motorized",3,"Wed","weekday","sled","1","2","2",18.9,0,62,-1,42,30.5,-1,0,-1,1,-2,-2,-3,-2
"6168",2019-03-27,"Snodgrass","w1819","Hybrid",0,"Wed","weekday","sled","1","2","2",18.9,0,62,-1,42,30.5,-1,0,-1,1,-2,-2,-3,-2
"6169",2019-03-28,"Snodgrass","w1819","Non.motorized",55,"Thu","weekday","no_sled","1","2","2",18.9,0,60,-2,40,31.5,-1,-1,0,-1,-3,-4,-4,-5
"6170",2019-03-28,"Snodgrass","w1819","Mechanized",1,"Thu","weekday","no_sled","1","2","2",18.9,0,60,-2,40,31.5,-1,-1,0,-1,-3,-4,-4,-5
"6171",2019-03-28,"Snodgrass","w1819","Motorized",0,"Thu","weekday","sled","1","2","2",18.9,0,60,-2,40,31.5,-1,-1,0,-1,-3,-4,-4,-5
"6172",2019-03-28,"Snodgrass","w1819","Hybrid",0,"Thu","weekday","sled","1","2","2",18.9,0,60,-2,40,31.5,-1,-1,0,-1,-3,-4,-4,-5
"6173",2019-03-29,"Snodgrass","w1819","Non.motorized",36,"Fri","weekday","no_sled","1","1","1",19,0.1,58,-2,26,32.8,-2,-1,-1,0,-4,-5,-6,-6
"6174",2019-03-29,"Snodgrass","w1819","Mechanized",0,"Fri","weekday","no_sled","1","1","1",19,0.1,58,-2,26,32.8,-2,-1,-1,0,-4,-5,-6,-6
"6175",2019-03-29,"Snodgrass","w1819","Motorized",0,"Fri","weekday","sled","1","1","1",19,0.1,58,-2,26,32.8,-2,-1,-1,0,-4,-5,-6,-6
"6176",2019-03-29,"Snodgrass","w1819","Hybrid",0,"Fri","weekday","sled","1","1","1",19,0.1,58,-2,26,32.8,-2,-1,-1,0,-4,-5,-6,-6
"6177",2019-03-30,"Snodgrass","w1819","Non.motorized",100,"Sat","weekend","no_sled","1","1","1",19.1,0.1,61,3,24,31.3,-2,-2,-1,-1,1,-1,-2,-3
"6178",2019-03-30,"Snodgrass","w1819","Mechanized",2,"Sat","weekend","no_sled","1","1","1",19.1,0.1,61,3,24,31.3,-2,-2,-1,-1,1,-1,-2,-3
"6179",2019-03-30,"Snodgrass","w1819","Motorized",5,"Sat","weekend","sled","1","1","1",19.1,0.1,61,3,24,31.3,-2,-2,-1,-1,1,-1,-2,-3
"6180",2019-03-30,"Snodgrass","w1819","Hybrid",0,"Sat","weekend","sled","1","1","1",19.1,0.1,61,3,24,31.3,-2,-2,-1,-1,1,-1,-2,-3
"6181",2019-03-31,"Snodgrass","w1819","Non.motorized",41,"Sun","weekend","no_sled","1","1","1",19.1,0,59,-2,24,32.4,3,-2,-2,-1,1,-1,-3,-4
"6182",2019-03-31,"Snodgrass","w1819","Mechanized",3,"Sun","weekend","no_sled","1","1","1",19.1,0,59,-2,24,32.4,3,-2,-2,-1,1,-1,-3,-4
"6183",2019-03-31,"Snodgrass","w1819","Motorized",7,"Sun","weekend","sled","1","1","1",19.1,0,59,-2,24,32.4,3,-2,-2,-1,1,-1,-3,-4
"6184",2019-03-31,"Snodgrass","w1819","Hybrid",0,"Sun","weekend","sled","1","1","1",19.1,0,59,-2,24,32.4,3,-2,-2,-1,1,-1,-3,-4
"6185",2019-04-01,"Snodgrass","w1819","Non.motorized",37,"Mon","weekday","no_sled","2","1","1",19.1,0,58,-1,29,32.9,-2,3,-2,-2,-3,0,-2,-4
"6186",2019-04-01,"Snodgrass","w1819","Mechanized",4,"Mon","weekday","no_sled","2","1","1",19.1,0,58,-1,29,32.9,-2,3,-2,-2,-3,0,-2,-4
"6187",2019-04-01,"Snodgrass","w1819","Motorized",7,"Mon","weekday","sled","2","1","1",19.1,0,58,-1,29,32.9,-2,3,-2,-2,-3,0,-2,-4
"6188",2019-04-01,"Snodgrass","w1819","Hybrid",0,"Mon","weekday","sled","2","1","1",19.1,0,58,-1,29,32.9,-2,3,-2,-2,-3,0,-2,-4
"6189",2019-04-02,"Snodgrass","w1819","Non.motorized",24,"Tue","weekday","no_sled","1","1","1",19.1,0,58,0,33,32.9,-1,-2,3,-2,-1,-3,0,-2
"6190",2019-04-02,"Snodgrass","w1819","Mechanized",0,"Tue","weekday","no_sled","1","1","1",19.1,0,58,0,33,32.9,-1,-2,3,-2,-1,-3,0,-2
"6191",2019-04-02,"Snodgrass","w1819","Motorized",0,"Tue","weekday","sled","1","1","1",19.1,0,58,0,33,32.9,-1,-2,3,-2,-1,-3,0,-2
"6192",2019-04-02,"Snodgrass","w1819","Hybrid",0,"Tue","weekday","sled","1","1","1",19.1,0,58,0,33,32.9,-1,-2,3,-2,-1,-3,0,-2
"6193",2019-04-03,"Snodgrass","w1819","Non.motorized",23,"Wed","weekday","no_sled","2","1","1",19.2,0.1,58,0,31,33.1,0,-1,-2,3,0,-1,-3,0
"6194",2019-04-03,"Snodgrass","w1819","Mechanized",0,"Wed","weekday","no_sled","2","1","1",19.2,0.1,58,0,31,33.1,0,-1,-2,3,0,-1,-3,0
"6195",2019-04-03,"Snodgrass","w1819","Motorized",2,"Wed","weekday","sled","2","1","1",19.2,0.1,58,0,31,33.1,0,-1,-2,3,0,-1,-3,0
"6196",2019-04-03,"Snodgrass","w1819","Hybrid",0,"Wed","weekday","sled","2","1","1",19.2,0.1,58,0,31,33.1,0,-1,-2,3,0,-1,-3,0
"6197",2019-04-04,"Snodgrass","w1819","Non.motorized",43,"Thu","weekday","no_sled","2","1","1",19.4,0.2,59,1,35,32.9,0,0,-1,-2,1,1,0,-2
"6198",2019-04-04,"Snodgrass","w1819","Mechanized",0,"Thu","weekday","no_sled","2","1","1",19.4,0.2,59,1,35,32.9,0,0,-1,-2,1,1,0,-2
"6199",2019-04-04,"Snodgrass","w1819","Motorized",0,"Thu","weekday","sled","2","1","1",19.4,0.2,59,1,35,32.9,0,0,-1,-2,1,1,0,-2
"6200",2019-04-04,"Snodgrass","w1819","Hybrid",0,"Thu","weekday","sled","2","1","1",19.4,0.2,59,1,35,32.9,0,0,-1,-2,1,1,0,-2
"6201",2019-04-05,"Snodgrass","w1819","Non.motorized",29,"Fri","weekday","no_sled","1","1","1",19.4,0,57,-2,38,34,1,0,0,-1,-1,-1,-1,-2
"6202",2019-04-05,"Snodgrass","w1819","Mechanized",0,"Fri","weekday","no_sled","1","1","1",19.4,0,57,-2,38,34,1,0,0,-1,-1,-1,-1,-2
"6203",2019-04-05,"Snodgrass","w1819","Motorized",1,"Fri","weekday","sled","1","1","1",19.4,0,57,-2,38,34,1,0,0,-1,-1,-1,-1,-2
"6204",2019-04-05,"Snodgrass","w1819","Hybrid",0,"Fri","weekday","sled","1","1","1",19.4,0,57,-2,38,34,1,0,0,-1,-1,-1,-1,-2
"6205",2019-04-06,"Snodgrass","w1819","Non.motorized",42,"Sat","weekend","no_sled","1","1","1",19.3,-0.1,57,0,35,33.9,-2,1,0,0,-2,-1,-1,-1
"6206",2019-04-06,"Snodgrass","w1819","Mechanized",1,"Sat","weekend","no_sled","1","1","1",19.3,-0.1,57,0,35,33.9,-2,1,0,0,-2,-1,-1,-1
"6207",2019-04-06,"Snodgrass","w1819","Motorized",4,"Sat","weekend","sled","1","1","1",19.3,-0.1,57,0,35,33.9,-2,1,0,0,-2,-1,-1,-1
"6208",2019-04-06,"Snodgrass","w1819","Hybrid",0,"Sat","weekend","sled","1","1","1",19.3,-0.1,57,0,35,33.9,-2,1,0,0,-2,-1,-1,-1
"6209",2019-04-07,"Snodgrass","w1819","Non.motorized",37,"Sun","weekend","no_sled","1","1","1",19.1,-0.2,57,0,37,33.5,0,-2,1,0,0,-2,-1,-1
"6210",2019-04-07,"Snodgrass","w1819","Mechanized",2,"Sun","weekend","no_sled","1","1","1",19.1,-0.2,57,0,37,33.5,0,-2,1,0,0,-2,-1,-1
"6211",2019-04-07,"Snodgrass","w1819","Motorized",3,"Sun","weekend","sled","1","1","1",19.1,-0.2,57,0,37,33.5,0,-2,1,0,0,-2,-1,-1
"6212",2019-04-07,"Snodgrass","w1819","Hybrid",0,"Sun","weekend","sled","1","1","1",19.1,-0.2,57,0,37,33.5,0,-2,1,0,0,-2,-1,-1
"6213",2019-04-08,"Snodgrass","w1819","Non.motorized",30,"Mon","weekday","no_sled","1","2","2",19.3,0.2,54,-3,41,35.7,0,0,-2,1,-3,-3,-5,-4
"6214",2019-04-08,"Snodgrass","w1819","Mechanized",0,"Mon","weekday","no_sled","1","2","2",19.3,0.2,54,-3,41,35.7,0,0,-2,1,-3,-3,-5,-4
"6215",2019-04-08,"Snodgrass","w1819","Motorized",9,"Mon","weekday","sled","1","2","2",19.3,0.2,54,-3,41,35.7,0,0,-2,1,-3,-3,-5,-4
"6216",2019-04-08,"Snodgrass","w1819","Hybrid",4,"Mon","weekday","sled","1","2","2",19.3,0.2,54,-3,41,35.7,0,0,-2,1,-3,-3,-5,-4
"6217",2019-04-09,"Snodgrass","w1819","Non.motorized",6,"Tue","weekday","no_sled","1","2","2",19.3,0,53,-1,43,36.4,-3,0,0,-2,-4,-4,-4,-6
"6218",2019-04-09,"Snodgrass","w1819","Mechanized",0,"Tue","weekday","no_sled","1","2","2",19.3,0,53,-1,43,36.4,-3,0,0,-2,-4,-4,-4,-6
"6219",2019-04-09,"Snodgrass","w1819","Motorized",4,"Tue","weekday","sled","1","2","2",19.3,0,53,-1,43,36.4,-3,0,0,-2,-4,-4,-4,-6
"6220",2019-04-09,"Snodgrass","w1819","Hybrid",4,"Tue","weekday","sled","1","2","2",19.3,0,53,-1,43,36.4,-3,0,0,-2,-4,-4,-4,-6
"6221",2019-04-10,"Snodgrass","w1819","Non.motorized",23,"Wed","weekday","no_sled","2","2","1",19,-0.3,51,-2,30,37.3,-1,-3,0,0,-3,-6,-6,-6
"6222",2019-04-10,"Snodgrass","w1819","Mechanized",0,"Wed","weekday","no_sled","2","2","1",19,-0.3,51,-2,30,37.3,-1,-3,0,0,-3,-6,-6,-6
"6223",2019-04-10,"Snodgrass","w1819","Motorized",4,"Wed","weekday","sled","2","2","1",19,-0.3,51,-2,30,37.3,-1,-3,0,0,-3,-6,-6,-6
"6224",2019-04-10,"Snodgrass","w1819","Hybrid",0,"Wed","weekday","sled","2","2","1",19,-0.3,51,-2,30,37.3,-1,-3,0,0,-3,-6,-6,-6
"6225",2019-04-11,"Snodgrass","w1819","Non.motorized",20,"Thu","weekday","no_sled","3","3","2",18.9,-0.1,53,2,20,35.7,-2,-1,-3,0,0,-1,-4,-4
"6226",2019-04-11,"Snodgrass","w1819","Mechanized",0,"Thu","weekday","no_sled","3","3","2",18.9,-0.1,53,2,20,35.7,-2,-1,-3,0,0,-1,-4,-4
"6227",2019-04-11,"Snodgrass","w1819","Motorized",0,"Thu","weekday","sled","3","3","2",18.9,-0.1,53,2,20,35.7,-2,-1,-3,0,0,-1,-4,-4
"6228",2019-04-11,"Snodgrass","w1819","Hybrid",0,"Thu","weekday","sled","3","3","2",18.9,-0.1,53,2,20,35.7,-2,-1,-3,0,0,-1,-4,-4
"6229",2019-04-12,"Snodgrass","w1819","Non.motorized",51,"Fri","weekday","no_sled","2","2","1",18.7,-0.2,53,0,24,35.3,2,-2,-1,-3,2,0,-1,-4
"6230",2019-04-12,"Snodgrass","w1819","Mechanized",0,"Fri","weekday","no_sled","2","2","1",18.7,-0.2,53,0,24,35.3,2,-2,-1,-3,2,0,-1,-4
"6231",2019-04-12,"Snodgrass","w1819","Motorized",0,"Fri","weekday","sled","2","2","1",18.7,-0.2,53,0,24,35.3,2,-2,-1,-3,2,0,-1,-4
"6232",2019-04-12,"Snodgrass","w1819","Hybrid",0,"Fri","weekday","sled","2","2","1",18.7,-0.2,53,0,24,35.3,2,-2,-1,-3,2,0,-1,-4
"6233",2019-04-13,"Snodgrass","w1819","Non.motorized",42,"Sat","weekend","no_sled","1","1","1",18.8,0.1,52,-1,27,36.2,0,2,-2,-1,-1,1,-1,-2
"6234",2019-04-13,"Snodgrass","w1819","Mechanized",2,"Sat","weekend","no_sled","1","1","1",18.8,0.1,52,-1,27,36.2,0,2,-2,-1,-1,1,-1,-2
"6235",2019-04-13,"Snodgrass","w1819","Motorized",4,"Sat","weekend","sled","1","1","1",18.8,0.1,52,-1,27,36.2,0,2,-2,-1,-1,1,-1,-2
"6236",2019-04-13,"Snodgrass","w1819","Hybrid",0,"Sat","weekend","sled","1","1","1",18.8,0.1,52,-1,27,36.2,0,2,-2,-1,-1,1,-1,-2
"6237",2019-04-14,"Snodgrass","w1819","Non.motorized",29,"Sun","weekend","no_sled","1","1","1",18.7,-0.1,51,-1,35,36.7,-1,0,2,-2,-2,-2,0,-2
"6238",2019-04-14,"Snodgrass","w1819","Mechanized",0,"Sun","weekend","no_sled","1","1","1",18.7,-0.1,51,-1,35,36.7,-1,0,2,-2,-2,-2,0,-2
"6239",2019-04-14,"Snodgrass","w1819","Motorized",0,"Sun","weekend","sled","1","1","1",18.7,-0.1,51,-1,35,36.7,-1,0,2,-2,-2,-2,0,-2
"6240",2019-04-14,"Snodgrass","w1819","Hybrid",0,"Sun","weekend","sled","1","1","1",18.7,-0.1,51,-1,35,36.7,-1,0,2,-2,-2,-2,0,-2
"6241",2019-04-15,"Snodgrass","w1819","Non.motorized",13,"Mon","weekday","no_sled",NA,NA,NA,18.6,-0.1,50,-1,41,37.2,-1,-1,0,2,-2,-3,-3,-1
"6242",2019-04-15,"Snodgrass","w1819","Mechanized",0,"Mon","weekday","no_sled",NA,NA,NA,18.6,-0.1,50,-1,41,37.2,-1,-1,0,2,-2,-3,-3,-1
"6243",2019-04-15,"Snodgrass","w1819","Motorized",0,"Mon","weekday","sled",NA,NA,NA,18.6,-0.1,50,-1,41,37.2,-1,-1,0,2,-2,-3,-3,-1
"6244",2019-04-15,"Snodgrass","w1819","Hybrid",0,"Mon","weekday","sled",NA,NA,NA,18.6,-0.1,50,-1,41,37.2,-1,-1,0,2,-2,-3,-3,-1
"6245",2018-12-01,"Washington Gulch","w1819","Non.motorized",25,"Sat","weekend","no_sled","3","3","2",3.3,0.2,19,1,16,17.4,0,0,0,0,1,1,1,1
"6246",2018-12-01,"Washington Gulch","w1819","Mechanized",0,"Sat","weekend","no_sled","3","3","2",3.3,0.2,19,1,16,17.4,0,0,0,0,1,1,1,1
"6247",2018-12-01,"Washington Gulch","w1819","Motorized",4,"Sat","weekend","sled","3","3","2",3.3,0.2,19,1,16,17.4,0,0,0,0,1,1,1,1
"6248",2018-12-01,"Washington Gulch","w1819","Hybrid",0,"Sat","weekend","sled","3","3","2",3.3,0.2,19,1,16,17.4,0,0,0,0,1,1,1,1
"6249",2018-12-02,"Washington Gulch","w1819","Non.motorized",33,"Sun","weekend","no_sled","3","3","3",3.3,0,20,1,14,16.5,1,0,0,0,2,2,2,2
"6250",2018-12-02,"Washington Gulch","w1819","Mechanized",0,"Sun","weekend","no_sled","3","3","3",3.3,0,20,1,14,16.5,1,0,0,0,2,2,2,2
"6251",2018-12-02,"Washington Gulch","w1819","Motorized",6,"Sun","weekend","sled","3","3","3",3.3,0,20,1,14,16.5,1,0,0,0,2,2,2,2
"6252",2018-12-02,"Washington Gulch","w1819","Hybrid",2,"Sun","weekend","sled","3","3","3",3.3,0,20,1,14,16.5,1,0,0,0,2,2,2,2
"6253",2018-12-03,"Washington Gulch","w1819","Non.motorized",4,"Mon","weekday","no_sled","3","3","2",3.4,0.1,19,-1,13,17.9,1,1,0,0,0,1,1,1
"6254",2018-12-03,"Washington Gulch","w1819","Mechanized",0,"Mon","weekday","no_sled","3","3","2",3.4,0.1,19,-1,13,17.9,1,1,0,0,0,1,1,1
"6255",2018-12-03,"Washington Gulch","w1819","Motorized",2,"Mon","weekday","sled","3","3","2",3.4,0.1,19,-1,13,17.9,1,1,0,0,0,1,1,1
"6256",2018-12-03,"Washington Gulch","w1819","Hybrid",2,"Mon","weekday","sled","3","3","2",3.4,0.1,19,-1,13,17.9,1,1,0,0,0,1,1,1
"6257",2018-12-04,"Washington Gulch","w1819","Non.motorized",15,"Tue","weekday","no_sled","3","3","2",3.5,0.1,20,1,8,17.5,-1,1,1,0,0,1,2,2
"6258",2018-12-04,"Washington Gulch","w1819","Mechanized",0,"Tue","weekday","no_sled","3","3","2",3.5,0.1,20,1,8,17.5,-1,1,1,0,0,1,2,2
"6259",2018-12-04,"Washington Gulch","w1819","Motorized",6,"Tue","weekday","sled","3","3","2",3.5,0.1,20,1,8,17.5,-1,1,1,0,0,1,2,2
"6260",2018-12-04,"Washington Gulch","w1819","Hybrid",1,"Tue","weekday","sled","3","3","2",3.5,0.1,20,1,8,17.5,-1,1,1,0,0,1,2,2
"6261",2018-12-05,"Washington Gulch","w1819","Non.motorized",6,"Wed","weekday","no_sled","3","3","2",3.5,0,19,-1,21,18.4,1,-1,1,1,0,-1,0,1
"6262",2018-12-05,"Washington Gulch","w1819","Mechanized",1,"Wed","weekday","no_sled","3","3","2",3.5,0,19,-1,21,18.4,1,-1,1,1,0,-1,0,1
"6263",2018-12-05,"Washington Gulch","w1819","Motorized",0,"Wed","weekday","sled","3","3","2",3.5,0,19,-1,21,18.4,1,-1,1,1,0,-1,0,1
"6264",2018-12-05,"Washington Gulch","w1819","Hybrid",0,"Wed","weekday","sled","3","3","2",3.5,0,19,-1,21,18.4,1,-1,1,1,0,-1,0,1
"6265",2018-12-06,"Washington Gulch","w1819","Non.motorized",11,"Thu","weekday","no_sled","2","2","2",3.7,0.2,18,-1,25,20.6,-1,1,-1,1,-2,-1,-2,-1
"6266",2018-12-06,"Washington Gulch","w1819","Mechanized",0,"Thu","weekday","no_sled","2","2","2",3.7,0.2,18,-1,25,20.6,-1,1,-1,1,-2,-1,-2,-1
"6267",2018-12-06,"Washington Gulch","w1819","Motorized",2,"Thu","weekday","sled","2","2","2",3.7,0.2,18,-1,25,20.6,-1,1,-1,1,-2,-1,-2,-1
"6268",2018-12-06,"Washington Gulch","w1819","Hybrid",2,"Thu","weekday","sled","2","2","2",3.7,0.2,18,-1,25,20.6,-1,1,-1,1,-2,-1,-2,-1
"6269",2018-12-07,"Washington Gulch","w1819","Non.motorized",13,"Fri","weekday","no_sled","2","2","2",3.8,0.1,21,3,23,18.1,-1,-1,1,-1,2,1,2,1
"6270",2018-12-07,"Washington Gulch","w1819","Mechanized",0,"Fri","weekday","no_sled","2","2","2",3.8,0.1,21,3,23,18.1,-1,-1,1,-1,2,1,2,1
"6271",2018-12-07,"Washington Gulch","w1819","Motorized",5,"Fri","weekday","sled","2","2","2",3.8,0.1,21,3,23,18.1,-1,-1,1,-1,2,1,2,1
"6272",2018-12-07,"Washington Gulch","w1819","Hybrid",3,"Fri","weekday","sled","2","2","2",3.8,0.1,21,3,23,18.1,-1,-1,1,-1,2,1,2,1
"6273",2018-12-08,"Washington Gulch","w1819","Non.motorized",49,"Sat","weekend","no_sled","2","2","2",3.8,0,20,-1,23,19,3,-1,-1,1,2,1,0,1
"6274",2018-12-08,"Washington Gulch","w1819","Mechanized",0,"Sat","weekend","no_sled","2","2","2",3.8,0,20,-1,23,19,3,-1,-1,1,2,1,0,1
"6275",2018-12-08,"Washington Gulch","w1819","Motorized",3,"Sat","weekend","sled","2","2","2",3.8,0,20,-1,23,19,3,-1,-1,1,2,1,0,1
"6276",2018-12-08,"Washington Gulch","w1819","Hybrid",0,"Sat","weekend","sled","2","2","2",3.8,0,20,-1,23,19,3,-1,-1,1,2,1,0,1
"6277",2018-12-09,"Washington Gulch","w1819","Non.motorized",63,"Sun","weekend","no_sled","2","2","2",3.8,0,20,0,19,19,-1,3,-1,-1,-1,2,1,0
"6278",2018-12-09,"Washington Gulch","w1819","Mechanized",0,"Sun","weekend","no_sled","2","2","2",3.8,0,20,0,19,19,-1,3,-1,-1,-1,2,1,0
"6279",2018-12-09,"Washington Gulch","w1819","Motorized",9,"Sun","weekend","sled","2","2","2",3.8,0,20,0,19,19,-1,3,-1,-1,-1,2,1,0
"6280",2018-12-09,"Washington Gulch","w1819","Hybrid",7,"Sun","weekend","sled","2","2","2",3.8,0,20,0,19,19,-1,3,-1,-1,-1,2,1,0
"6281",2018-12-10,"Washington Gulch","w1819","Non.motorized",13,"Mon","weekday","no_sled","2","2","2",3.8,0,20,0,21,19,0,-1,3,-1,0,-1,2,1
"6282",2018-12-10,"Washington Gulch","w1819","Mechanized",0,"Mon","weekday","no_sled","2","2","2",3.8,0,20,0,21,19,0,-1,3,-1,0,-1,2,1
"6283",2018-12-10,"Washington Gulch","w1819","Motorized",4,"Mon","weekday","sled","2","2","2",3.8,0,20,0,21,19,0,-1,3,-1,0,-1,2,1
"6284",2018-12-10,"Washington Gulch","w1819","Hybrid",2,"Mon","weekday","sled","2","2","2",3.8,0,20,0,21,19,0,-1,3,-1,0,-1,2,1
"6285",2018-12-11,"Washington Gulch","w1819","Non.motorized",22,"Tue","weekday","no_sled","2","2","2",3.9,0.1,19,-1,27,20.5,0,0,-1,3,-1,-1,-2,1
"6286",2018-12-11,"Washington Gulch","w1819","Mechanized",0,"Tue","weekday","no_sled","2","2","2",3.9,0.1,19,-1,27,20.5,0,0,-1,3,-1,-1,-2,1
"6287",2018-12-11,"Washington Gulch","w1819","Motorized",6,"Tue","weekday","sled","2","2","2",3.9,0.1,19,-1,27,20.5,0,0,-1,3,-1,-1,-2,1
"6288",2018-12-11,"Washington Gulch","w1819","Hybrid",2,"Tue","weekday","sled","2","2","2",3.9,0.1,19,-1,27,20.5,0,0,-1,3,-1,-1,-2,1
"6289",2018-12-12,"Washington Gulch","w1819","Non.motorized",9,"Wed","weekday","no_sled","2","2","1",3.9,0,19,0,21,20.5,-1,0,0,-1,-1,-1,-1,-2
"6290",2018-12-12,"Washington Gulch","w1819","Mechanized",0,"Wed","weekday","no_sled","2","2","1",3.9,0,19,0,21,20.5,-1,0,0,-1,-1,-1,-1,-2
"6291",2018-12-12,"Washington Gulch","w1819","Motorized",0,"Wed","weekday","sled","2","2","1",3.9,0,19,0,21,20.5,-1,0,0,-1,-1,-1,-1,-2
"6292",2018-12-12,"Washington Gulch","w1819","Hybrid",0,"Wed","weekday","sled","2","2","1",3.9,0,19,0,21,20.5,-1,0,0,-1,-1,-1,-1,-2
"6293",2018-12-13,"Washington Gulch","w1819","Non.motorized",18,"Thu","weekday","no_sled","3","3","2",4,0.1,21,2,15,19,0,-1,0,0,2,1,1,1
"6294",2018-12-13,"Washington Gulch","w1819","Mechanized",0,"Thu","weekday","no_sled","3","3","2",4,0.1,21,2,15,19,0,-1,0,0,2,1,1,1
"6295",2018-12-13,"Washington Gulch","w1819","Motorized",3,"Thu","weekday","sled","3","3","2",4,0.1,21,2,15,19,0,-1,0,0,2,1,1,1
"6296",2018-12-13,"Washington Gulch","w1819","Hybrid",1,"Thu","weekday","sled","3","3","2",4,0.1,21,2,15,19,0,-1,0,0,2,1,1,1
"6297",2018-12-14,"Washington Gulch","w1819","Non.motorized",34,"Fri","weekday","no_sled","3","3","2",4,0,20,-1,24,20,2,0,-1,0,1,1,0,0
"6298",2018-12-14,"Washington Gulch","w1819","Mechanized",0,"Fri","weekday","no_sled","3","3","2",4,0,20,-1,24,20,2,0,-1,0,1,1,0,0
"6299",2018-12-14,"Washington Gulch","w1819","Motorized",3,"Fri","weekday","sled","3","3","2",4,0,20,-1,24,20,2,0,-1,0,1,1,0,0
"6300",2018-12-14,"Washington Gulch","w1819","Hybrid",3,"Fri","weekday","sled","3","3","2",4,0,20,-1,24,20,2,0,-1,0,1,1,0,0
"6301",2018-12-15,"Washington Gulch","w1819","Non.motorized",42,"Sat","weekend","no_sled","2","2","2",4,0,20,0,29,20,-1,2,0,-1,-1,1,1,0
"6302",2018-12-15,"Washington Gulch","w1819","Mechanized",0,"Sat","weekend","no_sled","2","2","2",4,0,20,0,29,20,-1,2,0,-1,-1,1,1,0
"6303",2018-12-15,"Washington Gulch","w1819","Motorized",3,"Sat","weekend","sled","2","2","2",4,0,20,0,29,20,-1,2,0,-1,-1,1,1,0
"6304",2018-12-15,"Washington Gulch","w1819","Hybrid",0,"Sat","weekend","sled","2","2","2",4,0,20,0,29,20,-1,2,0,-1,-1,1,1,0
"6305",2018-12-16,"Washington Gulch","w1819","Non.motorized",74,"Sun","weekend","no_sled","2","2","2",4.1,0.1,19,-1,28,21.6,0,-1,2,0,-1,-2,0,0
"6306",2018-12-16,"Washington Gulch","w1819","Mechanized",2,"Sun","weekend","no_sled","2","2","2",4.1,0.1,19,-1,28,21.6,0,-1,2,0,-1,-2,0,0
"6307",2018-12-16,"Washington Gulch","w1819","Motorized",9,"Sun","weekend","sled","2","2","2",4.1,0.1,19,-1,28,21.6,0,-1,2,0,-1,-2,0,0
"6308",2018-12-16,"Washington Gulch","w1819","Hybrid",5,"Sun","weekend","sled","2","2","2",4.1,0.1,19,-1,28,21.6,0,-1,2,0,-1,-2,0,0
"6309",2018-12-17,"Washington Gulch","w1819","Non.motorized",9,"Mon","weekday","no_sled","2","2","2",4.1,0,19,0,29,21.6,-1,0,-1,2,-1,-1,-2,0
"6310",2018-12-17,"Washington Gulch","w1819","Mechanized",0,"Mon","weekday","no_sled","2","2","2",4.1,0,19,0,29,21.6,-1,0,-1,2,-1,-1,-2,0
"6311",2018-12-17,"Washington Gulch","w1819","Motorized",6,"Mon","weekday","sled","2","2","2",4.1,0,19,0,29,21.6,-1,0,-1,2,-1,-1,-2,0
"6312",2018-12-17,"Washington Gulch","w1819","Hybrid",6,"Mon","weekday","sled","2","2","2",4.1,0,19,0,29,21.6,-1,0,-1,2,-1,-1,-2,0
"6313",2018-12-18,"Washington Gulch","w1819","Non.motorized",18,"Tue","weekday","no_sled","2","2","2",4.1,0,19,0,27,21.6,0,-1,0,-1,0,-1,-1,-2
"6314",2018-12-18,"Washington Gulch","w1819","Mechanized",0,"Tue","weekday","no_sled","2","2","2",4.1,0,19,0,27,21.6,0,-1,0,-1,0,-1,-1,-2
"6315",2018-12-18,"Washington Gulch","w1819","Motorized",8,"Tue","weekday","sled","2","2","2",4.1,0,19,0,27,21.6,0,-1,0,-1,0,-1,-1,-2
"6316",2018-12-18,"Washington Gulch","w1819","Hybrid",6,"Tue","weekday","sled","2","2","2",4.1,0,19,0,27,21.6,0,-1,0,-1,0,-1,-1,-2
"6317",2018-12-19,"Washington Gulch","w1819","Non.motorized",12,"Wed","weekday","no_sled","2","2","2",4.1,0,19,0,24,21.6,0,0,-1,0,0,0,-1,-1
"6318",2018-12-19,"Washington Gulch","w1819","Mechanized",0,"Wed","weekday","no_sled","2","2","2",4.1,0,19,0,24,21.6,0,0,-1,0,0,0,-1,-1
"6319",2018-12-19,"Washington Gulch","w1819","Motorized",1,"Wed","weekday","sled","2","2","2",4.1,0,19,0,24,21.6,0,0,-1,0,0,0,-1,-1
"6320",2018-12-19,"Washington Gulch","w1819","Hybrid",1,"Wed","weekday","sled","2","2","2",4.1,0,19,0,24,21.6,0,0,-1,0,0,0,-1,-1
"6321",2018-12-20,"Washington Gulch","w1819","Non.motorized",9,"Thu","weekday","no_sled","2","2","1",4.1,0,20,1,25,20.5,0,0,0,-1,1,1,1,0
"6322",2018-12-20,"Washington Gulch","w1819","Mechanized",0,"Thu","weekday","no_sled","2","2","1",4.1,0,20,1,25,20.5,0,0,0,-1,1,1,1,0
"6323",2018-12-20,"Washington Gulch","w1819","Motorized",10,"Thu","weekday","sled","2","2","1",4.1,0,20,1,25,20.5,0,0,0,-1,1,1,1,0
"6324",2018-12-20,"Washington Gulch","w1819","Hybrid",9,"Thu","weekday","sled","2","2","1",4.1,0,20,1,25,20.5,0,0,0,-1,1,1,1,0
"6325",2018-12-21,"Washington Gulch","w1819","Non.motorized",23,"Fri","weekday","no_sled","2","2","1",4.1,0,19,-1,28,21.6,1,0,0,0,0,0,0,0
"6326",2018-12-21,"Washington Gulch","w1819","Mechanized",0,"Fri","weekday","no_sled","2","2","1",4.1,0,19,-1,28,21.6,1,0,0,0,0,0,0,0
"6327",2018-12-21,"Washington Gulch","w1819","Motorized",0,"Fri","weekday","sled","2","2","1",4.1,0,19,-1,28,21.6,1,0,0,0,0,0,0,0
"6328",2018-12-21,"Washington Gulch","w1819","Hybrid",0,"Fri","weekday","sled","2","2","1",4.1,0,19,-1,28,21.6,1,0,0,0,0,0,0,0
"6329",2018-12-22,"Washington Gulch","w1819","Non.motorized",39,"Sat","weekend","no_sled","2","2","1",4.2,0.1,19,0,20,22.1,-1,1,0,0,-1,0,0,0
"6330",2018-12-22,"Washington Gulch","w1819","Mechanized",0,"Sat","weekend","no_sled","2","2","1",4.2,0.1,19,0,20,22.1,-1,1,0,0,-1,0,0,0
"6331",2018-12-22,"Washington Gulch","w1819","Motorized",21,"Sat","weekend","sled","2","2","1",4.2,0.1,19,0,20,22.1,-1,1,0,0,-1,0,0,0
"6332",2018-12-22,"Washington Gulch","w1819","Hybrid",2,"Sat","weekend","sled","2","2","1",4.2,0.1,19,0,20,22.1,-1,1,0,0,-1,0,0,0
"6333",2018-12-23,"Washington Gulch","w1819","Non.motorized",66,"Sun","weekend","no_sled","2","2","1",4.2,0,21,2,19,20,0,-1,1,0,2,1,2,2
"6334",2018-12-23,"Washington Gulch","w1819","Mechanized",0,"Sun","weekend","no_sled","2","2","1",4.2,0,21,2,19,20,0,-1,1,0,2,1,2,2
"6335",2018-12-23,"Washington Gulch","w1819","Motorized",13,"Sun","weekend","sled","2","2","1",4.2,0,21,2,19,20,0,-1,1,0,2,1,2,2
"6336",2018-12-23,"Washington Gulch","w1819","Hybrid",3,"Sun","weekend","sled","2","2","1",4.2,0,21,2,19,20,0,-1,1,0,2,1,2,2
"6337",2018-12-24,"Washington Gulch","w1819","Non.motorized",28,"Mon","weekday","no_sled","2","2","2",4.3,0.1,20,-1,21,21.5,2,0,-1,1,1,1,0,1
"6338",2018-12-24,"Washington Gulch","w1819","Mechanized",0,"Mon","weekday","no_sled","2","2","2",4.3,0.1,20,-1,21,21.5,2,0,-1,1,1,1,0,1
"6339",2018-12-24,"Washington Gulch","w1819","Motorized",13,"Mon","weekday","sled","2","2","2",4.3,0.1,20,-1,21,21.5,2,0,-1,1,1,1,0,1
"6340",2018-12-24,"Washington Gulch","w1819","Hybrid",4,"Mon","weekday","sled","2","2","2",4.3,0.1,20,-1,21,21.5,2,0,-1,1,1,1,0,1
"6341",2018-12-25,"Washington Gulch","w1819","Non.motorized",57,"Tue","weekday","no_sled","2","2","2",4.7,0.4,25,5,25,18.8,-1,2,0,-1,4,6,6,5
"6342",2018-12-25,"Washington Gulch","w1819","Mechanized",0,"Tue","weekday","no_sled","2","2","2",4.7,0.4,25,5,25,18.8,-1,2,0,-1,4,6,6,5
"6343",2018-12-25,"Washington Gulch","w1819","Motorized",9,"Tue","weekday","sled","2","2","2",4.7,0.4,25,5,25,18.8,-1,2,0,-1,4,6,6,5
"6344",2018-12-25,"Washington Gulch","w1819","Hybrid",7,"Tue","weekday","sled","2","2","2",4.7,0.4,25,5,25,18.8,-1,2,0,-1,4,6,6,5
"6345",2018-12-26,"Washington Gulch","w1819","Non.motorized",54,"Wed","weekday","no_sled","3","3","3",4.7,0,23,-2,24,20.4,5,-1,2,0,3,2,4,4
"6346",2018-12-26,"Washington Gulch","w1819","Mechanized",0,"Wed","weekday","no_sled","3","3","3",4.7,0,23,-2,24,20.4,5,-1,2,0,3,2,4,4
"6347",2018-12-26,"Washington Gulch","w1819","Motorized",12,"Wed","weekday","sled","3","3","3",4.7,0,23,-2,24,20.4,5,-1,2,0,3,2,4,4
"6348",2018-12-26,"Washington Gulch","w1819","Hybrid",8,"Wed","weekday","sled","3","3","3",4.7,0,23,-2,24,20.4,5,-1,2,0,3,2,4,4
"6349",2018-12-27,"Washington Gulch","w1819","Non.motorized",68,"Thu","weekday","no_sled","3","3","2",4.7,0,24,1,12,19.6,-2,5,-1,2,-1,4,3,5
"6350",2018-12-27,"Washington Gulch","w1819","Mechanized",0,"Thu","weekday","no_sled","3","3","2",4.7,0,24,1,12,19.6,-2,5,-1,2,-1,4,3,5
"6351",2018-12-27,"Washington Gulch","w1819","Motorized",6,"Thu","weekday","sled","3","3","2",4.7,0,24,1,12,19.6,-2,5,-1,2,-1,4,3,5
"6352",2018-12-27,"Washington Gulch","w1819","Hybrid",6,"Thu","weekday","sled","3","3","2",4.7,0,24,1,12,19.6,-2,5,-1,2,-1,4,3,5
"6353",2018-12-28,"Washington Gulch","w1819","Non.motorized",38,"Fri","weekday","no_sled","3","3","2",4.7,0,24,0,12,19.6,1,-2,5,-1,1,-1,4,3
"6354",2018-12-28,"Washington Gulch","w1819","Mechanized",0,"Fri","weekday","no_sled","3","3","2",4.7,0,24,0,12,19.6,1,-2,5,-1,1,-1,4,3
"6355",2018-12-28,"Washington Gulch","w1819","Motorized",4,"Fri","weekday","sled","3","3","2",4.7,0,24,0,12,19.6,1,-2,5,-1,1,-1,4,3
"6356",2018-12-28,"Washington Gulch","w1819","Hybrid",2,"Fri","weekday","sled","3","3","2",4.7,0,24,0,12,19.6,1,-2,5,-1,1,-1,4,3
"6357",2018-12-29,"Washington Gulch","w1819","Non.motorized",72,"Sat","weekend","no_sled","3","3","2",4.7,0,24,0,8,19.6,0,1,-2,5,0,1,-1,4
"6358",2018-12-29,"Washington Gulch","w1819","Mechanized",0,"Sat","weekend","no_sled","3","3","2",4.7,0,24,0,8,19.6,0,1,-2,5,0,1,-1,4
"6359",2018-12-29,"Washington Gulch","w1819","Motorized",17,"Sat","weekend","sled","3","3","2",4.7,0,24,0,8,19.6,0,1,-2,5,0,1,-1,4
"6360",2018-12-29,"Washington Gulch","w1819","Hybrid",3,"Sat","weekend","sled","3","3","2",4.7,0,24,0,8,19.6,0,1,-2,5,0,1,-1,4
"6361",2018-12-30,"Washington Gulch","w1819","Non.motorized",85,"Sun","weekend","no_sled","3","3","2",4.7,0,24,0,16,19.6,0,0,1,-2,0,0,1,-1
"6362",2018-12-30,"Washington Gulch","w1819","Mechanized",0,"Sun","weekend","no_sled","3","3","2",4.7,0,24,0,16,19.6,0,0,1,-2,0,0,1,-1
"6363",2018-12-30,"Washington Gulch","w1819","Motorized",36,"Sun","weekend","sled","3","3","2",4.7,0,24,0,16,19.6,0,0,1,-2,0,0,1,-1
"6364",2018-12-30,"Washington Gulch","w1819","Hybrid",5,"Sun","weekend","sled","3","3","2",4.7,0,24,0,16,19.6,0,0,1,-2,0,0,1,-1
"6365",2018-12-31,"Washington Gulch","w1819","Non.motorized",53,"Mon","weekday","no_sled","3","3","3",4.9,0.2,23,-1,14,21.3,0,0,0,1,-1,-1,-1,0
"6366",2018-12-31,"Washington Gulch","w1819","Mechanized",0,"Mon","weekday","no_sled","3","3","3",4.9,0.2,23,-1,14,21.3,0,0,0,1,-1,-1,-1,0
"6367",2018-12-31,"Washington Gulch","w1819","Motorized",8,"Mon","weekday","sled","3","3","3",4.9,0.2,23,-1,14,21.3,0,0,0,1,-1,-1,-1,0
"6368",2018-12-31,"Washington Gulch","w1819","Hybrid",2,"Mon","weekday","sled","3","3","3",4.9,0.2,23,-1,14,21.3,0,0,0,1,-1,-1,-1,0
"6369",2019-01-01,"Washington Gulch","w1819","Non.motorized",19,"Tue","weekday","no_sled","3","3","3",5.1,0.2,29,6,11,17.6,-1,0,0,0,5,5,5,5
"6370",2019-01-01,"Washington Gulch","w1819","Mechanized",1,"Tue","weekday","no_sled","3","3","3",5.1,0.2,29,6,11,17.6,-1,0,0,0,5,5,5,5
"6371",2019-01-01,"Washington Gulch","w1819","Motorized",0,"Tue","weekday","sled","3","3","3",5.1,0.2,29,6,11,17.6,-1,0,0,0,5,5,5,5
"6372",2019-01-01,"Washington Gulch","w1819","Hybrid",0,"Tue","weekday","sled","3","3","3",5.1,0.2,29,6,11,17.6,-1,0,0,0,5,5,5,5
"6373",2019-01-02,"Washington Gulch","w1819","Non.motorized",2,"Wed","weekday","no_sled","3","3","2",5.1,0,28,-1,10,18.2,6,-1,0,0,5,4,4,4
"6374",2019-01-02,"Washington Gulch","w1819","Mechanized",0,"Wed","weekday","no_sled","3","3","2",5.1,0,28,-1,10,18.2,6,-1,0,0,5,4,4,4
"6375",2019-01-02,"Washington Gulch","w1819","Motorized",0,"Wed","weekday","sled","3","3","2",5.1,0,28,-1,10,18.2,6,-1,0,0,5,4,4,4
"6376",2019-01-02,"Washington Gulch","w1819","Hybrid",0,"Wed","weekday","sled","3","3","2",5.1,0,28,-1,10,18.2,6,-1,0,0,5,4,4,4
"6377",2019-01-03,"Washington Gulch","w1819","Non.motorized",8,"Thu","weekday","no_sled","3","3","2",5.1,0,27,-1,22,18.9,-1,6,-1,0,-2,4,3,3
"6378",2019-01-03,"Washington Gulch","w1819","Mechanized",0,"Thu","weekday","no_sled","3","3","2",5.1,0,27,-1,22,18.9,-1,6,-1,0,-2,4,3,3
"6379",2019-01-03,"Washington Gulch","w1819","Motorized",1,"Thu","weekday","sled","3","3","2",5.1,0,27,-1,22,18.9,-1,6,-1,0,-2,4,3,3
"6380",2019-01-03,"Washington Gulch","w1819","Hybrid",0,"Thu","weekday","sled","3","3","2",5.1,0,27,-1,22,18.9,-1,6,-1,0,-2,4,3,3
"6381",2019-01-04,"Washington Gulch","w1819","Non.motorized",3,"Fri","weekday","no_sled","3","3","2",5.3,0.2,26,-1,29,20.4,-1,-1,6,-1,-2,-3,3,2
"6382",2019-01-04,"Washington Gulch","w1819","Mechanized",0,"Fri","weekday","no_sled","3","3","2",5.3,0.2,26,-1,29,20.4,-1,-1,6,-1,-2,-3,3,2
"6383",2019-01-04,"Washington Gulch","w1819","Motorized",3,"Fri","weekday","sled","3","3","2",5.3,0.2,26,-1,29,20.4,-1,-1,6,-1,-2,-3,3,2
"6384",2019-01-04,"Washington Gulch","w1819","Hybrid",3,"Fri","weekday","sled","3","3","2",5.3,0.2,26,-1,29,20.4,-1,-1,6,-1,-2,-3,3,2
"6385",2019-01-05,"Washington Gulch","w1819","Non.motorized",12,"Sat","weekend","no_sled","2","2","2",5.3,0,25,-1,30,21.2,-1,-1,-1,6,-2,-3,-4,2
"6386",2019-01-05,"Washington Gulch","w1819","Mechanized",0,"Sat","weekend","no_sled","2","2","2",5.3,0,25,-1,30,21.2,-1,-1,-1,6,-2,-3,-4,2
"6387",2019-01-05,"Washington Gulch","w1819","Motorized",3,"Sat","weekend","sled","2","2","2",5.3,0,25,-1,30,21.2,-1,-1,-1,6,-2,-3,-4,2
"6388",2019-01-05,"Washington Gulch","w1819","Hybrid",3,"Sat","weekend","sled","2","2","2",5.3,0,25,-1,30,21.2,-1,-1,-1,6,-2,-3,-4,2
"6389",2019-01-06,"Washington Gulch","w1819","Non.motorized",NA,"Sun","weekend","no_sled","3","3","3",5.3,0,25,0,26,21.2,-1,-1,-1,-1,-1,-2,-3,-4
"6390",2019-01-06,"Washington Gulch","w1819","Mechanized",NA,"Sun","weekend","no_sled","3","3","3",5.3,0,25,0,26,21.2,-1,-1,-1,-1,-1,-2,-3,-4
"6391",2019-01-06,"Washington Gulch","w1819","Motorized",NA,"Sun","weekend","sled","3","3","3",5.3,0,25,0,26,21.2,-1,-1,-1,-1,-1,-2,-3,-4
"6392",2019-01-06,"Washington Gulch","w1819","Hybrid",NA,"Sun","weekend","sled","3","3","3",5.3,0,25,0,26,21.2,-1,-1,-1,-1,-1,-2,-3,-4
"6393",2019-01-07,"Washington Gulch","w1819","Non.motorized",NA,"Mon","weekday","no_sled","3","3","3",5.8,0.5,32,7,21,18.1,0,-1,-1,-1,7,6,5,4
"6394",2019-01-07,"Washington Gulch","w1819","Mechanized",NA,"Mon","weekday","no_sled","3","3","3",5.8,0.5,32,7,21,18.1,0,-1,-1,-1,7,6,5,4
"6395",2019-01-07,"Washington Gulch","w1819","Motorized",NA,"Mon","weekday","sled","3","3","3",5.8,0.5,32,7,21,18.1,0,-1,-1,-1,7,6,5,4
"6396",2019-01-07,"Washington Gulch","w1819","Hybrid",NA,"Mon","weekday","sled","3","3","3",5.8,0.5,32,7,21,18.1,0,-1,-1,-1,7,6,5,4
"6397",2019-01-08,"Washington Gulch","w1819","Non.motorized",2,"Tue","weekday","no_sled","3","3","3",5.9,0.1,32,0,24,18.4,7,0,-1,-1,7,7,6,5
"6398",2019-01-08,"Washington Gulch","w1819","Mechanized",0,"Tue","weekday","no_sled","3","3","3",5.9,0.1,32,0,24,18.4,7,0,-1,-1,7,7,6,5
"6399",2019-01-08,"Washington Gulch","w1819","Motorized",5,"Tue","weekday","sled","3","3","3",5.9,0.1,32,0,24,18.4,7,0,-1,-1,7,7,6,5
"6400",2019-01-08,"Washington Gulch","w1819","Hybrid",4,"Tue","weekday","sled","3","3","3",5.9,0.1,32,0,24,18.4,7,0,-1,-1,7,7,6,5
"6401",2019-01-09,"Washington Gulch","w1819","Non.motorized",1,"Wed","weekday","no_sled","3","3","3",6,0.1,30,-2,29,20,0,7,0,-1,-2,5,5,4
"6402",2019-01-09,"Washington Gulch","w1819","Mechanized",0,"Wed","weekday","no_sled","3","3","3",6,0.1,30,-2,29,20,0,7,0,-1,-2,5,5,4
"6403",2019-01-09,"Washington Gulch","w1819","Motorized",5,"Wed","weekday","sled","3","3","3",6,0.1,30,-2,29,20,0,7,0,-1,-2,5,5,4
"6404",2019-01-09,"Washington Gulch","w1819","Hybrid",2,"Wed","weekday","sled","3","3","3",6,0.1,30,-2,29,20,0,7,0,-1,-2,5,5,4
"6405",2019-01-10,"Washington Gulch","w1819","Non.motorized",5,"Thu","weekday","no_sled","3","3","3",6,0,29,-1,29,20.7,-2,0,7,0,-3,-3,4,4
"6406",2019-01-10,"Washington Gulch","w1819","Mechanized",0,"Thu","weekday","no_sled","3","3","3",6,0,29,-1,29,20.7,-2,0,7,0,-3,-3,4,4
"6407",2019-01-10,"Washington Gulch","w1819","Motorized",0,"Thu","weekday","sled","3","3","3",6,0,29,-1,29,20.7,-2,0,7,0,-3,-3,4,4
"6408",2019-01-10,"Washington Gulch","w1819","Hybrid",0,"Thu","weekday","sled","3","3","3",6,0,29,-1,29,20.7,-2,0,7,0,-3,-3,4,4
"6409",2019-01-11,"Washington Gulch","w1819","Non.motorized",18,"Fri","weekday","no_sled","2","2","2",6.1,0.1,29,0,25,21,-1,-2,0,7,-1,-3,-3,4
"6410",2019-01-11,"Washington Gulch","w1819","Mechanized",0,"Fri","weekday","no_sled","2","2","2",6.1,0.1,29,0,25,21,-1,-2,0,7,-1,-3,-3,4
"6411",2019-01-11,"Washington Gulch","w1819","Motorized",3,"Fri","weekday","sled","2","2","2",6.1,0.1,29,0,25,21,-1,-2,0,7,-1,-3,-3,4
"6412",2019-01-11,"Washington Gulch","w1819","Hybrid",2,"Fri","weekday","sled","2","2","2",6.1,0.1,29,0,25,21,-1,-2,0,7,-1,-3,-3,4
"6413",2019-01-12,"Washington Gulch","w1819","Non.motorized",19,"Sat","weekend","no_sled","3","3","2",6.1,0,28,-1,21,21.8,0,-1,-2,0,-1,-2,-4,-4
"6414",2019-01-12,"Washington Gulch","w1819","Mechanized",0,"Sat","weekend","no_sled","3","3","2",6.1,0,28,-1,21,21.8,0,-1,-2,0,-1,-2,-4,-4
"6415",2019-01-12,"Washington Gulch","w1819","Motorized",3,"Sat","weekend","sled","3","3","2",6.1,0,28,-1,21,21.8,0,-1,-2,0,-1,-2,-4,-4
"6416",2019-01-12,"Washington Gulch","w1819","Hybrid",0,"Sat","weekend","sled","3","3","2",6.1,0,28,-1,21,21.8,0,-1,-2,0,-1,-2,-4,-4
"6417",2019-01-13,"Washington Gulch","w1819","Non.motorized",29,"Sun","weekend","no_sled","2","2","2",6.2,0.1,30,2,18,20.7,-1,0,-1,-2,1,1,0,-2
"6418",2019-01-13,"Washington Gulch","w1819","Mechanized",0,"Sun","weekend","no_sled","2","2","2",6.2,0.1,30,2,18,20.7,-1,0,-1,-2,1,1,0,-2
"6419",2019-01-13,"Washington Gulch","w1819","Motorized",6,"Sun","weekend","sled","2","2","2",6.2,0.1,30,2,18,20.7,-1,0,-1,-2,1,1,0,-2
"6420",2019-01-13,"Washington Gulch","w1819","Hybrid",6,"Sun","weekend","sled","2","2","2",6.2,0.1,30,2,18,20.7,-1,0,-1,-2,1,1,0,-2
"6421",2019-01-14,"Washington Gulch","w1819","Non.motorized",8,"Mon","weekday","no_sled","2","2","2",6.2,0,30,0,18,20.7,2,-1,0,-1,2,1,1,0
"6422",2019-01-14,"Washington Gulch","w1819","Mechanized",0,"Mon","weekday","no_sled","2","2","2",6.2,0,30,0,18,20.7,2,-1,0,-1,2,1,1,0
"6423",2019-01-14,"Washington Gulch","w1819","Motorized",9,"Mon","weekday","sled","2","2","2",6.2,0,30,0,18,20.7,2,-1,0,-1,2,1,1,0
"6424",2019-01-14,"Washington Gulch","w1819","Hybrid",2,"Mon","weekday","sled","2","2","2",6.2,0,30,0,18,20.7,2,-1,0,-1,2,1,1,0
"6425",2019-01-15,"Washington Gulch","w1819","Non.motorized",0,"Tue","weekday","no_sled","2","2","2",6.2,0,29,-1,24,21.4,0,2,-1,0,-1,1,0,0
"6426",2019-01-15,"Washington Gulch","w1819","Mechanized",0,"Tue","weekday","no_sled","2","2","2",6.2,0,29,-1,24,21.4,0,2,-1,0,-1,1,0,0
"6427",2019-01-15,"Washington Gulch","w1819","Motorized",0,"Tue","weekday","sled","2","2","2",6.2,0,29,-1,24,21.4,0,2,-1,0,-1,1,0,0
"6428",2019-01-15,"Washington Gulch","w1819","Hybrid",0,"Tue","weekday","sled","2","2","2",6.2,0,29,-1,24,21.4,0,2,-1,0,-1,1,0,0
"6429",2019-01-16,"Washington Gulch","w1819","Non.motorized",0,"Wed","weekday","no_sled","4","4","3",6.3,0.1,29,0,26,21.7,-1,0,2,-1,-1,-1,1,0
"6430",2019-01-16,"Washington Gulch","w1819","Mechanized",0,"Wed","weekday","no_sled","4","4","3",6.3,0.1,29,0,26,21.7,-1,0,2,-1,-1,-1,1,0
"6431",2019-01-16,"Washington Gulch","w1819","Motorized",0,"Wed","weekday","sled","4","4","3",6.3,0.1,29,0,26,21.7,-1,0,2,-1,-1,-1,1,0
"6432",2019-01-16,"Washington Gulch","w1819","Hybrid",0,"Wed","weekday","sled","4","4","3",6.3,0.1,29,0,26,21.7,-1,0,2,-1,-1,-1,1,0
"6433",2019-01-17,"Washington Gulch","w1819","Non.motorized",0,"Thu","weekday","no_sled","3","3","2",7,0.7,38,9,28,18.4,0,-1,0,2,9,8,8,10
"6434",2019-01-17,"Washington Gulch","w1819","Mechanized",0,"Thu","weekday","no_sled","3","3","2",7,0.7,38,9,28,18.4,0,-1,0,2,9,8,8,10
"6435",2019-01-17,"Washington Gulch","w1819","Motorized",0,"Thu","weekday","sled","3","3","2",7,0.7,38,9,28,18.4,0,-1,0,2,9,8,8,10
"6436",2019-01-17,"Washington Gulch","w1819","Hybrid",0,"Thu","weekday","sled","3","3","2",7,0.7,38,9,28,18.4,0,-1,0,2,9,8,8,10
"6437",2019-01-18,"Washington Gulch","w1819","Non.motorized",0,"Fri","weekday","no_sled","4","4","4",7.5,0.5,41,3,22,18.3,9,0,-1,0,12,12,11,11
"6438",2019-01-18,"Washington Gulch","w1819","Mechanized",0,"Fri","weekday","no_sled","4","4","4",7.5,0.5,41,3,22,18.3,9,0,-1,0,12,12,11,11
"6439",2019-01-18,"Washington Gulch","w1819","Motorized",0,"Fri","weekday","sled","4","4","4",7.5,0.5,41,3,22,18.3,9,0,-1,0,12,12,11,11
"6440",2019-01-18,"Washington Gulch","w1819","Hybrid",0,"Fri","weekday","sled","4","4","4",7.5,0.5,41,3,22,18.3,9,0,-1,0,12,12,11,11
"6441",2019-01-19,"Washington Gulch","w1819","Non.motorized",0,"Sat","weekend","no_sled","3","3","3",7.8,0.3,43,2,20,18.1,3,9,0,-1,5,14,14,13
"6442",2019-01-19,"Washington Gulch","w1819","Mechanized",0,"Sat","weekend","no_sled","3","3","3",7.8,0.3,43,2,20,18.1,3,9,0,-1,5,14,14,13
"6443",2019-01-19,"Washington Gulch","w1819","Motorized",0,"Sat","weekend","sled","3","3","3",7.8,0.3,43,2,20,18.1,3,9,0,-1,5,14,14,13
"6444",2019-01-19,"Washington Gulch","w1819","Hybrid",0,"Sat","weekend","sled","3","3","3",7.8,0.3,43,2,20,18.1,3,9,0,-1,5,14,14,13
"6445",2019-01-20,"Washington Gulch","w1819","Non.motorized",0,"Sun","weekend","no_sled","3","3","3",7.9,0.1,41,-2,27,19.3,2,3,9,0,0,3,12,12
"6446",2019-01-20,"Washington Gulch","w1819","Mechanized",0,"Sun","weekend","no_sled","3","3","3",7.9,0.1,41,-2,27,19.3,2,3,9,0,0,3,12,12
"6447",2019-01-20,"Washington Gulch","w1819","Motorized",0,"Sun","weekend","sled","3","3","3",7.9,0.1,41,-2,27,19.3,2,3,9,0,0,3,12,12
"6448",2019-01-20,"Washington Gulch","w1819","Hybrid",0,"Sun","weekend","sled","3","3","3",7.9,0.1,41,-2,27,19.3,2,3,9,0,0,3,12,12
"6449",2019-01-21,"Washington Gulch","w1819","Non.motorized",NA,"Mon","weekday","no_sled","3","3","3",7.9,0,39,-2,23,20.3,-2,2,3,9,-4,-2,1,10
"6450",2019-01-21,"Washington Gulch","w1819","Mechanized",NA,"Mon","weekday","no_sled","3","3","3",7.9,0,39,-2,23,20.3,-2,2,3,9,-4,-2,1,10
"6451",2019-01-21,"Washington Gulch","w1819","Motorized",NA,"Mon","weekday","sled","3","3","3",7.9,0,39,-2,23,20.3,-2,2,3,9,-4,-2,1,10
"6452",2019-01-21,"Washington Gulch","w1819","Hybrid",NA,"Mon","weekday","sled","3","3","3",7.9,0,39,-2,23,20.3,-2,2,3,9,-4,-2,1,10
"6453",2019-01-22,"Washington Gulch","w1819","Non.motorized",NA,"Tue","weekday","no_sled","3","3","3",8,0.1,41,2,12,19.5,-2,-2,2,3,0,-2,0,3
"6454",2019-01-22,"Washington Gulch","w1819","Mechanized",NA,"Tue","weekday","no_sled","3","3","3",8,0.1,41,2,12,19.5,-2,-2,2,3,0,-2,0,3
"6455",2019-01-22,"Washington Gulch","w1819","Motorized",NA,"Tue","weekday","sled","3","3","3",8,0.1,41,2,12,19.5,-2,-2,2,3,0,-2,0,3
"6456",2019-01-22,"Washington Gulch","w1819","Hybrid",NA,"Tue","weekday","sled","3","3","3",8,0.1,41,2,12,19.5,-2,-2,2,3,0,-2,0,3
"6457",2019-01-23,"Washington Gulch","w1819","Non.motorized",NA,"Wed","weekday","no_sled","3","3","2",8,0,40,-1,14,20,2,-2,-2,2,1,-1,-3,-1
"6458",2019-01-23,"Washington Gulch","w1819","Mechanized",NA,"Wed","weekday","no_sled","3","3","2",8,0,40,-1,14,20,2,-2,-2,2,1,-1,-3,-1
"6459",2019-01-23,"Washington Gulch","w1819","Motorized",NA,"Wed","weekday","sled","3","3","2",8,0,40,-1,14,20,2,-2,-2,2,1,-1,-3,-1
"6460",2019-01-23,"Washington Gulch","w1819","Hybrid",NA,"Wed","weekday","sled","3","3","2",8,0,40,-1,14,20,2,-2,-2,2,1,-1,-3,-1
"6461",2019-01-24,"Washington Gulch","w1819","Non.motorized",1,"Thu","weekday","no_sled","3","3","2",8.2,0.2,40,0,17,20.5,-1,2,-2,-2,-1,1,-1,-3
"6462",2019-01-24,"Washington Gulch","w1819","Mechanized",1,"Thu","weekday","no_sled","3","3","2",8.2,0.2,40,0,17,20.5,-1,2,-2,-2,-1,1,-1,-3
"6463",2019-01-24,"Washington Gulch","w1819","Motorized",0,"Thu","weekday","sled","3","3","2",8.2,0.2,40,0,17,20.5,-1,2,-2,-2,-1,1,-1,-3
"6464",2019-01-24,"Washington Gulch","w1819","Hybrid",0,"Thu","weekday","sled","3","3","2",8.2,0.2,40,0,17,20.5,-1,2,-2,-2,-1,1,-1,-3
"6465",2019-01-25,"Washington Gulch","w1819","Non.motorized",0,"Fri","weekday","no_sled","3","3","2",8.3,0.1,40,0,15,20.8,0,-1,2,-2,0,-1,1,-1
"6466",2019-01-25,"Washington Gulch","w1819","Mechanized",0,"Fri","weekday","no_sled","3","3","2",8.3,0.1,40,0,15,20.8,0,-1,2,-2,0,-1,1,-1
"6467",2019-01-25,"Washington Gulch","w1819","Motorized",1,"Fri","weekday","sled","3","3","2",8.3,0.1,40,0,15,20.8,0,-1,2,-2,0,-1,1,-1
"6468",2019-01-25,"Washington Gulch","w1819","Hybrid",0,"Fri","weekday","sled","3","3","2",8.3,0.1,40,0,15,20.8,0,-1,2,-2,0,-1,1,-1
"6469",2019-01-26,"Washington Gulch","w1819","Non.motorized",0,"Sat","weekend","no_sled","3","3","2",8.3,0,39,-1,19,21.3,0,0,-1,2,-1,-1,-2,0
"6470",2019-01-26,"Washington Gulch","w1819","Mechanized",0,"Sat","weekend","no_sled","3","3","2",8.3,0,39,-1,19,21.3,0,0,-1,2,-1,-1,-2,0
"6471",2019-01-26,"Washington Gulch","w1819","Motorized",0,"Sat","weekend","sled","3","3","2",8.3,0,39,-1,19,21.3,0,0,-1,2,-1,-1,-2,0
"6472",2019-01-26,"Washington Gulch","w1819","Hybrid",0,"Sat","weekend","sled","3","3","2",8.3,0,39,-1,19,21.3,0,0,-1,2,-1,-1,-2,0
"6473",2019-01-27,"Washington Gulch","w1819","Non.motorized",0,"Sun","weekend","no_sled","3","3","2",8.3,0,38,-1,24,21.8,-1,0,0,-1,-2,-2,-2,-3
"6474",2019-01-27,"Washington Gulch","w1819","Mechanized",0,"Sun","weekend","no_sled","3","3","2",8.3,0,38,-1,24,21.8,-1,0,0,-1,-2,-2,-2,-3
"6475",2019-01-27,"Washington Gulch","w1819","Motorized",0,"Sun","weekend","sled","3","3","2",8.3,0,38,-1,24,21.8,-1,0,0,-1,-2,-2,-2,-3
"6476",2019-01-27,"Washington Gulch","w1819","Hybrid",0,"Sun","weekend","sled","3","3","2",8.3,0,38,-1,24,21.8,-1,0,0,-1,-2,-2,-2,-3
"6477",2019-01-28,"Washington Gulch","w1819","Non.motorized",0,"Mon","weekday","no_sled","2","2","2",8.3,0,38,0,17,21.8,-1,-1,0,0,-1,-2,-2,-2
"6478",2019-01-28,"Washington Gulch","w1819","Mechanized",0,"Mon","weekday","no_sled","2","2","2",8.3,0,38,0,17,21.8,-1,-1,0,0,-1,-2,-2,-2
"6479",2019-01-28,"Washington Gulch","w1819","Motorized",0,"Mon","weekday","sled","2","2","2",8.3,0,38,0,17,21.8,-1,-1,0,0,-1,-2,-2,-2
"6480",2019-01-28,"Washington Gulch","w1819","Hybrid",0,"Mon","weekday","sled","2","2","2",8.3,0,38,0,17,21.8,-1,-1,0,0,-1,-2,-2,-2
"6481",2019-01-29,"Washington Gulch","w1819","Non.motorized",0,"Tue","weekday","no_sled","2","2","2",8.3,0,38,0,16,21.8,0,-1,-1,0,0,-1,-2,-2
"6482",2019-01-29,"Washington Gulch","w1819","Mechanized",0,"Tue","weekday","no_sled","2","2","2",8.3,0,38,0,16,21.8,0,-1,-1,0,0,-1,-2,-2
"6483",2019-01-29,"Washington Gulch","w1819","Motorized",0,"Tue","weekday","sled","2","2","2",8.3,0,38,0,16,21.8,0,-1,-1,0,0,-1,-2,-2
"6484",2019-01-29,"Washington Gulch","w1819","Hybrid",0,"Tue","weekday","sled","2","2","2",8.3,0,38,0,16,21.8,0,-1,-1,0,0,-1,-2,-2
"6485",2019-01-30,"Washington Gulch","w1819","Non.motorized",0,"Wed","weekday","no_sled","2","2","1",8.3,0,37,-1,20,22.4,0,0,-1,-1,-1,-1,-2,-3
"6486",2019-01-30,"Washington Gulch","w1819","Mechanized",0,"Wed","weekday","no_sled","2","2","1",8.3,0,37,-1,20,22.4,0,0,-1,-1,-1,-1,-2,-3
"6487",2019-01-30,"Washington Gulch","w1819","Motorized",0,"Wed","weekday","sled","2","2","1",8.3,0,37,-1,20,22.4,0,0,-1,-1,-1,-1,-2,-3
"6488",2019-01-30,"Washington Gulch","w1819","Hybrid",0,"Wed","weekday","sled","2","2","1",8.3,0,37,-1,20,22.4,0,0,-1,-1,-1,-1,-2,-3
"6489",2019-01-31,"Washington Gulch","w1819","Non.motorized",0,"Thu","weekday","no_sled","2","2","1",8.3,0,36,-1,24,23.1,-1,0,0,-1,-2,-2,-2,-3
"6490",2019-01-31,"Washington Gulch","w1819","Mechanized",0,"Thu","weekday","no_sled","2","2","1",8.3,0,36,-1,24,23.1,-1,0,0,-1,-2,-2,-2,-3
"6491",2019-01-31,"Washington Gulch","w1819","Motorized",0,"Thu","weekday","sled","2","2","1",8.3,0,36,-1,24,23.1,-1,0,0,-1,-2,-2,-2,-3
"6492",2019-01-31,"Washington Gulch","w1819","Hybrid",0,"Thu","weekday","sled","2","2","1",8.3,0,36,-1,24,23.1,-1,0,0,-1,-2,-2,-2,-3
"6493",2019-02-01,"Washington Gulch","w1819","Non.motorized",0,"Fri","weekday","no_sled","2","2","1",8.3,0,36,0,25,23.1,-1,-1,0,0,-1,-2,-2,-2
"6494",2019-02-01,"Washington Gulch","w1819","Mechanized",0,"Fri","weekday","no_sled","2","2","1",8.3,0,36,0,25,23.1,-1,-1,0,0,-1,-2,-2,-2
"6495",2019-02-01,"Washington Gulch","w1819","Motorized",0,"Fri","weekday","sled","2","2","1",8.3,0,36,0,25,23.1,-1,-1,0,0,-1,-2,-2,-2
"6496",2019-02-01,"Washington Gulch","w1819","Hybrid",0,"Fri","weekday","sled","2","2","1",8.3,0,36,0,25,23.1,-1,-1,0,0,-1,-2,-2,-2
"6497",2019-02-02,"Washington Gulch","w1819","Non.motorized",0,"Sat","weekend","no_sled","2","2","1",8.3,0,36,0,26,23.1,0,-1,-1,0,0,-1,-2,-2
"6498",2019-02-02,"Washington Gulch","w1819","Mechanized",0,"Sat","weekend","no_sled","2","2","1",8.3,0,36,0,26,23.1,0,-1,-1,0,0,-1,-2,-2
"6499",2019-02-02,"Washington Gulch","w1819","Motorized",0,"Sat","weekend","sled","2","2","1",8.3,0,36,0,26,23.1,0,-1,-1,0,0,-1,-2,-2
"6500",2019-02-02,"Washington Gulch","w1819","Hybrid",0,"Sat","weekend","sled","2","2","1",8.3,0,36,0,26,23.1,0,-1,-1,0,0,-1,-2,-2
"6501",2019-02-03,"Washington Gulch","w1819","Non.motorized",0,"Sun","weekend","no_sled","3","3","2",8.4,0.1,36,0,28,23.3,0,0,-1,-1,0,0,-1,-2
"6502",2019-02-03,"Washington Gulch","w1819","Mechanized",0,"Sun","weekend","no_sled","3","3","2",8.4,0.1,36,0,28,23.3,0,0,-1,-1,0,0,-1,-2
"6503",2019-02-03,"Washington Gulch","w1819","Motorized",0,"Sun","weekend","sled","3","3","2",8.4,0.1,36,0,28,23.3,0,0,-1,-1,0,0,-1,-2
"6504",2019-02-03,"Washington Gulch","w1819","Hybrid",0,"Sun","weekend","sled","3","3","2",8.4,0.1,36,0,28,23.3,0,0,-1,-1,0,0,-1,-2
"6505",2019-02-04,"Washington Gulch","w1819","Non.motorized",0,"Mon","weekday","no_sled","3","3","2",8.8,0.4,39,3,28,22.6,0,0,0,-1,3,3,3,2
"6506",2019-02-04,"Washington Gulch","w1819","Mechanized",0,"Mon","weekday","no_sled","3","3","2",8.8,0.4,39,3,28,22.6,0,0,0,-1,3,3,3,2
"6507",2019-02-04,"Washington Gulch","w1819","Motorized",0,"Mon","weekday","sled","3","3","2",8.8,0.4,39,3,28,22.6,0,0,0,-1,3,3,3,2
"6508",2019-02-04,"Washington Gulch","w1819","Hybrid",0,"Mon","weekday","sled","3","3","2",8.8,0.4,39,3,28,22.6,0,0,0,-1,3,3,3,2
"6509",2019-02-05,"Washington Gulch","w1819","Non.motorized",2,"Tue","weekday","no_sled","3","2","2",9,0.2,40,1,26,22.5,3,0,0,0,4,4,4,4
"6510",2019-02-05,"Washington Gulch","w1819","Mechanized",0,"Tue","weekday","no_sled","3","2","2",9,0.2,40,1,26,22.5,3,0,0,0,4,4,4,4
"6511",2019-02-05,"Washington Gulch","w1819","Motorized",0,"Tue","weekday","sled","3","2","2",9,0.2,40,1,26,22.5,3,0,0,0,4,4,4,4
"6512",2019-02-05,"Washington Gulch","w1819","Hybrid",0,"Tue","weekday","sled","3","2","2",9,0.2,40,1,26,22.5,3,0,0,0,4,4,4,4
"6513",2019-02-06,"Washington Gulch","w1819","Non.motorized",3,"Wed","weekday","no_sled","4","4","3",9,0,40,0,16,22.5,1,3,0,0,1,4,4,4
"6514",2019-02-06,"Washington Gulch","w1819","Mechanized",0,"Wed","weekday","no_sled","4","4","3",9,0,40,0,16,22.5,1,3,0,0,1,4,4,4
"6515",2019-02-06,"Washington Gulch","w1819","Motorized",0,"Wed","weekday","sled","4","4","3",9,0,40,0,16,22.5,1,3,0,0,1,4,4,4
"6516",2019-02-06,"Washington Gulch","w1819","Hybrid",0,"Wed","weekday","sled","4","4","3",9,0,40,0,16,22.5,1,3,0,0,1,4,4,4
"6517",2019-02-07,"Washington Gulch","w1819","Non.motorized",19,"Thu","weekday","no_sled","3","3","2",9.2,0.2,43,3,4,21.4,0,1,3,0,3,4,7,7
"6518",2019-02-07,"Washington Gulch","w1819","Mechanized",0,"Thu","weekday","no_sled","3","3","2",9.2,0.2,43,3,4,21.4,0,1,3,0,3,4,7,7
"6519",2019-02-07,"Washington Gulch","w1819","Motorized",2,"Thu","weekday","sled","3","3","2",9.2,0.2,43,3,4,21.4,0,1,3,0,3,4,7,7
"6520",2019-02-07,"Washington Gulch","w1819","Hybrid",2,"Thu","weekday","sled","3","3","2",9.2,0.2,43,3,4,21.4,0,1,3,0,3,4,7,7
"6521",2019-02-08,"Washington Gulch","w1819","Non.motorized",0,"Fri","weekday","no_sled","3","2","2",9.2,0,42,-1,10,21.9,3,0,1,3,2,2,3,6
"6522",2019-02-08,"Washington Gulch","w1819","Mechanized",0,"Fri","weekday","no_sled","3","2","2",9.2,0,42,-1,10,21.9,3,0,1,3,2,2,3,6
"6523",2019-02-08,"Washington Gulch","w1819","Motorized",0,"Fri","weekday","sled","3","2","2",9.2,0,42,-1,10,21.9,3,0,1,3,2,2,3,6
"6524",2019-02-08,"Washington Gulch","w1819","Hybrid",0,"Fri","weekday","sled","3","2","2",9.2,0,42,-1,10,21.9,3,0,1,3,2,2,3,6
"6525",2019-02-09,"Washington Gulch","w1819","Non.motorized",5,"Sat","weekend","no_sled","3","2","2",9.2,0,41,-1,20,22.4,-1,3,0,1,-2,1,1,2
"6526",2019-02-09,"Washington Gulch","w1819","Mechanized",0,"Sat","weekend","no_sled","3","2","2",9.2,0,41,-1,20,22.4,-1,3,0,1,-2,1,1,2
"6527",2019-02-09,"Washington Gulch","w1819","Motorized",0,"Sat","weekend","sled","3","2","2",9.2,0,41,-1,20,22.4,-1,3,0,1,-2,1,1,2
"6528",2019-02-09,"Washington Gulch","w1819","Hybrid",0,"Sat","weekend","sled","3","2","2",9.2,0,41,-1,20,22.4,-1,3,0,1,-2,1,1,2
"6529",2019-02-10,"Washington Gulch","w1819","Non.motorized",0,"Sun","weekend","no_sled","2","2","2",9.3,0.1,40,-1,20,23.2,-1,-1,3,0,-2,-3,0,0
"6530",2019-02-10,"Washington Gulch","w1819","Mechanized",0,"Sun","weekend","no_sled","2","2","2",9.3,0.1,40,-1,20,23.2,-1,-1,3,0,-2,-3,0,0
"6531",2019-02-10,"Washington Gulch","w1819","Motorized",0,"Sun","weekend","sled","2","2","2",9.3,0.1,40,-1,20,23.2,-1,-1,3,0,-2,-3,0,0
"6532",2019-02-10,"Washington Gulch","w1819","Hybrid",0,"Sun","weekend","sled","2","2","2",9.3,0.1,40,-1,20,23.2,-1,-1,3,0,-2,-3,0,0
"6533",2019-02-11,"Washington Gulch","w1819","Non.motorized",0,"Mon","weekday","no_sled","2","2","1",9.3,0,40,0,15,23.2,-1,-1,-1,3,-1,-2,-3,0
"6534",2019-02-11,"Washington Gulch","w1819","Mechanized",0,"Mon","weekday","no_sled","2","2","1",9.3,0,40,0,15,23.2,-1,-1,-1,3,-1,-2,-3,0
"6535",2019-02-11,"Washington Gulch","w1819","Motorized",0,"Mon","weekday","sled","2","2","1",9.3,0,40,0,15,23.2,-1,-1,-1,3,-1,-2,-3,0
"6536",2019-02-11,"Washington Gulch","w1819","Hybrid",0,"Mon","weekday","sled","2","2","1",9.3,0,40,0,15,23.2,-1,-1,-1,3,-1,-2,-3,0
"6537",2019-02-12,"Washington Gulch","w1819","Non.motorized",0,"Tue","weekday","no_sled","2","2","1",9.3,0,40,0,18,23.2,0,-1,-1,-1,0,-1,-2,-3
"6538",2019-02-12,"Washington Gulch","w1819","Mechanized",0,"Tue","weekday","no_sled","2","2","1",9.3,0,40,0,18,23.2,0,-1,-1,-1,0,-1,-2,-3
"6539",2019-02-12,"Washington Gulch","w1819","Motorized",2,"Tue","weekday","sled","2","2","1",9.3,0,40,0,18,23.2,0,-1,-1,-1,0,-1,-2,-3
"6540",2019-02-12,"Washington Gulch","w1819","Hybrid",0,"Tue","weekday","sled","2","2","1",9.3,0,40,0,18,23.2,0,-1,-1,-1,0,-1,-2,-3
"6541",2019-02-13,"Washington Gulch","w1819","Non.motorized",NA,"Wed","weekday","no_sled","2","2","1",9.4,0.1,40,0,26,23.5,0,0,-1,-1,0,0,-1,-2
"6542",2019-02-13,"Washington Gulch","w1819","Mechanized",NA,"Wed","weekday","no_sled","2","2","1",9.4,0.1,40,0,26,23.5,0,0,-1,-1,0,0,-1,-2
"6543",2019-02-13,"Washington Gulch","w1819","Motorized",NA,"Wed","weekday","sled","2","2","1",9.4,0.1,40,0,26,23.5,0,0,-1,-1,0,0,-1,-2
"6544",2019-02-13,"Washington Gulch","w1819","Hybrid",NA,"Wed","weekday","sled","2","2","1",9.4,0.1,40,0,26,23.5,0,0,-1,-1,0,0,-1,-2
"6545",2019-02-14,"Washington Gulch","w1819","Non.motorized",NA,"Thu","weekday","no_sled","3","2","2",9.7,0.3,41,1,29,23.7,0,0,0,-1,1,1,1,0
"6546",2019-02-14,"Washington Gulch","w1819","Mechanized",NA,"Thu","weekday","no_sled","3","2","2",9.7,0.3,41,1,29,23.7,0,0,0,-1,1,1,1,0
"6547",2019-02-14,"Washington Gulch","w1819","Motorized",NA,"Thu","weekday","sled","3","2","2",9.7,0.3,41,1,29,23.7,0,0,0,-1,1,1,1,0
"6548",2019-02-14,"Washington Gulch","w1819","Hybrid",NA,"Thu","weekday","sled","3","2","2",9.7,0.3,41,1,29,23.7,0,0,0,-1,1,1,1,0
"6549",2019-02-15,"Washington Gulch","w1819","Non.motorized",1,"Fri","weekday","no_sled","4","4","3",10.8,1.1,51,10,27,21.2,1,0,0,0,11,11,11,11
"6550",2019-02-15,"Washington Gulch","w1819","Mechanized",0,"Fri","weekday","no_sled","4","4","3",10.8,1.1,51,10,27,21.2,1,0,0,0,11,11,11,11
"6551",2019-02-15,"Washington Gulch","w1819","Motorized",0,"Fri","weekday","sled","4","4","3",10.8,1.1,51,10,27,21.2,1,0,0,0,11,11,11,11
"6552",2019-02-15,"Washington Gulch","w1819","Hybrid",0,"Fri","weekday","sled","4","4","3",10.8,1.1,51,10,27,21.2,1,0,0,0,11,11,11,11
"6553",2019-02-16,"Washington Gulch","w1819","Non.motorized",0,"Sat","weekend","no_sled","3","3","3",11.1,0.3,52,1,14,21.3,10,1,0,0,11,12,12,12
"6554",2019-02-16,"Washington Gulch","w1819","Mechanized",0,"Sat","weekend","no_sled","3","3","3",11.1,0.3,52,1,14,21.3,10,1,0,0,11,12,12,12
"6555",2019-02-16,"Washington Gulch","w1819","Motorized",0,"Sat","weekend","sled","3","3","3",11.1,0.3,52,1,14,21.3,10,1,0,0,11,12,12,12
"6556",2019-02-16,"Washington Gulch","w1819","Hybrid",0,"Sat","weekend","sled","3","3","3",11.1,0.3,52,1,14,21.3,10,1,0,0,11,12,12,12
"6557",2019-02-17,"Washington Gulch","w1819","Non.motorized",0,"Sun","weekend","no_sled","3","3","3",11.3,0.2,55,3,10,20.5,1,10,1,0,4,14,15,15
"6558",2019-02-17,"Washington Gulch","w1819","Mechanized",0,"Sun","weekend","no_sled","3","3","3",11.3,0.2,55,3,10,20.5,1,10,1,0,4,14,15,15
"6559",2019-02-17,"Washington Gulch","w1819","Motorized",0,"Sun","weekend","sled","3","3","3",11.3,0.2,55,3,10,20.5,1,10,1,0,4,14,15,15
"6560",2019-02-17,"Washington Gulch","w1819","Hybrid",0,"Sun","weekend","sled","3","3","3",11.3,0.2,55,3,10,20.5,1,10,1,0,4,14,15,15
"6561",2019-02-18,"Washington Gulch","w1819","Non.motorized",0,"Mon","weekday","no_sled","3","3","2",11.4,0.1,53,-2,13,21.5,3,1,10,1,1,2,12,13
"6562",2019-02-18,"Washington Gulch","w1819","Mechanized",0,"Mon","weekday","no_sled","3","3","2",11.4,0.1,53,-2,13,21.5,3,1,10,1,1,2,12,13
"6563",2019-02-18,"Washington Gulch","w1819","Motorized",0,"Mon","weekday","sled","3","3","2",11.4,0.1,53,-2,13,21.5,3,1,10,1,1,2,12,13
"6564",2019-02-18,"Washington Gulch","w1819","Hybrid",0,"Mon","weekday","sled","3","3","2",11.4,0.1,53,-2,13,21.5,3,1,10,1,1,2,12,13
"6565",2019-02-19,"Washington Gulch","w1819","Non.motorized",0,"Tue","weekday","no_sled","3","3","2",11.5,0.1,53,0,11,21.7,-2,3,1,10,-2,1,2,12
"6566",2019-02-19,"Washington Gulch","w1819","Mechanized",0,"Tue","weekday","no_sled","3","3","2",11.5,0.1,53,0,11,21.7,-2,3,1,10,-2,1,2,12
"6567",2019-02-19,"Washington Gulch","w1819","Motorized",0,"Tue","weekday","sled","3","3","2",11.5,0.1,53,0,11,21.7,-2,3,1,10,-2,1,2,12
"6568",2019-02-19,"Washington Gulch","w1819","Hybrid",0,"Tue","weekday","sled","3","3","2",11.5,0.1,53,0,11,21.7,-2,3,1,10,-2,1,2,12
"6569",2019-02-20,"Washington Gulch","w1819","Non.motorized",0,"Wed","weekday","no_sled","3","3","2",11.6,0.1,53,0,7,21.9,0,-2,3,1,0,-2,1,2
"6570",2019-02-20,"Washington Gulch","w1819","Mechanized",0,"Wed","weekday","no_sled","3","3","2",11.6,0.1,53,0,7,21.9,0,-2,3,1,0,-2,1,2
"6571",2019-02-20,"Washington Gulch","w1819","Motorized",0,"Wed","weekday","sled","3","3","2",11.6,0.1,53,0,7,21.9,0,-2,3,1,0,-2,1,2
"6572",2019-02-20,"Washington Gulch","w1819","Hybrid",0,"Wed","weekday","sled","3","3","2",11.6,0.1,53,0,7,21.9,0,-2,3,1,0,-2,1,2
"6573",2019-02-21,"Washington Gulch","w1819","Non.motorized",0,"Thu","weekday","no_sled","3","3","3",11.6,0,52,-1,15,22.3,0,0,-2,3,-1,-1,-3,0
"6574",2019-02-21,"Washington Gulch","w1819","Mechanized",0,"Thu","weekday","no_sled","3","3","3",11.6,0,52,-1,15,22.3,0,0,-2,3,-1,-1,-3,0
"6575",2019-02-21,"Washington Gulch","w1819","Motorized",0,"Thu","weekday","sled","3","3","3",11.6,0,52,-1,15,22.3,0,0,-2,3,-1,-1,-3,0
"6576",2019-02-21,"Washington Gulch","w1819","Hybrid",0,"Thu","weekday","sled","3","3","3",11.6,0,52,-1,15,22.3,0,0,-2,3,-1,-1,-3,0
"6577",2019-02-22,"Washington Gulch","w1819","Non.motorized",0,"Fri","weekday","no_sled","3","3","3",11.8,0.2,52,0,20,22.7,-1,0,0,-2,-1,-1,-1,-3
"6578",2019-02-22,"Washington Gulch","w1819","Mechanized",0,"Fri","weekday","no_sled","3","3","3",11.8,0.2,52,0,20,22.7,-1,0,0,-2,-1,-1,-1,-3
"6579",2019-02-22,"Washington Gulch","w1819","Motorized",0,"Fri","weekday","sled","3","3","3",11.8,0.2,52,0,20,22.7,-1,0,0,-2,-1,-1,-1,-3
"6580",2019-02-22,"Washington Gulch","w1819","Hybrid",0,"Fri","weekday","sled","3","3","3",11.8,0.2,52,0,20,22.7,-1,0,0,-2,-1,-1,-1,-3
"6581",2019-02-23,"Washington Gulch","w1819","Non.motorized",11,"Sat","weekend","no_sled","3","3","3",12.1,0.3,53,1,13,22.8,0,-1,0,0,1,0,0,0
"6582",2019-02-23,"Washington Gulch","w1819","Mechanized",0,"Sat","weekend","no_sled","3","3","3",12.1,0.3,53,1,13,22.8,0,-1,0,0,1,0,0,0
"6583",2019-02-23,"Washington Gulch","w1819","Motorized",13,"Sat","weekend","sled","3","3","3",12.1,0.3,53,1,13,22.8,0,-1,0,0,1,0,0,0
"6584",2019-02-23,"Washington Gulch","w1819","Hybrid",6,"Sat","weekend","sled","3","3","3",12.1,0.3,53,1,13,22.8,0,-1,0,0,1,0,0,0
"6585",2019-02-24,"Washington Gulch","w1819","Non.motorized",24,"Sun","weekend","no_sled","3","3","2",12.1,0,52,-1,14,23.3,1,0,-1,0,0,0,-1,-1
"6586",2019-02-24,"Washington Gulch","w1819","Mechanized",0,"Sun","weekend","no_sled","3","3","2",12.1,0,52,-1,14,23.3,1,0,-1,0,0,0,-1,-1
"6587",2019-02-24,"Washington Gulch","w1819","Motorized",4,"Sun","weekend","sled","3","3","2",12.1,0,52,-1,14,23.3,1,0,-1,0,0,0,-1,-1
"6588",2019-02-24,"Washington Gulch","w1819","Hybrid",2,"Sun","weekend","sled","3","3","2",12.1,0,52,-1,14,23.3,1,0,-1,0,0,0,-1,-1
"6589",2019-02-25,"Washington Gulch","w1819","Non.motorized",11,"Mon","weekday","no_sled","3","3","2",12.1,0,51,-1,22,23.7,-1,1,0,-1,-2,-1,-1,-2
"6590",2019-02-25,"Washington Gulch","w1819","Mechanized",0,"Mon","weekday","no_sled","3","3","2",12.1,0,51,-1,22,23.7,-1,1,0,-1,-2,-1,-1,-2
"6591",2019-02-25,"Washington Gulch","w1819","Motorized",3,"Mon","weekday","sled","3","3","2",12.1,0,51,-1,22,23.7,-1,1,0,-1,-2,-1,-1,-2
"6592",2019-02-25,"Washington Gulch","w1819","Hybrid",0,"Mon","weekday","sled","3","3","2",12.1,0,51,-1,22,23.7,-1,1,0,-1,-2,-1,-1,-2
"6593",2019-02-26,"Washington Gulch","w1819","Non.motorized",38,"Tue","weekday","no_sled","2","2","2",12.1,0,50,-1,27,24.2,-1,-1,1,0,-2,-3,-2,-2
"6594",2019-02-26,"Washington Gulch","w1819","Mechanized",0,"Tue","weekday","no_sled","2","2","2",12.1,0,50,-1,27,24.2,-1,-1,1,0,-2,-3,-2,-2
"6595",2019-02-26,"Washington Gulch","w1819","Motorized",7,"Tue","weekday","sled","2","2","2",12.1,0,50,-1,27,24.2,-1,-1,1,0,-2,-3,-2,-2
"6596",2019-02-26,"Washington Gulch","w1819","Hybrid",1,"Tue","weekday","sled","2","2","2",12.1,0,50,-1,27,24.2,-1,-1,1,0,-2,-3,-2,-2
"6597",2019-02-27,"Washington Gulch","w1819","Non.motorized",49,"Wed","weekday","no_sled","2","2","2",12.1,0,50,0,30,24.2,-1,-1,-1,1,-1,-2,-3,-2
"6598",2019-02-27,"Washington Gulch","w1819","Mechanized",0,"Wed","weekday","no_sled","2","2","2",12.1,0,50,0,30,24.2,-1,-1,-1,1,-1,-2,-3,-2
"6599",2019-02-27,"Washington Gulch","w1819","Motorized",0,"Wed","weekday","sled","2","2","2",12.1,0,50,0,30,24.2,-1,-1,-1,1,-1,-2,-3,-2
"6600",2019-02-27,"Washington Gulch","w1819","Hybrid",0,"Wed","weekday","sled","2","2","2",12.1,0,50,0,30,24.2,-1,-1,-1,1,-1,-2,-3,-2
"6601",2019-02-28,"Washington Gulch","w1819","Non.motorized",8,"Thu","weekday","no_sled","2","2","2",12.2,0.1,49,-1,30,24.9,0,-1,-1,-1,-1,-2,-3,-4
"6602",2019-02-28,"Washington Gulch","w1819","Mechanized",0,"Thu","weekday","no_sled","2","2","2",12.2,0.1,49,-1,30,24.9,0,-1,-1,-1,-1,-2,-3,-4
"6603",2019-02-28,"Washington Gulch","w1819","Motorized",2,"Thu","weekday","sled","2","2","2",12.2,0.1,49,-1,30,24.9,0,-1,-1,-1,-1,-2,-3,-4
"6604",2019-02-28,"Washington Gulch","w1819","Hybrid",2,"Thu","weekday","sled","2","2","2",12.2,0.1,49,-1,30,24.9,0,-1,-1,-1,-1,-2,-3,-4
"6605",2019-03-01,"Washington Gulch","w1819","Non.motorized",7,"Fri","weekday","no_sled","2","2","1",12.3,0.1,49,0,29,25.1,-1,0,-1,-1,-1,-1,-2,-3
"6606",2019-03-01,"Washington Gulch","w1819","Mechanized",0,"Fri","weekday","no_sled","2","2","1",12.3,0.1,49,0,29,25.1,-1,0,-1,-1,-1,-1,-2,-3
"6607",2019-03-01,"Washington Gulch","w1819","Motorized",0,"Fri","weekday","sled","2","2","1",12.3,0.1,49,0,29,25.1,-1,0,-1,-1,-1,-1,-2,-3
"6608",2019-03-01,"Washington Gulch","w1819","Hybrid",0,"Fri","weekday","sled","2","2","1",12.3,0.1,49,0,29,25.1,-1,0,-1,-1,-1,-1,-2,-3
"6609",2019-03-02,"Washington Gulch","w1819","Non.motorized",0,"Sat","weekend","no_sled","3","3","2",13,0.7,58,9,30,22.4,0,-1,0,-1,9,8,8,7
"6610",2019-03-02,"Washington Gulch","w1819","Mechanized",0,"Sat","weekend","no_sled","3","3","2",13,0.7,58,9,30,22.4,0,-1,0,-1,9,8,8,7
"6611",2019-03-02,"Washington Gulch","w1819","Motorized",0,"Sat","weekend","sled","3","3","2",13,0.7,58,9,30,22.4,0,-1,0,-1,9,8,8,7
"6612",2019-03-02,"Washington Gulch","w1819","Hybrid",0,"Sat","weekend","sled","3","3","2",13,0.7,58,9,30,22.4,0,-1,0,-1,9,8,8,7
"6613",2019-03-03,"Washington Gulch","w1819","Non.motorized",0,"Sun","weekend","no_sled","3","3","3",13.7,0.7,64,6,27,21.4,9,0,-1,0,15,15,14,14
"6614",2019-03-03,"Washington Gulch","w1819","Mechanized",0,"Sun","weekend","no_sled","3","3","3",13.7,0.7,64,6,27,21.4,9,0,-1,0,15,15,14,14
"6615",2019-03-03,"Washington Gulch","w1819","Motorized",0,"Sun","weekend","sled","3","3","3",13.7,0.7,64,6,27,21.4,9,0,-1,0,15,15,14,14
"6616",2019-03-03,"Washington Gulch","w1819","Hybrid",0,"Sun","weekend","sled","3","3","3",13.7,0.7,64,6,27,21.4,9,0,-1,0,15,15,14,14
"6617",2019-03-04,"Washington Gulch","w1819","Non.motorized",4,"Mon","weekday","no_sled","3","3","3",14.4,0.7,66,2,23,21.8,6,9,0,-1,8,17,17,16
"6618",2019-03-04,"Washington Gulch","w1819","Mechanized",0,"Mon","weekday","no_sled","3","3","3",14.4,0.7,66,2,23,21.8,6,9,0,-1,8,17,17,16
"6619",2019-03-04,"Washington Gulch","w1819","Motorized",0,"Mon","weekday","sled","3","3","3",14.4,0.7,66,2,23,21.8,6,9,0,-1,8,17,17,16
"6620",2019-03-04,"Washington Gulch","w1819","Hybrid",0,"Mon","weekday","sled","3","3","3",14.4,0.7,66,2,23,21.8,6,9,0,-1,8,17,17,16
"6621",2019-03-05,"Washington Gulch","w1819","Non.motorized",12,"Tue","weekday","no_sled","3","3","3",14.4,0,64,-2,24,22.5,2,6,9,0,0,6,15,15
"6622",2019-03-05,"Washington Gulch","w1819","Mechanized",0,"Tue","weekday","no_sled","3","3","3",14.4,0,64,-2,24,22.5,2,6,9,0,0,6,15,15
"6623",2019-03-05,"Washington Gulch","w1819","Motorized",14,"Tue","weekday","sled","3","3","3",14.4,0,64,-2,24,22.5,2,6,9,0,0,6,15,15
"6624",2019-03-05,"Washington Gulch","w1819","Hybrid",8,"Tue","weekday","sled","3","3","3",14.4,0,64,-2,24,22.5,2,6,9,0,0,6,15,15
"6625",2019-03-06,"Washington Gulch","w1819","Non.motorized",12,"Wed","weekday","no_sled","3","3","2",14.5,0.1,62,-2,31,23.4,-2,2,6,9,-4,-2,4,13
"6626",2019-03-06,"Washington Gulch","w1819","Non.motorized",12,"Wed","weekday","no_sled","4","4","3",14.5,0.1,62,-2,31,23.4,-2,2,6,9,-4,-2,4,13
"6627",2019-03-06,"Washington Gulch","w1819","Mechanized",0,"Wed","weekday","no_sled","3","3","2",14.5,0.1,62,-2,31,23.4,-2,2,6,9,-4,-2,4,13
"6628",2019-03-06,"Washington Gulch","w1819","Mechanized",0,"Wed","weekday","no_sled","4","4","3",14.5,0.1,62,-2,31,23.4,-2,2,6,9,-4,-2,4,13
"6629",2019-03-06,"Washington Gulch","w1819","Motorized",0,"Wed","weekday","sled","3","3","2",14.5,0.1,62,-2,31,23.4,-2,2,6,9,-4,-2,4,13
"6630",2019-03-06,"Washington Gulch","w1819","Motorized",0,"Wed","weekday","sled","4","4","3",14.5,0.1,62,-2,31,23.4,-2,2,6,9,-4,-2,4,13
"6631",2019-03-06,"Washington Gulch","w1819","Hybrid",0,"Wed","weekday","sled","3","3","2",14.5,0.1,62,-2,31,23.4,-2,2,6,9,-4,-2,4,13
"6632",2019-03-06,"Washington Gulch","w1819","Hybrid",0,"Wed","weekday","sled","4","4","3",14.5,0.1,62,-2,31,23.4,-2,2,6,9,-4,-2,4,13
"6633",2019-03-07,"Washington Gulch","w1819","Non.motorized",0,"Thu","weekday","no_sled","4","4","3",16.2,1.7,71,9,30,22.8,-2,-2,2,6,7,5,7,13
"6634",2019-03-07,"Washington Gulch","w1819","Mechanized",0,"Thu","weekday","no_sled","4","4","3",16.2,1.7,71,9,30,22.8,-2,-2,2,6,7,5,7,13
"6635",2019-03-07,"Washington Gulch","w1819","Motorized",0,"Thu","weekday","sled","4","4","3",16.2,1.7,71,9,30,22.8,-2,-2,2,6,7,5,7,13
"6636",2019-03-07,"Washington Gulch","w1819","Hybrid",0,"Thu","weekday","sled","4","4","3",16.2,1.7,71,9,30,22.8,-2,-2,2,6,7,5,7,13
"6637",2019-03-08,"Washington Gulch","w1819","Non.motorized",0,"Fri","weekday","no_sled","3","3","3",16.6,0.4,71,0,27,23.4,9,-2,-2,2,9,7,5,7
"6638",2019-03-08,"Washington Gulch","w1819","Mechanized",0,"Fri","weekday","no_sled","3","3","3",16.6,0.4,71,0,27,23.4,9,-2,-2,2,9,7,5,7
"6639",2019-03-08,"Washington Gulch","w1819","Motorized",3,"Fri","weekday","sled","3","3","3",16.6,0.4,71,0,27,23.4,9,-2,-2,2,9,7,5,7
"6640",2019-03-08,"Washington Gulch","w1819","Hybrid",1,"Fri","weekday","sled","3","3","3",16.6,0.4,71,0,27,23.4,9,-2,-2,2,9,7,5,7
"6641",2019-03-09,"Washington Gulch","w1819","Non.motorized",37,"Sat","weekend","no_sled","4","4","3",17.2,0.6,76,5,22,22.6,0,9,-2,-2,5,14,12,10
"6642",2019-03-09,"Washington Gulch","w1819","Mechanized",0,"Sat","weekend","no_sled","4","4","3",17.2,0.6,76,5,22,22.6,0,9,-2,-2,5,14,12,10
"6643",2019-03-09,"Washington Gulch","w1819","Motorized",5,"Sat","weekend","sled","4","4","3",17.2,0.6,76,5,22,22.6,0,9,-2,-2,5,14,12,10
"6644",2019-03-09,"Washington Gulch","w1819","Hybrid",0,"Sat","weekend","sled","4","4","3",17.2,0.6,76,5,22,22.6,0,9,-2,-2,5,14,12,10
"6645",2019-03-10,"Washington Gulch","w1819","Non.motorized",44,"Sun","weekend","no_sled","3","3","3",17.3,0.1,73,-3,25,23.7,5,0,9,-2,2,2,11,9
"6646",2019-03-10,"Washington Gulch","w1819","Mechanized",0,"Sun","weekend","no_sled","3","3","3",17.3,0.1,73,-3,25,23.7,5,0,9,-2,2,2,11,9
"6647",2019-03-10,"Washington Gulch","w1819","Motorized",8,"Sun","weekend","sled","3","3","3",17.3,0.1,73,-3,25,23.7,5,0,9,-2,2,2,11,9
"6648",2019-03-10,"Washington Gulch","w1819","Hybrid",2,"Sun","weekend","sled","3","3","3",17.3,0.1,73,-3,25,23.7,5,0,9,-2,2,2,11,9
"6649",2019-03-11,"Washington Gulch","w1819","Non.motorized",11,"Mon","weekday","no_sled","3","3","2",17.3,0,71,-2,29,24.4,-3,5,0,9,-5,0,0,9
"6650",2019-03-11,"Washington Gulch","w1819","Mechanized",0,"Mon","weekday","no_sled","3","3","2",17.3,0,71,-2,29,24.4,-3,5,0,9,-5,0,0,9
"6651",2019-03-11,"Washington Gulch","w1819","Motorized",0,"Mon","weekday","sled","3","3","2",17.3,0,71,-2,29,24.4,-3,5,0,9,-5,0,0,9
"6652",2019-03-11,"Washington Gulch","w1819","Hybrid",0,"Mon","weekday","sled","3","3","2",17.3,0,71,-2,29,24.4,-3,5,0,9,-5,0,0,9
"6653",2019-03-12,"Washington Gulch","w1819","Non.motorized",0,"Tue","weekday","no_sled","3","3","3",17.4,0.1,70,-1,32,24.9,-2,-3,5,0,-3,-6,-1,-1
"6654",2019-03-12,"Washington Gulch","w1819","Non.motorized",0,"Tue","weekday","no_sled","4","4","4",17.4,0.1,70,-1,32,24.9,-2,-3,5,0,-3,-6,-1,-1
"6655",2019-03-12,"Washington Gulch","w1819","Mechanized",0,"Tue","weekday","no_sled","3","3","3",17.4,0.1,70,-1,32,24.9,-2,-3,5,0,-3,-6,-1,-1
"6656",2019-03-12,"Washington Gulch","w1819","Mechanized",0,"Tue","weekday","no_sled","4","4","4",17.4,0.1,70,-1,32,24.9,-2,-3,5,0,-3,-6,-1,-1
"6657",2019-03-12,"Washington Gulch","w1819","Motorized",0,"Tue","weekday","sled","3","3","3",17.4,0.1,70,-1,32,24.9,-2,-3,5,0,-3,-6,-1,-1
"6658",2019-03-12,"Washington Gulch","w1819","Motorized",0,"Tue","weekday","sled","4","4","4",17.4,0.1,70,-1,32,24.9,-2,-3,5,0,-3,-6,-1,-1
"6659",2019-03-12,"Washington Gulch","w1819","Hybrid",0,"Tue","weekday","sled","3","3","3",17.4,0.1,70,-1,32,24.9,-2,-3,5,0,-3,-6,-1,-1
"6660",2019-03-12,"Washington Gulch","w1819","Hybrid",0,"Tue","weekday","sled","4","4","4",17.4,0.1,70,-1,32,24.9,-2,-3,5,0,-3,-6,-1,-1
"6661",2019-03-13,"Washington Gulch","w1819","Non.motorized",0,"Wed","weekday","no_sled","4","4","3",18.1,0.7,74,4,24,24.5,-1,-2,-3,5,3,1,-2,3
"6662",2019-03-13,"Washington Gulch","w1819","Mechanized",0,"Wed","weekday","no_sled","4","4","3",18.1,0.7,74,4,24,24.5,-1,-2,-3,5,3,1,-2,3
"6663",2019-03-13,"Washington Gulch","w1819","Motorized",0,"Wed","weekday","sled","4","4","3",18.1,0.7,74,4,24,24.5,-1,-2,-3,5,3,1,-2,3
"6664",2019-03-13,"Washington Gulch","w1819","Hybrid",0,"Wed","weekday","sled","4","4","3",18.1,0.7,74,4,24,24.5,-1,-2,-3,5,3,1,-2,3
"6665",2019-03-14,"Washington Gulch","w1819","Non.motorized",0,"Thu","weekday","no_sled","4","4","3",18.1,0,74,0,17,24.5,4,-1,-2,-3,4,3,1,-2
"6666",2019-03-14,"Washington Gulch","w1819","Mechanized",0,"Thu","weekday","no_sled","4","4","3",18.1,0,74,0,17,24.5,4,-1,-2,-3,4,3,1,-2
"6667",2019-03-14,"Washington Gulch","w1819","Motorized",0,"Thu","weekday","sled","4","4","3",18.1,0,74,0,17,24.5,4,-1,-2,-3,4,3,1,-2
"6668",2019-03-14,"Washington Gulch","w1819","Hybrid",0,"Thu","weekday","sled","4","4","3",18.1,0,74,0,17,24.5,4,-1,-2,-3,4,3,1,-2
"6669",2019-03-15,"Washington Gulch","w1819","Non.motorized",19,"Fri","weekday","no_sled","3","3","2",18.1,0,72,-2,18,25.1,0,4,-1,-2,-2,2,1,-1
"6670",2019-03-15,"Washington Gulch","w1819","Mechanized",0,"Fri","weekday","no_sled","3","3","2",18.1,0,72,-2,18,25.1,0,4,-1,-2,-2,2,1,-1
"6671",2019-03-15,"Washington Gulch","w1819","Motorized",13,"Fri","weekday","sled","3","3","2",18.1,0,72,-2,18,25.1,0,4,-1,-2,-2,2,1,-1
"6672",2019-03-15,"Washington Gulch","w1819","Hybrid",0,"Fri","weekday","sled","3","3","2",18.1,0,72,-2,18,25.1,0,4,-1,-2,-2,2,1,-1
"6673",2019-03-16,"Washington Gulch","w1819","Non.motorized",60,"Sat","weekend","no_sled","3","3","2",18.2,0.1,70,-2,26,26,-2,0,4,-1,-4,-4,0,-1
"6674",2019-03-16,"Washington Gulch","w1819","Mechanized",0,"Sat","weekend","no_sled","3","3","2",18.2,0.1,70,-2,26,26,-2,0,4,-1,-4,-4,0,-1
"6675",2019-03-16,"Washington Gulch","w1819","Motorized",17,"Sat","weekend","sled","3","3","2",18.2,0.1,70,-2,26,26,-2,0,4,-1,-4,-4,0,-1
"6676",2019-03-16,"Washington Gulch","w1819","Hybrid",0,"Sat","weekend","sled","3","3","2",18.2,0.1,70,-2,26,26,-2,0,4,-1,-4,-4,0,-1
"6677",2019-03-17,"Washington Gulch","w1819","Non.motorized",43,"Sun","weekend","no_sled","3","3","2",18.2,0,69,-1,28,26.4,-2,-2,0,4,-3,-5,-5,-1
"6678",2019-03-17,"Washington Gulch","w1819","Mechanized",0,"Sun","weekend","no_sled","3","3","2",18.2,0,69,-1,28,26.4,-2,-2,0,4,-3,-5,-5,-1
"6679",2019-03-17,"Washington Gulch","w1819","Motorized",24,"Sun","weekend","sled","3","3","2",18.2,0,69,-1,28,26.4,-2,-2,0,4,-3,-5,-5,-1
"6680",2019-03-17,"Washington Gulch","w1819","Hybrid",0,"Sun","weekend","sled","3","3","2",18.2,0,69,-1,28,26.4,-2,-2,0,4,-3,-5,-5,-1
"6681",2019-03-18,"Washington Gulch","w1819","Non.motorized",19,"Mon","weekday","no_sled","2","2","2",18.3,0.1,68,-1,29,26.9,-1,-2,-2,0,-2,-4,-6,-6
"6682",2019-03-18,"Washington Gulch","w1819","Mechanized",0,"Mon","weekday","no_sled","2","2","2",18.3,0.1,68,-1,29,26.9,-1,-2,-2,0,-2,-4,-6,-6
"6683",2019-03-18,"Washington Gulch","w1819","Motorized",13,"Mon","weekday","sled","2","2","2",18.3,0.1,68,-1,29,26.9,-1,-2,-2,0,-2,-4,-6,-6
"6684",2019-03-18,"Washington Gulch","w1819","Hybrid",0,"Mon","weekday","sled","2","2","2",18.3,0.1,68,-1,29,26.9,-1,-2,-2,0,-2,-4,-6,-6
"6685",2019-03-19,"Washington Gulch","w1819","Non.motorized",0,"Tue","weekday","no_sled","2","2","2",18.3,0,67,-1,28,27.3,-1,-1,-2,-2,-2,-3,-5,-7
"6686",2019-03-19,"Washington Gulch","w1819","Mechanized",0,"Tue","weekday","no_sled","2","2","2",18.3,0,67,-1,28,27.3,-1,-1,-2,-2,-2,-3,-5,-7
"6687",2019-03-19,"Washington Gulch","w1819","Motorized",0,"Tue","weekday","sled","2","2","2",18.3,0,67,-1,28,27.3,-1,-1,-2,-2,-2,-3,-5,-7
"6688",2019-03-19,"Washington Gulch","w1819","Hybrid",0,"Tue","weekday","sled","2","2","2",18.3,0,67,-1,28,27.3,-1,-1,-2,-2,-2,-3,-5,-7
"6689",2019-03-20,"Washington Gulch","w1819","Non.motorized",0,"Wed","weekday","no_sled","2","2","2",18.3,0,66,-1,30,27.7,-1,-1,-1,-2,-2,-3,-4,-6
"6690",2019-03-20,"Washington Gulch","w1819","Mechanized",0,"Wed","weekday","no_sled","2","2","2",18.3,0,66,-1,30,27.7,-1,-1,-1,-2,-2,-3,-4,-6
"6691",2019-03-20,"Washington Gulch","w1819","Motorized",0,"Wed","weekday","sled","2","2","2",18.3,0,66,-1,30,27.7,-1,-1,-1,-2,-2,-3,-4,-6
"6692",2019-03-20,"Washington Gulch","w1819","Hybrid",0,"Wed","weekday","sled","2","2","2",18.3,0,66,-1,30,27.7,-1,-1,-1,-2,-2,-3,-4,-6
"6693",2019-03-21,"Washington Gulch","w1819","Non.motorized",0,"Thu","weekday","no_sled","2","2","2",18.4,0.1,65,-1,33,28.3,-1,-1,-1,-1,-2,-3,-4,-5
"6694",2019-03-21,"Washington Gulch","w1819","Mechanized",0,"Thu","weekday","no_sled","2","2","2",18.4,0.1,65,-1,33,28.3,-1,-1,-1,-1,-2,-3,-4,-5
"6695",2019-03-21,"Washington Gulch","w1819","Motorized",0,"Thu","weekday","sled","2","2","2",18.4,0.1,65,-1,33,28.3,-1,-1,-1,-1,-2,-3,-4,-5
"6696",2019-03-21,"Washington Gulch","w1819","Hybrid",0,"Thu","weekday","sled","2","2","2",18.4,0.1,65,-1,33,28.3,-1,-1,-1,-1,-2,-3,-4,-5
"6697",2019-03-22,"Washington Gulch","w1819","Non.motorized",0,"Fri","weekday","no_sled","3","3","2",18.4,0,64,-1,28,28.8,-1,-1,-1,-1,-2,-3,-4,-5
"6698",2019-03-22,"Washington Gulch","w1819","Mechanized",0,"Fri","weekday","no_sled","3","3","2",18.4,0,64,-1,28,28.8,-1,-1,-1,-1,-2,-3,-4,-5
"6699",2019-03-22,"Washington Gulch","w1819","Motorized",0,"Fri","weekday","sled","3","3","2",18.4,0,64,-1,28,28.8,-1,-1,-1,-1,-2,-3,-4,-5
"6700",2019-03-22,"Washington Gulch","w1819","Hybrid",0,"Fri","weekday","sled","3","3","2",18.4,0,64,-1,28,28.8,-1,-1,-1,-1,-2,-3,-4,-5
"6701",2019-03-23,"Washington Gulch","w1819","Non.motorized",0,"Sat","weekend","no_sled","2","2","1",18.4,0,65,1,28,28.3,-1,-1,-1,-1,0,-1,-2,-3
"6702",2019-03-23,"Washington Gulch","w1819","Mechanized",0,"Sat","weekend","no_sled","2","2","1",18.4,0,65,1,28,28.3,-1,-1,-1,-1,0,-1,-2,-3
"6703",2019-03-23,"Washington Gulch","w1819","Motorized",0,"Sat","weekend","sled","2","2","1",18.4,0,65,1,28,28.3,-1,-1,-1,-1,0,-1,-2,-3
"6704",2019-03-23,"Washington Gulch","w1819","Hybrid",0,"Sat","weekend","sled","2","2","1",18.4,0,65,1,28,28.3,-1,-1,-1,-1,0,-1,-2,-3
"6705",2019-03-24,"Washington Gulch","w1819","Non.motorized",0,"Sun","weekend","no_sled","2","2","1",18.4,0,64,-1,29,28.8,1,-1,-1,-1,0,-1,-2,-3
"6706",2019-03-24,"Washington Gulch","w1819","Mechanized",0,"Sun","weekend","no_sled","2","2","1",18.4,0,64,-1,29,28.8,1,-1,-1,-1,0,-1,-2,-3
"6707",2019-03-24,"Washington Gulch","w1819","Motorized",0,"Sun","weekend","sled","2","2","1",18.4,0,64,-1,29,28.8,1,-1,-1,-1,0,-1,-2,-3
"6708",2019-03-24,"Washington Gulch","w1819","Hybrid",0,"Sun","weekend","sled","2","2","1",18.4,0,64,-1,29,28.8,1,-1,-1,-1,0,-1,-2,-3
"6709",2019-03-25,"Washington Gulch","w1819","Non.motorized",4,"Mon","weekday","no_sled","2","2","2",18.6,0.2,64,0,31,29.1,-1,1,-1,-1,-1,0,-1,-2
"6710",2019-03-25,"Washington Gulch","w1819","Mechanized",0,"Mon","weekday","no_sled","2","2","2",18.6,0.2,64,0,31,29.1,-1,1,-1,-1,-1,0,-1,-2
"6711",2019-03-25,"Washington Gulch","w1819","Motorized",1,"Mon","weekday","sled","2","2","2",18.6,0.2,64,0,31,29.1,-1,1,-1,-1,-1,0,-1,-2
"6712",2019-03-25,"Washington Gulch","w1819","Hybrid",0,"Mon","weekday","sled","2","2","2",18.6,0.2,64,0,31,29.1,-1,1,-1,-1,-1,0,-1,-2
"6713",2019-03-26,"Washington Gulch","w1819","Non.motorized",20,"Tue","weekday","no_sled","2","2","2",18.9,0.3,63,-1,36,30,0,-1,1,-1,-1,-2,-1,-2
"6714",2019-03-26,"Washington Gulch","w1819","Mechanized",0,"Tue","weekday","no_sled","2","2","2",18.9,0.3,63,-1,36,30,0,-1,1,-1,-1,-2,-1,-2
"6715",2019-03-26,"Washington Gulch","w1819","Motorized",0,"Tue","weekday","sled","2","2","2",18.9,0.3,63,-1,36,30,0,-1,1,-1,-1,-2,-1,-2
"6716",2019-03-26,"Washington Gulch","w1819","Hybrid",0,"Tue","weekday","sled","2","2","2",18.9,0.3,63,-1,36,30,0,-1,1,-1,-1,-2,-1,-2
"6717",2019-03-27,"Washington Gulch","w1819","Non.motorized",22,"Wed","weekday","no_sled","1","2","2",18.9,0,62,-1,42,30.5,-1,0,-1,1,-2,-2,-3,-2
"6718",2019-03-27,"Washington Gulch","w1819","Mechanized",0,"Wed","weekday","no_sled","1","2","2",18.9,0,62,-1,42,30.5,-1,0,-1,1,-2,-2,-3,-2
"6719",2019-03-27,"Washington Gulch","w1819","Motorized",2,"Wed","weekday","sled","1","2","2",18.9,0,62,-1,42,30.5,-1,0,-1,1,-2,-2,-3,-2
"6720",2019-03-27,"Washington Gulch","w1819","Hybrid",0,"Wed","weekday","sled","1","2","2",18.9,0,62,-1,42,30.5,-1,0,-1,1,-2,-2,-3,-2
"6721",2019-03-28,"Washington Gulch","w1819","Non.motorized",13,"Thu","weekday","no_sled","1","2","2",18.9,0,60,-2,40,31.5,-1,-1,0,-1,-3,-4,-4,-5
"6722",2019-03-28,"Washington Gulch","w1819","Mechanized",0,"Thu","weekday","no_sled","1","2","2",18.9,0,60,-2,40,31.5,-1,-1,0,-1,-3,-4,-4,-5
"6723",2019-03-28,"Washington Gulch","w1819","Motorized",5,"Thu","weekday","sled","1","2","2",18.9,0,60,-2,40,31.5,-1,-1,0,-1,-3,-4,-4,-5
"6724",2019-03-28,"Washington Gulch","w1819","Hybrid",0,"Thu","weekday","sled","1","2","2",18.9,0,60,-2,40,31.5,-1,-1,0,-1,-3,-4,-4,-5
"6725",2019-03-29,"Washington Gulch","w1819","Non.motorized",15,"Fri","weekday","no_sled","1","1","1",19,0.1,58,-2,26,32.8,-2,-1,-1,0,-4,-5,-6,-6
"6726",2019-03-29,"Washington Gulch","w1819","Mechanized",0,"Fri","weekday","no_sled","1","1","1",19,0.1,58,-2,26,32.8,-2,-1,-1,0,-4,-5,-6,-6
"6727",2019-03-29,"Washington Gulch","w1819","Motorized",0,"Fri","weekday","sled","1","1","1",19,0.1,58,-2,26,32.8,-2,-1,-1,0,-4,-5,-6,-6
"6728",2019-03-29,"Washington Gulch","w1819","Hybrid",0,"Fri","weekday","sled","1","1","1",19,0.1,58,-2,26,32.8,-2,-1,-1,0,-4,-5,-6,-6
"6729",2019-03-30,"Washington Gulch","w1819","Non.motorized",48,"Sat","weekend","no_sled","1","1","1",19.1,0.1,61,3,24,31.3,-2,-2,-1,-1,1,-1,-2,-3
"6730",2019-03-30,"Washington Gulch","w1819","Mechanized",0,"Sat","weekend","no_sled","1","1","1",19.1,0.1,61,3,24,31.3,-2,-2,-1,-1,1,-1,-2,-3
"6731",2019-03-30,"Washington Gulch","w1819","Motorized",2,"Sat","weekend","sled","1","1","1",19.1,0.1,61,3,24,31.3,-2,-2,-1,-1,1,-1,-2,-3
"6732",2019-03-30,"Washington Gulch","w1819","Hybrid",1,"Sat","weekend","sled","1","1","1",19.1,0.1,61,3,24,31.3,-2,-2,-1,-1,1,-1,-2,-3
"6733",2019-03-31,"Washington Gulch","w1819","Non.motorized",19,"Sun","weekend","no_sled","1","1","1",19.1,0,59,-2,24,32.4,3,-2,-2,-1,1,-1,-3,-4
"6734",2019-03-31,"Washington Gulch","w1819","Mechanized",0,"Sun","weekend","no_sled","1","1","1",19.1,0,59,-2,24,32.4,3,-2,-2,-1,1,-1,-3,-4
"6735",2019-03-31,"Washington Gulch","w1819","Motorized",0,"Sun","weekend","sled","1","1","1",19.1,0,59,-2,24,32.4,3,-2,-2,-1,1,-1,-3,-4
"6736",2019-03-31,"Washington Gulch","w1819","Hybrid",0,"Sun","weekend","sled","1","1","1",19.1,0,59,-2,24,32.4,3,-2,-2,-1,1,-1,-3,-4
"6737",2019-04-01,"Washington Gulch","w1819","Non.motorized",10,"Mon","weekday","no_sled","2","1","1",19.1,0,58,-1,29,32.9,-2,3,-2,-2,-3,0,-2,-4
"6738",2019-04-01,"Washington Gulch","w1819","Mechanized",0,"Mon","weekday","no_sled","2","1","1",19.1,0,58,-1,29,32.9,-2,3,-2,-2,-3,0,-2,-4
"6739",2019-04-01,"Washington Gulch","w1819","Motorized",5,"Mon","weekday","sled","2","1","1",19.1,0,58,-1,29,32.9,-2,3,-2,-2,-3,0,-2,-4
"6740",2019-04-01,"Washington Gulch","w1819","Hybrid",1,"Mon","weekday","sled","2","1","1",19.1,0,58,-1,29,32.9,-2,3,-2,-2,-3,0,-2,-4
"6741",2019-04-02,"Washington Gulch","w1819","Non.motorized",13,"Tue","weekday","no_sled","1","1","1",19.1,0,58,0,33,32.9,-1,-2,3,-2,-1,-3,0,-2
"6742",2019-04-02,"Washington Gulch","w1819","Mechanized",0,"Tue","weekday","no_sled","1","1","1",19.1,0,58,0,33,32.9,-1,-2,3,-2,-1,-3,0,-2
"6743",2019-04-02,"Washington Gulch","w1819","Motorized",5,"Tue","weekday","sled","1","1","1",19.1,0,58,0,33,32.9,-1,-2,3,-2,-1,-3,0,-2
"6744",2019-04-02,"Washington Gulch","w1819","Hybrid",0,"Tue","weekday","sled","1","1","1",19.1,0,58,0,33,32.9,-1,-2,3,-2,-1,-3,0,-2
"6745",2019-04-03,"Washington Gulch","w1819","Non.motorized",5,"Wed","weekday","no_sled","2","1","1",19.2,0.1,58,0,31,33.1,0,-1,-2,3,0,-1,-3,0
"6746",2019-04-03,"Washington Gulch","w1819","Mechanized",0,"Wed","weekday","no_sled","2","1","1",19.2,0.1,58,0,31,33.1,0,-1,-2,3,0,-1,-3,0
"6747",2019-04-03,"Washington Gulch","w1819","Motorized",1,"Wed","weekday","sled","2","1","1",19.2,0.1,58,0,31,33.1,0,-1,-2,3,0,-1,-3,0
"6748",2019-04-03,"Washington Gulch","w1819","Hybrid",1,"Wed","weekday","sled","2","1","1",19.2,0.1,58,0,31,33.1,0,-1,-2,3,0,-1,-3,0
"6749",2019-04-04,"Washington Gulch","w1819","Non.motorized",12,"Thu","weekday","no_sled","2","1","1",19.4,0.2,59,1,35,32.9,0,0,-1,-2,1,1,0,-2
"6750",2019-04-04,"Washington Gulch","w1819","Mechanized",0,"Thu","weekday","no_sled","2","1","1",19.4,0.2,59,1,35,32.9,0,0,-1,-2,1,1,0,-2
"6751",2019-04-04,"Washington Gulch","w1819","Motorized",3,"Thu","weekday","sled","2","1","1",19.4,0.2,59,1,35,32.9,0,0,-1,-2,1,1,0,-2
"6752",2019-04-04,"Washington Gulch","w1819","Hybrid",3,"Thu","weekday","sled","2","1","1",19.4,0.2,59,1,35,32.9,0,0,-1,-2,1,1,0,-2
"6753",2019-04-05,"Washington Gulch","w1819","Non.motorized",8,"Fri","weekday","no_sled","1","1","1",19.4,0,57,-2,38,34,1,0,0,-1,-1,-1,-1,-2
"6754",2019-04-05,"Washington Gulch","w1819","Mechanized",0,"Fri","weekday","no_sled","1","1","1",19.4,0,57,-2,38,34,1,0,0,-1,-1,-1,-1,-2
"6755",2019-04-05,"Washington Gulch","w1819","Motorized",2,"Fri","weekday","sled","1","1","1",19.4,0,57,-2,38,34,1,0,0,-1,-1,-1,-1,-2
"6756",2019-04-05,"Washington Gulch","w1819","Hybrid",2,"Fri","weekday","sled","1","1","1",19.4,0,57,-2,38,34,1,0,0,-1,-1,-1,-1,-2
"6757",2019-04-06,"Washington Gulch","w1819","Non.motorized",0,"Sat","weekend","no_sled","1","1","1",19.3,-0.1,57,0,35,33.9,-2,1,0,0,-2,-1,-1,-1
"6758",2019-04-06,"Washington Gulch","w1819","Mechanized",0,"Sat","weekend","no_sled","1","1","1",19.3,-0.1,57,0,35,33.9,-2,1,0,0,-2,-1,-1,-1
"6759",2019-04-06,"Washington Gulch","w1819","Motorized",0,"Sat","weekend","sled","1","1","1",19.3,-0.1,57,0,35,33.9,-2,1,0,0,-2,-1,-1,-1
"6760",2019-04-06,"Washington Gulch","w1819","Hybrid",0,"Sat","weekend","sled","1","1","1",19.3,-0.1,57,0,35,33.9,-2,1,0,0,-2,-1,-1,-1
"6761",2019-04-07,"Washington Gulch","w1819","Non.motorized",0,"Sun","weekend","no_sled","1","1","1",19.1,-0.2,57,0,37,33.5,0,-2,1,0,0,-2,-1,-1
"6762",2019-04-07,"Washington Gulch","w1819","Mechanized",0,"Sun","weekend","no_sled","1","1","1",19.1,-0.2,57,0,37,33.5,0,-2,1,0,0,-2,-1,-1
"6763",2019-04-07,"Washington Gulch","w1819","Motorized",0,"Sun","weekend","sled","1","1","1",19.1,-0.2,57,0,37,33.5,0,-2,1,0,0,-2,-1,-1
"6764",2019-04-07,"Washington Gulch","w1819","Hybrid",0,"Sun","weekend","sled","1","1","1",19.1,-0.2,57,0,37,33.5,0,-2,1,0,0,-2,-1,-1
"6765",2019-04-08,"Washington Gulch","w1819","Non.motorized",9,"Mon","weekday","no_sled","1","2","2",19.3,0.2,54,-3,41,35.7,0,0,-2,1,-3,-3,-5,-4
"6766",2019-04-08,"Washington Gulch","w1819","Mechanized",0,"Mon","weekday","no_sled","1","2","2",19.3,0.2,54,-3,41,35.7,0,0,-2,1,-3,-3,-5,-4
"6767",2019-04-08,"Washington Gulch","w1819","Motorized",3,"Mon","weekday","sled","1","2","2",19.3,0.2,54,-3,41,35.7,0,0,-2,1,-3,-3,-5,-4
"6768",2019-04-08,"Washington Gulch","w1819","Hybrid",1,"Mon","weekday","sled","1","2","2",19.3,0.2,54,-3,41,35.7,0,0,-2,1,-3,-3,-5,-4
"6769",2019-04-09,"Washington Gulch","w1819","Non.motorized",3,"Tue","weekday","no_sled","1","2","2",19.3,0,53,-1,43,36.4,-3,0,0,-2,-4,-4,-4,-6
"6770",2019-04-09,"Washington Gulch","w1819","Mechanized",0,"Tue","weekday","no_sled","1","2","2",19.3,0,53,-1,43,36.4,-3,0,0,-2,-4,-4,-4,-6
"6771",2019-04-09,"Washington Gulch","w1819","Motorized",3,"Tue","weekday","sled","1","2","2",19.3,0,53,-1,43,36.4,-3,0,0,-2,-4,-4,-4,-6
"6772",2019-04-09,"Washington Gulch","w1819","Hybrid",0,"Tue","weekday","sled","1","2","2",19.3,0,53,-1,43,36.4,-3,0,0,-2,-4,-4,-4,-6
"6773",2019-04-10,"Washington Gulch","w1819","Non.motorized",4,"Wed","weekday","no_sled","2","2","1",19,-0.3,51,-2,30,37.3,-1,-3,0,0,-3,-6,-6,-6
"6774",2019-04-10,"Washington Gulch","w1819","Mechanized",0,"Wed","weekday","no_sled","2","2","1",19,-0.3,51,-2,30,37.3,-1,-3,0,0,-3,-6,-6,-6
"6775",2019-04-10,"Washington Gulch","w1819","Motorized",2,"Wed","weekday","sled","2","2","1",19,-0.3,51,-2,30,37.3,-1,-3,0,0,-3,-6,-6,-6
"6776",2019-04-10,"Washington Gulch","w1819","Hybrid",2,"Wed","weekday","sled","2","2","1",19,-0.3,51,-2,30,37.3,-1,-3,0,0,-3,-6,-6,-6
"6777",2019-04-11,"Washington Gulch","w1819","Non.motorized",9,"Thu","weekday","no_sled","3","3","2",18.9,-0.1,53,2,20,35.7,-2,-1,-3,0,0,-1,-4,-4
"6778",2019-04-11,"Washington Gulch","w1819","Mechanized",0,"Thu","weekday","no_sled","3","3","2",18.9,-0.1,53,2,20,35.7,-2,-1,-3,0,0,-1,-4,-4
"6779",2019-04-11,"Washington Gulch","w1819","Motorized",1,"Thu","weekday","sled","3","3","2",18.9,-0.1,53,2,20,35.7,-2,-1,-3,0,0,-1,-4,-4
"6780",2019-04-11,"Washington Gulch","w1819","Hybrid",1,"Thu","weekday","sled","3","3","2",18.9,-0.1,53,2,20,35.7,-2,-1,-3,0,0,-1,-4,-4
"6781",2019-04-12,"Washington Gulch","w1819","Non.motorized",11,"Fri","weekday","no_sled","2","2","1",18.7,-0.2,53,0,24,35.3,2,-2,-1,-3,2,0,-1,-4
"6782",2019-04-12,"Washington Gulch","w1819","Mechanized",0,"Fri","weekday","no_sled","2","2","1",18.7,-0.2,53,0,24,35.3,2,-2,-1,-3,2,0,-1,-4
"6783",2019-04-12,"Washington Gulch","w1819","Motorized",7,"Fri","weekday","sled","2","2","1",18.7,-0.2,53,0,24,35.3,2,-2,-1,-3,2,0,-1,-4
"6784",2019-04-12,"Washington Gulch","w1819","Hybrid",0,"Fri","weekday","sled","2","2","1",18.7,-0.2,53,0,24,35.3,2,-2,-1,-3,2,0,-1,-4
"6785",2019-04-13,"Washington Gulch","w1819","Non.motorized",0,"Sat","weekend","no_sled","1","1","1",18.8,0.1,52,-1,27,36.2,0,2,-2,-1,-1,1,-1,-2
"6786",2019-04-13,"Washington Gulch","w1819","Mechanized",0,"Sat","weekend","no_sled","1","1","1",18.8,0.1,52,-1,27,36.2,0,2,-2,-1,-1,1,-1,-2
"6787",2019-04-13,"Washington Gulch","w1819","Motorized",0,"Sat","weekend","sled","1","1","1",18.8,0.1,52,-1,27,36.2,0,2,-2,-1,-1,1,-1,-2
"6788",2019-04-13,"Washington Gulch","w1819","Hybrid",0,"Sat","weekend","sled","1","1","1",18.8,0.1,52,-1,27,36.2,0,2,-2,-1,-1,1,-1,-2
"6789",2019-04-14,"Washington Gulch","w1819","Non.motorized",0,"Sun","weekend","no_sled","1","1","1",18.7,-0.1,51,-1,35,36.7,-1,0,2,-2,-2,-2,0,-2
"6790",2019-04-14,"Washington Gulch","w1819","Mechanized",0,"Sun","weekend","no_sled","1","1","1",18.7,-0.1,51,-1,35,36.7,-1,0,2,-2,-2,-2,0,-2
"6791",2019-04-14,"Washington Gulch","w1819","Motorized",0,"Sun","weekend","sled","1","1","1",18.7,-0.1,51,-1,35,36.7,-1,0,2,-2,-2,-2,0,-2
"6792",2019-04-14,"Washington Gulch","w1819","Hybrid",0,"Sun","weekend","sled","1","1","1",18.7,-0.1,51,-1,35,36.7,-1,0,2,-2,-2,-2,0,-2
"6793",2019-04-15,"Washington Gulch","w1819","Non.motorized",0,"Mon","weekday","no_sled",NA,NA,NA,18.6,-0.1,50,-1,41,37.2,-1,-1,0,2,-2,-3,-3,-1
"6794",2019-04-15,"Washington Gulch","w1819","Mechanized",0,"Mon","weekday","no_sled",NA,NA,NA,18.6,-0.1,50,-1,41,37.2,-1,-1,0,2,-2,-3,-3,-1
"6795",2019-04-15,"Washington Gulch","w1819","Motorized",0,"Mon","weekday","sled",NA,NA,NA,18.6,-0.1,50,-1,41,37.2,-1,-1,0,2,-2,-3,-3,-1
"6796",2019-04-15,"Washington Gulch","w1819","Hybrid",0,"Mon","weekday","sled",NA,NA,NA,18.6,-0.1,50,-1,41,37.2,-1,-1,0,2,-2,-3,-3,-1
"6797",2019-12-06,"Brush Creek Rd","w1920","Non.motorized",10,"Fri","weekday","no_sled","2","2","1",2.9,0.4,19,5,24,15.3,0,0,0,0,5,5,5,5
"6798",2019-12-06,"Brush Creek Rd","w1920","Mechanized",0,"Fri","weekday","no_sled","2","2","1",2.9,0.4,19,5,24,15.3,0,0,0,0,5,5,5,5
"6799",2019-12-06,"Brush Creek Rd","w1920","Motorized",0,"Fri","weekday","sled","2","2","1",2.9,0.4,19,5,24,15.3,0,0,0,0,5,5,5,5
"6800",2019-12-06,"Brush Creek Rd","w1920","Hybrid",0,"Fri","weekday","sled","2","2","1",2.9,0.4,19,5,24,15.3,0,0,0,0,5,5,5,5
"6801",2019-12-07,"Brush Creek Rd","w1920","Non.motorized",16,"Sat","weekend","no_sled","2","2","1",3,0.1,18,-1,29,16.7,5,0,0,0,4,4,4,4
"6802",2019-12-07,"Brush Creek Rd","w1920","Mechanized",0,"Sat","weekend","no_sled","2","2","1",3,0.1,18,-1,29,16.7,5,0,0,0,4,4,4,4
"6803",2019-12-07,"Brush Creek Rd","w1920","Motorized",0,"Sat","weekend","sled","2","2","1",3,0.1,18,-1,29,16.7,5,0,0,0,4,4,4,4
"6804",2019-12-07,"Brush Creek Rd","w1920","Hybrid",0,"Sat","weekend","sled","2","2","1",3,0.1,18,-1,29,16.7,5,0,0,0,4,4,4,4
"6805",2019-12-08,"Brush Creek Rd","w1920","Non.motorized",4,"Sun","weekend","no_sled","2","2","1",3,0,17,-1,28,17.6,-1,5,0,0,-2,3,3,3
"6806",2019-12-08,"Brush Creek Rd","w1920","Mechanized",0,"Sun","weekend","no_sled","2","2","1",3,0,17,-1,28,17.6,-1,5,0,0,-2,3,3,3
"6807",2019-12-08,"Brush Creek Rd","w1920","Motorized",0,"Sun","weekend","sled","2","2","1",3,0,17,-1,28,17.6,-1,5,0,0,-2,3,3,3
"6808",2019-12-08,"Brush Creek Rd","w1920","Hybrid",0,"Sun","weekend","sled","2","2","1",3,0,17,-1,28,17.6,-1,5,0,0,-2,3,3,3
"6809",2019-12-09,"Brush Creek Rd","w1920","Non.motorized",2,"Mon","weekday","no_sled","3","3","2",3.4,0.4,22,5,21,15.5,-1,-1,5,0,4,3,8,8
"6810",2019-12-09,"Brush Creek Rd","w1920","Mechanized",0,"Mon","weekday","no_sled","3","3","2",3.4,0.4,22,5,21,15.5,-1,-1,5,0,4,3,8,8
"6811",2019-12-09,"Brush Creek Rd","w1920","Motorized",0,"Mon","weekday","sled","3","3","2",3.4,0.4,22,5,21,15.5,-1,-1,5,0,4,3,8,8
"6812",2019-12-09,"Brush Creek Rd","w1920","Hybrid",0,"Mon","weekday","sled","3","3","2",3.4,0.4,22,5,21,15.5,-1,-1,5,0,4,3,8,8
"6813",2019-12-10,"Brush Creek Rd","w1920","Non.motorized",5,"Tue","weekday","no_sled","2","2","2",3.4,0,21,-1,19,16.2,5,-1,-1,5,4,3,2,7
"6814",2019-12-10,"Brush Creek Rd","w1920","Mechanized",0,"Tue","weekday","no_sled","2","2","2",3.4,0,21,-1,19,16.2,5,-1,-1,5,4,3,2,7
"6815",2019-12-10,"Brush Creek Rd","w1920","Motorized",0,"Tue","weekday","sled","2","2","2",3.4,0,21,-1,19,16.2,5,-1,-1,5,4,3,2,7
"6816",2019-12-10,"Brush Creek Rd","w1920","Hybrid",0,"Tue","weekday","sled","2","2","2",3.4,0,21,-1,19,16.2,5,-1,-1,5,4,3,2,7
"6817",2019-12-11,"Brush Creek Rd","w1920","Non.motorized",5,"Wed","weekday","no_sled","2","2","2",3.4,0,20,-1,22,17,-1,5,-1,-1,-2,3,2,1
"6818",2019-12-11,"Brush Creek Rd","w1920","Mechanized",0,"Wed","weekday","no_sled","2","2","2",3.4,0,20,-1,22,17,-1,5,-1,-1,-2,3,2,1
"6819",2019-12-11,"Brush Creek Rd","w1920","Motorized",0,"Wed","weekday","sled","2","2","2",3.4,0,20,-1,22,17,-1,5,-1,-1,-2,3,2,1
"6820",2019-12-11,"Brush Creek Rd","w1920","Hybrid",0,"Wed","weekday","sled","2","2","2",3.4,0,20,-1,22,17,-1,5,-1,-1,-2,3,2,1
"6821",2019-12-12,"Brush Creek Rd","w1920","Non.motorized",4,"Thu","weekday","no_sled","2","2","2",3.4,0,19,-1,25,17.9,-1,-1,5,-1,-2,-3,2,1
"6822",2019-12-12,"Brush Creek Rd","w1920","Mechanized",0,"Thu","weekday","no_sled","2","2","2",3.4,0,19,-1,25,17.9,-1,-1,5,-1,-2,-3,2,1
"6823",2019-12-12,"Brush Creek Rd","w1920","Motorized",0,"Thu","weekday","sled","2","2","2",3.4,0,19,-1,25,17.9,-1,-1,5,-1,-2,-3,2,1
"6824",2019-12-12,"Brush Creek Rd","w1920","Hybrid",0,"Thu","weekday","sled","2","2","2",3.4,0,19,-1,25,17.9,-1,-1,5,-1,-2,-3,2,1
"6825",2019-12-13,"Brush Creek Rd","w1920","Non.motorized",4,"Fri","weekday","no_sled","2","2","2",3.8,0.4,21,2,24,18.1,-1,-1,-1,5,1,0,-1,4
"6826",2019-12-13,"Brush Creek Rd","w1920","Mechanized",0,"Fri","weekday","no_sled","2","2","2",3.8,0.4,21,2,24,18.1,-1,-1,-1,5,1,0,-1,4
"6827",2019-12-13,"Brush Creek Rd","w1920","Motorized",0,"Fri","weekday","sled","2","2","2",3.8,0.4,21,2,24,18.1,-1,-1,-1,5,1,0,-1,4
"6828",2019-12-13,"Brush Creek Rd","w1920","Hybrid",0,"Fri","weekday","sled","2","2","2",3.8,0.4,21,2,24,18.1,-1,-1,-1,5,1,0,-1,4
"6829",2019-12-14,"Brush Creek Rd","w1920","Non.motorized",6,"Sat","weekend","no_sled","3","3","3",4.2,0.4,27,6,25,15.6,2,-1,-1,-1,8,7,6,5
"6830",2019-12-14,"Brush Creek Rd","w1920","Mechanized",0,"Sat","weekend","no_sled","3","3","3",4.2,0.4,27,6,25,15.6,2,-1,-1,-1,8,7,6,5
"6831",2019-12-14,"Brush Creek Rd","w1920","Motorized",0,"Sat","weekend","sled","3","3","3",4.2,0.4,27,6,25,15.6,2,-1,-1,-1,8,7,6,5
"6832",2019-12-14,"Brush Creek Rd","w1920","Hybrid",0,"Sat","weekend","sled","3","3","3",4.2,0.4,27,6,25,15.6,2,-1,-1,-1,8,7,6,5
"6833",2019-12-15,"Brush Creek Rd","w1920","Non.motorized",4,"Sun","weekend","no_sled","3","3","2",4.8,0.6,31,4,17,15.5,6,2,-1,-1,10,12,11,10
"6834",2019-12-15,"Brush Creek Rd","w1920","Mechanized",0,"Sun","weekend","no_sled","3","3","2",4.8,0.6,31,4,17,15.5,6,2,-1,-1,10,12,11,10
"6835",2019-12-15,"Brush Creek Rd","w1920","Motorized",0,"Sun","weekend","sled","3","3","2",4.8,0.6,31,4,17,15.5,6,2,-1,-1,10,12,11,10
"6836",2019-12-15,"Brush Creek Rd","w1920","Hybrid",0,"Sun","weekend","sled","3","3","2",4.8,0.6,31,4,17,15.5,6,2,-1,-1,10,12,11,10
"6837",2019-12-16,"Brush Creek Rd","w1920","Non.motorized",4,"Mon","weekday","no_sled","3","3","2",4.8,0,29,-2,6,16.6,4,6,2,-1,2,8,10,9
"6838",2019-12-16,"Brush Creek Rd","w1920","Mechanized",0,"Mon","weekday","no_sled","3","3","2",4.8,0,29,-2,6,16.6,4,6,2,-1,2,8,10,9
"6839",2019-12-16,"Brush Creek Rd","w1920","Motorized",0,"Mon","weekday","sled","3","3","2",4.8,0,29,-2,6,16.6,4,6,2,-1,2,8,10,9
"6840",2019-12-16,"Brush Creek Rd","w1920","Hybrid",0,"Mon","weekday","sled","3","3","2",4.8,0,29,-2,6,16.6,4,6,2,-1,2,8,10,9
"6841",2019-12-17,"Brush Creek Rd","w1920","Non.motorized",NA,"Tue","weekday","no_sled","2","2","1",4.8,0,27,-2,8,17.8,-2,4,6,2,-4,0,6,8
"6842",2019-12-17,"Brush Creek Rd","w1920","Mechanized",NA,"Tue","weekday","no_sled","2","2","1",4.8,0,27,-2,8,17.8,-2,4,6,2,-4,0,6,8
"6843",2019-12-17,"Brush Creek Rd","w1920","Motorized",NA,"Tue","weekday","sled","2","2","1",4.8,0,27,-2,8,17.8,-2,4,6,2,-4,0,6,8
"6844",2019-12-17,"Brush Creek Rd","w1920","Hybrid",NA,"Tue","weekday","sled","2","2","1",4.8,0,27,-2,8,17.8,-2,4,6,2,-4,0,6,8
"6845",2019-12-18,"Brush Creek Rd","w1920","Non.motorized",2,"Wed","weekday","no_sled","2","2","1",4.8,0,26,-1,20,18.5,-2,-2,4,6,-3,-5,-1,5
"6846",2019-12-18,"Brush Creek Rd","w1920","Mechanized",0,"Wed","weekday","no_sled","2","2","1",4.8,0,26,-1,20,18.5,-2,-2,4,6,-3,-5,-1,5
"6847",2019-12-18,"Brush Creek Rd","w1920","Motorized",0,"Wed","weekday","sled","2","2","1",4.8,0,26,-1,20,18.5,-2,-2,4,6,-3,-5,-1,5
"6848",2019-12-18,"Brush Creek Rd","w1920","Hybrid",0,"Wed","weekday","sled","2","2","1",4.8,0,26,-1,20,18.5,-2,-2,4,6,-3,-5,-1,5
"6849",2019-12-19,"Brush Creek Rd","w1920","Non.motorized",4,"Thu","weekday","no_sled","2","2","1",4.9,0.1,25,-1,21,19.6,-1,-2,-2,4,-2,-4,-6,-2
"6850",2019-12-19,"Brush Creek Rd","w1920","Mechanized",0,"Thu","weekday","no_sled","2","2","1",4.9,0.1,25,-1,21,19.6,-1,-2,-2,4,-2,-4,-6,-2
"6851",2019-12-19,"Brush Creek Rd","w1920","Motorized",0,"Thu","weekday","sled","2","2","1",4.9,0.1,25,-1,21,19.6,-1,-2,-2,4,-2,-4,-6,-2
"6852",2019-12-19,"Brush Creek Rd","w1920","Hybrid",0,"Thu","weekday","sled","2","2","1",4.9,0.1,25,-1,21,19.6,-1,-2,-2,4,-2,-4,-6,-2
"6853",2019-12-20,"Brush Creek Rd","w1920","Non.motorized",5,"Fri","weekday","no_sled","2","2","1",4.9,0,24,-1,21,20.4,-1,-1,-2,-2,-2,-3,-5,-7
"6854",2019-12-20,"Brush Creek Rd","w1920","Mechanized",0,"Fri","weekday","no_sled","2","2","1",4.9,0,24,-1,21,20.4,-1,-1,-2,-2,-2,-3,-5,-7
"6855",2019-12-20,"Brush Creek Rd","w1920","Motorized",0,"Fri","weekday","sled","2","2","1",4.9,0,24,-1,21,20.4,-1,-1,-2,-2,-2,-3,-5,-7
"6856",2019-12-20,"Brush Creek Rd","w1920","Hybrid",0,"Fri","weekday","sled","2","2","1",4.9,0,24,-1,21,20.4,-1,-1,-2,-2,-2,-3,-5,-7
"6857",2019-12-21,"Brush Creek Rd","w1920","Non.motorized",12,"Sat","weekend","no_sled","2","2","1",4.9,0,24,0,27,20.4,-1,-1,-1,-2,-1,-2,-3,-5
"6858",2019-12-21,"Brush Creek Rd","w1920","Mechanized",0,"Sat","weekend","no_sled","2","2","1",4.9,0,24,0,27,20.4,-1,-1,-1,-2,-1,-2,-3,-5
"6859",2019-12-21,"Brush Creek Rd","w1920","Motorized",0,"Sat","weekend","sled","2","2","1",4.9,0,24,0,27,20.4,-1,-1,-1,-2,-1,-2,-3,-5
"6860",2019-12-21,"Brush Creek Rd","w1920","Hybrid",0,"Sat","weekend","sled","2","2","1",4.9,0,24,0,27,20.4,-1,-1,-1,-2,-1,-2,-3,-5
"6861",2019-12-22,"Brush Creek Rd","w1920","Non.motorized",13,"Sun","weekend","no_sled","2","2","1",5,0.1,23,-1,31,21.7,0,-1,-1,-1,-1,-2,-3,-4
"6862",2019-12-22,"Brush Creek Rd","w1920","Mechanized",1,"Sun","weekend","no_sled","2","2","1",5,0.1,23,-1,31,21.7,0,-1,-1,-1,-1,-2,-3,-4
"6863",2019-12-22,"Brush Creek Rd","w1920","Motorized",0,"Sun","weekend","sled","2","2","1",5,0.1,23,-1,31,21.7,0,-1,-1,-1,-1,-2,-3,-4
"6864",2019-12-22,"Brush Creek Rd","w1920","Hybrid",0,"Sun","weekend","sled","2","2","1",5,0.1,23,-1,31,21.7,0,-1,-1,-1,-1,-2,-3,-4
"6865",2019-12-23,"Brush Creek Rd","w1920","Non.motorized",23,"Mon","weekday","no_sled","2","1","1",5,0,23,0,34,21.7,-1,0,-1,-1,-1,-1,-2,-3
"6866",2019-12-23,"Brush Creek Rd","w1920","Mechanized",0,"Mon","weekday","no_sled","2","1","1",5,0,23,0,34,21.7,-1,0,-1,-1,-1,-1,-2,-3
"6867",2019-12-23,"Brush Creek Rd","w1920","Motorized",0,"Mon","weekday","sled","2","1","1",5,0,23,0,34,21.7,-1,0,-1,-1,-1,-1,-2,-3
"6868",2019-12-23,"Brush Creek Rd","w1920","Hybrid",0,"Mon","weekday","sled","2","1","1",5,0,23,0,34,21.7,-1,0,-1,-1,-1,-1,-2,-3
"6869",2019-12-24,"Brush Creek Rd","w1920","Non.motorized",13,"Tue","weekday","no_sled","2","1","1",5,0,22,-1,30,22.7,0,-1,0,-1,-1,-2,-2,-3
"6870",2019-12-24,"Brush Creek Rd","w1920","Mechanized",0,"Tue","weekday","no_sled","2","1","1",5,0,22,-1,30,22.7,0,-1,0,-1,-1,-2,-2,-3
"6871",2019-12-24,"Brush Creek Rd","w1920","Motorized",0,"Tue","weekday","sled","2","1","1",5,0,22,-1,30,22.7,0,-1,0,-1,-1,-2,-2,-3
"6872",2019-12-24,"Brush Creek Rd","w1920","Hybrid",0,"Tue","weekday","sled","2","1","1",5,0,22,-1,30,22.7,0,-1,0,-1,-1,-2,-2,-3
"6873",2019-12-25,"Brush Creek Rd","w1920","Non.motorized",14,"Wed","weekday","no_sled","2","2","2",5,0,23,1,22,21.7,-1,0,-1,0,0,0,-1,-1
"6874",2019-12-25,"Brush Creek Rd","w1920","Mechanized",0,"Wed","weekday","no_sled","2","2","2",5,0,23,1,22,21.7,-1,0,-1,0,0,0,-1,-1
"6875",2019-12-25,"Brush Creek Rd","w1920","Motorized",0,"Wed","weekday","sled","2","2","2",5,0,23,1,22,21.7,-1,0,-1,0,0,0,-1,-1
"6876",2019-12-25,"Brush Creek Rd","w1920","Hybrid",0,"Wed","weekday","sled","2","2","2",5,0,23,1,22,21.7,-1,0,-1,0,0,0,-1,-1
"6877",2019-12-26,"Brush Creek Rd","w1920","Non.motorized",15,"Thu","weekday","no_sled","2","2","1",5,0,23,0,17,21.7,1,-1,0,-1,1,0,0,-1
"6878",2019-12-26,"Brush Creek Rd","w1920","Mechanized",0,"Thu","weekday","no_sled","2","2","1",5,0,23,0,17,21.7,1,-1,0,-1,1,0,0,-1
"6879",2019-12-26,"Brush Creek Rd","w1920","Motorized",0,"Thu","weekday","sled","2","2","1",5,0,23,0,17,21.7,1,-1,0,-1,1,0,0,-1
"6880",2019-12-26,"Brush Creek Rd","w1920","Hybrid",0,"Thu","weekday","sled","2","2","1",5,0,23,0,17,21.7,1,-1,0,-1,1,0,0,-1
"6881",2019-12-27,"Brush Creek Rd","w1920","Non.motorized",5,"Fri","weekday","no_sled","3","3","2",5.1,0.1,24,1,22,21.2,0,1,-1,0,1,2,1,1
"6882",2019-12-27,"Brush Creek Rd","w1920","Mechanized",0,"Fri","weekday","no_sled","3","3","2",5.1,0.1,24,1,22,21.2,0,1,-1,0,1,2,1,1
"6883",2019-12-27,"Brush Creek Rd","w1920","Motorized",0,"Fri","weekday","sled","3","3","2",5.1,0.1,24,1,22,21.2,0,1,-1,0,1,2,1,1
"6884",2019-12-27,"Brush Creek Rd","w1920","Hybrid",0,"Fri","weekday","sled","3","3","2",5.1,0.1,24,1,22,21.2,0,1,-1,0,1,2,1,1
"6885",2019-12-28,"Brush Creek Rd","w1920","Non.motorized",13,"Sat","weekend","no_sled","3","3","2",5.6,0.5,30,6,16,18.7,1,0,1,-1,7,7,8,7
"6886",2019-12-28,"Brush Creek Rd","w1920","Mechanized",0,"Sat","weekend","no_sled","3","3","2",5.6,0.5,30,6,16,18.7,1,0,1,-1,7,7,8,7
"6887",2019-12-28,"Brush Creek Rd","w1920","Motorized",0,"Sat","weekend","sled","3","3","2",5.6,0.5,30,6,16,18.7,1,0,1,-1,7,7,8,7
"6888",2019-12-28,"Brush Creek Rd","w1920","Hybrid",0,"Sat","weekend","sled","3","3","2",5.6,0.5,30,6,16,18.7,1,0,1,-1,7,7,8,7
"6889",2019-12-29,"Brush Creek Rd","w1920","Non.motorized",14,"Sun","weekend","no_sled","3","3","2",5.6,0,29,-1,3,19.3,6,1,0,1,5,6,6,7
"6890",2019-12-29,"Brush Creek Rd","w1920","Mechanized",0,"Sun","weekend","no_sled","3","3","2",5.6,0,29,-1,3,19.3,6,1,0,1,5,6,6,7
"6891",2019-12-29,"Brush Creek Rd","w1920","Motorized",0,"Sun","weekend","sled","3","3","2",5.6,0,29,-1,3,19.3,6,1,0,1,5,6,6,7
"6892",2019-12-29,"Brush Creek Rd","w1920","Hybrid",0,"Sun","weekend","sled","3","3","2",5.6,0,29,-1,3,19.3,6,1,0,1,5,6,6,7
"6893",2019-12-30,"Brush Creek Rd","w1920","Non.motorized",11,"Mon","weekday","no_sled","3","3","2",5.6,0,28,-1,3,20,-1,6,1,0,-2,4,5,5
"6894",2019-12-30,"Brush Creek Rd","w1920","Mechanized",1,"Mon","weekday","no_sled","3","3","2",5.6,0,28,-1,3,20,-1,6,1,0,-2,4,5,5
"6895",2019-12-30,"Brush Creek Rd","w1920","Motorized",0,"Mon","weekday","sled","3","3","2",5.6,0,28,-1,3,20,-1,6,1,0,-2,4,5,5
"6896",2019-12-30,"Brush Creek Rd","w1920","Hybrid",0,"Mon","weekday","sled","3","3","2",5.6,0,28,-1,3,20,-1,6,1,0,-2,4,5,5
"6897",2019-12-31,"Brush Creek Rd","w1920","Non.motorized",9,"Tue","weekday","no_sled","2","2","1",5.6,0,28,0,13,20,-1,-1,6,1,-1,-2,4,5
"6898",2019-12-31,"Brush Creek Rd","w1920","Mechanized",1,"Tue","weekday","no_sled","2","2","1",5.6,0,28,0,13,20,-1,-1,6,1,-1,-2,4,5
"6899",2019-12-31,"Brush Creek Rd","w1920","Motorized",0,"Tue","weekday","sled","2","2","1",5.6,0,28,0,13,20,-1,-1,6,1,-1,-2,4,5
"6900",2019-12-31,"Brush Creek Rd","w1920","Hybrid",0,"Tue","weekday","sled","2","2","1",5.6,0,28,0,13,20,-1,-1,6,1,-1,-2,4,5
"6901",2020-01-01,"Brush Creek Rd","w1920","Non.motorized",16,"Wed","weekday","no_sled","2","1","1",5.6,0,27,-1,21,20.7,0,-1,-1,6,-1,-2,-3,3
"6902",2020-01-01,"Brush Creek Rd","w1920","Mechanized",1,"Wed","weekday","no_sled","2","1","1",5.6,0,27,-1,21,20.7,0,-1,-1,6,-1,-2,-3,3
"6903",2020-01-01,"Brush Creek Rd","w1920","Motorized",0,"Wed","weekday","sled","2","1","1",5.6,0,27,-1,21,20.7,0,-1,-1,6,-1,-2,-3,3
"6904",2020-01-01,"Brush Creek Rd","w1920","Hybrid",0,"Wed","weekday","sled","2","1","1",5.6,0,27,-1,21,20.7,0,-1,-1,6,-1,-2,-3,3
"6905",2020-01-02,"Brush Creek Rd","w1920","Non.motorized",10,"Thu","weekday","no_sled","3","3","2",5.9,0.3,29,2,16,20.3,-1,0,-1,-1,1,1,0,-1
"6906",2020-01-02,"Brush Creek Rd","w1920","Mechanized",1,"Thu","weekday","no_sled","3","3","2",5.9,0.3,29,2,16,20.3,-1,0,-1,-1,1,1,0,-1
"6907",2020-01-02,"Brush Creek Rd","w1920","Motorized",0,"Thu","weekday","sled","3","3","2",5.9,0.3,29,2,16,20.3,-1,0,-1,-1,1,1,0,-1
"6908",2020-01-02,"Brush Creek Rd","w1920","Hybrid",0,"Thu","weekday","sled","3","3","2",5.9,0.3,29,2,16,20.3,-1,0,-1,-1,1,1,0,-1
"6909",2020-01-03,"Brush Creek Rd","w1920","Non.motorized",19,"Fri","weekday","no_sled","3","2","1",5.9,0,31,2,19,19,2,-1,0,-1,4,3,3,2
"6910",2020-01-03,"Brush Creek Rd","w1920","Mechanized",1,"Fri","weekday","no_sled","3","2","1",5.9,0,31,2,19,19,2,-1,0,-1,4,3,3,2
"6911",2020-01-03,"Brush Creek Rd","w1920","Motorized",0,"Fri","weekday","sled","3","2","1",5.9,0,31,2,19,19,2,-1,0,-1,4,3,3,2
"6912",2020-01-03,"Brush Creek Rd","w1920","Hybrid",0,"Fri","weekday","sled","3","2","1",5.9,0,31,2,19,19,2,-1,0,-1,4,3,3,2
"6913",2020-01-04,"Brush Creek Rd","w1920","Non.motorized",14,"Sat","weekend","no_sled","2","2","1",5.9,0,30,-1,26,19.7,2,2,-1,0,1,3,2,2
"6914",2020-01-04,"Brush Creek Rd","w1920","Mechanized",1,"Sat","weekend","no_sled","2","2","1",5.9,0,30,-1,26,19.7,2,2,-1,0,1,3,2,2
"6915",2020-01-04,"Brush Creek Rd","w1920","Motorized",0,"Sat","weekend","sled","2","2","1",5.9,0,30,-1,26,19.7,2,2,-1,0,1,3,2,2
"6916",2020-01-04,"Brush Creek Rd","w1920","Hybrid",0,"Sat","weekend","sled","2","2","1",5.9,0,30,-1,26,19.7,2,2,-1,0,1,3,2,2
"6917",2020-01-05,"Brush Creek Rd","w1920","Non.motorized",20,"Sun","weekend","no_sled","2","2","1",5.9,0,28,-2,23,21.1,-1,2,2,-1,-3,-1,1,0
"6918",2020-01-05,"Brush Creek Rd","w1920","Mechanized",1,"Sun","weekend","no_sled","2","2","1",5.9,0,28,-2,23,21.1,-1,2,2,-1,-3,-1,1,0
"6919",2020-01-05,"Brush Creek Rd","w1920","Motorized",0,"Sun","weekend","sled","2","2","1",5.9,0,28,-2,23,21.1,-1,2,2,-1,-3,-1,1,0
"6920",2020-01-05,"Brush Creek Rd","w1920","Hybrid",0,"Sun","weekend","sled","2","2","1",5.9,0,28,-2,23,21.1,-1,2,2,-1,-3,-1,1,0
"6921",2020-01-06,"Brush Creek Rd","w1920","Non.motorized",13,"Mon","weekday","no_sled","2","2","1",5.9,0,28,0,15,21.1,-2,-1,2,2,-2,-3,-1,1
"6922",2020-01-06,"Brush Creek Rd","w1920","Mechanized",2,"Mon","weekday","no_sled","2","2","1",5.9,0,28,0,15,21.1,-2,-1,2,2,-2,-3,-1,1
"6923",2020-01-06,"Brush Creek Rd","w1920","Motorized",0,"Mon","weekday","sled","2","2","1",5.9,0,28,0,15,21.1,-2,-1,2,2,-2,-3,-1,1
"6924",2020-01-06,"Brush Creek Rd","w1920","Hybrid",0,"Mon","weekday","sled","2","2","1",5.9,0,28,0,15,21.1,-2,-1,2,2,-2,-3,-1,1
"6925",2020-01-07,"Brush Creek Rd","w1920","Non.motorized",10,"Tue","weekday","no_sled","2","1","1",5.9,0,28,0,22,21.1,0,-2,-1,2,0,-2,-3,-1
"6926",2020-01-07,"Brush Creek Rd","w1920","Mechanized",2,"Tue","weekday","no_sled","2","1","1",5.9,0,28,0,22,21.1,0,-2,-1,2,0,-2,-3,-1
"6927",2020-01-07,"Brush Creek Rd","w1920","Motorized",0,"Tue","weekday","sled","2","1","1",5.9,0,28,0,22,21.1,0,-2,-1,2,0,-2,-3,-1
"6928",2020-01-07,"Brush Creek Rd","w1920","Hybrid",0,"Tue","weekday","sled","2","1","1",5.9,0,28,0,22,21.1,0,-2,-1,2,0,-2,-3,-1
"6929",2020-01-08,"Brush Creek Rd","w1920","Non.motorized",10,"Wed","weekday","no_sled","2","1","1",6,0.1,28,0,23,21.4,0,0,-2,-1,0,0,-2,-3
"6930",2020-01-08,"Brush Creek Rd","w1920","Mechanized",0,"Wed","weekday","no_sled","2","1","1",6,0.1,28,0,23,21.4,0,0,-2,-1,0,0,-2,-3
"6931",2020-01-08,"Brush Creek Rd","w1920","Motorized",0,"Wed","weekday","sled","2","1","1",6,0.1,28,0,23,21.4,0,0,-2,-1,0,0,-2,-3
"6932",2020-01-08,"Brush Creek Rd","w1920","Hybrid",0,"Wed","weekday","sled","2","1","1",6,0.1,28,0,23,21.4,0,0,-2,-1,0,0,-2,-3
"6933",2020-01-09,"Brush Creek Rd","w1920","Non.motorized",5,"Thu","weekday","no_sled","2","1","1",6,0,27,-1,17,22.2,0,0,0,-2,-1,-1,-1,-3
"6934",2020-01-09,"Brush Creek Rd","w1920","Mechanized",0,"Thu","weekday","no_sled","2","1","1",6,0,27,-1,17,22.2,0,0,0,-2,-1,-1,-1,-3
"6935",2020-01-09,"Brush Creek Rd","w1920","Motorized",0,"Thu","weekday","sled","2","1","1",6,0,27,-1,17,22.2,0,0,0,-2,-1,-1,-1,-3
"6936",2020-01-09,"Brush Creek Rd","w1920","Hybrid",0,"Thu","weekday","sled","2","1","1",6,0,27,-1,17,22.2,0,0,0,-2,-1,-1,-1,-3
"6937",2020-01-10,"Brush Creek Rd","w1920","Non.motorized",4,"Fri","weekday","no_sled","2","1","1",6,0,29,2,11,20.7,-1,0,0,0,1,1,1,1
"6938",2020-01-10,"Brush Creek Rd","w1920","Mechanized",0,"Fri","weekday","no_sled","2","1","1",6,0,29,2,11,20.7,-1,0,0,0,1,1,1,1
"6939",2020-01-10,"Brush Creek Rd","w1920","Motorized",0,"Fri","weekday","sled","2","1","1",6,0,29,2,11,20.7,-1,0,0,0,1,1,1,1
"6940",2020-01-10,"Brush Creek Rd","w1920","Hybrid",0,"Fri","weekday","sled","2","1","1",6,0,29,2,11,20.7,-1,0,0,0,1,1,1,1
"6941",2020-01-11,"Brush Creek Rd","w1920","Non.motorized",7,"Sat","weekend","no_sled","2","1","1",6,0,29,0,12,20.7,2,-1,0,0,2,1,1,1
"6942",2020-01-11,"Brush Creek Rd","w1920","Mechanized",0,"Sat","weekend","no_sled","2","1","1",6,0,29,0,12,20.7,2,-1,0,0,2,1,1,1
"6943",2020-01-11,"Brush Creek Rd","w1920","Motorized",0,"Sat","weekend","sled","2","1","1",6,0,29,0,12,20.7,2,-1,0,0,2,1,1,1
"6944",2020-01-11,"Brush Creek Rd","w1920","Hybrid",0,"Sat","weekend","sled","2","1","1",6,0,29,0,12,20.7,2,-1,0,0,2,1,1,1
"6945",2020-01-12,"Brush Creek Rd","w1920","Non.motorized",9,"Sun","weekend","no_sled","2","1","1",6.1,0.1,29,0,13,21,0,2,-1,0,0,2,1,1
"6946",2020-01-12,"Brush Creek Rd","w1920","Mechanized",0,"Sun","weekend","no_sled","2","1","1",6.1,0.1,29,0,13,21,0,2,-1,0,0,2,1,1
"6947",2020-01-12,"Brush Creek Rd","w1920","Motorized",0,"Sun","weekend","sled","2","1","1",6.1,0.1,29,0,13,21,0,2,-1,0,0,2,1,1
"6948",2020-01-12,"Brush Creek Rd","w1920","Hybrid",0,"Sun","weekend","sled","2","1","1",6.1,0.1,29,0,13,21,0,2,-1,0,0,2,1,1
"6949",2020-01-13,"Brush Creek Rd","w1920","Non.motorized",NA,"Mon","weekday","no_sled","2","2","1",6.2,0.1,29,0,16,21.4,0,0,2,-1,0,0,2,1
"6950",2020-01-13,"Brush Creek Rd","w1920","Mechanized",NA,"Mon","weekday","no_sled","2","2","1",6.2,0.1,29,0,16,21.4,0,0,2,-1,0,0,2,1
"6951",2020-01-13,"Brush Creek Rd","w1920","Motorized",NA,"Mon","weekday","sled","2","2","1",6.2,0.1,29,0,16,21.4,0,0,2,-1,0,0,2,1
"6952",2020-01-13,"Brush Creek Rd","w1920","Hybrid",NA,"Mon","weekday","sled","2","2","1",6.2,0.1,29,0,16,21.4,0,0,2,-1,0,0,2,1
"6953",2020-01-14,"Brush Creek Rd","w1920","Non.motorized",5,"Tue","weekday","no_sled","3","2","1",6.6,0.4,34,5,23,19.4,0,0,0,2,5,5,5,7
"6954",2020-01-14,"Brush Creek Rd","w1920","Mechanized",0,"Tue","weekday","no_sled","3","2","1",6.6,0.4,34,5,23,19.4,0,0,0,2,5,5,5,7
"6955",2020-01-14,"Brush Creek Rd","w1920","Motorized",0,"Tue","weekday","sled","3","2","1",6.6,0.4,34,5,23,19.4,0,0,0,2,5,5,5,7
"6956",2020-01-14,"Brush Creek Rd","w1920","Hybrid",0,"Tue","weekday","sled","3","2","1",6.6,0.4,34,5,23,19.4,0,0,0,2,5,5,5,7
"6957",2020-01-15,"Brush Creek Rd","w1920","Non.motorized",6,"Wed","weekday","no_sled","3","2","1",6.7,0.1,32,-2,23,20.9,5,0,0,0,3,3,3,3
"6958",2020-01-15,"Brush Creek Rd","w1920","Mechanized",0,"Wed","weekday","no_sled","3","2","1",6.7,0.1,32,-2,23,20.9,5,0,0,0,3,3,3,3
"6959",2020-01-15,"Brush Creek Rd","w1920","Motorized",0,"Wed","weekday","sled","3","2","1",6.7,0.1,32,-2,23,20.9,5,0,0,0,3,3,3,3
"6960",2020-01-15,"Brush Creek Rd","w1920","Hybrid",0,"Wed","weekday","sled","3","2","1",6.7,0.1,32,-2,23,20.9,5,0,0,0,3,3,3,3
"6961",2020-01-16,"Brush Creek Rd","w1920","Non.motorized",1,"Thu","weekday","no_sled","2","2","1",6.7,0,31,-1,28,21.6,-2,5,0,0,-3,2,2,2
"6962",2020-01-16,"Brush Creek Rd","w1920","Mechanized",0,"Thu","weekday","no_sled","2","2","1",6.7,0,31,-1,28,21.6,-2,5,0,0,-3,2,2,2
"6963",2020-01-16,"Brush Creek Rd","w1920","Motorized",0,"Thu","weekday","sled","2","2","1",6.7,0,31,-1,28,21.6,-2,5,0,0,-3,2,2,2
"6964",2020-01-16,"Brush Creek Rd","w1920","Hybrid",0,"Thu","weekday","sled","2","2","1",6.7,0,31,-1,28,21.6,-2,5,0,0,-3,2,2,2
"6965",2020-01-17,"Brush Creek Rd","w1920","Non.motorized",4,"Fri","weekday","no_sled","2","2","1",6.8,0.1,29,-2,19,23.4,-1,-2,5,0,-3,-5,0,0
"6966",2020-01-17,"Brush Creek Rd","w1920","Mechanized",0,"Fri","weekday","no_sled","2","2","1",6.8,0.1,29,-2,19,23.4,-1,-2,5,0,-3,-5,0,0
"6967",2020-01-17,"Brush Creek Rd","w1920","Motorized",0,"Fri","weekday","sled","2","2","1",6.8,0.1,29,-2,19,23.4,-1,-2,5,0,-3,-5,0,0
"6968",2020-01-17,"Brush Creek Rd","w1920","Hybrid",0,"Fri","weekday","sled","2","2","1",6.8,0.1,29,-2,19,23.4,-1,-2,5,0,-3,-5,0,0
"6969",2020-01-18,"Brush Creek Rd","w1920","Non.motorized",11,"Sat","weekend","no_sled","2","2","2",7,0.2,34,5,16,20.6,-2,-1,-2,5,3,2,0,5
"6970",2020-01-18,"Brush Creek Rd","w1920","Mechanized",0,"Sat","weekend","no_sled","2","2","2",7,0.2,34,5,16,20.6,-2,-1,-2,5,3,2,0,5
"6971",2020-01-18,"Brush Creek Rd","w1920","Motorized",0,"Sat","weekend","sled","2","2","2",7,0.2,34,5,16,20.6,-2,-1,-2,5,3,2,0,5
"6972",2020-01-18,"Brush Creek Rd","w1920","Hybrid",0,"Sat","weekend","sled","2","2","2",7,0.2,34,5,16,20.6,-2,-1,-2,5,3,2,0,5
"6973",2020-01-19,"Brush Creek Rd","w1920","Non.motorized",21,"Sun","weekend","no_sled","2","2","1",7,0,33,-1,21,21.2,5,-2,-1,-2,4,2,1,-1
"6974",2020-01-19,"Brush Creek Rd","w1920","Mechanized",0,"Sun","weekend","no_sled","2","2","1",7,0,33,-1,21,21.2,5,-2,-1,-2,4,2,1,-1
"6975",2020-01-19,"Brush Creek Rd","w1920","Motorized",0,"Sun","weekend","sled","2","2","1",7,0,33,-1,21,21.2,5,-2,-1,-2,4,2,1,-1
"6976",2020-01-19,"Brush Creek Rd","w1920","Hybrid",0,"Sun","weekend","sled","2","2","1",7,0,33,-1,21,21.2,5,-2,-1,-2,4,2,1,-1
"6977",2020-01-20,"Brush Creek Rd","w1920","Non.motorized",9,"Mon","weekday","no_sled","2","2","1",7.1,0.1,32,-1,25,22.2,-1,5,-2,-1,-2,3,1,0
"6978",2020-01-20,"Brush Creek Rd","w1920","Mechanized",0,"Mon","weekday","no_sled","2","2","1",7.1,0.1,32,-1,25,22.2,-1,5,-2,-1,-2,3,1,0
"6979",2020-01-20,"Brush Creek Rd","w1920","Motorized",0,"Mon","weekday","sled","2","2","1",7.1,0.1,32,-1,25,22.2,-1,5,-2,-1,-2,3,1,0
"6980",2020-01-20,"Brush Creek Rd","w1920","Hybrid",0,"Mon","weekday","sled","2","2","1",7.1,0.1,32,-1,25,22.2,-1,5,-2,-1,-2,3,1,0
"6981",2020-01-21,"Brush Creek Rd","w1920","Non.motorized",2,"Tue","weekday","no_sled","2","2","1",7.1,0,31,-1,28,22.9,-1,-1,5,-2,-2,-3,2,0
"6982",2020-01-21,"Brush Creek Rd","w1920","Mechanized",0,"Tue","weekday","no_sled","2","2","1",7.1,0,31,-1,28,22.9,-1,-1,5,-2,-2,-3,2,0
"6983",2020-01-21,"Brush Creek Rd","w1920","Motorized",0,"Tue","weekday","sled","2","2","1",7.1,0,31,-1,28,22.9,-1,-1,5,-2,-2,-3,2,0
"6984",2020-01-21,"Brush Creek Rd","w1920","Hybrid",0,"Tue","weekday","sled","2","2","1",7.1,0,31,-1,28,22.9,-1,-1,5,-2,-2,-3,2,0
"6985",2020-01-22,"Brush Creek Rd","w1920","Non.motorized",8,"Wed","weekday","no_sled","2","2","2",7.3,0.2,32,1,25,22.8,-1,-1,-1,5,0,-1,-2,3
"6986",2020-01-22,"Brush Creek Rd","w1920","Mechanized",0,"Wed","weekday","no_sled","2","2","2",7.3,0.2,32,1,25,22.8,-1,-1,-1,5,0,-1,-2,3
"6987",2020-01-22,"Brush Creek Rd","w1920","Motorized",0,"Wed","weekday","sled","2","2","2",7.3,0.2,32,1,25,22.8,-1,-1,-1,5,0,-1,-2,3
"6988",2020-01-22,"Brush Creek Rd","w1920","Hybrid",0,"Wed","weekday","sled","2","2","2",7.3,0.2,32,1,25,22.8,-1,-1,-1,5,0,-1,-2,3
"6989",2020-01-23,"Brush Creek Rd","w1920","Non.motorized",5,"Thu","weekday","no_sled","3","2","2",7.3,0,34,2,23,21.5,1,-1,-1,-1,3,2,1,0
"6990",2020-01-23,"Brush Creek Rd","w1920","Mechanized",1,"Thu","weekday","no_sled","3","2","2",7.3,0,34,2,23,21.5,1,-1,-1,-1,3,2,1,0
"6991",2020-01-23,"Brush Creek Rd","w1920","Motorized",0,"Thu","weekday","sled","3","2","2",7.3,0,34,2,23,21.5,1,-1,-1,-1,3,2,1,0
"6992",2020-01-23,"Brush Creek Rd","w1920","Hybrid",0,"Thu","weekday","sled","3","2","2",7.3,0,34,2,23,21.5,1,-1,-1,-1,3,2,1,0
"6993",2020-01-24,"Brush Creek Rd","w1920","Non.motorized",9,"Fri","weekday","no_sled","2","2","1",7.3,0,33,-1,23,22.1,2,1,-1,-1,1,2,1,0
"6994",2020-01-24,"Brush Creek Rd","w1920","Mechanized",1,"Fri","weekday","no_sled","2","2","1",7.3,0,33,-1,23,22.1,2,1,-1,-1,1,2,1,0
"6995",2020-01-24,"Brush Creek Rd","w1920","Motorized",0,"Fri","weekday","sled","2","2","1",7.3,0,33,-1,23,22.1,2,1,-1,-1,1,2,1,0
"6996",2020-01-24,"Brush Creek Rd","w1920","Hybrid",0,"Fri","weekday","sled","2","2","1",7.3,0,33,-1,23,22.1,2,1,-1,-1,1,2,1,0
"6997",2020-01-25,"Brush Creek Rd","w1920","Non.motorized",17,"Sat","weekend","no_sled","2","2","1",7.4,0.1,32,-1,25,23.1,-1,2,1,-1,-2,0,1,0
"6998",2020-01-25,"Brush Creek Rd","w1920","Mechanized",1,"Sat","weekend","no_sled","2","2","1",7.4,0.1,32,-1,25,23.1,-1,2,1,-1,-2,0,1,0
"6999",2020-01-25,"Brush Creek Rd","w1920","Motorized",0,"Sat","weekend","sled","2","2","1",7.4,0.1,32,-1,25,23.1,-1,2,1,-1,-2,0,1,0
"7000",2020-01-25,"Brush Creek Rd","w1920","Hybrid",0,"Sat","weekend","sled","2","2","1",7.4,0.1,32,-1,25,23.1,-1,2,1,-1,-2,0,1,0
"7001",2020-01-26,"Brush Creek Rd","w1920","Non.motorized",23,"Sun","weekend","no_sled","2","1","1",7.4,0,32,0,28,23.1,-1,-1,2,1,-1,-2,0,1
"7002",2020-01-26,"Brush Creek Rd","w1920","Mechanized",1,"Sun","weekend","no_sled","2","1","1",7.4,0,32,0,28,23.1,-1,-1,2,1,-1,-2,0,1
"7003",2020-01-26,"Brush Creek Rd","w1920","Motorized",0,"Sun","weekend","sled","2","1","1",7.4,0,32,0,28,23.1,-1,-1,2,1,-1,-2,0,1
"7004",2020-01-26,"Brush Creek Rd","w1920","Hybrid",0,"Sun","weekend","sled","2","1","1",7.4,0,32,0,28,23.1,-1,-1,2,1,-1,-2,0,1
"7005",2020-01-27,"Brush Creek Rd","w1920","Non.motorized",4,"Mon","weekday","no_sled","2","1","1",7.4,0,32,0,24,23.1,0,-1,-1,2,0,-1,-2,0
"7006",2020-01-27,"Brush Creek Rd","w1920","Mechanized",1,"Mon","weekday","no_sled","2","1","1",7.4,0,32,0,24,23.1,0,-1,-1,2,0,-1,-2,0
"7007",2020-01-27,"Brush Creek Rd","w1920","Motorized",0,"Mon","weekday","sled","2","1","1",7.4,0,32,0,24,23.1,0,-1,-1,2,0,-1,-2,0
"7008",2020-01-27,"Brush Creek Rd","w1920","Hybrid",0,"Mon","weekday","sled","2","1","1",7.4,0,32,0,24,23.1,0,-1,-1,2,0,-1,-2,0
"7009",2020-01-28,"Brush Creek Rd","w1920","Non.motorized",3,"Tue","weekday","no_sled","3","2","2",7.4,0,32,0,19,23.1,0,0,-1,-1,0,0,-1,-2
"7010",2020-01-28,"Brush Creek Rd","w1920","Mechanized",1,"Tue","weekday","no_sled","3","2","2",7.4,0,32,0,19,23.1,0,0,-1,-1,0,0,-1,-2
"7011",2020-01-28,"Brush Creek Rd","w1920","Motorized",0,"Tue","weekday","sled","3","2","2",7.4,0,32,0,19,23.1,0,0,-1,-1,0,0,-1,-2
"7012",2020-01-28,"Brush Creek Rd","w1920","Hybrid",0,"Tue","weekday","sled","3","2","2",7.4,0,32,0,19,23.1,0,0,-1,-1,0,0,-1,-2
"7013",2020-01-29,"Brush Creek Rd","w1920","Non.motorized",5,"Wed","weekday","no_sled","2","2","1",7.4,0,31,-1,20,23.9,0,0,0,-1,-1,-1,-1,-2
"7014",2020-01-29,"Brush Creek Rd","w1920","Mechanized",1,"Wed","weekday","no_sled","2","2","1",7.4,0,31,-1,20,23.9,0,0,0,-1,-1,-1,-1,-2
"7015",2020-01-29,"Brush Creek Rd","w1920","Motorized",0,"Wed","weekday","sled","2","2","1",7.4,0,31,-1,20,23.9,0,0,0,-1,-1,-1,-1,-2
"7016",2020-01-29,"Brush Creek Rd","w1920","Hybrid",0,"Wed","weekday","sled","2","2","1",7.4,0,31,-1,20,23.9,0,0,0,-1,-1,-1,-1,-2
"7017",2020-01-30,"Brush Creek Rd","w1920","Non.motorized",3,"Thu","weekday","no_sled","2","2","1",7.4,0,31,0,17,23.9,-1,0,0,0,-1,-1,-1,-1
"7018",2020-01-30,"Brush Creek Rd","w1920","Mechanized",1,"Thu","weekday","no_sled","2","2","1",7.4,0,31,0,17,23.9,-1,0,0,0,-1,-1,-1,-1
"7019",2020-01-30,"Brush Creek Rd","w1920","Motorized",0,"Thu","weekday","sled","2","2","1",7.4,0,31,0,17,23.9,-1,0,0,0,-1,-1,-1,-1
"7020",2020-01-30,"Brush Creek Rd","w1920","Hybrid",0,"Thu","weekday","sled","2","2","1",7.4,0,31,0,17,23.9,-1,0,0,0,-1,-1,-1,-1
"7021",2020-01-31,"Brush Creek Rd","w1920","Non.motorized",2,"Fri","weekday","no_sled","2","1","1",7.4,0,31,0,20,23.9,0,-1,0,0,0,-1,-1,-1
"7022",2020-01-31,"Brush Creek Rd","w1920","Mechanized",1,"Fri","weekday","no_sled","2","1","1",7.4,0,31,0,20,23.9,0,-1,0,0,0,-1,-1,-1
"7023",2020-01-31,"Brush Creek Rd","w1920","Motorized",0,"Fri","weekday","sled","2","1","1",7.4,0,31,0,20,23.9,0,-1,0,0,0,-1,-1,-1
"7024",2020-01-31,"Brush Creek Rd","w1920","Hybrid",0,"Fri","weekday","sled","2","1","1",7.4,0,31,0,20,23.9,0,-1,0,0,0,-1,-1,-1
"7025",2020-02-01,"Brush Creek Rd","w1920","Non.motorized",20,"Sat","weekend","no_sled","2","1","1",7.4,0,31,0,28,23.9,0,0,-1,0,0,0,-1,-1
"7026",2020-02-01,"Brush Creek Rd","w1920","Mechanized",1,"Sat","weekend","no_sled","2","1","1",7.4,0,31,0,28,23.9,0,0,-1,0,0,0,-1,-1
"7027",2020-02-01,"Brush Creek Rd","w1920","Motorized",0,"Sat","weekend","sled","2","1","1",7.4,0,31,0,28,23.9,0,0,-1,0,0,0,-1,-1
"7028",2020-02-01,"Brush Creek Rd","w1920","Hybrid",0,"Sat","weekend","sled","2","1","1",7.4,0,31,0,28,23.9,0,0,-1,0,0,0,-1,-1
"7029",2020-02-02,"Brush Creek Rd","w1920","Non.motorized",15,"Sun","weekend","no_sled","1","1","1",7.4,0,31,0,33,23.9,0,0,0,-1,0,0,0,-1
"7030",2020-02-02,"Brush Creek Rd","w1920","Mechanized",1,"Sun","weekend","no_sled","1","1","1",7.4,0,31,0,33,23.9,0,0,0,-1,0,0,0,-1
"7031",2020-02-02,"Brush Creek Rd","w1920","Motorized",0,"Sun","weekend","sled","1","1","1",7.4,0,31,0,33,23.9,0,0,0,-1,0,0,0,-1
"7032",2020-02-02,"Brush Creek Rd","w1920","Hybrid",0,"Sun","weekend","sled","1","1","1",7.4,0,31,0,33,23.9,0,0,0,-1,0,0,0,-1
"7033",2020-02-03,"Brush Creek Rd","w1920","Non.motorized",1,"Mon","weekday","no_sled","2","2","1",7.4,0,31,0,24,23.9,0,0,0,0,0,0,0,0
"7034",2020-02-03,"Brush Creek Rd","w1920","Mechanized",0,"Mon","weekday","no_sled","2","2","1",7.4,0,31,0,24,23.9,0,0,0,0,0,0,0,0
"7035",2020-02-03,"Brush Creek Rd","w1920","Motorized",0,"Mon","weekday","sled","2","2","1",7.4,0,31,0,24,23.9,0,0,0,0,0,0,0,0
"7036",2020-02-03,"Brush Creek Rd","w1920","Hybrid",0,"Mon","weekday","sled","2","2","1",7.4,0,31,0,24,23.9,0,0,0,0,0,0,0,0
"7037",2020-02-04,"Brush Creek Rd","w1920","Non.motorized",5,"Tue","weekday","no_sled","2","2","2",7.4,0,33,2,5,22.4,0,0,0,0,2,2,2,2
"7038",2020-02-04,"Brush Creek Rd","w1920","Mechanized",0,"Tue","weekday","no_sled","2","2","2",7.4,0,33,2,5,22.4,0,0,0,0,2,2,2,2
"7039",2020-02-04,"Brush Creek Rd","w1920","Motorized",0,"Tue","weekday","sled","2","2","2",7.4,0,33,2,5,22.4,0,0,0,0,2,2,2,2
"7040",2020-02-04,"Brush Creek Rd","w1920","Hybrid",0,"Tue","weekday","sled","2","2","2",7.4,0,33,2,5,22.4,0,0,0,0,2,2,2,2
"7041",2020-02-05,"Brush Creek Rd","w1920","Non.motorized",0,"Wed","weekday","no_sled","2","2","1",7.4,0,33,0,2,22.4,2,0,0,0,2,2,2,2
"7042",2020-02-05,"Brush Creek Rd","w1920","Mechanized",0,"Wed","weekday","no_sled","2","2","1",7.4,0,33,0,2,22.4,2,0,0,0,2,2,2,2
"7043",2020-02-05,"Brush Creek Rd","w1920","Motorized",0,"Wed","weekday","sled","2","2","1",7.4,0,33,0,2,22.4,2,0,0,0,2,2,2,2
"7044",2020-02-05,"Brush Creek Rd","w1920","Hybrid",0,"Wed","weekday","sled","2","2","1",7.4,0,33,0,2,22.4,2,0,0,0,2,2,2,2
"7045",2020-02-06,"Brush Creek Rd","w1920","Non.motorized",2,"Thu","weekday","no_sled","2","2","1",7.5,0.1,32,-1,16,23.4,0,2,0,0,-1,1,1,1
"7046",2020-02-06,"Brush Creek Rd","w1920","Mechanized",0,"Thu","weekday","no_sled","2","2","1",7.5,0.1,32,-1,16,23.4,0,2,0,0,-1,1,1,1
"7047",2020-02-06,"Brush Creek Rd","w1920","Motorized",0,"Thu","weekday","sled","2","2","1",7.5,0.1,32,-1,16,23.4,0,2,0,0,-1,1,1,1
"7048",2020-02-06,"Brush Creek Rd","w1920","Hybrid",0,"Thu","weekday","sled","2","2","1",7.5,0.1,32,-1,16,23.4,0,2,0,0,-1,1,1,1
"7049",2020-02-07,"Brush Creek Rd","w1920","Non.motorized",NA,"Fri","weekday","no_sled","3","3","3",7.9,0.4,37,5,26,21.4,-1,0,2,0,4,4,6,6
"7050",2020-02-07,"Brush Creek Rd","w1920","Mechanized",NA,"Fri","weekday","no_sled","3","3","3",7.9,0.4,37,5,26,21.4,-1,0,2,0,4,4,6,6
"7051",2020-02-07,"Brush Creek Rd","w1920","Motorized",NA,"Fri","weekday","sled","3","3","3",7.9,0.4,37,5,26,21.4,-1,0,2,0,4,4,6,6
"7052",2020-02-07,"Brush Creek Rd","w1920","Hybrid",NA,"Fri","weekday","sled","3","3","3",7.9,0.4,37,5,26,21.4,-1,0,2,0,4,4,6,6
"7053",2020-02-08,"Brush Creek Rd","w1920","Non.motorized",7,"Sat","weekend","no_sled","3","3","2",8.3,0.4,39,2,30,21.3,5,-1,0,2,7,6,6,8
"7054",2020-02-08,"Brush Creek Rd","w1920","Mechanized",0,"Sat","weekend","no_sled","3","3","2",8.3,0.4,39,2,30,21.3,5,-1,0,2,7,6,6,8
"7055",2020-02-08,"Brush Creek Rd","w1920","Motorized",0,"Sat","weekend","sled","3","3","2",8.3,0.4,39,2,30,21.3,5,-1,0,2,7,6,6,8
"7056",2020-02-08,"Brush Creek Rd","w1920","Hybrid",0,"Sat","weekend","sled","3","3","2",8.3,0.4,39,2,30,21.3,5,-1,0,2,7,6,6,8
"7057",2020-02-09,"Brush Creek Rd","w1920","Non.motorized",11,"Sun","weekend","no_sled","3","2","2",8.4,0.1,38,-1,26,22.1,2,5,-1,0,1,6,5,5
"7058",2020-02-09,"Brush Creek Rd","w1920","Mechanized",0,"Sun","weekend","no_sled","3","2","2",8.4,0.1,38,-1,26,22.1,2,5,-1,0,1,6,5,5
"7059",2020-02-09,"Brush Creek Rd","w1920","Motorized",0,"Sun","weekend","sled","3","2","2",8.4,0.1,38,-1,26,22.1,2,5,-1,0,1,6,5,5
"7060",2020-02-09,"Brush Creek Rd","w1920","Hybrid",0,"Sun","weekend","sled","3","2","2",8.4,0.1,38,-1,26,22.1,2,5,-1,0,1,6,5,5
"7061",2020-02-10,"Brush Creek Rd","w1920","Non.motorized",NA,"Mon","weekday","no_sled","2","2","1",8.4,0,38,0,22,22.1,-1,2,5,-1,-1,1,6,5
"7062",2020-02-10,"Brush Creek Rd","w1920","Mechanized",NA,"Mon","weekday","no_sled","2","2","1",8.4,0,38,0,22,22.1,-1,2,5,-1,-1,1,6,5
"7063",2020-02-10,"Brush Creek Rd","w1920","Motorized",NA,"Mon","weekday","sled","2","2","1",8.4,0,38,0,22,22.1,-1,2,5,-1,-1,1,6,5
"7064",2020-02-10,"Brush Creek Rd","w1920","Hybrid",NA,"Mon","weekday","sled","2","2","1",8.4,0,38,0,22,22.1,-1,2,5,-1,-1,1,6,5
"7065",2020-02-11,"Brush Creek Rd","w1920","Non.motorized",7,"Tue","weekday","no_sled","2","2","2",8.5,0.1,40,2,16,21.2,0,-1,2,5,2,1,3,8
"7066",2020-02-11,"Brush Creek Rd","w1920","Mechanized",0,"Tue","weekday","no_sled","2","2","2",8.5,0.1,40,2,16,21.2,0,-1,2,5,2,1,3,8
"7067",2020-02-11,"Brush Creek Rd","w1920","Motorized",0,"Tue","weekday","sled","2","2","2",8.5,0.1,40,2,16,21.2,0,-1,2,5,2,1,3,8
"7068",2020-02-11,"Brush Creek Rd","w1920","Hybrid",0,"Tue","weekday","sled","2","2","2",8.5,0.1,40,2,16,21.2,0,-1,2,5,2,1,3,8
"7069",2020-02-12,"Brush Creek Rd","w1920","Non.motorized",9,"Wed","weekday","no_sled","2","2","2",8.5,0,39,-1,15,21.8,2,0,-1,2,1,1,0,2
"7070",2020-02-12,"Brush Creek Rd","w1920","Mechanized",0,"Wed","weekday","no_sled","2","2","2",8.5,0,39,-1,15,21.8,2,0,-1,2,1,1,0,2
"7071",2020-02-12,"Brush Creek Rd","w1920","Motorized",0,"Wed","weekday","sled","2","2","2",8.5,0,39,-1,15,21.8,2,0,-1,2,1,1,0,2
"7072",2020-02-12,"Brush Creek Rd","w1920","Hybrid",0,"Wed","weekday","sled","2","2","2",8.5,0,39,-1,15,21.8,2,0,-1,2,1,1,0,2
"7073",2020-02-13,"Brush Creek Rd","w1920","Non.motorized",NA,"Thu","weekday","no_sled","2","2","1",8.5,0,39,0,18,21.8,-1,2,0,-1,-1,1,1,0
"7074",2020-02-13,"Brush Creek Rd","w1920","Mechanized",NA,"Thu","weekday","no_sled","2","2","1",8.5,0,39,0,18,21.8,-1,2,0,-1,-1,1,1,0
"7075",2020-02-13,"Brush Creek Rd","w1920","Motorized",NA,"Thu","weekday","sled","2","2","1",8.5,0,39,0,18,21.8,-1,2,0,-1,-1,1,1,0
"7076",2020-02-13,"Brush Creek Rd","w1920","Hybrid",NA,"Thu","weekday","sled","2","2","1",8.5,0,39,0,18,21.8,-1,2,0,-1,-1,1,1,0
"7077",2020-02-14,"Brush Creek Rd","w1920","Non.motorized",10,"Fri","weekday","no_sled","2","1","1",8.6,0.1,38,-1,24,22.6,0,-1,2,0,-1,-2,0,0
"7078",2020-02-14,"Brush Creek Rd","w1920","Mechanized",0,"Fri","weekday","no_sled","2","1","1",8.6,0.1,38,-1,24,22.6,0,-1,2,0,-1,-2,0,0
"7079",2020-02-14,"Brush Creek Rd","w1920","Motorized",0,"Fri","weekday","sled","2","1","1",8.6,0.1,38,-1,24,22.6,0,-1,2,0,-1,-2,0,0
"7080",2020-02-14,"Brush Creek Rd","w1920","Hybrid",0,"Fri","weekday","sled","2","1","1",8.6,0.1,38,-1,24,22.6,0,-1,2,0,-1,-2,0,0
"7081",2020-02-15,"Brush Creek Rd","w1920","Non.motorized",11,"Sat","weekend","no_sled","1","1","1",8.6,0,38,0,26,22.6,-1,0,-1,2,-1,-1,-2,0
"7082",2020-02-15,"Brush Creek Rd","w1920","Mechanized",0,"Sat","weekend","no_sled","1","1","1",8.6,0,38,0,26,22.6,-1,0,-1,2,-1,-1,-2,0
"7083",2020-02-15,"Brush Creek Rd","w1920","Motorized",0,"Sat","weekend","sled","1","1","1",8.6,0,38,0,26,22.6,-1,0,-1,2,-1,-1,-2,0
"7084",2020-02-15,"Brush Creek Rd","w1920","Hybrid",0,"Sat","weekend","sled","1","1","1",8.6,0,38,0,26,22.6,-1,0,-1,2,-1,-1,-2,0
"7085",2020-02-16,"Brush Creek Rd","w1920","Non.motorized",9,"Sun","weekend","no_sled","1","1","1",8.8,0.2,37,-1,26,23.8,0,-1,0,-1,-1,-2,-2,-3
"7086",2020-02-16,"Brush Creek Rd","w1920","Mechanized",0,"Sun","weekend","no_sled","1","1","1",8.8,0.2,37,-1,26,23.8,0,-1,0,-1,-1,-2,-2,-3
"7087",2020-02-16,"Brush Creek Rd","w1920","Motorized",0,"Sun","weekend","sled","1","1","1",8.8,0.2,37,-1,26,23.8,0,-1,0,-1,-1,-2,-2,-3
"7088",2020-02-16,"Brush Creek Rd","w1920","Hybrid",0,"Sun","weekend","sled","1","1","1",8.8,0.2,37,-1,26,23.8,0,-1,0,-1,-1,-2,-2,-3
"7089",2020-02-17,"Brush Creek Rd","w1920","Non.motorized",10,"Mon","weekday","no_sled","2","1","1",9.2,0.4,43,6,25,21.4,-1,0,-1,0,5,5,4,4
"7090",2020-02-17,"Brush Creek Rd","w1920","Mechanized",0,"Mon","weekday","no_sled","2","1","1",9.2,0.4,43,6,25,21.4,-1,0,-1,0,5,5,4,4
"7091",2020-02-17,"Brush Creek Rd","w1920","Motorized",0,"Mon","weekday","sled","2","1","1",9.2,0.4,43,6,25,21.4,-1,0,-1,0,5,5,4,4
"7092",2020-02-17,"Brush Creek Rd","w1920","Hybrid",0,"Mon","weekday","sled","2","1","1",9.2,0.4,43,6,25,21.4,-1,0,-1,0,5,5,4,4
"7093",2020-02-18,"Brush Creek Rd","w1920","Non.motorized",9,"Tue","weekday","no_sled","1","1","1",9.3,0.1,42,-1,18,22.1,6,-1,0,-1,5,4,4,3
"7094",2020-02-18,"Brush Creek Rd","w1920","Mechanized",0,"Tue","weekday","no_sled","1","1","1",9.3,0.1,42,-1,18,22.1,6,-1,0,-1,5,4,4,3
"7095",2020-02-18,"Brush Creek Rd","w1920","Motorized",0,"Tue","weekday","sled","1","1","1",9.3,0.1,42,-1,18,22.1,6,-1,0,-1,5,4,4,3
"7096",2020-02-18,"Brush Creek Rd","w1920","Hybrid",0,"Tue","weekday","sled","1","1","1",9.3,0.1,42,-1,18,22.1,6,-1,0,-1,5,4,4,3
"7097",2020-02-19,"Brush Creek Rd","w1920","Non.motorized",3,"Wed","weekday","no_sled","1","1","1",9.3,0,41,-1,22,22.7,-1,6,-1,0,-2,4,3,3
"7098",2020-02-19,"Brush Creek Rd","w1920","Mechanized",0,"Wed","weekday","no_sled","1","1","1",9.3,0,41,-1,22,22.7,-1,6,-1,0,-2,4,3,3
"7099",2020-02-19,"Brush Creek Rd","w1920","Motorized",0,"Wed","weekday","sled","1","1","1",9.3,0,41,-1,22,22.7,-1,6,-1,0,-2,4,3,3
"7100",2020-02-19,"Brush Creek Rd","w1920","Hybrid",0,"Wed","weekday","sled","1","1","1",9.3,0,41,-1,22,22.7,-1,6,-1,0,-2,4,3,3
"7101",2020-02-20,"Brush Creek Rd","w1920","Non.motorized",6,"Thu","weekday","no_sled","1","1","1",9.3,0,41,0,18,22.7,-1,-1,6,-1,-1,-2,4,3
"7102",2020-02-20,"Brush Creek Rd","w1920","Mechanized",0,"Thu","weekday","no_sled","1","1","1",9.3,0,41,0,18,22.7,-1,-1,6,-1,-1,-2,4,3
"7103",2020-02-20,"Brush Creek Rd","w1920","Motorized",0,"Thu","weekday","sled","1","1","1",9.3,0,41,0,18,22.7,-1,-1,6,-1,-1,-2,4,3
"7104",2020-02-20,"Brush Creek Rd","w1920","Hybrid",0,"Thu","weekday","sled","1","1","1",9.3,0,41,0,18,22.7,-1,-1,6,-1,-1,-2,4,3
"7105",2020-02-21,"Brush Creek Rd","w1920","Non.motorized",7,"Fri","weekday","no_sled","1","1","1",9.3,0,40,-1,26,23.2,0,-1,-1,6,-1,-2,-3,3
"7106",2020-02-21,"Brush Creek Rd","w1920","Mechanized",0,"Fri","weekday","no_sled","1","1","1",9.3,0,40,-1,26,23.2,0,-1,-1,6,-1,-2,-3,3
"7107",2020-02-21,"Brush Creek Rd","w1920","Motorized",0,"Fri","weekday","sled","1","1","1",9.3,0,40,-1,26,23.2,0,-1,-1,6,-1,-2,-3,3
"7108",2020-02-21,"Brush Creek Rd","w1920","Hybrid",0,"Fri","weekday","sled","1","1","1",9.3,0,40,-1,26,23.2,0,-1,-1,6,-1,-2,-3,3
"7109",2020-02-22,"Brush Creek Rd","w1920","Non.motorized",15,"Sat","weekend","no_sled","1","1","1",9.4,0.1,39,-1,32,24.1,-1,0,-1,-1,-2,-2,-3,-4
"7110",2020-02-22,"Brush Creek Rd","w1920","Mechanized",0,"Sat","weekend","no_sled","1","1","1",9.4,0.1,39,-1,32,24.1,-1,0,-1,-1,-2,-2,-3,-4
"7111",2020-02-22,"Brush Creek Rd","w1920","Motorized",0,"Sat","weekend","sled","1","1","1",9.4,0.1,39,-1,32,24.1,-1,0,-1,-1,-2,-2,-3,-4
"7112",2020-02-22,"Brush Creek Rd","w1920","Hybrid",0,"Sat","weekend","sled","1","1","1",9.4,0.1,39,-1,32,24.1,-1,0,-1,-1,-2,-2,-3,-4
"7113",2020-02-23,"Brush Creek Rd","w1920","Non.motorized",7,"Sun","weekend","no_sled","2","2","2",9.5,0.1,40,1,27,23.8,-1,-1,0,-1,0,-1,-1,-2
"7114",2020-02-23,"Brush Creek Rd","w1920","Mechanized",0,"Sun","weekend","no_sled","2","2","2",9.5,0.1,40,1,27,23.8,-1,-1,0,-1,0,-1,-1,-2
"7115",2020-02-23,"Brush Creek Rd","w1920","Motorized",0,"Sun","weekend","sled","2","2","2",9.5,0.1,40,1,27,23.8,-1,-1,0,-1,0,-1,-1,-2
"7116",2020-02-23,"Brush Creek Rd","w1920","Hybrid",0,"Sun","weekend","sled","2","2","2",9.5,0.1,40,1,27,23.8,-1,-1,0,-1,0,-1,-1,-2
"7117",2020-02-24,"Brush Creek Rd","w1920","Non.motorized",1,"Mon","weekday","no_sled","3","3","2",9.8,0.3,43,3,17,22.8,1,-1,-1,0,4,3,2,2
"7118",2020-02-24,"Brush Creek Rd","w1920","Mechanized",0,"Mon","weekday","no_sled","3","3","2",9.8,0.3,43,3,17,22.8,1,-1,-1,0,4,3,2,2
"7119",2020-02-24,"Brush Creek Rd","w1920","Motorized",0,"Mon","weekday","sled","3","3","2",9.8,0.3,43,3,17,22.8,1,-1,-1,0,4,3,2,2
"7120",2020-02-24,"Brush Creek Rd","w1920","Hybrid",0,"Mon","weekday","sled","3","3","2",9.8,0.3,43,3,17,22.8,1,-1,-1,0,4,3,2,2
"7121",2020-02-25,"Brush Creek Rd","w1920","Non.motorized",0,"Tue","weekday","no_sled","2","2","1",9.8,0,43,0,8,22.8,3,1,-1,-1,3,4,3,2
"7122",2020-02-25,"Brush Creek Rd","w1920","Mechanized",0,"Tue","weekday","no_sled","2","2","1",9.8,0,43,0,8,22.8,3,1,-1,-1,3,4,3,2
"7123",2020-02-25,"Brush Creek Rd","w1920","Motorized",0,"Tue","weekday","sled","2","2","1",9.8,0,43,0,8,22.8,3,1,-1,-1,3,4,3,2
"7124",2020-02-25,"Brush Creek Rd","w1920","Hybrid",0,"Tue","weekday","sled","2","2","1",9.8,0,43,0,8,22.8,3,1,-1,-1,3,4,3,2
"7125",2020-02-26,"Brush Creek Rd","w1920","Non.motorized",1,"Wed","weekday","no_sled","2","2","1",9.8,0,42,-1,15,23.3,0,3,1,-1,-1,2,3,2
"7126",2020-02-26,"Brush Creek Rd","w1920","Mechanized",0,"Wed","weekday","no_sled","2","2","1",9.8,0,42,-1,15,23.3,0,3,1,-1,-1,2,3,2
"7127",2020-02-26,"Brush Creek Rd","w1920","Motorized",0,"Wed","weekday","sled","2","2","1",9.8,0,42,-1,15,23.3,0,3,1,-1,-1,2,3,2
"7128",2020-02-26,"Brush Creek Rd","w1920","Hybrid",0,"Wed","weekday","sled","2","2","1",9.8,0,42,-1,15,23.3,0,3,1,-1,-1,2,3,2
"7129",2020-02-27,"Brush Creek Rd","w1920","Non.motorized",22,"Thu","weekday","no_sled","2","2","1",9.9,0.1,41,-1,25,24.1,-1,0,3,1,-2,-2,1,2
"7130",2020-02-27,"Brush Creek Rd","w1920","Mechanized",0,"Thu","weekday","no_sled","2","2","1",9.9,0.1,41,-1,25,24.1,-1,0,3,1,-2,-2,1,2
"7131",2020-02-27,"Brush Creek Rd","w1920","Motorized",0,"Thu","weekday","sled","2","2","1",9.9,0.1,41,-1,25,24.1,-1,0,3,1,-2,-2,1,2
"7132",2020-02-27,"Brush Creek Rd","w1920","Hybrid",0,"Thu","weekday","sled","2","2","1",9.9,0.1,41,-1,25,24.1,-1,0,3,1,-2,-2,1,2
"7133",2020-02-28,"Brush Creek Rd","w1920","Non.motorized",6,"Fri","weekday","no_sled","2","1","1",9.9,0,41,0,28,24.1,-1,-1,0,3,-1,-2,-2,1
"7134",2020-02-28,"Brush Creek Rd","w1920","Mechanized",0,"Fri","weekday","no_sled","2","1","1",9.9,0,41,0,28,24.1,-1,-1,0,3,-1,-2,-2,1
"7135",2020-02-28,"Brush Creek Rd","w1920","Motorized",0,"Fri","weekday","sled","2","1","1",9.9,0,41,0,28,24.1,-1,-1,0,3,-1,-2,-2,1
"7136",2020-02-28,"Brush Creek Rd","w1920","Hybrid",0,"Fri","weekday","sled","2","1","1",9.9,0,41,0,28,24.1,-1,-1,0,3,-1,-2,-2,1
"7137",2020-02-29,"Brush Creek Rd","w1920","Non.motorized",17,"Sat","weekend","no_sled","1","1","1",9.9,0,40,-1,29,24.8,0,-1,-1,0,-1,-2,-3,-3
"7138",2020-02-29,"Brush Creek Rd","w1920","Mechanized",0,"Sat","weekend","no_sled","1","1","1",9.9,0,40,-1,29,24.8,0,-1,-1,0,-1,-2,-3,-3
"7139",2020-02-29,"Brush Creek Rd","w1920","Motorized",0,"Sat","weekend","sled","1","1","1",9.9,0,40,-1,29,24.8,0,-1,-1,0,-1,-2,-3,-3
"7140",2020-02-29,"Brush Creek Rd","w1920","Hybrid",0,"Sat","weekend","sled","1","1","1",9.9,0,40,-1,29,24.8,0,-1,-1,0,-1,-2,-3,-3
"7141",2020-03-01,"Brush Creek Rd","w1920","Non.motorized",13,"Sun","weekend","no_sled","1","1","1",10,0.1,40,0,28,25,-1,0,-1,-1,-1,-1,-2,-3
"7142",2020-03-01,"Brush Creek Rd","w1920","Mechanized",0,"Sun","weekend","no_sled","1","1","1",10,0.1,40,0,28,25,-1,0,-1,-1,-1,-1,-2,-3
"7143",2020-03-01,"Brush Creek Rd","w1920","Motorized",0,"Sun","weekend","sled","1","1","1",10,0.1,40,0,28,25,-1,0,-1,-1,-1,-1,-2,-3
"7144",2020-03-01,"Brush Creek Rd","w1920","Hybrid",0,"Sun","weekend","sled","1","1","1",10,0.1,40,0,28,25,-1,0,-1,-1,-1,-1,-2,-3
"7145",2020-03-02,"Brush Creek Rd","w1920","Non.motorized",0,"Mon","weekday","no_sled","2","2","1",10.4,0.4,45,5,25,23.1,0,-1,0,-1,5,4,4,3
"7146",2020-03-02,"Brush Creek Rd","w1920","Mechanized",0,"Mon","weekday","no_sled","2","2","1",10.4,0.4,45,5,25,23.1,0,-1,0,-1,5,4,4,3
"7147",2020-03-02,"Brush Creek Rd","w1920","Motorized",0,"Mon","weekday","sled","2","2","1",10.4,0.4,45,5,25,23.1,0,-1,0,-1,5,4,4,3
"7148",2020-03-02,"Brush Creek Rd","w1920","Hybrid",0,"Mon","weekday","sled","2","2","1",10.4,0.4,45,5,25,23.1,0,-1,0,-1,5,4,4,3
"7149",2020-03-03,"Brush Creek Rd","w1920","Non.motorized",0,"Tue","weekday","no_sled","2","1","1",10.9,0.5,50,5,25,21.8,5,0,-1,0,10,10,9,9
"7150",2020-03-03,"Brush Creek Rd","w1920","Mechanized",0,"Tue","weekday","no_sled","2","1","1",10.9,0.5,50,5,25,21.8,5,0,-1,0,10,10,9,9
"7151",2020-03-03,"Brush Creek Rd","w1920","Motorized",0,"Tue","weekday","sled","2","1","1",10.9,0.5,50,5,25,21.8,5,0,-1,0,10,10,9,9
"7152",2020-03-03,"Brush Creek Rd","w1920","Hybrid",0,"Tue","weekday","sled","2","1","1",10.9,0.5,50,5,25,21.8,5,0,-1,0,10,10,9,9
"7153",2020-03-04,"Brush Creek Rd","w1920","Non.motorized",1,"Wed","weekday","no_sled","2","1","1",10.9,0,48,-2,29,22.7,5,5,0,-1,3,8,8,7
"7154",2020-03-04,"Brush Creek Rd","w1920","Mechanized",0,"Wed","weekday","no_sled","2","1","1",10.9,0,48,-2,29,22.7,5,5,0,-1,3,8,8,7
"7155",2020-03-04,"Brush Creek Rd","w1920","Motorized",0,"Wed","weekday","sled","2","1","1",10.9,0,48,-2,29,22.7,5,5,0,-1,3,8,8,7
"7156",2020-03-04,"Brush Creek Rd","w1920","Hybrid",0,"Wed","weekday","sled","2","1","1",10.9,0,48,-2,29,22.7,5,5,0,-1,3,8,8,7
"7157",2020-03-05,"Brush Creek Rd","w1920","Non.motorized",0,"Thu","weekday","no_sled","2","1","1",10.9,0,46,-2,32,23.7,-2,5,5,0,-4,1,6,6
"7158",2020-03-05,"Brush Creek Rd","w1920","Mechanized",0,"Thu","weekday","no_sled","2","1","1",10.9,0,46,-2,32,23.7,-2,5,5,0,-4,1,6,6
"7159",2020-03-05,"Brush Creek Rd","w1920","Motorized",0,"Thu","weekday","sled","2","1","1",10.9,0,46,-2,32,23.7,-2,5,5,0,-4,1,6,6
"7160",2020-03-05,"Brush Creek Rd","w1920","Hybrid",0,"Thu","weekday","sled","2","1","1",10.9,0,46,-2,32,23.7,-2,5,5,0,-4,1,6,6
"7161",2020-03-06,"Brush Creek Rd","w1920","Non.motorized",7,"Fri","weekday","no_sled","1","1","1",10.9,0,45,-1,34,24.2,-2,-2,5,5,-3,-5,0,5
"7162",2020-03-06,"Brush Creek Rd","w1920","Mechanized",0,"Fri","weekday","no_sled","1","1","1",10.9,0,45,-1,34,24.2,-2,-2,5,5,-3,-5,0,5
"7163",2020-03-06,"Brush Creek Rd","w1920","Motorized",0,"Fri","weekday","sled","1","1","1",10.9,0,45,-1,34,24.2,-2,-2,5,5,-3,-5,0,5
"7164",2020-03-06,"Brush Creek Rd","w1920","Hybrid",0,"Fri","weekday","sled","1","1","1",10.9,0,45,-1,34,24.2,-2,-2,5,5,-3,-5,0,5
"7165",2020-03-07,"Brush Creek Rd","w1920","Non.motorized",11,"Sat","weekend","no_sled","1","1","2",10.9,0,44,-1,35,24.8,-1,-2,-2,5,-2,-4,-6,-1
"7166",2020-03-07,"Brush Creek Rd","w1920","Mechanized",0,"Sat","weekend","no_sled","1","1","2",10.9,0,44,-1,35,24.8,-1,-2,-2,5,-2,-4,-6,-1
"7167",2020-03-07,"Brush Creek Rd","w1920","Motorized",0,"Sat","weekend","sled","1","1","2",10.9,0,44,-1,35,24.8,-1,-2,-2,5,-2,-4,-6,-1
"7168",2020-03-07,"Brush Creek Rd","w1920","Hybrid",0,"Sat","weekend","sled","1","1","2",10.9,0,44,-1,35,24.8,-1,-2,-2,5,-2,-4,-6,-1
"7169",2020-03-08,"Brush Creek Rd","w1920","Non.motorized",13,"Sun","weekend","no_sled","1","1","1",11,0.1,43,-1,33,25.6,-1,-1,-2,-2,-2,-3,-5,-7
"7170",2020-03-08,"Brush Creek Rd","w1920","Mechanized",0,"Sun","weekend","no_sled","1","1","1",11,0.1,43,-1,33,25.6,-1,-1,-2,-2,-2,-3,-5,-7
"7171",2020-03-08,"Brush Creek Rd","w1920","Motorized",0,"Sun","weekend","sled","1","1","1",11,0.1,43,-1,33,25.6,-1,-1,-2,-2,-2,-3,-5,-7
"7172",2020-03-08,"Brush Creek Rd","w1920","Hybrid",0,"Sun","weekend","sled","1","1","1",11,0.1,43,-1,33,25.6,-1,-1,-2,-2,-2,-3,-5,-7
"7173",2020-03-09,"Brush Creek Rd","w1920","Non.motorized",3,"Mon","weekday","no_sled","1","1","1",11.1,0.1,42,-1,31,26.4,-1,-1,-1,-2,-2,-3,-4,-6
"7174",2020-03-09,"Brush Creek Rd","w1920","Mechanized",0,"Mon","weekday","no_sled","1","1","1",11.1,0.1,42,-1,31,26.4,-1,-1,-1,-2,-2,-3,-4,-6
"7175",2020-03-09,"Brush Creek Rd","w1920","Motorized",0,"Mon","weekday","sled","1","1","1",11.1,0.1,42,-1,31,26.4,-1,-1,-1,-2,-2,-3,-4,-6
"7176",2020-03-09,"Brush Creek Rd","w1920","Hybrid",0,"Mon","weekday","sled","1","1","1",11.1,0.1,42,-1,31,26.4,-1,-1,-1,-2,-2,-3,-4,-6
"7177",2020-03-10,"Brush Creek Rd","w1920","Non.motorized",0,"Tue","weekday","no_sled","1","1","2",11.2,0.1,44,2,31,25.5,-1,-1,-1,-1,1,0,-1,-2
"7178",2020-03-10,"Brush Creek Rd","w1920","Mechanized",0,"Tue","weekday","no_sled","1","1","2",11.2,0.1,44,2,31,25.5,-1,-1,-1,-1,1,0,-1,-2
"7179",2020-03-10,"Brush Creek Rd","w1920","Motorized",0,"Tue","weekday","sled","1","1","2",11.2,0.1,44,2,31,25.5,-1,-1,-1,-1,1,0,-1,-2
"7180",2020-03-10,"Brush Creek Rd","w1920","Hybrid",0,"Tue","weekday","sled","1","1","2",11.2,0.1,44,2,31,25.5,-1,-1,-1,-1,1,0,-1,-2
"7181",2020-03-11,"Brush Creek Rd","w1920","Non.motorized",9,"Wed","weekday","no_sled","2","2","1",11.2,0,44,0,32,25.5,2,-1,-1,-1,2,1,0,-1
"7182",2020-03-11,"Brush Creek Rd","w1920","Mechanized",0,"Wed","weekday","no_sled","2","2","1",11.2,0,44,0,32,25.5,2,-1,-1,-1,2,1,0,-1
"7183",2020-03-11,"Brush Creek Rd","w1920","Motorized",0,"Wed","weekday","sled","2","2","1",11.2,0,44,0,32,25.5,2,-1,-1,-1,2,1,0,-1
"7184",2020-03-11,"Brush Creek Rd","w1920","Hybrid",0,"Wed","weekday","sled","2","2","1",11.2,0,44,0,32,25.5,2,-1,-1,-1,2,1,0,-1
"7185",2020-03-12,"Brush Creek Rd","w1920","Non.motorized",4,"Thu","weekday","no_sled","2","2","2",11.4,0.2,42,-2,35,27.1,0,2,-1,-1,-2,0,-1,-2
"7186",2020-03-12,"Brush Creek Rd","w1920","Mechanized",0,"Thu","weekday","no_sled","2","2","2",11.4,0.2,42,-2,35,27.1,0,2,-1,-1,-2,0,-1,-2
"7187",2020-03-12,"Brush Creek Rd","w1920","Motorized",0,"Thu","weekday","sled","2","2","2",11.4,0.2,42,-2,35,27.1,0,2,-1,-1,-2,0,-1,-2
"7188",2020-03-12,"Brush Creek Rd","w1920","Hybrid",0,"Thu","weekday","sled","2","2","2",11.4,0.2,42,-2,35,27.1,0,2,-1,-1,-2,0,-1,-2
"7189",2020-03-13,"Brush Creek Rd","w1920","Non.motorized",10,"Fri","weekday","no_sled","3","3","2",11.5,0.1,44,2,31,26.1,-2,0,2,-1,0,0,2,1
"7190",2020-03-13,"Brush Creek Rd","w1920","Mechanized",0,"Fri","weekday","no_sled","3","3","2",11.5,0.1,44,2,31,26.1,-2,0,2,-1,0,0,2,1
"7191",2020-03-13,"Brush Creek Rd","w1920","Motorized",0,"Fri","weekday","sled","3","3","2",11.5,0.1,44,2,31,26.1,-2,0,2,-1,0,0,2,1
"7192",2020-03-13,"Brush Creek Rd","w1920","Hybrid",0,"Fri","weekday","sled","3","3","2",11.5,0.1,44,2,31,26.1,-2,0,2,-1,0,0,2,1
"7193",2020-03-14,"Brush Creek Rd","w1920","Non.motorized",16,"Sat","weekend","no_sled","3","3","3",11.7,0.2,44,0,31,26.6,2,-2,0,2,2,0,0,2
"7194",2020-03-14,"Brush Creek Rd","w1920","Mechanized",0,"Sat","weekend","no_sled","3","3","3",11.7,0.2,44,0,31,26.6,2,-2,0,2,2,0,0,2
"7195",2020-03-14,"Brush Creek Rd","w1920","Motorized",0,"Sat","weekend","sled","3","3","3",11.7,0.2,44,0,31,26.6,2,-2,0,2,2,0,0,2
"7196",2020-03-14,"Brush Creek Rd","w1920","Hybrid",0,"Sat","weekend","sled","3","3","3",11.7,0.2,44,0,31,26.6,2,-2,0,2,2,0,0,2
"7197",2020-03-15,"Brush Creek Rd","w1920","Non.motorized",27,"Sun","weekend","no_sled","2","2","2",11.7,0,45,1,33,26,0,2,-2,0,1,3,1,1
"7198",2020-03-15,"Brush Creek Rd","w1920","Mechanized",0,"Sun","weekend","no_sled","2","2","2",11.7,0,45,1,33,26,0,2,-2,0,1,3,1,1
"7199",2020-03-15,"Brush Creek Rd","w1920","Motorized",0,"Sun","weekend","sled","2","2","2",11.7,0,45,1,33,26,0,2,-2,0,1,3,1,1
"7200",2020-03-15,"Brush Creek Rd","w1920","Hybrid",0,"Sun","weekend","sled","2","2","2",11.7,0,45,1,33,26,0,2,-2,0,1,3,1,1
"7201",2020-03-16,"Brush Creek Rd","w1920","Non.motorized",5,"Mon","weekday","no_sled","2","2","2",11.7,0,45,0,35,26,1,0,2,-2,1,1,3,1
"7202",2020-03-16,"Brush Creek Rd","w1920","Mechanized",0,"Mon","weekday","no_sled","2","2","2",11.7,0,45,0,35,26,1,0,2,-2,1,1,3,1
"7203",2020-03-16,"Brush Creek Rd","w1920","Motorized",0,"Mon","weekday","sled","2","2","2",11.7,0,45,0,35,26,1,0,2,-2,1,1,3,1
"7204",2020-03-16,"Brush Creek Rd","w1920","Hybrid",0,"Mon","weekday","sled","2","2","2",11.7,0,45,0,35,26,1,0,2,-2,1,1,3,1
"7205",2020-03-17,"Brush Creek Rd","w1920","Non.motorized",11,"Tue","weekday","no_sled","2","2","2",11.7,0,44,-1,36,26.6,0,1,0,2,-1,0,0,2
"7206",2020-03-17,"Brush Creek Rd","w1920","Mechanized",0,"Tue","weekday","no_sled","2","2","2",11.7,0,44,-1,36,26.6,0,1,0,2,-1,0,0,2
"7207",2020-03-17,"Brush Creek Rd","w1920","Motorized",0,"Tue","weekday","sled","2","2","2",11.7,0,44,-1,36,26.6,0,1,0,2,-1,0,0,2
"7208",2020-03-17,"Brush Creek Rd","w1920","Hybrid",0,"Tue","weekday","sled","2","2","2",11.7,0,44,-1,36,26.6,0,1,0,2,-1,0,0,2
"7209",2020-03-18,"Brush Creek Rd","w1920","Non.motorized",12,"Wed","weekday","no_sled","2","2","2",11.7,0,43,-1,33,27.2,-1,0,1,0,-2,-2,-1,-1
"7210",2020-03-18,"Brush Creek Rd","w1920","Mechanized",0,"Wed","weekday","no_sled","2","2","2",11.7,0,43,-1,33,27.2,-1,0,1,0,-2,-2,-1,-1
"7211",2020-03-18,"Brush Creek Rd","w1920","Motorized",0,"Wed","weekday","sled","2","2","2",11.7,0,43,-1,33,27.2,-1,0,1,0,-2,-2,-1,-1
"7212",2020-03-18,"Brush Creek Rd","w1920","Hybrid",0,"Wed","weekday","sled","2","2","2",11.7,0,43,-1,33,27.2,-1,0,1,0,-2,-2,-1,-1
"7213",2020-03-19,"Brush Creek Rd","w1920","Non.motorized",5,"Thu","weekday","no_sled","3","3","3",11.8,0.1,43,0,27,27.4,-1,-1,0,1,-1,-2,-2,-1
"7214",2020-03-19,"Brush Creek Rd","w1920","Mechanized",0,"Thu","weekday","no_sled","3","3","3",11.8,0.1,43,0,27,27.4,-1,-1,0,1,-1,-2,-2,-1
"7215",2020-03-19,"Brush Creek Rd","w1920","Motorized",0,"Thu","weekday","sled","3","3","3",11.8,0.1,43,0,27,27.4,-1,-1,0,1,-1,-2,-2,-1
"7216",2020-03-19,"Brush Creek Rd","w1920","Hybrid",0,"Thu","weekday","sled","3","3","3",11.8,0.1,43,0,27,27.4,-1,-1,0,1,-1,-2,-2,-1
"7217",2020-03-20,"Brush Creek Rd","w1920","Non.motorized",12,"Fri","weekday","no_sled","3","3","2",12.7,0.9,52,9,26,24.4,0,-1,-1,0,9,8,7,7
"7218",2020-03-20,"Brush Creek Rd","w1920","Mechanized",0,"Fri","weekday","no_sled","3","3","2",12.7,0.9,52,9,26,24.4,0,-1,-1,0,9,8,7,7
"7219",2020-03-20,"Brush Creek Rd","w1920","Motorized",0,"Fri","weekday","sled","3","3","2",12.7,0.9,52,9,26,24.4,0,-1,-1,0,9,8,7,7
"7220",2020-03-20,"Brush Creek Rd","w1920","Hybrid",0,"Fri","weekday","sled","3","3","2",12.7,0.9,52,9,26,24.4,0,-1,-1,0,9,8,7,7
"7221",2020-03-21,"Brush Creek Rd","w1920","Non.motorized",12,"Sat","weekend","no_sled","3","3","2",12.8,0.1,54,2,26,23.7,9,0,-1,-1,11,11,10,9
"7222",2020-03-21,"Brush Creek Rd","w1920","Mechanized",0,"Sat","weekend","no_sled","3","3","2",12.8,0.1,54,2,26,23.7,9,0,-1,-1,11,11,10,9
"7223",2020-03-21,"Brush Creek Rd","w1920","Motorized",0,"Sat","weekend","sled","3","3","2",12.8,0.1,54,2,26,23.7,9,0,-1,-1,11,11,10,9
"7224",2020-03-21,"Brush Creek Rd","w1920","Hybrid",0,"Sat","weekend","sled","3","3","2",12.8,0.1,54,2,26,23.7,9,0,-1,-1,11,11,10,9
"7225",2020-03-22,"Brush Creek Rd","w1920","Non.motorized",22,"Sun","weekend","no_sled","2","2","2",13,0.2,53,-1,28,24.5,2,9,0,-1,1,10,10,9
"7226",2020-03-22,"Brush Creek Rd","w1920","Mechanized",0,"Sun","weekend","no_sled","2","2","2",13,0.2,53,-1,28,24.5,2,9,0,-1,1,10,10,9
"7227",2020-03-22,"Brush Creek Rd","w1920","Motorized",0,"Sun","weekend","sled","2","2","2",13,0.2,53,-1,28,24.5,2,9,0,-1,1,10,10,9
"7228",2020-03-22,"Brush Creek Rd","w1920","Hybrid",0,"Sun","weekend","sled","2","2","2",13,0.2,53,-1,28,24.5,2,9,0,-1,1,10,10,9
"7229",2020-03-23,"Brush Creek Rd","w1920","Non.motorized",10,"Mon","weekday","no_sled","2","2","2",13,0,53,0,28,24.5,-1,2,9,0,-1,1,10,10
"7230",2020-03-23,"Brush Creek Rd","w1920","Mechanized",0,"Mon","weekday","no_sled","2","2","2",13,0,53,0,28,24.5,-1,2,9,0,-1,1,10,10
"7231",2020-03-23,"Brush Creek Rd","w1920","Motorized",2,"Mon","weekday","sled","2","2","2",13,0,53,0,28,24.5,-1,2,9,0,-1,1,10,10
"7232",2020-03-23,"Brush Creek Rd","w1920","Hybrid",0,"Mon","weekday","sled","2","2","2",13,0,53,0,28,24.5,-1,2,9,0,-1,1,10,10
"7233",2020-03-24,"Brush Creek Rd","w1920","Non.motorized",NA,"Tue","weekday","no_sled","2","2","2",13.2,0.2,53,0,32,24.9,0,-1,2,9,0,-1,1,10
"7234",2020-03-24,"Brush Creek Rd","w1920","Mechanized",NA,"Tue","weekday","no_sled","2","2","2",13.2,0.2,53,0,32,24.9,0,-1,2,9,0,-1,1,10
"7235",2020-03-24,"Brush Creek Rd","w1920","Motorized",NA,"Tue","weekday","sled","2","2","2",13.2,0.2,53,0,32,24.9,0,-1,2,9,0,-1,1,10
"7236",2020-03-24,"Brush Creek Rd","w1920","Hybrid",NA,"Tue","weekday","sled","2","2","2",13.2,0.2,53,0,32,24.9,0,-1,2,9,0,-1,1,10
"7237",2020-03-25,"Brush Creek Rd","w1920","Non.motorized",NA,"Wed","weekday","no_sled","2","2","2",13.3,0.1,51,-2,34,26.1,0,0,-1,2,-2,-2,-3,-1
"7238",2020-03-25,"Brush Creek Rd","w1920","Mechanized",NA,"Wed","weekday","no_sled","2","2","2",13.3,0.1,51,-2,34,26.1,0,0,-1,2,-2,-2,-3,-1
"7239",2020-03-25,"Brush Creek Rd","w1920","Motorized",NA,"Wed","weekday","sled","2","2","2",13.3,0.1,51,-2,34,26.1,0,0,-1,2,-2,-2,-3,-1
"7240",2020-03-25,"Brush Creek Rd","w1920","Hybrid",NA,"Wed","weekday","sled","2","2","2",13.3,0.1,51,-2,34,26.1,0,0,-1,2,-2,-2,-3,-1
"7241",2020-03-26,"Brush Creek Rd","w1920","Non.motorized",NA,"Thu","weekday","no_sled","2","2","2",13.3,0,50,-1,36,26.6,-2,0,0,-1,-3,-3,-3,-4
"7242",2020-03-26,"Brush Creek Rd","w1920","Non.motorized",NA,"Thu","weekday","no_sled","3","3","2",13.3,0,50,-1,36,26.6,-2,0,0,-1,-3,-3,-3,-4
"7243",2020-03-26,"Brush Creek Rd","w1920","Mechanized",NA,"Thu","weekday","no_sled","2","2","2",13.3,0,50,-1,36,26.6,-2,0,0,-1,-3,-3,-3,-4
"7244",2020-03-26,"Brush Creek Rd","w1920","Mechanized",NA,"Thu","weekday","no_sled","3","3","2",13.3,0,50,-1,36,26.6,-2,0,0,-1,-3,-3,-3,-4
"7245",2020-03-26,"Brush Creek Rd","w1920","Motorized",NA,"Thu","weekday","sled","2","2","2",13.3,0,50,-1,36,26.6,-2,0,0,-1,-3,-3,-3,-4
"7246",2020-03-26,"Brush Creek Rd","w1920","Motorized",NA,"Thu","weekday","sled","3","3","2",13.3,0,50,-1,36,26.6,-2,0,0,-1,-3,-3,-3,-4
"7247",2020-03-26,"Brush Creek Rd","w1920","Hybrid",NA,"Thu","weekday","sled","2","2","2",13.3,0,50,-1,36,26.6,-2,0,0,-1,-3,-3,-3,-4
"7248",2020-03-26,"Brush Creek Rd","w1920","Hybrid",NA,"Thu","weekday","sled","3","3","2",13.3,0,50,-1,36,26.6,-2,0,0,-1,-3,-3,-3,-4
"7249",2020-03-27,"Brush Creek Rd","w1920","Non.motorized",NA,"Fri","weekday","no_sled","3","3","2",13.3,0,50,0,23,26.6,-1,-2,0,0,-1,-3,-3,-3
"7250",2020-03-27,"Brush Creek Rd","w1920","Mechanized",NA,"Fri","weekday","no_sled","3","3","2",13.3,0,50,0,23,26.6,-1,-2,0,0,-1,-3,-3,-3
"7251",2020-03-27,"Brush Creek Rd","w1920","Motorized",NA,"Fri","weekday","sled","3","3","2",13.3,0,50,0,23,26.6,-1,-2,0,0,-1,-3,-3,-3
"7252",2020-03-27,"Brush Creek Rd","w1920","Hybrid",NA,"Fri","weekday","sled","3","3","2",13.3,0,50,0,23,26.6,-1,-2,0,0,-1,-3,-3,-3
"7253",2020-03-28,"Brush Creek Rd","w1920","Non.motorized",NA,"Sat","weekend","no_sled","3","3","3",13.3,0,50,0,18,26.6,0,-1,-2,0,0,-1,-3,-3
"7254",2020-03-28,"Brush Creek Rd","w1920","Mechanized",NA,"Sat","weekend","no_sled","3","3","3",13.3,0,50,0,18,26.6,0,-1,-2,0,0,-1,-3,-3
"7255",2020-03-28,"Brush Creek Rd","w1920","Motorized",NA,"Sat","weekend","sled","3","3","3",13.3,0,50,0,18,26.6,0,-1,-2,0,0,-1,-3,-3
"7256",2020-03-28,"Brush Creek Rd","w1920","Hybrid",NA,"Sat","weekend","sled","3","3","3",13.3,0,50,0,18,26.6,0,-1,-2,0,0,-1,-3,-3
"7257",2020-03-29,"Brush Creek Rd","w1920","Non.motorized",NA,"Sun","weekend","no_sled","2","2","2",13.3,0,49,-1,24,27.1,0,0,-1,-2,-1,-1,-2,-4
"7258",2020-03-29,"Brush Creek Rd","w1920","Mechanized",NA,"Sun","weekend","no_sled","2","2","2",13.3,0,49,-1,24,27.1,0,0,-1,-2,-1,-1,-2,-4
"7259",2020-03-29,"Brush Creek Rd","w1920","Motorized",NA,"Sun","weekend","sled","2","2","2",13.3,0,49,-1,24,27.1,0,0,-1,-2,-1,-1,-2,-4
"7260",2020-03-29,"Brush Creek Rd","w1920","Hybrid",NA,"Sun","weekend","sled","2","2","2",13.3,0,49,-1,24,27.1,0,0,-1,-2,-1,-1,-2,-4
"7261",2020-03-30,"Brush Creek Rd","w1920","Non.motorized",NA,"Mon","weekday","no_sled","2","2","2",13.4,0.1,49,0,29,27.3,-1,0,0,-1,-1,-1,-1,-2
"7262",2020-03-30,"Brush Creek Rd","w1920","Mechanized",NA,"Mon","weekday","no_sled","2","2","2",13.4,0.1,49,0,29,27.3,-1,0,0,-1,-1,-1,-1,-2
"7263",2020-03-30,"Brush Creek Rd","w1920","Motorized",NA,"Mon","weekday","sled","2","2","2",13.4,0.1,49,0,29,27.3,-1,0,0,-1,-1,-1,-1,-2
"7264",2020-03-30,"Brush Creek Rd","w1920","Hybrid",NA,"Mon","weekday","sled","2","2","2",13.4,0.1,49,0,29,27.3,-1,0,0,-1,-1,-1,-1,-2
"7265",2020-03-31,"Brush Creek Rd","w1920","Non.motorized",NA,"Tue","weekday","no_sled","2","2","2",13.6,0.2,51,2,35,26.7,0,-1,0,0,2,1,1,1
"7266",2020-03-31,"Brush Creek Rd","w1920","Mechanized",NA,"Tue","weekday","no_sled","2","2","2",13.6,0.2,51,2,35,26.7,0,-1,0,0,2,1,1,1
"7267",2020-03-31,"Brush Creek Rd","w1920","Motorized",NA,"Tue","weekday","sled","2","2","2",13.6,0.2,51,2,35,26.7,0,-1,0,0,2,1,1,1
"7268",2020-03-31,"Brush Creek Rd","w1920","Hybrid",NA,"Tue","weekday","sled","2","2","2",13.6,0.2,51,2,35,26.7,0,-1,0,0,2,1,1,1
"7269",2020-04-01,"Brush Creek Rd","w1920","Non.motorized",NA,"Wed","weekday","no_sled","2","2","2",13.6,0,47,-4,39,28.9,2,0,-1,0,-2,-2,-3,-3
"7270",2020-04-01,"Brush Creek Rd","w1920","Mechanized",NA,"Wed","weekday","no_sled","2","2","2",13.6,0,47,-4,39,28.9,2,0,-1,0,-2,-2,-3,-3
"7271",2020-04-01,"Brush Creek Rd","w1920","Motorized",NA,"Wed","weekday","sled","2","2","2",13.6,0,47,-4,39,28.9,2,0,-1,0,-2,-2,-3,-3
"7272",2020-04-01,"Brush Creek Rd","w1920","Hybrid",NA,"Wed","weekday","sled","2","2","2",13.6,0,47,-4,39,28.9,2,0,-1,0,-2,-2,-3,-3
"7273",2020-04-02,"Brush Creek Rd","w1920","Non.motorized",NA,"Thu","weekday","no_sled","2","2","2",13.6,0,46,-1,31,29.6,-4,2,0,-1,-5,-3,-3,-4
"7274",2020-04-02,"Brush Creek Rd","w1920","Mechanized",NA,"Thu","weekday","no_sled","2","2","2",13.6,0,46,-1,31,29.6,-4,2,0,-1,-5,-3,-3,-4
"7275",2020-04-02,"Brush Creek Rd","w1920","Motorized",NA,"Thu","weekday","sled","2","2","2",13.6,0,46,-1,31,29.6,-4,2,0,-1,-5,-3,-3,-4
"7276",2020-04-02,"Brush Creek Rd","w1920","Hybrid",NA,"Thu","weekday","sled","2","2","2",13.6,0,46,-1,31,29.6,-4,2,0,-1,-5,-3,-3,-4
"7277",2020-04-03,"Brush Creek Rd","w1920","Non.motorized",NA,"Fri","weekday","no_sled","2","2","2",13.6,0,46,0,28,29.6,-1,-4,2,0,-1,-5,-3,-3
"7278",2020-04-03,"Brush Creek Rd","w1920","Mechanized",NA,"Fri","weekday","no_sled","2","2","2",13.6,0,46,0,28,29.6,-1,-4,2,0,-1,-5,-3,-3
"7279",2020-04-03,"Brush Creek Rd","w1920","Motorized",NA,"Fri","weekday","sled","2","2","2",13.6,0,46,0,28,29.6,-1,-4,2,0,-1,-5,-3,-3
"7280",2020-04-03,"Brush Creek Rd","w1920","Hybrid",NA,"Fri","weekday","sled","2","2","2",13.6,0,46,0,28,29.6,-1,-4,2,0,-1,-5,-3,-3
"7281",2020-04-04,"Brush Creek Rd","w1920","Non.motorized",NA,"Sat","weekend","no_sled","2","2","2",13.6,0,45,-1,33,30.2,0,-1,-4,2,-1,-2,-6,-4
"7282",2020-04-04,"Brush Creek Rd","w1920","Mechanized",NA,"Sat","weekend","no_sled","2","2","2",13.6,0,45,-1,33,30.2,0,-1,-4,2,-1,-2,-6,-4
"7283",2020-04-04,"Brush Creek Rd","w1920","Motorized",NA,"Sat","weekend","sled","2","2","2",13.6,0,45,-1,33,30.2,0,-1,-4,2,-1,-2,-6,-4
"7284",2020-04-04,"Brush Creek Rd","w1920","Hybrid",NA,"Sat","weekend","sled","2","2","2",13.6,0,45,-1,33,30.2,0,-1,-4,2,-1,-2,-6,-4
"7285",2020-04-05,"Brush Creek Rd","w1920","Non.motorized",NA,"Sun","weekend","no_sled","2","2","3",13.6,0,45,0,38,30.2,-1,0,-1,-4,-1,-1,-2,-6
"7286",2020-04-05,"Brush Creek Rd","w1920","Mechanized",NA,"Sun","weekend","no_sled","2","2","3",13.6,0,45,0,38,30.2,-1,0,-1,-4,-1,-1,-2,-6
"7287",2020-04-05,"Brush Creek Rd","w1920","Motorized",NA,"Sun","weekend","sled","2","2","3",13.6,0,45,0,38,30.2,-1,0,-1,-4,-1,-1,-2,-6
"7288",2020-04-05,"Brush Creek Rd","w1920","Hybrid",NA,"Sun","weekend","sled","2","2","3",13.6,0,45,0,38,30.2,-1,0,-1,-4,-1,-1,-2,-6
"7289",2020-04-06,"Brush Creek Rd","w1920","Non.motorized",3,"Mon","weekday","no_sled","2","2","3",13.6,0,44,-1,40,30.9,0,-1,0,-1,-1,-2,-2,-3
"7290",2020-04-06,"Brush Creek Rd","w1920","Mechanized",0,"Mon","weekday","no_sled","2","2","3",13.6,0,44,-1,40,30.9,0,-1,0,-1,-1,-2,-2,-3
"7291",2020-04-06,"Brush Creek Rd","w1920","Motorized",0,"Mon","weekday","sled","2","2","3",13.6,0,44,-1,40,30.9,0,-1,0,-1,-1,-2,-2,-3
"7292",2020-04-06,"Brush Creek Rd","w1920","Hybrid",0,"Mon","weekday","sled","2","2","3",13.6,0,44,-1,40,30.9,0,-1,0,-1,-1,-2,-2,-3
"7293",2020-04-07,"Brush Creek Rd","w1920","Non.motorized",3,"Tue","weekday","no_sled","2","2","3",13.4,-0.2,43,-1,39,31.2,-1,0,-1,0,-2,-2,-3,-3
"7294",2020-04-07,"Brush Creek Rd","w1920","Mechanized",0,"Tue","weekday","no_sled","2","2","3",13.4,-0.2,43,-1,39,31.2,-1,0,-1,0,-2,-2,-3,-3
"7295",2020-04-07,"Brush Creek Rd","w1920","Motorized",0,"Tue","weekday","sled","2","2","3",13.4,-0.2,43,-1,39,31.2,-1,0,-1,0,-2,-2,-3,-3
"7296",2020-04-07,"Brush Creek Rd","w1920","Hybrid",0,"Tue","weekday","sled","2","2","3",13.4,-0.2,43,-1,39,31.2,-1,0,-1,0,-2,-2,-3,-3
"7297",2020-04-08,"Brush Creek Rd","w1920","Non.motorized",7,"Wed","weekday","no_sled","2","3","3",13.3,-0.1,42,-1,40,31.7,-1,-1,0,-1,-2,-3,-3,-4
"7298",2020-04-08,"Brush Creek Rd","w1920","Mechanized",0,"Wed","weekday","no_sled","2","3","3",13.3,-0.1,42,-1,40,31.7,-1,-1,0,-1,-2,-3,-3,-4
"7299",2020-04-08,"Brush Creek Rd","w1920","Motorized",0,"Wed","weekday","sled","2","3","3",13.3,-0.1,42,-1,40,31.7,-1,-1,0,-1,-2,-3,-3,-4
"7300",2020-04-08,"Brush Creek Rd","w1920","Hybrid",0,"Wed","weekday","sled","2","3","3",13.3,-0.1,42,-1,40,31.7,-1,-1,0,-1,-2,-3,-3,-4
"7301",2020-04-09,"Brush Creek Rd","w1920","Non.motorized",5,"Thu","weekday","no_sled","2","3","3",13.1,-0.2,40,-2,42,32.8,-1,-1,-1,0,-3,-4,-5,-5
"7302",2020-04-09,"Brush Creek Rd","w1920","Mechanized",0,"Thu","weekday","no_sled","2","3","3",13.1,-0.2,40,-2,42,32.8,-1,-1,-1,0,-3,-4,-5,-5
"7303",2020-04-09,"Brush Creek Rd","w1920","Motorized",0,"Thu","weekday","sled","2","3","3",13.1,-0.2,40,-2,42,32.8,-1,-1,-1,0,-3,-4,-5,-5
"7304",2020-04-09,"Brush Creek Rd","w1920","Hybrid",0,"Thu","weekday","sled","2","3","3",13.1,-0.2,40,-2,42,32.8,-1,-1,-1,0,-3,-4,-5,-5
"7305",2020-04-10,"Brush Creek Rd","w1920","Non.motorized",2,"Fri","weekday","no_sled","3","3","3",12.9,-0.2,39,-1,38,33.1,-2,-1,-1,-1,-3,-4,-5,-6
"7306",2020-04-10,"Brush Creek Rd","w1920","Mechanized",0,"Fri","weekday","no_sled","3","3","3",12.9,-0.2,39,-1,38,33.1,-2,-1,-1,-1,-3,-4,-5,-6
"7307",2020-04-10,"Brush Creek Rd","w1920","Motorized",0,"Fri","weekday","sled","3","3","3",12.9,-0.2,39,-1,38,33.1,-2,-1,-1,-1,-3,-4,-5,-6
"7308",2020-04-10,"Brush Creek Rd","w1920","Hybrid",0,"Fri","weekday","sled","3","3","3",12.9,-0.2,39,-1,38,33.1,-2,-1,-1,-1,-3,-4,-5,-6
"7309",2020-04-11,"Brush Creek Rd","w1920","Non.motorized",6,"Sat","weekend","no_sled","2","3","3",12.9,0,39,0,36,33.1,-1,-2,-1,-1,-1,-3,-4,-5
"7310",2020-04-11,"Brush Creek Rd","w1920","Mechanized",0,"Sat","weekend","no_sled","2","3","3",12.9,0,39,0,36,33.1,-1,-2,-1,-1,-1,-3,-4,-5
"7311",2020-04-11,"Brush Creek Rd","w1920","Motorized",0,"Sat","weekend","sled","2","3","3",12.9,0,39,0,36,33.1,-1,-2,-1,-1,-1,-3,-4,-5
"7312",2020-04-11,"Brush Creek Rd","w1920","Hybrid",0,"Sat","weekend","sled","2","3","3",12.9,0,39,0,36,33.1,-1,-2,-1,-1,-1,-3,-4,-5
"7313",2020-04-12,"Brush Creek Rd","w1920","Non.motorized",10,"Sun","weekend","no_sled","2","2","2",12.8,-0.1,38,-1,29,33.7,0,-1,-2,-1,-1,-2,-4,-5
"7314",2020-04-12,"Brush Creek Rd","w1920","Mechanized",0,"Sun","weekend","no_sled","2","2","2",12.8,-0.1,38,-1,29,33.7,0,-1,-2,-1,-1,-2,-4,-5
"7315",2020-04-12,"Brush Creek Rd","w1920","Motorized",0,"Sun","weekend","sled","2","2","2",12.8,-0.1,38,-1,29,33.7,0,-1,-2,-1,-1,-2,-4,-5
"7316",2020-04-12,"Brush Creek Rd","w1920","Hybrid",0,"Sun","weekend","sled","2","2","2",12.8,-0.1,38,-1,29,33.7,0,-1,-2,-1,-1,-2,-4,-5
"7317",2020-04-13,"Brush Creek Rd","w1920","Non.motorized",6,"Mon","weekday","no_sled",NA,NA,NA,12.9,0.1,39,1,20,33.1,-1,0,-1,-2,0,0,-1,-3
"7318",2020-04-13,"Brush Creek Rd","w1920","Mechanized",0,"Mon","weekday","no_sled",NA,NA,NA,12.9,0.1,39,1,20,33.1,-1,0,-1,-2,0,0,-1,-3
"7319",2020-04-13,"Brush Creek Rd","w1920","Motorized",0,"Mon","weekday","sled",NA,NA,NA,12.9,0.1,39,1,20,33.1,-1,0,-1,-2,0,0,-1,-3
"7320",2020-04-13,"Brush Creek Rd","w1920","Hybrid",0,"Mon","weekday","sled",NA,NA,NA,12.9,0.1,39,1,20,33.1,-1,0,-1,-2,0,0,-1,-3
"7321",2020-04-14,"Brush Creek Rd","w1920","Non.motorized",4,"Tue","weekday","no_sled","2","2","2",13,0.1,39,0,18,33.3,1,-1,0,-1,1,0,0,-1
"7322",2020-04-14,"Brush Creek Rd","w1920","Mechanized",0,"Tue","weekday","no_sled","2","2","2",13,0.1,39,0,18,33.3,1,-1,0,-1,1,0,0,-1
"7323",2020-04-14,"Brush Creek Rd","w1920","Motorized",0,"Tue","weekday","sled","2","2","2",13,0.1,39,0,18,33.3,1,-1,0,-1,1,0,0,-1
"7324",2020-04-14,"Brush Creek Rd","w1920","Hybrid",0,"Tue","weekday","sled","2","2","2",13,0.1,39,0,18,33.3,1,-1,0,-1,1,0,0,-1
"7325",2020-04-15,"Brush Creek Rd","w1920","Non.motorized",2,"Wed","weekday","no_sled",NA,NA,NA,13.2,0.2,39,0,28,33.8,0,1,-1,0,0,1,0,0
"7326",2020-04-15,"Brush Creek Rd","w1920","Mechanized",0,"Wed","weekday","no_sled",NA,NA,NA,13.2,0.2,39,0,28,33.8,0,1,-1,0,0,1,0,0
"7327",2020-04-15,"Brush Creek Rd","w1920","Motorized",0,"Wed","weekday","sled",NA,NA,NA,13.2,0.2,39,0,28,33.8,0,1,-1,0,0,1,0,0
"7328",2020-04-15,"Brush Creek Rd","w1920","Hybrid",0,"Wed","weekday","sled",NA,NA,NA,13.2,0.2,39,0,28,33.8,0,1,-1,0,0,1,0,0
"7329",2019-12-06,"Cement Creek","w1920","Non.motorized",7,"Fri","weekday","no_sled","2","2","1",2.9,0.4,19,5,24,15.3,0,0,0,0,5,5,5,5
"7330",2019-12-06,"Cement Creek","w1920","Mechanized",2,"Fri","weekday","no_sled","2","2","1",2.9,0.4,19,5,24,15.3,0,0,0,0,5,5,5,5
"7331",2019-12-06,"Cement Creek","w1920","Motorized",3,"Fri","weekday","sled","2","2","1",2.9,0.4,19,5,24,15.3,0,0,0,0,5,5,5,5
"7332",2019-12-06,"Cement Creek","w1920","Hybrid",NA,"Fri","weekday","sled","2","2","1",2.9,0.4,19,5,24,15.3,0,0,0,0,5,5,5,5
"7333",2019-12-07,"Cement Creek","w1920","Non.motorized",34,"Sat","weekend","no_sled","2","2","1",3,0.1,18,-1,29,16.7,5,0,0,0,4,4,4,4
"7334",2019-12-07,"Cement Creek","w1920","Mechanized",2,"Sat","weekend","no_sled","2","2","1",3,0.1,18,-1,29,16.7,5,0,0,0,4,4,4,4
"7335",2019-12-07,"Cement Creek","w1920","Motorized",9,"Sat","weekend","sled","2","2","1",3,0.1,18,-1,29,16.7,5,0,0,0,4,4,4,4
"7336",2019-12-07,"Cement Creek","w1920","Hybrid",NA,"Sat","weekend","sled","2","2","1",3,0.1,18,-1,29,16.7,5,0,0,0,4,4,4,4
"7337",2019-12-08,"Cement Creek","w1920","Non.motorized",33,"Sun","weekend","no_sled","2","2","1",3,0,17,-1,28,17.6,-1,5,0,0,-2,3,3,3
"7338",2019-12-08,"Cement Creek","w1920","Mechanized",3,"Sun","weekend","no_sled","2","2","1",3,0,17,-1,28,17.6,-1,5,0,0,-2,3,3,3
"7339",2019-12-08,"Cement Creek","w1920","Motorized",2,"Sun","weekend","sled","2","2","1",3,0,17,-1,28,17.6,-1,5,0,0,-2,3,3,3
"7340",2019-12-08,"Cement Creek","w1920","Hybrid",NA,"Sun","weekend","sled","2","2","1",3,0,17,-1,28,17.6,-1,5,0,0,-2,3,3,3
"7341",2019-12-09,"Cement Creek","w1920","Non.motorized",3,"Mon","weekday","no_sled","3","3","2",3.4,0.4,22,5,21,15.5,-1,-1,5,0,4,3,8,8
"7342",2019-12-09,"Cement Creek","w1920","Mechanized",0,"Mon","weekday","no_sled","3","3","2",3.4,0.4,22,5,21,15.5,-1,-1,5,0,4,3,8,8
"7343",2019-12-09,"Cement Creek","w1920","Motorized",5,"Mon","weekday","sled","3","3","2",3.4,0.4,22,5,21,15.5,-1,-1,5,0,4,3,8,8
"7344",2019-12-09,"Cement Creek","w1920","Hybrid",NA,"Mon","weekday","sled","3","3","2",3.4,0.4,22,5,21,15.5,-1,-1,5,0,4,3,8,8
"7345",2019-12-10,"Cement Creek","w1920","Non.motorized",11,"Tue","weekday","no_sled","2","2","2",3.4,0,21,-1,19,16.2,5,-1,-1,5,4,3,2,7
"7346",2019-12-10,"Cement Creek","w1920","Mechanized",1,"Tue","weekday","no_sled","2","2","2",3.4,0,21,-1,19,16.2,5,-1,-1,5,4,3,2,7
"7347",2019-12-10,"Cement Creek","w1920","Motorized",5,"Tue","weekday","sled","2","2","2",3.4,0,21,-1,19,16.2,5,-1,-1,5,4,3,2,7
"7348",2019-12-10,"Cement Creek","w1920","Hybrid",1,"Tue","weekday","sled","2","2","2",3.4,0,21,-1,19,16.2,5,-1,-1,5,4,3,2,7
"7349",2019-12-11,"Cement Creek","w1920","Non.motorized",12,"Wed","weekday","no_sled","2","2","2",3.4,0,20,-1,22,17,-1,5,-1,-1,-2,3,2,1
"7350",2019-12-11,"Cement Creek","w1920","Mechanized",0,"Wed","weekday","no_sled","2","2","2",3.4,0,20,-1,22,17,-1,5,-1,-1,-2,3,2,1
"7351",2019-12-11,"Cement Creek","w1920","Motorized",2,"Wed","weekday","sled","2","2","2",3.4,0,20,-1,22,17,-1,5,-1,-1,-2,3,2,1
"7352",2019-12-11,"Cement Creek","w1920","Hybrid",NA,"Wed","weekday","sled","2","2","2",3.4,0,20,-1,22,17,-1,5,-1,-1,-2,3,2,1
"7353",2019-12-12,"Cement Creek","w1920","Non.motorized",9,"Thu","weekday","no_sled","2","2","2",3.4,0,19,-1,25,17.9,-1,-1,5,-1,-2,-3,2,1
"7354",2019-12-12,"Cement Creek","w1920","Mechanized",0,"Thu","weekday","no_sled","2","2","2",3.4,0,19,-1,25,17.9,-1,-1,5,-1,-2,-3,2,1
"7355",2019-12-12,"Cement Creek","w1920","Motorized",3,"Thu","weekday","sled","2","2","2",3.4,0,19,-1,25,17.9,-1,-1,5,-1,-2,-3,2,1
"7356",2019-12-12,"Cement Creek","w1920","Hybrid",NA,"Thu","weekday","sled","2","2","2",3.4,0,19,-1,25,17.9,-1,-1,5,-1,-2,-3,2,1
"7357",2019-12-13,"Cement Creek","w1920","Non.motorized",5,"Fri","weekday","no_sled","2","2","2",3.8,0.4,21,2,24,18.1,-1,-1,-1,5,1,0,-1,4
"7358",2019-12-13,"Cement Creek","w1920","Mechanized",0,"Fri","weekday","no_sled","2","2","2",3.8,0.4,21,2,24,18.1,-1,-1,-1,5,1,0,-1,4
"7359",2019-12-13,"Cement Creek","w1920","Motorized",5,"Fri","weekday","sled","2","2","2",3.8,0.4,21,2,24,18.1,-1,-1,-1,5,1,0,-1,4
"7360",2019-12-13,"Cement Creek","w1920","Hybrid",1,"Fri","weekday","sled","2","2","2",3.8,0.4,21,2,24,18.1,-1,-1,-1,5,1,0,-1,4
"7361",2019-12-14,"Cement Creek","w1920","Non.motorized",12,"Sat","weekend","no_sled","3","3","3",4.2,0.4,27,6,25,15.6,2,-1,-1,-1,8,7,6,5
"7362",2019-12-14,"Cement Creek","w1920","Mechanized",0,"Sat","weekend","no_sled","3","3","3",4.2,0.4,27,6,25,15.6,2,-1,-1,-1,8,7,6,5
"7363",2019-12-14,"Cement Creek","w1920","Motorized",2,"Sat","weekend","sled","3","3","3",4.2,0.4,27,6,25,15.6,2,-1,-1,-1,8,7,6,5
"7364",2019-12-14,"Cement Creek","w1920","Hybrid",2,"Sat","weekend","sled","3","3","3",4.2,0.4,27,6,25,15.6,2,-1,-1,-1,8,7,6,5
"7365",2019-12-15,"Cement Creek","w1920","Non.motorized",40,"Sun","weekend","no_sled","3","3","2",4.8,0.6,31,4,17,15.5,6,2,-1,-1,10,12,11,10
"7366",2019-12-15,"Cement Creek","w1920","Mechanized",0,"Sun","weekend","no_sled","3","3","2",4.8,0.6,31,4,17,15.5,6,2,-1,-1,10,12,11,10
"7367",2019-12-15,"Cement Creek","w1920","Motorized",4,"Sun","weekend","sled","3","3","2",4.8,0.6,31,4,17,15.5,6,2,-1,-1,10,12,11,10
"7368",2019-12-15,"Cement Creek","w1920","Hybrid",NA,"Sun","weekend","sled","3","3","2",4.8,0.6,31,4,17,15.5,6,2,-1,-1,10,12,11,10
"7369",2019-12-16,"Cement Creek","w1920","Non.motorized",9,"Mon","weekday","no_sled","3","3","2",4.8,0,29,-2,6,16.6,4,6,2,-1,2,8,10,9
"7370",2019-12-16,"Cement Creek","w1920","Mechanized",2,"Mon","weekday","no_sled","3","3","2",4.8,0,29,-2,6,16.6,4,6,2,-1,2,8,10,9
"7371",2019-12-16,"Cement Creek","w1920","Motorized",6,"Mon","weekday","sled","3","3","2",4.8,0,29,-2,6,16.6,4,6,2,-1,2,8,10,9
"7372",2019-12-16,"Cement Creek","w1920","Hybrid",1,"Mon","weekday","sled","3","3","2",4.8,0,29,-2,6,16.6,4,6,2,-1,2,8,10,9
"7373",2019-12-17,"Cement Creek","w1920","Non.motorized",4,"Tue","weekday","no_sled","2","2","1",4.8,0,27,-2,8,17.8,-2,4,6,2,-4,0,6,8
"7374",2019-12-17,"Cement Creek","w1920","Mechanized",1,"Tue","weekday","no_sled","2","2","1",4.8,0,27,-2,8,17.8,-2,4,6,2,-4,0,6,8
"7375",2019-12-17,"Cement Creek","w1920","Motorized",2,"Tue","weekday","sled","2","2","1",4.8,0,27,-2,8,17.8,-2,4,6,2,-4,0,6,8
"7376",2019-12-17,"Cement Creek","w1920","Hybrid",NA,"Tue","weekday","sled","2","2","1",4.8,0,27,-2,8,17.8,-2,4,6,2,-4,0,6,8
"7377",2019-12-18,"Cement Creek","w1920","Non.motorized",4,"Wed","weekday","no_sled","2","2","1",4.8,0,26,-1,20,18.5,-2,-2,4,6,-3,-5,-1,5
"7378",2019-12-18,"Cement Creek","w1920","Mechanized",5,"Wed","weekday","no_sled","2","2","1",4.8,0,26,-1,20,18.5,-2,-2,4,6,-3,-5,-1,5
"7379",2019-12-18,"Cement Creek","w1920","Motorized",2,"Wed","weekday","sled","2","2","1",4.8,0,26,-1,20,18.5,-2,-2,4,6,-3,-5,-1,5
"7380",2019-12-18,"Cement Creek","w1920","Hybrid",NA,"Wed","weekday","sled","2","2","1",4.8,0,26,-1,20,18.5,-2,-2,4,6,-3,-5,-1,5
"7381",2019-12-19,"Cement Creek","w1920","Non.motorized",5,"Thu","weekday","no_sled","2","2","1",4.9,0.1,25,-1,21,19.6,-1,-2,-2,4,-2,-4,-6,-2
"7382",2019-12-19,"Cement Creek","w1920","Mechanized",0,"Thu","weekday","no_sled","2","2","1",4.9,0.1,25,-1,21,19.6,-1,-2,-2,4,-2,-4,-6,-2
"7383",2019-12-19,"Cement Creek","w1920","Motorized",4,"Thu","weekday","sled","2","2","1",4.9,0.1,25,-1,21,19.6,-1,-2,-2,4,-2,-4,-6,-2
"7384",2019-12-19,"Cement Creek","w1920","Hybrid",1,"Thu","weekday","sled","2","2","1",4.9,0.1,25,-1,21,19.6,-1,-2,-2,4,-2,-4,-6,-2
"7385",2019-12-20,"Cement Creek","w1920","Non.motorized",4,"Fri","weekday","no_sled","2","2","1",4.9,0,24,-1,21,20.4,-1,-1,-2,-2,-2,-3,-5,-7
"7386",2019-12-20,"Cement Creek","w1920","Mechanized",0,"Fri","weekday","no_sled","2","2","1",4.9,0,24,-1,21,20.4,-1,-1,-2,-2,-2,-3,-5,-7
"7387",2019-12-20,"Cement Creek","w1920","Motorized",7,"Fri","weekday","sled","2","2","1",4.9,0,24,-1,21,20.4,-1,-1,-2,-2,-2,-3,-5,-7
"7388",2019-12-20,"Cement Creek","w1920","Hybrid",NA,"Fri","weekday","sled","2","2","1",4.9,0,24,-1,21,20.4,-1,-1,-2,-2,-2,-3,-5,-7
"7389",2019-12-21,"Cement Creek","w1920","Non.motorized",26,"Sat","weekend","no_sled","2","2","1",4.9,0,24,0,27,20.4,-1,-1,-1,-2,-1,-2,-3,-5
"7390",2019-12-21,"Cement Creek","w1920","Mechanized",3,"Sat","weekend","no_sled","2","2","1",4.9,0,24,0,27,20.4,-1,-1,-1,-2,-1,-2,-3,-5
"7391",2019-12-21,"Cement Creek","w1920","Motorized",3,"Sat","weekend","sled","2","2","1",4.9,0,24,0,27,20.4,-1,-1,-1,-2,-1,-2,-3,-5
"7392",2019-12-21,"Cement Creek","w1920","Hybrid",NA,"Sat","weekend","sled","2","2","1",4.9,0,24,0,27,20.4,-1,-1,-1,-2,-1,-2,-3,-5
"7393",2019-12-22,"Cement Creek","w1920","Non.motorized",31,"Sun","weekend","no_sled","2","2","1",5,0.1,23,-1,31,21.7,0,-1,-1,-1,-1,-2,-3,-4
"7394",2019-12-22,"Cement Creek","w1920","Mechanized",3,"Sun","weekend","no_sled","2","2","1",5,0.1,23,-1,31,21.7,0,-1,-1,-1,-1,-2,-3,-4
"7395",2019-12-22,"Cement Creek","w1920","Motorized",7,"Sun","weekend","sled","2","2","1",5,0.1,23,-1,31,21.7,0,-1,-1,-1,-1,-2,-3,-4
"7396",2019-12-22,"Cement Creek","w1920","Hybrid",NA,"Sun","weekend","sled","2","2","1",5,0.1,23,-1,31,21.7,0,-1,-1,-1,-1,-2,-3,-4
"7397",2019-12-23,"Cement Creek","w1920","Non.motorized",21,"Mon","weekday","no_sled","2","1","1",5,0,23,0,34,21.7,-1,0,-1,-1,-1,-1,-2,-3
"7398",2019-12-23,"Cement Creek","w1920","Mechanized",1,"Mon","weekday","no_sled","2","1","1",5,0,23,0,34,21.7,-1,0,-1,-1,-1,-1,-2,-3
"7399",2019-12-23,"Cement Creek","w1920","Motorized",1,"Mon","weekday","sled","2","1","1",5,0,23,0,34,21.7,-1,0,-1,-1,-1,-1,-2,-3
"7400",2019-12-23,"Cement Creek","w1920","Hybrid",NA,"Mon","weekday","sled","2","1","1",5,0,23,0,34,21.7,-1,0,-1,-1,-1,-1,-2,-3
"7401",2019-12-24,"Cement Creek","w1920","Non.motorized",22,"Tue","weekday","no_sled","2","1","1",5,0,22,-1,30,22.7,0,-1,0,-1,-1,-2,-2,-3
"7402",2019-12-24,"Cement Creek","w1920","Mechanized",6,"Tue","weekday","no_sled","2","1","1",5,0,22,-1,30,22.7,0,-1,0,-1,-1,-2,-2,-3
"7403",2019-12-24,"Cement Creek","w1920","Motorized",8,"Tue","weekday","sled","2","1","1",5,0,22,-1,30,22.7,0,-1,0,-1,-1,-2,-2,-3
"7404",2019-12-24,"Cement Creek","w1920","Hybrid",1,"Tue","weekday","sled","2","1","1",5,0,22,-1,30,22.7,0,-1,0,-1,-1,-2,-2,-3
"7405",2019-12-25,"Cement Creek","w1920","Non.motorized",30,"Wed","weekday","no_sled","2","2","2",5,0,23,1,22,21.7,-1,0,-1,0,0,0,-1,-1
"7406",2019-12-25,"Cement Creek","w1920","Mechanized",2,"Wed","weekday","no_sled","2","2","2",5,0,23,1,22,21.7,-1,0,-1,0,0,0,-1,-1
"7407",2019-12-25,"Cement Creek","w1920","Motorized",3,"Wed","weekday","sled","2","2","2",5,0,23,1,22,21.7,-1,0,-1,0,0,0,-1,-1
"7408",2019-12-25,"Cement Creek","w1920","Hybrid",2,"Wed","weekday","sled","2","2","2",5,0,23,1,22,21.7,-1,0,-1,0,0,0,-1,-1
"7409",2019-12-26,"Cement Creek","w1920","Non.motorized",25,"Thu","weekday","no_sled","2","2","1",5,0,23,0,17,21.7,1,-1,0,-1,1,0,0,-1
"7410",2019-12-26,"Cement Creek","w1920","Mechanized",1,"Thu","weekday","no_sled","2","2","1",5,0,23,0,17,21.7,1,-1,0,-1,1,0,0,-1
"7411",2019-12-26,"Cement Creek","w1920","Motorized",7,"Thu","weekday","sled","2","2","1",5,0,23,0,17,21.7,1,-1,0,-1,1,0,0,-1
"7412",2019-12-26,"Cement Creek","w1920","Hybrid",1,"Thu","weekday","sled","2","2","1",5,0,23,0,17,21.7,1,-1,0,-1,1,0,0,-1
"7413",2019-12-27,"Cement Creek","w1920","Non.motorized",22,"Fri","weekday","no_sled","3","3","2",5.1,0.1,24,1,22,21.2,0,1,-1,0,1,2,1,1
"7414",2019-12-27,"Cement Creek","w1920","Mechanized",1,"Fri","weekday","no_sled","3","3","2",5.1,0.1,24,1,22,21.2,0,1,-1,0,1,2,1,1
"7415",2019-12-27,"Cement Creek","w1920","Motorized",5,"Fri","weekday","sled","3","3","2",5.1,0.1,24,1,22,21.2,0,1,-1,0,1,2,1,1
"7416",2019-12-27,"Cement Creek","w1920","Hybrid",NA,"Fri","weekday","sled","3","3","2",5.1,0.1,24,1,22,21.2,0,1,-1,0,1,2,1,1
"7417",2019-12-28,"Cement Creek","w1920","Non.motorized",34,"Sat","weekend","no_sled","3","3","2",5.6,0.5,30,6,16,18.7,1,0,1,-1,7,7,8,7
"7418",2019-12-28,"Cement Creek","w1920","Mechanized",0,"Sat","weekend","no_sled","3","3","2",5.6,0.5,30,6,16,18.7,1,0,1,-1,7,7,8,7
"7419",2019-12-28,"Cement Creek","w1920","Motorized",3,"Sat","weekend","sled","3","3","2",5.6,0.5,30,6,16,18.7,1,0,1,-1,7,7,8,7
"7420",2019-12-28,"Cement Creek","w1920","Hybrid",NA,"Sat","weekend","sled","3","3","2",5.6,0.5,30,6,16,18.7,1,0,1,-1,7,7,8,7
"7421",2019-12-29,"Cement Creek","w1920","Non.motorized",30,"Sun","weekend","no_sled","3","3","2",5.6,0,29,-1,3,19.3,6,1,0,1,5,6,6,7
"7422",2019-12-29,"Cement Creek","w1920","Mechanized",0,"Sun","weekend","no_sled","3","3","2",5.6,0,29,-1,3,19.3,6,1,0,1,5,6,6,7
"7423",2019-12-29,"Cement Creek","w1920","Motorized",6,"Sun","weekend","sled","3","3","2",5.6,0,29,-1,3,19.3,6,1,0,1,5,6,6,7
"7424",2019-12-29,"Cement Creek","w1920","Hybrid",NA,"Sun","weekend","sled","3","3","2",5.6,0,29,-1,3,19.3,6,1,0,1,5,6,6,7
"7425",2019-12-30,"Cement Creek","w1920","Non.motorized",18,"Mon","weekday","no_sled","3","3","2",5.6,0,28,-1,3,20,-1,6,1,0,-2,4,5,5
"7426",2019-12-30,"Cement Creek","w1920","Mechanized",2,"Mon","weekday","no_sled","3","3","2",5.6,0,28,-1,3,20,-1,6,1,0,-2,4,5,5
"7427",2019-12-30,"Cement Creek","w1920","Motorized",0,"Mon","weekday","sled","3","3","2",5.6,0,28,-1,3,20,-1,6,1,0,-2,4,5,5
"7428",2019-12-30,"Cement Creek","w1920","Hybrid",NA,"Mon","weekday","sled","3","3","2",5.6,0,28,-1,3,20,-1,6,1,0,-2,4,5,5
"7429",2019-12-31,"Cement Creek","w1920","Non.motorized",5,"Tue","weekday","no_sled","2","2","1",5.6,0,28,0,13,20,-1,-1,6,1,-1,-2,4,5
"7430",2019-12-31,"Cement Creek","w1920","Mechanized",1,"Tue","weekday","no_sled","2","2","1",5.6,0,28,0,13,20,-1,-1,6,1,-1,-2,4,5
"7431",2019-12-31,"Cement Creek","w1920","Motorized",1,"Tue","weekday","sled","2","2","1",5.6,0,28,0,13,20,-1,-1,6,1,-1,-2,4,5
"7432",2019-12-31,"Cement Creek","w1920","Hybrid",NA,"Tue","weekday","sled","2","2","1",5.6,0,28,0,13,20,-1,-1,6,1,-1,-2,4,5
"7433",2020-01-01,"Cement Creek","w1920","Non.motorized",42,"Wed","weekday","no_sled","2","1","1",5.6,0,27,-1,21,20.7,0,-1,-1,6,-1,-2,-3,3
"7434",2020-01-01,"Cement Creek","w1920","Mechanized",1,"Wed","weekday","no_sled","2","1","1",5.6,0,27,-1,21,20.7,0,-1,-1,6,-1,-2,-3,3
"7435",2020-01-01,"Cement Creek","w1920","Motorized",3,"Wed","weekday","sled","2","1","1",5.6,0,27,-1,21,20.7,0,-1,-1,6,-1,-2,-3,3
"7436",2020-01-01,"Cement Creek","w1920","Hybrid",NA,"Wed","weekday","sled","2","1","1",5.6,0,27,-1,21,20.7,0,-1,-1,6,-1,-2,-3,3
"7437",2020-01-02,"Cement Creek","w1920","Non.motorized",19,"Thu","weekday","no_sled","3","3","2",5.9,0.3,29,2,16,20.3,-1,0,-1,-1,1,1,0,-1
"7438",2020-01-02,"Cement Creek","w1920","Mechanized",0,"Thu","weekday","no_sled","3","3","2",5.9,0.3,29,2,16,20.3,-1,0,-1,-1,1,1,0,-1
"7439",2020-01-02,"Cement Creek","w1920","Motorized",2,"Thu","weekday","sled","3","3","2",5.9,0.3,29,2,16,20.3,-1,0,-1,-1,1,1,0,-1
"7440",2020-01-02,"Cement Creek","w1920","Hybrid",NA,"Thu","weekday","sled","3","3","2",5.9,0.3,29,2,16,20.3,-1,0,-1,-1,1,1,0,-1
"7441",2020-01-03,"Cement Creek","w1920","Non.motorized",37,"Fri","weekday","no_sled","3","2","1",5.9,0,31,2,19,19,2,-1,0,-1,4,3,3,2
"7442",2020-01-03,"Cement Creek","w1920","Mechanized",0,"Fri","weekday","no_sled","3","2","1",5.9,0,31,2,19,19,2,-1,0,-1,4,3,3,2
"7443",2020-01-03,"Cement Creek","w1920","Motorized",3,"Fri","weekday","sled","3","2","1",5.9,0,31,2,19,19,2,-1,0,-1,4,3,3,2
"7444",2020-01-03,"Cement Creek","w1920","Hybrid",NA,"Fri","weekday","sled","3","2","1",5.9,0,31,2,19,19,2,-1,0,-1,4,3,3,2
"7445",2020-01-04,"Cement Creek","w1920","Non.motorized",36,"Sat","weekend","no_sled","2","2","1",5.9,0,30,-1,26,19.7,2,2,-1,0,1,3,2,2
"7446",2020-01-04,"Cement Creek","w1920","Mechanized",2,"Sat","weekend","no_sled","2","2","1",5.9,0,30,-1,26,19.7,2,2,-1,0,1,3,2,2
"7447",2020-01-04,"Cement Creek","w1920","Motorized",1,"Sat","weekend","sled","2","2","1",5.9,0,30,-1,26,19.7,2,2,-1,0,1,3,2,2
"7448",2020-01-04,"Cement Creek","w1920","Hybrid",NA,"Sat","weekend","sled","2","2","1",5.9,0,30,-1,26,19.7,2,2,-1,0,1,3,2,2
"7449",2020-01-05,"Cement Creek","w1920","Non.motorized",24,"Sun","weekend","no_sled","2","2","1",5.9,0,28,-2,23,21.1,-1,2,2,-1,-3,-1,1,0
"7450",2020-01-05,"Cement Creek","w1920","Mechanized",2,"Sun","weekend","no_sled","2","2","1",5.9,0,28,-2,23,21.1,-1,2,2,-1,-3,-1,1,0
"7451",2020-01-05,"Cement Creek","w1920","Motorized",1,"Sun","weekend","sled","2","2","1",5.9,0,28,-2,23,21.1,-1,2,2,-1,-3,-1,1,0
"7452",2020-01-05,"Cement Creek","w1920","Hybrid",NA,"Sun","weekend","sled","2","2","1",5.9,0,28,-2,23,21.1,-1,2,2,-1,-3,-1,1,0
"7453",2020-01-06,"Cement Creek","w1920","Non.motorized",15,"Mon","weekday","no_sled","2","2","1",5.9,0,28,0,15,21.1,-2,-1,2,2,-2,-3,-1,1
"7454",2020-01-06,"Cement Creek","w1920","Mechanized",1,"Mon","weekday","no_sled","2","2","1",5.9,0,28,0,15,21.1,-2,-1,2,2,-2,-3,-1,1
"7455",2020-01-06,"Cement Creek","w1920","Motorized",4,"Mon","weekday","sled","2","2","1",5.9,0,28,0,15,21.1,-2,-1,2,2,-2,-3,-1,1
"7456",2020-01-06,"Cement Creek","w1920","Hybrid",NA,"Mon","weekday","sled","2","2","1",5.9,0,28,0,15,21.1,-2,-1,2,2,-2,-3,-1,1
"7457",2020-01-07,"Cement Creek","w1920","Non.motorized",8,"Tue","weekday","no_sled","2","1","1",5.9,0,28,0,22,21.1,0,-2,-1,2,0,-2,-3,-1
"7458",2020-01-07,"Cement Creek","w1920","Mechanized",2,"Tue","weekday","no_sled","2","1","1",5.9,0,28,0,22,21.1,0,-2,-1,2,0,-2,-3,-1
"7459",2020-01-07,"Cement Creek","w1920","Motorized",3,"Tue","weekday","sled","2","1","1",5.9,0,28,0,22,21.1,0,-2,-1,2,0,-2,-3,-1
"7460",2020-01-07,"Cement Creek","w1920","Hybrid",NA,"Tue","weekday","sled","2","1","1",5.9,0,28,0,22,21.1,0,-2,-1,2,0,-2,-3,-1
"7461",2020-01-08,"Cement Creek","w1920","Non.motorized",14,"Wed","weekday","no_sled","2","1","1",6,0.1,28,0,23,21.4,0,0,-2,-1,0,0,-2,-3
"7462",2020-01-08,"Cement Creek","w1920","Mechanized",1,"Wed","weekday","no_sled","2","1","1",6,0.1,28,0,23,21.4,0,0,-2,-1,0,0,-2,-3
"7463",2020-01-08,"Cement Creek","w1920","Motorized",0,"Wed","weekday","sled","2","1","1",6,0.1,28,0,23,21.4,0,0,-2,-1,0,0,-2,-3
"7464",2020-01-08,"Cement Creek","w1920","Hybrid",NA,"Wed","weekday","sled","2","1","1",6,0.1,28,0,23,21.4,0,0,-2,-1,0,0,-2,-3
"7465",2020-01-09,"Cement Creek","w1920","Non.motorized",15,"Thu","weekday","no_sled","2","1","1",6,0,27,-1,17,22.2,0,0,0,-2,-1,-1,-1,-3
"7466",2020-01-09,"Cement Creek","w1920","Mechanized",1,"Thu","weekday","no_sled","2","1","1",6,0,27,-1,17,22.2,0,0,0,-2,-1,-1,-1,-3
"7467",2020-01-09,"Cement Creek","w1920","Motorized",0,"Thu","weekday","sled","2","1","1",6,0,27,-1,17,22.2,0,0,0,-2,-1,-1,-1,-3
"7468",2020-01-09,"Cement Creek","w1920","Hybrid",NA,"Thu","weekday","sled","2","1","1",6,0,27,-1,17,22.2,0,0,0,-2,-1,-1,-1,-3
"7469",2020-01-10,"Cement Creek","w1920","Non.motorized",13,"Fri","weekday","no_sled","2","1","1",6,0,29,2,11,20.7,-1,0,0,0,1,1,1,1
"7470",2020-01-10,"Cement Creek","w1920","Mechanized",2,"Fri","weekday","no_sled","2","1","1",6,0,29,2,11,20.7,-1,0,0,0,1,1,1,1
"7471",2020-01-10,"Cement Creek","w1920","Motorized",2,"Fri","weekday","sled","2","1","1",6,0,29,2,11,20.7,-1,0,0,0,1,1,1,1
"7472",2020-01-10,"Cement Creek","w1920","Hybrid",NA,"Fri","weekday","sled","2","1","1",6,0,29,2,11,20.7,-1,0,0,0,1,1,1,1
"7473",2020-01-11,"Cement Creek","w1920","Non.motorized",13,"Sat","weekend","no_sled","2","1","1",6,0,29,0,12,20.7,2,-1,0,0,2,1,1,1
"7474",2020-01-11,"Cement Creek","w1920","Mechanized",2,"Sat","weekend","no_sled","2","1","1",6,0,29,0,12,20.7,2,-1,0,0,2,1,1,1
"7475",2020-01-11,"Cement Creek","w1920","Motorized",0,"Sat","weekend","sled","2","1","1",6,0,29,0,12,20.7,2,-1,0,0,2,1,1,1
"7476",2020-01-11,"Cement Creek","w1920","Hybrid",NA,"Sat","weekend","sled","2","1","1",6,0,29,0,12,20.7,2,-1,0,0,2,1,1,1
"7477",2020-01-12,"Cement Creek","w1920","Non.motorized",NA,"Sun","weekend","no_sled","2","1","1",6.1,0.1,29,0,13,21,0,2,-1,0,0,2,1,1
"7478",2020-01-12,"Cement Creek","w1920","Mechanized",NA,"Sun","weekend","no_sled","2","1","1",6.1,0.1,29,0,13,21,0,2,-1,0,0,2,1,1
"7479",2020-01-12,"Cement Creek","w1920","Motorized",NA,"Sun","weekend","sled","2","1","1",6.1,0.1,29,0,13,21,0,2,-1,0,0,2,1,1
"7480",2020-01-12,"Cement Creek","w1920","Hybrid",NA,"Sun","weekend","sled","2","1","1",6.1,0.1,29,0,13,21,0,2,-1,0,0,2,1,1
"7481",2020-01-13,"Cement Creek","w1920","Non.motorized",NA,"Mon","weekday","no_sled","2","2","1",6.2,0.1,29,0,16,21.4,0,0,2,-1,0,0,2,1
"7482",2020-01-13,"Cement Creek","w1920","Mechanized",NA,"Mon","weekday","no_sled","2","2","1",6.2,0.1,29,0,16,21.4,0,0,2,-1,0,0,2,1
"7483",2020-01-13,"Cement Creek","w1920","Motorized",NA,"Mon","weekday","sled","2","2","1",6.2,0.1,29,0,16,21.4,0,0,2,-1,0,0,2,1
"7484",2020-01-13,"Cement Creek","w1920","Hybrid",NA,"Mon","weekday","sled","2","2","1",6.2,0.1,29,0,16,21.4,0,0,2,-1,0,0,2,1
"7485",2020-01-14,"Cement Creek","w1920","Non.motorized",NA,"Tue","weekday","no_sled","3","2","1",6.6,0.4,34,5,23,19.4,0,0,0,2,5,5,5,7
"7486",2020-01-14,"Cement Creek","w1920","Mechanized",NA,"Tue","weekday","no_sled","3","2","1",6.6,0.4,34,5,23,19.4,0,0,0,2,5,5,5,7
"7487",2020-01-14,"Cement Creek","w1920","Motorized",NA,"Tue","weekday","sled","3","2","1",6.6,0.4,34,5,23,19.4,0,0,0,2,5,5,5,7
"7488",2020-01-14,"Cement Creek","w1920","Hybrid",NA,"Tue","weekday","sled","3","2","1",6.6,0.4,34,5,23,19.4,0,0,0,2,5,5,5,7
"7489",2020-01-15,"Cement Creek","w1920","Non.motorized",NA,"Wed","weekday","no_sled","3","2","1",6.7,0.1,32,-2,23,20.9,5,0,0,0,3,3,3,3
"7490",2020-01-15,"Cement Creek","w1920","Mechanized",NA,"Wed","weekday","no_sled","3","2","1",6.7,0.1,32,-2,23,20.9,5,0,0,0,3,3,3,3
"7491",2020-01-15,"Cement Creek","w1920","Motorized",NA,"Wed","weekday","sled","3","2","1",6.7,0.1,32,-2,23,20.9,5,0,0,0,3,3,3,3
"7492",2020-01-15,"Cement Creek","w1920","Hybrid",NA,"Wed","weekday","sled","3","2","1",6.7,0.1,32,-2,23,20.9,5,0,0,0,3,3,3,3
"7493",2020-01-16,"Cement Creek","w1920","Non.motorized",NA,"Thu","weekday","no_sled","2","2","1",6.7,0,31,-1,28,21.6,-2,5,0,0,-3,2,2,2
"7494",2020-01-16,"Cement Creek","w1920","Mechanized",NA,"Thu","weekday","no_sled","2","2","1",6.7,0,31,-1,28,21.6,-2,5,0,0,-3,2,2,2
"7495",2020-01-16,"Cement Creek","w1920","Motorized",NA,"Thu","weekday","sled","2","2","1",6.7,0,31,-1,28,21.6,-2,5,0,0,-3,2,2,2
"7496",2020-01-16,"Cement Creek","w1920","Hybrid",NA,"Thu","weekday","sled","2","2","1",6.7,0,31,-1,28,21.6,-2,5,0,0,-3,2,2,2
"7497",2020-01-17,"Cement Creek","w1920","Non.motorized",NA,"Fri","weekday","no_sled","2","2","1",6.8,0.1,29,-2,19,23.4,-1,-2,5,0,-3,-5,0,0
"7498",2020-01-17,"Cement Creek","w1920","Mechanized",NA,"Fri","weekday","no_sled","2","2","1",6.8,0.1,29,-2,19,23.4,-1,-2,5,0,-3,-5,0,0
"7499",2020-01-17,"Cement Creek","w1920","Motorized",NA,"Fri","weekday","sled","2","2","1",6.8,0.1,29,-2,19,23.4,-1,-2,5,0,-3,-5,0,0
"7500",2020-01-17,"Cement Creek","w1920","Hybrid",NA,"Fri","weekday","sled","2","2","1",6.8,0.1,29,-2,19,23.4,-1,-2,5,0,-3,-5,0,0
"7501",2020-01-18,"Cement Creek","w1920","Non.motorized",NA,"Sat","weekend","no_sled","2","2","2",7,0.2,34,5,16,20.6,-2,-1,-2,5,3,2,0,5
"7502",2020-01-18,"Cement Creek","w1920","Mechanized",NA,"Sat","weekend","no_sled","2","2","2",7,0.2,34,5,16,20.6,-2,-1,-2,5,3,2,0,5
"7503",2020-01-18,"Cement Creek","w1920","Motorized",NA,"Sat","weekend","sled","2","2","2",7,0.2,34,5,16,20.6,-2,-1,-2,5,3,2,0,5
"7504",2020-01-18,"Cement Creek","w1920","Hybrid",NA,"Sat","weekend","sled","2","2","2",7,0.2,34,5,16,20.6,-2,-1,-2,5,3,2,0,5
"7505",2020-01-19,"Cement Creek","w1920","Non.motorized",NA,"Sun","weekend","no_sled","2","2","1",7,0,33,-1,21,21.2,5,-2,-1,-2,4,2,1,-1
"7506",2020-01-19,"Cement Creek","w1920","Mechanized",NA,"Sun","weekend","no_sled","2","2","1",7,0,33,-1,21,21.2,5,-2,-1,-2,4,2,1,-1
"7507",2020-01-19,"Cement Creek","w1920","Motorized",NA,"Sun","weekend","sled","2","2","1",7,0,33,-1,21,21.2,5,-2,-1,-2,4,2,1,-1
"7508",2020-01-19,"Cement Creek","w1920","Hybrid",NA,"Sun","weekend","sled","2","2","1",7,0,33,-1,21,21.2,5,-2,-1,-2,4,2,1,-1
"7509",2020-01-20,"Cement Creek","w1920","Non.motorized",NA,"Mon","weekday","no_sled","2","2","1",7.1,0.1,32,-1,25,22.2,-1,5,-2,-1,-2,3,1,0
"7510",2020-01-20,"Cement Creek","w1920","Mechanized",NA,"Mon","weekday","no_sled","2","2","1",7.1,0.1,32,-1,25,22.2,-1,5,-2,-1,-2,3,1,0
"7511",2020-01-20,"Cement Creek","w1920","Motorized",NA,"Mon","weekday","sled","2","2","1",7.1,0.1,32,-1,25,22.2,-1,5,-2,-1,-2,3,1,0
"7512",2020-01-20,"Cement Creek","w1920","Hybrid",NA,"Mon","weekday","sled","2","2","1",7.1,0.1,32,-1,25,22.2,-1,5,-2,-1,-2,3,1,0
"7513",2020-01-21,"Cement Creek","w1920","Non.motorized",NA,"Tue","weekday","no_sled","2","2","1",7.1,0,31,-1,28,22.9,-1,-1,5,-2,-2,-3,2,0
"7514",2020-01-21,"Cement Creek","w1920","Mechanized",NA,"Tue","weekday","no_sled","2","2","1",7.1,0,31,-1,28,22.9,-1,-1,5,-2,-2,-3,2,0
"7515",2020-01-21,"Cement Creek","w1920","Motorized",NA,"Tue","weekday","sled","2","2","1",7.1,0,31,-1,28,22.9,-1,-1,5,-2,-2,-3,2,0
"7516",2020-01-21,"Cement Creek","w1920","Hybrid",NA,"Tue","weekday","sled","2","2","1",7.1,0,31,-1,28,22.9,-1,-1,5,-2,-2,-3,2,0
"7517",2020-01-22,"Cement Creek","w1920","Non.motorized",NA,"Wed","weekday","no_sled","2","2","2",7.3,0.2,32,1,25,22.8,-1,-1,-1,5,0,-1,-2,3
"7518",2020-01-22,"Cement Creek","w1920","Mechanized",NA,"Wed","weekday","no_sled","2","2","2",7.3,0.2,32,1,25,22.8,-1,-1,-1,5,0,-1,-2,3
"7519",2020-01-22,"Cement Creek","w1920","Motorized",NA,"Wed","weekday","sled","2","2","2",7.3,0.2,32,1,25,22.8,-1,-1,-1,5,0,-1,-2,3
"7520",2020-01-22,"Cement Creek","w1920","Hybrid",NA,"Wed","weekday","sled","2","2","2",7.3,0.2,32,1,25,22.8,-1,-1,-1,5,0,-1,-2,3
"7521",2020-01-23,"Cement Creek","w1920","Non.motorized",NA,"Thu","weekday","no_sled","3","2","2",7.3,0,34,2,23,21.5,1,-1,-1,-1,3,2,1,0
"7522",2020-01-23,"Cement Creek","w1920","Mechanized",NA,"Thu","weekday","no_sled","3","2","2",7.3,0,34,2,23,21.5,1,-1,-1,-1,3,2,1,0
"7523",2020-01-23,"Cement Creek","w1920","Motorized",NA,"Thu","weekday","sled","3","2","2",7.3,0,34,2,23,21.5,1,-1,-1,-1,3,2,1,0
"7524",2020-01-23,"Cement Creek","w1920","Hybrid",NA,"Thu","weekday","sled","3","2","2",7.3,0,34,2,23,21.5,1,-1,-1,-1,3,2,1,0
"7525",2020-01-24,"Cement Creek","w1920","Non.motorized",NA,"Fri","weekday","no_sled","2","2","1",7.3,0,33,-1,23,22.1,2,1,-1,-1,1,2,1,0
"7526",2020-01-24,"Cement Creek","w1920","Mechanized",NA,"Fri","weekday","no_sled","2","2","1",7.3,0,33,-1,23,22.1,2,1,-1,-1,1,2,1,0
"7527",2020-01-24,"Cement Creek","w1920","Motorized",NA,"Fri","weekday","sled","2","2","1",7.3,0,33,-1,23,22.1,2,1,-1,-1,1,2,1,0
"7528",2020-01-24,"Cement Creek","w1920","Hybrid",NA,"Fri","weekday","sled","2","2","1",7.3,0,33,-1,23,22.1,2,1,-1,-1,1,2,1,0
"7529",2020-01-25,"Cement Creek","w1920","Non.motorized",NA,"Sat","weekend","no_sled","2","2","1",7.4,0.1,32,-1,25,23.1,-1,2,1,-1,-2,0,1,0
"7530",2020-01-25,"Cement Creek","w1920","Mechanized",NA,"Sat","weekend","no_sled","2","2","1",7.4,0.1,32,-1,25,23.1,-1,2,1,-1,-2,0,1,0
"7531",2020-01-25,"Cement Creek","w1920","Motorized",NA,"Sat","weekend","sled","2","2","1",7.4,0.1,32,-1,25,23.1,-1,2,1,-1,-2,0,1,0
"7532",2020-01-25,"Cement Creek","w1920","Hybrid",NA,"Sat","weekend","sled","2","2","1",7.4,0.1,32,-1,25,23.1,-1,2,1,-1,-2,0,1,0
"7533",2020-01-26,"Cement Creek","w1920","Non.motorized",NA,"Sun","weekend","no_sled","2","1","1",7.4,0,32,0,28,23.1,-1,-1,2,1,-1,-2,0,1
"7534",2020-01-26,"Cement Creek","w1920","Mechanized",NA,"Sun","weekend","no_sled","2","1","1",7.4,0,32,0,28,23.1,-1,-1,2,1,-1,-2,0,1
"7535",2020-01-26,"Cement Creek","w1920","Motorized",NA,"Sun","weekend","sled","2","1","1",7.4,0,32,0,28,23.1,-1,-1,2,1,-1,-2,0,1
"7536",2020-01-26,"Cement Creek","w1920","Hybrid",NA,"Sun","weekend","sled","2","1","1",7.4,0,32,0,28,23.1,-1,-1,2,1,-1,-2,0,1
"7537",2020-01-27,"Cement Creek","w1920","Non.motorized",NA,"Mon","weekday","no_sled","2","1","1",7.4,0,32,0,24,23.1,0,-1,-1,2,0,-1,-2,0
"7538",2020-01-27,"Cement Creek","w1920","Mechanized",NA,"Mon","weekday","no_sled","2","1","1",7.4,0,32,0,24,23.1,0,-1,-1,2,0,-1,-2,0
"7539",2020-01-27,"Cement Creek","w1920","Motorized",NA,"Mon","weekday","sled","2","1","1",7.4,0,32,0,24,23.1,0,-1,-1,2,0,-1,-2,0
"7540",2020-01-27,"Cement Creek","w1920","Hybrid",NA,"Mon","weekday","sled","2","1","1",7.4,0,32,0,24,23.1,0,-1,-1,2,0,-1,-2,0
"7541",2020-01-28,"Cement Creek","w1920","Non.motorized",NA,"Tue","weekday","no_sled","3","2","2",7.4,0,32,0,19,23.1,0,0,-1,-1,0,0,-1,-2
"7542",2020-01-28,"Cement Creek","w1920","Mechanized",NA,"Tue","weekday","no_sled","3","2","2",7.4,0,32,0,19,23.1,0,0,-1,-1,0,0,-1,-2
"7543",2020-01-28,"Cement Creek","w1920","Motorized",NA,"Tue","weekday","sled","3","2","2",7.4,0,32,0,19,23.1,0,0,-1,-1,0,0,-1,-2
"7544",2020-01-28,"Cement Creek","w1920","Hybrid",NA,"Tue","weekday","sled","3","2","2",7.4,0,32,0,19,23.1,0,0,-1,-1,0,0,-1,-2
"7545",2020-01-29,"Cement Creek","w1920","Non.motorized",NA,"Wed","weekday","no_sled","2","2","1",7.4,0,31,-1,20,23.9,0,0,0,-1,-1,-1,-1,-2
"7546",2020-01-29,"Cement Creek","w1920","Mechanized",NA,"Wed","weekday","no_sled","2","2","1",7.4,0,31,-1,20,23.9,0,0,0,-1,-1,-1,-1,-2
"7547",2020-01-29,"Cement Creek","w1920","Motorized",NA,"Wed","weekday","sled","2","2","1",7.4,0,31,-1,20,23.9,0,0,0,-1,-1,-1,-1,-2
"7548",2020-01-29,"Cement Creek","w1920","Hybrid",NA,"Wed","weekday","sled","2","2","1",7.4,0,31,-1,20,23.9,0,0,0,-1,-1,-1,-1,-2
"7549",2020-01-30,"Cement Creek","w1920","Non.motorized",9,"Thu","weekday","no_sled","2","2","1",7.4,0,31,0,17,23.9,-1,0,0,0,-1,-1,-1,-1
"7550",2020-01-30,"Cement Creek","w1920","Mechanized",1,"Thu","weekday","no_sled","2","2","1",7.4,0,31,0,17,23.9,-1,0,0,0,-1,-1,-1,-1
"7551",2020-01-30,"Cement Creek","w1920","Motorized",1,"Thu","weekday","sled","2","2","1",7.4,0,31,0,17,23.9,-1,0,0,0,-1,-1,-1,-1
"7552",2020-01-30,"Cement Creek","w1920","Hybrid",NA,"Thu","weekday","sled","2","2","1",7.4,0,31,0,17,23.9,-1,0,0,0,-1,-1,-1,-1
"7553",2020-01-31,"Cement Creek","w1920","Non.motorized",16,"Fri","weekday","no_sled","2","1","1",7.4,0,31,0,20,23.9,0,-1,0,0,0,-1,-1,-1
"7554",2020-01-31,"Cement Creek","w1920","Mechanized",1,"Fri","weekday","no_sled","2","1","1",7.4,0,31,0,20,23.9,0,-1,0,0,0,-1,-1,-1
"7555",2020-01-31,"Cement Creek","w1920","Motorized",2,"Fri","weekday","sled","2","1","1",7.4,0,31,0,20,23.9,0,-1,0,0,0,-1,-1,-1
"7556",2020-01-31,"Cement Creek","w1920","Hybrid",NA,"Fri","weekday","sled","2","1","1",7.4,0,31,0,20,23.9,0,-1,0,0,0,-1,-1,-1
"7557",2020-02-01,"Cement Creek","w1920","Non.motorized",29,"Sat","weekend","no_sled","2","1","1",7.4,0,31,0,28,23.9,0,0,-1,0,0,0,-1,-1
"7558",2020-02-01,"Cement Creek","w1920","Mechanized",2,"Sat","weekend","no_sled","2","1","1",7.4,0,31,0,28,23.9,0,0,-1,0,0,0,-1,-1
"7559",2020-02-01,"Cement Creek","w1920","Motorized",4,"Sat","weekend","sled","2","1","1",7.4,0,31,0,28,23.9,0,0,-1,0,0,0,-1,-1
"7560",2020-02-01,"Cement Creek","w1920","Hybrid",NA,"Sat","weekend","sled","2","1","1",7.4,0,31,0,28,23.9,0,0,-1,0,0,0,-1,-1
"7561",2020-02-02,"Cement Creek","w1920","Non.motorized",30,"Sun","weekend","no_sled","1","1","1",7.4,0,31,0,33,23.9,0,0,0,-1,0,0,0,-1
"7562",2020-02-02,"Cement Creek","w1920","Mechanized",3,"Sun","weekend","no_sled","1","1","1",7.4,0,31,0,33,23.9,0,0,0,-1,0,0,0,-1
"7563",2020-02-02,"Cement Creek","w1920","Motorized",3,"Sun","weekend","sled","1","1","1",7.4,0,31,0,33,23.9,0,0,0,-1,0,0,0,-1
"7564",2020-02-02,"Cement Creek","w1920","Hybrid",NA,"Sun","weekend","sled","1","1","1",7.4,0,31,0,33,23.9,0,0,0,-1,0,0,0,-1
"7565",2020-02-03,"Cement Creek","w1920","Non.motorized",5,"Mon","weekday","no_sled","2","2","1",7.4,0,31,0,24,23.9,0,0,0,0,0,0,0,0
"7566",2020-02-03,"Cement Creek","w1920","Mechanized",0,"Mon","weekday","no_sled","2","2","1",7.4,0,31,0,24,23.9,0,0,0,0,0,0,0,0
"7567",2020-02-03,"Cement Creek","w1920","Motorized",1,"Mon","weekday","sled","2","2","1",7.4,0,31,0,24,23.9,0,0,0,0,0,0,0,0
"7568",2020-02-03,"Cement Creek","w1920","Hybrid",NA,"Mon","weekday","sled","2","2","1",7.4,0,31,0,24,23.9,0,0,0,0,0,0,0,0
"7569",2020-02-04,"Cement Creek","w1920","Non.motorized",3,"Tue","weekday","no_sled","2","2","2",7.4,0,33,2,5,22.4,0,0,0,0,2,2,2,2
"7570",2020-02-04,"Cement Creek","w1920","Mechanized",0,"Tue","weekday","no_sled","2","2","2",7.4,0,33,2,5,22.4,0,0,0,0,2,2,2,2
"7571",2020-02-04,"Cement Creek","w1920","Motorized",0,"Tue","weekday","sled","2","2","2",7.4,0,33,2,5,22.4,0,0,0,0,2,2,2,2
"7572",2020-02-04,"Cement Creek","w1920","Hybrid",NA,"Tue","weekday","sled","2","2","2",7.4,0,33,2,5,22.4,0,0,0,0,2,2,2,2
"7573",2020-02-05,"Cement Creek","w1920","Non.motorized",10,"Wed","weekday","no_sled","2","2","1",7.4,0,33,0,2,22.4,2,0,0,0,2,2,2,2
"7574",2020-02-05,"Cement Creek","w1920","Mechanized",1,"Wed","weekday","no_sled","2","2","1",7.4,0,33,0,2,22.4,2,0,0,0,2,2,2,2
"7575",2020-02-05,"Cement Creek","w1920","Motorized",3,"Wed","weekday","sled","2","2","1",7.4,0,33,0,2,22.4,2,0,0,0,2,2,2,2
"7576",2020-02-05,"Cement Creek","w1920","Hybrid",NA,"Wed","weekday","sled","2","2","1",7.4,0,33,0,2,22.4,2,0,0,0,2,2,2,2
"7577",2020-02-06,"Cement Creek","w1920","Non.motorized",2,"Thu","weekday","no_sled","2","2","1",7.5,0.1,32,-1,16,23.4,0,2,0,0,-1,1,1,1
"7578",2020-02-06,"Cement Creek","w1920","Mechanized",0,"Thu","weekday","no_sled","2","2","1",7.5,0.1,32,-1,16,23.4,0,2,0,0,-1,1,1,1
"7579",2020-02-06,"Cement Creek","w1920","Motorized",1,"Thu","weekday","sled","2","2","1",7.5,0.1,32,-1,16,23.4,0,2,0,0,-1,1,1,1
"7580",2020-02-06,"Cement Creek","w1920","Hybrid",NA,"Thu","weekday","sled","2","2","1",7.5,0.1,32,-1,16,23.4,0,2,0,0,-1,1,1,1
"7581",2020-02-07,"Cement Creek","w1920","Non.motorized",NA,"Fri","weekday","no_sled","3","3","3",7.9,0.4,37,5,26,21.4,-1,0,2,0,4,4,6,6
"7582",2020-02-07,"Cement Creek","w1920","Mechanized",NA,"Fri","weekday","no_sled","3","3","3",7.9,0.4,37,5,26,21.4,-1,0,2,0,4,4,6,6
"7583",2020-02-07,"Cement Creek","w1920","Motorized",NA,"Fri","weekday","sled","3","3","3",7.9,0.4,37,5,26,21.4,-1,0,2,0,4,4,6,6
"7584",2020-02-07,"Cement Creek","w1920","Hybrid",NA,"Fri","weekday","sled","3","3","3",7.9,0.4,37,5,26,21.4,-1,0,2,0,4,4,6,6
"7585",2020-02-08,"Cement Creek","w1920","Non.motorized",5,"Sat","weekend","no_sled","3","3","2",8.3,0.4,39,2,30,21.3,5,-1,0,2,7,6,6,8
"7586",2020-02-08,"Cement Creek","w1920","Mechanized",0,"Sat","weekend","no_sled","3","3","2",8.3,0.4,39,2,30,21.3,5,-1,0,2,7,6,6,8
"7587",2020-02-08,"Cement Creek","w1920","Motorized",1,"Sat","weekend","sled","3","3","2",8.3,0.4,39,2,30,21.3,5,-1,0,2,7,6,6,8
"7588",2020-02-08,"Cement Creek","w1920","Hybrid",NA,"Sat","weekend","sled","3","3","2",8.3,0.4,39,2,30,21.3,5,-1,0,2,7,6,6,8
"7589",2020-02-09,"Cement Creek","w1920","Non.motorized",38,"Sun","weekend","no_sled","3","2","2",8.4,0.1,38,-1,26,22.1,2,5,-1,0,1,6,5,5
"7590",2020-02-09,"Cement Creek","w1920","Mechanized",4,"Sun","weekend","no_sled","3","2","2",8.4,0.1,38,-1,26,22.1,2,5,-1,0,1,6,5,5
"7591",2020-02-09,"Cement Creek","w1920","Motorized",1,"Sun","weekend","sled","3","2","2",8.4,0.1,38,-1,26,22.1,2,5,-1,0,1,6,5,5
"7592",2020-02-09,"Cement Creek","w1920","Hybrid",NA,"Sun","weekend","sled","3","2","2",8.4,0.1,38,-1,26,22.1,2,5,-1,0,1,6,5,5
"7593",2020-02-10,"Cement Creek","w1920","Non.motorized",20,"Mon","weekday","no_sled","2","2","1",8.4,0,38,0,22,22.1,-1,2,5,-1,-1,1,6,5
"7594",2020-02-10,"Cement Creek","w1920","Mechanized",1,"Mon","weekday","no_sled","2","2","1",8.4,0,38,0,22,22.1,-1,2,5,-1,-1,1,6,5
"7595",2020-02-10,"Cement Creek","w1920","Motorized",2,"Mon","weekday","sled","2","2","1",8.4,0,38,0,22,22.1,-1,2,5,-1,-1,1,6,5
"7596",2020-02-10,"Cement Creek","w1920","Hybrid",NA,"Mon","weekday","sled","2","2","1",8.4,0,38,0,22,22.1,-1,2,5,-1,-1,1,6,5
"7597",2020-02-11,"Cement Creek","w1920","Non.motorized",10,"Tue","weekday","no_sled","2","2","2",8.5,0.1,40,2,16,21.2,0,-1,2,5,2,1,3,8
"7598",2020-02-11,"Cement Creek","w1920","Mechanized",2,"Tue","weekday","no_sled","2","2","2",8.5,0.1,40,2,16,21.2,0,-1,2,5,2,1,3,8
"7599",2020-02-11,"Cement Creek","w1920","Motorized",6,"Tue","weekday","sled","2","2","2",8.5,0.1,40,2,16,21.2,0,-1,2,5,2,1,3,8
"7600",2020-02-11,"Cement Creek","w1920","Hybrid",NA,"Tue","weekday","sled","2","2","2",8.5,0.1,40,2,16,21.2,0,-1,2,5,2,1,3,8
"7601",2020-02-12,"Cement Creek","w1920","Non.motorized",4,"Wed","weekday","no_sled","2","2","2",8.5,0,39,-1,15,21.8,2,0,-1,2,1,1,0,2
"7602",2020-02-12,"Cement Creek","w1920","Mechanized",1,"Wed","weekday","no_sled","2","2","2",8.5,0,39,-1,15,21.8,2,0,-1,2,1,1,0,2
"7603",2020-02-12,"Cement Creek","w1920","Motorized",3,"Wed","weekday","sled","2","2","2",8.5,0,39,-1,15,21.8,2,0,-1,2,1,1,0,2
"7604",2020-02-12,"Cement Creek","w1920","Hybrid",NA,"Wed","weekday","sled","2","2","2",8.5,0,39,-1,15,21.8,2,0,-1,2,1,1,0,2
"7605",2020-02-13,"Cement Creek","w1920","Non.motorized",11,"Thu","weekday","no_sled","2","2","1",8.5,0,39,0,18,21.8,-1,2,0,-1,-1,1,1,0
"7606",2020-02-13,"Cement Creek","w1920","Mechanized",0,"Thu","weekday","no_sled","2","2","1",8.5,0,39,0,18,21.8,-1,2,0,-1,-1,1,1,0
"7607",2020-02-13,"Cement Creek","w1920","Motorized",3,"Thu","weekday","sled","2","2","1",8.5,0,39,0,18,21.8,-1,2,0,-1,-1,1,1,0
"7608",2020-02-13,"Cement Creek","w1920","Hybrid",NA,"Thu","weekday","sled","2","2","1",8.5,0,39,0,18,21.8,-1,2,0,-1,-1,1,1,0
"7609",2020-02-14,"Cement Creek","w1920","Non.motorized",17,"Fri","weekday","no_sled","2","1","1",8.6,0.1,38,-1,24,22.6,0,-1,2,0,-1,-2,0,0
"7610",2020-02-14,"Cement Creek","w1920","Mechanized",1,"Fri","weekday","no_sled","2","1","1",8.6,0.1,38,-1,24,22.6,0,-1,2,0,-1,-2,0,0
"7611",2020-02-14,"Cement Creek","w1920","Motorized",0,"Fri","weekday","sled","2","1","1",8.6,0.1,38,-1,24,22.6,0,-1,2,0,-1,-2,0,0
"7612",2020-02-14,"Cement Creek","w1920","Hybrid",NA,"Fri","weekday","sled","2","1","1",8.6,0.1,38,-1,24,22.6,0,-1,2,0,-1,-2,0,0
"7613",2020-02-15,"Cement Creek","w1920","Non.motorized",64,"Sat","weekend","no_sled","1","1","1",8.6,0,38,0,26,22.6,-1,0,-1,2,-1,-1,-2,0
"7614",2020-02-15,"Cement Creek","w1920","Mechanized",3,"Sat","weekend","no_sled","1","1","1",8.6,0,38,0,26,22.6,-1,0,-1,2,-1,-1,-2,0
"7615",2020-02-15,"Cement Creek","w1920","Motorized",9,"Sat","weekend","sled","1","1","1",8.6,0,38,0,26,22.6,-1,0,-1,2,-1,-1,-2,0
"7616",2020-02-15,"Cement Creek","w1920","Hybrid",NA,"Sat","weekend","sled","1","1","1",8.6,0,38,0,26,22.6,-1,0,-1,2,-1,-1,-2,0
"7617",2020-02-16,"Cement Creek","w1920","Non.motorized",33,"Sun","weekend","no_sled","1","1","1",8.8,0.2,37,-1,26,23.8,0,-1,0,-1,-1,-2,-2,-3
"7618",2020-02-16,"Cement Creek","w1920","Mechanized",0,"Sun","weekend","no_sled","1","1","1",8.8,0.2,37,-1,26,23.8,0,-1,0,-1,-1,-2,-2,-3
"7619",2020-02-16,"Cement Creek","w1920","Motorized",3,"Sun","weekend","sled","1","1","1",8.8,0.2,37,-1,26,23.8,0,-1,0,-1,-1,-2,-2,-3
"7620",2020-02-16,"Cement Creek","w1920","Hybrid",NA,"Sun","weekend","sled","1","1","1",8.8,0.2,37,-1,26,23.8,0,-1,0,-1,-1,-2,-2,-3
"7621",2020-02-17,"Cement Creek","w1920","Non.motorized",13,"Mon","weekday","no_sled","2","1","1",9.2,0.4,43,6,25,21.4,-1,0,-1,0,5,5,4,4
"7622",2020-02-17,"Cement Creek","w1920","Mechanized",0,"Mon","weekday","no_sled","2","1","1",9.2,0.4,43,6,25,21.4,-1,0,-1,0,5,5,4,4
"7623",2020-02-17,"Cement Creek","w1920","Motorized",3,"Mon","weekday","sled","2","1","1",9.2,0.4,43,6,25,21.4,-1,0,-1,0,5,5,4,4
"7624",2020-02-17,"Cement Creek","w1920","Hybrid",NA,"Mon","weekday","sled","2","1","1",9.2,0.4,43,6,25,21.4,-1,0,-1,0,5,5,4,4
"7625",2020-02-18,"Cement Creek","w1920","Non.motorized",15,"Tue","weekday","no_sled","1","1","1",9.3,0.1,42,-1,18,22.1,6,-1,0,-1,5,4,4,3
"7626",2020-02-18,"Cement Creek","w1920","Mechanized",0,"Tue","weekday","no_sled","1","1","1",9.3,0.1,42,-1,18,22.1,6,-1,0,-1,5,4,4,3
"7627",2020-02-18,"Cement Creek","w1920","Motorized",0,"Tue","weekday","sled","1","1","1",9.3,0.1,42,-1,18,22.1,6,-1,0,-1,5,4,4,3
"7628",2020-02-18,"Cement Creek","w1920","Hybrid",NA,"Tue","weekday","sled","1","1","1",9.3,0.1,42,-1,18,22.1,6,-1,0,-1,5,4,4,3
"7629",2020-02-19,"Cement Creek","w1920","Non.motorized",12,"Wed","weekday","no_sled","1","1","1",9.3,0,41,-1,22,22.7,-1,6,-1,0,-2,4,3,3
"7630",2020-02-19,"Cement Creek","w1920","Mechanized",0,"Wed","weekday","no_sled","1","1","1",9.3,0,41,-1,22,22.7,-1,6,-1,0,-2,4,3,3
"7631",2020-02-19,"Cement Creek","w1920","Motorized",2,"Wed","weekday","sled","1","1","1",9.3,0,41,-1,22,22.7,-1,6,-1,0,-2,4,3,3
"7632",2020-02-19,"Cement Creek","w1920","Hybrid",NA,"Wed","weekday","sled","1","1","1",9.3,0,41,-1,22,22.7,-1,6,-1,0,-2,4,3,3
"7633",2020-02-20,"Cement Creek","w1920","Non.motorized",21,"Thu","weekday","no_sled","1","1","1",9.3,0,41,0,18,22.7,-1,-1,6,-1,-1,-2,4,3
"7634",2020-02-20,"Cement Creek","w1920","Mechanized",0,"Thu","weekday","no_sled","1","1","1",9.3,0,41,0,18,22.7,-1,-1,6,-1,-1,-2,4,3
"7635",2020-02-20,"Cement Creek","w1920","Motorized",3,"Thu","weekday","sled","1","1","1",9.3,0,41,0,18,22.7,-1,-1,6,-1,-1,-2,4,3
"7636",2020-02-20,"Cement Creek","w1920","Hybrid",NA,"Thu","weekday","sled","1","1","1",9.3,0,41,0,18,22.7,-1,-1,6,-1,-1,-2,4,3
"7637",2020-02-21,"Cement Creek","w1920","Non.motorized",19,"Fri","weekday","no_sled","1","1","1",9.3,0,40,-1,26,23.2,0,-1,-1,6,-1,-2,-3,3
"7638",2020-02-21,"Cement Creek","w1920","Mechanized",2,"Fri","weekday","no_sled","1","1","1",9.3,0,40,-1,26,23.2,0,-1,-1,6,-1,-2,-3,3
"7639",2020-02-21,"Cement Creek","w1920","Motorized",3,"Fri","weekday","sled","1","1","1",9.3,0,40,-1,26,23.2,0,-1,-1,6,-1,-2,-3,3
"7640",2020-02-21,"Cement Creek","w1920","Hybrid",NA,"Fri","weekday","sled","1","1","1",9.3,0,40,-1,26,23.2,0,-1,-1,6,-1,-2,-3,3
"7641",2020-02-22,"Cement Creek","w1920","Non.motorized",36,"Sat","weekend","no_sled","1","1","1",9.4,0.1,39,-1,32,24.1,-1,0,-1,-1,-2,-2,-3,-4
"7642",2020-02-22,"Cement Creek","w1920","Mechanized",0,"Sat","weekend","no_sled","1","1","1",9.4,0.1,39,-1,32,24.1,-1,0,-1,-1,-2,-2,-3,-4
"7643",2020-02-22,"Cement Creek","w1920","Motorized",1,"Sat","weekend","sled","1","1","1",9.4,0.1,39,-1,32,24.1,-1,0,-1,-1,-2,-2,-3,-4
"7644",2020-02-22,"Cement Creek","w1920","Hybrid",NA,"Sat","weekend","sled","1","1","1",9.4,0.1,39,-1,32,24.1,-1,0,-1,-1,-2,-2,-3,-4
"7645",2020-02-23,"Cement Creek","w1920","Non.motorized",26,"Sun","weekend","no_sled","2","2","2",9.5,0.1,40,1,27,23.8,-1,-1,0,-1,0,-1,-1,-2
"7646",2020-02-23,"Cement Creek","w1920","Mechanized",0,"Sun","weekend","no_sled","2","2","2",9.5,0.1,40,1,27,23.8,-1,-1,0,-1,0,-1,-1,-2
"7647",2020-02-23,"Cement Creek","w1920","Motorized",3,"Sun","weekend","sled","2","2","2",9.5,0.1,40,1,27,23.8,-1,-1,0,-1,0,-1,-1,-2
"7648",2020-02-23,"Cement Creek","w1920","Hybrid",NA,"Sun","weekend","sled","2","2","2",9.5,0.1,40,1,27,23.8,-1,-1,0,-1,0,-1,-1,-2
"7649",2020-02-24,"Cement Creek","w1920","Non.motorized",3,"Mon","weekday","no_sled","3","3","2",9.8,0.3,43,3,17,22.8,1,-1,-1,0,4,3,2,2
"7650",2020-02-24,"Cement Creek","w1920","Mechanized",0,"Mon","weekday","no_sled","3","3","2",9.8,0.3,43,3,17,22.8,1,-1,-1,0,4,3,2,2
"7651",2020-02-24,"Cement Creek","w1920","Motorized",4,"Mon","weekday","sled","3","3","2",9.8,0.3,43,3,17,22.8,1,-1,-1,0,4,3,2,2
"7652",2020-02-24,"Cement Creek","w1920","Hybrid",NA,"Mon","weekday","sled","3","3","2",9.8,0.3,43,3,17,22.8,1,-1,-1,0,4,3,2,2
"7653",2020-02-25,"Cement Creek","w1920","Non.motorized",12,"Tue","weekday","no_sled","2","2","1",9.8,0,43,0,8,22.8,3,1,-1,-1,3,4,3,2
"7654",2020-02-25,"Cement Creek","w1920","Mechanized",1,"Tue","weekday","no_sled","2","2","1",9.8,0,43,0,8,22.8,3,1,-1,-1,3,4,3,2
"7655",2020-02-25,"Cement Creek","w1920","Motorized",4,"Tue","weekday","sled","2","2","1",9.8,0,43,0,8,22.8,3,1,-1,-1,3,4,3,2
"7656",2020-02-25,"Cement Creek","w1920","Hybrid",NA,"Tue","weekday","sled","2","2","1",9.8,0,43,0,8,22.8,3,1,-1,-1,3,4,3,2
"7657",2020-02-26,"Cement Creek","w1920","Non.motorized",6,"Wed","weekday","no_sled","2","2","1",9.8,0,42,-1,15,23.3,0,3,1,-1,-1,2,3,2
"7658",2020-02-26,"Cement Creek","w1920","Mechanized",0,"Wed","weekday","no_sled","2","2","1",9.8,0,42,-1,15,23.3,0,3,1,-1,-1,2,3,2
"7659",2020-02-26,"Cement Creek","w1920","Motorized",2,"Wed","weekday","sled","2","2","1",9.8,0,42,-1,15,23.3,0,3,1,-1,-1,2,3,2
"7660",2020-02-26,"Cement Creek","w1920","Hybrid",NA,"Wed","weekday","sled","2","2","1",9.8,0,42,-1,15,23.3,0,3,1,-1,-1,2,3,2
"7661",2020-02-27,"Cement Creek","w1920","Non.motorized",20,"Thu","weekday","no_sled","2","2","1",9.9,0.1,41,-1,25,24.1,-1,0,3,1,-2,-2,1,2
"7662",2020-02-27,"Cement Creek","w1920","Mechanized",6,"Thu","weekday","no_sled","2","2","1",9.9,0.1,41,-1,25,24.1,-1,0,3,1,-2,-2,1,2
"7663",2020-02-27,"Cement Creek","w1920","Motorized",3,"Thu","weekday","sled","2","2","1",9.9,0.1,41,-1,25,24.1,-1,0,3,1,-2,-2,1,2
"7664",2020-02-27,"Cement Creek","w1920","Hybrid",NA,"Thu","weekday","sled","2","2","1",9.9,0.1,41,-1,25,24.1,-1,0,3,1,-2,-2,1,2
"7665",2020-02-28,"Cement Creek","w1920","Non.motorized",9,"Fri","weekday","no_sled","2","1","1",9.9,0,41,0,28,24.1,-1,-1,0,3,-1,-2,-2,1
"7666",2020-02-28,"Cement Creek","w1920","Mechanized",0,"Fri","weekday","no_sled","2","1","1",9.9,0,41,0,28,24.1,-1,-1,0,3,-1,-2,-2,1
"7667",2020-02-28,"Cement Creek","w1920","Motorized",7,"Fri","weekday","sled","2","1","1",9.9,0,41,0,28,24.1,-1,-1,0,3,-1,-2,-2,1
"7668",2020-02-28,"Cement Creek","w1920","Hybrid",NA,"Fri","weekday","sled","2","1","1",9.9,0,41,0,28,24.1,-1,-1,0,3,-1,-2,-2,1
"7669",2020-02-29,"Cement Creek","w1920","Non.motorized",46,"Sat","weekend","no_sled","1","1","1",9.9,0,40,-1,29,24.8,0,-1,-1,0,-1,-2,-3,-3
"7670",2020-02-29,"Cement Creek","w1920","Mechanized",2,"Sat","weekend","no_sled","1","1","1",9.9,0,40,-1,29,24.8,0,-1,-1,0,-1,-2,-3,-3
"7671",2020-02-29,"Cement Creek","w1920","Motorized",2,"Sat","weekend","sled","1","1","1",9.9,0,40,-1,29,24.8,0,-1,-1,0,-1,-2,-3,-3
"7672",2020-02-29,"Cement Creek","w1920","Hybrid",NA,"Sat","weekend","sled","1","1","1",9.9,0,40,-1,29,24.8,0,-1,-1,0,-1,-2,-3,-3
"7673",2020-03-01,"Cement Creek","w1920","Non.motorized",28,"Sun","weekend","no_sled","1","1","1",10,0.1,40,0,28,25,-1,0,-1,-1,-1,-1,-2,-3
"7674",2020-03-01,"Cement Creek","w1920","Mechanized",3,"Sun","weekend","no_sled","1","1","1",10,0.1,40,0,28,25,-1,0,-1,-1,-1,-1,-2,-3
"7675",2020-03-01,"Cement Creek","w1920","Motorized",8,"Sun","weekend","sled","1","1","1",10,0.1,40,0,28,25,-1,0,-1,-1,-1,-1,-2,-3
"7676",2020-03-01,"Cement Creek","w1920","Hybrid",NA,"Sun","weekend","sled","1","1","1",10,0.1,40,0,28,25,-1,0,-1,-1,-1,-1,-2,-3
"7677",2020-03-02,"Cement Creek","w1920","Non.motorized",0,"Mon","weekday","no_sled","2","2","1",10.4,0.4,45,5,25,23.1,0,-1,0,-1,5,4,4,3
"7678",2020-03-02,"Cement Creek","w1920","Mechanized",0,"Mon","weekday","no_sled","2","2","1",10.4,0.4,45,5,25,23.1,0,-1,0,-1,5,4,4,3
"7679",2020-03-02,"Cement Creek","w1920","Motorized",0,"Mon","weekday","sled","2","2","1",10.4,0.4,45,5,25,23.1,0,-1,0,-1,5,4,4,3
"7680",2020-03-02,"Cement Creek","w1920","Hybrid",NA,"Mon","weekday","sled","2","2","1",10.4,0.4,45,5,25,23.1,0,-1,0,-1,5,4,4,3
"7681",2020-03-03,"Cement Creek","w1920","Non.motorized",19,"Tue","weekday","no_sled","2","1","1",10.9,0.5,50,5,25,21.8,5,0,-1,0,10,10,9,9
"7682",2020-03-03,"Cement Creek","w1920","Mechanized",1,"Tue","weekday","no_sled","2","1","1",10.9,0.5,50,5,25,21.8,5,0,-1,0,10,10,9,9
"7683",2020-03-03,"Cement Creek","w1920","Motorized",5,"Tue","weekday","sled","2","1","1",10.9,0.5,50,5,25,21.8,5,0,-1,0,10,10,9,9
"7684",2020-03-03,"Cement Creek","w1920","Hybrid",NA,"Tue","weekday","sled","2","1","1",10.9,0.5,50,5,25,21.8,5,0,-1,0,10,10,9,9
"7685",2020-03-04,"Cement Creek","w1920","Non.motorized",18,"Wed","weekday","no_sled","2","1","1",10.9,0,48,-2,29,22.7,5,5,0,-1,3,8,8,7
"7686",2020-03-04,"Cement Creek","w1920","Mechanized",0,"Wed","weekday","no_sled","2","1","1",10.9,0,48,-2,29,22.7,5,5,0,-1,3,8,8,7
"7687",2020-03-04,"Cement Creek","w1920","Motorized",4,"Wed","weekday","sled","2","1","1",10.9,0,48,-2,29,22.7,5,5,0,-1,3,8,8,7
"7688",2020-03-04,"Cement Creek","w1920","Hybrid",1,"Wed","weekday","sled","2","1","1",10.9,0,48,-2,29,22.7,5,5,0,-1,3,8,8,7
"7689",2020-03-05,"Cement Creek","w1920","Non.motorized",10,"Thu","weekday","no_sled","2","1","1",10.9,0,46,-2,32,23.7,-2,5,5,0,-4,1,6,6
"7690",2020-03-05,"Cement Creek","w1920","Mechanized",0,"Thu","weekday","no_sled","2","1","1",10.9,0,46,-2,32,23.7,-2,5,5,0,-4,1,6,6
"7691",2020-03-05,"Cement Creek","w1920","Motorized",5,"Thu","weekday","sled","2","1","1",10.9,0,46,-2,32,23.7,-2,5,5,0,-4,1,6,6
"7692",2020-03-05,"Cement Creek","w1920","Hybrid",NA,"Thu","weekday","sled","2","1","1",10.9,0,46,-2,32,23.7,-2,5,5,0,-4,1,6,6
"7693",2020-03-06,"Cement Creek","w1920","Non.motorized",7,"Fri","weekday","no_sled","1","1","1",10.9,0,45,-1,34,24.2,-2,-2,5,5,-3,-5,0,5
"7694",2020-03-06,"Cement Creek","w1920","Mechanized",0,"Fri","weekday","no_sled","1","1","1",10.9,0,45,-1,34,24.2,-2,-2,5,5,-3,-5,0,5
"7695",2020-03-06,"Cement Creek","w1920","Motorized",5,"Fri","weekday","sled","1","1","1",10.9,0,45,-1,34,24.2,-2,-2,5,5,-3,-5,0,5
"7696",2020-03-06,"Cement Creek","w1920","Hybrid",1,"Fri","weekday","sled","1","1","1",10.9,0,45,-1,34,24.2,-2,-2,5,5,-3,-5,0,5
"7697",2020-03-07,"Cement Creek","w1920","Non.motorized",26,"Sat","weekend","no_sled","1","1","2",10.9,0,44,-1,35,24.8,-1,-2,-2,5,-2,-4,-6,-1
"7698",2020-03-07,"Cement Creek","w1920","Mechanized",0,"Sat","weekend","no_sled","1","1","2",10.9,0,44,-1,35,24.8,-1,-2,-2,5,-2,-4,-6,-1
"7699",2020-03-07,"Cement Creek","w1920","Motorized",3,"Sat","weekend","sled","1","1","2",10.9,0,44,-1,35,24.8,-1,-2,-2,5,-2,-4,-6,-1
"7700",2020-03-07,"Cement Creek","w1920","Hybrid",1,"Sat","weekend","sled","1","1","2",10.9,0,44,-1,35,24.8,-1,-2,-2,5,-2,-4,-6,-1
"7701",2020-03-08,"Cement Creek","w1920","Non.motorized",22,"Sun","weekend","no_sled","1","1","1",11,0.1,43,-1,33,25.6,-1,-1,-2,-2,-2,-3,-5,-7
"7702",2020-03-08,"Cement Creek","w1920","Mechanized",0,"Sun","weekend","no_sled","1","1","1",11,0.1,43,-1,33,25.6,-1,-1,-2,-2,-2,-3,-5,-7
"7703",2020-03-08,"Cement Creek","w1920","Motorized",5,"Sun","weekend","sled","1","1","1",11,0.1,43,-1,33,25.6,-1,-1,-2,-2,-2,-3,-5,-7
"7704",2020-03-08,"Cement Creek","w1920","Hybrid",NA,"Sun","weekend","sled","1","1","1",11,0.1,43,-1,33,25.6,-1,-1,-2,-2,-2,-3,-5,-7
"7705",2020-03-09,"Cement Creek","w1920","Non.motorized",4,"Mon","weekday","no_sled","1","1","1",11.1,0.1,42,-1,31,26.4,-1,-1,-1,-2,-2,-3,-4,-6
"7706",2020-03-09,"Cement Creek","w1920","Mechanized",1,"Mon","weekday","no_sled","1","1","1",11.1,0.1,42,-1,31,26.4,-1,-1,-1,-2,-2,-3,-4,-6
"7707",2020-03-09,"Cement Creek","w1920","Motorized",1,"Mon","weekday","sled","1","1","1",11.1,0.1,42,-1,31,26.4,-1,-1,-1,-2,-2,-3,-4,-6
"7708",2020-03-09,"Cement Creek","w1920","Hybrid",NA,"Mon","weekday","sled","1","1","1",11.1,0.1,42,-1,31,26.4,-1,-1,-1,-2,-2,-3,-4,-6
"7709",2020-03-10,"Cement Creek","w1920","Non.motorized",8,"Tue","weekday","no_sled","1","1","2",11.2,0.1,44,2,31,25.5,-1,-1,-1,-1,1,0,-1,-2
"7710",2020-03-10,"Cement Creek","w1920","Mechanized",2,"Tue","weekday","no_sled","1","1","2",11.2,0.1,44,2,31,25.5,-1,-1,-1,-1,1,0,-1,-2
"7711",2020-03-10,"Cement Creek","w1920","Motorized",2,"Tue","weekday","sled","1","1","2",11.2,0.1,44,2,31,25.5,-1,-1,-1,-1,1,0,-1,-2
"7712",2020-03-10,"Cement Creek","w1920","Hybrid",NA,"Tue","weekday","sled","1","1","2",11.2,0.1,44,2,31,25.5,-1,-1,-1,-1,1,0,-1,-2
"7713",2020-03-11,"Cement Creek","w1920","Non.motorized",2,"Wed","weekday","no_sled","2","2","1",11.2,0,44,0,32,25.5,2,-1,-1,-1,2,1,0,-1
"7714",2020-03-11,"Cement Creek","w1920","Mechanized",1,"Wed","weekday","no_sled","2","2","1",11.2,0,44,0,32,25.5,2,-1,-1,-1,2,1,0,-1
"7715",2020-03-11,"Cement Creek","w1920","Motorized",1,"Wed","weekday","sled","2","2","1",11.2,0,44,0,32,25.5,2,-1,-1,-1,2,1,0,-1
"7716",2020-03-11,"Cement Creek","w1920","Hybrid",1,"Wed","weekday","sled","2","2","1",11.2,0,44,0,32,25.5,2,-1,-1,-1,2,1,0,-1
"7717",2020-03-12,"Cement Creek","w1920","Non.motorized",6,"Thu","weekday","no_sled","2","2","2",11.4,0.2,42,-2,35,27.1,0,2,-1,-1,-2,0,-1,-2
"7718",2020-03-12,"Cement Creek","w1920","Mechanized",0,"Thu","weekday","no_sled","2","2","2",11.4,0.2,42,-2,35,27.1,0,2,-1,-1,-2,0,-1,-2
"7719",2020-03-12,"Cement Creek","w1920","Motorized",5,"Thu","weekday","sled","2","2","2",11.4,0.2,42,-2,35,27.1,0,2,-1,-1,-2,0,-1,-2
"7720",2020-03-12,"Cement Creek","w1920","Hybrid",NA,"Thu","weekday","sled","2","2","2",11.4,0.2,42,-2,35,27.1,0,2,-1,-1,-2,0,-1,-2
"7721",2020-03-13,"Cement Creek","w1920","Non.motorized",8,"Fri","weekday","no_sled","3","3","2",11.5,0.1,44,2,31,26.1,-2,0,2,-1,0,0,2,1
"7722",2020-03-13,"Cement Creek","w1920","Mechanized",1,"Fri","weekday","no_sled","3","3","2",11.5,0.1,44,2,31,26.1,-2,0,2,-1,0,0,2,1
"7723",2020-03-13,"Cement Creek","w1920","Motorized",4,"Fri","weekday","sled","3","3","2",11.5,0.1,44,2,31,26.1,-2,0,2,-1,0,0,2,1
"7724",2020-03-13,"Cement Creek","w1920","Hybrid",NA,"Fri","weekday","sled","3","3","2",11.5,0.1,44,2,31,26.1,-2,0,2,-1,0,0,2,1
"7725",2020-03-14,"Cement Creek","w1920","Non.motorized",23,"Sat","weekend","no_sled","3","3","3",11.7,0.2,44,0,31,26.6,2,-2,0,2,2,0,0,2
"7726",2020-03-14,"Cement Creek","w1920","Mechanized",5,"Sat","weekend","no_sled","3","3","3",11.7,0.2,44,0,31,26.6,2,-2,0,2,2,0,0,2
"7727",2020-03-14,"Cement Creek","w1920","Motorized",6,"Sat","weekend","sled","3","3","3",11.7,0.2,44,0,31,26.6,2,-2,0,2,2,0,0,2
"7728",2020-03-14,"Cement Creek","w1920","Hybrid",1,"Sat","weekend","sled","3","3","3",11.7,0.2,44,0,31,26.6,2,-2,0,2,2,0,0,2
"7729",2020-03-15,"Cement Creek","w1920","Non.motorized",41,"Sun","weekend","no_sled","2","2","2",11.7,0,45,1,33,26,0,2,-2,0,1,3,1,1
"7730",2020-03-15,"Cement Creek","w1920","Mechanized",2,"Sun","weekend","no_sled","2","2","2",11.7,0,45,1,33,26,0,2,-2,0,1,3,1,1
"7731",2020-03-15,"Cement Creek","w1920","Motorized",14,"Sun","weekend","sled","2","2","2",11.7,0,45,1,33,26,0,2,-2,0,1,3,1,1
"7732",2020-03-15,"Cement Creek","w1920","Hybrid",NA,"Sun","weekend","sled","2","2","2",11.7,0,45,1,33,26,0,2,-2,0,1,3,1,1
"7733",2020-03-16,"Cement Creek","w1920","Non.motorized",35,"Mon","weekday","no_sled","2","2","2",11.7,0,45,0,35,26,1,0,2,-2,1,1,3,1
"7734",2020-03-16,"Cement Creek","w1920","Mechanized",0,"Mon","weekday","no_sled","2","2","2",11.7,0,45,0,35,26,1,0,2,-2,1,1,3,1
"7735",2020-03-16,"Cement Creek","w1920","Motorized",4,"Mon","weekday","sled","2","2","2",11.7,0,45,0,35,26,1,0,2,-2,1,1,3,1
"7736",2020-03-16,"Cement Creek","w1920","Hybrid",NA,"Mon","weekday","sled","2","2","2",11.7,0,45,0,35,26,1,0,2,-2,1,1,3,1
"7737",2020-03-17,"Cement Creek","w1920","Non.motorized",27,"Tue","weekday","no_sled","2","2","2",11.7,0,44,-1,36,26.6,0,1,0,2,-1,0,0,2
"7738",2020-03-17,"Cement Creek","w1920","Mechanized",1,"Tue","weekday","no_sled","2","2","2",11.7,0,44,-1,36,26.6,0,1,0,2,-1,0,0,2
"7739",2020-03-17,"Cement Creek","w1920","Motorized",6,"Tue","weekday","sled","2","2","2",11.7,0,44,-1,36,26.6,0,1,0,2,-1,0,0,2
"7740",2020-03-17,"Cement Creek","w1920","Hybrid",2,"Tue","weekday","sled","2","2","2",11.7,0,44,-1,36,26.6,0,1,0,2,-1,0,0,2
"7741",2020-03-18,"Cement Creek","w1920","Non.motorized",6,"Wed","weekday","no_sled","2","2","2",11.7,0,43,-1,33,27.2,-1,0,1,0,-2,-2,-1,-1
"7742",2020-03-18,"Cement Creek","w1920","Mechanized",1,"Wed","weekday","no_sled","2","2","2",11.7,0,43,-1,33,27.2,-1,0,1,0,-2,-2,-1,-1
"7743",2020-03-18,"Cement Creek","w1920","Motorized",0,"Wed","weekday","sled","2","2","2",11.7,0,43,-1,33,27.2,-1,0,1,0,-2,-2,-1,-1
"7744",2020-03-18,"Cement Creek","w1920","Hybrid",NA,"Wed","weekday","sled","2","2","2",11.7,0,43,-1,33,27.2,-1,0,1,0,-2,-2,-1,-1
"7745",2020-03-19,"Cement Creek","w1920","Non.motorized",2,"Thu","weekday","no_sled","3","3","3",11.8,0.1,43,0,27,27.4,-1,-1,0,1,-1,-2,-2,-1
"7746",2020-03-19,"Cement Creek","w1920","Mechanized",0,"Thu","weekday","no_sled","3","3","3",11.8,0.1,43,0,27,27.4,-1,-1,0,1,-1,-2,-2,-1
"7747",2020-03-19,"Cement Creek","w1920","Motorized",0,"Thu","weekday","sled","3","3","3",11.8,0.1,43,0,27,27.4,-1,-1,0,1,-1,-2,-2,-1
"7748",2020-03-19,"Cement Creek","w1920","Hybrid",NA,"Thu","weekday","sled","3","3","3",11.8,0.1,43,0,27,27.4,-1,-1,0,1,-1,-2,-2,-1
"7749",2020-03-20,"Cement Creek","w1920","Non.motorized",17,"Fri","weekday","no_sled","3","3","2",12.7,0.9,52,9,26,24.4,0,-1,-1,0,9,8,7,7
"7750",2020-03-20,"Cement Creek","w1920","Mechanized",0,"Fri","weekday","no_sled","3","3","2",12.7,0.9,52,9,26,24.4,0,-1,-1,0,9,8,7,7
"7751",2020-03-20,"Cement Creek","w1920","Motorized",4,"Fri","weekday","sled","3","3","2",12.7,0.9,52,9,26,24.4,0,-1,-1,0,9,8,7,7
"7752",2020-03-20,"Cement Creek","w1920","Hybrid",2,"Fri","weekday","sled","3","3","2",12.7,0.9,52,9,26,24.4,0,-1,-1,0,9,8,7,7
"7753",2020-03-21,"Cement Creek","w1920","Non.motorized",32,"Sat","weekend","no_sled","3","3","2",12.8,0.1,54,2,26,23.7,9,0,-1,-1,11,11,10,9
"7754",2020-03-21,"Cement Creek","w1920","Mechanized",3,"Sat","weekend","no_sled","3","3","2",12.8,0.1,54,2,26,23.7,9,0,-1,-1,11,11,10,9
"7755",2020-03-21,"Cement Creek","w1920","Motorized",3,"Sat","weekend","sled","3","3","2",12.8,0.1,54,2,26,23.7,9,0,-1,-1,11,11,10,9
"7756",2020-03-21,"Cement Creek","w1920","Hybrid",NA,"Sat","weekend","sled","3","3","2",12.8,0.1,54,2,26,23.7,9,0,-1,-1,11,11,10,9
"7757",2020-03-22,"Cement Creek","w1920","Non.motorized",8,"Sun","weekend","no_sled","2","2","2",13,0.2,53,-1,28,24.5,2,9,0,-1,1,10,10,9
"7758",2020-03-22,"Cement Creek","w1920","Mechanized",0,"Sun","weekend","no_sled","2","2","2",13,0.2,53,-1,28,24.5,2,9,0,-1,1,10,10,9
"7759",2020-03-22,"Cement Creek","w1920","Motorized",2,"Sun","weekend","sled","2","2","2",13,0.2,53,-1,28,24.5,2,9,0,-1,1,10,10,9
"7760",2020-03-22,"Cement Creek","w1920","Hybrid",NA,"Sun","weekend","sled","2","2","2",13,0.2,53,-1,28,24.5,2,9,0,-1,1,10,10,9
"7761",2020-03-23,"Cement Creek","w1920","Non.motorized",12,"Mon","weekday","no_sled","2","2","2",13,0,53,0,28,24.5,-1,2,9,0,-1,1,10,10
"7762",2020-03-23,"Cement Creek","w1920","Mechanized",2,"Mon","weekday","no_sled","2","2","2",13,0,53,0,28,24.5,-1,2,9,0,-1,1,10,10
"7763",2020-03-23,"Cement Creek","w1920","Motorized",3,"Mon","weekday","sled","2","2","2",13,0,53,0,28,24.5,-1,2,9,0,-1,1,10,10
"7764",2020-03-23,"Cement Creek","w1920","Hybrid",1,"Mon","weekday","sled","2","2","2",13,0,53,0,28,24.5,-1,2,9,0,-1,1,10,10
"7765",2020-03-24,"Cement Creek","w1920","Non.motorized",20,"Tue","weekday","no_sled","2","2","2",13.2,0.2,53,0,32,24.9,0,-1,2,9,0,-1,1,10
"7766",2020-03-24,"Cement Creek","w1920","Mechanized",1,"Tue","weekday","no_sled","2","2","2",13.2,0.2,53,0,32,24.9,0,-1,2,9,0,-1,1,10
"7767",2020-03-24,"Cement Creek","w1920","Motorized",5,"Tue","weekday","sled","2","2","2",13.2,0.2,53,0,32,24.9,0,-1,2,9,0,-1,1,10
"7768",2020-03-24,"Cement Creek","w1920","Hybrid",1,"Tue","weekday","sled","2","2","2",13.2,0.2,53,0,32,24.9,0,-1,2,9,0,-1,1,10
"7769",2020-03-25,"Cement Creek","w1920","Non.motorized",20,"Wed","weekday","no_sled","2","2","2",13.3,0.1,51,-2,34,26.1,0,0,-1,2,-2,-2,-3,-1
"7770",2020-03-25,"Cement Creek","w1920","Mechanized",2,"Wed","weekday","no_sled","2","2","2",13.3,0.1,51,-2,34,26.1,0,0,-1,2,-2,-2,-3,-1
"7771",2020-03-25,"Cement Creek","w1920","Motorized",2,"Wed","weekday","sled","2","2","2",13.3,0.1,51,-2,34,26.1,0,0,-1,2,-2,-2,-3,-1
"7772",2020-03-25,"Cement Creek","w1920","Hybrid",NA,"Wed","weekday","sled","2","2","2",13.3,0.1,51,-2,34,26.1,0,0,-1,2,-2,-2,-3,-1
"7773",2020-03-26,"Cement Creek","w1920","Non.motorized",23,"Thu","weekday","no_sled","2","2","2",13.3,0,50,-1,36,26.6,-2,0,0,-1,-3,-3,-3,-4
"7774",2020-03-26,"Cement Creek","w1920","Non.motorized",23,"Thu","weekday","no_sled","3","3","2",13.3,0,50,-1,36,26.6,-2,0,0,-1,-3,-3,-3,-4
"7775",2020-03-26,"Cement Creek","w1920","Mechanized",0,"Thu","weekday","no_sled","2","2","2",13.3,0,50,-1,36,26.6,-2,0,0,-1,-3,-3,-3,-4
"7776",2020-03-26,"Cement Creek","w1920","Mechanized",0,"Thu","weekday","no_sled","3","3","2",13.3,0,50,-1,36,26.6,-2,0,0,-1,-3,-3,-3,-4
"7777",2020-03-26,"Cement Creek","w1920","Motorized",2,"Thu","weekday","sled","2","2","2",13.3,0,50,-1,36,26.6,-2,0,0,-1,-3,-3,-3,-4
"7778",2020-03-26,"Cement Creek","w1920","Motorized",2,"Thu","weekday","sled","3","3","2",13.3,0,50,-1,36,26.6,-2,0,0,-1,-3,-3,-3,-4
"7779",2020-03-26,"Cement Creek","w1920","Hybrid",NA,"Thu","weekday","sled","2","2","2",13.3,0,50,-1,36,26.6,-2,0,0,-1,-3,-3,-3,-4
"7780",2020-03-26,"Cement Creek","w1920","Hybrid",NA,"Thu","weekday","sled","3","3","2",13.3,0,50,-1,36,26.6,-2,0,0,-1,-3,-3,-3,-4
"7781",2020-03-27,"Cement Creek","w1920","Non.motorized",8,"Fri","weekday","no_sled","3","3","2",13.3,0,50,0,23,26.6,-1,-2,0,0,-1,-3,-3,-3
"7782",2020-03-27,"Cement Creek","w1920","Mechanized",0,"Fri","weekday","no_sled","3","3","2",13.3,0,50,0,23,26.6,-1,-2,0,0,-1,-3,-3,-3
"7783",2020-03-27,"Cement Creek","w1920","Motorized",2,"Fri","weekday","sled","3","3","2",13.3,0,50,0,23,26.6,-1,-2,0,0,-1,-3,-3,-3
"7784",2020-03-27,"Cement Creek","w1920","Hybrid",NA,"Fri","weekday","sled","3","3","2",13.3,0,50,0,23,26.6,-1,-2,0,0,-1,-3,-3,-3
"7785",2020-03-28,"Cement Creek","w1920","Non.motorized",28,"Sat","weekend","no_sled","3","3","3",13.3,0,50,0,18,26.6,0,-1,-2,0,0,-1,-3,-3
"7786",2020-03-28,"Cement Creek","w1920","Mechanized",3,"Sat","weekend","no_sled","3","3","3",13.3,0,50,0,18,26.6,0,-1,-2,0,0,-1,-3,-3
"7787",2020-03-28,"Cement Creek","w1920","Motorized",2,"Sat","weekend","sled","3","3","3",13.3,0,50,0,18,26.6,0,-1,-2,0,0,-1,-3,-3
"7788",2020-03-28,"Cement Creek","w1920","Hybrid",1,"Sat","weekend","sled","3","3","3",13.3,0,50,0,18,26.6,0,-1,-2,0,0,-1,-3,-3
"7789",2020-03-29,"Cement Creek","w1920","Non.motorized",25,"Sun","weekend","no_sled","2","2","2",13.3,0,49,-1,24,27.1,0,0,-1,-2,-1,-1,-2,-4
"7790",2020-03-29,"Cement Creek","w1920","Mechanized",0,"Sun","weekend","no_sled","2","2","2",13.3,0,49,-1,24,27.1,0,0,-1,-2,-1,-1,-2,-4
"7791",2020-03-29,"Cement Creek","w1920","Motorized",3,"Sun","weekend","sled","2","2","2",13.3,0,49,-1,24,27.1,0,0,-1,-2,-1,-1,-2,-4
"7792",2020-03-29,"Cement Creek","w1920","Hybrid",NA,"Sun","weekend","sled","2","2","2",13.3,0,49,-1,24,27.1,0,0,-1,-2,-1,-1,-2,-4
"7793",2020-03-30,"Cement Creek","w1920","Non.motorized",13,"Mon","weekday","no_sled","2","2","2",13.4,0.1,49,0,29,27.3,-1,0,0,-1,-1,-1,-1,-2
"7794",2020-03-30,"Cement Creek","w1920","Mechanized",1,"Mon","weekday","no_sled","2","2","2",13.4,0.1,49,0,29,27.3,-1,0,0,-1,-1,-1,-1,-2
"7795",2020-03-30,"Cement Creek","w1920","Motorized",6,"Mon","weekday","sled","2","2","2",13.4,0.1,49,0,29,27.3,-1,0,0,-1,-1,-1,-1,-2
"7796",2020-03-30,"Cement Creek","w1920","Hybrid",1,"Mon","weekday","sled","2","2","2",13.4,0.1,49,0,29,27.3,-1,0,0,-1,-1,-1,-1,-2
"7797",2020-03-31,"Cement Creek","w1920","Non.motorized",12,"Tue","weekday","no_sled","2","2","2",13.6,0.2,51,2,35,26.7,0,-1,0,0,2,1,1,1
"7798",2020-03-31,"Cement Creek","w1920","Mechanized",0,"Tue","weekday","no_sled","2","2","2",13.6,0.2,51,2,35,26.7,0,-1,0,0,2,1,1,1
"7799",2020-03-31,"Cement Creek","w1920","Motorized",2,"Tue","weekday","sled","2","2","2",13.6,0.2,51,2,35,26.7,0,-1,0,0,2,1,1,1
"7800",2020-03-31,"Cement Creek","w1920","Hybrid",1,"Tue","weekday","sled","2","2","2",13.6,0.2,51,2,35,26.7,0,-1,0,0,2,1,1,1
"7801",2020-04-01,"Cement Creek","w1920","Non.motorized",6,"Wed","weekday","no_sled","2","2","2",13.6,0,47,-4,39,28.9,2,0,-1,0,-2,-2,-3,-3
"7802",2020-04-01,"Cement Creek","w1920","Mechanized",0,"Wed","weekday","no_sled","2","2","2",13.6,0,47,-4,39,28.9,2,0,-1,0,-2,-2,-3,-3
"7803",2020-04-01,"Cement Creek","w1920","Motorized",6,"Wed","weekday","sled","2","2","2",13.6,0,47,-4,39,28.9,2,0,-1,0,-2,-2,-3,-3
"7804",2020-04-01,"Cement Creek","w1920","Hybrid",NA,"Wed","weekday","sled","2","2","2",13.6,0,47,-4,39,28.9,2,0,-1,0,-2,-2,-3,-3
"7805",2020-04-02,"Cement Creek","w1920","Non.motorized",5,"Thu","weekday","no_sled","2","2","2",13.6,0,46,-1,31,29.6,-4,2,0,-1,-5,-3,-3,-4
"7806",2020-04-02,"Cement Creek","w1920","Mechanized",1,"Thu","weekday","no_sled","2","2","2",13.6,0,46,-1,31,29.6,-4,2,0,-1,-5,-3,-3,-4
"7807",2020-04-02,"Cement Creek","w1920","Motorized",1,"Thu","weekday","sled","2","2","2",13.6,0,46,-1,31,29.6,-4,2,0,-1,-5,-3,-3,-4
"7808",2020-04-02,"Cement Creek","w1920","Hybrid",1,"Thu","weekday","sled","2","2","2",13.6,0,46,-1,31,29.6,-4,2,0,-1,-5,-3,-3,-4
"7809",2020-04-03,"Cement Creek","w1920","Non.motorized",27,"Fri","weekday","no_sled","2","2","2",13.6,0,46,0,28,29.6,-1,-4,2,0,-1,-5,-3,-3
"7810",2020-04-03,"Cement Creek","w1920","Mechanized",0,"Fri","weekday","no_sled","2","2","2",13.6,0,46,0,28,29.6,-1,-4,2,0,-1,-5,-3,-3
"7811",2020-04-03,"Cement Creek","w1920","Motorized",1,"Fri","weekday","sled","2","2","2",13.6,0,46,0,28,29.6,-1,-4,2,0,-1,-5,-3,-3
"7812",2020-04-03,"Cement Creek","w1920","Hybrid",NA,"Fri","weekday","sled","2","2","2",13.6,0,46,0,28,29.6,-1,-4,2,0,-1,-5,-3,-3
"7813",2020-04-04,"Cement Creek","w1920","Non.motorized",21,"Sat","weekend","no_sled","2","2","2",13.6,0,45,-1,33,30.2,0,-1,-4,2,-1,-2,-6,-4
"7814",2020-04-04,"Cement Creek","w1920","Mechanized",0,"Sat","weekend","no_sled","2","2","2",13.6,0,45,-1,33,30.2,0,-1,-4,2,-1,-2,-6,-4
"7815",2020-04-04,"Cement Creek","w1920","Motorized",6,"Sat","weekend","sled","2","2","2",13.6,0,45,-1,33,30.2,0,-1,-4,2,-1,-2,-6,-4
"7816",2020-04-04,"Cement Creek","w1920","Hybrid",1,"Sat","weekend","sled","2","2","2",13.6,0,45,-1,33,30.2,0,-1,-4,2,-1,-2,-6,-4
"7817",2020-04-05,"Cement Creek","w1920","Non.motorized",21,"Sun","weekend","no_sled","2","2","3",13.6,0,45,0,38,30.2,-1,0,-1,-4,-1,-1,-2,-6
"7818",2020-04-05,"Cement Creek","w1920","Mechanized",1,"Sun","weekend","no_sled","2","2","3",13.6,0,45,0,38,30.2,-1,0,-1,-4,-1,-1,-2,-6
"7819",2020-04-05,"Cement Creek","w1920","Motorized",4,"Sun","weekend","sled","2","2","3",13.6,0,45,0,38,30.2,-1,0,-1,-4,-1,-1,-2,-6
"7820",2020-04-05,"Cement Creek","w1920","Hybrid",NA,"Sun","weekend","sled","2","2","3",13.6,0,45,0,38,30.2,-1,0,-1,-4,-1,-1,-2,-6
"7821",2020-04-06,"Cement Creek","w1920","Non.motorized",11,"Mon","weekday","no_sled","2","2","3",13.6,0,44,-1,40,30.9,0,-1,0,-1,-1,-2,-2,-3
"7822",2020-04-06,"Cement Creek","w1920","Mechanized",1,"Mon","weekday","no_sled","2","2","3",13.6,0,44,-1,40,30.9,0,-1,0,-1,-1,-2,-2,-3
"7823",2020-04-06,"Cement Creek","w1920","Motorized",0,"Mon","weekday","sled","2","2","3",13.6,0,44,-1,40,30.9,0,-1,0,-1,-1,-2,-2,-3
"7824",2020-04-06,"Cement Creek","w1920","Hybrid",NA,"Mon","weekday","sled","2","2","3",13.6,0,44,-1,40,30.9,0,-1,0,-1,-1,-2,-2,-3
"7825",2020-04-07,"Cement Creek","w1920","Non.motorized",12,"Tue","weekday","no_sled","2","2","3",13.4,-0.2,43,-1,39,31.2,-1,0,-1,0,-2,-2,-3,-3
"7826",2020-04-07,"Cement Creek","w1920","Mechanized",1,"Tue","weekday","no_sled","2","2","3",13.4,-0.2,43,-1,39,31.2,-1,0,-1,0,-2,-2,-3,-3
"7827",2020-04-07,"Cement Creek","w1920","Motorized",4,"Tue","weekday","sled","2","2","3",13.4,-0.2,43,-1,39,31.2,-1,0,-1,0,-2,-2,-3,-3
"7828",2020-04-07,"Cement Creek","w1920","Hybrid",1,"Tue","weekday","sled","2","2","3",13.4,-0.2,43,-1,39,31.2,-1,0,-1,0,-2,-2,-3,-3
"7829",2020-04-08,"Cement Creek","w1920","Non.motorized",17,"Wed","weekday","no_sled","2","3","3",13.3,-0.1,42,-1,40,31.7,-1,-1,0,-1,-2,-3,-3,-4
"7830",2020-04-08,"Cement Creek","w1920","Mechanized",0,"Wed","weekday","no_sled","2","3","3",13.3,-0.1,42,-1,40,31.7,-1,-1,0,-1,-2,-3,-3,-4
"7831",2020-04-08,"Cement Creek","w1920","Motorized",0,"Wed","weekday","sled","2","3","3",13.3,-0.1,42,-1,40,31.7,-1,-1,0,-1,-2,-3,-3,-4
"7832",2020-04-08,"Cement Creek","w1920","Hybrid",NA,"Wed","weekday","sled","2","3","3",13.3,-0.1,42,-1,40,31.7,-1,-1,0,-1,-2,-3,-3,-4
"7833",2020-04-09,"Cement Creek","w1920","Non.motorized",9,"Thu","weekday","no_sled","2","3","3",13.1,-0.2,40,-2,42,32.8,-1,-1,-1,0,-3,-4,-5,-5
"7834",2020-04-09,"Cement Creek","w1920","Mechanized",0,"Thu","weekday","no_sled","2","3","3",13.1,-0.2,40,-2,42,32.8,-1,-1,-1,0,-3,-4,-5,-5
"7835",2020-04-09,"Cement Creek","w1920","Motorized",1,"Thu","weekday","sled","2","3","3",13.1,-0.2,40,-2,42,32.8,-1,-1,-1,0,-3,-4,-5,-5
"7836",2020-04-09,"Cement Creek","w1920","Hybrid",1,"Thu","weekday","sled","2","3","3",13.1,-0.2,40,-2,42,32.8,-1,-1,-1,0,-3,-4,-5,-5
"7837",2020-04-10,"Cement Creek","w1920","Non.motorized",6,"Fri","weekday","no_sled","3","3","3",12.9,-0.2,39,-1,38,33.1,-2,-1,-1,-1,-3,-4,-5,-6
"7838",2020-04-10,"Cement Creek","w1920","Mechanized",1,"Fri","weekday","no_sled","3","3","3",12.9,-0.2,39,-1,38,33.1,-2,-1,-1,-1,-3,-4,-5,-6
"7839",2020-04-10,"Cement Creek","w1920","Motorized",0,"Fri","weekday","sled","3","3","3",12.9,-0.2,39,-1,38,33.1,-2,-1,-1,-1,-3,-4,-5,-6
"7840",2020-04-10,"Cement Creek","w1920","Hybrid",NA,"Fri","weekday","sled","3","3","3",12.9,-0.2,39,-1,38,33.1,-2,-1,-1,-1,-3,-4,-5,-6
"7841",2020-04-11,"Cement Creek","w1920","Non.motorized",17,"Sat","weekend","no_sled","2","3","3",12.9,0,39,0,36,33.1,-1,-2,-1,-1,-1,-3,-4,-5
"7842",2020-04-11,"Cement Creek","w1920","Mechanized",1,"Sat","weekend","no_sled","2","3","3",12.9,0,39,0,36,33.1,-1,-2,-1,-1,-1,-3,-4,-5
"7843",2020-04-11,"Cement Creek","w1920","Motorized",2,"Sat","weekend","sled","2","3","3",12.9,0,39,0,36,33.1,-1,-2,-1,-1,-1,-3,-4,-5
"7844",2020-04-11,"Cement Creek","w1920","Hybrid",NA,"Sat","weekend","sled","2","3","3",12.9,0,39,0,36,33.1,-1,-2,-1,-1,-1,-3,-4,-5
"7845",2020-04-12,"Cement Creek","w1920","Non.motorized",16,"Sun","weekend","no_sled","2","2","2",12.8,-0.1,38,-1,29,33.7,0,-1,-2,-1,-1,-2,-4,-5
"7846",2020-04-12,"Cement Creek","w1920","Mechanized",0,"Sun","weekend","no_sled","2","2","2",12.8,-0.1,38,-1,29,33.7,0,-1,-2,-1,-1,-2,-4,-5
"7847",2020-04-12,"Cement Creek","w1920","Motorized",3,"Sun","weekend","sled","2","2","2",12.8,-0.1,38,-1,29,33.7,0,-1,-2,-1,-1,-2,-4,-5
"7848",2020-04-12,"Cement Creek","w1920","Hybrid",NA,"Sun","weekend","sled","2","2","2",12.8,-0.1,38,-1,29,33.7,0,-1,-2,-1,-1,-2,-4,-5
"7849",2020-04-13,"Cement Creek","w1920","Non.motorized",2,"Mon","weekday","no_sled",NA,NA,NA,12.9,0.1,39,1,20,33.1,-1,0,-1,-2,0,0,-1,-3
"7850",2020-04-13,"Cement Creek","w1920","Mechanized",0,"Mon","weekday","no_sled",NA,NA,NA,12.9,0.1,39,1,20,33.1,-1,0,-1,-2,0,0,-1,-3
"7851",2020-04-13,"Cement Creek","w1920","Motorized",0,"Mon","weekday","sled",NA,NA,NA,12.9,0.1,39,1,20,33.1,-1,0,-1,-2,0,0,-1,-3
"7852",2020-04-13,"Cement Creek","w1920","Hybrid",NA,"Mon","weekday","sled",NA,NA,NA,12.9,0.1,39,1,20,33.1,-1,0,-1,-2,0,0,-1,-3
"7853",2020-04-14,"Cement Creek","w1920","Non.motorized",4,"Tue","weekday","no_sled","2","2","2",13,0.1,39,0,18,33.3,1,-1,0,-1,1,0,0,-1
"7854",2020-04-14,"Cement Creek","w1920","Mechanized",0,"Tue","weekday","no_sled","2","2","2",13,0.1,39,0,18,33.3,1,-1,0,-1,1,0,0,-1
"7855",2020-04-14,"Cement Creek","w1920","Motorized",0,"Tue","weekday","sled","2","2","2",13,0.1,39,0,18,33.3,1,-1,0,-1,1,0,0,-1
"7856",2020-04-14,"Cement Creek","w1920","Hybrid",NA,"Tue","weekday","sled","2","2","2",13,0.1,39,0,18,33.3,1,-1,0,-1,1,0,0,-1
"7857",2020-04-15,"Cement Creek","w1920","Non.motorized",6,"Wed","weekday","no_sled",NA,NA,NA,13.2,0.2,39,0,28,33.8,0,1,-1,0,0,1,0,0
"7858",2020-04-15,"Cement Creek","w1920","Mechanized",0,"Wed","weekday","no_sled",NA,NA,NA,13.2,0.2,39,0,28,33.8,0,1,-1,0,0,1,0,0
"7859",2020-04-15,"Cement Creek","w1920","Motorized",1,"Wed","weekday","sled",NA,NA,NA,13.2,0.2,39,0,28,33.8,0,1,-1,0,0,1,0,0
"7860",2020-04-15,"Cement Creek","w1920","Hybrid",NA,"Wed","weekday","sled",NA,NA,NA,13.2,0.2,39,0,28,33.8,0,1,-1,0,0,1,0,0
"7861",2019-12-06,"Gothic Rd","w1920","Non.motorized",14,"Fri","weekday","no_sled","2","2","1",2.9,0.4,19,5,24,15.3,0,0,0,0,5,5,5,5
"7862",2019-12-06,"Gothic Rd","w1920","Mechanized",2,"Fri","weekday","no_sled","2","2","1",2.9,0.4,19,5,24,15.3,0,0,0,0,5,5,5,5
"7863",2019-12-06,"Gothic Rd","w1920","Motorized",2,"Fri","weekday","sled","2","2","1",2.9,0.4,19,5,24,15.3,0,0,0,0,5,5,5,5
"7864",2019-12-06,"Gothic Rd","w1920","Hybrid",0,"Fri","weekday","sled","2","2","1",2.9,0.4,19,5,24,15.3,0,0,0,0,5,5,5,5
"7865",2019-12-07,"Gothic Rd","w1920","Non.motorized",NA,"Sat","weekend","no_sled","2","2","1",3,0.1,18,-1,29,16.7,5,0,0,0,4,4,4,4
"7866",2019-12-07,"Gothic Rd","w1920","Mechanized",NA,"Sat","weekend","no_sled","2","2","1",3,0.1,18,-1,29,16.7,5,0,0,0,4,4,4,4
"7867",2019-12-07,"Gothic Rd","w1920","Motorized",NA,"Sat","weekend","sled","2","2","1",3,0.1,18,-1,29,16.7,5,0,0,0,4,4,4,4
"7868",2019-12-07,"Gothic Rd","w1920","Hybrid",NA,"Sat","weekend","sled","2","2","1",3,0.1,18,-1,29,16.7,5,0,0,0,4,4,4,4
"7869",2019-12-08,"Gothic Rd","w1920","Non.motorized",12,"Sun","weekend","no_sled","2","2","1",3,0,17,-1,28,17.6,-1,5,0,0,-2,3,3,3
"7870",2019-12-08,"Gothic Rd","w1920","Mechanized",0,"Sun","weekend","no_sled","2","2","1",3,0,17,-1,28,17.6,-1,5,0,0,-2,3,3,3
"7871",2019-12-08,"Gothic Rd","w1920","Motorized",2,"Sun","weekend","sled","2","2","1",3,0,17,-1,28,17.6,-1,5,0,0,-2,3,3,3
"7872",2019-12-08,"Gothic Rd","w1920","Hybrid",0,"Sun","weekend","sled","2","2","1",3,0,17,-1,28,17.6,-1,5,0,0,-2,3,3,3
"7873",2019-12-09,"Gothic Rd","w1920","Non.motorized",3,"Mon","weekday","no_sled","3","3","2",3.4,0.4,22,5,21,15.5,-1,-1,5,0,4,3,8,8
"7874",2019-12-09,"Gothic Rd","w1920","Mechanized",0,"Mon","weekday","no_sled","3","3","2",3.4,0.4,22,5,21,15.5,-1,-1,5,0,4,3,8,8
"7875",2019-12-09,"Gothic Rd","w1920","Motorized",3,"Mon","weekday","sled","3","3","2",3.4,0.4,22,5,21,15.5,-1,-1,5,0,4,3,8,8
"7876",2019-12-09,"Gothic Rd","w1920","Hybrid",0,"Mon","weekday","sled","3","3","2",3.4,0.4,22,5,21,15.5,-1,-1,5,0,4,3,8,8
"7877",2019-12-10,"Gothic Rd","w1920","Non.motorized",7,"Tue","weekday","no_sled","2","2","2",3.4,0,21,-1,19,16.2,5,-1,-1,5,4,3,2,7
"7878",2019-12-10,"Gothic Rd","w1920","Mechanized",0,"Tue","weekday","no_sled","2","2","2",3.4,0,21,-1,19,16.2,5,-1,-1,5,4,3,2,7
"7879",2019-12-10,"Gothic Rd","w1920","Motorized",2,"Tue","weekday","sled","2","2","2",3.4,0,21,-1,19,16.2,5,-1,-1,5,4,3,2,7
"7880",2019-12-10,"Gothic Rd","w1920","Hybrid",0,"Tue","weekday","sled","2","2","2",3.4,0,21,-1,19,16.2,5,-1,-1,5,4,3,2,7
"7881",2019-12-11,"Gothic Rd","w1920","Non.motorized",11,"Wed","weekday","no_sled","2","2","2",3.4,0,20,-1,22,17,-1,5,-1,-1,-2,3,2,1
"7882",2019-12-11,"Gothic Rd","w1920","Mechanized",0,"Wed","weekday","no_sled","2","2","2",3.4,0,20,-1,22,17,-1,5,-1,-1,-2,3,2,1
"7883",2019-12-11,"Gothic Rd","w1920","Motorized",1,"Wed","weekday","sled","2","2","2",3.4,0,20,-1,22,17,-1,5,-1,-1,-2,3,2,1
"7884",2019-12-11,"Gothic Rd","w1920","Hybrid",0,"Wed","weekday","sled","2","2","2",3.4,0,20,-1,22,17,-1,5,-1,-1,-2,3,2,1
"7885",2019-12-12,"Gothic Rd","w1920","Non.motorized",15,"Thu","weekday","no_sled","2","2","2",3.4,0,19,-1,25,17.9,-1,-1,5,-1,-2,-3,2,1
"7886",2019-12-12,"Gothic Rd","w1920","Mechanized",0,"Thu","weekday","no_sled","2","2","2",3.4,0,19,-1,25,17.9,-1,-1,5,-1,-2,-3,2,1
"7887",2019-12-12,"Gothic Rd","w1920","Motorized",0,"Thu","weekday","sled","2","2","2",3.4,0,19,-1,25,17.9,-1,-1,5,-1,-2,-3,2,1
"7888",2019-12-12,"Gothic Rd","w1920","Hybrid",0,"Thu","weekday","sled","2","2","2",3.4,0,19,-1,25,17.9,-1,-1,5,-1,-2,-3,2,1
"7889",2019-12-13,"Gothic Rd","w1920","Non.motorized",11,"Fri","weekday","no_sled","2","2","2",3.8,0.4,21,2,24,18.1,-1,-1,-1,5,1,0,-1,4
"7890",2019-12-13,"Gothic Rd","w1920","Mechanized",0,"Fri","weekday","no_sled","2","2","2",3.8,0.4,21,2,24,18.1,-1,-1,-1,5,1,0,-1,4
"7891",2019-12-13,"Gothic Rd","w1920","Motorized",0,"Fri","weekday","sled","2","2","2",3.8,0.4,21,2,24,18.1,-1,-1,-1,5,1,0,-1,4
"7892",2019-12-13,"Gothic Rd","w1920","Hybrid",0,"Fri","weekday","sled","2","2","2",3.8,0.4,21,2,24,18.1,-1,-1,-1,5,1,0,-1,4
"7893",2019-12-14,"Gothic Rd","w1920","Non.motorized",7,"Sat","weekend","no_sled","3","3","3",4.2,0.4,27,6,25,15.6,2,-1,-1,-1,8,7,6,5
"7894",2019-12-14,"Gothic Rd","w1920","Mechanized",2,"Sat","weekend","no_sled","3","3","3",4.2,0.4,27,6,25,15.6,2,-1,-1,-1,8,7,6,5
"7895",2019-12-14,"Gothic Rd","w1920","Motorized",0,"Sat","weekend","sled","3","3","3",4.2,0.4,27,6,25,15.6,2,-1,-1,-1,8,7,6,5
"7896",2019-12-14,"Gothic Rd","w1920","Hybrid",0,"Sat","weekend","sled","3","3","3",4.2,0.4,27,6,25,15.6,2,-1,-1,-1,8,7,6,5
"7897",2019-12-15,"Gothic Rd","w1920","Non.motorized",13,"Sun","weekend","no_sled","3","3","2",4.8,0.6,31,4,17,15.5,6,2,-1,-1,10,12,11,10
"7898",2019-12-15,"Gothic Rd","w1920","Mechanized",0,"Sun","weekend","no_sled","3","3","2",4.8,0.6,31,4,17,15.5,6,2,-1,-1,10,12,11,10
"7899",2019-12-15,"Gothic Rd","w1920","Motorized",0,"Sun","weekend","sled","3","3","2",4.8,0.6,31,4,17,15.5,6,2,-1,-1,10,12,11,10
"7900",2019-12-15,"Gothic Rd","w1920","Hybrid",0,"Sun","weekend","sled","3","3","2",4.8,0.6,31,4,17,15.5,6,2,-1,-1,10,12,11,10
"7901",2019-12-16,"Gothic Rd","w1920","Non.motorized",7,"Mon","weekday","no_sled","3","3","2",4.8,0,29,-2,6,16.6,4,6,2,-1,2,8,10,9
"7902",2019-12-16,"Gothic Rd","w1920","Mechanized",0,"Mon","weekday","no_sled","3","3","2",4.8,0,29,-2,6,16.6,4,6,2,-1,2,8,10,9
"7903",2019-12-16,"Gothic Rd","w1920","Motorized",1,"Mon","weekday","sled","3","3","2",4.8,0,29,-2,6,16.6,4,6,2,-1,2,8,10,9
"7904",2019-12-16,"Gothic Rd","w1920","Hybrid",0,"Mon","weekday","sled","3","3","2",4.8,0,29,-2,6,16.6,4,6,2,-1,2,8,10,9
"7905",2019-12-17,"Gothic Rd","w1920","Non.motorized",3,"Tue","weekday","no_sled","2","2","1",4.8,0,27,-2,8,17.8,-2,4,6,2,-4,0,6,8
"7906",2019-12-17,"Gothic Rd","w1920","Mechanized",0,"Tue","weekday","no_sled","2","2","1",4.8,0,27,-2,8,17.8,-2,4,6,2,-4,0,6,8
"7907",2019-12-17,"Gothic Rd","w1920","Motorized",0,"Tue","weekday","sled","2","2","1",4.8,0,27,-2,8,17.8,-2,4,6,2,-4,0,6,8
"7908",2019-12-17,"Gothic Rd","w1920","Hybrid",0,"Tue","weekday","sled","2","2","1",4.8,0,27,-2,8,17.8,-2,4,6,2,-4,0,6,8
"7909",2019-12-18,"Gothic Rd","w1920","Non.motorized",10,"Wed","weekday","no_sled","2","2","1",4.8,0,26,-1,20,18.5,-2,-2,4,6,-3,-5,-1,5
"7910",2019-12-18,"Gothic Rd","w1920","Mechanized",1,"Wed","weekday","no_sled","2","2","1",4.8,0,26,-1,20,18.5,-2,-2,4,6,-3,-5,-1,5
"7911",2019-12-18,"Gothic Rd","w1920","Motorized",2,"Wed","weekday","sled","2","2","1",4.8,0,26,-1,20,18.5,-2,-2,4,6,-3,-5,-1,5
"7912",2019-12-18,"Gothic Rd","w1920","Hybrid",0,"Wed","weekday","sled","2","2","1",4.8,0,26,-1,20,18.5,-2,-2,4,6,-3,-5,-1,5
"7913",2019-12-19,"Gothic Rd","w1920","Non.motorized",13,"Thu","weekday","no_sled","2","2","1",4.9,0.1,25,-1,21,19.6,-1,-2,-2,4,-2,-4,-6,-2
"7914",2019-12-19,"Gothic Rd","w1920","Mechanized",0,"Thu","weekday","no_sled","2","2","1",4.9,0.1,25,-1,21,19.6,-1,-2,-2,4,-2,-4,-6,-2
"7915",2019-12-19,"Gothic Rd","w1920","Motorized",0,"Thu","weekday","sled","2","2","1",4.9,0.1,25,-1,21,19.6,-1,-2,-2,4,-2,-4,-6,-2
"7916",2019-12-19,"Gothic Rd","w1920","Hybrid",0,"Thu","weekday","sled","2","2","1",4.9,0.1,25,-1,21,19.6,-1,-2,-2,4,-2,-4,-6,-2
"7917",2019-12-20,"Gothic Rd","w1920","Non.motorized",20,"Fri","weekday","no_sled","2","2","1",4.9,0,24,-1,21,20.4,-1,-1,-2,-2,-2,-3,-5,-7
"7918",2019-12-20,"Gothic Rd","w1920","Mechanized",0,"Fri","weekday","no_sled","2","2","1",4.9,0,24,-1,21,20.4,-1,-1,-2,-2,-2,-3,-5,-7
"7919",2019-12-20,"Gothic Rd","w1920","Motorized",0,"Fri","weekday","sled","2","2","1",4.9,0,24,-1,21,20.4,-1,-1,-2,-2,-2,-3,-5,-7
"7920",2019-12-20,"Gothic Rd","w1920","Hybrid",0,"Fri","weekday","sled","2","2","1",4.9,0,24,-1,21,20.4,-1,-1,-2,-2,-2,-3,-5,-7
"7921",2019-12-21,"Gothic Rd","w1920","Non.motorized",33,"Sat","weekend","no_sled","2","2","1",4.9,0,24,0,27,20.4,-1,-1,-1,-2,-1,-2,-3,-5
"7922",2019-12-21,"Gothic Rd","w1920","Mechanized",3,"Sat","weekend","no_sled","2","2","1",4.9,0,24,0,27,20.4,-1,-1,-1,-2,-1,-2,-3,-5
"7923",2019-12-21,"Gothic Rd","w1920","Motorized",1,"Sat","weekend","sled","2","2","1",4.9,0,24,0,27,20.4,-1,-1,-1,-2,-1,-2,-3,-5
"7924",2019-12-21,"Gothic Rd","w1920","Hybrid",0,"Sat","weekend","sled","2","2","1",4.9,0,24,0,27,20.4,-1,-1,-1,-2,-1,-2,-3,-5
"7925",2019-12-22,"Gothic Rd","w1920","Non.motorized",25,"Sun","weekend","no_sled","2","2","1",5,0.1,23,-1,31,21.7,0,-1,-1,-1,-1,-2,-3,-4
"7926",2019-12-22,"Gothic Rd","w1920","Mechanized",2,"Sun","weekend","no_sled","2","2","1",5,0.1,23,-1,31,21.7,0,-1,-1,-1,-1,-2,-3,-4
"7927",2019-12-22,"Gothic Rd","w1920","Motorized",0,"Sun","weekend","sled","2","2","1",5,0.1,23,-1,31,21.7,0,-1,-1,-1,-1,-2,-3,-4
"7928",2019-12-22,"Gothic Rd","w1920","Hybrid",0,"Sun","weekend","sled","2","2","1",5,0.1,23,-1,31,21.7,0,-1,-1,-1,-1,-2,-3,-4
"7929",2019-12-23,"Gothic Rd","w1920","Non.motorized",12,"Mon","weekday","no_sled","2","1","1",5,0,23,0,34,21.7,-1,0,-1,-1,-1,-1,-2,-3
"7930",2019-12-23,"Gothic Rd","w1920","Mechanized",1,"Mon","weekday","no_sled","2","1","1",5,0,23,0,34,21.7,-1,0,-1,-1,-1,-1,-2,-3
"7931",2019-12-23,"Gothic Rd","w1920","Motorized",0,"Mon","weekday","sled","2","1","1",5,0,23,0,34,21.7,-1,0,-1,-1,-1,-1,-2,-3
"7932",2019-12-23,"Gothic Rd","w1920","Hybrid",0,"Mon","weekday","sled","2","1","1",5,0,23,0,34,21.7,-1,0,-1,-1,-1,-1,-2,-3
"7933",2019-12-24,"Gothic Rd","w1920","Non.motorized",27,"Tue","weekday","no_sled","2","1","1",5,0,22,-1,30,22.7,0,-1,0,-1,-1,-2,-2,-3
"7934",2019-12-24,"Gothic Rd","w1920","Mechanized",3,"Tue","weekday","no_sled","2","1","1",5,0,22,-1,30,22.7,0,-1,0,-1,-1,-2,-2,-3
"7935",2019-12-24,"Gothic Rd","w1920","Motorized",0,"Tue","weekday","sled","2","1","1",5,0,22,-1,30,22.7,0,-1,0,-1,-1,-2,-2,-3
"7936",2019-12-24,"Gothic Rd","w1920","Hybrid",0,"Tue","weekday","sled","2","1","1",5,0,22,-1,30,22.7,0,-1,0,-1,-1,-2,-2,-3
"7937",2019-12-25,"Gothic Rd","w1920","Non.motorized",39,"Wed","weekday","no_sled","2","2","2",5,0,23,1,22,21.7,-1,0,-1,0,0,0,-1,-1
"7938",2019-12-25,"Gothic Rd","w1920","Mechanized",4,"Wed","weekday","no_sled","2","2","2",5,0,23,1,22,21.7,-1,0,-1,0,0,0,-1,-1
"7939",2019-12-25,"Gothic Rd","w1920","Motorized",0,"Wed","weekday","sled","2","2","2",5,0,23,1,22,21.7,-1,0,-1,0,0,0,-1,-1
"7940",2019-12-25,"Gothic Rd","w1920","Hybrid",0,"Wed","weekday","sled","2","2","2",5,0,23,1,22,21.7,-1,0,-1,0,0,0,-1,-1
"7941",2019-12-26,"Gothic Rd","w1920","Non.motorized",36,"Thu","weekday","no_sled","2","2","1",5,0,23,0,17,21.7,1,-1,0,-1,1,0,0,-1
"7942",2019-12-26,"Gothic Rd","w1920","Mechanized",4,"Thu","weekday","no_sled","2","2","1",5,0,23,0,17,21.7,1,-1,0,-1,1,0,0,-1
"7943",2019-12-26,"Gothic Rd","w1920","Motorized",0,"Thu","weekday","sled","2","2","1",5,0,23,0,17,21.7,1,-1,0,-1,1,0,0,-1
"7944",2019-12-26,"Gothic Rd","w1920","Hybrid",0,"Thu","weekday","sled","2","2","1",5,0,23,0,17,21.7,1,-1,0,-1,1,0,0,-1
"7945",2019-12-27,"Gothic Rd","w1920","Non.motorized",42,"Fri","weekday","no_sled","3","3","2",5.1,0.1,24,1,22,21.2,0,1,-1,0,1,2,1,1
"7946",2019-12-27,"Gothic Rd","w1920","Mechanized",2,"Fri","weekday","no_sled","3","3","2",5.1,0.1,24,1,22,21.2,0,1,-1,0,1,2,1,1
"7947",2019-12-27,"Gothic Rd","w1920","Motorized",0,"Fri","weekday","sled","3","3","2",5.1,0.1,24,1,22,21.2,0,1,-1,0,1,2,1,1
"7948",2019-12-27,"Gothic Rd","w1920","Hybrid",0,"Fri","weekday","sled","3","3","2",5.1,0.1,24,1,22,21.2,0,1,-1,0,1,2,1,1
"7949",2019-12-28,"Gothic Rd","w1920","Non.motorized",55,"Sat","weekend","no_sled","3","3","2",5.6,0.5,30,6,16,18.7,1,0,1,-1,7,7,8,7
"7950",2019-12-28,"Gothic Rd","w1920","Mechanized",1,"Sat","weekend","no_sled","3","3","2",5.6,0.5,30,6,16,18.7,1,0,1,-1,7,7,8,7
"7951",2019-12-28,"Gothic Rd","w1920","Motorized",0,"Sat","weekend","sled","3","3","2",5.6,0.5,30,6,16,18.7,1,0,1,-1,7,7,8,7
"7952",2019-12-28,"Gothic Rd","w1920","Hybrid",0,"Sat","weekend","sled","3","3","2",5.6,0.5,30,6,16,18.7,1,0,1,-1,7,7,8,7
"7953",2019-12-29,"Gothic Rd","w1920","Non.motorized",50,"Sun","weekend","no_sled","3","3","2",5.6,0,29,-1,3,19.3,6,1,0,1,5,6,6,7
"7954",2019-12-29,"Gothic Rd","w1920","Mechanized",1,"Sun","weekend","no_sled","3","3","2",5.6,0,29,-1,3,19.3,6,1,0,1,5,6,6,7
"7955",2019-12-29,"Gothic Rd","w1920","Motorized",0,"Sun","weekend","sled","3","3","2",5.6,0,29,-1,3,19.3,6,1,0,1,5,6,6,7
"7956",2019-12-29,"Gothic Rd","w1920","Hybrid",0,"Sun","weekend","sled","3","3","2",5.6,0,29,-1,3,19.3,6,1,0,1,5,6,6,7
"7957",2019-12-30,"Gothic Rd","w1920","Non.motorized",55,"Mon","weekday","no_sled","3","3","2",5.6,0,28,-1,3,20,-1,6,1,0,-2,4,5,5
"7958",2019-12-30,"Gothic Rd","w1920","Mechanized",2,"Mon","weekday","no_sled","3","3","2",5.6,0,28,-1,3,20,-1,6,1,0,-2,4,5,5
"7959",2019-12-30,"Gothic Rd","w1920","Motorized",0,"Mon","weekday","sled","3","3","2",5.6,0,28,-1,3,20,-1,6,1,0,-2,4,5,5
"7960",2019-12-30,"Gothic Rd","w1920","Hybrid",0,"Mon","weekday","sled","3","3","2",5.6,0,28,-1,3,20,-1,6,1,0,-2,4,5,5
"7961",2019-12-31,"Gothic Rd","w1920","Non.motorized",39,"Tue","weekday","no_sled","2","2","1",5.6,0,28,0,13,20,-1,-1,6,1,-1,-2,4,5
"7962",2019-12-31,"Gothic Rd","w1920","Mechanized",5,"Tue","weekday","no_sled","2","2","1",5.6,0,28,0,13,20,-1,-1,6,1,-1,-2,4,5
"7963",2019-12-31,"Gothic Rd","w1920","Motorized",1,"Tue","weekday","sled","2","2","1",5.6,0,28,0,13,20,-1,-1,6,1,-1,-2,4,5
"7964",2019-12-31,"Gothic Rd","w1920","Hybrid",0,"Tue","weekday","sled","2","2","1",5.6,0,28,0,13,20,-1,-1,6,1,-1,-2,4,5
"7965",2020-01-01,"Gothic Rd","w1920","Non.motorized",49,"Wed","weekday","no_sled","2","1","1",5.6,0,27,-1,21,20.7,0,-1,-1,6,-1,-2,-3,3
"7966",2020-01-01,"Gothic Rd","w1920","Mechanized",1,"Wed","weekday","no_sled","2","1","1",5.6,0,27,-1,21,20.7,0,-1,-1,6,-1,-2,-3,3
"7967",2020-01-01,"Gothic Rd","w1920","Motorized",1,"Wed","weekday","sled","2","1","1",5.6,0,27,-1,21,20.7,0,-1,-1,6,-1,-2,-3,3
"7968",2020-01-01,"Gothic Rd","w1920","Hybrid",0,"Wed","weekday","sled","2","1","1",5.6,0,27,-1,21,20.7,0,-1,-1,6,-1,-2,-3,3
"7969",2020-01-02,"Gothic Rd","w1920","Non.motorized",33,"Thu","weekday","no_sled","3","3","2",5.9,0.3,29,2,16,20.3,-1,0,-1,-1,1,1,0,-1
"7970",2020-01-02,"Gothic Rd","w1920","Mechanized",1,"Thu","weekday","no_sled","3","3","2",5.9,0.3,29,2,16,20.3,-1,0,-1,-1,1,1,0,-1
"7971",2020-01-02,"Gothic Rd","w1920","Motorized",3,"Thu","weekday","sled","3","3","2",5.9,0.3,29,2,16,20.3,-1,0,-1,-1,1,1,0,-1
"7972",2020-01-02,"Gothic Rd","w1920","Hybrid",0,"Thu","weekday","sled","3","3","2",5.9,0.3,29,2,16,20.3,-1,0,-1,-1,1,1,0,-1
"7973",2020-01-03,"Gothic Rd","w1920","Non.motorized",36,"Fri","weekday","no_sled","3","2","1",5.9,0,31,2,19,19,2,-1,0,-1,4,3,3,2
"7974",2020-01-03,"Gothic Rd","w1920","Mechanized",5,"Fri","weekday","no_sled","3","2","1",5.9,0,31,2,19,19,2,-1,0,-1,4,3,3,2
"7975",2020-01-03,"Gothic Rd","w1920","Motorized",0,"Fri","weekday","sled","3","2","1",5.9,0,31,2,19,19,2,-1,0,-1,4,3,3,2
"7976",2020-01-03,"Gothic Rd","w1920","Hybrid",0,"Fri","weekday","sled","3","2","1",5.9,0,31,2,19,19,2,-1,0,-1,4,3,3,2
"7977",2020-01-04,"Gothic Rd","w1920","Non.motorized",34,"Sat","weekend","no_sled","2","2","1",5.9,0,30,-1,26,19.7,2,2,-1,0,1,3,2,2
"7978",2020-01-04,"Gothic Rd","w1920","Mechanized",7,"Sat","weekend","no_sled","2","2","1",5.9,0,30,-1,26,19.7,2,2,-1,0,1,3,2,2
"7979",2020-01-04,"Gothic Rd","w1920","Motorized",1,"Sat","weekend","sled","2","2","1",5.9,0,30,-1,26,19.7,2,2,-1,0,1,3,2,2
"7980",2020-01-04,"Gothic Rd","w1920","Hybrid",0,"Sat","weekend","sled","2","2","1",5.9,0,30,-1,26,19.7,2,2,-1,0,1,3,2,2
"7981",2020-01-05,"Gothic Rd","w1920","Non.motorized",18,"Sun","weekend","no_sled","2","2","1",5.9,0,28,-2,23,21.1,-1,2,2,-1,-3,-1,1,0
"7982",2020-01-05,"Gothic Rd","w1920","Mechanized",3,"Sun","weekend","no_sled","2","2","1",5.9,0,28,-2,23,21.1,-1,2,2,-1,-3,-1,1,0
"7983",2020-01-05,"Gothic Rd","w1920","Motorized",0,"Sun","weekend","sled","2","2","1",5.9,0,28,-2,23,21.1,-1,2,2,-1,-3,-1,1,0
"7984",2020-01-05,"Gothic Rd","w1920","Hybrid",0,"Sun","weekend","sled","2","2","1",5.9,0,28,-2,23,21.1,-1,2,2,-1,-3,-1,1,0
"7985",2020-01-06,"Gothic Rd","w1920","Non.motorized",22,"Mon","weekday","no_sled","2","2","1",5.9,0,28,0,15,21.1,-2,-1,2,2,-2,-3,-1,1
"7986",2020-01-06,"Gothic Rd","w1920","Mechanized",1,"Mon","weekday","no_sled","2","2","1",5.9,0,28,0,15,21.1,-2,-1,2,2,-2,-3,-1,1
"7987",2020-01-06,"Gothic Rd","w1920","Motorized",2,"Mon","weekday","sled","2","2","1",5.9,0,28,0,15,21.1,-2,-1,2,2,-2,-3,-1,1
"7988",2020-01-06,"Gothic Rd","w1920","Hybrid",0,"Mon","weekday","sled","2","2","1",5.9,0,28,0,15,21.1,-2,-1,2,2,-2,-3,-1,1
"7989",2020-01-07,"Gothic Rd","w1920","Non.motorized",16,"Tue","weekday","no_sled","2","1","1",5.9,0,28,0,22,21.1,0,-2,-1,2,0,-2,-3,-1
"7990",2020-01-07,"Gothic Rd","w1920","Mechanized",4,"Tue","weekday","no_sled","2","1","1",5.9,0,28,0,22,21.1,0,-2,-1,2,0,-2,-3,-1
"7991",2020-01-07,"Gothic Rd","w1920","Motorized",0,"Tue","weekday","sled","2","1","1",5.9,0,28,0,22,21.1,0,-2,-1,2,0,-2,-3,-1
"7992",2020-01-07,"Gothic Rd","w1920","Hybrid",0,"Tue","weekday","sled","2","1","1",5.9,0,28,0,22,21.1,0,-2,-1,2,0,-2,-3,-1
"7993",2020-01-08,"Gothic Rd","w1920","Non.motorized",21,"Wed","weekday","no_sled","2","1","1",6,0.1,28,0,23,21.4,0,0,-2,-1,0,0,-2,-3
"7994",2020-01-08,"Gothic Rd","w1920","Mechanized",0,"Wed","weekday","no_sled","2","1","1",6,0.1,28,0,23,21.4,0,0,-2,-1,0,0,-2,-3
"7995",2020-01-08,"Gothic Rd","w1920","Motorized",0,"Wed","weekday","sled","2","1","1",6,0.1,28,0,23,21.4,0,0,-2,-1,0,0,-2,-3
"7996",2020-01-08,"Gothic Rd","w1920","Hybrid",0,"Wed","weekday","sled","2","1","1",6,0.1,28,0,23,21.4,0,0,-2,-1,0,0,-2,-3
"7997",2020-01-09,"Gothic Rd","w1920","Non.motorized",19,"Thu","weekday","no_sled","2","1","1",6,0,27,-1,17,22.2,0,0,0,-2,-1,-1,-1,-3
"7998",2020-01-09,"Gothic Rd","w1920","Mechanized",0,"Thu","weekday","no_sled","2","1","1",6,0,27,-1,17,22.2,0,0,0,-2,-1,-1,-1,-3
"7999",2020-01-09,"Gothic Rd","w1920","Motorized",1,"Thu","weekday","sled","2","1","1",6,0,27,-1,17,22.2,0,0,0,-2,-1,-1,-1,-3
"8000",2020-01-09,"Gothic Rd","w1920","Hybrid",0,"Thu","weekday","sled","2","1","1",6,0,27,-1,17,22.2,0,0,0,-2,-1,-1,-1,-3
"8001",2020-01-10,"Gothic Rd","w1920","Non.motorized",36,"Fri","weekday","no_sled","2","1","1",6,0,29,2,11,20.7,-1,0,0,0,1,1,1,1
"8002",2020-01-10,"Gothic Rd","w1920","Mechanized",2,"Fri","weekday","no_sled","2","1","1",6,0,29,2,11,20.7,-1,0,0,0,1,1,1,1
"8003",2020-01-10,"Gothic Rd","w1920","Motorized",3,"Fri","weekday","sled","2","1","1",6,0,29,2,11,20.7,-1,0,0,0,1,1,1,1
"8004",2020-01-10,"Gothic Rd","w1920","Hybrid",0,"Fri","weekday","sled","2","1","1",6,0,29,2,11,20.7,-1,0,0,0,1,1,1,1
"8005",2020-01-11,"Gothic Rd","w1920","Non.motorized",22,"Sat","weekend","no_sled","2","1","1",6,0,29,0,12,20.7,2,-1,0,0,2,1,1,1
"8006",2020-01-11,"Gothic Rd","w1920","Mechanized",1,"Sat","weekend","no_sled","2","1","1",6,0,29,0,12,20.7,2,-1,0,0,2,1,1,1
"8007",2020-01-11,"Gothic Rd","w1920","Motorized",1,"Sat","weekend","sled","2","1","1",6,0,29,0,12,20.7,2,-1,0,0,2,1,1,1
"8008",2020-01-11,"Gothic Rd","w1920","Hybrid",0,"Sat","weekend","sled","2","1","1",6,0,29,0,12,20.7,2,-1,0,0,2,1,1,1
"8009",2020-01-12,"Gothic Rd","w1920","Non.motorized",26,"Sun","weekend","no_sled","2","1","1",6.1,0.1,29,0,13,21,0,2,-1,0,0,2,1,1
"8010",2020-01-12,"Gothic Rd","w1920","Mechanized",0,"Sun","weekend","no_sled","2","1","1",6.1,0.1,29,0,13,21,0,2,-1,0,0,2,1,1
"8011",2020-01-12,"Gothic Rd","w1920","Motorized",0,"Sun","weekend","sled","2","1","1",6.1,0.1,29,0,13,21,0,2,-1,0,0,2,1,1
"8012",2020-01-12,"Gothic Rd","w1920","Hybrid",0,"Sun","weekend","sled","2","1","1",6.1,0.1,29,0,13,21,0,2,-1,0,0,2,1,1
"8013",2020-01-13,"Gothic Rd","w1920","Non.motorized",4,"Mon","weekday","no_sled","2","2","1",6.2,0.1,29,0,16,21.4,0,0,2,-1,0,0,2,1
"8014",2020-01-13,"Gothic Rd","w1920","Mechanized",0,"Mon","weekday","no_sled","2","2","1",6.2,0.1,29,0,16,21.4,0,0,2,-1,0,0,2,1
"8015",2020-01-13,"Gothic Rd","w1920","Motorized",0,"Mon","weekday","sled","2","2","1",6.2,0.1,29,0,16,21.4,0,0,2,-1,0,0,2,1
"8016",2020-01-13,"Gothic Rd","w1920","Hybrid",0,"Mon","weekday","sled","2","2","1",6.2,0.1,29,0,16,21.4,0,0,2,-1,0,0,2,1
"8017",2020-01-14,"Gothic Rd","w1920","Non.motorized",9,"Tue","weekday","no_sled","3","2","1",6.6,0.4,34,5,23,19.4,0,0,0,2,5,5,5,7
"8018",2020-01-14,"Gothic Rd","w1920","Mechanized",0,"Tue","weekday","no_sled","3","2","1",6.6,0.4,34,5,23,19.4,0,0,0,2,5,5,5,7
"8019",2020-01-14,"Gothic Rd","w1920","Motorized",0,"Tue","weekday","sled","3","2","1",6.6,0.4,34,5,23,19.4,0,0,0,2,5,5,5,7
"8020",2020-01-14,"Gothic Rd","w1920","Hybrid",0,"Tue","weekday","sled","3","2","1",6.6,0.4,34,5,23,19.4,0,0,0,2,5,5,5,7
"8021",2020-01-15,"Gothic Rd","w1920","Non.motorized",21,"Wed","weekday","no_sled","3","2","1",6.7,0.1,32,-2,23,20.9,5,0,0,0,3,3,3,3
"8022",2020-01-15,"Gothic Rd","w1920","Mechanized",1,"Wed","weekday","no_sled","3","2","1",6.7,0.1,32,-2,23,20.9,5,0,0,0,3,3,3,3
"8023",2020-01-15,"Gothic Rd","w1920","Motorized",2,"Wed","weekday","sled","3","2","1",6.7,0.1,32,-2,23,20.9,5,0,0,0,3,3,3,3
"8024",2020-01-15,"Gothic Rd","w1920","Hybrid",0,"Wed","weekday","sled","3","2","1",6.7,0.1,32,-2,23,20.9,5,0,0,0,3,3,3,3
"8025",2020-01-16,"Gothic Rd","w1920","Non.motorized",17,"Thu","weekday","no_sled","2","2","1",6.7,0,31,-1,28,21.6,-2,5,0,0,-3,2,2,2
"8026",2020-01-16,"Gothic Rd","w1920","Mechanized",0,"Thu","weekday","no_sled","2","2","1",6.7,0,31,-1,28,21.6,-2,5,0,0,-3,2,2,2
"8027",2020-01-16,"Gothic Rd","w1920","Motorized",0,"Thu","weekday","sled","2","2","1",6.7,0,31,-1,28,21.6,-2,5,0,0,-3,2,2,2
"8028",2020-01-16,"Gothic Rd","w1920","Hybrid",0,"Thu","weekday","sled","2","2","1",6.7,0,31,-1,28,21.6,-2,5,0,0,-3,2,2,2
"8029",2020-01-17,"Gothic Rd","w1920","Non.motorized",5,"Fri","weekday","no_sled","2","2","1",6.8,0.1,29,-2,19,23.4,-1,-2,5,0,-3,-5,0,0
"8030",2020-01-17,"Gothic Rd","w1920","Mechanized",0,"Fri","weekday","no_sled","2","2","1",6.8,0.1,29,-2,19,23.4,-1,-2,5,0,-3,-5,0,0
"8031",2020-01-17,"Gothic Rd","w1920","Motorized",0,"Fri","weekday","sled","2","2","1",6.8,0.1,29,-2,19,23.4,-1,-2,5,0,-3,-5,0,0
"8032",2020-01-17,"Gothic Rd","w1920","Hybrid",0,"Fri","weekday","sled","2","2","1",6.8,0.1,29,-2,19,23.4,-1,-2,5,0,-3,-5,0,0
"8033",2020-01-18,"Gothic Rd","w1920","Non.motorized",20,"Sat","weekend","no_sled","2","2","2",7,0.2,34,5,16,20.6,-2,-1,-2,5,3,2,0,5
"8034",2020-01-18,"Gothic Rd","w1920","Mechanized",0,"Sat","weekend","no_sled","2","2","2",7,0.2,34,5,16,20.6,-2,-1,-2,5,3,2,0,5
"8035",2020-01-18,"Gothic Rd","w1920","Motorized",0,"Sat","weekend","sled","2","2","2",7,0.2,34,5,16,20.6,-2,-1,-2,5,3,2,0,5
"8036",2020-01-18,"Gothic Rd","w1920","Hybrid",0,"Sat","weekend","sled","2","2","2",7,0.2,34,5,16,20.6,-2,-1,-2,5,3,2,0,5
"8037",2020-01-19,"Gothic Rd","w1920","Non.motorized",21,"Sun","weekend","no_sled","2","2","1",7,0,33,-1,21,21.2,5,-2,-1,-2,4,2,1,-1
"8038",2020-01-19,"Gothic Rd","w1920","Mechanized",1,"Sun","weekend","no_sled","2","2","1",7,0,33,-1,21,21.2,5,-2,-1,-2,4,2,1,-1
"8039",2020-01-19,"Gothic Rd","w1920","Motorized",1,"Sun","weekend","sled","2","2","1",7,0,33,-1,21,21.2,5,-2,-1,-2,4,2,1,-1
"8040",2020-01-19,"Gothic Rd","w1920","Hybrid",0,"Sun","weekend","sled","2","2","1",7,0,33,-1,21,21.2,5,-2,-1,-2,4,2,1,-1
"8041",2020-01-20,"Gothic Rd","w1920","Non.motorized",9,"Mon","weekday","no_sled","2","2","1",7.1,0.1,32,-1,25,22.2,-1,5,-2,-1,-2,3,1,0
"8042",2020-01-20,"Gothic Rd","w1920","Mechanized",1,"Mon","weekday","no_sled","2","2","1",7.1,0.1,32,-1,25,22.2,-1,5,-2,-1,-2,3,1,0
"8043",2020-01-20,"Gothic Rd","w1920","Motorized",0,"Mon","weekday","sled","2","2","1",7.1,0.1,32,-1,25,22.2,-1,5,-2,-1,-2,3,1,0
"8044",2020-01-20,"Gothic Rd","w1920","Hybrid",0,"Mon","weekday","sled","2","2","1",7.1,0.1,32,-1,25,22.2,-1,5,-2,-1,-2,3,1,0
"8045",2020-01-21,"Gothic Rd","w1920","Non.motorized",4,"Tue","weekday","no_sled","2","2","1",7.1,0,31,-1,28,22.9,-1,-1,5,-2,-2,-3,2,0
"8046",2020-01-21,"Gothic Rd","w1920","Mechanized",0,"Tue","weekday","no_sled","2","2","1",7.1,0,31,-1,28,22.9,-1,-1,5,-2,-2,-3,2,0
"8047",2020-01-21,"Gothic Rd","w1920","Motorized",0,"Tue","weekday","sled","2","2","1",7.1,0,31,-1,28,22.9,-1,-1,5,-2,-2,-3,2,0
"8048",2020-01-21,"Gothic Rd","w1920","Hybrid",0,"Tue","weekday","sled","2","2","1",7.1,0,31,-1,28,22.9,-1,-1,5,-2,-2,-3,2,0
"8049",2020-01-22,"Gothic Rd","w1920","Non.motorized",10,"Wed","weekday","no_sled","2","2","2",7.3,0.2,32,1,25,22.8,-1,-1,-1,5,0,-1,-2,3
"8050",2020-01-22,"Gothic Rd","w1920","Mechanized",0,"Wed","weekday","no_sled","2","2","2",7.3,0.2,32,1,25,22.8,-1,-1,-1,5,0,-1,-2,3
"8051",2020-01-22,"Gothic Rd","w1920","Motorized",1,"Wed","weekday","sled","2","2","2",7.3,0.2,32,1,25,22.8,-1,-1,-1,5,0,-1,-2,3
"8052",2020-01-22,"Gothic Rd","w1920","Hybrid",0,"Wed","weekday","sled","2","2","2",7.3,0.2,32,1,25,22.8,-1,-1,-1,5,0,-1,-2,3
"8053",2020-01-23,"Gothic Rd","w1920","Non.motorized",5,"Thu","weekday","no_sled","3","2","2",7.3,0,34,2,23,21.5,1,-1,-1,-1,3,2,1,0
"8054",2020-01-23,"Gothic Rd","w1920","Mechanized",1,"Thu","weekday","no_sled","3","2","2",7.3,0,34,2,23,21.5,1,-1,-1,-1,3,2,1,0
"8055",2020-01-23,"Gothic Rd","w1920","Motorized",2,"Thu","weekday","sled","3","2","2",7.3,0,34,2,23,21.5,1,-1,-1,-1,3,2,1,0
"8056",2020-01-23,"Gothic Rd","w1920","Hybrid",0,"Thu","weekday","sled","3","2","2",7.3,0,34,2,23,21.5,1,-1,-1,-1,3,2,1,0
"8057",2020-01-24,"Gothic Rd","w1920","Non.motorized",26,"Fri","weekday","no_sled","2","2","1",7.3,0,33,-1,23,22.1,2,1,-1,-1,1,2,1,0
"8058",2020-01-24,"Gothic Rd","w1920","Mechanized",2,"Fri","weekday","no_sled","2","2","1",7.3,0,33,-1,23,22.1,2,1,-1,-1,1,2,1,0
"8059",2020-01-24,"Gothic Rd","w1920","Motorized",0,"Fri","weekday","sled","2","2","1",7.3,0,33,-1,23,22.1,2,1,-1,-1,1,2,1,0
"8060",2020-01-24,"Gothic Rd","w1920","Hybrid",0,"Fri","weekday","sled","2","2","1",7.3,0,33,-1,23,22.1,2,1,-1,-1,1,2,1,0
"8061",2020-01-25,"Gothic Rd","w1920","Non.motorized",23,"Sat","weekend","no_sled","2","2","1",7.4,0.1,32,-1,25,23.1,-1,2,1,-1,-2,0,1,0
"8062",2020-01-25,"Gothic Rd","w1920","Mechanized",1,"Sat","weekend","no_sled","2","2","1",7.4,0.1,32,-1,25,23.1,-1,2,1,-1,-2,0,1,0
"8063",2020-01-25,"Gothic Rd","w1920","Motorized",0,"Sat","weekend","sled","2","2","1",7.4,0.1,32,-1,25,23.1,-1,2,1,-1,-2,0,1,0
"8064",2020-01-25,"Gothic Rd","w1920","Hybrid",0,"Sat","weekend","sled","2","2","1",7.4,0.1,32,-1,25,23.1,-1,2,1,-1,-2,0,1,0
"8065",2020-01-26,"Gothic Rd","w1920","Non.motorized",20,"Sun","weekend","no_sled","2","1","1",7.4,0,32,0,28,23.1,-1,-1,2,1,-1,-2,0,1
"8066",2020-01-26,"Gothic Rd","w1920","Mechanized",1,"Sun","weekend","no_sled","2","1","1",7.4,0,32,0,28,23.1,-1,-1,2,1,-1,-2,0,1
"8067",2020-01-26,"Gothic Rd","w1920","Motorized",0,"Sun","weekend","sled","2","1","1",7.4,0,32,0,28,23.1,-1,-1,2,1,-1,-2,0,1
"8068",2020-01-26,"Gothic Rd","w1920","Hybrid",0,"Sun","weekend","sled","2","1","1",7.4,0,32,0,28,23.1,-1,-1,2,1,-1,-2,0,1
"8069",2020-01-27,"Gothic Rd","w1920","Non.motorized",14,"Mon","weekday","no_sled","2","1","1",7.4,0,32,0,24,23.1,0,-1,-1,2,0,-1,-2,0
"8070",2020-01-27,"Gothic Rd","w1920","Mechanized",0,"Mon","weekday","no_sled","2","1","1",7.4,0,32,0,24,23.1,0,-1,-1,2,0,-1,-2,0
"8071",2020-01-27,"Gothic Rd","w1920","Motorized",2,"Mon","weekday","sled","2","1","1",7.4,0,32,0,24,23.1,0,-1,-1,2,0,-1,-2,0
"8072",2020-01-27,"Gothic Rd","w1920","Hybrid",0,"Mon","weekday","sled","2","1","1",7.4,0,32,0,24,23.1,0,-1,-1,2,0,-1,-2,0
"8073",2020-01-28,"Gothic Rd","w1920","Non.motorized",16,"Tue","weekday","no_sled","3","2","2",7.4,0,32,0,19,23.1,0,0,-1,-1,0,0,-1,-2
"8074",2020-01-28,"Gothic Rd","w1920","Mechanized",1,"Tue","weekday","no_sled","3","2","2",7.4,0,32,0,19,23.1,0,0,-1,-1,0,0,-1,-2
"8075",2020-01-28,"Gothic Rd","w1920","Motorized",0,"Tue","weekday","sled","3","2","2",7.4,0,32,0,19,23.1,0,0,-1,-1,0,0,-1,-2
"8076",2020-01-28,"Gothic Rd","w1920","Hybrid",0,"Tue","weekday","sled","3","2","2",7.4,0,32,0,19,23.1,0,0,-1,-1,0,0,-1,-2
"8077",2020-01-29,"Gothic Rd","w1920","Non.motorized",4,"Wed","weekday","no_sled","2","2","1",7.4,0,31,-1,20,23.9,0,0,0,-1,-1,-1,-1,-2
"8078",2020-01-29,"Gothic Rd","w1920","Mechanized",0,"Wed","weekday","no_sled","2","2","1",7.4,0,31,-1,20,23.9,0,0,0,-1,-1,-1,-1,-2
"8079",2020-01-29,"Gothic Rd","w1920","Motorized",0,"Wed","weekday","sled","2","2","1",7.4,0,31,-1,20,23.9,0,0,0,-1,-1,-1,-1,-2
"8080",2020-01-29,"Gothic Rd","w1920","Hybrid",0,"Wed","weekday","sled","2","2","1",7.4,0,31,-1,20,23.9,0,0,0,-1,-1,-1,-1,-2
"8081",2020-01-30,"Gothic Rd","w1920","Non.motorized",11,"Thu","weekday","no_sled","2","2","1",7.4,0,31,0,17,23.9,-1,0,0,0,-1,-1,-1,-1
"8082",2020-01-30,"Gothic Rd","w1920","Mechanized",1,"Thu","weekday","no_sled","2","2","1",7.4,0,31,0,17,23.9,-1,0,0,0,-1,-1,-1,-1
"8083",2020-01-30,"Gothic Rd","w1920","Motorized",0,"Thu","weekday","sled","2","2","1",7.4,0,31,0,17,23.9,-1,0,0,0,-1,-1,-1,-1
"8084",2020-01-30,"Gothic Rd","w1920","Hybrid",0,"Thu","weekday","sled","2","2","1",7.4,0,31,0,17,23.9,-1,0,0,0,-1,-1,-1,-1
"8085",2020-01-31,"Gothic Rd","w1920","Non.motorized",27,"Fri","weekday","no_sled","2","1","1",7.4,0,31,0,20,23.9,0,-1,0,0,0,-1,-1,-1
"8086",2020-01-31,"Gothic Rd","w1920","Mechanized",2,"Fri","weekday","no_sled","2","1","1",7.4,0,31,0,20,23.9,0,-1,0,0,0,-1,-1,-1
"8087",2020-01-31,"Gothic Rd","w1920","Motorized",0,"Fri","weekday","sled","2","1","1",7.4,0,31,0,20,23.9,0,-1,0,0,0,-1,-1,-1
"8088",2020-01-31,"Gothic Rd","w1920","Hybrid",0,"Fri","weekday","sled","2","1","1",7.4,0,31,0,20,23.9,0,-1,0,0,0,-1,-1,-1
"8089",2020-02-01,"Gothic Rd","w1920","Non.motorized",15,"Sat","weekend","no_sled","2","1","1",7.4,0,31,0,28,23.9,0,0,-1,0,0,0,-1,-1
"8090",2020-02-01,"Gothic Rd","w1920","Mechanized",5,"Sat","weekend","no_sled","2","1","1",7.4,0,31,0,28,23.9,0,0,-1,0,0,0,-1,-1
"8091",2020-02-01,"Gothic Rd","w1920","Motorized",0,"Sat","weekend","sled","2","1","1",7.4,0,31,0,28,23.9,0,0,-1,0,0,0,-1,-1
"8092",2020-02-01,"Gothic Rd","w1920","Hybrid",0,"Sat","weekend","sled","2","1","1",7.4,0,31,0,28,23.9,0,0,-1,0,0,0,-1,-1
"8093",2020-02-02,"Gothic Rd","w1920","Non.motorized",27,"Sun","weekend","no_sled","1","1","1",7.4,0,31,0,33,23.9,0,0,0,-1,0,0,0,-1
"8094",2020-02-02,"Gothic Rd","w1920","Mechanized",4,"Sun","weekend","no_sled","1","1","1",7.4,0,31,0,33,23.9,0,0,0,-1,0,0,0,-1
"8095",2020-02-02,"Gothic Rd","w1920","Motorized",0,"Sun","weekend","sled","1","1","1",7.4,0,31,0,33,23.9,0,0,0,-1,0,0,0,-1
"8096",2020-02-02,"Gothic Rd","w1920","Hybrid",0,"Sun","weekend","sled","1","1","1",7.4,0,31,0,33,23.9,0,0,0,-1,0,0,0,-1
"8097",2020-02-03,"Gothic Rd","w1920","Non.motorized",8,"Mon","weekday","no_sled","2","2","1",7.4,0,31,0,24,23.9,0,0,0,0,0,0,0,0
"8098",2020-02-03,"Gothic Rd","w1920","Mechanized",0,"Mon","weekday","no_sled","2","2","1",7.4,0,31,0,24,23.9,0,0,0,0,0,0,0,0
"8099",2020-02-03,"Gothic Rd","w1920","Motorized",0,"Mon","weekday","sled","2","2","1",7.4,0,31,0,24,23.9,0,0,0,0,0,0,0,0
"8100",2020-02-03,"Gothic Rd","w1920","Hybrid",0,"Mon","weekday","sled","2","2","1",7.4,0,31,0,24,23.9,0,0,0,0,0,0,0,0
"8101",2020-02-04,"Gothic Rd","w1920","Non.motorized",21,"Tue","weekday","no_sled","2","2","2",7.4,0,33,2,5,22.4,0,0,0,0,2,2,2,2
"8102",2020-02-04,"Gothic Rd","w1920","Mechanized",3,"Tue","weekday","no_sled","2","2","2",7.4,0,33,2,5,22.4,0,0,0,0,2,2,2,2
"8103",2020-02-04,"Gothic Rd","w1920","Motorized",1,"Tue","weekday","sled","2","2","2",7.4,0,33,2,5,22.4,0,0,0,0,2,2,2,2
"8104",2020-02-04,"Gothic Rd","w1920","Hybrid",0,"Tue","weekday","sled","2","2","2",7.4,0,33,2,5,22.4,0,0,0,0,2,2,2,2
"8105",2020-02-05,"Gothic Rd","w1920","Non.motorized",10,"Wed","weekday","no_sled","2","2","1",7.4,0,33,0,2,22.4,2,0,0,0,2,2,2,2
"8106",2020-02-05,"Gothic Rd","w1920","Mechanized",0,"Wed","weekday","no_sled","2","2","1",7.4,0,33,0,2,22.4,2,0,0,0,2,2,2,2
"8107",2020-02-05,"Gothic Rd","w1920","Motorized",0,"Wed","weekday","sled","2","2","1",7.4,0,33,0,2,22.4,2,0,0,0,2,2,2,2
"8108",2020-02-05,"Gothic Rd","w1920","Hybrid",0,"Wed","weekday","sled","2","2","1",7.4,0,33,0,2,22.4,2,0,0,0,2,2,2,2
"8109",2020-02-06,"Gothic Rd","w1920","Non.motorized",9,"Thu","weekday","no_sled","2","2","1",7.5,0.1,32,-1,16,23.4,0,2,0,0,-1,1,1,1
"8110",2020-02-06,"Gothic Rd","w1920","Mechanized",0,"Thu","weekday","no_sled","2","2","1",7.5,0.1,32,-1,16,23.4,0,2,0,0,-1,1,1,1
"8111",2020-02-06,"Gothic Rd","w1920","Motorized",1,"Thu","weekday","sled","2","2","1",7.5,0.1,32,-1,16,23.4,0,2,0,0,-1,1,1,1
"8112",2020-02-06,"Gothic Rd","w1920","Hybrid",0,"Thu","weekday","sled","2","2","1",7.5,0.1,32,-1,16,23.4,0,2,0,0,-1,1,1,1
"8113",2020-02-07,"Gothic Rd","w1920","Non.motorized",6,"Fri","weekday","no_sled","3","3","3",7.9,0.4,37,5,26,21.4,-1,0,2,0,4,4,6,6
"8114",2020-02-07,"Gothic Rd","w1920","Mechanized",0,"Fri","weekday","no_sled","3","3","3",7.9,0.4,37,5,26,21.4,-1,0,2,0,4,4,6,6
"8115",2020-02-07,"Gothic Rd","w1920","Motorized",3,"Fri","weekday","sled","3","3","3",7.9,0.4,37,5,26,21.4,-1,0,2,0,4,4,6,6
"8116",2020-02-07,"Gothic Rd","w1920","Hybrid",0,"Fri","weekday","sled","3","3","3",7.9,0.4,37,5,26,21.4,-1,0,2,0,4,4,6,6
"8117",2020-02-08,"Gothic Rd","w1920","Non.motorized",20,"Sat","weekend","no_sled","3","3","2",8.3,0.4,39,2,30,21.3,5,-1,0,2,7,6,6,8
"8118",2020-02-08,"Gothic Rd","w1920","Mechanized",2,"Sat","weekend","no_sled","3","3","2",8.3,0.4,39,2,30,21.3,5,-1,0,2,7,6,6,8
"8119",2020-02-08,"Gothic Rd","w1920","Motorized",3,"Sat","weekend","sled","3","3","2",8.3,0.4,39,2,30,21.3,5,-1,0,2,7,6,6,8
"8120",2020-02-08,"Gothic Rd","w1920","Hybrid",0,"Sat","weekend","sled","3","3","2",8.3,0.4,39,2,30,21.3,5,-1,0,2,7,6,6,8
"8121",2020-02-09,"Gothic Rd","w1920","Non.motorized",7,"Sun","weekend","no_sled","3","2","2",8.4,0.1,38,-1,26,22.1,2,5,-1,0,1,6,5,5
"8122",2020-02-09,"Gothic Rd","w1920","Mechanized",1,"Sun","weekend","no_sled","3","2","2",8.4,0.1,38,-1,26,22.1,2,5,-1,0,1,6,5,5
"8123",2020-02-09,"Gothic Rd","w1920","Motorized",3,"Sun","weekend","sled","3","2","2",8.4,0.1,38,-1,26,22.1,2,5,-1,0,1,6,5,5
"8124",2020-02-09,"Gothic Rd","w1920","Hybrid",0,"Sun","weekend","sled","3","2","2",8.4,0.1,38,-1,26,22.1,2,5,-1,0,1,6,5,5
"8125",2020-02-10,"Gothic Rd","w1920","Non.motorized",19,"Mon","weekday","no_sled","2","2","1",8.4,0,38,0,22,22.1,-1,2,5,-1,-1,1,6,5
"8126",2020-02-10,"Gothic Rd","w1920","Mechanized",1,"Mon","weekday","no_sled","2","2","1",8.4,0,38,0,22,22.1,-1,2,5,-1,-1,1,6,5
"8127",2020-02-10,"Gothic Rd","w1920","Motorized",1,"Mon","weekday","sled","2","2","1",8.4,0,38,0,22,22.1,-1,2,5,-1,-1,1,6,5
"8128",2020-02-10,"Gothic Rd","w1920","Hybrid",0,"Mon","weekday","sled","2","2","1",8.4,0,38,0,22,22.1,-1,2,5,-1,-1,1,6,5
"8129",2020-02-11,"Gothic Rd","w1920","Non.motorized",15,"Tue","weekday","no_sled","2","2","2",8.5,0.1,40,2,16,21.2,0,-1,2,5,2,1,3,8
"8130",2020-02-11,"Gothic Rd","w1920","Mechanized",0,"Tue","weekday","no_sled","2","2","2",8.5,0.1,40,2,16,21.2,0,-1,2,5,2,1,3,8
"8131",2020-02-11,"Gothic Rd","w1920","Motorized",2,"Tue","weekday","sled","2","2","2",8.5,0.1,40,2,16,21.2,0,-1,2,5,2,1,3,8
"8132",2020-02-11,"Gothic Rd","w1920","Hybrid",0,"Tue","weekday","sled","2","2","2",8.5,0.1,40,2,16,21.2,0,-1,2,5,2,1,3,8
"8133",2020-02-12,"Gothic Rd","w1920","Non.motorized",10,"Wed","weekday","no_sled","2","2","2",8.5,0,39,-1,15,21.8,2,0,-1,2,1,1,0,2
"8134",2020-02-12,"Gothic Rd","w1920","Mechanized",1,"Wed","weekday","no_sled","2","2","2",8.5,0,39,-1,15,21.8,2,0,-1,2,1,1,0,2
"8135",2020-02-12,"Gothic Rd","w1920","Motorized",1,"Wed","weekday","sled","2","2","2",8.5,0,39,-1,15,21.8,2,0,-1,2,1,1,0,2
"8136",2020-02-12,"Gothic Rd","w1920","Hybrid",0,"Wed","weekday","sled","2","2","2",8.5,0,39,-1,15,21.8,2,0,-1,2,1,1,0,2
"8137",2020-02-13,"Gothic Rd","w1920","Non.motorized",8,"Thu","weekday","no_sled","2","2","1",8.5,0,39,0,18,21.8,-1,2,0,-1,-1,1,1,0
"8138",2020-02-13,"Gothic Rd","w1920","Mechanized",0,"Thu","weekday","no_sled","2","2","1",8.5,0,39,0,18,21.8,-1,2,0,-1,-1,1,1,0
"8139",2020-02-13,"Gothic Rd","w1920","Motorized",0,"Thu","weekday","sled","2","2","1",8.5,0,39,0,18,21.8,-1,2,0,-1,-1,1,1,0
"8140",2020-02-13,"Gothic Rd","w1920","Hybrid",0,"Thu","weekday","sled","2","2","1",8.5,0,39,0,18,21.8,-1,2,0,-1,-1,1,1,0
"8141",2020-02-14,"Gothic Rd","w1920","Non.motorized",21,"Fri","weekday","no_sled","2","1","1",8.6,0.1,38,-1,24,22.6,0,-1,2,0,-1,-2,0,0
"8142",2020-02-14,"Gothic Rd","w1920","Mechanized",2,"Fri","weekday","no_sled","2","1","1",8.6,0.1,38,-1,24,22.6,0,-1,2,0,-1,-2,0,0
"8143",2020-02-14,"Gothic Rd","w1920","Motorized",0,"Fri","weekday","sled","2","1","1",8.6,0.1,38,-1,24,22.6,0,-1,2,0,-1,-2,0,0
"8144",2020-02-14,"Gothic Rd","w1920","Hybrid",0,"Fri","weekday","sled","2","1","1",8.6,0.1,38,-1,24,22.6,0,-1,2,0,-1,-2,0,0
"8145",2020-02-15,"Gothic Rd","w1920","Non.motorized",45,"Sat","weekend","no_sled","1","1","1",8.6,0,38,0,26,22.6,-1,0,-1,2,-1,-1,-2,0
"8146",2020-02-15,"Gothic Rd","w1920","Mechanized",6,"Sat","weekend","no_sled","1","1","1",8.6,0,38,0,26,22.6,-1,0,-1,2,-1,-1,-2,0
"8147",2020-02-15,"Gothic Rd","w1920","Motorized",0,"Sat","weekend","sled","1","1","1",8.6,0,38,0,26,22.6,-1,0,-1,2,-1,-1,-2,0
"8148",2020-02-15,"Gothic Rd","w1920","Hybrid",0,"Sat","weekend","sled","1","1","1",8.6,0,38,0,26,22.6,-1,0,-1,2,-1,-1,-2,0
"8149",2020-02-16,"Gothic Rd","w1920","Non.motorized",27,"Sun","weekend","no_sled","1","1","1",8.8,0.2,37,-1,26,23.8,0,-1,0,-1,-1,-2,-2,-3
"8150",2020-02-16,"Gothic Rd","w1920","Mechanized",1,"Sun","weekend","no_sled","1","1","1",8.8,0.2,37,-1,26,23.8,0,-1,0,-1,-1,-2,-2,-3
"8151",2020-02-16,"Gothic Rd","w1920","Motorized",0,"Sun","weekend","sled","1","1","1",8.8,0.2,37,-1,26,23.8,0,-1,0,-1,-1,-2,-2,-3
"8152",2020-02-16,"Gothic Rd","w1920","Hybrid",0,"Sun","weekend","sled","1","1","1",8.8,0.2,37,-1,26,23.8,0,-1,0,-1,-1,-2,-2,-3
"8153",2020-02-17,"Gothic Rd","w1920","Non.motorized",42,"Mon","weekday","no_sled","2","1","1",9.2,0.4,43,6,25,21.4,-1,0,-1,0,5,5,4,4
"8154",2020-02-17,"Gothic Rd","w1920","Mechanized",1,"Mon","weekday","no_sled","2","1","1",9.2,0.4,43,6,25,21.4,-1,0,-1,0,5,5,4,4
"8155",2020-02-17,"Gothic Rd","w1920","Motorized",2,"Mon","weekday","sled","2","1","1",9.2,0.4,43,6,25,21.4,-1,0,-1,0,5,5,4,4
"8156",2020-02-17,"Gothic Rd","w1920","Hybrid",0,"Mon","weekday","sled","2","1","1",9.2,0.4,43,6,25,21.4,-1,0,-1,0,5,5,4,4
"8157",2020-02-18,"Gothic Rd","w1920","Non.motorized",23,"Tue","weekday","no_sled","1","1","1",9.3,0.1,42,-1,18,22.1,6,-1,0,-1,5,4,4,3
"8158",2020-02-18,"Gothic Rd","w1920","Mechanized",0,"Tue","weekday","no_sled","1","1","1",9.3,0.1,42,-1,18,22.1,6,-1,0,-1,5,4,4,3
"8159",2020-02-18,"Gothic Rd","w1920","Motorized",0,"Tue","weekday","sled","1","1","1",9.3,0.1,42,-1,18,22.1,6,-1,0,-1,5,4,4,3
"8160",2020-02-18,"Gothic Rd","w1920","Hybrid",0,"Tue","weekday","sled","1","1","1",9.3,0.1,42,-1,18,22.1,6,-1,0,-1,5,4,4,3
"8161",2020-02-19,"Gothic Rd","w1920","Non.motorized",31,"Wed","weekday","no_sled","1","1","1",9.3,0,41,-1,22,22.7,-1,6,-1,0,-2,4,3,3
"8162",2020-02-19,"Gothic Rd","w1920","Mechanized",2,"Wed","weekday","no_sled","1","1","1",9.3,0,41,-1,22,22.7,-1,6,-1,0,-2,4,3,3
"8163",2020-02-19,"Gothic Rd","w1920","Motorized",0,"Wed","weekday","sled","1","1","1",9.3,0,41,-1,22,22.7,-1,6,-1,0,-2,4,3,3
"8164",2020-02-19,"Gothic Rd","w1920","Hybrid",0,"Wed","weekday","sled","1","1","1",9.3,0,41,-1,22,22.7,-1,6,-1,0,-2,4,3,3
"8165",2020-02-20,"Gothic Rd","w1920","Non.motorized",16,"Thu","weekday","no_sled","1","1","1",9.3,0,41,0,18,22.7,-1,-1,6,-1,-1,-2,4,3
"8166",2020-02-20,"Gothic Rd","w1920","Mechanized",0,"Thu","weekday","no_sled","1","1","1",9.3,0,41,0,18,22.7,-1,-1,6,-1,-1,-2,4,3
"8167",2020-02-20,"Gothic Rd","w1920","Motorized",0,"Thu","weekday","sled","1","1","1",9.3,0,41,0,18,22.7,-1,-1,6,-1,-1,-2,4,3
"8168",2020-02-20,"Gothic Rd","w1920","Hybrid",0,"Thu","weekday","sled","1","1","1",9.3,0,41,0,18,22.7,-1,-1,6,-1,-1,-2,4,3
"8169",2020-02-21,"Gothic Rd","w1920","Non.motorized",33,"Fri","weekday","no_sled","1","1","1",9.3,0,40,-1,26,23.2,0,-1,-1,6,-1,-2,-3,3
"8170",2020-02-21,"Gothic Rd","w1920","Mechanized",0,"Fri","weekday","no_sled","1","1","1",9.3,0,40,-1,26,23.2,0,-1,-1,6,-1,-2,-3,3
"8171",2020-02-21,"Gothic Rd","w1920","Motorized",0,"Fri","weekday","sled","1","1","1",9.3,0,40,-1,26,23.2,0,-1,-1,6,-1,-2,-3,3
"8172",2020-02-21,"Gothic Rd","w1920","Hybrid",0,"Fri","weekday","sled","1","1","1",9.3,0,40,-1,26,23.2,0,-1,-1,6,-1,-2,-3,3
"8173",2020-02-22,"Gothic Rd","w1920","Non.motorized",NA,"Sat","weekend","no_sled","1","1","1",9.4,0.1,39,-1,32,24.1,-1,0,-1,-1,-2,-2,-3,-4
"8174",2020-02-22,"Gothic Rd","w1920","Mechanized",NA,"Sat","weekend","no_sled","1","1","1",9.4,0.1,39,-1,32,24.1,-1,0,-1,-1,-2,-2,-3,-4
"8175",2020-02-22,"Gothic Rd","w1920","Motorized",NA,"Sat","weekend","sled","1","1","1",9.4,0.1,39,-1,32,24.1,-1,0,-1,-1,-2,-2,-3,-4
"8176",2020-02-22,"Gothic Rd","w1920","Hybrid",NA,"Sat","weekend","sled","1","1","1",9.4,0.1,39,-1,32,24.1,-1,0,-1,-1,-2,-2,-3,-4
"8177",2020-02-23,"Gothic Rd","w1920","Non.motorized",NA,"Sun","weekend","no_sled","2","2","2",9.5,0.1,40,1,27,23.8,-1,-1,0,-1,0,-1,-1,-2
"8178",2020-02-23,"Gothic Rd","w1920","Mechanized",NA,"Sun","weekend","no_sled","2","2","2",9.5,0.1,40,1,27,23.8,-1,-1,0,-1,0,-1,-1,-2
"8179",2020-02-23,"Gothic Rd","w1920","Motorized",NA,"Sun","weekend","sled","2","2","2",9.5,0.1,40,1,27,23.8,-1,-1,0,-1,0,-1,-1,-2
"8180",2020-02-23,"Gothic Rd","w1920","Hybrid",NA,"Sun","weekend","sled","2","2","2",9.5,0.1,40,1,27,23.8,-1,-1,0,-1,0,-1,-1,-2
"8181",2020-02-24,"Gothic Rd","w1920","Non.motorized",NA,"Mon","weekday","no_sled","3","3","2",9.8,0.3,43,3,17,22.8,1,-1,-1,0,4,3,2,2
"8182",2020-02-24,"Gothic Rd","w1920","Mechanized",NA,"Mon","weekday","no_sled","3","3","2",9.8,0.3,43,3,17,22.8,1,-1,-1,0,4,3,2,2
"8183",2020-02-24,"Gothic Rd","w1920","Motorized",NA,"Mon","weekday","sled","3","3","2",9.8,0.3,43,3,17,22.8,1,-1,-1,0,4,3,2,2
"8184",2020-02-24,"Gothic Rd","w1920","Hybrid",NA,"Mon","weekday","sled","3","3","2",9.8,0.3,43,3,17,22.8,1,-1,-1,0,4,3,2,2
"8185",2020-02-25,"Gothic Rd","w1920","Non.motorized",NA,"Tue","weekday","no_sled","2","2","1",9.8,0,43,0,8,22.8,3,1,-1,-1,3,4,3,2
"8186",2020-02-25,"Gothic Rd","w1920","Mechanized",NA,"Tue","weekday","no_sled","2","2","1",9.8,0,43,0,8,22.8,3,1,-1,-1,3,4,3,2
"8187",2020-02-25,"Gothic Rd","w1920","Motorized",NA,"Tue","weekday","sled","2","2","1",9.8,0,43,0,8,22.8,3,1,-1,-1,3,4,3,2
"8188",2020-02-25,"Gothic Rd","w1920","Hybrid",NA,"Tue","weekday","sled","2","2","1",9.8,0,43,0,8,22.8,3,1,-1,-1,3,4,3,2
"8189",2020-02-26,"Gothic Rd","w1920","Non.motorized",NA,"Wed","weekday","no_sled","2","2","1",9.8,0,42,-1,15,23.3,0,3,1,-1,-1,2,3,2
"8190",2020-02-26,"Gothic Rd","w1920","Mechanized",NA,"Wed","weekday","no_sled","2","2","1",9.8,0,42,-1,15,23.3,0,3,1,-1,-1,2,3,2
"8191",2020-02-26,"Gothic Rd","w1920","Motorized",NA,"Wed","weekday","sled","2","2","1",9.8,0,42,-1,15,23.3,0,3,1,-1,-1,2,3,2
"8192",2020-02-26,"Gothic Rd","w1920","Hybrid",NA,"Wed","weekday","sled","2","2","1",9.8,0,42,-1,15,23.3,0,3,1,-1,-1,2,3,2
"8193",2020-02-27,"Gothic Rd","w1920","Non.motorized",17,"Thu","weekday","no_sled","2","2","1",9.9,0.1,41,-1,25,24.1,-1,0,3,1,-2,-2,1,2
"8194",2020-02-27,"Gothic Rd","w1920","Mechanized",4,"Thu","weekday","no_sled","2","2","1",9.9,0.1,41,-1,25,24.1,-1,0,3,1,-2,-2,1,2
"8195",2020-02-27,"Gothic Rd","w1920","Motorized",1,"Thu","weekday","sled","2","2","1",9.9,0.1,41,-1,25,24.1,-1,0,3,1,-2,-2,1,2
"8196",2020-02-27,"Gothic Rd","w1920","Hybrid",0,"Thu","weekday","sled","2","2","1",9.9,0.1,41,-1,25,24.1,-1,0,3,1,-2,-2,1,2
"8197",2020-02-28,"Gothic Rd","w1920","Non.motorized",34,"Fri","weekday","no_sled","2","1","1",9.9,0,41,0,28,24.1,-1,-1,0,3,-1,-2,-2,1
"8198",2020-02-28,"Gothic Rd","w1920","Mechanized",0,"Fri","weekday","no_sled","2","1","1",9.9,0,41,0,28,24.1,-1,-1,0,3,-1,-2,-2,1
"8199",2020-02-28,"Gothic Rd","w1920","Motorized",0,"Fri","weekday","sled","2","1","1",9.9,0,41,0,28,24.1,-1,-1,0,3,-1,-2,-2,1
"8200",2020-02-28,"Gothic Rd","w1920","Hybrid",0,"Fri","weekday","sled","2","1","1",9.9,0,41,0,28,24.1,-1,-1,0,3,-1,-2,-2,1
"8201",2020-02-29,"Gothic Rd","w1920","Non.motorized",54,"Sat","weekend","no_sled","1","1","1",9.9,0,40,-1,29,24.8,0,-1,-1,0,-1,-2,-3,-3
"8202",2020-02-29,"Gothic Rd","w1920","Mechanized",4,"Sat","weekend","no_sled","1","1","1",9.9,0,40,-1,29,24.8,0,-1,-1,0,-1,-2,-3,-3
"8203",2020-02-29,"Gothic Rd","w1920","Motorized",2,"Sat","weekend","sled","1","1","1",9.9,0,40,-1,29,24.8,0,-1,-1,0,-1,-2,-3,-3
"8204",2020-02-29,"Gothic Rd","w1920","Hybrid",0,"Sat","weekend","sled","1","1","1",9.9,0,40,-1,29,24.8,0,-1,-1,0,-1,-2,-3,-3
"8205",2020-03-01,"Gothic Rd","w1920","Non.motorized",27,"Sun","weekend","no_sled","1","1","1",10,0.1,40,0,28,25,-1,0,-1,-1,-1,-1,-2,-3
"8206",2020-03-01,"Gothic Rd","w1920","Mechanized",4,"Sun","weekend","no_sled","1","1","1",10,0.1,40,0,28,25,-1,0,-1,-1,-1,-1,-2,-3
"8207",2020-03-01,"Gothic Rd","w1920","Motorized",0,"Sun","weekend","sled","1","1","1",10,0.1,40,0,28,25,-1,0,-1,-1,-1,-1,-2,-3
"8208",2020-03-01,"Gothic Rd","w1920","Hybrid",0,"Sun","weekend","sled","1","1","1",10,0.1,40,0,28,25,-1,0,-1,-1,-1,-1,-2,-3
"8209",2020-03-02,"Gothic Rd","w1920","Non.motorized",27,"Mon","weekday","no_sled","2","2","1",10.4,0.4,45,5,25,23.1,0,-1,0,-1,5,4,4,3
"8210",2020-03-02,"Gothic Rd","w1920","Mechanized",0,"Mon","weekday","no_sled","2","2","1",10.4,0.4,45,5,25,23.1,0,-1,0,-1,5,4,4,3
"8211",2020-03-02,"Gothic Rd","w1920","Motorized",0,"Mon","weekday","sled","2","2","1",10.4,0.4,45,5,25,23.1,0,-1,0,-1,5,4,4,3
"8212",2020-03-02,"Gothic Rd","w1920","Hybrid",0,"Mon","weekday","sled","2","2","1",10.4,0.4,45,5,25,23.1,0,-1,0,-1,5,4,4,3
"8213",2020-03-03,"Gothic Rd","w1920","Non.motorized",9,"Tue","weekday","no_sled","2","1","1",10.9,0.5,50,5,25,21.8,5,0,-1,0,10,10,9,9
"8214",2020-03-03,"Gothic Rd","w1920","Mechanized",3,"Tue","weekday","no_sled","2","1","1",10.9,0.5,50,5,25,21.8,5,0,-1,0,10,10,9,9
"8215",2020-03-03,"Gothic Rd","w1920","Motorized",1,"Tue","weekday","sled","2","1","1",10.9,0.5,50,5,25,21.8,5,0,-1,0,10,10,9,9
"8216",2020-03-03,"Gothic Rd","w1920","Hybrid",0,"Tue","weekday","sled","2","1","1",10.9,0.5,50,5,25,21.8,5,0,-1,0,10,10,9,9
"8217",2020-03-04,"Gothic Rd","w1920","Non.motorized",22,"Wed","weekday","no_sled","2","1","1",10.9,0,48,-2,29,22.7,5,5,0,-1,3,8,8,7
"8218",2020-03-04,"Gothic Rd","w1920","Mechanized",0,"Wed","weekday","no_sled","2","1","1",10.9,0,48,-2,29,22.7,5,5,0,-1,3,8,8,7
"8219",2020-03-04,"Gothic Rd","w1920","Motorized",1,"Wed","weekday","sled","2","1","1",10.9,0,48,-2,29,22.7,5,5,0,-1,3,8,8,7
"8220",2020-03-04,"Gothic Rd","w1920","Hybrid",0,"Wed","weekday","sled","2","1","1",10.9,0,48,-2,29,22.7,5,5,0,-1,3,8,8,7
"8221",2020-03-05,"Gothic Rd","w1920","Non.motorized",12,"Thu","weekday","no_sled","2","1","1",10.9,0,46,-2,32,23.7,-2,5,5,0,-4,1,6,6
"8222",2020-03-05,"Gothic Rd","w1920","Mechanized",0,"Thu","weekday","no_sled","2","1","1",10.9,0,46,-2,32,23.7,-2,5,5,0,-4,1,6,6
"8223",2020-03-05,"Gothic Rd","w1920","Motorized",0,"Thu","weekday","sled","2","1","1",10.9,0,46,-2,32,23.7,-2,5,5,0,-4,1,6,6
"8224",2020-03-05,"Gothic Rd","w1920","Hybrid",0,"Thu","weekday","sled","2","1","1",10.9,0,46,-2,32,23.7,-2,5,5,0,-4,1,6,6
"8225",2020-03-06,"Gothic Rd","w1920","Non.motorized",17,"Fri","weekday","no_sled","1","1","1",10.9,0,45,-1,34,24.2,-2,-2,5,5,-3,-5,0,5
"8226",2020-03-06,"Gothic Rd","w1920","Mechanized",1,"Fri","weekday","no_sled","1","1","1",10.9,0,45,-1,34,24.2,-2,-2,5,5,-3,-5,0,5
"8227",2020-03-06,"Gothic Rd","w1920","Motorized",1,"Fri","weekday","sled","1","1","1",10.9,0,45,-1,34,24.2,-2,-2,5,5,-3,-5,0,5
"8228",2020-03-06,"Gothic Rd","w1920","Hybrid",0,"Fri","weekday","sled","1","1","1",10.9,0,45,-1,34,24.2,-2,-2,5,5,-3,-5,0,5
"8229",2020-03-07,"Gothic Rd","w1920","Non.motorized",16,"Sat","weekend","no_sled","1","1","2",10.9,0,44,-1,35,24.8,-1,-2,-2,5,-2,-4,-6,-1
"8230",2020-03-07,"Gothic Rd","w1920","Mechanized",5,"Sat","weekend","no_sled","1","1","2",10.9,0,44,-1,35,24.8,-1,-2,-2,5,-2,-4,-6,-1
"8231",2020-03-07,"Gothic Rd","w1920","Motorized",2,"Sat","weekend","sled","1","1","2",10.9,0,44,-1,35,24.8,-1,-2,-2,5,-2,-4,-6,-1
"8232",2020-03-07,"Gothic Rd","w1920","Hybrid",0,"Sat","weekend","sled","1","1","2",10.9,0,44,-1,35,24.8,-1,-2,-2,5,-2,-4,-6,-1
"8233",2020-03-08,"Gothic Rd","w1920","Non.motorized",20,"Sun","weekend","no_sled","1","1","1",11,0.1,43,-1,33,25.6,-1,-1,-2,-2,-2,-3,-5,-7
"8234",2020-03-08,"Gothic Rd","w1920","Mechanized",1,"Sun","weekend","no_sled","1","1","1",11,0.1,43,-1,33,25.6,-1,-1,-2,-2,-2,-3,-5,-7
"8235",2020-03-08,"Gothic Rd","w1920","Motorized",2,"Sun","weekend","sled","1","1","1",11,0.1,43,-1,33,25.6,-1,-1,-2,-2,-2,-3,-5,-7
"8236",2020-03-08,"Gothic Rd","w1920","Hybrid",0,"Sun","weekend","sled","1","1","1",11,0.1,43,-1,33,25.6,-1,-1,-2,-2,-2,-3,-5,-7
"8237",2020-03-09,"Gothic Rd","w1920","Non.motorized",15,"Mon","weekday","no_sled","1","1","1",11.1,0.1,42,-1,31,26.4,-1,-1,-1,-2,-2,-3,-4,-6
"8238",2020-03-09,"Gothic Rd","w1920","Mechanized",3,"Mon","weekday","no_sled","1","1","1",11.1,0.1,42,-1,31,26.4,-1,-1,-1,-2,-2,-3,-4,-6
"8239",2020-03-09,"Gothic Rd","w1920","Motorized",0,"Mon","weekday","sled","1","1","1",11.1,0.1,42,-1,31,26.4,-1,-1,-1,-2,-2,-3,-4,-6
"8240",2020-03-09,"Gothic Rd","w1920","Hybrid",0,"Mon","weekday","sled","1","1","1",11.1,0.1,42,-1,31,26.4,-1,-1,-1,-2,-2,-3,-4,-6
"8241",2020-03-10,"Gothic Rd","w1920","Non.motorized",15,"Tue","weekday","no_sled","1","1","2",11.2,0.1,44,2,31,25.5,-1,-1,-1,-1,1,0,-1,-2
"8242",2020-03-10,"Gothic Rd","w1920","Mechanized",1,"Tue","weekday","no_sled","1","1","2",11.2,0.1,44,2,31,25.5,-1,-1,-1,-1,1,0,-1,-2
"8243",2020-03-10,"Gothic Rd","w1920","Motorized",1,"Tue","weekday","sled","1","1","2",11.2,0.1,44,2,31,25.5,-1,-1,-1,-1,1,0,-1,-2
"8244",2020-03-10,"Gothic Rd","w1920","Hybrid",0,"Tue","weekday","sled","1","1","2",11.2,0.1,44,2,31,25.5,-1,-1,-1,-1,1,0,-1,-2
"8245",2020-03-11,"Gothic Rd","w1920","Non.motorized",5,"Wed","weekday","no_sled","2","2","1",11.2,0,44,0,32,25.5,2,-1,-1,-1,2,1,0,-1
"8246",2020-03-11,"Gothic Rd","w1920","Mechanized",0,"Wed","weekday","no_sled","2","2","1",11.2,0,44,0,32,25.5,2,-1,-1,-1,2,1,0,-1
"8247",2020-03-11,"Gothic Rd","w1920","Motorized",0,"Wed","weekday","sled","2","2","1",11.2,0,44,0,32,25.5,2,-1,-1,-1,2,1,0,-1
"8248",2020-03-11,"Gothic Rd","w1920","Hybrid",0,"Wed","weekday","sled","2","2","1",11.2,0,44,0,32,25.5,2,-1,-1,-1,2,1,0,-1
"8249",2020-03-12,"Gothic Rd","w1920","Non.motorized",19,"Thu","weekday","no_sled","2","2","2",11.4,0.2,42,-2,35,27.1,0,2,-1,-1,-2,0,-1,-2
"8250",2020-03-12,"Gothic Rd","w1920","Mechanized",1,"Thu","weekday","no_sled","2","2","2",11.4,0.2,42,-2,35,27.1,0,2,-1,-1,-2,0,-1,-2
"8251",2020-03-12,"Gothic Rd","w1920","Motorized",1,"Thu","weekday","sled","2","2","2",11.4,0.2,42,-2,35,27.1,0,2,-1,-1,-2,0,-1,-2
"8252",2020-03-12,"Gothic Rd","w1920","Hybrid",0,"Thu","weekday","sled","2","2","2",11.4,0.2,42,-2,35,27.1,0,2,-1,-1,-2,0,-1,-2
"8253",2020-03-13,"Gothic Rd","w1920","Non.motorized",13,"Fri","weekday","no_sled","3","3","2",11.5,0.1,44,2,31,26.1,-2,0,2,-1,0,0,2,1
"8254",2020-03-13,"Gothic Rd","w1920","Mechanized",1,"Fri","weekday","no_sled","3","3","2",11.5,0.1,44,2,31,26.1,-2,0,2,-1,0,0,2,1
"8255",2020-03-13,"Gothic Rd","w1920","Motorized",4,"Fri","weekday","sled","3","3","2",11.5,0.1,44,2,31,26.1,-2,0,2,-1,0,0,2,1
"8256",2020-03-13,"Gothic Rd","w1920","Hybrid",0,"Fri","weekday","sled","3","3","2",11.5,0.1,44,2,31,26.1,-2,0,2,-1,0,0,2,1
"8257",2020-03-14,"Gothic Rd","w1920","Non.motorized",25,"Sat","weekend","no_sled","3","3","3",11.7,0.2,44,0,31,26.6,2,-2,0,2,2,0,0,2
"8258",2020-03-14,"Gothic Rd","w1920","Mechanized",1,"Sat","weekend","no_sled","3","3","3",11.7,0.2,44,0,31,26.6,2,-2,0,2,2,0,0,2
"8259",2020-03-14,"Gothic Rd","w1920","Motorized",1,"Sat","weekend","sled","3","3","3",11.7,0.2,44,0,31,26.6,2,-2,0,2,2,0,0,2
"8260",2020-03-14,"Gothic Rd","w1920","Hybrid",0,"Sat","weekend","sled","3","3","3",11.7,0.2,44,0,31,26.6,2,-2,0,2,2,0,0,2
"8261",2020-03-15,"Gothic Rd","w1920","Non.motorized",21,"Sun","weekend","no_sled","2","2","2",11.7,0,45,1,33,26,0,2,-2,0,1,3,1,1
"8262",2020-03-15,"Gothic Rd","w1920","Mechanized",4,"Sun","weekend","no_sled","2","2","2",11.7,0,45,1,33,26,0,2,-2,0,1,3,1,1
"8263",2020-03-15,"Gothic Rd","w1920","Motorized",7,"Sun","weekend","sled","2","2","2",11.7,0,45,1,33,26,0,2,-2,0,1,3,1,1
"8264",2020-03-15,"Gothic Rd","w1920","Hybrid",0,"Sun","weekend","sled","2","2","2",11.7,0,45,1,33,26,0,2,-2,0,1,3,1,1
"8265",2020-03-16,"Gothic Rd","w1920","Non.motorized",12,"Mon","weekday","no_sled","2","2","2",11.7,0,45,0,35,26,1,0,2,-2,1,1,3,1
"8266",2020-03-16,"Gothic Rd","w1920","Mechanized",1,"Mon","weekday","no_sled","2","2","2",11.7,0,45,0,35,26,1,0,2,-2,1,1,3,1
"8267",2020-03-16,"Gothic Rd","w1920","Motorized",0,"Mon","weekday","sled","2","2","2",11.7,0,45,0,35,26,1,0,2,-2,1,1,3,1
"8268",2020-03-16,"Gothic Rd","w1920","Hybrid",0,"Mon","weekday","sled","2","2","2",11.7,0,45,0,35,26,1,0,2,-2,1,1,3,1
"8269",2020-03-17,"Gothic Rd","w1920","Non.motorized",7,"Tue","weekday","no_sled","2","2","2",11.7,0,44,-1,36,26.6,0,1,0,2,-1,0,0,2
"8270",2020-03-17,"Gothic Rd","w1920","Mechanized",4,"Tue","weekday","no_sled","2","2","2",11.7,0,44,-1,36,26.6,0,1,0,2,-1,0,0,2
"8271",2020-03-17,"Gothic Rd","w1920","Motorized",0,"Tue","weekday","sled","2","2","2",11.7,0,44,-1,36,26.6,0,1,0,2,-1,0,0,2
"8272",2020-03-17,"Gothic Rd","w1920","Hybrid",0,"Tue","weekday","sled","2","2","2",11.7,0,44,-1,36,26.6,0,1,0,2,-1,0,0,2
"8273",2020-03-18,"Gothic Rd","w1920","Non.motorized",4,"Wed","weekday","no_sled","2","2","2",11.7,0,43,-1,33,27.2,-1,0,1,0,-2,-2,-1,-1
"8274",2020-03-18,"Gothic Rd","w1920","Mechanized",0,"Wed","weekday","no_sled","2","2","2",11.7,0,43,-1,33,27.2,-1,0,1,0,-2,-2,-1,-1
"8275",2020-03-18,"Gothic Rd","w1920","Motorized",0,"Wed","weekday","sled","2","2","2",11.7,0,43,-1,33,27.2,-1,0,1,0,-2,-2,-1,-1
"8276",2020-03-18,"Gothic Rd","w1920","Hybrid",0,"Wed","weekday","sled","2","2","2",11.7,0,43,-1,33,27.2,-1,0,1,0,-2,-2,-1,-1
"8277",2020-03-19,"Gothic Rd","w1920","Non.motorized",8,"Thu","weekday","no_sled","3","3","3",11.8,0.1,43,0,27,27.4,-1,-1,0,1,-1,-2,-2,-1
"8278",2020-03-19,"Gothic Rd","w1920","Mechanized",0,"Thu","weekday","no_sled","3","3","3",11.8,0.1,43,0,27,27.4,-1,-1,0,1,-1,-2,-2,-1
"8279",2020-03-19,"Gothic Rd","w1920","Motorized",0,"Thu","weekday","sled","3","3","3",11.8,0.1,43,0,27,27.4,-1,-1,0,1,-1,-2,-2,-1
"8280",2020-03-19,"Gothic Rd","w1920","Hybrid",0,"Thu","weekday","sled","3","3","3",11.8,0.1,43,0,27,27.4,-1,-1,0,1,-1,-2,-2,-1
"8281",2020-03-20,"Gothic Rd","w1920","Non.motorized",7,"Fri","weekday","no_sled","3","3","2",12.7,0.9,52,9,26,24.4,0,-1,-1,0,9,8,7,7
"8282",2020-03-20,"Gothic Rd","w1920","Mechanized",1,"Fri","weekday","no_sled","3","3","2",12.7,0.9,52,9,26,24.4,0,-1,-1,0,9,8,7,7
"8283",2020-03-20,"Gothic Rd","w1920","Motorized",1,"Fri","weekday","sled","3","3","2",12.7,0.9,52,9,26,24.4,0,-1,-1,0,9,8,7,7
"8284",2020-03-20,"Gothic Rd","w1920","Hybrid",0,"Fri","weekday","sled","3","3","2",12.7,0.9,52,9,26,24.4,0,-1,-1,0,9,8,7,7
"8285",2020-03-21,"Gothic Rd","w1920","Non.motorized",21,"Sat","weekend","no_sled","3","3","2",12.8,0.1,54,2,26,23.7,9,0,-1,-1,11,11,10,9
"8286",2020-03-21,"Gothic Rd","w1920","Mechanized",2,"Sat","weekend","no_sled","3","3","2",12.8,0.1,54,2,26,23.7,9,0,-1,-1,11,11,10,9
"8287",2020-03-21,"Gothic Rd","w1920","Motorized",0,"Sat","weekend","sled","3","3","2",12.8,0.1,54,2,26,23.7,9,0,-1,-1,11,11,10,9
"8288",2020-03-21,"Gothic Rd","w1920","Hybrid",0,"Sat","weekend","sled","3","3","2",12.8,0.1,54,2,26,23.7,9,0,-1,-1,11,11,10,9
"8289",2020-03-22,"Gothic Rd","w1920","Non.motorized",27,"Sun","weekend","no_sled","2","2","2",13,0.2,53,-1,28,24.5,2,9,0,-1,1,10,10,9
"8290",2020-03-22,"Gothic Rd","w1920","Mechanized",3,"Sun","weekend","no_sled","2","2","2",13,0.2,53,-1,28,24.5,2,9,0,-1,1,10,10,9
"8291",2020-03-22,"Gothic Rd","w1920","Motorized",0,"Sun","weekend","sled","2","2","2",13,0.2,53,-1,28,24.5,2,9,0,-1,1,10,10,9
"8292",2020-03-22,"Gothic Rd","w1920","Hybrid",0,"Sun","weekend","sled","2","2","2",13,0.2,53,-1,28,24.5,2,9,0,-1,1,10,10,9
"8293",2020-03-23,"Gothic Rd","w1920","Non.motorized",13,"Mon","weekday","no_sled","2","2","2",13,0,53,0,28,24.5,-1,2,9,0,-1,1,10,10
"8294",2020-03-23,"Gothic Rd","w1920","Mechanized",1,"Mon","weekday","no_sled","2","2","2",13,0,53,0,28,24.5,-1,2,9,0,-1,1,10,10
"8295",2020-03-23,"Gothic Rd","w1920","Motorized",0,"Mon","weekday","sled","2","2","2",13,0,53,0,28,24.5,-1,2,9,0,-1,1,10,10
"8296",2020-03-23,"Gothic Rd","w1920","Hybrid",0,"Mon","weekday","sled","2","2","2",13,0,53,0,28,24.5,-1,2,9,0,-1,1,10,10
"8297",2020-03-24,"Gothic Rd","w1920","Non.motorized",15,"Tue","weekday","no_sled","2","2","2",13.2,0.2,53,0,32,24.9,0,-1,2,9,0,-1,1,10
"8298",2020-03-24,"Gothic Rd","w1920","Mechanized",1,"Tue","weekday","no_sled","2","2","2",13.2,0.2,53,0,32,24.9,0,-1,2,9,0,-1,1,10
"8299",2020-03-24,"Gothic Rd","w1920","Motorized",0,"Tue","weekday","sled","2","2","2",13.2,0.2,53,0,32,24.9,0,-1,2,9,0,-1,1,10
"8300",2020-03-24,"Gothic Rd","w1920","Hybrid",0,"Tue","weekday","sled","2","2","2",13.2,0.2,53,0,32,24.9,0,-1,2,9,0,-1,1,10
"8301",2020-03-25,"Gothic Rd","w1920","Non.motorized",11,"Wed","weekday","no_sled","2","2","2",13.3,0.1,51,-2,34,26.1,0,0,-1,2,-2,-2,-3,-1
"8302",2020-03-25,"Gothic Rd","w1920","Mechanized",1,"Wed","weekday","no_sled","2","2","2",13.3,0.1,51,-2,34,26.1,0,0,-1,2,-2,-2,-3,-1
"8303",2020-03-25,"Gothic Rd","w1920","Motorized",1,"Wed","weekday","sled","2","2","2",13.3,0.1,51,-2,34,26.1,0,0,-1,2,-2,-2,-3,-1
"8304",2020-03-25,"Gothic Rd","w1920","Hybrid",0,"Wed","weekday","sled","2","2","2",13.3,0.1,51,-2,34,26.1,0,0,-1,2,-2,-2,-3,-1
"8305",2020-03-26,"Gothic Rd","w1920","Non.motorized",9,"Thu","weekday","no_sled","2","2","2",13.3,0,50,-1,36,26.6,-2,0,0,-1,-3,-3,-3,-4
"8306",2020-03-26,"Gothic Rd","w1920","Non.motorized",9,"Thu","weekday","no_sled","3","3","2",13.3,0,50,-1,36,26.6,-2,0,0,-1,-3,-3,-3,-4
"8307",2020-03-26,"Gothic Rd","w1920","Mechanized",1,"Thu","weekday","no_sled","2","2","2",13.3,0,50,-1,36,26.6,-2,0,0,-1,-3,-3,-3,-4
"8308",2020-03-26,"Gothic Rd","w1920","Mechanized",1,"Thu","weekday","no_sled","3","3","2",13.3,0,50,-1,36,26.6,-2,0,0,-1,-3,-3,-3,-4
"8309",2020-03-26,"Gothic Rd","w1920","Motorized",1,"Thu","weekday","sled","2","2","2",13.3,0,50,-1,36,26.6,-2,0,0,-1,-3,-3,-3,-4
"8310",2020-03-26,"Gothic Rd","w1920","Motorized",1,"Thu","weekday","sled","3","3","2",13.3,0,50,-1,36,26.6,-2,0,0,-1,-3,-3,-3,-4
"8311",2020-03-26,"Gothic Rd","w1920","Hybrid",0,"Thu","weekday","sled","2","2","2",13.3,0,50,-1,36,26.6,-2,0,0,-1,-3,-3,-3,-4
"8312",2020-03-26,"Gothic Rd","w1920","Hybrid",0,"Thu","weekday","sled","3","3","2",13.3,0,50,-1,36,26.6,-2,0,0,-1,-3,-3,-3,-4
"8313",2020-03-27,"Gothic Rd","w1920","Non.motorized",NA,"Fri","weekday","no_sled","3","3","2",13.3,0,50,0,23,26.6,-1,-2,0,0,-1,-3,-3,-3
"8314",2020-03-27,"Gothic Rd","w1920","Mechanized",NA,"Fri","weekday","no_sled","3","3","2",13.3,0,50,0,23,26.6,-1,-2,0,0,-1,-3,-3,-3
"8315",2020-03-27,"Gothic Rd","w1920","Motorized",NA,"Fri","weekday","sled","3","3","2",13.3,0,50,0,23,26.6,-1,-2,0,0,-1,-3,-3,-3
"8316",2020-03-27,"Gothic Rd","w1920","Hybrid",NA,"Fri","weekday","sled","3","3","2",13.3,0,50,0,23,26.6,-1,-2,0,0,-1,-3,-3,-3
"8317",2020-03-28,"Gothic Rd","w1920","Non.motorized",27,"Sat","weekend","no_sled","3","3","3",13.3,0,50,0,18,26.6,0,-1,-2,0,0,-1,-3,-3
"8318",2020-03-28,"Gothic Rd","w1920","Mechanized",0,"Sat","weekend","no_sled","3","3","3",13.3,0,50,0,18,26.6,0,-1,-2,0,0,-1,-3,-3
"8319",2020-03-28,"Gothic Rd","w1920","Motorized",0,"Sat","weekend","sled","3","3","3",13.3,0,50,0,18,26.6,0,-1,-2,0,0,-1,-3,-3
"8320",2020-03-28,"Gothic Rd","w1920","Hybrid",0,"Sat","weekend","sled","3","3","3",13.3,0,50,0,18,26.6,0,-1,-2,0,0,-1,-3,-3
"8321",2020-03-29,"Gothic Rd","w1920","Non.motorized",11,"Sun","weekend","no_sled","2","2","2",13.3,0,49,-1,24,27.1,0,0,-1,-2,-1,-1,-2,-4
"8322",2020-03-29,"Gothic Rd","w1920","Mechanized",1,"Sun","weekend","no_sled","2","2","2",13.3,0,49,-1,24,27.1,0,0,-1,-2,-1,-1,-2,-4
"8323",2020-03-29,"Gothic Rd","w1920","Motorized",0,"Sun","weekend","sled","2","2","2",13.3,0,49,-1,24,27.1,0,0,-1,-2,-1,-1,-2,-4
"8324",2020-03-29,"Gothic Rd","w1920","Hybrid",0,"Sun","weekend","sled","2","2","2",13.3,0,49,-1,24,27.1,0,0,-1,-2,-1,-1,-2,-4
"8325",2020-03-30,"Gothic Rd","w1920","Non.motorized",8,"Mon","weekday","no_sled","2","2","2",13.4,0.1,49,0,29,27.3,-1,0,0,-1,-1,-1,-1,-2
"8326",2020-03-30,"Gothic Rd","w1920","Mechanized",0,"Mon","weekday","no_sled","2","2","2",13.4,0.1,49,0,29,27.3,-1,0,0,-1,-1,-1,-1,-2
"8327",2020-03-30,"Gothic Rd","w1920","Motorized",0,"Mon","weekday","sled","2","2","2",13.4,0.1,49,0,29,27.3,-1,0,0,-1,-1,-1,-1,-2
"8328",2020-03-30,"Gothic Rd","w1920","Hybrid",0,"Mon","weekday","sled","2","2","2",13.4,0.1,49,0,29,27.3,-1,0,0,-1,-1,-1,-1,-2
"8329",2020-03-31,"Gothic Rd","w1920","Non.motorized",5,"Tue","weekday","no_sled","2","2","2",13.6,0.2,51,2,35,26.7,0,-1,0,0,2,1,1,1
"8330",2020-03-31,"Gothic Rd","w1920","Mechanized",1,"Tue","weekday","no_sled","2","2","2",13.6,0.2,51,2,35,26.7,0,-1,0,0,2,1,1,1
"8331",2020-03-31,"Gothic Rd","w1920","Motorized",1,"Tue","weekday","sled","2","2","2",13.6,0.2,51,2,35,26.7,0,-1,0,0,2,1,1,1
"8332",2020-03-31,"Gothic Rd","w1920","Hybrid",0,"Tue","weekday","sled","2","2","2",13.6,0.2,51,2,35,26.7,0,-1,0,0,2,1,1,1
"8333",2020-04-01,"Gothic Rd","w1920","Non.motorized",6,"Wed","weekday","no_sled","2","2","2",13.6,0,47,-4,39,28.9,2,0,-1,0,-2,-2,-3,-3
"8334",2020-04-01,"Gothic Rd","w1920","Mechanized",1,"Wed","weekday","no_sled","2","2","2",13.6,0,47,-4,39,28.9,2,0,-1,0,-2,-2,-3,-3
"8335",2020-04-01,"Gothic Rd","w1920","Motorized",1,"Wed","weekday","sled","2","2","2",13.6,0,47,-4,39,28.9,2,0,-1,0,-2,-2,-3,-3
"8336",2020-04-01,"Gothic Rd","w1920","Hybrid",0,"Wed","weekday","sled","2","2","2",13.6,0,47,-4,39,28.9,2,0,-1,0,-2,-2,-3,-3
"8337",2020-04-02,"Gothic Rd","w1920","Non.motorized",5,"Thu","weekday","no_sled","2","2","2",13.6,0,46,-1,31,29.6,-4,2,0,-1,-5,-3,-3,-4
"8338",2020-04-02,"Gothic Rd","w1920","Mechanized",0,"Thu","weekday","no_sled","2","2","2",13.6,0,46,-1,31,29.6,-4,2,0,-1,-5,-3,-3,-4
"8339",2020-04-02,"Gothic Rd","w1920","Motorized",1,"Thu","weekday","sled","2","2","2",13.6,0,46,-1,31,29.6,-4,2,0,-1,-5,-3,-3,-4
"8340",2020-04-02,"Gothic Rd","w1920","Hybrid",0,"Thu","weekday","sled","2","2","2",13.6,0,46,-1,31,29.6,-4,2,0,-1,-5,-3,-3,-4
"8341",2020-04-03,"Gothic Rd","w1920","Non.motorized",5,"Fri","weekday","no_sled","2","2","2",13.6,0,46,0,28,29.6,-1,-4,2,0,-1,-5,-3,-3
"8342",2020-04-03,"Gothic Rd","w1920","Mechanized",0,"Fri","weekday","no_sled","2","2","2",13.6,0,46,0,28,29.6,-1,-4,2,0,-1,-5,-3,-3
"8343",2020-04-03,"Gothic Rd","w1920","Motorized",0,"Fri","weekday","sled","2","2","2",13.6,0,46,0,28,29.6,-1,-4,2,0,-1,-5,-3,-3
"8344",2020-04-03,"Gothic Rd","w1920","Hybrid",0,"Fri","weekday","sled","2","2","2",13.6,0,46,0,28,29.6,-1,-4,2,0,-1,-5,-3,-3
"8345",2020-04-04,"Gothic Rd","w1920","Non.motorized",11,"Sat","weekend","no_sled","2","2","2",13.6,0,45,-1,33,30.2,0,-1,-4,2,-1,-2,-6,-4
"8346",2020-04-04,"Gothic Rd","w1920","Mechanized",0,"Sat","weekend","no_sled","2","2","2",13.6,0,45,-1,33,30.2,0,-1,-4,2,-1,-2,-6,-4
"8347",2020-04-04,"Gothic Rd","w1920","Motorized",1,"Sat","weekend","sled","2","2","2",13.6,0,45,-1,33,30.2,0,-1,-4,2,-1,-2,-6,-4
"8348",2020-04-04,"Gothic Rd","w1920","Hybrid",0,"Sat","weekend","sled","2","2","2",13.6,0,45,-1,33,30.2,0,-1,-4,2,-1,-2,-6,-4
"8349",2020-04-05,"Gothic Rd","w1920","Non.motorized",14,"Sun","weekend","no_sled","2","2","3",13.6,0,45,0,38,30.2,-1,0,-1,-4,-1,-1,-2,-6
"8350",2020-04-05,"Gothic Rd","w1920","Mechanized",0,"Sun","weekend","no_sled","2","2","3",13.6,0,45,0,38,30.2,-1,0,-1,-4,-1,-1,-2,-6
"8351",2020-04-05,"Gothic Rd","w1920","Motorized",0,"Sun","weekend","sled","2","2","3",13.6,0,45,0,38,30.2,-1,0,-1,-4,-1,-1,-2,-6
"8352",2020-04-05,"Gothic Rd","w1920","Hybrid",0,"Sun","weekend","sled","2","2","3",13.6,0,45,0,38,30.2,-1,0,-1,-4,-1,-1,-2,-6
"8353",2020-04-06,"Gothic Rd","w1920","Non.motorized",1,"Mon","weekday","no_sled","2","2","3",13.6,0,44,-1,40,30.9,0,-1,0,-1,-1,-2,-2,-3
"8354",2020-04-06,"Gothic Rd","w1920","Mechanized",2,"Mon","weekday","no_sled","2","2","3",13.6,0,44,-1,40,30.9,0,-1,0,-1,-1,-2,-2,-3
"8355",2020-04-06,"Gothic Rd","w1920","Motorized",0,"Mon","weekday","sled","2","2","3",13.6,0,44,-1,40,30.9,0,-1,0,-1,-1,-2,-2,-3
"8356",2020-04-06,"Gothic Rd","w1920","Hybrid",0,"Mon","weekday","sled","2","2","3",13.6,0,44,-1,40,30.9,0,-1,0,-1,-1,-2,-2,-3
"8357",2020-04-07,"Gothic Rd","w1920","Non.motorized",NA,"Tue","weekday","no_sled","2","2","3",13.4,-0.2,43,-1,39,31.2,-1,0,-1,0,-2,-2,-3,-3
"8358",2020-04-07,"Gothic Rd","w1920","Mechanized",NA,"Tue","weekday","no_sled","2","2","3",13.4,-0.2,43,-1,39,31.2,-1,0,-1,0,-2,-2,-3,-3
"8359",2020-04-07,"Gothic Rd","w1920","Motorized",NA,"Tue","weekday","sled","2","2","3",13.4,-0.2,43,-1,39,31.2,-1,0,-1,0,-2,-2,-3,-3
"8360",2020-04-07,"Gothic Rd","w1920","Hybrid",NA,"Tue","weekday","sled","2","2","3",13.4,-0.2,43,-1,39,31.2,-1,0,-1,0,-2,-2,-3,-3
"8361",2020-04-08,"Gothic Rd","w1920","Non.motorized",NA,"Wed","weekday","no_sled","2","3","3",13.3,-0.1,42,-1,40,31.7,-1,-1,0,-1,-2,-3,-3,-4
"8362",2020-04-08,"Gothic Rd","w1920","Mechanized",NA,"Wed","weekday","no_sled","2","3","3",13.3,-0.1,42,-1,40,31.7,-1,-1,0,-1,-2,-3,-3,-4
"8363",2020-04-08,"Gothic Rd","w1920","Motorized",NA,"Wed","weekday","sled","2","3","3",13.3,-0.1,42,-1,40,31.7,-1,-1,0,-1,-2,-3,-3,-4
"8364",2020-04-08,"Gothic Rd","w1920","Hybrid",NA,"Wed","weekday","sled","2","3","3",13.3,-0.1,42,-1,40,31.7,-1,-1,0,-1,-2,-3,-3,-4
"8365",2020-04-09,"Gothic Rd","w1920","Non.motorized",NA,"Thu","weekday","no_sled","2","3","3",13.1,-0.2,40,-2,42,32.8,-1,-1,-1,0,-3,-4,-5,-5
"8366",2020-04-09,"Gothic Rd","w1920","Mechanized",NA,"Thu","weekday","no_sled","2","3","3",13.1,-0.2,40,-2,42,32.8,-1,-1,-1,0,-3,-4,-5,-5
"8367",2020-04-09,"Gothic Rd","w1920","Motorized",NA,"Thu","weekday","sled","2","3","3",13.1,-0.2,40,-2,42,32.8,-1,-1,-1,0,-3,-4,-5,-5
"8368",2020-04-09,"Gothic Rd","w1920","Hybrid",NA,"Thu","weekday","sled","2","3","3",13.1,-0.2,40,-2,42,32.8,-1,-1,-1,0,-3,-4,-5,-5
"8369",2020-04-10,"Gothic Rd","w1920","Non.motorized",NA,"Fri","weekday","no_sled","3","3","3",12.9,-0.2,39,-1,38,33.1,-2,-1,-1,-1,-3,-4,-5,-6
"8370",2020-04-10,"Gothic Rd","w1920","Mechanized",NA,"Fri","weekday","no_sled","3","3","3",12.9,-0.2,39,-1,38,33.1,-2,-1,-1,-1,-3,-4,-5,-6
"8371",2020-04-10,"Gothic Rd","w1920","Motorized",NA,"Fri","weekday","sled","3","3","3",12.9,-0.2,39,-1,38,33.1,-2,-1,-1,-1,-3,-4,-5,-6
"8372",2020-04-10,"Gothic Rd","w1920","Hybrid",NA,"Fri","weekday","sled","3","3","3",12.9,-0.2,39,-1,38,33.1,-2,-1,-1,-1,-3,-4,-5,-6
"8373",2020-04-11,"Gothic Rd","w1920","Non.motorized",NA,"Sat","weekend","no_sled","2","3","3",12.9,0,39,0,36,33.1,-1,-2,-1,-1,-1,-3,-4,-5
"8374",2020-04-11,"Gothic Rd","w1920","Mechanized",NA,"Sat","weekend","no_sled","2","3","3",12.9,0,39,0,36,33.1,-1,-2,-1,-1,-1,-3,-4,-5
"8375",2020-04-11,"Gothic Rd","w1920","Motorized",NA,"Sat","weekend","sled","2","3","3",12.9,0,39,0,36,33.1,-1,-2,-1,-1,-1,-3,-4,-5
"8376",2020-04-11,"Gothic Rd","w1920","Hybrid",NA,"Sat","weekend","sled","2","3","3",12.9,0,39,0,36,33.1,-1,-2,-1,-1,-1,-3,-4,-5
"8377",2020-04-12,"Gothic Rd","w1920","Non.motorized",NA,"Sun","weekend","no_sled","2","2","2",12.8,-0.1,38,-1,29,33.7,0,-1,-2,-1,-1,-2,-4,-5
"8378",2020-04-12,"Gothic Rd","w1920","Mechanized",NA,"Sun","weekend","no_sled","2","2","2",12.8,-0.1,38,-1,29,33.7,0,-1,-2,-1,-1,-2,-4,-5
"8379",2020-04-12,"Gothic Rd","w1920","Motorized",NA,"Sun","weekend","sled","2","2","2",12.8,-0.1,38,-1,29,33.7,0,-1,-2,-1,-1,-2,-4,-5
"8380",2020-04-12,"Gothic Rd","w1920","Hybrid",NA,"Sun","weekend","sled","2","2","2",12.8,-0.1,38,-1,29,33.7,0,-1,-2,-1,-1,-2,-4,-5
"8381",2020-04-13,"Gothic Rd","w1920","Non.motorized",NA,"Mon","weekday","no_sled",NA,NA,NA,12.9,0.1,39,1,20,33.1,-1,0,-1,-2,0,0,-1,-3
"8382",2020-04-13,"Gothic Rd","w1920","Mechanized",NA,"Mon","weekday","no_sled",NA,NA,NA,12.9,0.1,39,1,20,33.1,-1,0,-1,-2,0,0,-1,-3
"8383",2020-04-13,"Gothic Rd","w1920","Motorized",NA,"Mon","weekday","sled",NA,NA,NA,12.9,0.1,39,1,20,33.1,-1,0,-1,-2,0,0,-1,-3
"8384",2020-04-13,"Gothic Rd","w1920","Hybrid",NA,"Mon","weekday","sled",NA,NA,NA,12.9,0.1,39,1,20,33.1,-1,0,-1,-2,0,0,-1,-3
"8385",2020-04-14,"Gothic Rd","w1920","Non.motorized",NA,"Tue","weekday","no_sled","2","2","2",13,0.1,39,0,18,33.3,1,-1,0,-1,1,0,0,-1
"8386",2020-04-14,"Gothic Rd","w1920","Mechanized",NA,"Tue","weekday","no_sled","2","2","2",13,0.1,39,0,18,33.3,1,-1,0,-1,1,0,0,-1
"8387",2020-04-14,"Gothic Rd","w1920","Motorized",NA,"Tue","weekday","sled","2","2","2",13,0.1,39,0,18,33.3,1,-1,0,-1,1,0,0,-1
"8388",2020-04-14,"Gothic Rd","w1920","Hybrid",NA,"Tue","weekday","sled","2","2","2",13,0.1,39,0,18,33.3,1,-1,0,-1,1,0,0,-1
"8389",2020-04-15,"Gothic Rd","w1920","Non.motorized",NA,"Wed","weekday","no_sled",NA,NA,NA,13.2,0.2,39,0,28,33.8,0,1,-1,0,0,1,0,0
"8390",2020-04-15,"Gothic Rd","w1920","Mechanized",NA,"Wed","weekday","no_sled",NA,NA,NA,13.2,0.2,39,0,28,33.8,0,1,-1,0,0,1,0,0
"8391",2020-04-15,"Gothic Rd","w1920","Motorized",NA,"Wed","weekday","sled",NA,NA,NA,13.2,0.2,39,0,28,33.8,0,1,-1,0,0,1,0,0
"8392",2020-04-15,"Gothic Rd","w1920","Hybrid",NA,"Wed","weekday","sled",NA,NA,NA,13.2,0.2,39,0,28,33.8,0,1,-1,0,0,1,0,0
"8393",2019-12-06,"Kebler","w1920","Non.motorized",6,"Fri","weekday","no_sled","2","2","1",2.9,0.4,19,5,24,15.3,0,0,0,0,5,5,5,5
"8394",2019-12-06,"Kebler","w1920","Mechanized",2,"Fri","weekday","no_sled","2","2","1",2.9,0.4,19,5,24,15.3,0,0,0,0,5,5,5,5
"8395",2019-12-06,"Kebler","w1920","Motorized",8,"Fri","weekday","sled","2","2","1",2.9,0.4,19,5,24,15.3,0,0,0,0,5,5,5,5
"8396",2019-12-06,"Kebler","w1920","Hybrid",NA,"Fri","weekday","sled","2","2","1",2.9,0.4,19,5,24,15.3,0,0,0,0,5,5,5,5
"8397",2019-12-07,"Kebler","w1920","Non.motorized",9,"Sat","weekend","no_sled","2","2","1",3,0.1,18,-1,29,16.7,5,0,0,0,4,4,4,4
"8398",2019-12-07,"Kebler","w1920","Mechanized",0,"Sat","weekend","no_sled","2","2","1",3,0.1,18,-1,29,16.7,5,0,0,0,4,4,4,4
"8399",2019-12-07,"Kebler","w1920","Motorized",38,"Sat","weekend","sled","2","2","1",3,0.1,18,-1,29,16.7,5,0,0,0,4,4,4,4
"8400",2019-12-07,"Kebler","w1920","Hybrid",NA,"Sat","weekend","sled","2","2","1",3,0.1,18,-1,29,16.7,5,0,0,0,4,4,4,4
"8401",2019-12-08,"Kebler","w1920","Non.motorized",8,"Sun","weekend","no_sled","2","2","1",3,0,17,-1,28,17.6,-1,5,0,0,-2,3,3,3
"8402",2019-12-08,"Kebler","w1920","Mechanized",0,"Sun","weekend","no_sled","2","2","1",3,0,17,-1,28,17.6,-1,5,0,0,-2,3,3,3
"8403",2019-12-08,"Kebler","w1920","Motorized",16,"Sun","weekend","sled","2","2","1",3,0,17,-1,28,17.6,-1,5,0,0,-2,3,3,3
"8404",2019-12-08,"Kebler","w1920","Hybrid",NA,"Sun","weekend","sled","2","2","1",3,0,17,-1,28,17.6,-1,5,0,0,-2,3,3,3
"8405",2019-12-09,"Kebler","w1920","Non.motorized",13,"Mon","weekday","no_sled","3","3","2",3.4,0.4,22,5,21,15.5,-1,-1,5,0,4,3,8,8
"8406",2019-12-09,"Kebler","w1920","Mechanized",0,"Mon","weekday","no_sled","3","3","2",3.4,0.4,22,5,21,15.5,-1,-1,5,0,4,3,8,8
"8407",2019-12-09,"Kebler","w1920","Motorized",36,"Mon","weekday","sled","3","3","2",3.4,0.4,22,5,21,15.5,-1,-1,5,0,4,3,8,8
"8408",2019-12-09,"Kebler","w1920","Hybrid",NA,"Mon","weekday","sled","3","3","2",3.4,0.4,22,5,21,15.5,-1,-1,5,0,4,3,8,8
"8409",2019-12-10,"Kebler","w1920","Non.motorized",16,"Tue","weekday","no_sled","2","2","2",3.4,0,21,-1,19,16.2,5,-1,-1,5,4,3,2,7
"8410",2019-12-10,"Kebler","w1920","Mechanized",0,"Tue","weekday","no_sled","2","2","2",3.4,0,21,-1,19,16.2,5,-1,-1,5,4,3,2,7
"8411",2019-12-10,"Kebler","w1920","Motorized",36,"Tue","weekday","sled","2","2","2",3.4,0,21,-1,19,16.2,5,-1,-1,5,4,3,2,7
"8412",2019-12-10,"Kebler","w1920","Hybrid",NA,"Tue","weekday","sled","2","2","2",3.4,0,21,-1,19,16.2,5,-1,-1,5,4,3,2,7
"8413",2019-12-11,"Kebler","w1920","Non.motorized",3,"Wed","weekday","no_sled","2","2","2",3.4,0,20,-1,22,17,-1,5,-1,-1,-2,3,2,1
"8414",2019-12-11,"Kebler","w1920","Mechanized",0,"Wed","weekday","no_sled","2","2","2",3.4,0,20,-1,22,17,-1,5,-1,-1,-2,3,2,1
"8415",2019-12-11,"Kebler","w1920","Motorized",39,"Wed","weekday","sled","2","2","2",3.4,0,20,-1,22,17,-1,5,-1,-1,-2,3,2,1
"8416",2019-12-11,"Kebler","w1920","Hybrid",NA,"Wed","weekday","sled","2","2","2",3.4,0,20,-1,22,17,-1,5,-1,-1,-2,3,2,1
"8417",2019-12-12,"Kebler","w1920","Non.motorized",2,"Thu","weekday","no_sled","2","2","2",3.4,0,19,-1,25,17.9,-1,-1,5,-1,-2,-3,2,1
"8418",2019-12-12,"Kebler","w1920","Mechanized",0,"Thu","weekday","no_sled","2","2","2",3.4,0,19,-1,25,17.9,-1,-1,5,-1,-2,-3,2,1
"8419",2019-12-12,"Kebler","w1920","Motorized",29,"Thu","weekday","sled","2","2","2",3.4,0,19,-1,25,17.9,-1,-1,5,-1,-2,-3,2,1
"8420",2019-12-12,"Kebler","w1920","Hybrid",NA,"Thu","weekday","sled","2","2","2",3.4,0,19,-1,25,17.9,-1,-1,5,-1,-2,-3,2,1
"8421",2019-12-13,"Kebler","w1920","Non.motorized",10,"Fri","weekday","no_sled","2","2","2",3.8,0.4,21,2,24,18.1,-1,-1,-1,5,1,0,-1,4
"8422",2019-12-13,"Kebler","w1920","Mechanized",0,"Fri","weekday","no_sled","2","2","2",3.8,0.4,21,2,24,18.1,-1,-1,-1,5,1,0,-1,4
"8423",2019-12-13,"Kebler","w1920","Motorized",32,"Fri","weekday","sled","2","2","2",3.8,0.4,21,2,24,18.1,-1,-1,-1,5,1,0,-1,4
"8424",2019-12-13,"Kebler","w1920","Hybrid",NA,"Fri","weekday","sled","2","2","2",3.8,0.4,21,2,24,18.1,-1,-1,-1,5,1,0,-1,4
"8425",2019-12-14,"Kebler","w1920","Non.motorized",3,"Sat","weekend","no_sled","3","3","3",4.2,0.4,27,6,25,15.6,2,-1,-1,-1,8,7,6,5
"8426",2019-12-14,"Kebler","w1920","Mechanized",1,"Sat","weekend","no_sled","3","3","3",4.2,0.4,27,6,25,15.6,2,-1,-1,-1,8,7,6,5
"8427",2019-12-14,"Kebler","w1920","Motorized",32,"Sat","weekend","sled","3","3","3",4.2,0.4,27,6,25,15.6,2,-1,-1,-1,8,7,6,5
"8428",2019-12-14,"Kebler","w1920","Hybrid",NA,"Sat","weekend","sled","3","3","3",4.2,0.4,27,6,25,15.6,2,-1,-1,-1,8,7,6,5
"8429",2019-12-15,"Kebler","w1920","Non.motorized",20,"Sun","weekend","no_sled","3","3","2",4.8,0.6,31,4,17,15.5,6,2,-1,-1,10,12,11,10
"8430",2019-12-15,"Kebler","w1920","Mechanized",1,"Sun","weekend","no_sled","3","3","2",4.8,0.6,31,4,17,15.5,6,2,-1,-1,10,12,11,10
"8431",2019-12-15,"Kebler","w1920","Motorized",70,"Sun","weekend","sled","3","3","2",4.8,0.6,31,4,17,15.5,6,2,-1,-1,10,12,11,10
"8432",2019-12-15,"Kebler","w1920","Hybrid",NA,"Sun","weekend","sled","3","3","2",4.8,0.6,31,4,17,15.5,6,2,-1,-1,10,12,11,10
"8433",2019-12-16,"Kebler","w1920","Non.motorized",12,"Mon","weekday","no_sled","3","3","2",4.8,0,29,-2,6,16.6,4,6,2,-1,2,8,10,9
"8434",2019-12-16,"Kebler","w1920","Mechanized",0,"Mon","weekday","no_sled","3","3","2",4.8,0,29,-2,6,16.6,4,6,2,-1,2,8,10,9
"8435",2019-12-16,"Kebler","w1920","Motorized",68,"Mon","weekday","sled","3","3","2",4.8,0,29,-2,6,16.6,4,6,2,-1,2,8,10,9
"8436",2019-12-16,"Kebler","w1920","Hybrid",NA,"Mon","weekday","sled","3","3","2",4.8,0,29,-2,6,16.6,4,6,2,-1,2,8,10,9
"8437",2019-12-17,"Kebler","w1920","Non.motorized",10,"Tue","weekday","no_sled","2","2","1",4.8,0,27,-2,8,17.8,-2,4,6,2,-4,0,6,8
"8438",2019-12-17,"Kebler","w1920","Mechanized",3,"Tue","weekday","no_sled","2","2","1",4.8,0,27,-2,8,17.8,-2,4,6,2,-4,0,6,8
"8439",2019-12-17,"Kebler","w1920","Motorized",36,"Tue","weekday","sled","2","2","1",4.8,0,27,-2,8,17.8,-2,4,6,2,-4,0,6,8
"8440",2019-12-17,"Kebler","w1920","Hybrid",NA,"Tue","weekday","sled","2","2","1",4.8,0,27,-2,8,17.8,-2,4,6,2,-4,0,6,8
"8441",2019-12-18,"Kebler","w1920","Non.motorized",9,"Wed","weekday","no_sled","2","2","1",4.8,0,26,-1,20,18.5,-2,-2,4,6,-3,-5,-1,5
"8442",2019-12-18,"Kebler","w1920","Mechanized",0,"Wed","weekday","no_sled","2","2","1",4.8,0,26,-1,20,18.5,-2,-2,4,6,-3,-5,-1,5
"8443",2019-12-18,"Kebler","w1920","Motorized",52,"Wed","weekday","sled","2","2","1",4.8,0,26,-1,20,18.5,-2,-2,4,6,-3,-5,-1,5
"8444",2019-12-18,"Kebler","w1920","Hybrid",NA,"Wed","weekday","sled","2","2","1",4.8,0,26,-1,20,18.5,-2,-2,4,6,-3,-5,-1,5
"8445",2019-12-19,"Kebler","w1920","Non.motorized",12,"Thu","weekday","no_sled","2","2","1",4.9,0.1,25,-1,21,19.6,-1,-2,-2,4,-2,-4,-6,-2
"8446",2019-12-19,"Kebler","w1920","Mechanized",1,"Thu","weekday","no_sled","2","2","1",4.9,0.1,25,-1,21,19.6,-1,-2,-2,4,-2,-4,-6,-2
"8447",2019-12-19,"Kebler","w1920","Motorized",56,"Thu","weekday","sled","2","2","1",4.9,0.1,25,-1,21,19.6,-1,-2,-2,4,-2,-4,-6,-2
"8448",2019-12-19,"Kebler","w1920","Hybrid",NA,"Thu","weekday","sled","2","2","1",4.9,0.1,25,-1,21,19.6,-1,-2,-2,4,-2,-4,-6,-2
"8449",2019-12-20,"Kebler","w1920","Non.motorized",9,"Fri","weekday","no_sled","2","2","1",4.9,0,24,-1,21,20.4,-1,-1,-2,-2,-2,-3,-5,-7
"8450",2019-12-20,"Kebler","w1920","Mechanized",0,"Fri","weekday","no_sled","2","2","1",4.9,0,24,-1,21,20.4,-1,-1,-2,-2,-2,-3,-5,-7
"8451",2019-12-20,"Kebler","w1920","Motorized",62,"Fri","weekday","sled","2","2","1",4.9,0,24,-1,21,20.4,-1,-1,-2,-2,-2,-3,-5,-7
"8452",2019-12-20,"Kebler","w1920","Hybrid",NA,"Fri","weekday","sled","2","2","1",4.9,0,24,-1,21,20.4,-1,-1,-2,-2,-2,-3,-5,-7
"8453",2019-12-21,"Kebler","w1920","Non.motorized",7,"Sat","weekend","no_sled","2","2","1",4.9,0,24,0,27,20.4,-1,-1,-1,-2,-1,-2,-3,-5
"8454",2019-12-21,"Kebler","w1920","Mechanized",0,"Sat","weekend","no_sled","2","2","1",4.9,0,24,0,27,20.4,-1,-1,-1,-2,-1,-2,-3,-5
"8455",2019-12-21,"Kebler","w1920","Motorized",100,"Sat","weekend","sled","2","2","1",4.9,0,24,0,27,20.4,-1,-1,-1,-2,-1,-2,-3,-5
"8456",2019-12-21,"Kebler","w1920","Hybrid",NA,"Sat","weekend","sled","2","2","1",4.9,0,24,0,27,20.4,-1,-1,-1,-2,-1,-2,-3,-5
"8457",2019-12-22,"Kebler","w1920","Non.motorized",13,"Sun","weekend","no_sled","2","2","1",5,0.1,23,-1,31,21.7,0,-1,-1,-1,-1,-2,-3,-4
"8458",2019-12-22,"Kebler","w1920","Mechanized",0,"Sun","weekend","no_sled","2","2","1",5,0.1,23,-1,31,21.7,0,-1,-1,-1,-1,-2,-3,-4
"8459",2019-12-22,"Kebler","w1920","Motorized",16,"Sun","weekend","sled","2","2","1",5,0.1,23,-1,31,21.7,0,-1,-1,-1,-1,-2,-3,-4
"8460",2019-12-22,"Kebler","w1920","Hybrid",NA,"Sun","weekend","sled","2","2","1",5,0.1,23,-1,31,21.7,0,-1,-1,-1,-1,-2,-3,-4
"8461",2019-12-23,"Kebler","w1920","Non.motorized",2,"Mon","weekday","no_sled","2","1","1",5,0,23,0,34,21.7,-1,0,-1,-1,-1,-1,-2,-3
"8462",2019-12-23,"Kebler","w1920","Mechanized",1,"Mon","weekday","no_sled","2","1","1",5,0,23,0,34,21.7,-1,0,-1,-1,-1,-1,-2,-3
"8463",2019-12-23,"Kebler","w1920","Motorized",124,"Mon","weekday","sled","2","1","1",5,0,23,0,34,21.7,-1,0,-1,-1,-1,-1,-2,-3
"8464",2019-12-23,"Kebler","w1920","Hybrid",NA,"Mon","weekday","sled","2","1","1",5,0,23,0,34,21.7,-1,0,-1,-1,-1,-1,-2,-3
"8465",2019-12-24,"Kebler","w1920","Non.motorized",6,"Tue","weekday","no_sled","2","1","1",5,0,22,-1,30,22.7,0,-1,0,-1,-1,-2,-2,-3
"8466",2019-12-24,"Kebler","w1920","Mechanized",0,"Tue","weekday","no_sled","2","1","1",5,0,22,-1,30,22.7,0,-1,0,-1,-1,-2,-2,-3
"8467",2019-12-24,"Kebler","w1920","Motorized",141,"Tue","weekday","sled","2","1","1",5,0,22,-1,30,22.7,0,-1,0,-1,-1,-2,-2,-3
"8468",2019-12-24,"Kebler","w1920","Hybrid",NA,"Tue","weekday","sled","2","1","1",5,0,22,-1,30,22.7,0,-1,0,-1,-1,-2,-2,-3
"8469",2019-12-25,"Kebler","w1920","Non.motorized",2,"Wed","weekday","no_sled","2","2","2",5,0,23,1,22,21.7,-1,0,-1,0,0,0,-1,-1
"8470",2019-12-25,"Kebler","w1920","Mechanized",0,"Wed","weekday","no_sled","2","2","2",5,0,23,1,22,21.7,-1,0,-1,0,0,0,-1,-1
"8471",2019-12-25,"Kebler","w1920","Motorized",154,"Wed","weekday","sled","2","2","2",5,0,23,1,22,21.7,-1,0,-1,0,0,0,-1,-1
"8472",2019-12-25,"Kebler","w1920","Hybrid",NA,"Wed","weekday","sled","2","2","2",5,0,23,1,22,21.7,-1,0,-1,0,0,0,-1,-1
"8473",2019-12-26,"Kebler","w1920","Non.motorized",10,"Thu","weekday","no_sled","2","2","1",5,0,23,0,17,21.7,1,-1,0,-1,1,0,0,-1
"8474",2019-12-26,"Kebler","w1920","Mechanized",0,"Thu","weekday","no_sled","2","2","1",5,0,23,0,17,21.7,1,-1,0,-1,1,0,0,-1
"8475",2019-12-26,"Kebler","w1920","Motorized",213,"Thu","weekday","sled","2","2","1",5,0,23,0,17,21.7,1,-1,0,-1,1,0,0,-1
"8476",2019-12-26,"Kebler","w1920","Hybrid",NA,"Thu","weekday","sled","2","2","1",5,0,23,0,17,21.7,1,-1,0,-1,1,0,0,-1
"8477",2019-12-27,"Kebler","w1920","Non.motorized",9,"Fri","weekday","no_sled","3","3","2",5.1,0.1,24,1,22,21.2,0,1,-1,0,1,2,1,1
"8478",2019-12-27,"Kebler","w1920","Mechanized",0,"Fri","weekday","no_sled","3","3","2",5.1,0.1,24,1,22,21.2,0,1,-1,0,1,2,1,1
"8479",2019-12-27,"Kebler","w1920","Motorized",159,"Fri","weekday","sled","3","3","2",5.1,0.1,24,1,22,21.2,0,1,-1,0,1,2,1,1
"8480",2019-12-27,"Kebler","w1920","Hybrid",NA,"Fri","weekday","sled","3","3","2",5.1,0.1,24,1,22,21.2,0,1,-1,0,1,2,1,1
"8481",2019-12-28,"Kebler","w1920","Non.motorized",23,"Sat","weekend","no_sled","3","3","2",5.6,0.5,30,6,16,18.7,1,0,1,-1,7,7,8,7
"8482",2019-12-28,"Kebler","w1920","Mechanized",1,"Sat","weekend","no_sled","3","3","2",5.6,0.5,30,6,16,18.7,1,0,1,-1,7,7,8,7
"8483",2019-12-28,"Kebler","w1920","Motorized",158,"Sat","weekend","sled","3","3","2",5.6,0.5,30,6,16,18.7,1,0,1,-1,7,7,8,7
"8484",2019-12-28,"Kebler","w1920","Hybrid",NA,"Sat","weekend","sled","3","3","2",5.6,0.5,30,6,16,18.7,1,0,1,-1,7,7,8,7
"8485",2019-12-29,"Kebler","w1920","Non.motorized",9,"Sun","weekend","no_sled","3","3","2",5.6,0,29,-1,3,19.3,6,1,0,1,5,6,6,7
"8486",2019-12-29,"Kebler","w1920","Mechanized",0,"Sun","weekend","no_sled","3","3","2",5.6,0,29,-1,3,19.3,6,1,0,1,5,6,6,7
"8487",2019-12-29,"Kebler","w1920","Motorized",146,"Sun","weekend","sled","3","3","2",5.6,0,29,-1,3,19.3,6,1,0,1,5,6,6,7
"8488",2019-12-29,"Kebler","w1920","Hybrid",NA,"Sun","weekend","sled","3","3","2",5.6,0,29,-1,3,19.3,6,1,0,1,5,6,6,7
"8489",2019-12-30,"Kebler","w1920","Non.motorized",5,"Mon","weekday","no_sled","3","3","2",5.6,0,28,-1,3,20,-1,6,1,0,-2,4,5,5
"8490",2019-12-30,"Kebler","w1920","Mechanized",0,"Mon","weekday","no_sled","3","3","2",5.6,0,28,-1,3,20,-1,6,1,0,-2,4,5,5
"8491",2019-12-30,"Kebler","w1920","Motorized",163,"Mon","weekday","sled","3","3","2",5.6,0,28,-1,3,20,-1,6,1,0,-2,4,5,5
"8492",2019-12-30,"Kebler","w1920","Hybrid",NA,"Mon","weekday","sled","3","3","2",5.6,0,28,-1,3,20,-1,6,1,0,-2,4,5,5
"8493",2019-12-31,"Kebler","w1920","Non.motorized",21,"Tue","weekday","no_sled","2","2","1",5.6,0,28,0,13,20,-1,-1,6,1,-1,-2,4,5
"8494",2019-12-31,"Kebler","w1920","Mechanized",0,"Tue","weekday","no_sled","2","2","1",5.6,0,28,0,13,20,-1,-1,6,1,-1,-2,4,5
"8495",2019-12-31,"Kebler","w1920","Motorized",176,"Tue","weekday","sled","2","2","1",5.6,0,28,0,13,20,-1,-1,6,1,-1,-2,4,5
"8496",2019-12-31,"Kebler","w1920","Hybrid",NA,"Tue","weekday","sled","2","2","1",5.6,0,28,0,13,20,-1,-1,6,1,-1,-2,4,5
"8497",2020-01-01,"Kebler","w1920","Non.motorized",11,"Wed","weekday","no_sled","2","1","1",5.6,0,27,-1,21,20.7,0,-1,-1,6,-1,-2,-3,3
"8498",2020-01-01,"Kebler","w1920","Mechanized",0,"Wed","weekday","no_sled","2","1","1",5.6,0,27,-1,21,20.7,0,-1,-1,6,-1,-2,-3,3
"8499",2020-01-01,"Kebler","w1920","Motorized",92,"Wed","weekday","sled","2","1","1",5.6,0,27,-1,21,20.7,0,-1,-1,6,-1,-2,-3,3
"8500",2020-01-01,"Kebler","w1920","Hybrid",NA,"Wed","weekday","sled","2","1","1",5.6,0,27,-1,21,20.7,0,-1,-1,6,-1,-2,-3,3
"8501",2020-01-02,"Kebler","w1920","Non.motorized",12,"Thu","weekday","no_sled","3","3","2",5.9,0.3,29,2,16,20.3,-1,0,-1,-1,1,1,0,-1
"8502",2020-01-02,"Kebler","w1920","Mechanized",0,"Thu","weekday","no_sled","3","3","2",5.9,0.3,29,2,16,20.3,-1,0,-1,-1,1,1,0,-1
"8503",2020-01-02,"Kebler","w1920","Motorized",125,"Thu","weekday","sled","3","3","2",5.9,0.3,29,2,16,20.3,-1,0,-1,-1,1,1,0,-1
"8504",2020-01-02,"Kebler","w1920","Hybrid",NA,"Thu","weekday","sled","3","3","2",5.9,0.3,29,2,16,20.3,-1,0,-1,-1,1,1,0,-1
"8505",2020-01-03,"Kebler","w1920","Non.motorized",18,"Fri","weekday","no_sled","3","2","1",5.9,0,31,2,19,19,2,-1,0,-1,4,3,3,2
"8506",2020-01-03,"Kebler","w1920","Mechanized",0,"Fri","weekday","no_sled","3","2","1",5.9,0,31,2,19,19,2,-1,0,-1,4,3,3,2
"8507",2020-01-03,"Kebler","w1920","Motorized",140,"Fri","weekday","sled","3","2","1",5.9,0,31,2,19,19,2,-1,0,-1,4,3,3,2
"8508",2020-01-03,"Kebler","w1920","Hybrid",NA,"Fri","weekday","sled","3","2","1",5.9,0,31,2,19,19,2,-1,0,-1,4,3,3,2
"8509",2020-01-04,"Kebler","w1920","Non.motorized",15,"Sat","weekend","no_sled","2","2","1",5.9,0,30,-1,26,19.7,2,2,-1,0,1,3,2,2
"8510",2020-01-04,"Kebler","w1920","Mechanized",1,"Sat","weekend","no_sled","2","2","1",5.9,0,30,-1,26,19.7,2,2,-1,0,1,3,2,2
"8511",2020-01-04,"Kebler","w1920","Motorized",90,"Sat","weekend","sled","2","2","1",5.9,0,30,-1,26,19.7,2,2,-1,0,1,3,2,2
"8512",2020-01-04,"Kebler","w1920","Hybrid",NA,"Sat","weekend","sled","2","2","1",5.9,0,30,-1,26,19.7,2,2,-1,0,1,3,2,2
"8513",2020-01-05,"Kebler","w1920","Non.motorized",7,"Sun","weekend","no_sled","2","2","1",5.9,0,28,-2,23,21.1,-1,2,2,-1,-3,-1,1,0
"8514",2020-01-05,"Kebler","w1920","Mechanized",0,"Sun","weekend","no_sled","2","2","1",5.9,0,28,-2,23,21.1,-1,2,2,-1,-3,-1,1,0
"8515",2020-01-05,"Kebler","w1920","Motorized",24,"Sun","weekend","sled","2","2","1",5.9,0,28,-2,23,21.1,-1,2,2,-1,-3,-1,1,0
"8516",2020-01-05,"Kebler","w1920","Hybrid",NA,"Sun","weekend","sled","2","2","1",5.9,0,28,-2,23,21.1,-1,2,2,-1,-3,-1,1,0
"8517",2020-01-06,"Kebler","w1920","Non.motorized",NA,"Mon","weekday","no_sled","2","2","1",5.9,0,28,0,15,21.1,-2,-1,2,2,-2,-3,-1,1
"8518",2020-01-06,"Kebler","w1920","Mechanized",NA,"Mon","weekday","no_sled","2","2","1",5.9,0,28,0,15,21.1,-2,-1,2,2,-2,-3,-1,1
"8519",2020-01-06,"Kebler","w1920","Motorized",NA,"Mon","weekday","sled","2","2","1",5.9,0,28,0,15,21.1,-2,-1,2,2,-2,-3,-1,1
"8520",2020-01-06,"Kebler","w1920","Hybrid",NA,"Mon","weekday","sled","2","2","1",5.9,0,28,0,15,21.1,-2,-1,2,2,-2,-3,-1,1
"8521",2020-01-07,"Kebler","w1920","Non.motorized",NA,"Tue","weekday","no_sled","2","1","1",5.9,0,28,0,22,21.1,0,-2,-1,2,0,-2,-3,-1
"8522",2020-01-07,"Kebler","w1920","Mechanized",NA,"Tue","weekday","no_sled","2","1","1",5.9,0,28,0,22,21.1,0,-2,-1,2,0,-2,-3,-1
"8523",2020-01-07,"Kebler","w1920","Motorized",NA,"Tue","weekday","sled","2","1","1",5.9,0,28,0,22,21.1,0,-2,-1,2,0,-2,-3,-1
"8524",2020-01-07,"Kebler","w1920","Hybrid",NA,"Tue","weekday","sled","2","1","1",5.9,0,28,0,22,21.1,0,-2,-1,2,0,-2,-3,-1
"8525",2020-01-08,"Kebler","w1920","Non.motorized",NA,"Wed","weekday","no_sled","2","1","1",6,0.1,28,0,23,21.4,0,0,-2,-1,0,0,-2,-3
"8526",2020-01-08,"Kebler","w1920","Mechanized",NA,"Wed","weekday","no_sled","2","1","1",6,0.1,28,0,23,21.4,0,0,-2,-1,0,0,-2,-3
"8527",2020-01-08,"Kebler","w1920","Motorized",NA,"Wed","weekday","sled","2","1","1",6,0.1,28,0,23,21.4,0,0,-2,-1,0,0,-2,-3
"8528",2020-01-08,"Kebler","w1920","Hybrid",NA,"Wed","weekday","sled","2","1","1",6,0.1,28,0,23,21.4,0,0,-2,-1,0,0,-2,-3
"8529",2020-01-09,"Kebler","w1920","Non.motorized",NA,"Thu","weekday","no_sled","2","1","1",6,0,27,-1,17,22.2,0,0,0,-2,-1,-1,-1,-3
"8530",2020-01-09,"Kebler","w1920","Mechanized",NA,"Thu","weekday","no_sled","2","1","1",6,0,27,-1,17,22.2,0,0,0,-2,-1,-1,-1,-3
"8531",2020-01-09,"Kebler","w1920","Motorized",NA,"Thu","weekday","sled","2","1","1",6,0,27,-1,17,22.2,0,0,0,-2,-1,-1,-1,-3
"8532",2020-01-09,"Kebler","w1920","Hybrid",NA,"Thu","weekday","sled","2","1","1",6,0,27,-1,17,22.2,0,0,0,-2,-1,-1,-1,-3
"8533",2020-01-10,"Kebler","w1920","Non.motorized",NA,"Fri","weekday","no_sled","2","1","1",6,0,29,2,11,20.7,-1,0,0,0,1,1,1,1
"8534",2020-01-10,"Kebler","w1920","Mechanized",NA,"Fri","weekday","no_sled","2","1","1",6,0,29,2,11,20.7,-1,0,0,0,1,1,1,1
"8535",2020-01-10,"Kebler","w1920","Motorized",NA,"Fri","weekday","sled","2","1","1",6,0,29,2,11,20.7,-1,0,0,0,1,1,1,1
"8536",2020-01-10,"Kebler","w1920","Hybrid",NA,"Fri","weekday","sled","2","1","1",6,0,29,2,11,20.7,-1,0,0,0,1,1,1,1
"8537",2020-01-11,"Kebler","w1920","Non.motorized",3,"Sat","weekend","no_sled","2","1","1",6,0,29,0,12,20.7,2,-1,0,0,2,1,1,1
"8538",2020-01-11,"Kebler","w1920","Mechanized",0,"Sat","weekend","no_sled","2","1","1",6,0,29,0,12,20.7,2,-1,0,0,2,1,1,1
"8539",2020-01-11,"Kebler","w1920","Motorized",23,"Sat","weekend","sled","2","1","1",6,0,29,0,12,20.7,2,-1,0,0,2,1,1,1
"8540",2020-01-11,"Kebler","w1920","Hybrid",NA,"Sat","weekend","sled","2","1","1",6,0,29,0,12,20.7,2,-1,0,0,2,1,1,1
"8541",2020-01-12,"Kebler","w1920","Non.motorized",3,"Sun","weekend","no_sled","2","1","1",6.1,0.1,29,0,13,21,0,2,-1,0,0,2,1,1
"8542",2020-01-12,"Kebler","w1920","Mechanized",0,"Sun","weekend","no_sled","2","1","1",6.1,0.1,29,0,13,21,0,2,-1,0,0,2,1,1
"8543",2020-01-12,"Kebler","w1920","Motorized",47,"Sun","weekend","sled","2","1","1",6.1,0.1,29,0,13,21,0,2,-1,0,0,2,1,1
"8544",2020-01-12,"Kebler","w1920","Hybrid",NA,"Sun","weekend","sled","2","1","1",6.1,0.1,29,0,13,21,0,2,-1,0,0,2,1,1
"8545",2020-01-13,"Kebler","w1920","Non.motorized",6,"Mon","weekday","no_sled","2","2","1",6.2,0.1,29,0,16,21.4,0,0,2,-1,0,0,2,1
"8546",2020-01-13,"Kebler","w1920","Mechanized",0,"Mon","weekday","no_sled","2","2","1",6.2,0.1,29,0,16,21.4,0,0,2,-1,0,0,2,1
"8547",2020-01-13,"Kebler","w1920","Motorized",38,"Mon","weekday","sled","2","2","1",6.2,0.1,29,0,16,21.4,0,0,2,-1,0,0,2,1
"8548",2020-01-13,"Kebler","w1920","Hybrid",NA,"Mon","weekday","sled","2","2","1",6.2,0.1,29,0,16,21.4,0,0,2,-1,0,0,2,1
"8549",2020-01-14,"Kebler","w1920","Non.motorized",12,"Tue","weekday","no_sled","3","2","1",6.6,0.4,34,5,23,19.4,0,0,0,2,5,5,5,7
"8550",2020-01-14,"Kebler","w1920","Mechanized",0,"Tue","weekday","no_sled","3","2","1",6.6,0.4,34,5,23,19.4,0,0,0,2,5,5,5,7
"8551",2020-01-14,"Kebler","w1920","Motorized",37,"Tue","weekday","sled","3","2","1",6.6,0.4,34,5,23,19.4,0,0,0,2,5,5,5,7
"8552",2020-01-14,"Kebler","w1920","Hybrid",NA,"Tue","weekday","sled","3","2","1",6.6,0.4,34,5,23,19.4,0,0,0,2,5,5,5,7
"8553",2020-01-15,"Kebler","w1920","Non.motorized",5,"Wed","weekday","no_sled","3","2","1",6.7,0.1,32,-2,23,20.9,5,0,0,0,3,3,3,3
"8554",2020-01-15,"Kebler","w1920","Mechanized",0,"Wed","weekday","no_sled","3","2","1",6.7,0.1,32,-2,23,20.9,5,0,0,0,3,3,3,3
"8555",2020-01-15,"Kebler","w1920","Motorized",27,"Wed","weekday","sled","3","2","1",6.7,0.1,32,-2,23,20.9,5,0,0,0,3,3,3,3
"8556",2020-01-15,"Kebler","w1920","Hybrid",NA,"Wed","weekday","sled","3","2","1",6.7,0.1,32,-2,23,20.9,5,0,0,0,3,3,3,3
"8557",2020-01-16,"Kebler","w1920","Non.motorized",1,"Thu","weekday","no_sled","2","2","1",6.7,0,31,-1,28,21.6,-2,5,0,0,-3,2,2,2
"8558",2020-01-16,"Kebler","w1920","Mechanized",1,"Thu","weekday","no_sled","2","2","1",6.7,0,31,-1,28,21.6,-2,5,0,0,-3,2,2,2
"8559",2020-01-16,"Kebler","w1920","Motorized",43,"Thu","weekday","sled","2","2","1",6.7,0,31,-1,28,21.6,-2,5,0,0,-3,2,2,2
"8560",2020-01-16,"Kebler","w1920","Hybrid",NA,"Thu","weekday","sled","2","2","1",6.7,0,31,-1,28,21.6,-2,5,0,0,-3,2,2,2
"8561",2020-01-17,"Kebler","w1920","Non.motorized",0,"Fri","weekday","no_sled","2","2","1",6.8,0.1,29,-2,19,23.4,-1,-2,5,0,-3,-5,0,0
"8562",2020-01-17,"Kebler","w1920","Mechanized",0,"Fri","weekday","no_sled","2","2","1",6.8,0.1,29,-2,19,23.4,-1,-2,5,0,-3,-5,0,0
"8563",2020-01-17,"Kebler","w1920","Motorized",6,"Fri","weekday","sled","2","2","1",6.8,0.1,29,-2,19,23.4,-1,-2,5,0,-3,-5,0,0
"8564",2020-01-17,"Kebler","w1920","Hybrid",NA,"Fri","weekday","sled","2","2","1",6.8,0.1,29,-2,19,23.4,-1,-2,5,0,-3,-5,0,0
"8565",2020-01-18,"Kebler","w1920","Non.motorized",5,"Sat","weekend","no_sled","2","2","2",7,0.2,34,5,16,20.6,-2,-1,-2,5,3,2,0,5
"8566",2020-01-18,"Kebler","w1920","Mechanized",0,"Sat","weekend","no_sled","2","2","2",7,0.2,34,5,16,20.6,-2,-1,-2,5,3,2,0,5
"8567",2020-01-18,"Kebler","w1920","Motorized",30,"Sat","weekend","sled","2","2","2",7,0.2,34,5,16,20.6,-2,-1,-2,5,3,2,0,5
"8568",2020-01-18,"Kebler","w1920","Hybrid",NA,"Sat","weekend","sled","2","2","2",7,0.2,34,5,16,20.6,-2,-1,-2,5,3,2,0,5
"8569",2020-01-19,"Kebler","w1920","Non.motorized",11,"Sun","weekend","no_sled","2","2","1",7,0,33,-1,21,21.2,5,-2,-1,-2,4,2,1,-1
"8570",2020-01-19,"Kebler","w1920","Mechanized",0,"Sun","weekend","no_sled","2","2","1",7,0,33,-1,21,21.2,5,-2,-1,-2,4,2,1,-1
"8571",2020-01-19,"Kebler","w1920","Motorized",65,"Sun","weekend","sled","2","2","1",7,0,33,-1,21,21.2,5,-2,-1,-2,4,2,1,-1
"8572",2020-01-19,"Kebler","w1920","Hybrid",NA,"Sun","weekend","sled","2","2","1",7,0,33,-1,21,21.2,5,-2,-1,-2,4,2,1,-1
"8573",2020-01-20,"Kebler","w1920","Non.motorized",2,"Mon","weekday","no_sled","2","2","1",7.1,0.1,32,-1,25,22.2,-1,5,-2,-1,-2,3,1,0
"8574",2020-01-20,"Kebler","w1920","Mechanized",0,"Mon","weekday","no_sled","2","2","1",7.1,0.1,32,-1,25,22.2,-1,5,-2,-1,-2,3,1,0
"8575",2020-01-20,"Kebler","w1920","Motorized",48,"Mon","weekday","sled","2","2","1",7.1,0.1,32,-1,25,22.2,-1,5,-2,-1,-2,3,1,0
"8576",2020-01-20,"Kebler","w1920","Hybrid",NA,"Mon","weekday","sled","2","2","1",7.1,0.1,32,-1,25,22.2,-1,5,-2,-1,-2,3,1,0
"8577",2020-01-21,"Kebler","w1920","Non.motorized",4,"Tue","weekday","no_sled","2","2","1",7.1,0,31,-1,28,22.9,-1,-1,5,-2,-2,-3,2,0
"8578",2020-01-21,"Kebler","w1920","Mechanized",1,"Tue","weekday","no_sled","2","2","1",7.1,0,31,-1,28,22.9,-1,-1,5,-2,-2,-3,2,0
"8579",2020-01-21,"Kebler","w1920","Motorized",22,"Tue","weekday","sled","2","2","1",7.1,0,31,-1,28,22.9,-1,-1,5,-2,-2,-3,2,0
"8580",2020-01-21,"Kebler","w1920","Hybrid",NA,"Tue","weekday","sled","2","2","1",7.1,0,31,-1,28,22.9,-1,-1,5,-2,-2,-3,2,0
"8581",2020-01-22,"Kebler","w1920","Non.motorized",6,"Wed","weekday","no_sled","2","2","2",7.3,0.2,32,1,25,22.8,-1,-1,-1,5,0,-1,-2,3
"8582",2020-01-22,"Kebler","w1920","Mechanized",0,"Wed","weekday","no_sled","2","2","2",7.3,0.2,32,1,25,22.8,-1,-1,-1,5,0,-1,-2,3
"8583",2020-01-22,"Kebler","w1920","Motorized",47,"Wed","weekday","sled","2","2","2",7.3,0.2,32,1,25,22.8,-1,-1,-1,5,0,-1,-2,3
"8584",2020-01-22,"Kebler","w1920","Hybrid",NA,"Wed","weekday","sled","2","2","2",7.3,0.2,32,1,25,22.8,-1,-1,-1,5,0,-1,-2,3
"8585",2020-01-23,"Kebler","w1920","Non.motorized",11,"Thu","weekday","no_sled","3","2","2",7.3,0,34,2,23,21.5,1,-1,-1,-1,3,2,1,0
"8586",2020-01-23,"Kebler","w1920","Mechanized",0,"Thu","weekday","no_sled","3","2","2",7.3,0,34,2,23,21.5,1,-1,-1,-1,3,2,1,0
"8587",2020-01-23,"Kebler","w1920","Motorized",37,"Thu","weekday","sled","3","2","2",7.3,0,34,2,23,21.5,1,-1,-1,-1,3,2,1,0
"8588",2020-01-23,"Kebler","w1920","Hybrid",NA,"Thu","weekday","sled","3","2","2",7.3,0,34,2,23,21.5,1,-1,-1,-1,3,2,1,0
"8589",2020-01-24,"Kebler","w1920","Non.motorized",2,"Fri","weekday","no_sled","2","2","1",7.3,0,33,-1,23,22.1,2,1,-1,-1,1,2,1,0
"8590",2020-01-24,"Kebler","w1920","Mechanized",0,"Fri","weekday","no_sled","2","2","1",7.3,0,33,-1,23,22.1,2,1,-1,-1,1,2,1,0
"8591",2020-01-24,"Kebler","w1920","Motorized",49,"Fri","weekday","sled","2","2","1",7.3,0,33,-1,23,22.1,2,1,-1,-1,1,2,1,0
"8592",2020-01-24,"Kebler","w1920","Hybrid",NA,"Fri","weekday","sled","2","2","1",7.3,0,33,-1,23,22.1,2,1,-1,-1,1,2,1,0
"8593",2020-01-25,"Kebler","w1920","Non.motorized",6,"Sat","weekend","no_sled","2","2","1",7.4,0.1,32,-1,25,23.1,-1,2,1,-1,-2,0,1,0
"8594",2020-01-25,"Kebler","w1920","Mechanized",0,"Sat","weekend","no_sled","2","2","1",7.4,0.1,32,-1,25,23.1,-1,2,1,-1,-2,0,1,0
"8595",2020-01-25,"Kebler","w1920","Motorized",77,"Sat","weekend","sled","2","2","1",7.4,0.1,32,-1,25,23.1,-1,2,1,-1,-2,0,1,0
"8596",2020-01-25,"Kebler","w1920","Hybrid",NA,"Sat","weekend","sled","2","2","1",7.4,0.1,32,-1,25,23.1,-1,2,1,-1,-2,0,1,0
"8597",2020-01-26,"Kebler","w1920","Non.motorized",3,"Sun","weekend","no_sled","2","1","1",7.4,0,32,0,28,23.1,-1,-1,2,1,-1,-2,0,1
"8598",2020-01-26,"Kebler","w1920","Mechanized",0,"Sun","weekend","no_sled","2","1","1",7.4,0,32,0,28,23.1,-1,-1,2,1,-1,-2,0,1
"8599",2020-01-26,"Kebler","w1920","Motorized",68,"Sun","weekend","sled","2","1","1",7.4,0,32,0,28,23.1,-1,-1,2,1,-1,-2,0,1
"8600",2020-01-26,"Kebler","w1920","Hybrid",NA,"Sun","weekend","sled","2","1","1",7.4,0,32,0,28,23.1,-1,-1,2,1,-1,-2,0,1
"8601",2020-01-27,"Kebler","w1920","Non.motorized",3,"Mon","weekday","no_sled","2","1","1",7.4,0,32,0,24,23.1,0,-1,-1,2,0,-1,-2,0
"8602",2020-01-27,"Kebler","w1920","Mechanized",0,"Mon","weekday","no_sled","2","1","1",7.4,0,32,0,24,23.1,0,-1,-1,2,0,-1,-2,0
"8603",2020-01-27,"Kebler","w1920","Motorized",28,"Mon","weekday","sled","2","1","1",7.4,0,32,0,24,23.1,0,-1,-1,2,0,-1,-2,0
"8604",2020-01-27,"Kebler","w1920","Hybrid",NA,"Mon","weekday","sled","2","1","1",7.4,0,32,0,24,23.1,0,-1,-1,2,0,-1,-2,0
"8605",2020-01-28,"Kebler","w1920","Non.motorized",3,"Tue","weekday","no_sled","3","2","2",7.4,0,32,0,19,23.1,0,0,-1,-1,0,0,-1,-2
"8606",2020-01-28,"Kebler","w1920","Mechanized",0,"Tue","weekday","no_sled","3","2","2",7.4,0,32,0,19,23.1,0,0,-1,-1,0,0,-1,-2
"8607",2020-01-28,"Kebler","w1920","Motorized",53,"Tue","weekday","sled","3","2","2",7.4,0,32,0,19,23.1,0,0,-1,-1,0,0,-1,-2
"8608",2020-01-28,"Kebler","w1920","Hybrid",NA,"Tue","weekday","sled","3","2","2",7.4,0,32,0,19,23.1,0,0,-1,-1,0,0,-1,-2
"8609",2020-01-29,"Kebler","w1920","Non.motorized",4,"Wed","weekday","no_sled","2","2","1",7.4,0,31,-1,20,23.9,0,0,0,-1,-1,-1,-1,-2
"8610",2020-01-29,"Kebler","w1920","Mechanized",0,"Wed","weekday","no_sled","2","2","1",7.4,0,31,-1,20,23.9,0,0,0,-1,-1,-1,-1,-2
"8611",2020-01-29,"Kebler","w1920","Motorized",55,"Wed","weekday","sled","2","2","1",7.4,0,31,-1,20,23.9,0,0,0,-1,-1,-1,-1,-2
"8612",2020-01-29,"Kebler","w1920","Hybrid",NA,"Wed","weekday","sled","2","2","1",7.4,0,31,-1,20,23.9,0,0,0,-1,-1,-1,-1,-2
"8613",2020-01-30,"Kebler","w1920","Non.motorized",1,"Thu","weekday","no_sled","2","2","1",7.4,0,31,0,17,23.9,-1,0,0,0,-1,-1,-1,-1
"8614",2020-01-30,"Kebler","w1920","Mechanized",0,"Thu","weekday","no_sled","2","2","1",7.4,0,31,0,17,23.9,-1,0,0,0,-1,-1,-1,-1
"8615",2020-01-30,"Kebler","w1920","Motorized",71,"Thu","weekday","sled","2","2","1",7.4,0,31,0,17,23.9,-1,0,0,0,-1,-1,-1,-1
"8616",2020-01-30,"Kebler","w1920","Hybrid",NA,"Thu","weekday","sled","2","2","1",7.4,0,31,0,17,23.9,-1,0,0,0,-1,-1,-1,-1
"8617",2020-01-31,"Kebler","w1920","Non.motorized",10,"Fri","weekday","no_sled","2","1","1",7.4,0,31,0,20,23.9,0,-1,0,0,0,-1,-1,-1
"8618",2020-01-31,"Kebler","w1920","Mechanized",0,"Fri","weekday","no_sled","2","1","1",7.4,0,31,0,20,23.9,0,-1,0,0,0,-1,-1,-1
"8619",2020-01-31,"Kebler","w1920","Motorized",40,"Fri","weekday","sled","2","1","1",7.4,0,31,0,20,23.9,0,-1,0,0,0,-1,-1,-1
"8620",2020-01-31,"Kebler","w1920","Hybrid",NA,"Fri","weekday","sled","2","1","1",7.4,0,31,0,20,23.9,0,-1,0,0,0,-1,-1,-1
"8621",2020-02-01,"Kebler","w1920","Non.motorized",7,"Sat","weekend","no_sled","2","1","1",7.4,0,31,0,28,23.9,0,0,-1,0,0,0,-1,-1
"8622",2020-02-01,"Kebler","w1920","Mechanized",0,"Sat","weekend","no_sled","2","1","1",7.4,0,31,0,28,23.9,0,0,-1,0,0,0,-1,-1
"8623",2020-02-01,"Kebler","w1920","Motorized",97,"Sat","weekend","sled","2","1","1",7.4,0,31,0,28,23.9,0,0,-1,0,0,0,-1,-1
"8624",2020-02-01,"Kebler","w1920","Hybrid",NA,"Sat","weekend","sled","2","1","1",7.4,0,31,0,28,23.9,0,0,-1,0,0,0,-1,-1
"8625",2020-02-02,"Kebler","w1920","Non.motorized",11,"Sun","weekend","no_sled","1","1","1",7.4,0,31,0,33,23.9,0,0,0,-1,0,0,0,-1
"8626",2020-02-02,"Kebler","w1920","Mechanized",0,"Sun","weekend","no_sled","1","1","1",7.4,0,31,0,33,23.9,0,0,0,-1,0,0,0,-1
"8627",2020-02-02,"Kebler","w1920","Motorized",92,"Sun","weekend","sled","1","1","1",7.4,0,31,0,33,23.9,0,0,0,-1,0,0,0,-1
"8628",2020-02-02,"Kebler","w1920","Hybrid",NA,"Sun","weekend","sled","1","1","1",7.4,0,31,0,33,23.9,0,0,0,-1,0,0,0,-1
"8629",2020-02-03,"Kebler","w1920","Non.motorized",3,"Mon","weekday","no_sled","2","2","1",7.4,0,31,0,24,23.9,0,0,0,0,0,0,0,0
"8630",2020-02-03,"Kebler","w1920","Mechanized",0,"Mon","weekday","no_sled","2","2","1",7.4,0,31,0,24,23.9,0,0,0,0,0,0,0,0
"8631",2020-02-03,"Kebler","w1920","Motorized",47,"Mon","weekday","sled","2","2","1",7.4,0,31,0,24,23.9,0,0,0,0,0,0,0,0
"8632",2020-02-03,"Kebler","w1920","Hybrid",NA,"Mon","weekday","sled","2","2","1",7.4,0,31,0,24,23.9,0,0,0,0,0,0,0,0
"8633",2020-02-04,"Kebler","w1920","Non.motorized",1,"Tue","weekday","no_sled","2","2","2",7.4,0,33,2,5,22.4,0,0,0,0,2,2,2,2
"8634",2020-02-04,"Kebler","w1920","Mechanized",0,"Tue","weekday","no_sled","2","2","2",7.4,0,33,2,5,22.4,0,0,0,0,2,2,2,2
"8635",2020-02-04,"Kebler","w1920","Motorized",34,"Tue","weekday","sled","2","2","2",7.4,0,33,2,5,22.4,0,0,0,0,2,2,2,2
"8636",2020-02-04,"Kebler","w1920","Hybrid",NA,"Tue","weekday","sled","2","2","2",7.4,0,33,2,5,22.4,0,0,0,0,2,2,2,2
"8637",2020-02-05,"Kebler","w1920","Non.motorized",4,"Wed","weekday","no_sled","2","2","1",7.4,0,33,0,2,22.4,2,0,0,0,2,2,2,2
"8638",2020-02-05,"Kebler","w1920","Mechanized",0,"Wed","weekday","no_sled","2","2","1",7.4,0,33,0,2,22.4,2,0,0,0,2,2,2,2
"8639",2020-02-05,"Kebler","w1920","Motorized",42,"Wed","weekday","sled","2","2","1",7.4,0,33,0,2,22.4,2,0,0,0,2,2,2,2
"8640",2020-02-05,"Kebler","w1920","Hybrid",NA,"Wed","weekday","sled","2","2","1",7.4,0,33,0,2,22.4,2,0,0,0,2,2,2,2
"8641",2020-02-06,"Kebler","w1920","Non.motorized",3,"Thu","weekday","no_sled","2","2","1",7.5,0.1,32,-1,16,23.4,0,2,0,0,-1,1,1,1
"8642",2020-02-06,"Kebler","w1920","Mechanized",0,"Thu","weekday","no_sled","2","2","1",7.5,0.1,32,-1,16,23.4,0,2,0,0,-1,1,1,1
"8643",2020-02-06,"Kebler","w1920","Motorized",39,"Thu","weekday","sled","2","2","1",7.5,0.1,32,-1,16,23.4,0,2,0,0,-1,1,1,1
"8644",2020-02-06,"Kebler","w1920","Hybrid",NA,"Thu","weekday","sled","2","2","1",7.5,0.1,32,-1,16,23.4,0,2,0,0,-1,1,1,1
"8645",2020-02-07,"Kebler","w1920","Non.motorized",NA,"Fri","weekday","no_sled","3","3","3",7.9,0.4,37,5,26,21.4,-1,0,2,0,4,4,6,6
"8646",2020-02-07,"Kebler","w1920","Mechanized",NA,"Fri","weekday","no_sled","3","3","3",7.9,0.4,37,5,26,21.4,-1,0,2,0,4,4,6,6
"8647",2020-02-07,"Kebler","w1920","Motorized",NA,"Fri","weekday","sled","3","3","3",7.9,0.4,37,5,26,21.4,-1,0,2,0,4,4,6,6
"8648",2020-02-07,"Kebler","w1920","Hybrid",NA,"Fri","weekday","sled","3","3","3",7.9,0.4,37,5,26,21.4,-1,0,2,0,4,4,6,6
"8649",2020-02-08,"Kebler","w1920","Non.motorized",3,"Sat","weekend","no_sled","3","3","2",8.3,0.4,39,2,30,21.3,5,-1,0,2,7,6,6,8
"8650",2020-02-08,"Kebler","w1920","Mechanized",0,"Sat","weekend","no_sled","3","3","2",8.3,0.4,39,2,30,21.3,5,-1,0,2,7,6,6,8
"8651",2020-02-08,"Kebler","w1920","Motorized",13,"Sat","weekend","sled","3","3","2",8.3,0.4,39,2,30,21.3,5,-1,0,2,7,6,6,8
"8652",2020-02-08,"Kebler","w1920","Hybrid",NA,"Sat","weekend","sled","3","3","2",8.3,0.4,39,2,30,21.3,5,-1,0,2,7,6,6,8
"8653",2020-02-09,"Kebler","w1920","Non.motorized",13,"Sun","weekend","no_sled","3","2","2",8.4,0.1,38,-1,26,22.1,2,5,-1,0,1,6,5,5
"8654",2020-02-09,"Kebler","w1920","Mechanized",0,"Sun","weekend","no_sled","3","2","2",8.4,0.1,38,-1,26,22.1,2,5,-1,0,1,6,5,5
"8655",2020-02-09,"Kebler","w1920","Motorized",56,"Sun","weekend","sled","3","2","2",8.4,0.1,38,-1,26,22.1,2,5,-1,0,1,6,5,5
"8656",2020-02-09,"Kebler","w1920","Hybrid",NA,"Sun","weekend","sled","3","2","2",8.4,0.1,38,-1,26,22.1,2,5,-1,0,1,6,5,5
"8657",2020-02-10,"Kebler","w1920","Non.motorized",17,"Mon","weekday","no_sled","2","2","1",8.4,0,38,0,22,22.1,-1,2,5,-1,-1,1,6,5
"8658",2020-02-10,"Kebler","w1920","Mechanized",0,"Mon","weekday","no_sled","2","2","1",8.4,0,38,0,22,22.1,-1,2,5,-1,-1,1,6,5
"8659",2020-02-10,"Kebler","w1920","Motorized",16,"Mon","weekday","sled","2","2","1",8.4,0,38,0,22,22.1,-1,2,5,-1,-1,1,6,5
"8660",2020-02-10,"Kebler","w1920","Hybrid",NA,"Mon","weekday","sled","2","2","1",8.4,0,38,0,22,22.1,-1,2,5,-1,-1,1,6,5
"8661",2020-02-11,"Kebler","w1920","Non.motorized",1,"Tue","weekday","no_sled","2","2","2",8.5,0.1,40,2,16,21.2,0,-1,2,5,2,1,3,8
"8662",2020-02-11,"Kebler","w1920","Mechanized",0,"Tue","weekday","no_sled","2","2","2",8.5,0.1,40,2,16,21.2,0,-1,2,5,2,1,3,8
"8663",2020-02-11,"Kebler","w1920","Motorized",36,"Tue","weekday","sled","2","2","2",8.5,0.1,40,2,16,21.2,0,-1,2,5,2,1,3,8
"8664",2020-02-11,"Kebler","w1920","Hybrid",NA,"Tue","weekday","sled","2","2","2",8.5,0.1,40,2,16,21.2,0,-1,2,5,2,1,3,8
"8665",2020-02-12,"Kebler","w1920","Non.motorized",0,"Wed","weekday","no_sled","2","2","2",8.5,0,39,-1,15,21.8,2,0,-1,2,1,1,0,2
"8666",2020-02-12,"Kebler","w1920","Mechanized",0,"Wed","weekday","no_sled","2","2","2",8.5,0,39,-1,15,21.8,2,0,-1,2,1,1,0,2
"8667",2020-02-12,"Kebler","w1920","Motorized",23,"Wed","weekday","sled","2","2","2",8.5,0,39,-1,15,21.8,2,0,-1,2,1,1,0,2
"8668",2020-02-12,"Kebler","w1920","Hybrid",NA,"Wed","weekday","sled","2","2","2",8.5,0,39,-1,15,21.8,2,0,-1,2,1,1,0,2
"8669",2020-02-13,"Kebler","w1920","Non.motorized",2,"Thu","weekday","no_sled","2","2","1",8.5,0,39,0,18,21.8,-1,2,0,-1,-1,1,1,0
"8670",2020-02-13,"Kebler","w1920","Mechanized",0,"Thu","weekday","no_sled","2","2","1",8.5,0,39,0,18,21.8,-1,2,0,-1,-1,1,1,0
"8671",2020-02-13,"Kebler","w1920","Motorized",28,"Thu","weekday","sled","2","2","1",8.5,0,39,0,18,21.8,-1,2,0,-1,-1,1,1,0
"8672",2020-02-13,"Kebler","w1920","Hybrid",NA,"Thu","weekday","sled","2","2","1",8.5,0,39,0,18,21.8,-1,2,0,-1,-1,1,1,0
"8673",2020-02-14,"Kebler","w1920","Non.motorized",3,"Fri","weekday","no_sled","2","1","1",8.6,0.1,38,-1,24,22.6,0,-1,2,0,-1,-2,0,0
"8674",2020-02-14,"Kebler","w1920","Mechanized",0,"Fri","weekday","no_sled","2","1","1",8.6,0.1,38,-1,24,22.6,0,-1,2,0,-1,-2,0,0
"8675",2020-02-14,"Kebler","w1920","Motorized",33,"Fri","weekday","sled","2","1","1",8.6,0.1,38,-1,24,22.6,0,-1,2,0,-1,-2,0,0
"8676",2020-02-14,"Kebler","w1920","Hybrid",NA,"Fri","weekday","sled","2","1","1",8.6,0.1,38,-1,24,22.6,0,-1,2,0,-1,-2,0,0
"8677",2020-02-15,"Kebler","w1920","Non.motorized",5,"Sat","weekend","no_sled","1","1","1",8.6,0,38,0,26,22.6,-1,0,-1,2,-1,-1,-2,0
"8678",2020-02-15,"Kebler","w1920","Mechanized",0,"Sat","weekend","no_sled","1","1","1",8.6,0,38,0,26,22.6,-1,0,-1,2,-1,-1,-2,0
"8679",2020-02-15,"Kebler","w1920","Motorized",35,"Sat","weekend","sled","1","1","1",8.6,0,38,0,26,22.6,-1,0,-1,2,-1,-1,-2,0
"8680",2020-02-15,"Kebler","w1920","Hybrid",NA,"Sat","weekend","sled","1","1","1",8.6,0,38,0,26,22.6,-1,0,-1,2,-1,-1,-2,0
"8681",2020-02-16,"Kebler","w1920","Non.motorized",1,"Sun","weekend","no_sled","1","1","1",8.8,0.2,37,-1,26,23.8,0,-1,0,-1,-1,-2,-2,-3
"8682",2020-02-16,"Kebler","w1920","Mechanized",1,"Sun","weekend","no_sled","1","1","1",8.8,0.2,37,-1,26,23.8,0,-1,0,-1,-1,-2,-2,-3
"8683",2020-02-16,"Kebler","w1920","Motorized",51,"Sun","weekend","sled","1","1","1",8.8,0.2,37,-1,26,23.8,0,-1,0,-1,-1,-2,-2,-3
"8684",2020-02-16,"Kebler","w1920","Hybrid",NA,"Sun","weekend","sled","1","1","1",8.8,0.2,37,-1,26,23.8,0,-1,0,-1,-1,-2,-2,-3
"8685",2020-02-17,"Kebler","w1920","Non.motorized",3,"Mon","weekday","no_sled","2","1","1",9.2,0.4,43,6,25,21.4,-1,0,-1,0,5,5,4,4
"8686",2020-02-17,"Kebler","w1920","Mechanized",0,"Mon","weekday","no_sled","2","1","1",9.2,0.4,43,6,25,21.4,-1,0,-1,0,5,5,4,4
"8687",2020-02-17,"Kebler","w1920","Motorized",9,"Mon","weekday","sled","2","1","1",9.2,0.4,43,6,25,21.4,-1,0,-1,0,5,5,4,4
"8688",2020-02-17,"Kebler","w1920","Hybrid",NA,"Mon","weekday","sled","2","1","1",9.2,0.4,43,6,25,21.4,-1,0,-1,0,5,5,4,4
"8689",2020-02-18,"Kebler","w1920","Non.motorized",0,"Tue","weekday","no_sled","1","1","1",9.3,0.1,42,-1,18,22.1,6,-1,0,-1,5,4,4,3
"8690",2020-02-18,"Kebler","w1920","Mechanized",0,"Tue","weekday","no_sled","1","1","1",9.3,0.1,42,-1,18,22.1,6,-1,0,-1,5,4,4,3
"8691",2020-02-18,"Kebler","w1920","Motorized",27,"Tue","weekday","sled","1","1","1",9.3,0.1,42,-1,18,22.1,6,-1,0,-1,5,4,4,3
"8692",2020-02-18,"Kebler","w1920","Hybrid",NA,"Tue","weekday","sled","1","1","1",9.3,0.1,42,-1,18,22.1,6,-1,0,-1,5,4,4,3
"8693",2020-02-19,"Kebler","w1920","Non.motorized",2,"Wed","weekday","no_sled","1","1","1",9.3,0,41,-1,22,22.7,-1,6,-1,0,-2,4,3,3
"8694",2020-02-19,"Kebler","w1920","Mechanized",0,"Wed","weekday","no_sled","1","1","1",9.3,0,41,-1,22,22.7,-1,6,-1,0,-2,4,3,3
"8695",2020-02-19,"Kebler","w1920","Motorized",40,"Wed","weekday","sled","1","1","1",9.3,0,41,-1,22,22.7,-1,6,-1,0,-2,4,3,3
"8696",2020-02-19,"Kebler","w1920","Hybrid",NA,"Wed","weekday","sled","1","1","1",9.3,0,41,-1,22,22.7,-1,6,-1,0,-2,4,3,3
"8697",2020-02-20,"Kebler","w1920","Non.motorized",3,"Thu","weekday","no_sled","1","1","1",9.3,0,41,0,18,22.7,-1,-1,6,-1,-1,-2,4,3
"8698",2020-02-20,"Kebler","w1920","Mechanized",1,"Thu","weekday","no_sled","1","1","1",9.3,0,41,0,18,22.7,-1,-1,6,-1,-1,-2,4,3
"8699",2020-02-20,"Kebler","w1920","Motorized",47,"Thu","weekday","sled","1","1","1",9.3,0,41,0,18,22.7,-1,-1,6,-1,-1,-2,4,3
"8700",2020-02-20,"Kebler","w1920","Hybrid",NA,"Thu","weekday","sled","1","1","1",9.3,0,41,0,18,22.7,-1,-1,6,-1,-1,-2,4,3
"8701",2020-02-21,"Kebler","w1920","Non.motorized",4,"Fri","weekday","no_sled","1","1","1",9.3,0,40,-1,26,23.2,0,-1,-1,6,-1,-2,-3,3
"8702",2020-02-21,"Kebler","w1920","Mechanized",0,"Fri","weekday","no_sled","1","1","1",9.3,0,40,-1,26,23.2,0,-1,-1,6,-1,-2,-3,3
"8703",2020-02-21,"Kebler","w1920","Motorized",80,"Fri","weekday","sled","1","1","1",9.3,0,40,-1,26,23.2,0,-1,-1,6,-1,-2,-3,3
"8704",2020-02-21,"Kebler","w1920","Hybrid",NA,"Fri","weekday","sled","1","1","1",9.3,0,40,-1,26,23.2,0,-1,-1,6,-1,-2,-3,3
"8705",2020-02-22,"Kebler","w1920","Non.motorized",4,"Sat","weekend","no_sled","1","1","1",9.4,0.1,39,-1,32,24.1,-1,0,-1,-1,-2,-2,-3,-4
"8706",2020-02-22,"Kebler","w1920","Mechanized",0,"Sat","weekend","no_sled","1","1","1",9.4,0.1,39,-1,32,24.1,-1,0,-1,-1,-2,-2,-3,-4
"8707",2020-02-22,"Kebler","w1920","Motorized",86,"Sat","weekend","sled","1","1","1",9.4,0.1,39,-1,32,24.1,-1,0,-1,-1,-2,-2,-3,-4
"8708",2020-02-22,"Kebler","w1920","Hybrid",NA,"Sat","weekend","sled","1","1","1",9.4,0.1,39,-1,32,24.1,-1,0,-1,-1,-2,-2,-3,-4
"8709",2020-02-23,"Kebler","w1920","Non.motorized",1,"Sun","weekend","no_sled","2","2","2",9.5,0.1,40,1,27,23.8,-1,-1,0,-1,0,-1,-1,-2
"8710",2020-02-23,"Kebler","w1920","Mechanized",0,"Sun","weekend","no_sled","2","2","2",9.5,0.1,40,1,27,23.8,-1,-1,0,-1,0,-1,-1,-2
"8711",2020-02-23,"Kebler","w1920","Motorized",25,"Sun","weekend","sled","2","2","2",9.5,0.1,40,1,27,23.8,-1,-1,0,-1,0,-1,-1,-2
"8712",2020-02-23,"Kebler","w1920","Hybrid",NA,"Sun","weekend","sled","2","2","2",9.5,0.1,40,1,27,23.8,-1,-1,0,-1,0,-1,-1,-2
"8713",2020-02-24,"Kebler","w1920","Non.motorized",4,"Mon","weekday","no_sled","3","3","2",9.8,0.3,43,3,17,22.8,1,-1,-1,0,4,3,2,2
"8714",2020-02-24,"Kebler","w1920","Mechanized",0,"Mon","weekday","no_sled","3","3","2",9.8,0.3,43,3,17,22.8,1,-1,-1,0,4,3,2,2
"8715",2020-02-24,"Kebler","w1920","Motorized",10,"Mon","weekday","sled","3","3","2",9.8,0.3,43,3,17,22.8,1,-1,-1,0,4,3,2,2
"8716",2020-02-24,"Kebler","w1920","Hybrid",NA,"Mon","weekday","sled","3","3","2",9.8,0.3,43,3,17,22.8,1,-1,-1,0,4,3,2,2
"8717",2020-02-25,"Kebler","w1920","Non.motorized",2,"Tue","weekday","no_sled","2","2","1",9.8,0,43,0,8,22.8,3,1,-1,-1,3,4,3,2
"8718",2020-02-25,"Kebler","w1920","Mechanized",0,"Tue","weekday","no_sled","2","2","1",9.8,0,43,0,8,22.8,3,1,-1,-1,3,4,3,2
"8719",2020-02-25,"Kebler","w1920","Motorized",35,"Tue","weekday","sled","2","2","1",9.8,0,43,0,8,22.8,3,1,-1,-1,3,4,3,2
"8720",2020-02-25,"Kebler","w1920","Hybrid",NA,"Tue","weekday","sled","2","2","1",9.8,0,43,0,8,22.8,3,1,-1,-1,3,4,3,2
"8721",2020-02-26,"Kebler","w1920","Non.motorized",1,"Wed","weekday","no_sled","2","2","1",9.8,0,42,-1,15,23.3,0,3,1,-1,-1,2,3,2
"8722",2020-02-26,"Kebler","w1920","Mechanized",0,"Wed","weekday","no_sled","2","2","1",9.8,0,42,-1,15,23.3,0,3,1,-1,-1,2,3,2
"8723",2020-02-26,"Kebler","w1920","Motorized",42,"Wed","weekday","sled","2","2","1",9.8,0,42,-1,15,23.3,0,3,1,-1,-1,2,3,2
"8724",2020-02-26,"Kebler","w1920","Hybrid",NA,"Wed","weekday","sled","2","2","1",9.8,0,42,-1,15,23.3,0,3,1,-1,-1,2,3,2
"8725",2020-02-27,"Kebler","w1920","Non.motorized",12,"Thu","weekday","no_sled","2","2","1",9.9,0.1,41,-1,25,24.1,-1,0,3,1,-2,-2,1,2
"8726",2020-02-27,"Kebler","w1920","Mechanized",1,"Thu","weekday","no_sled","2","2","1",9.9,0.1,41,-1,25,24.1,-1,0,3,1,-2,-2,1,2
"8727",2020-02-27,"Kebler","w1920","Motorized",56,"Thu","weekday","sled","2","2","1",9.9,0.1,41,-1,25,24.1,-1,0,3,1,-2,-2,1,2
"8728",2020-02-27,"Kebler","w1920","Hybrid",NA,"Thu","weekday","sled","2","2","1",9.9,0.1,41,-1,25,24.1,-1,0,3,1,-2,-2,1,2
"8729",2020-02-28,"Kebler","w1920","Non.motorized",6,"Fri","weekday","no_sled","2","1","1",9.9,0,41,0,28,24.1,-1,-1,0,3,-1,-2,-2,1
"8730",2020-02-28,"Kebler","w1920","Mechanized",0,"Fri","weekday","no_sled","2","1","1",9.9,0,41,0,28,24.1,-1,-1,0,3,-1,-2,-2,1
"8731",2020-02-28,"Kebler","w1920","Motorized",86,"Fri","weekday","sled","2","1","1",9.9,0,41,0,28,24.1,-1,-1,0,3,-1,-2,-2,1
"8732",2020-02-28,"Kebler","w1920","Hybrid",NA,"Fri","weekday","sled","2","1","1",9.9,0,41,0,28,24.1,-1,-1,0,3,-1,-2,-2,1
"8733",2020-02-29,"Kebler","w1920","Non.motorized",13,"Sat","weekend","no_sled","1","1","1",9.9,0,40,-1,29,24.8,0,-1,-1,0,-1,-2,-3,-3
"8734",2020-02-29,"Kebler","w1920","Mechanized",1,"Sat","weekend","no_sled","1","1","1",9.9,0,40,-1,29,24.8,0,-1,-1,0,-1,-2,-3,-3
"8735",2020-02-29,"Kebler","w1920","Motorized",147,"Sat","weekend","sled","1","1","1",9.9,0,40,-1,29,24.8,0,-1,-1,0,-1,-2,-3,-3
"8736",2020-02-29,"Kebler","w1920","Hybrid",NA,"Sat","weekend","sled","1","1","1",9.9,0,40,-1,29,24.8,0,-1,-1,0,-1,-2,-3,-3
"8737",2020-03-01,"Kebler","w1920","Non.motorized",3,"Sun","weekend","no_sled","1","1","1",10,0.1,40,0,28,25,-1,0,-1,-1,-1,-1,-2,-3
"8738",2020-03-01,"Kebler","w1920","Mechanized",2,"Sun","weekend","no_sled","1","1","1",10,0.1,40,0,28,25,-1,0,-1,-1,-1,-1,-2,-3
"8739",2020-03-01,"Kebler","w1920","Motorized",83,"Sun","weekend","sled","1","1","1",10,0.1,40,0,28,25,-1,0,-1,-1,-1,-1,-2,-3
"8740",2020-03-01,"Kebler","w1920","Hybrid",NA,"Sun","weekend","sled","1","1","1",10,0.1,40,0,28,25,-1,0,-1,-1,-1,-1,-2,-3
"8741",2020-03-02,"Kebler","w1920","Non.motorized",8,"Mon","weekday","no_sled","2","2","1",10.4,0.4,45,5,25,23.1,0,-1,0,-1,5,4,4,3
"8742",2020-03-02,"Kebler","w1920","Mechanized",1,"Mon","weekday","no_sled","2","2","1",10.4,0.4,45,5,25,23.1,0,-1,0,-1,5,4,4,3
"8743",2020-03-02,"Kebler","w1920","Motorized",62,"Mon","weekday","sled","2","2","1",10.4,0.4,45,5,25,23.1,0,-1,0,-1,5,4,4,3
"8744",2020-03-02,"Kebler","w1920","Hybrid",NA,"Mon","weekday","sled","2","2","1",10.4,0.4,45,5,25,23.1,0,-1,0,-1,5,4,4,3
"8745",2020-03-03,"Kebler","w1920","Non.motorized",0,"Tue","weekday","no_sled","2","1","1",10.9,0.5,50,5,25,21.8,5,0,-1,0,10,10,9,9
"8746",2020-03-03,"Kebler","w1920","Mechanized",0,"Tue","weekday","no_sled","2","1","1",10.9,0.5,50,5,25,21.8,5,0,-1,0,10,10,9,9
"8747",2020-03-03,"Kebler","w1920","Motorized",10,"Tue","weekday","sled","2","1","1",10.9,0.5,50,5,25,21.8,5,0,-1,0,10,10,9,9
"8748",2020-03-03,"Kebler","w1920","Hybrid",NA,"Tue","weekday","sled","2","1","1",10.9,0.5,50,5,25,21.8,5,0,-1,0,10,10,9,9
"8749",2020-03-04,"Kebler","w1920","Non.motorized",2,"Wed","weekday","no_sled","2","1","1",10.9,0,48,-2,29,22.7,5,5,0,-1,3,8,8,7
"8750",2020-03-04,"Kebler","w1920","Mechanized",0,"Wed","weekday","no_sled","2","1","1",10.9,0,48,-2,29,22.7,5,5,0,-1,3,8,8,7
"8751",2020-03-04,"Kebler","w1920","Motorized",8,"Wed","weekday","sled","2","1","1",10.9,0,48,-2,29,22.7,5,5,0,-1,3,8,8,7
"8752",2020-03-04,"Kebler","w1920","Hybrid",NA,"Wed","weekday","sled","2","1","1",10.9,0,48,-2,29,22.7,5,5,0,-1,3,8,8,7
"8753",2020-03-05,"Kebler","w1920","Non.motorized",1,"Thu","weekday","no_sled","2","1","1",10.9,0,46,-2,32,23.7,-2,5,5,0,-4,1,6,6
"8754",2020-03-05,"Kebler","w1920","Mechanized",0,"Thu","weekday","no_sled","2","1","1",10.9,0,46,-2,32,23.7,-2,5,5,0,-4,1,6,6
"8755",2020-03-05,"Kebler","w1920","Motorized",57,"Thu","weekday","sled","2","1","1",10.9,0,46,-2,32,23.7,-2,5,5,0,-4,1,6,6
"8756",2020-03-05,"Kebler","w1920","Hybrid",NA,"Thu","weekday","sled","2","1","1",10.9,0,46,-2,32,23.7,-2,5,5,0,-4,1,6,6
"8757",2020-03-06,"Kebler","w1920","Non.motorized",2,"Fri","weekday","no_sled","1","1","1",10.9,0,45,-1,34,24.2,-2,-2,5,5,-3,-5,0,5
"8758",2020-03-06,"Kebler","w1920","Mechanized",0,"Fri","weekday","no_sled","1","1","1",10.9,0,45,-1,34,24.2,-2,-2,5,5,-3,-5,0,5
"8759",2020-03-06,"Kebler","w1920","Motorized",87,"Fri","weekday","sled","1","1","1",10.9,0,45,-1,34,24.2,-2,-2,5,5,-3,-5,0,5
"8760",2020-03-06,"Kebler","w1920","Hybrid",NA,"Fri","weekday","sled","1","1","1",10.9,0,45,-1,34,24.2,-2,-2,5,5,-3,-5,0,5
"8761",2020-03-07,"Kebler","w1920","Non.motorized",14,"Sat","weekend","no_sled","1","1","2",10.9,0,44,-1,35,24.8,-1,-2,-2,5,-2,-4,-6,-1
"8762",2020-03-07,"Kebler","w1920","Mechanized",3,"Sat","weekend","no_sled","1","1","2",10.9,0,44,-1,35,24.8,-1,-2,-2,5,-2,-4,-6,-1
"8763",2020-03-07,"Kebler","w1920","Motorized",92,"Sat","weekend","sled","1","1","2",10.9,0,44,-1,35,24.8,-1,-2,-2,5,-2,-4,-6,-1
"8764",2020-03-07,"Kebler","w1920","Hybrid",NA,"Sat","weekend","sled","1","1","2",10.9,0,44,-1,35,24.8,-1,-2,-2,5,-2,-4,-6,-1
"8765",2020-03-08,"Kebler","w1920","Non.motorized",15,"Sun","weekend","no_sled","1","1","1",11,0.1,43,-1,33,25.6,-1,-1,-2,-2,-2,-3,-5,-7
"8766",2020-03-08,"Kebler","w1920","Mechanized",0,"Sun","weekend","no_sled","1","1","1",11,0.1,43,-1,33,25.6,-1,-1,-2,-2,-2,-3,-5,-7
"8767",2020-03-08,"Kebler","w1920","Motorized",60,"Sun","weekend","sled","1","1","1",11,0.1,43,-1,33,25.6,-1,-1,-2,-2,-2,-3,-5,-7
"8768",2020-03-08,"Kebler","w1920","Hybrid",NA,"Sun","weekend","sled","1","1","1",11,0.1,43,-1,33,25.6,-1,-1,-2,-2,-2,-3,-5,-7
"8769",2020-03-09,"Kebler","w1920","Non.motorized",1,"Mon","weekday","no_sled","1","1","1",11.1,0.1,42,-1,31,26.4,-1,-1,-1,-2,-2,-3,-4,-6
"8770",2020-03-09,"Kebler","w1920","Mechanized",0,"Mon","weekday","no_sled","1","1","1",11.1,0.1,42,-1,31,26.4,-1,-1,-1,-2,-2,-3,-4,-6
"8771",2020-03-09,"Kebler","w1920","Motorized",47,"Mon","weekday","sled","1","1","1",11.1,0.1,42,-1,31,26.4,-1,-1,-1,-2,-2,-3,-4,-6
"8772",2020-03-09,"Kebler","w1920","Hybrid",NA,"Mon","weekday","sled","1","1","1",11.1,0.1,42,-1,31,26.4,-1,-1,-1,-2,-2,-3,-4,-6
"8773",2020-03-10,"Kebler","w1920","Non.motorized",13,"Tue","weekday","no_sled","1","1","2",11.2,0.1,44,2,31,25.5,-1,-1,-1,-1,1,0,-1,-2
"8774",2020-03-10,"Kebler","w1920","Mechanized",0,"Tue","weekday","no_sled","1","1","2",11.2,0.1,44,2,31,25.5,-1,-1,-1,-1,1,0,-1,-2
"8775",2020-03-10,"Kebler","w1920","Motorized",102,"Tue","weekday","sled","1","1","2",11.2,0.1,44,2,31,25.5,-1,-1,-1,-1,1,0,-1,-2
"8776",2020-03-10,"Kebler","w1920","Hybrid",NA,"Tue","weekday","sled","1","1","2",11.2,0.1,44,2,31,25.5,-1,-1,-1,-1,1,0,-1,-2
"8777",2020-03-11,"Kebler","w1920","Non.motorized",7,"Wed","weekday","no_sled","2","2","1",11.2,0,44,0,32,25.5,2,-1,-1,-1,2,1,0,-1
"8778",2020-03-11,"Kebler","w1920","Mechanized",0,"Wed","weekday","no_sled","2","2","1",11.2,0,44,0,32,25.5,2,-1,-1,-1,2,1,0,-1
"8779",2020-03-11,"Kebler","w1920","Motorized",136,"Wed","weekday","sled","2","2","1",11.2,0,44,0,32,25.5,2,-1,-1,-1,2,1,0,-1
"8780",2020-03-11,"Kebler","w1920","Hybrid",NA,"Wed","weekday","sled","2","2","1",11.2,0,44,0,32,25.5,2,-1,-1,-1,2,1,0,-1
"8781",2020-03-12,"Kebler","w1920","Non.motorized",9,"Thu","weekday","no_sled","2","2","2",11.4,0.2,42,-2,35,27.1,0,2,-1,-1,-2,0,-1,-2
"8782",2020-03-12,"Kebler","w1920","Mechanized",0,"Thu","weekday","no_sled","2","2","2",11.4,0.2,42,-2,35,27.1,0,2,-1,-1,-2,0,-1,-2
"8783",2020-03-12,"Kebler","w1920","Motorized",114,"Thu","weekday","sled","2","2","2",11.4,0.2,42,-2,35,27.1,0,2,-1,-1,-2,0,-1,-2
"8784",2020-03-12,"Kebler","w1920","Hybrid",NA,"Thu","weekday","sled","2","2","2",11.4,0.2,42,-2,35,27.1,0,2,-1,-1,-2,0,-1,-2
"8785",2020-03-13,"Kebler","w1920","Non.motorized",3,"Fri","weekday","no_sled","3","3","2",11.5,0.1,44,2,31,26.1,-2,0,2,-1,0,0,2,1
"8786",2020-03-13,"Kebler","w1920","Mechanized",0,"Fri","weekday","no_sled","3","3","2",11.5,0.1,44,2,31,26.1,-2,0,2,-1,0,0,2,1
"8787",2020-03-13,"Kebler","w1920","Motorized",62,"Fri","weekday","sled","3","3","2",11.5,0.1,44,2,31,26.1,-2,0,2,-1,0,0,2,1
"8788",2020-03-13,"Kebler","w1920","Hybrid",NA,"Fri","weekday","sled","3","3","2",11.5,0.1,44,2,31,26.1,-2,0,2,-1,0,0,2,1
"8789",2020-03-14,"Kebler","w1920","Non.motorized",1,"Sat","weekend","no_sled","3","3","3",11.7,0.2,44,0,31,26.6,2,-2,0,2,2,0,0,2
"8790",2020-03-14,"Kebler","w1920","Mechanized",0,"Sat","weekend","no_sled","3","3","3",11.7,0.2,44,0,31,26.6,2,-2,0,2,2,0,0,2
"8791",2020-03-14,"Kebler","w1920","Motorized",26,"Sat","weekend","sled","3","3","3",11.7,0.2,44,0,31,26.6,2,-2,0,2,2,0,0,2
"8792",2020-03-14,"Kebler","w1920","Hybrid",NA,"Sat","weekend","sled","3","3","3",11.7,0.2,44,0,31,26.6,2,-2,0,2,2,0,0,2
"8793",2020-03-15,"Kebler","w1920","Non.motorized",5,"Sun","weekend","no_sled","2","2","2",11.7,0,45,1,33,26,0,2,-2,0,1,3,1,1
"8794",2020-03-15,"Kebler","w1920","Mechanized",1,"Sun","weekend","no_sled","2","2","2",11.7,0,45,1,33,26,0,2,-2,0,1,3,1,1
"8795",2020-03-15,"Kebler","w1920","Motorized",75,"Sun","weekend","sled","2","2","2",11.7,0,45,1,33,26,0,2,-2,0,1,3,1,1
"8796",2020-03-15,"Kebler","w1920","Hybrid",NA,"Sun","weekend","sled","2","2","2",11.7,0,45,1,33,26,0,2,-2,0,1,3,1,1
"8797",2020-03-16,"Kebler","w1920","Non.motorized",10,"Mon","weekday","no_sled","2","2","2",11.7,0,45,0,35,26,1,0,2,-2,1,1,3,1
"8798",2020-03-16,"Kebler","w1920","Mechanized",1,"Mon","weekday","no_sled","2","2","2",11.7,0,45,0,35,26,1,0,2,-2,1,1,3,1
"8799",2020-03-16,"Kebler","w1920","Motorized",199,"Mon","weekday","sled","2","2","2",11.7,0,45,0,35,26,1,0,2,-2,1,1,3,1
"8800",2020-03-16,"Kebler","w1920","Hybrid",NA,"Mon","weekday","sled","2","2","2",11.7,0,45,0,35,26,1,0,2,-2,1,1,3,1
"8801",2020-03-17,"Kebler","w1920","Non.motorized",9,"Tue","weekday","no_sled","2","2","2",11.7,0,44,-1,36,26.6,0,1,0,2,-1,0,0,2
"8802",2020-03-17,"Kebler","w1920","Mechanized",1,"Tue","weekday","no_sled","2","2","2",11.7,0,44,-1,36,26.6,0,1,0,2,-1,0,0,2
"8803",2020-03-17,"Kebler","w1920","Motorized",169,"Tue","weekday","sled","2","2","2",11.7,0,44,-1,36,26.6,0,1,0,2,-1,0,0,2
"8804",2020-03-17,"Kebler","w1920","Hybrid",NA,"Tue","weekday","sled","2","2","2",11.7,0,44,-1,36,26.6,0,1,0,2,-1,0,0,2
"8805",2020-03-18,"Kebler","w1920","Non.motorized",13,"Wed","weekday","no_sled","2","2","2",11.7,0,43,-1,33,27.2,-1,0,1,0,-2,-2,-1,-1
"8806",2020-03-18,"Kebler","w1920","Mechanized",0,"Wed","weekday","no_sled","2","2","2",11.7,0,43,-1,33,27.2,-1,0,1,0,-2,-2,-1,-1
"8807",2020-03-18,"Kebler","w1920","Motorized",53,"Wed","weekday","sled","2","2","2",11.7,0,43,-1,33,27.2,-1,0,1,0,-2,-2,-1,-1
"8808",2020-03-18,"Kebler","w1920","Hybrid",NA,"Wed","weekday","sled","2","2","2",11.7,0,43,-1,33,27.2,-1,0,1,0,-2,-2,-1,-1
"8809",2020-03-19,"Kebler","w1920","Non.motorized",30,"Thu","weekday","no_sled","3","3","3",11.8,0.1,43,0,27,27.4,-1,-1,0,1,-1,-2,-2,-1
"8810",2020-03-19,"Kebler","w1920","Mechanized",1,"Thu","weekday","no_sled","3","3","3",11.8,0.1,43,0,27,27.4,-1,-1,0,1,-1,-2,-2,-1
"8811",2020-03-19,"Kebler","w1920","Motorized",44,"Thu","weekday","sled","3","3","3",11.8,0.1,43,0,27,27.4,-1,-1,0,1,-1,-2,-2,-1
"8812",2020-03-19,"Kebler","w1920","Hybrid",NA,"Thu","weekday","sled","3","3","3",11.8,0.1,43,0,27,27.4,-1,-1,0,1,-1,-2,-2,-1
"8813",2020-03-20,"Kebler","w1920","Non.motorized",26,"Fri","weekday","no_sled","3","3","2",12.7,0.9,52,9,26,24.4,0,-1,-1,0,9,8,7,7
"8814",2020-03-20,"Kebler","w1920","Mechanized",2,"Fri","weekday","no_sled","3","3","2",12.7,0.9,52,9,26,24.4,0,-1,-1,0,9,8,7,7
"8815",2020-03-20,"Kebler","w1920","Motorized",46,"Fri","weekday","sled","3","3","2",12.7,0.9,52,9,26,24.4,0,-1,-1,0,9,8,7,7
"8816",2020-03-20,"Kebler","w1920","Hybrid",NA,"Fri","weekday","sled","3","3","2",12.7,0.9,52,9,26,24.4,0,-1,-1,0,9,8,7,7
"8817",2020-03-21,"Kebler","w1920","Non.motorized",29,"Sat","weekend","no_sled","3","3","2",12.8,0.1,54,2,26,23.7,9,0,-1,-1,11,11,10,9
"8818",2020-03-21,"Kebler","w1920","Mechanized",0,"Sat","weekend","no_sled","3","3","2",12.8,0.1,54,2,26,23.7,9,0,-1,-1,11,11,10,9
"8819",2020-03-21,"Kebler","w1920","Motorized",49,"Sat","weekend","sled","3","3","2",12.8,0.1,54,2,26,23.7,9,0,-1,-1,11,11,10,9
"8820",2020-03-21,"Kebler","w1920","Hybrid",NA,"Sat","weekend","sled","3","3","2",12.8,0.1,54,2,26,23.7,9,0,-1,-1,11,11,10,9
"8821",2020-03-22,"Kebler","w1920","Non.motorized",10,"Sun","weekend","no_sled","2","2","2",13,0.2,53,-1,28,24.5,2,9,0,-1,1,10,10,9
"8822",2020-03-22,"Kebler","w1920","Mechanized",0,"Sun","weekend","no_sled","2","2","2",13,0.2,53,-1,28,24.5,2,9,0,-1,1,10,10,9
"8823",2020-03-22,"Kebler","w1920","Motorized",40,"Sun","weekend","sled","2","2","2",13,0.2,53,-1,28,24.5,2,9,0,-1,1,10,10,9
"8824",2020-03-22,"Kebler","w1920","Hybrid",NA,"Sun","weekend","sled","2","2","2",13,0.2,53,-1,28,24.5,2,9,0,-1,1,10,10,9
"8825",2020-03-23,"Kebler","w1920","Non.motorized",7,"Mon","weekday","no_sled","2","2","2",13,0,53,0,28,24.5,-1,2,9,0,-1,1,10,10
"8826",2020-03-23,"Kebler","w1920","Mechanized",1,"Mon","weekday","no_sled","2","2","2",13,0,53,0,28,24.5,-1,2,9,0,-1,1,10,10
"8827",2020-03-23,"Kebler","w1920","Motorized",40,"Mon","weekday","sled","2","2","2",13,0,53,0,28,24.5,-1,2,9,0,-1,1,10,10
"8828",2020-03-23,"Kebler","w1920","Hybrid",NA,"Mon","weekday","sled","2","2","2",13,0,53,0,28,24.5,-1,2,9,0,-1,1,10,10
"8829",2020-03-24,"Kebler","w1920","Non.motorized",5,"Tue","weekday","no_sled","2","2","2",13.2,0.2,53,0,32,24.9,0,-1,2,9,0,-1,1,10
"8830",2020-03-24,"Kebler","w1920","Mechanized",3,"Tue","weekday","no_sled","2","2","2",13.2,0.2,53,0,32,24.9,0,-1,2,9,0,-1,1,10
"8831",2020-03-24,"Kebler","w1920","Motorized",58,"Tue","weekday","sled","2","2","2",13.2,0.2,53,0,32,24.9,0,-1,2,9,0,-1,1,10
"8832",2020-03-24,"Kebler","w1920","Hybrid",NA,"Tue","weekday","sled","2","2","2",13.2,0.2,53,0,32,24.9,0,-1,2,9,0,-1,1,10
"8833",2020-03-25,"Kebler","w1920","Non.motorized",14,"Wed","weekday","no_sled","2","2","2",13.3,0.1,51,-2,34,26.1,0,0,-1,2,-2,-2,-3,-1
"8834",2020-03-25,"Kebler","w1920","Mechanized",0,"Wed","weekday","no_sled","2","2","2",13.3,0.1,51,-2,34,26.1,0,0,-1,2,-2,-2,-3,-1
"8835",2020-03-25,"Kebler","w1920","Motorized",68,"Wed","weekday","sled","2","2","2",13.3,0.1,51,-2,34,26.1,0,0,-1,2,-2,-2,-3,-1
"8836",2020-03-25,"Kebler","w1920","Hybrid",NA,"Wed","weekday","sled","2","2","2",13.3,0.1,51,-2,34,26.1,0,0,-1,2,-2,-2,-3,-1
"8837",2020-03-26,"Kebler","w1920","Non.motorized",12,"Thu","weekday","no_sled","2","2","2",13.3,0,50,-1,36,26.6,-2,0,0,-1,-3,-3,-3,-4
"8838",2020-03-26,"Kebler","w1920","Non.motorized",12,"Thu","weekday","no_sled","3","3","2",13.3,0,50,-1,36,26.6,-2,0,0,-1,-3,-3,-3,-4
"8839",2020-03-26,"Kebler","w1920","Mechanized",0,"Thu","weekday","no_sled","2","2","2",13.3,0,50,-1,36,26.6,-2,0,0,-1,-3,-3,-3,-4
"8840",2020-03-26,"Kebler","w1920","Mechanized",0,"Thu","weekday","no_sled","3","3","2",13.3,0,50,-1,36,26.6,-2,0,0,-1,-3,-3,-3,-4
"8841",2020-03-26,"Kebler","w1920","Motorized",95,"Thu","weekday","sled","2","2","2",13.3,0,50,-1,36,26.6,-2,0,0,-1,-3,-3,-3,-4
"8842",2020-03-26,"Kebler","w1920","Motorized",95,"Thu","weekday","sled","3","3","2",13.3,0,50,-1,36,26.6,-2,0,0,-1,-3,-3,-3,-4
"8843",2020-03-26,"Kebler","w1920","Hybrid",NA,"Thu","weekday","sled","2","2","2",13.3,0,50,-1,36,26.6,-2,0,0,-1,-3,-3,-3,-4
"8844",2020-03-26,"Kebler","w1920","Hybrid",NA,"Thu","weekday","sled","3","3","2",13.3,0,50,-1,36,26.6,-2,0,0,-1,-3,-3,-3,-4
"8845",2020-03-27,"Kebler","w1920","Non.motorized",11,"Fri","weekday","no_sled","3","3","2",13.3,0,50,0,23,26.6,-1,-2,0,0,-1,-3,-3,-3
"8846",2020-03-27,"Kebler","w1920","Mechanized",0,"Fri","weekday","no_sled","3","3","2",13.3,0,50,0,23,26.6,-1,-2,0,0,-1,-3,-3,-3
"8847",2020-03-27,"Kebler","w1920","Motorized",53,"Fri","weekday","sled","3","3","2",13.3,0,50,0,23,26.6,-1,-2,0,0,-1,-3,-3,-3
"8848",2020-03-27,"Kebler","w1920","Hybrid",NA,"Fri","weekday","sled","3","3","2",13.3,0,50,0,23,26.6,-1,-2,0,0,-1,-3,-3,-3
"8849",2020-03-28,"Kebler","w1920","Non.motorized",4,"Sat","weekend","no_sled","3","3","3",13.3,0,50,0,18,26.6,0,-1,-2,0,0,-1,-3,-3
"8850",2020-03-28,"Kebler","w1920","Mechanized",0,"Sat","weekend","no_sled","3","3","3",13.3,0,50,0,18,26.6,0,-1,-2,0,0,-1,-3,-3
"8851",2020-03-28,"Kebler","w1920","Motorized",46,"Sat","weekend","sled","3","3","3",13.3,0,50,0,18,26.6,0,-1,-2,0,0,-1,-3,-3
"8852",2020-03-28,"Kebler","w1920","Hybrid",NA,"Sat","weekend","sled","3","3","3",13.3,0,50,0,18,26.6,0,-1,-2,0,0,-1,-3,-3
"8853",2020-03-29,"Kebler","w1920","Non.motorized",4,"Sun","weekend","no_sled","2","2","2",13.3,0,49,-1,24,27.1,0,0,-1,-2,-1,-1,-2,-4
"8854",2020-03-29,"Kebler","w1920","Mechanized",0,"Sun","weekend","no_sled","2","2","2",13.3,0,49,-1,24,27.1,0,0,-1,-2,-1,-1,-2,-4
"8855",2020-03-29,"Kebler","w1920","Motorized",11,"Sun","weekend","sled","2","2","2",13.3,0,49,-1,24,27.1,0,0,-1,-2,-1,-1,-2,-4
"8856",2020-03-29,"Kebler","w1920","Hybrid",NA,"Sun","weekend","sled","2","2","2",13.3,0,49,-1,24,27.1,0,0,-1,-2,-1,-1,-2,-4
"8857",2020-03-30,"Kebler","w1920","Non.motorized",8,"Mon","weekday","no_sled","2","2","2",13.4,0.1,49,0,29,27.3,-1,0,0,-1,-1,-1,-1,-2
"8858",2020-03-30,"Kebler","w1920","Mechanized",0,"Mon","weekday","no_sled","2","2","2",13.4,0.1,49,0,29,27.3,-1,0,0,-1,-1,-1,-1,-2
"8859",2020-03-30,"Kebler","w1920","Motorized",49,"Mon","weekday","sled","2","2","2",13.4,0.1,49,0,29,27.3,-1,0,0,-1,-1,-1,-1,-2
"8860",2020-03-30,"Kebler","w1920","Hybrid",NA,"Mon","weekday","sled","2","2","2",13.4,0.1,49,0,29,27.3,-1,0,0,-1,-1,-1,-1,-2
"8861",2020-03-31,"Kebler","w1920","Non.motorized",7,"Tue","weekday","no_sled","2","2","2",13.6,0.2,51,2,35,26.7,0,-1,0,0,2,1,1,1
"8862",2020-03-31,"Kebler","w1920","Mechanized",0,"Tue","weekday","no_sled","2","2","2",13.6,0.2,51,2,35,26.7,0,-1,0,0,2,1,1,1
"8863",2020-03-31,"Kebler","w1920","Motorized",20,"Tue","weekday","sled","2","2","2",13.6,0.2,51,2,35,26.7,0,-1,0,0,2,1,1,1
"8864",2020-03-31,"Kebler","w1920","Hybrid",NA,"Tue","weekday","sled","2","2","2",13.6,0.2,51,2,35,26.7,0,-1,0,0,2,1,1,1
"8865",2020-04-01,"Kebler","w1920","Non.motorized",2,"Wed","weekday","no_sled","2","2","2",13.6,0,47,-4,39,28.9,2,0,-1,0,-2,-2,-3,-3
"8866",2020-04-01,"Kebler","w1920","Mechanized",0,"Wed","weekday","no_sled","2","2","2",13.6,0,47,-4,39,28.9,2,0,-1,0,-2,-2,-3,-3
"8867",2020-04-01,"Kebler","w1920","Motorized",23,"Wed","weekday","sled","2","2","2",13.6,0,47,-4,39,28.9,2,0,-1,0,-2,-2,-3,-3
"8868",2020-04-01,"Kebler","w1920","Hybrid",NA,"Wed","weekday","sled","2","2","2",13.6,0,47,-4,39,28.9,2,0,-1,0,-2,-2,-3,-3
"8869",2020-04-02,"Kebler","w1920","Non.motorized",17,"Thu","weekday","no_sled","2","2","2",13.6,0,46,-1,31,29.6,-4,2,0,-1,-5,-3,-3,-4
"8870",2020-04-02,"Kebler","w1920","Mechanized",0,"Thu","weekday","no_sled","2","2","2",13.6,0,46,-1,31,29.6,-4,2,0,-1,-5,-3,-3,-4
"8871",2020-04-02,"Kebler","w1920","Motorized",37,"Thu","weekday","sled","2","2","2",13.6,0,46,-1,31,29.6,-4,2,0,-1,-5,-3,-3,-4
"8872",2020-04-02,"Kebler","w1920","Hybrid",NA,"Thu","weekday","sled","2","2","2",13.6,0,46,-1,31,29.6,-4,2,0,-1,-5,-3,-3,-4
"8873",2020-04-03,"Kebler","w1920","Non.motorized",0,"Fri","weekday","no_sled","2","2","2",13.6,0,46,0,28,29.6,-1,-4,2,0,-1,-5,-3,-3
"8874",2020-04-03,"Kebler","w1920","Mechanized",0,"Fri","weekday","no_sled","2","2","2",13.6,0,46,0,28,29.6,-1,-4,2,0,-1,-5,-3,-3
"8875",2020-04-03,"Kebler","w1920","Motorized",3,"Fri","weekday","sled","2","2","2",13.6,0,46,0,28,29.6,-1,-4,2,0,-1,-5,-3,-3
"8876",2020-04-03,"Kebler","w1920","Hybrid",NA,"Fri","weekday","sled","2","2","2",13.6,0,46,0,28,29.6,-1,-4,2,0,-1,-5,-3,-3
"8877",2020-04-04,"Kebler","w1920","Non.motorized",0,"Sat","weekend","no_sled","2","2","2",13.6,0,45,-1,33,30.2,0,-1,-4,2,-1,-2,-6,-4
"8878",2020-04-04,"Kebler","w1920","Mechanized",0,"Sat","weekend","no_sled","2","2","2",13.6,0,45,-1,33,30.2,0,-1,-4,2,-1,-2,-6,-4
"8879",2020-04-04,"Kebler","w1920","Motorized",4,"Sat","weekend","sled","2","2","2",13.6,0,45,-1,33,30.2,0,-1,-4,2,-1,-2,-6,-4
"8880",2020-04-04,"Kebler","w1920","Hybrid",NA,"Sat","weekend","sled","2","2","2",13.6,0,45,-1,33,30.2,0,-1,-4,2,-1,-2,-6,-4
"8881",2020-04-05,"Kebler","w1920","Non.motorized",2,"Sun","weekend","no_sled","2","2","3",13.6,0,45,0,38,30.2,-1,0,-1,-4,-1,-1,-2,-6
"8882",2020-04-05,"Kebler","w1920","Mechanized",0,"Sun","weekend","no_sled","2","2","3",13.6,0,45,0,38,30.2,-1,0,-1,-4,-1,-1,-2,-6
"8883",2020-04-05,"Kebler","w1920","Motorized",8,"Sun","weekend","sled","2","2","3",13.6,0,45,0,38,30.2,-1,0,-1,-4,-1,-1,-2,-6
"8884",2020-04-05,"Kebler","w1920","Hybrid",NA,"Sun","weekend","sled","2","2","3",13.6,0,45,0,38,30.2,-1,0,-1,-4,-1,-1,-2,-6
"8885",2020-04-06,"Kebler","w1920","Non.motorized",1,"Mon","weekday","no_sled","2","2","3",13.6,0,44,-1,40,30.9,0,-1,0,-1,-1,-2,-2,-3
"8886",2020-04-06,"Kebler","w1920","Mechanized",0,"Mon","weekday","no_sled","2","2","3",13.6,0,44,-1,40,30.9,0,-1,0,-1,-1,-2,-2,-3
"8887",2020-04-06,"Kebler","w1920","Motorized",7,"Mon","weekday","sled","2","2","3",13.6,0,44,-1,40,30.9,0,-1,0,-1,-1,-2,-2,-3
"8888",2020-04-06,"Kebler","w1920","Hybrid",NA,"Mon","weekday","sled","2","2","3",13.6,0,44,-1,40,30.9,0,-1,0,-1,-1,-2,-2,-3
"8889",2020-04-07,"Kebler","w1920","Non.motorized",5,"Tue","weekday","no_sled","2","2","3",13.4,-0.2,43,-1,39,31.2,-1,0,-1,0,-2,-2,-3,-3
"8890",2020-04-07,"Kebler","w1920","Mechanized",1,"Tue","weekday","no_sled","2","2","3",13.4,-0.2,43,-1,39,31.2,-1,0,-1,0,-2,-2,-3,-3
"8891",2020-04-07,"Kebler","w1920","Motorized",12,"Tue","weekday","sled","2","2","3",13.4,-0.2,43,-1,39,31.2,-1,0,-1,0,-2,-2,-3,-3
"8892",2020-04-07,"Kebler","w1920","Hybrid",NA,"Tue","weekday","sled","2","2","3",13.4,-0.2,43,-1,39,31.2,-1,0,-1,0,-2,-2,-3,-3
"8893",2020-04-08,"Kebler","w1920","Non.motorized",2,"Wed","weekday","no_sled","2","3","3",13.3,-0.1,42,-1,40,31.7,-1,-1,0,-1,-2,-3,-3,-4
"8894",2020-04-08,"Kebler","w1920","Mechanized",0,"Wed","weekday","no_sled","2","3","3",13.3,-0.1,42,-1,40,31.7,-1,-1,0,-1,-2,-3,-3,-4
"8895",2020-04-08,"Kebler","w1920","Motorized",32,"Wed","weekday","sled","2","3","3",13.3,-0.1,42,-1,40,31.7,-1,-1,0,-1,-2,-3,-3,-4
"8896",2020-04-08,"Kebler","w1920","Hybrid",NA,"Wed","weekday","sled","2","3","3",13.3,-0.1,42,-1,40,31.7,-1,-1,0,-1,-2,-3,-3,-4
"8897",2020-04-09,"Kebler","w1920","Non.motorized",4,"Thu","weekday","no_sled","2","3","3",13.1,-0.2,40,-2,42,32.8,-1,-1,-1,0,-3,-4,-5,-5
"8898",2020-04-09,"Kebler","w1920","Mechanized",0,"Thu","weekday","no_sled","2","3","3",13.1,-0.2,40,-2,42,32.8,-1,-1,-1,0,-3,-4,-5,-5
"8899",2020-04-09,"Kebler","w1920","Motorized",17,"Thu","weekday","sled","2","3","3",13.1,-0.2,40,-2,42,32.8,-1,-1,-1,0,-3,-4,-5,-5
"8900",2020-04-09,"Kebler","w1920","Hybrid",NA,"Thu","weekday","sled","2","3","3",13.1,-0.2,40,-2,42,32.8,-1,-1,-1,0,-3,-4,-5,-5
"8901",2020-04-10,"Kebler","w1920","Non.motorized",2,"Fri","weekday","no_sled","3","3","3",12.9,-0.2,39,-1,38,33.1,-2,-1,-1,-1,-3,-4,-5,-6
"8902",2020-04-10,"Kebler","w1920","Mechanized",0,"Fri","weekday","no_sled","3","3","3",12.9,-0.2,39,-1,38,33.1,-2,-1,-1,-1,-3,-4,-5,-6
"8903",2020-04-10,"Kebler","w1920","Motorized",6,"Fri","weekday","sled","3","3","3",12.9,-0.2,39,-1,38,33.1,-2,-1,-1,-1,-3,-4,-5,-6
"8904",2020-04-10,"Kebler","w1920","Hybrid",NA,"Fri","weekday","sled","3","3","3",12.9,-0.2,39,-1,38,33.1,-2,-1,-1,-1,-3,-4,-5,-6
"8905",2020-04-11,"Kebler","w1920","Non.motorized",3,"Sat","weekend","no_sled","2","3","3",12.9,0,39,0,36,33.1,-1,-2,-1,-1,-1,-3,-4,-5
"8906",2020-04-11,"Kebler","w1920","Mechanized",1,"Sat","weekend","no_sled","2","3","3",12.9,0,39,0,36,33.1,-1,-2,-1,-1,-1,-3,-4,-5
"8907",2020-04-11,"Kebler","w1920","Motorized",47,"Sat","weekend","sled","2","3","3",12.9,0,39,0,36,33.1,-1,-2,-1,-1,-1,-3,-4,-5
"8908",2020-04-11,"Kebler","w1920","Hybrid",NA,"Sat","weekend","sled","2","3","3",12.9,0,39,0,36,33.1,-1,-2,-1,-1,-1,-3,-4,-5
"8909",2020-04-12,"Kebler","w1920","Non.motorized",5,"Sun","weekend","no_sled","2","2","2",12.8,-0.1,38,-1,29,33.7,0,-1,-2,-1,-1,-2,-4,-5
"8910",2020-04-12,"Kebler","w1920","Mechanized",1,"Sun","weekend","no_sled","2","2","2",12.8,-0.1,38,-1,29,33.7,0,-1,-2,-1,-1,-2,-4,-5
"8911",2020-04-12,"Kebler","w1920","Motorized",30,"Sun","weekend","sled","2","2","2",12.8,-0.1,38,-1,29,33.7,0,-1,-2,-1,-1,-2,-4,-5
"8912",2020-04-12,"Kebler","w1920","Hybrid",NA,"Sun","weekend","sled","2","2","2",12.8,-0.1,38,-1,29,33.7,0,-1,-2,-1,-1,-2,-4,-5
"8913",2020-04-13,"Kebler","w1920","Non.motorized",3,"Mon","weekday","no_sled",NA,NA,NA,12.9,0.1,39,1,20,33.1,-1,0,-1,-2,0,0,-1,-3
"8914",2020-04-13,"Kebler","w1920","Mechanized",0,"Mon","weekday","no_sled",NA,NA,NA,12.9,0.1,39,1,20,33.1,-1,0,-1,-2,0,0,-1,-3
"8915",2020-04-13,"Kebler","w1920","Motorized",28,"Mon","weekday","sled",NA,NA,NA,12.9,0.1,39,1,20,33.1,-1,0,-1,-2,0,0,-1,-3
"8916",2020-04-13,"Kebler","w1920","Hybrid",NA,"Mon","weekday","sled",NA,NA,NA,12.9,0.1,39,1,20,33.1,-1,0,-1,-2,0,0,-1,-3
"8917",2020-04-14,"Kebler","w1920","Non.motorized",6,"Tue","weekday","no_sled","2","2","2",13,0.1,39,0,18,33.3,1,-1,0,-1,1,0,0,-1
"8918",2020-04-14,"Kebler","w1920","Mechanized",0,"Tue","weekday","no_sled","2","2","2",13,0.1,39,0,18,33.3,1,-1,0,-1,1,0,0,-1
"8919",2020-04-14,"Kebler","w1920","Motorized",25,"Tue","weekday","sled","2","2","2",13,0.1,39,0,18,33.3,1,-1,0,-1,1,0,0,-1
"8920",2020-04-14,"Kebler","w1920","Hybrid",NA,"Tue","weekday","sled","2","2","2",13,0.1,39,0,18,33.3,1,-1,0,-1,1,0,0,-1
"8921",2020-04-15,"Kebler","w1920","Non.motorized",8,"Wed","weekday","no_sled",NA,NA,NA,13.2,0.2,39,0,28,33.8,0,1,-1,0,0,1,0,0
"8922",2020-04-15,"Kebler","w1920","Mechanized",0,"Wed","weekday","no_sled",NA,NA,NA,13.2,0.2,39,0,28,33.8,0,1,-1,0,0,1,0,0
"8923",2020-04-15,"Kebler","w1920","Motorized",19,"Wed","weekday","sled",NA,NA,NA,13.2,0.2,39,0,28,33.8,0,1,-1,0,0,1,0,0
"8924",2020-04-15,"Kebler","w1920","Hybrid",NA,"Wed","weekday","sled",NA,NA,NA,13.2,0.2,39,0,28,33.8,0,1,-1,0,0,1,0,0
"8925",2019-12-06,"Slate River Rd","w1920","Non.motorized",3,"Fri","weekday","no_sled","2","2","1",2.9,0.4,19,5,24,15.3,0,0,0,0,5,5,5,5
"8926",2019-12-06,"Slate River Rd","w1920","Mechanized",0,"Fri","weekday","no_sled","2","2","1",2.9,0.4,19,5,24,15.3,0,0,0,0,5,5,5,5
"8927",2019-12-06,"Slate River Rd","w1920","Motorized",5,"Fri","weekday","sled","2","2","1",2.9,0.4,19,5,24,15.3,0,0,0,0,5,5,5,5
"8928",2019-12-06,"Slate River Rd","w1920","Hybrid",NA,"Fri","weekday","sled","2","2","1",2.9,0.4,19,5,24,15.3,0,0,0,0,5,5,5,5
"8929",2019-12-07,"Slate River Rd","w1920","Non.motorized",37,"Sat","weekend","no_sled","2","2","1",3,0.1,18,-1,29,16.7,5,0,0,0,4,4,4,4
"8930",2019-12-07,"Slate River Rd","w1920","Mechanized",1,"Sat","weekend","no_sled","2","2","1",3,0.1,18,-1,29,16.7,5,0,0,0,4,4,4,4
"8931",2019-12-07,"Slate River Rd","w1920","Motorized",8,"Sat","weekend","sled","2","2","1",3,0.1,18,-1,29,16.7,5,0,0,0,4,4,4,4
"8932",2019-12-07,"Slate River Rd","w1920","Hybrid",NA,"Sat","weekend","sled","2","2","1",3,0.1,18,-1,29,16.7,5,0,0,0,4,4,4,4
"8933",2019-12-08,"Slate River Rd","w1920","Non.motorized",8,"Sun","weekend","no_sled","2","2","1",3,0,17,-1,28,17.6,-1,5,0,0,-2,3,3,3
"8934",2019-12-08,"Slate River Rd","w1920","Mechanized",1,"Sun","weekend","no_sled","2","2","1",3,0,17,-1,28,17.6,-1,5,0,0,-2,3,3,3
"8935",2019-12-08,"Slate River Rd","w1920","Motorized",3,"Sun","weekend","sled","2","2","1",3,0,17,-1,28,17.6,-1,5,0,0,-2,3,3,3
"8936",2019-12-08,"Slate River Rd","w1920","Hybrid",NA,"Sun","weekend","sled","2","2","1",3,0,17,-1,28,17.6,-1,5,0,0,-2,3,3,3
"8937",2019-12-09,"Slate River Rd","w1920","Non.motorized",13,"Mon","weekday","no_sled","3","3","2",3.4,0.4,22,5,21,15.5,-1,-1,5,0,4,3,8,8
"8938",2019-12-09,"Slate River Rd","w1920","Mechanized",0,"Mon","weekday","no_sled","3","3","2",3.4,0.4,22,5,21,15.5,-1,-1,5,0,4,3,8,8
"8939",2019-12-09,"Slate River Rd","w1920","Motorized",5,"Mon","weekday","sled","3","3","2",3.4,0.4,22,5,21,15.5,-1,-1,5,0,4,3,8,8
"8940",2019-12-09,"Slate River Rd","w1920","Hybrid",NA,"Mon","weekday","sled","3","3","2",3.4,0.4,22,5,21,15.5,-1,-1,5,0,4,3,8,8
"8941",2019-12-10,"Slate River Rd","w1920","Non.motorized",21,"Tue","weekday","no_sled","2","2","2",3.4,0,21,-1,19,16.2,5,-1,-1,5,4,3,2,7
"8942",2019-12-10,"Slate River Rd","w1920","Mechanized",0,"Tue","weekday","no_sled","2","2","2",3.4,0,21,-1,19,16.2,5,-1,-1,5,4,3,2,7
"8943",2019-12-10,"Slate River Rd","w1920","Motorized",3,"Tue","weekday","sled","2","2","2",3.4,0,21,-1,19,16.2,5,-1,-1,5,4,3,2,7
"8944",2019-12-10,"Slate River Rd","w1920","Hybrid",NA,"Tue","weekday","sled","2","2","2",3.4,0,21,-1,19,16.2,5,-1,-1,5,4,3,2,7
"8945",2019-12-11,"Slate River Rd","w1920","Non.motorized",11,"Wed","weekday","no_sled","2","2","2",3.4,0,20,-1,22,17,-1,5,-1,-1,-2,3,2,1
"8946",2019-12-11,"Slate River Rd","w1920","Mechanized",0,"Wed","weekday","no_sled","2","2","2",3.4,0,20,-1,22,17,-1,5,-1,-1,-2,3,2,1
"8947",2019-12-11,"Slate River Rd","w1920","Motorized",5,"Wed","weekday","sled","2","2","2",3.4,0,20,-1,22,17,-1,5,-1,-1,-2,3,2,1
"8948",2019-12-11,"Slate River Rd","w1920","Hybrid",NA,"Wed","weekday","sled","2","2","2",3.4,0,20,-1,22,17,-1,5,-1,-1,-2,3,2,1
"8949",2019-12-12,"Slate River Rd","w1920","Non.motorized",19,"Thu","weekday","no_sled","2","2","2",3.4,0,19,-1,25,17.9,-1,-1,5,-1,-2,-3,2,1
"8950",2019-12-12,"Slate River Rd","w1920","Mechanized",0,"Thu","weekday","no_sled","2","2","2",3.4,0,19,-1,25,17.9,-1,-1,5,-1,-2,-3,2,1
"8951",2019-12-12,"Slate River Rd","w1920","Motorized",4,"Thu","weekday","sled","2","2","2",3.4,0,19,-1,25,17.9,-1,-1,5,-1,-2,-3,2,1
"8952",2019-12-12,"Slate River Rd","w1920","Hybrid",NA,"Thu","weekday","sled","2","2","2",3.4,0,19,-1,25,17.9,-1,-1,5,-1,-2,-3,2,1
"8953",2019-12-13,"Slate River Rd","w1920","Non.motorized",3,"Fri","weekday","no_sled","2","2","2",3.8,0.4,21,2,24,18.1,-1,-1,-1,5,1,0,-1,4
"8954",2019-12-13,"Slate River Rd","w1920","Mechanized",0,"Fri","weekday","no_sled","2","2","2",3.8,0.4,21,2,24,18.1,-1,-1,-1,5,1,0,-1,4
"8955",2019-12-13,"Slate River Rd","w1920","Motorized",3,"Fri","weekday","sled","2","2","2",3.8,0.4,21,2,24,18.1,-1,-1,-1,5,1,0,-1,4
"8956",2019-12-13,"Slate River Rd","w1920","Hybrid",NA,"Fri","weekday","sled","2","2","2",3.8,0.4,21,2,24,18.1,-1,-1,-1,5,1,0,-1,4
"8957",2019-12-14,"Slate River Rd","w1920","Non.motorized",13,"Sat","weekend","no_sled","3","3","3",4.2,0.4,27,6,25,15.6,2,-1,-1,-1,8,7,6,5
"8958",2019-12-14,"Slate River Rd","w1920","Mechanized",0,"Sat","weekend","no_sled","3","3","3",4.2,0.4,27,6,25,15.6,2,-1,-1,-1,8,7,6,5
"8959",2019-12-14,"Slate River Rd","w1920","Motorized",1,"Sat","weekend","sled","3","3","3",4.2,0.4,27,6,25,15.6,2,-1,-1,-1,8,7,6,5
"8960",2019-12-14,"Slate River Rd","w1920","Hybrid",NA,"Sat","weekend","sled","3","3","3",4.2,0.4,27,6,25,15.6,2,-1,-1,-1,8,7,6,5
"8961",2019-12-15,"Slate River Rd","w1920","Non.motorized",16,"Sun","weekend","no_sled","3","3","2",4.8,0.6,31,4,17,15.5,6,2,-1,-1,10,12,11,10
"8962",2019-12-15,"Slate River Rd","w1920","Mechanized",0,"Sun","weekend","no_sled","3","3","2",4.8,0.6,31,4,17,15.5,6,2,-1,-1,10,12,11,10
"8963",2019-12-15,"Slate River Rd","w1920","Motorized",3,"Sun","weekend","sled","3","3","2",4.8,0.6,31,4,17,15.5,6,2,-1,-1,10,12,11,10
"8964",2019-12-15,"Slate River Rd","w1920","Hybrid",NA,"Sun","weekend","sled","3","3","2",4.8,0.6,31,4,17,15.5,6,2,-1,-1,10,12,11,10
"8965",2019-12-16,"Slate River Rd","w1920","Non.motorized",7,"Mon","weekday","no_sled","3","3","2",4.8,0,29,-2,6,16.6,4,6,2,-1,2,8,10,9
"8966",2019-12-16,"Slate River Rd","w1920","Mechanized",0,"Mon","weekday","no_sled","3","3","2",4.8,0,29,-2,6,16.6,4,6,2,-1,2,8,10,9
"8967",2019-12-16,"Slate River Rd","w1920","Motorized",5,"Mon","weekday","sled","3","3","2",4.8,0,29,-2,6,16.6,4,6,2,-1,2,8,10,9
"8968",2019-12-16,"Slate River Rd","w1920","Hybrid",NA,"Mon","weekday","sled","3","3","2",4.8,0,29,-2,6,16.6,4,6,2,-1,2,8,10,9
"8969",2019-12-17,"Slate River Rd","w1920","Non.motorized",7,"Tue","weekday","no_sled","2","2","1",4.8,0,27,-2,8,17.8,-2,4,6,2,-4,0,6,8
"8970",2019-12-17,"Slate River Rd","w1920","Mechanized",0,"Tue","weekday","no_sled","2","2","1",4.8,0,27,-2,8,17.8,-2,4,6,2,-4,0,6,8
"8971",2019-12-17,"Slate River Rd","w1920","Motorized",1,"Tue","weekday","sled","2","2","1",4.8,0,27,-2,8,17.8,-2,4,6,2,-4,0,6,8
"8972",2019-12-17,"Slate River Rd","w1920","Hybrid",NA,"Tue","weekday","sled","2","2","1",4.8,0,27,-2,8,17.8,-2,4,6,2,-4,0,6,8
"8973",2019-12-18,"Slate River Rd","w1920","Non.motorized",19,"Wed","weekday","no_sled","2","2","1",4.8,0,26,-1,20,18.5,-2,-2,4,6,-3,-5,-1,5
"8974",2019-12-18,"Slate River Rd","w1920","Mechanized",0,"Wed","weekday","no_sled","2","2","1",4.8,0,26,-1,20,18.5,-2,-2,4,6,-3,-5,-1,5
"8975",2019-12-18,"Slate River Rd","w1920","Motorized",8,"Wed","weekday","sled","2","2","1",4.8,0,26,-1,20,18.5,-2,-2,4,6,-3,-5,-1,5
"8976",2019-12-18,"Slate River Rd","w1920","Hybrid",NA,"Wed","weekday","sled","2","2","1",4.8,0,26,-1,20,18.5,-2,-2,4,6,-3,-5,-1,5
"8977",2019-12-19,"Slate River Rd","w1920","Non.motorized",16,"Thu","weekday","no_sled","2","2","1",4.9,0.1,25,-1,21,19.6,-1,-2,-2,4,-2,-4,-6,-2
"8978",2019-12-19,"Slate River Rd","w1920","Mechanized",0,"Thu","weekday","no_sled","2","2","1",4.9,0.1,25,-1,21,19.6,-1,-2,-2,4,-2,-4,-6,-2
"8979",2019-12-19,"Slate River Rd","w1920","Motorized",4,"Thu","weekday","sled","2","2","1",4.9,0.1,25,-1,21,19.6,-1,-2,-2,4,-2,-4,-6,-2
"8980",2019-12-19,"Slate River Rd","w1920","Hybrid",NA,"Thu","weekday","sled","2","2","1",4.9,0.1,25,-1,21,19.6,-1,-2,-2,4,-2,-4,-6,-2
"8981",2019-12-20,"Slate River Rd","w1920","Non.motorized",13,"Fri","weekday","no_sled","2","2","1",4.9,0,24,-1,21,20.4,-1,-1,-2,-2,-2,-3,-5,-7
"8982",2019-12-20,"Slate River Rd","w1920","Mechanized",1,"Fri","weekday","no_sled","2","2","1",4.9,0,24,-1,21,20.4,-1,-1,-2,-2,-2,-3,-5,-7
"8983",2019-12-20,"Slate River Rd","w1920","Motorized",6,"Fri","weekday","sled","2","2","1",4.9,0,24,-1,21,20.4,-1,-1,-2,-2,-2,-3,-5,-7
"8984",2019-12-20,"Slate River Rd","w1920","Hybrid",NA,"Fri","weekday","sled","2","2","1",4.9,0,24,-1,21,20.4,-1,-1,-2,-2,-2,-3,-5,-7
"8985",2019-12-21,"Slate River Rd","w1920","Non.motorized",26,"Sat","weekend","no_sled","2","2","1",4.9,0,24,0,27,20.4,-1,-1,-1,-2,-1,-2,-3,-5
"8986",2019-12-21,"Slate River Rd","w1920","Mechanized",0,"Sat","weekend","no_sled","2","2","1",4.9,0,24,0,27,20.4,-1,-1,-1,-2,-1,-2,-3,-5
"8987",2019-12-21,"Slate River Rd","w1920","Motorized",10,"Sat","weekend","sled","2","2","1",4.9,0,24,0,27,20.4,-1,-1,-1,-2,-1,-2,-3,-5
"8988",2019-12-21,"Slate River Rd","w1920","Hybrid",NA,"Sat","weekend","sled","2","2","1",4.9,0,24,0,27,20.4,-1,-1,-1,-2,-1,-2,-3,-5
"8989",2019-12-22,"Slate River Rd","w1920","Non.motorized",40,"Sun","weekend","no_sled","2","2","1",5,0.1,23,-1,31,21.7,0,-1,-1,-1,-1,-2,-3,-4
"8990",2019-12-22,"Slate River Rd","w1920","Mechanized",0,"Sun","weekend","no_sled","2","2","1",5,0.1,23,-1,31,21.7,0,-1,-1,-1,-1,-2,-3,-4
"8991",2019-12-22,"Slate River Rd","w1920","Motorized",18,"Sun","weekend","sled","2","2","1",5,0.1,23,-1,31,21.7,0,-1,-1,-1,-1,-2,-3,-4
"8992",2019-12-22,"Slate River Rd","w1920","Hybrid",NA,"Sun","weekend","sled","2","2","1",5,0.1,23,-1,31,21.7,0,-1,-1,-1,-1,-2,-3,-4
"8993",2019-12-23,"Slate River Rd","w1920","Non.motorized",30,"Mon","weekday","no_sled","2","1","1",5,0,23,0,34,21.7,-1,0,-1,-1,-1,-1,-2,-3
"8994",2019-12-23,"Slate River Rd","w1920","Mechanized",0,"Mon","weekday","no_sled","2","1","1",5,0,23,0,34,21.7,-1,0,-1,-1,-1,-1,-2,-3
"8995",2019-12-23,"Slate River Rd","w1920","Motorized",3,"Mon","weekday","sled","2","1","1",5,0,23,0,34,21.7,-1,0,-1,-1,-1,-1,-2,-3
"8996",2019-12-23,"Slate River Rd","w1920","Hybrid",NA,"Mon","weekday","sled","2","1","1",5,0,23,0,34,21.7,-1,0,-1,-1,-1,-1,-2,-3
"8997",2019-12-24,"Slate River Rd","w1920","Non.motorized",35,"Tue","weekday","no_sled","2","1","1",5,0,22,-1,30,22.7,0,-1,0,-1,-1,-2,-2,-3
"8998",2019-12-24,"Slate River Rd","w1920","Mechanized",1,"Tue","weekday","no_sled","2","1","1",5,0,22,-1,30,22.7,0,-1,0,-1,-1,-2,-2,-3
"8999",2019-12-24,"Slate River Rd","w1920","Motorized",5,"Tue","weekday","sled","2","1","1",5,0,22,-1,30,22.7,0,-1,0,-1,-1,-2,-2,-3
"9000",2019-12-24,"Slate River Rd","w1920","Hybrid",NA,"Tue","weekday","sled","2","1","1",5,0,22,-1,30,22.7,0,-1,0,-1,-1,-2,-2,-3
"9001",2019-12-25,"Slate River Rd","w1920","Non.motorized",38,"Wed","weekday","no_sled","2","2","2",5,0,23,1,22,21.7,-1,0,-1,0,0,0,-1,-1
"9002",2019-12-25,"Slate River Rd","w1920","Mechanized",0,"Wed","weekday","no_sled","2","2","2",5,0,23,1,22,21.7,-1,0,-1,0,0,0,-1,-1
"9003",2019-12-25,"Slate River Rd","w1920","Motorized",6,"Wed","weekday","sled","2","2","2",5,0,23,1,22,21.7,-1,0,-1,0,0,0,-1,-1
"9004",2019-12-25,"Slate River Rd","w1920","Hybrid",NA,"Wed","weekday","sled","2","2","2",5,0,23,1,22,21.7,-1,0,-1,0,0,0,-1,-1
"9005",2019-12-26,"Slate River Rd","w1920","Non.motorized",41,"Thu","weekday","no_sled","2","2","1",5,0,23,0,17,21.7,1,-1,0,-1,1,0,0,-1
"9006",2019-12-26,"Slate River Rd","w1920","Mechanized",0,"Thu","weekday","no_sled","2","2","1",5,0,23,0,17,21.7,1,-1,0,-1,1,0,0,-1
"9007",2019-12-26,"Slate River Rd","w1920","Motorized",5,"Thu","weekday","sled","2","2","1",5,0,23,0,17,21.7,1,-1,0,-1,1,0,0,-1
"9008",2019-12-26,"Slate River Rd","w1920","Hybrid",NA,"Thu","weekday","sled","2","2","1",5,0,23,0,17,21.7,1,-1,0,-1,1,0,0,-1
"9009",2019-12-27,"Slate River Rd","w1920","Non.motorized",29,"Fri","weekday","no_sled","3","3","2",5.1,0.1,24,1,22,21.2,0,1,-1,0,1,2,1,1
"9010",2019-12-27,"Slate River Rd","w1920","Mechanized",0,"Fri","weekday","no_sled","3","3","2",5.1,0.1,24,1,22,21.2,0,1,-1,0,1,2,1,1
"9011",2019-12-27,"Slate River Rd","w1920","Motorized",5,"Fri","weekday","sled","3","3","2",5.1,0.1,24,1,22,21.2,0,1,-1,0,1,2,1,1
"9012",2019-12-27,"Slate River Rd","w1920","Hybrid",NA,"Fri","weekday","sled","3","3","2",5.1,0.1,24,1,22,21.2,0,1,-1,0,1,2,1,1
"9013",2019-12-28,"Slate River Rd","w1920","Non.motorized",22,"Sat","weekend","no_sled","3","3","2",5.6,0.5,30,6,16,18.7,1,0,1,-1,7,7,8,7
"9014",2019-12-28,"Slate River Rd","w1920","Mechanized",0,"Sat","weekend","no_sled","3","3","2",5.6,0.5,30,6,16,18.7,1,0,1,-1,7,7,8,7
"9015",2019-12-28,"Slate River Rd","w1920","Motorized",6,"Sat","weekend","sled","3","3","2",5.6,0.5,30,6,16,18.7,1,0,1,-1,7,7,8,7
"9016",2019-12-28,"Slate River Rd","w1920","Hybrid",NA,"Sat","weekend","sled","3","3","2",5.6,0.5,30,6,16,18.7,1,0,1,-1,7,7,8,7
"9017",2019-12-29,"Slate River Rd","w1920","Non.motorized",45,"Sun","weekend","no_sled","3","3","2",5.6,0,29,-1,3,19.3,6,1,0,1,5,6,6,7
"9018",2019-12-29,"Slate River Rd","w1920","Mechanized",0,"Sun","weekend","no_sled","3","3","2",5.6,0,29,-1,3,19.3,6,1,0,1,5,6,6,7
"9019",2019-12-29,"Slate River Rd","w1920","Motorized",16,"Sun","weekend","sled","3","3","2",5.6,0,29,-1,3,19.3,6,1,0,1,5,6,6,7
"9020",2019-12-29,"Slate River Rd","w1920","Hybrid",NA,"Sun","weekend","sled","3","3","2",5.6,0,29,-1,3,19.3,6,1,0,1,5,6,6,7
"9021",2019-12-30,"Slate River Rd","w1920","Non.motorized",NA,"Mon","weekday","no_sled","3","3","2",5.6,0,28,-1,3,20,-1,6,1,0,-2,4,5,5
"9022",2019-12-30,"Slate River Rd","w1920","Mechanized",NA,"Mon","weekday","no_sled","3","3","2",5.6,0,28,-1,3,20,-1,6,1,0,-2,4,5,5
"9023",2019-12-30,"Slate River Rd","w1920","Motorized",NA,"Mon","weekday","sled","3","3","2",5.6,0,28,-1,3,20,-1,6,1,0,-2,4,5,5
"9024",2019-12-30,"Slate River Rd","w1920","Hybrid",NA,"Mon","weekday","sled","3","3","2",5.6,0,28,-1,3,20,-1,6,1,0,-2,4,5,5
"9025",2019-12-31,"Slate River Rd","w1920","Non.motorized",NA,"Tue","weekday","no_sled","2","2","1",5.6,0,28,0,13,20,-1,-1,6,1,-1,-2,4,5
"9026",2019-12-31,"Slate River Rd","w1920","Mechanized",NA,"Tue","weekday","no_sled","2","2","1",5.6,0,28,0,13,20,-1,-1,6,1,-1,-2,4,5
"9027",2019-12-31,"Slate River Rd","w1920","Motorized",NA,"Tue","weekday","sled","2","2","1",5.6,0,28,0,13,20,-1,-1,6,1,-1,-2,4,5
"9028",2019-12-31,"Slate River Rd","w1920","Hybrid",NA,"Tue","weekday","sled","2","2","1",5.6,0,28,0,13,20,-1,-1,6,1,-1,-2,4,5
"9029",2020-01-01,"Slate River Rd","w1920","Non.motorized",NA,"Wed","weekday","no_sled","2","1","1",5.6,0,27,-1,21,20.7,0,-1,-1,6,-1,-2,-3,3
"9030",2020-01-01,"Slate River Rd","w1920","Mechanized",NA,"Wed","weekday","no_sled","2","1","1",5.6,0,27,-1,21,20.7,0,-1,-1,6,-1,-2,-3,3
"9031",2020-01-01,"Slate River Rd","w1920","Motorized",NA,"Wed","weekday","sled","2","1","1",5.6,0,27,-1,21,20.7,0,-1,-1,6,-1,-2,-3,3
"9032",2020-01-01,"Slate River Rd","w1920","Hybrid",NA,"Wed","weekday","sled","2","1","1",5.6,0,27,-1,21,20.7,0,-1,-1,6,-1,-2,-3,3
"9033",2020-01-02,"Slate River Rd","w1920","Non.motorized",NA,"Thu","weekday","no_sled","3","3","2",5.9,0.3,29,2,16,20.3,-1,0,-1,-1,1,1,0,-1
"9034",2020-01-02,"Slate River Rd","w1920","Mechanized",NA,"Thu","weekday","no_sled","3","3","2",5.9,0.3,29,2,16,20.3,-1,0,-1,-1,1,1,0,-1
"9035",2020-01-02,"Slate River Rd","w1920","Motorized",NA,"Thu","weekday","sled","3","3","2",5.9,0.3,29,2,16,20.3,-1,0,-1,-1,1,1,0,-1
"9036",2020-01-02,"Slate River Rd","w1920","Hybrid",NA,"Thu","weekday","sled","3","3","2",5.9,0.3,29,2,16,20.3,-1,0,-1,-1,1,1,0,-1
"9037",2020-01-03,"Slate River Rd","w1920","Non.motorized",NA,"Fri","weekday","no_sled","3","2","1",5.9,0,31,2,19,19,2,-1,0,-1,4,3,3,2
"9038",2020-01-03,"Slate River Rd","w1920","Mechanized",NA,"Fri","weekday","no_sled","3","2","1",5.9,0,31,2,19,19,2,-1,0,-1,4,3,3,2
"9039",2020-01-03,"Slate River Rd","w1920","Motorized",NA,"Fri","weekday","sled","3","2","1",5.9,0,31,2,19,19,2,-1,0,-1,4,3,3,2
"9040",2020-01-03,"Slate River Rd","w1920","Hybrid",NA,"Fri","weekday","sled","3","2","1",5.9,0,31,2,19,19,2,-1,0,-1,4,3,3,2
"9041",2020-01-04,"Slate River Rd","w1920","Non.motorized",NA,"Sat","weekend","no_sled","2","2","1",5.9,0,30,-1,26,19.7,2,2,-1,0,1,3,2,2
"9042",2020-01-04,"Slate River Rd","w1920","Mechanized",NA,"Sat","weekend","no_sled","2","2","1",5.9,0,30,-1,26,19.7,2,2,-1,0,1,3,2,2
"9043",2020-01-04,"Slate River Rd","w1920","Motorized",NA,"Sat","weekend","sled","2","2","1",5.9,0,30,-1,26,19.7,2,2,-1,0,1,3,2,2
"9044",2020-01-04,"Slate River Rd","w1920","Hybrid",NA,"Sat","weekend","sled","2","2","1",5.9,0,30,-1,26,19.7,2,2,-1,0,1,3,2,2
"9045",2020-01-05,"Slate River Rd","w1920","Non.motorized",NA,"Sun","weekend","no_sled","2","2","1",5.9,0,28,-2,23,21.1,-1,2,2,-1,-3,-1,1,0
"9046",2020-01-05,"Slate River Rd","w1920","Mechanized",NA,"Sun","weekend","no_sled","2","2","1",5.9,0,28,-2,23,21.1,-1,2,2,-1,-3,-1,1,0
"9047",2020-01-05,"Slate River Rd","w1920","Motorized",NA,"Sun","weekend","sled","2","2","1",5.9,0,28,-2,23,21.1,-1,2,2,-1,-3,-1,1,0
"9048",2020-01-05,"Slate River Rd","w1920","Hybrid",NA,"Sun","weekend","sled","2","2","1",5.9,0,28,-2,23,21.1,-1,2,2,-1,-3,-1,1,0
"9049",2020-01-06,"Slate River Rd","w1920","Non.motorized",NA,"Mon","weekday","no_sled","2","2","1",5.9,0,28,0,15,21.1,-2,-1,2,2,-2,-3,-1,1
"9050",2020-01-06,"Slate River Rd","w1920","Mechanized",NA,"Mon","weekday","no_sled","2","2","1",5.9,0,28,0,15,21.1,-2,-1,2,2,-2,-3,-1,1
"9051",2020-01-06,"Slate River Rd","w1920","Motorized",NA,"Mon","weekday","sled","2","2","1",5.9,0,28,0,15,21.1,-2,-1,2,2,-2,-3,-1,1
"9052",2020-01-06,"Slate River Rd","w1920","Hybrid",NA,"Mon","weekday","sled","2","2","1",5.9,0,28,0,15,21.1,-2,-1,2,2,-2,-3,-1,1
"9053",2020-01-07,"Slate River Rd","w1920","Non.motorized",NA,"Tue","weekday","no_sled","2","1","1",5.9,0,28,0,22,21.1,0,-2,-1,2,0,-2,-3,-1
"9054",2020-01-07,"Slate River Rd","w1920","Mechanized",NA,"Tue","weekday","no_sled","2","1","1",5.9,0,28,0,22,21.1,0,-2,-1,2,0,-2,-3,-1
"9055",2020-01-07,"Slate River Rd","w1920","Motorized",NA,"Tue","weekday","sled","2","1","1",5.9,0,28,0,22,21.1,0,-2,-1,2,0,-2,-3,-1
"9056",2020-01-07,"Slate River Rd","w1920","Hybrid",NA,"Tue","weekday","sled","2","1","1",5.9,0,28,0,22,21.1,0,-2,-1,2,0,-2,-3,-1
"9057",2020-01-08,"Slate River Rd","w1920","Non.motorized",NA,"Wed","weekday","no_sled","2","1","1",6,0.1,28,0,23,21.4,0,0,-2,-1,0,0,-2,-3
"9058",2020-01-08,"Slate River Rd","w1920","Mechanized",NA,"Wed","weekday","no_sled","2","1","1",6,0.1,28,0,23,21.4,0,0,-2,-1,0,0,-2,-3
"9059",2020-01-08,"Slate River Rd","w1920","Motorized",NA,"Wed","weekday","sled","2","1","1",6,0.1,28,0,23,21.4,0,0,-2,-1,0,0,-2,-3
"9060",2020-01-08,"Slate River Rd","w1920","Hybrid",NA,"Wed","weekday","sled","2","1","1",6,0.1,28,0,23,21.4,0,0,-2,-1,0,0,-2,-3
"9061",2020-01-09,"Slate River Rd","w1920","Non.motorized",NA,"Thu","weekday","no_sled","2","1","1",6,0,27,-1,17,22.2,0,0,0,-2,-1,-1,-1,-3
"9062",2020-01-09,"Slate River Rd","w1920","Mechanized",NA,"Thu","weekday","no_sled","2","1","1",6,0,27,-1,17,22.2,0,0,0,-2,-1,-1,-1,-3
"9063",2020-01-09,"Slate River Rd","w1920","Motorized",NA,"Thu","weekday","sled","2","1","1",6,0,27,-1,17,22.2,0,0,0,-2,-1,-1,-1,-3
"9064",2020-01-09,"Slate River Rd","w1920","Hybrid",NA,"Thu","weekday","sled","2","1","1",6,0,27,-1,17,22.2,0,0,0,-2,-1,-1,-1,-3
"9065",2020-01-10,"Slate River Rd","w1920","Non.motorized",NA,"Fri","weekday","no_sled","2","1","1",6,0,29,2,11,20.7,-1,0,0,0,1,1,1,1
"9066",2020-01-10,"Slate River Rd","w1920","Mechanized",NA,"Fri","weekday","no_sled","2","1","1",6,0,29,2,11,20.7,-1,0,0,0,1,1,1,1
"9067",2020-01-10,"Slate River Rd","w1920","Motorized",NA,"Fri","weekday","sled","2","1","1",6,0,29,2,11,20.7,-1,0,0,0,1,1,1,1
"9068",2020-01-10,"Slate River Rd","w1920","Hybrid",NA,"Fri","weekday","sled","2","1","1",6,0,29,2,11,20.7,-1,0,0,0,1,1,1,1
"9069",2020-01-11,"Slate River Rd","w1920","Non.motorized",13,"Sat","weekend","no_sled","2","1","1",6,0,29,0,12,20.7,2,-1,0,0,2,1,1,1
"9070",2020-01-11,"Slate River Rd","w1920","Mechanized",0,"Sat","weekend","no_sled","2","1","1",6,0,29,0,12,20.7,2,-1,0,0,2,1,1,1
"9071",2020-01-11,"Slate River Rd","w1920","Motorized",0,"Sat","weekend","sled","2","1","1",6,0,29,0,12,20.7,2,-1,0,0,2,1,1,1
"9072",2020-01-11,"Slate River Rd","w1920","Hybrid",NA,"Sat","weekend","sled","2","1","1",6,0,29,0,12,20.7,2,-1,0,0,2,1,1,1
"9073",2020-01-12,"Slate River Rd","w1920","Non.motorized",31,"Sun","weekend","no_sled","2","1","1",6.1,0.1,29,0,13,21,0,2,-1,0,0,2,1,1
"9074",2020-01-12,"Slate River Rd","w1920","Mechanized",0,"Sun","weekend","no_sled","2","1","1",6.1,0.1,29,0,13,21,0,2,-1,0,0,2,1,1
"9075",2020-01-12,"Slate River Rd","w1920","Motorized",27,"Sun","weekend","sled","2","1","1",6.1,0.1,29,0,13,21,0,2,-1,0,0,2,1,1
"9076",2020-01-12,"Slate River Rd","w1920","Hybrid",NA,"Sun","weekend","sled","2","1","1",6.1,0.1,29,0,13,21,0,2,-1,0,0,2,1,1
"9077",2020-01-13,"Slate River Rd","w1920","Non.motorized",0,"Mon","weekday","no_sled","2","2","1",6.2,0.1,29,0,16,21.4,0,0,2,-1,0,0,2,1
"9078",2020-01-13,"Slate River Rd","w1920","Mechanized",0,"Mon","weekday","no_sled","2","2","1",6.2,0.1,29,0,16,21.4,0,0,2,-1,0,0,2,1
"9079",2020-01-13,"Slate River Rd","w1920","Motorized",1,"Mon","weekday","sled","2","2","1",6.2,0.1,29,0,16,21.4,0,0,2,-1,0,0,2,1
"9080",2020-01-13,"Slate River Rd","w1920","Hybrid",NA,"Mon","weekday","sled","2","2","1",6.2,0.1,29,0,16,21.4,0,0,2,-1,0,0,2,1
"9081",2020-01-14,"Slate River Rd","w1920","Non.motorized",5,"Tue","weekday","no_sled","3","2","1",6.6,0.4,34,5,23,19.4,0,0,0,2,5,5,5,7
"9082",2020-01-14,"Slate River Rd","w1920","Mechanized",0,"Tue","weekday","no_sled","3","2","1",6.6,0.4,34,5,23,19.4,0,0,0,2,5,5,5,7
"9083",2020-01-14,"Slate River Rd","w1920","Motorized",7,"Tue","weekday","sled","3","2","1",6.6,0.4,34,5,23,19.4,0,0,0,2,5,5,5,7
"9084",2020-01-14,"Slate River Rd","w1920","Hybrid",NA,"Tue","weekday","sled","3","2","1",6.6,0.4,34,5,23,19.4,0,0,0,2,5,5,5,7
"9085",2020-01-15,"Slate River Rd","w1920","Non.motorized",16,"Wed","weekday","no_sled","3","2","1",6.7,0.1,32,-2,23,20.9,5,0,0,0,3,3,3,3
"9086",2020-01-15,"Slate River Rd","w1920","Mechanized",0,"Wed","weekday","no_sled","3","2","1",6.7,0.1,32,-2,23,20.9,5,0,0,0,3,3,3,3
"9087",2020-01-15,"Slate River Rd","w1920","Motorized",8,"Wed","weekday","sled","3","2","1",6.7,0.1,32,-2,23,20.9,5,0,0,0,3,3,3,3
"9088",2020-01-15,"Slate River Rd","w1920","Hybrid",NA,"Wed","weekday","sled","3","2","1",6.7,0.1,32,-2,23,20.9,5,0,0,0,3,3,3,3
"9089",2020-01-16,"Slate River Rd","w1920","Non.motorized",7,"Thu","weekday","no_sled","2","2","1",6.7,0,31,-1,28,21.6,-2,5,0,0,-3,2,2,2
"9090",2020-01-16,"Slate River Rd","w1920","Mechanized",0,"Thu","weekday","no_sled","2","2","1",6.7,0,31,-1,28,21.6,-2,5,0,0,-3,2,2,2
"9091",2020-01-16,"Slate River Rd","w1920","Motorized",6,"Thu","weekday","sled","2","2","1",6.7,0,31,-1,28,21.6,-2,5,0,0,-3,2,2,2
"9092",2020-01-16,"Slate River Rd","w1920","Hybrid",NA,"Thu","weekday","sled","2","2","1",6.7,0,31,-1,28,21.6,-2,5,0,0,-3,2,2,2
"9093",2020-01-17,"Slate River Rd","w1920","Non.motorized",NA,"Fri","weekday","no_sled","2","2","1",6.8,0.1,29,-2,19,23.4,-1,-2,5,0,-3,-5,0,0
"9094",2020-01-17,"Slate River Rd","w1920","Mechanized",NA,"Fri","weekday","no_sled","2","2","1",6.8,0.1,29,-2,19,23.4,-1,-2,5,0,-3,-5,0,0
"9095",2020-01-17,"Slate River Rd","w1920","Motorized",NA,"Fri","weekday","sled","2","2","1",6.8,0.1,29,-2,19,23.4,-1,-2,5,0,-3,-5,0,0
"9096",2020-01-17,"Slate River Rd","w1920","Hybrid",NA,"Fri","weekday","sled","2","2","1",6.8,0.1,29,-2,19,23.4,-1,-2,5,0,-3,-5,0,0
"9097",2020-01-18,"Slate River Rd","w1920","Non.motorized",NA,"Sat","weekend","no_sled","2","2","2",7,0.2,34,5,16,20.6,-2,-1,-2,5,3,2,0,5
"9098",2020-01-18,"Slate River Rd","w1920","Mechanized",NA,"Sat","weekend","no_sled","2","2","2",7,0.2,34,5,16,20.6,-2,-1,-2,5,3,2,0,5
"9099",2020-01-18,"Slate River Rd","w1920","Motorized",NA,"Sat","weekend","sled","2","2","2",7,0.2,34,5,16,20.6,-2,-1,-2,5,3,2,0,5
"9100",2020-01-18,"Slate River Rd","w1920","Hybrid",NA,"Sat","weekend","sled","2","2","2",7,0.2,34,5,16,20.6,-2,-1,-2,5,3,2,0,5
"9101",2020-01-19,"Slate River Rd","w1920","Non.motorized",30,"Sun","weekend","no_sled","2","2","1",7,0,33,-1,21,21.2,5,-2,-1,-2,4,2,1,-1
"9102",2020-01-19,"Slate River Rd","w1920","Mechanized",2,"Sun","weekend","no_sled","2","2","1",7,0,33,-1,21,21.2,5,-2,-1,-2,4,2,1,-1
"9103",2020-01-19,"Slate River Rd","w1920","Motorized",4,"Sun","weekend","sled","2","2","1",7,0,33,-1,21,21.2,5,-2,-1,-2,4,2,1,-1
"9104",2020-01-19,"Slate River Rd","w1920","Hybrid",NA,"Sun","weekend","sled","2","2","1",7,0,33,-1,21,21.2,5,-2,-1,-2,4,2,1,-1
"9105",2020-01-20,"Slate River Rd","w1920","Non.motorized",13,"Mon","weekday","no_sled","2","2","1",7.1,0.1,32,-1,25,22.2,-1,5,-2,-1,-2,3,1,0
"9106",2020-01-20,"Slate River Rd","w1920","Mechanized",0,"Mon","weekday","no_sled","2","2","1",7.1,0.1,32,-1,25,22.2,-1,5,-2,-1,-2,3,1,0
"9107",2020-01-20,"Slate River Rd","w1920","Motorized",8,"Mon","weekday","sled","2","2","1",7.1,0.1,32,-1,25,22.2,-1,5,-2,-1,-2,3,1,0
"9108",2020-01-20,"Slate River Rd","w1920","Hybrid",NA,"Mon","weekday","sled","2","2","1",7.1,0.1,32,-1,25,22.2,-1,5,-2,-1,-2,3,1,0
"9109",2020-01-21,"Slate River Rd","w1920","Non.motorized",1,"Tue","weekday","no_sled","2","2","1",7.1,0,31,-1,28,22.9,-1,-1,5,-2,-2,-3,2,0
"9110",2020-01-21,"Slate River Rd","w1920","Mechanized",0,"Tue","weekday","no_sled","2","2","1",7.1,0,31,-1,28,22.9,-1,-1,5,-2,-2,-3,2,0
"9111",2020-01-21,"Slate River Rd","w1920","Motorized",11,"Tue","weekday","sled","2","2","1",7.1,0,31,-1,28,22.9,-1,-1,5,-2,-2,-3,2,0
"9112",2020-01-21,"Slate River Rd","w1920","Hybrid",NA,"Tue","weekday","sled","2","2","1",7.1,0,31,-1,28,22.9,-1,-1,5,-2,-2,-3,2,0
"9113",2020-01-22,"Slate River Rd","w1920","Non.motorized",7,"Wed","weekday","no_sled","2","2","2",7.3,0.2,32,1,25,22.8,-1,-1,-1,5,0,-1,-2,3
"9114",2020-01-22,"Slate River Rd","w1920","Mechanized",0,"Wed","weekday","no_sled","2","2","2",7.3,0.2,32,1,25,22.8,-1,-1,-1,5,0,-1,-2,3
"9115",2020-01-22,"Slate River Rd","w1920","Motorized",3,"Wed","weekday","sled","2","2","2",7.3,0.2,32,1,25,22.8,-1,-1,-1,5,0,-1,-2,3
"9116",2020-01-22,"Slate River Rd","w1920","Hybrid",NA,"Wed","weekday","sled","2","2","2",7.3,0.2,32,1,25,22.8,-1,-1,-1,5,0,-1,-2,3
"9117",2020-01-23,"Slate River Rd","w1920","Non.motorized",7,"Thu","weekday","no_sled","3","2","2",7.3,0,34,2,23,21.5,1,-1,-1,-1,3,2,1,0
"9118",2020-01-23,"Slate River Rd","w1920","Mechanized",0,"Thu","weekday","no_sled","3","2","2",7.3,0,34,2,23,21.5,1,-1,-1,-1,3,2,1,0
"9119",2020-01-23,"Slate River Rd","w1920","Motorized",4,"Thu","weekday","sled","3","2","2",7.3,0,34,2,23,21.5,1,-1,-1,-1,3,2,1,0
"9120",2020-01-23,"Slate River Rd","w1920","Hybrid",NA,"Thu","weekday","sled","3","2","2",7.3,0,34,2,23,21.5,1,-1,-1,-1,3,2,1,0
"9121",2020-01-24,"Slate River Rd","w1920","Non.motorized",6,"Fri","weekday","no_sled","2","2","1",7.3,0,33,-1,23,22.1,2,1,-1,-1,1,2,1,0
"9122",2020-01-24,"Slate River Rd","w1920","Mechanized",0,"Fri","weekday","no_sled","2","2","1",7.3,0,33,-1,23,22.1,2,1,-1,-1,1,2,1,0
"9123",2020-01-24,"Slate River Rd","w1920","Motorized",7,"Fri","weekday","sled","2","2","1",7.3,0,33,-1,23,22.1,2,1,-1,-1,1,2,1,0
"9124",2020-01-24,"Slate River Rd","w1920","Hybrid",NA,"Fri","weekday","sled","2","2","1",7.3,0,33,-1,23,22.1,2,1,-1,-1,1,2,1,0
"9125",2020-01-25,"Slate River Rd","w1920","Non.motorized",13,"Sat","weekend","no_sled","2","2","1",7.4,0.1,32,-1,25,23.1,-1,2,1,-1,-2,0,1,0
"9126",2020-01-25,"Slate River Rd","w1920","Mechanized",1,"Sat","weekend","no_sled","2","2","1",7.4,0.1,32,-1,25,23.1,-1,2,1,-1,-2,0,1,0
"9127",2020-01-25,"Slate River Rd","w1920","Motorized",16,"Sat","weekend","sled","2","2","1",7.4,0.1,32,-1,25,23.1,-1,2,1,-1,-2,0,1,0
"9128",2020-01-25,"Slate River Rd","w1920","Hybrid",NA,"Sat","weekend","sled","2","2","1",7.4,0.1,32,-1,25,23.1,-1,2,1,-1,-2,0,1,0
"9129",2020-01-26,"Slate River Rd","w1920","Non.motorized",24,"Sun","weekend","no_sled","2","1","1",7.4,0,32,0,28,23.1,-1,-1,2,1,-1,-2,0,1
"9130",2020-01-26,"Slate River Rd","w1920","Mechanized",0,"Sun","weekend","no_sled","2","1","1",7.4,0,32,0,28,23.1,-1,-1,2,1,-1,-2,0,1
"9131",2020-01-26,"Slate River Rd","w1920","Motorized",8,"Sun","weekend","sled","2","1","1",7.4,0,32,0,28,23.1,-1,-1,2,1,-1,-2,0,1
"9132",2020-01-26,"Slate River Rd","w1920","Hybrid",NA,"Sun","weekend","sled","2","1","1",7.4,0,32,0,28,23.1,-1,-1,2,1,-1,-2,0,1
"9133",2020-01-27,"Slate River Rd","w1920","Non.motorized",4,"Mon","weekday","no_sled","2","1","1",7.4,0,32,0,24,23.1,0,-1,-1,2,0,-1,-2,0
"9134",2020-01-27,"Slate River Rd","w1920","Mechanized",0,"Mon","weekday","no_sled","2","1","1",7.4,0,32,0,24,23.1,0,-1,-1,2,0,-1,-2,0
"9135",2020-01-27,"Slate River Rd","w1920","Motorized",3,"Mon","weekday","sled","2","1","1",7.4,0,32,0,24,23.1,0,-1,-1,2,0,-1,-2,0
"9136",2020-01-27,"Slate River Rd","w1920","Hybrid",NA,"Mon","weekday","sled","2","1","1",7.4,0,32,0,24,23.1,0,-1,-1,2,0,-1,-2,0
"9137",2020-01-28,"Slate River Rd","w1920","Non.motorized",10,"Tue","weekday","no_sled","3","2","2",7.4,0,32,0,19,23.1,0,0,-1,-1,0,0,-1,-2
"9138",2020-01-28,"Slate River Rd","w1920","Mechanized",0,"Tue","weekday","no_sled","3","2","2",7.4,0,32,0,19,23.1,0,0,-1,-1,0,0,-1,-2
"9139",2020-01-28,"Slate River Rd","w1920","Motorized",6,"Tue","weekday","sled","3","2","2",7.4,0,32,0,19,23.1,0,0,-1,-1,0,0,-1,-2
"9140",2020-01-28,"Slate River Rd","w1920","Hybrid",NA,"Tue","weekday","sled","3","2","2",7.4,0,32,0,19,23.1,0,0,-1,-1,0,0,-1,-2
"9141",2020-01-29,"Slate River Rd","w1920","Non.motorized",10,"Wed","weekday","no_sled","2","2","1",7.4,0,31,-1,20,23.9,0,0,0,-1,-1,-1,-1,-2
"9142",2020-01-29,"Slate River Rd","w1920","Mechanized",0,"Wed","weekday","no_sled","2","2","1",7.4,0,31,-1,20,23.9,0,0,0,-1,-1,-1,-1,-2
"9143",2020-01-29,"Slate River Rd","w1920","Motorized",7,"Wed","weekday","sled","2","2","1",7.4,0,31,-1,20,23.9,0,0,0,-1,-1,-1,-1,-2
"9144",2020-01-29,"Slate River Rd","w1920","Hybrid",NA,"Wed","weekday","sled","2","2","1",7.4,0,31,-1,20,23.9,0,0,0,-1,-1,-1,-1,-2
"9145",2020-01-30,"Slate River Rd","w1920","Non.motorized",18,"Thu","weekday","no_sled","2","2","1",7.4,0,31,0,17,23.9,-1,0,0,0,-1,-1,-1,-1
"9146",2020-01-30,"Slate River Rd","w1920","Mechanized",0,"Thu","weekday","no_sled","2","2","1",7.4,0,31,0,17,23.9,-1,0,0,0,-1,-1,-1,-1
"9147",2020-01-30,"Slate River Rd","w1920","Motorized",12,"Thu","weekday","sled","2","2","1",7.4,0,31,0,17,23.9,-1,0,0,0,-1,-1,-1,-1
"9148",2020-01-30,"Slate River Rd","w1920","Hybrid",NA,"Thu","weekday","sled","2","2","1",7.4,0,31,0,17,23.9,-1,0,0,0,-1,-1,-1,-1
"9149",2020-01-31,"Slate River Rd","w1920","Non.motorized",22,"Fri","weekday","no_sled","2","1","1",7.4,0,31,0,20,23.9,0,-1,0,0,0,-1,-1,-1
"9150",2020-01-31,"Slate River Rd","w1920","Mechanized",0,"Fri","weekday","no_sled","2","1","1",7.4,0,31,0,20,23.9,0,-1,0,0,0,-1,-1,-1
"9151",2020-01-31,"Slate River Rd","w1920","Motorized",16,"Fri","weekday","sled","2","1","1",7.4,0,31,0,20,23.9,0,-1,0,0,0,-1,-1,-1
"9152",2020-01-31,"Slate River Rd","w1920","Hybrid",NA,"Fri","weekday","sled","2","1","1",7.4,0,31,0,20,23.9,0,-1,0,0,0,-1,-1,-1
"9153",2020-02-01,"Slate River Rd","w1920","Non.motorized",58,"Sat","weekend","no_sled","2","1","1",7.4,0,31,0,28,23.9,0,0,-1,0,0,0,-1,-1
"9154",2020-02-01,"Slate River Rd","w1920","Mechanized",2,"Sat","weekend","no_sled","2","1","1",7.4,0,31,0,28,23.9,0,0,-1,0,0,0,-1,-1
"9155",2020-02-01,"Slate River Rd","w1920","Motorized",4,"Sat","weekend","sled","2","1","1",7.4,0,31,0,28,23.9,0,0,-1,0,0,0,-1,-1
"9156",2020-02-01,"Slate River Rd","w1920","Hybrid",NA,"Sat","weekend","sled","2","1","1",7.4,0,31,0,28,23.9,0,0,-1,0,0,0,-1,-1
"9157",2020-02-02,"Slate River Rd","w1920","Non.motorized",44,"Sun","weekend","no_sled","1","1","1",7.4,0,31,0,33,23.9,0,0,0,-1,0,0,0,-1
"9158",2020-02-02,"Slate River Rd","w1920","Mechanized",0,"Sun","weekend","no_sled","1","1","1",7.4,0,31,0,33,23.9,0,0,0,-1,0,0,0,-1
"9159",2020-02-02,"Slate River Rd","w1920","Motorized",4,"Sun","weekend","sled","1","1","1",7.4,0,31,0,33,23.9,0,0,0,-1,0,0,0,-1
"9160",2020-02-02,"Slate River Rd","w1920","Hybrid",NA,"Sun","weekend","sled","1","1","1",7.4,0,31,0,33,23.9,0,0,0,-1,0,0,0,-1
"9161",2020-02-03,"Slate River Rd","w1920","Non.motorized",14,"Mon","weekday","no_sled","2","2","1",7.4,0,31,0,24,23.9,0,0,0,0,0,0,0,0
"9162",2020-02-03,"Slate River Rd","w1920","Mechanized",0,"Mon","weekday","no_sled","2","2","1",7.4,0,31,0,24,23.9,0,0,0,0,0,0,0,0
"9163",2020-02-03,"Slate River Rd","w1920","Motorized",7,"Mon","weekday","sled","2","2","1",7.4,0,31,0,24,23.9,0,0,0,0,0,0,0,0
"9164",2020-02-03,"Slate River Rd","w1920","Hybrid",NA,"Mon","weekday","sled","2","2","1",7.4,0,31,0,24,23.9,0,0,0,0,0,0,0,0
"9165",2020-02-04,"Slate River Rd","w1920","Non.motorized",6,"Tue","weekday","no_sled","2","2","2",7.4,0,33,2,5,22.4,0,0,0,0,2,2,2,2
"9166",2020-02-04,"Slate River Rd","w1920","Mechanized",0,"Tue","weekday","no_sled","2","2","2",7.4,0,33,2,5,22.4,0,0,0,0,2,2,2,2
"9167",2020-02-04,"Slate River Rd","w1920","Motorized",5,"Tue","weekday","sled","2","2","2",7.4,0,33,2,5,22.4,0,0,0,0,2,2,2,2
"9168",2020-02-04,"Slate River Rd","w1920","Hybrid",NA,"Tue","weekday","sled","2","2","2",7.4,0,33,2,5,22.4,0,0,0,0,2,2,2,2
"9169",2020-02-05,"Slate River Rd","w1920","Non.motorized",12,"Wed","weekday","no_sled","2","2","1",7.4,0,33,0,2,22.4,2,0,0,0,2,2,2,2
"9170",2020-02-05,"Slate River Rd","w1920","Mechanized",1,"Wed","weekday","no_sled","2","2","1",7.4,0,33,0,2,22.4,2,0,0,0,2,2,2,2
"9171",2020-02-05,"Slate River Rd","w1920","Motorized",4,"Wed","weekday","sled","2","2","1",7.4,0,33,0,2,22.4,2,0,0,0,2,2,2,2
"9172",2020-02-05,"Slate River Rd","w1920","Hybrid",NA,"Wed","weekday","sled","2","2","1",7.4,0,33,0,2,22.4,2,0,0,0,2,2,2,2
"9173",2020-02-06,"Slate River Rd","w1920","Non.motorized",5,"Thu","weekday","no_sled","2","2","1",7.5,0.1,32,-1,16,23.4,0,2,0,0,-1,1,1,1
"9174",2020-02-06,"Slate River Rd","w1920","Mechanized",0,"Thu","weekday","no_sled","2","2","1",7.5,0.1,32,-1,16,23.4,0,2,0,0,-1,1,1,1
"9175",2020-02-06,"Slate River Rd","w1920","Motorized",3,"Thu","weekday","sled","2","2","1",7.5,0.1,32,-1,16,23.4,0,2,0,0,-1,1,1,1
"9176",2020-02-06,"Slate River Rd","w1920","Hybrid",NA,"Thu","weekday","sled","2","2","1",7.5,0.1,32,-1,16,23.4,0,2,0,0,-1,1,1,1
"9177",2020-02-07,"Slate River Rd","w1920","Non.motorized",3,"Fri","weekday","no_sled","3","3","3",7.9,0.4,37,5,26,21.4,-1,0,2,0,4,4,6,6
"9178",2020-02-07,"Slate River Rd","w1920","Mechanized",0,"Fri","weekday","no_sled","3","3","3",7.9,0.4,37,5,26,21.4,-1,0,2,0,4,4,6,6
"9179",2020-02-07,"Slate River Rd","w1920","Motorized",0,"Fri","weekday","sled","3","3","3",7.9,0.4,37,5,26,21.4,-1,0,2,0,4,4,6,6
"9180",2020-02-07,"Slate River Rd","w1920","Hybrid",NA,"Fri","weekday","sled","3","3","3",7.9,0.4,37,5,26,21.4,-1,0,2,0,4,4,6,6
"9181",2020-02-08,"Slate River Rd","w1920","Non.motorized",20,"Sat","weekend","no_sled","3","3","2",8.3,0.4,39,2,30,21.3,5,-1,0,2,7,6,6,8
"9182",2020-02-08,"Slate River Rd","w1920","Mechanized",0,"Sat","weekend","no_sled","3","3","2",8.3,0.4,39,2,30,21.3,5,-1,0,2,7,6,6,8
"9183",2020-02-08,"Slate River Rd","w1920","Motorized",1,"Sat","weekend","sled","3","3","2",8.3,0.4,39,2,30,21.3,5,-1,0,2,7,6,6,8
"9184",2020-02-08,"Slate River Rd","w1920","Hybrid",NA,"Sat","weekend","sled","3","3","2",8.3,0.4,39,2,30,21.3,5,-1,0,2,7,6,6,8
"9185",2020-02-09,"Slate River Rd","w1920","Non.motorized",17,"Sun","weekend","no_sled","3","2","2",8.4,0.1,38,-1,26,22.1,2,5,-1,0,1,6,5,5
"9186",2020-02-09,"Slate River Rd","w1920","Mechanized",0,"Sun","weekend","no_sled","3","2","2",8.4,0.1,38,-1,26,22.1,2,5,-1,0,1,6,5,5
"9187",2020-02-09,"Slate River Rd","w1920","Motorized",8,"Sun","weekend","sled","3","2","2",8.4,0.1,38,-1,26,22.1,2,5,-1,0,1,6,5,5
"9188",2020-02-09,"Slate River Rd","w1920","Hybrid",NA,"Sun","weekend","sled","3","2","2",8.4,0.1,38,-1,26,22.1,2,5,-1,0,1,6,5,5
"9189",2020-02-10,"Slate River Rd","w1920","Non.motorized",14,"Mon","weekday","no_sled","2","2","1",8.4,0,38,0,22,22.1,-1,2,5,-1,-1,1,6,5
"9190",2020-02-10,"Slate River Rd","w1920","Mechanized",0,"Mon","weekday","no_sled","2","2","1",8.4,0,38,0,22,22.1,-1,2,5,-1,-1,1,6,5
"9191",2020-02-10,"Slate River Rd","w1920","Motorized",11,"Mon","weekday","sled","2","2","1",8.4,0,38,0,22,22.1,-1,2,5,-1,-1,1,6,5
"9192",2020-02-10,"Slate River Rd","w1920","Hybrid",NA,"Mon","weekday","sled","2","2","1",8.4,0,38,0,22,22.1,-1,2,5,-1,-1,1,6,5
"9193",2020-02-11,"Slate River Rd","w1920","Non.motorized",2,"Tue","weekday","no_sled","2","2","2",8.5,0.1,40,2,16,21.2,0,-1,2,5,2,1,3,8
"9194",2020-02-11,"Slate River Rd","w1920","Mechanized",0,"Tue","weekday","no_sled","2","2","2",8.5,0.1,40,2,16,21.2,0,-1,2,5,2,1,3,8
"9195",2020-02-11,"Slate River Rd","w1920","Motorized",7,"Tue","weekday","sled","2","2","2",8.5,0.1,40,2,16,21.2,0,-1,2,5,2,1,3,8
"9196",2020-02-11,"Slate River Rd","w1920","Hybrid",NA,"Tue","weekday","sled","2","2","2",8.5,0.1,40,2,16,21.2,0,-1,2,5,2,1,3,8
"9197",2020-02-12,"Slate River Rd","w1920","Non.motorized",16,"Wed","weekday","no_sled","2","2","2",8.5,0,39,-1,15,21.8,2,0,-1,2,1,1,0,2
"9198",2020-02-12,"Slate River Rd","w1920","Mechanized",0,"Wed","weekday","no_sled","2","2","2",8.5,0,39,-1,15,21.8,2,0,-1,2,1,1,0,2
"9199",2020-02-12,"Slate River Rd","w1920","Motorized",5,"Wed","weekday","sled","2","2","2",8.5,0,39,-1,15,21.8,2,0,-1,2,1,1,0,2
"9200",2020-02-12,"Slate River Rd","w1920","Hybrid",NA,"Wed","weekday","sled","2","2","2",8.5,0,39,-1,15,21.8,2,0,-1,2,1,1,0,2
"9201",2020-02-13,"Slate River Rd","w1920","Non.motorized",18,"Thu","weekday","no_sled","2","2","1",8.5,0,39,0,18,21.8,-1,2,0,-1,-1,1,1,0
"9202",2020-02-13,"Slate River Rd","w1920","Mechanized",0,"Thu","weekday","no_sled","2","2","1",8.5,0,39,0,18,21.8,-1,2,0,-1,-1,1,1,0
"9203",2020-02-13,"Slate River Rd","w1920","Motorized",13,"Thu","weekday","sled","2","2","1",8.5,0,39,0,18,21.8,-1,2,0,-1,-1,1,1,0
"9204",2020-02-13,"Slate River Rd","w1920","Hybrid",NA,"Thu","weekday","sled","2","2","1",8.5,0,39,0,18,21.8,-1,2,0,-1,-1,1,1,0
"9205",2020-02-14,"Slate River Rd","w1920","Non.motorized",11,"Fri","weekday","no_sled","2","1","1",8.6,0.1,38,-1,24,22.6,0,-1,2,0,-1,-2,0,0
"9206",2020-02-14,"Slate River Rd","w1920","Mechanized",0,"Fri","weekday","no_sled","2","1","1",8.6,0.1,38,-1,24,22.6,0,-1,2,0,-1,-2,0,0
"9207",2020-02-14,"Slate River Rd","w1920","Motorized",6,"Fri","weekday","sled","2","1","1",8.6,0.1,38,-1,24,22.6,0,-1,2,0,-1,-2,0,0
"9208",2020-02-14,"Slate River Rd","w1920","Hybrid",NA,"Fri","weekday","sled","2","1","1",8.6,0.1,38,-1,24,22.6,0,-1,2,0,-1,-2,0,0
"9209",2020-02-15,"Slate River Rd","w1920","Non.motorized",8,"Sat","weekend","no_sled","1","1","1",8.6,0,38,0,26,22.6,-1,0,-1,2,-1,-1,-2,0
"9210",2020-02-15,"Slate River Rd","w1920","Mechanized",0,"Sat","weekend","no_sled","1","1","1",8.6,0,38,0,26,22.6,-1,0,-1,2,-1,-1,-2,0
"9211",2020-02-15,"Slate River Rd","w1920","Motorized",17,"Sat","weekend","sled","1","1","1",8.6,0,38,0,26,22.6,-1,0,-1,2,-1,-1,-2,0
"9212",2020-02-15,"Slate River Rd","w1920","Hybrid",NA,"Sat","weekend","sled","1","1","1",8.6,0,38,0,26,22.6,-1,0,-1,2,-1,-1,-2,0
"9213",2020-02-16,"Slate River Rd","w1920","Non.motorized",7,"Sun","weekend","no_sled","1","1","1",8.8,0.2,37,-1,26,23.8,0,-1,0,-1,-1,-2,-2,-3
"9214",2020-02-16,"Slate River Rd","w1920","Mechanized",0,"Sun","weekend","no_sled","1","1","1",8.8,0.2,37,-1,26,23.8,0,-1,0,-1,-1,-2,-2,-3
"9215",2020-02-16,"Slate River Rd","w1920","Motorized",5,"Sun","weekend","sled","1","1","1",8.8,0.2,37,-1,26,23.8,0,-1,0,-1,-1,-2,-2,-3
"9216",2020-02-16,"Slate River Rd","w1920","Hybrid",NA,"Sun","weekend","sled","1","1","1",8.8,0.2,37,-1,26,23.8,0,-1,0,-1,-1,-2,-2,-3
"9217",2020-02-17,"Slate River Rd","w1920","Non.motorized",17,"Mon","weekday","no_sled","2","1","1",9.2,0.4,43,6,25,21.4,-1,0,-1,0,5,5,4,4
"9218",2020-02-17,"Slate River Rd","w1920","Mechanized",0,"Mon","weekday","no_sled","2","1","1",9.2,0.4,43,6,25,21.4,-1,0,-1,0,5,5,4,4
"9219",2020-02-17,"Slate River Rd","w1920","Motorized",1,"Mon","weekday","sled","2","1","1",9.2,0.4,43,6,25,21.4,-1,0,-1,0,5,5,4,4
"9220",2020-02-17,"Slate River Rd","w1920","Hybrid",NA,"Mon","weekday","sled","2","1","1",9.2,0.4,43,6,25,21.4,-1,0,-1,0,5,5,4,4
"9221",2020-02-18,"Slate River Rd","w1920","Non.motorized",16,"Tue","weekday","no_sled","1","1","1",9.3,0.1,42,-1,18,22.1,6,-1,0,-1,5,4,4,3
"9222",2020-02-18,"Slate River Rd","w1920","Mechanized",0,"Tue","weekday","no_sled","1","1","1",9.3,0.1,42,-1,18,22.1,6,-1,0,-1,5,4,4,3
"9223",2020-02-18,"Slate River Rd","w1920","Motorized",2,"Tue","weekday","sled","1","1","1",9.3,0.1,42,-1,18,22.1,6,-1,0,-1,5,4,4,3
"9224",2020-02-18,"Slate River Rd","w1920","Hybrid",NA,"Tue","weekday","sled","1","1","1",9.3,0.1,42,-1,18,22.1,6,-1,0,-1,5,4,4,3
"9225",2020-02-19,"Slate River Rd","w1920","Non.motorized",26,"Wed","weekday","no_sled","1","1","1",9.3,0,41,-1,22,22.7,-1,6,-1,0,-2,4,3,3
"9226",2020-02-19,"Slate River Rd","w1920","Mechanized",0,"Wed","weekday","no_sled","1","1","1",9.3,0,41,-1,22,22.7,-1,6,-1,0,-2,4,3,3
"9227",2020-02-19,"Slate River Rd","w1920","Motorized",3,"Wed","weekday","sled","1","1","1",9.3,0,41,-1,22,22.7,-1,6,-1,0,-2,4,3,3
"9228",2020-02-19,"Slate River Rd","w1920","Hybrid",NA,"Wed","weekday","sled","1","1","1",9.3,0,41,-1,22,22.7,-1,6,-1,0,-2,4,3,3
"9229",2020-02-20,"Slate River Rd","w1920","Non.motorized",16,"Thu","weekday","no_sled","1","1","1",9.3,0,41,0,18,22.7,-1,-1,6,-1,-1,-2,4,3
"9230",2020-02-20,"Slate River Rd","w1920","Mechanized",0,"Thu","weekday","no_sled","1","1","1",9.3,0,41,0,18,22.7,-1,-1,6,-1,-1,-2,4,3
"9231",2020-02-20,"Slate River Rd","w1920","Motorized",4,"Thu","weekday","sled","1","1","1",9.3,0,41,0,18,22.7,-1,-1,6,-1,-1,-2,4,3
"9232",2020-02-20,"Slate River Rd","w1920","Hybrid",NA,"Thu","weekday","sled","1","1","1",9.3,0,41,0,18,22.7,-1,-1,6,-1,-1,-2,4,3
"9233",2020-02-21,"Slate River Rd","w1920","Non.motorized",12,"Fri","weekday","no_sled","1","1","1",9.3,0,40,-1,26,23.2,0,-1,-1,6,-1,-2,-3,3
"9234",2020-02-21,"Slate River Rd","w1920","Mechanized",0,"Fri","weekday","no_sled","1","1","1",9.3,0,40,-1,26,23.2,0,-1,-1,6,-1,-2,-3,3
"9235",2020-02-21,"Slate River Rd","w1920","Motorized",6,"Fri","weekday","sled","1","1","1",9.3,0,40,-1,26,23.2,0,-1,-1,6,-1,-2,-3,3
"9236",2020-02-21,"Slate River Rd","w1920","Hybrid",NA,"Fri","weekday","sled","1","1","1",9.3,0,40,-1,26,23.2,0,-1,-1,6,-1,-2,-3,3
"9237",2020-02-22,"Slate River Rd","w1920","Non.motorized",22,"Sat","weekend","no_sled","1","1","1",9.4,0.1,39,-1,32,24.1,-1,0,-1,-1,-2,-2,-3,-4
"9238",2020-02-22,"Slate River Rd","w1920","Mechanized",0,"Sat","weekend","no_sled","1","1","1",9.4,0.1,39,-1,32,24.1,-1,0,-1,-1,-2,-2,-3,-4
"9239",2020-02-22,"Slate River Rd","w1920","Motorized",9,"Sat","weekend","sled","1","1","1",9.4,0.1,39,-1,32,24.1,-1,0,-1,-1,-2,-2,-3,-4
"9240",2020-02-22,"Slate River Rd","w1920","Hybrid",NA,"Sat","weekend","sled","1","1","1",9.4,0.1,39,-1,32,24.1,-1,0,-1,-1,-2,-2,-3,-4
"9241",2020-02-23,"Slate River Rd","w1920","Non.motorized",14,"Sun","weekend","no_sled","2","2","2",9.5,0.1,40,1,27,23.8,-1,-1,0,-1,0,-1,-1,-2
"9242",2020-02-23,"Slate River Rd","w1920","Mechanized",0,"Sun","weekend","no_sled","2","2","2",9.5,0.1,40,1,27,23.8,-1,-1,0,-1,0,-1,-1,-2
"9243",2020-02-23,"Slate River Rd","w1920","Motorized",1,"Sun","weekend","sled","2","2","2",9.5,0.1,40,1,27,23.8,-1,-1,0,-1,0,-1,-1,-2
"9244",2020-02-23,"Slate River Rd","w1920","Hybrid",NA,"Sun","weekend","sled","2","2","2",9.5,0.1,40,1,27,23.8,-1,-1,0,-1,0,-1,-1,-2
"9245",2020-02-24,"Slate River Rd","w1920","Non.motorized",15,"Mon","weekday","no_sled","3","3","2",9.8,0.3,43,3,17,22.8,1,-1,-1,0,4,3,2,2
"9246",2020-02-24,"Slate River Rd","w1920","Mechanized",0,"Mon","weekday","no_sled","3","3","2",9.8,0.3,43,3,17,22.8,1,-1,-1,0,4,3,2,2
"9247",2020-02-24,"Slate River Rd","w1920","Motorized",1,"Mon","weekday","sled","3","3","2",9.8,0.3,43,3,17,22.8,1,-1,-1,0,4,3,2,2
"9248",2020-02-24,"Slate River Rd","w1920","Hybrid",NA,"Mon","weekday","sled","3","3","2",9.8,0.3,43,3,17,22.8,1,-1,-1,0,4,3,2,2
"9249",2020-02-25,"Slate River Rd","w1920","Non.motorized",28,"Tue","weekday","no_sled","2","2","1",9.8,0,43,0,8,22.8,3,1,-1,-1,3,4,3,2
"9250",2020-02-25,"Slate River Rd","w1920","Mechanized",0,"Tue","weekday","no_sled","2","2","1",9.8,0,43,0,8,22.8,3,1,-1,-1,3,4,3,2
"9251",2020-02-25,"Slate River Rd","w1920","Motorized",2,"Tue","weekday","sled","2","2","1",9.8,0,43,0,8,22.8,3,1,-1,-1,3,4,3,2
"9252",2020-02-25,"Slate River Rd","w1920","Hybrid",NA,"Tue","weekday","sled","2","2","1",9.8,0,43,0,8,22.8,3,1,-1,-1,3,4,3,2
"9253",2020-02-26,"Slate River Rd","w1920","Non.motorized",2,"Wed","weekday","no_sled","2","2","1",9.8,0,42,-1,15,23.3,0,3,1,-1,-1,2,3,2
"9254",2020-02-26,"Slate River Rd","w1920","Mechanized",0,"Wed","weekday","no_sled","2","2","1",9.8,0,42,-1,15,23.3,0,3,1,-1,-1,2,3,2
"9255",2020-02-26,"Slate River Rd","w1920","Motorized",5,"Wed","weekday","sled","2","2","1",9.8,0,42,-1,15,23.3,0,3,1,-1,-1,2,3,2
"9256",2020-02-26,"Slate River Rd","w1920","Hybrid",NA,"Wed","weekday","sled","2","2","1",9.8,0,42,-1,15,23.3,0,3,1,-1,-1,2,3,2
"9257",2020-02-27,"Slate River Rd","w1920","Non.motorized",4,"Thu","weekday","no_sled","2","2","1",9.9,0.1,41,-1,25,24.1,-1,0,3,1,-2,-2,1,2
"9258",2020-02-27,"Slate River Rd","w1920","Mechanized",0,"Thu","weekday","no_sled","2","2","1",9.9,0.1,41,-1,25,24.1,-1,0,3,1,-2,-2,1,2
"9259",2020-02-27,"Slate River Rd","w1920","Motorized",11,"Thu","weekday","sled","2","2","1",9.9,0.1,41,-1,25,24.1,-1,0,3,1,-2,-2,1,2
"9260",2020-02-27,"Slate River Rd","w1920","Hybrid",NA,"Thu","weekday","sled","2","2","1",9.9,0.1,41,-1,25,24.1,-1,0,3,1,-2,-2,1,2
"9261",2020-02-28,"Slate River Rd","w1920","Non.motorized",11,"Fri","weekday","no_sled","2","1","1",9.9,0,41,0,28,24.1,-1,-1,0,3,-1,-2,-2,1
"9262",2020-02-28,"Slate River Rd","w1920","Mechanized",0,"Fri","weekday","no_sled","2","1","1",9.9,0,41,0,28,24.1,-1,-1,0,3,-1,-2,-2,1
"9263",2020-02-28,"Slate River Rd","w1920","Motorized",3,"Fri","weekday","sled","2","1","1",9.9,0,41,0,28,24.1,-1,-1,0,3,-1,-2,-2,1
"9264",2020-02-28,"Slate River Rd","w1920","Hybrid",NA,"Fri","weekday","sled","2","1","1",9.9,0,41,0,28,24.1,-1,-1,0,3,-1,-2,-2,1
"9265",2020-02-29,"Slate River Rd","w1920","Non.motorized",13,"Sat","weekend","no_sled","1","1","1",9.9,0,40,-1,29,24.8,0,-1,-1,0,-1,-2,-3,-3
"9266",2020-02-29,"Slate River Rd","w1920","Mechanized",0,"Sat","weekend","no_sled","1","1","1",9.9,0,40,-1,29,24.8,0,-1,-1,0,-1,-2,-3,-3
"9267",2020-02-29,"Slate River Rd","w1920","Motorized",0,"Sat","weekend","sled","1","1","1",9.9,0,40,-1,29,24.8,0,-1,-1,0,-1,-2,-3,-3
"9268",2020-02-29,"Slate River Rd","w1920","Hybrid",NA,"Sat","weekend","sled","1","1","1",9.9,0,40,-1,29,24.8,0,-1,-1,0,-1,-2,-3,-3
"9269",2020-03-01,"Slate River Rd","w1920","Non.motorized",14,"Sun","weekend","no_sled","1","1","1",10,0.1,40,0,28,25,-1,0,-1,-1,-1,-1,-2,-3
"9270",2020-03-01,"Slate River Rd","w1920","Mechanized",0,"Sun","weekend","no_sled","1","1","1",10,0.1,40,0,28,25,-1,0,-1,-1,-1,-1,-2,-3
"9271",2020-03-01,"Slate River Rd","w1920","Motorized",3,"Sun","weekend","sled","1","1","1",10,0.1,40,0,28,25,-1,0,-1,-1,-1,-1,-2,-3
"9272",2020-03-01,"Slate River Rd","w1920","Hybrid",NA,"Sun","weekend","sled","1","1","1",10,0.1,40,0,28,25,-1,0,-1,-1,-1,-1,-2,-3
"9273",2020-03-02,"Slate River Rd","w1920","Non.motorized",13,"Mon","weekday","no_sled","2","2","1",10.4,0.4,45,5,25,23.1,0,-1,0,-1,5,4,4,3
"9274",2020-03-02,"Slate River Rd","w1920","Mechanized",0,"Mon","weekday","no_sled","2","2","1",10.4,0.4,45,5,25,23.1,0,-1,0,-1,5,4,4,3
"9275",2020-03-02,"Slate River Rd","w1920","Motorized",1,"Mon","weekday","sled","2","2","1",10.4,0.4,45,5,25,23.1,0,-1,0,-1,5,4,4,3
"9276",2020-03-02,"Slate River Rd","w1920","Hybrid",NA,"Mon","weekday","sled","2","2","1",10.4,0.4,45,5,25,23.1,0,-1,0,-1,5,4,4,3
"9277",2020-03-03,"Slate River Rd","w1920","Non.motorized",35,"Tue","weekday","no_sled","2","1","1",10.9,0.5,50,5,25,21.8,5,0,-1,0,10,10,9,9
"9278",2020-03-03,"Slate River Rd","w1920","Mechanized",4,"Tue","weekday","no_sled","2","1","1",10.9,0.5,50,5,25,21.8,5,0,-1,0,10,10,9,9
"9279",2020-03-03,"Slate River Rd","w1920","Motorized",6,"Tue","weekday","sled","2","1","1",10.9,0.5,50,5,25,21.8,5,0,-1,0,10,10,9,9
"9280",2020-03-03,"Slate River Rd","w1920","Hybrid",NA,"Tue","weekday","sled","2","1","1",10.9,0.5,50,5,25,21.8,5,0,-1,0,10,10,9,9
"9281",2020-03-04,"Slate River Rd","w1920","Non.motorized",28,"Wed","weekday","no_sled","2","1","1",10.9,0,48,-2,29,22.7,5,5,0,-1,3,8,8,7
"9282",2020-03-04,"Slate River Rd","w1920","Mechanized",1,"Wed","weekday","no_sled","2","1","1",10.9,0,48,-2,29,22.7,5,5,0,-1,3,8,8,7
"9283",2020-03-04,"Slate River Rd","w1920","Motorized",6,"Wed","weekday","sled","2","1","1",10.9,0,48,-2,29,22.7,5,5,0,-1,3,8,8,7
"9284",2020-03-04,"Slate River Rd","w1920","Hybrid",NA,"Wed","weekday","sled","2","1","1",10.9,0,48,-2,29,22.7,5,5,0,-1,3,8,8,7
"9285",2020-03-05,"Slate River Rd","w1920","Non.motorized",6,"Thu","weekday","no_sled","2","1","1",10.9,0,46,-2,32,23.7,-2,5,5,0,-4,1,6,6
"9286",2020-03-05,"Slate River Rd","w1920","Mechanized",0,"Thu","weekday","no_sled","2","1","1",10.9,0,46,-2,32,23.7,-2,5,5,0,-4,1,6,6
"9287",2020-03-05,"Slate River Rd","w1920","Motorized",3,"Thu","weekday","sled","2","1","1",10.9,0,46,-2,32,23.7,-2,5,5,0,-4,1,6,6
"9288",2020-03-05,"Slate River Rd","w1920","Hybrid",NA,"Thu","weekday","sled","2","1","1",10.9,0,46,-2,32,23.7,-2,5,5,0,-4,1,6,6
"9289",2020-03-06,"Slate River Rd","w1920","Non.motorized",NA,"Fri","weekday","no_sled","1","1","1",10.9,0,45,-1,34,24.2,-2,-2,5,5,-3,-5,0,5
"9290",2020-03-06,"Slate River Rd","w1920","Mechanized",NA,"Fri","weekday","no_sled","1","1","1",10.9,0,45,-1,34,24.2,-2,-2,5,5,-3,-5,0,5
"9291",2020-03-06,"Slate River Rd","w1920","Motorized",NA,"Fri","weekday","sled","1","1","1",10.9,0,45,-1,34,24.2,-2,-2,5,5,-3,-5,0,5
"9292",2020-03-06,"Slate River Rd","w1920","Hybrid",NA,"Fri","weekday","sled","1","1","1",10.9,0,45,-1,34,24.2,-2,-2,5,5,-3,-5,0,5
"9293",2020-03-07,"Slate River Rd","w1920","Non.motorized",22,"Sat","weekend","no_sled","1","1","2",10.9,0,44,-1,35,24.8,-1,-2,-2,5,-2,-4,-6,-1
"9294",2020-03-07,"Slate River Rd","w1920","Mechanized",0,"Sat","weekend","no_sled","1","1","2",10.9,0,44,-1,35,24.8,-1,-2,-2,5,-2,-4,-6,-1
"9295",2020-03-07,"Slate River Rd","w1920","Motorized",0,"Sat","weekend","sled","1","1","2",10.9,0,44,-1,35,24.8,-1,-2,-2,5,-2,-4,-6,-1
"9296",2020-03-07,"Slate River Rd","w1920","Hybrid",NA,"Sat","weekend","sled","1","1","2",10.9,0,44,-1,35,24.8,-1,-2,-2,5,-2,-4,-6,-1
"9297",2020-03-08,"Slate River Rd","w1920","Non.motorized",NA,"Sun","weekend","no_sled","1","1","1",11,0.1,43,-1,33,25.6,-1,-1,-2,-2,-2,-3,-5,-7
"9298",2020-03-08,"Slate River Rd","w1920","Mechanized",NA,"Sun","weekend","no_sled","1","1","1",11,0.1,43,-1,33,25.6,-1,-1,-2,-2,-2,-3,-5,-7
"9299",2020-03-08,"Slate River Rd","w1920","Motorized",NA,"Sun","weekend","sled","1","1","1",11,0.1,43,-1,33,25.6,-1,-1,-2,-2,-2,-3,-5,-7
"9300",2020-03-08,"Slate River Rd","w1920","Hybrid",NA,"Sun","weekend","sled","1","1","1",11,0.1,43,-1,33,25.6,-1,-1,-2,-2,-2,-3,-5,-7
"9301",2020-03-09,"Slate River Rd","w1920","Non.motorized",NA,"Mon","weekday","no_sled","1","1","1",11.1,0.1,42,-1,31,26.4,-1,-1,-1,-2,-2,-3,-4,-6
"9302",2020-03-09,"Slate River Rd","w1920","Mechanized",NA,"Mon","weekday","no_sled","1","1","1",11.1,0.1,42,-1,31,26.4,-1,-1,-1,-2,-2,-3,-4,-6
"9303",2020-03-09,"Slate River Rd","w1920","Motorized",NA,"Mon","weekday","sled","1","1","1",11.1,0.1,42,-1,31,26.4,-1,-1,-1,-2,-2,-3,-4,-6
"9304",2020-03-09,"Slate River Rd","w1920","Hybrid",NA,"Mon","weekday","sled","1","1","1",11.1,0.1,42,-1,31,26.4,-1,-1,-1,-2,-2,-3,-4,-6
"9305",2020-03-10,"Slate River Rd","w1920","Non.motorized",NA,"Tue","weekday","no_sled","1","1","2",11.2,0.1,44,2,31,25.5,-1,-1,-1,-1,1,0,-1,-2
"9306",2020-03-10,"Slate River Rd","w1920","Mechanized",NA,"Tue","weekday","no_sled","1","1","2",11.2,0.1,44,2,31,25.5,-1,-1,-1,-1,1,0,-1,-2
"9307",2020-03-10,"Slate River Rd","w1920","Motorized",NA,"Tue","weekday","sled","1","1","2",11.2,0.1,44,2,31,25.5,-1,-1,-1,-1,1,0,-1,-2
"9308",2020-03-10,"Slate River Rd","w1920","Hybrid",NA,"Tue","weekday","sled","1","1","2",11.2,0.1,44,2,31,25.5,-1,-1,-1,-1,1,0,-1,-2
"9309",2020-03-11,"Slate River Rd","w1920","Non.motorized",NA,"Wed","weekday","no_sled","2","2","1",11.2,0,44,0,32,25.5,2,-1,-1,-1,2,1,0,-1
"9310",2020-03-11,"Slate River Rd","w1920","Mechanized",NA,"Wed","weekday","no_sled","2","2","1",11.2,0,44,0,32,25.5,2,-1,-1,-1,2,1,0,-1
"9311",2020-03-11,"Slate River Rd","w1920","Motorized",NA,"Wed","weekday","sled","2","2","1",11.2,0,44,0,32,25.5,2,-1,-1,-1,2,1,0,-1
"9312",2020-03-11,"Slate River Rd","w1920","Hybrid",NA,"Wed","weekday","sled","2","2","1",11.2,0,44,0,32,25.5,2,-1,-1,-1,2,1,0,-1
"9313",2020-03-12,"Slate River Rd","w1920","Non.motorized",NA,"Thu","weekday","no_sled","2","2","2",11.4,0.2,42,-2,35,27.1,0,2,-1,-1,-2,0,-1,-2
"9314",2020-03-12,"Slate River Rd","w1920","Mechanized",NA,"Thu","weekday","no_sled","2","2","2",11.4,0.2,42,-2,35,27.1,0,2,-1,-1,-2,0,-1,-2
"9315",2020-03-12,"Slate River Rd","w1920","Motorized",NA,"Thu","weekday","sled","2","2","2",11.4,0.2,42,-2,35,27.1,0,2,-1,-1,-2,0,-1,-2
"9316",2020-03-12,"Slate River Rd","w1920","Hybrid",NA,"Thu","weekday","sled","2","2","2",11.4,0.2,42,-2,35,27.1,0,2,-1,-1,-2,0,-1,-2
"9317",2020-03-13,"Slate River Rd","w1920","Non.motorized",NA,"Fri","weekday","no_sled","3","3","2",11.5,0.1,44,2,31,26.1,-2,0,2,-1,0,0,2,1
"9318",2020-03-13,"Slate River Rd","w1920","Mechanized",NA,"Fri","weekday","no_sled","3","3","2",11.5,0.1,44,2,31,26.1,-2,0,2,-1,0,0,2,1
"9319",2020-03-13,"Slate River Rd","w1920","Motorized",NA,"Fri","weekday","sled","3","3","2",11.5,0.1,44,2,31,26.1,-2,0,2,-1,0,0,2,1
"9320",2020-03-13,"Slate River Rd","w1920","Hybrid",NA,"Fri","weekday","sled","3","3","2",11.5,0.1,44,2,31,26.1,-2,0,2,-1,0,0,2,1
"9321",2020-03-14,"Slate River Rd","w1920","Non.motorized",NA,"Sat","weekend","no_sled","3","3","3",11.7,0.2,44,0,31,26.6,2,-2,0,2,2,0,0,2
"9322",2020-03-14,"Slate River Rd","w1920","Mechanized",NA,"Sat","weekend","no_sled","3","3","3",11.7,0.2,44,0,31,26.6,2,-2,0,2,2,0,0,2
"9323",2020-03-14,"Slate River Rd","w1920","Motorized",NA,"Sat","weekend","sled","3","3","3",11.7,0.2,44,0,31,26.6,2,-2,0,2,2,0,0,2
"9324",2020-03-14,"Slate River Rd","w1920","Hybrid",NA,"Sat","weekend","sled","3","3","3",11.7,0.2,44,0,31,26.6,2,-2,0,2,2,0,0,2
"9325",2020-03-15,"Slate River Rd","w1920","Non.motorized",NA,"Sun","weekend","no_sled","2","2","2",11.7,0,45,1,33,26,0,2,-2,0,1,3,1,1
"9326",2020-03-15,"Slate River Rd","w1920","Mechanized",NA,"Sun","weekend","no_sled","2","2","2",11.7,0,45,1,33,26,0,2,-2,0,1,3,1,1
"9327",2020-03-15,"Slate River Rd","w1920","Motorized",NA,"Sun","weekend","sled","2","2","2",11.7,0,45,1,33,26,0,2,-2,0,1,3,1,1
"9328",2020-03-15,"Slate River Rd","w1920","Hybrid",NA,"Sun","weekend","sled","2","2","2",11.7,0,45,1,33,26,0,2,-2,0,1,3,1,1
"9329",2020-03-16,"Slate River Rd","w1920","Non.motorized",NA,"Mon","weekday","no_sled","2","2","2",11.7,0,45,0,35,26,1,0,2,-2,1,1,3,1
"9330",2020-03-16,"Slate River Rd","w1920","Mechanized",NA,"Mon","weekday","no_sled","2","2","2",11.7,0,45,0,35,26,1,0,2,-2,1,1,3,1
"9331",2020-03-16,"Slate River Rd","w1920","Motorized",NA,"Mon","weekday","sled","2","2","2",11.7,0,45,0,35,26,1,0,2,-2,1,1,3,1
"9332",2020-03-16,"Slate River Rd","w1920","Hybrid",NA,"Mon","weekday","sled","2","2","2",11.7,0,45,0,35,26,1,0,2,-2,1,1,3,1
"9333",2020-03-17,"Slate River Rd","w1920","Non.motorized",2,"Tue","weekday","no_sled","2","2","2",11.7,0,44,-1,36,26.6,0,1,0,2,-1,0,0,2
"9334",2020-03-17,"Slate River Rd","w1920","Mechanized",0,"Tue","weekday","no_sled","2","2","2",11.7,0,44,-1,36,26.6,0,1,0,2,-1,0,0,2
"9335",2020-03-17,"Slate River Rd","w1920","Motorized",3,"Tue","weekday","sled","2","2","2",11.7,0,44,-1,36,26.6,0,1,0,2,-1,0,0,2
"9336",2020-03-17,"Slate River Rd","w1920","Hybrid",NA,"Tue","weekday","sled","2","2","2",11.7,0,44,-1,36,26.6,0,1,0,2,-1,0,0,2
"9337",2020-03-18,"Slate River Rd","w1920","Non.motorized",15,"Wed","weekday","no_sled","2","2","2",11.7,0,43,-1,33,27.2,-1,0,1,0,-2,-2,-1,-1
"9338",2020-03-18,"Slate River Rd","w1920","Mechanized",0,"Wed","weekday","no_sled","2","2","2",11.7,0,43,-1,33,27.2,-1,0,1,0,-2,-2,-1,-1
"9339",2020-03-18,"Slate River Rd","w1920","Motorized",4,"Wed","weekday","sled","2","2","2",11.7,0,43,-1,33,27.2,-1,0,1,0,-2,-2,-1,-1
"9340",2020-03-18,"Slate River Rd","w1920","Hybrid",NA,"Wed","weekday","sled","2","2","2",11.7,0,43,-1,33,27.2,-1,0,1,0,-2,-2,-1,-1
"9341",2020-03-19,"Slate River Rd","w1920","Non.motorized",22,"Thu","weekday","no_sled","3","3","3",11.8,0.1,43,0,27,27.4,-1,-1,0,1,-1,-2,-2,-1
"9342",2020-03-19,"Slate River Rd","w1920","Mechanized",0,"Thu","weekday","no_sled","3","3","3",11.8,0.1,43,0,27,27.4,-1,-1,0,1,-1,-2,-2,-1
"9343",2020-03-19,"Slate River Rd","w1920","Motorized",11,"Thu","weekday","sled","3","3","3",11.8,0.1,43,0,27,27.4,-1,-1,0,1,-1,-2,-2,-1
"9344",2020-03-19,"Slate River Rd","w1920","Hybrid",NA,"Thu","weekday","sled","3","3","3",11.8,0.1,43,0,27,27.4,-1,-1,0,1,-1,-2,-2,-1
"9345",2020-03-20,"Slate River Rd","w1920","Non.motorized",33,"Fri","weekday","no_sled","3","3","2",12.7,0.9,52,9,26,24.4,0,-1,-1,0,9,8,7,7
"9346",2020-03-20,"Slate River Rd","w1920","Mechanized",0,"Fri","weekday","no_sled","3","3","2",12.7,0.9,52,9,26,24.4,0,-1,-1,0,9,8,7,7
"9347",2020-03-20,"Slate River Rd","w1920","Motorized",14,"Fri","weekday","sled","3","3","2",12.7,0.9,52,9,26,24.4,0,-1,-1,0,9,8,7,7
"9348",2020-03-20,"Slate River Rd","w1920","Hybrid",NA,"Fri","weekday","sled","3","3","2",12.7,0.9,52,9,26,24.4,0,-1,-1,0,9,8,7,7
"9349",2020-03-21,"Slate River Rd","w1920","Non.motorized",3,"Sat","weekend","no_sled","3","3","2",12.8,0.1,54,2,26,23.7,9,0,-1,-1,11,11,10,9
"9350",2020-03-21,"Slate River Rd","w1920","Mechanized",0,"Sat","weekend","no_sled","3","3","2",12.8,0.1,54,2,26,23.7,9,0,-1,-1,11,11,10,9
"9351",2020-03-21,"Slate River Rd","w1920","Motorized",6,"Sat","weekend","sled","3","3","2",12.8,0.1,54,2,26,23.7,9,0,-1,-1,11,11,10,9
"9352",2020-03-21,"Slate River Rd","w1920","Hybrid",NA,"Sat","weekend","sled","3","3","2",12.8,0.1,54,2,26,23.7,9,0,-1,-1,11,11,10,9
"9353",2020-03-22,"Slate River Rd","w1920","Non.motorized",16,"Sun","weekend","no_sled","2","2","2",13,0.2,53,-1,28,24.5,2,9,0,-1,1,10,10,9
"9354",2020-03-22,"Slate River Rd","w1920","Mechanized",0,"Sun","weekend","no_sled","2","2","2",13,0.2,53,-1,28,24.5,2,9,0,-1,1,10,10,9
"9355",2020-03-22,"Slate River Rd","w1920","Motorized",2,"Sun","weekend","sled","2","2","2",13,0.2,53,-1,28,24.5,2,9,0,-1,1,10,10,9
"9356",2020-03-22,"Slate River Rd","w1920","Hybrid",NA,"Sun","weekend","sled","2","2","2",13,0.2,53,-1,28,24.5,2,9,0,-1,1,10,10,9
"9357",2020-03-23,"Slate River Rd","w1920","Non.motorized",36,"Mon","weekday","no_sled","2","2","2",13,0,53,0,28,24.5,-1,2,9,0,-1,1,10,10
"9358",2020-03-23,"Slate River Rd","w1920","Mechanized",1,"Mon","weekday","no_sled","2","2","2",13,0,53,0,28,24.5,-1,2,9,0,-1,1,10,10
"9359",2020-03-23,"Slate River Rd","w1920","Motorized",1,"Mon","weekday","sled","2","2","2",13,0,53,0,28,24.5,-1,2,9,0,-1,1,10,10
"9360",2020-03-23,"Slate River Rd","w1920","Hybrid",NA,"Mon","weekday","sled","2","2","2",13,0,53,0,28,24.5,-1,2,9,0,-1,1,10,10
"9361",2020-03-24,"Slate River Rd","w1920","Non.motorized",32,"Tue","weekday","no_sled","2","2","2",13.2,0.2,53,0,32,24.9,0,-1,2,9,0,-1,1,10
"9362",2020-03-24,"Slate River Rd","w1920","Mechanized",0,"Tue","weekday","no_sled","2","2","2",13.2,0.2,53,0,32,24.9,0,-1,2,9,0,-1,1,10
"9363",2020-03-24,"Slate River Rd","w1920","Motorized",5,"Tue","weekday","sled","2","2","2",13.2,0.2,53,0,32,24.9,0,-1,2,9,0,-1,1,10
"9364",2020-03-24,"Slate River Rd","w1920","Hybrid",NA,"Tue","weekday","sled","2","2","2",13.2,0.2,53,0,32,24.9,0,-1,2,9,0,-1,1,10
"9365",2020-03-25,"Slate River Rd","w1920","Non.motorized",3,"Wed","weekday","no_sled","2","2","2",13.3,0.1,51,-2,34,26.1,0,0,-1,2,-2,-2,-3,-1
"9366",2020-03-25,"Slate River Rd","w1920","Mechanized",1,"Wed","weekday","no_sled","2","2","2",13.3,0.1,51,-2,34,26.1,0,0,-1,2,-2,-2,-3,-1
"9367",2020-03-25,"Slate River Rd","w1920","Motorized",6,"Wed","weekday","sled","2","2","2",13.3,0.1,51,-2,34,26.1,0,0,-1,2,-2,-2,-3,-1
"9368",2020-03-25,"Slate River Rd","w1920","Hybrid",NA,"Wed","weekday","sled","2","2","2",13.3,0.1,51,-2,34,26.1,0,0,-1,2,-2,-2,-3,-1
"9369",2020-03-26,"Slate River Rd","w1920","Non.motorized",26,"Thu","weekday","no_sled","2","2","2",13.3,0,50,-1,36,26.6,-2,0,0,-1,-3,-3,-3,-4
"9370",2020-03-26,"Slate River Rd","w1920","Non.motorized",26,"Thu","weekday","no_sled","3","3","2",13.3,0,50,-1,36,26.6,-2,0,0,-1,-3,-3,-3,-4
"9371",2020-03-26,"Slate River Rd","w1920","Mechanized",0,"Thu","weekday","no_sled","2","2","2",13.3,0,50,-1,36,26.6,-2,0,0,-1,-3,-3,-3,-4
"9372",2020-03-26,"Slate River Rd","w1920","Mechanized",0,"Thu","weekday","no_sled","3","3","2",13.3,0,50,-1,36,26.6,-2,0,0,-1,-3,-3,-3,-4
"9373",2020-03-26,"Slate River Rd","w1920","Motorized",2,"Thu","weekday","sled","2","2","2",13.3,0,50,-1,36,26.6,-2,0,0,-1,-3,-3,-3,-4
"9374",2020-03-26,"Slate River Rd","w1920","Motorized",2,"Thu","weekday","sled","3","3","2",13.3,0,50,-1,36,26.6,-2,0,0,-1,-3,-3,-3,-4
"9375",2020-03-26,"Slate River Rd","w1920","Hybrid",NA,"Thu","weekday","sled","2","2","2",13.3,0,50,-1,36,26.6,-2,0,0,-1,-3,-3,-3,-4
"9376",2020-03-26,"Slate River Rd","w1920","Hybrid",NA,"Thu","weekday","sled","3","3","2",13.3,0,50,-1,36,26.6,-2,0,0,-1,-3,-3,-3,-4
"9377",2020-03-27,"Slate River Rd","w1920","Non.motorized",11,"Fri","weekday","no_sled","3","3","2",13.3,0,50,0,23,26.6,-1,-2,0,0,-1,-3,-3,-3
"9378",2020-03-27,"Slate River Rd","w1920","Mechanized",0,"Fri","weekday","no_sled","3","3","2",13.3,0,50,0,23,26.6,-1,-2,0,0,-1,-3,-3,-3
"9379",2020-03-27,"Slate River Rd","w1920","Motorized",2,"Fri","weekday","sled","3","3","2",13.3,0,50,0,23,26.6,-1,-2,0,0,-1,-3,-3,-3
"9380",2020-03-27,"Slate River Rd","w1920","Hybrid",NA,"Fri","weekday","sled","3","3","2",13.3,0,50,0,23,26.6,-1,-2,0,0,-1,-3,-3,-3
"9381",2020-03-28,"Slate River Rd","w1920","Non.motorized",14,"Sat","weekend","no_sled","3","3","3",13.3,0,50,0,18,26.6,0,-1,-2,0,0,-1,-3,-3
"9382",2020-03-28,"Slate River Rd","w1920","Mechanized",0,"Sat","weekend","no_sled","3","3","3",13.3,0,50,0,18,26.6,0,-1,-2,0,0,-1,-3,-3
"9383",2020-03-28,"Slate River Rd","w1920","Motorized",3,"Sat","weekend","sled","3","3","3",13.3,0,50,0,18,26.6,0,-1,-2,0,0,-1,-3,-3
"9384",2020-03-28,"Slate River Rd","w1920","Hybrid",NA,"Sat","weekend","sled","3","3","3",13.3,0,50,0,18,26.6,0,-1,-2,0,0,-1,-3,-3
"9385",2020-03-29,"Slate River Rd","w1920","Non.motorized",10,"Sun","weekend","no_sled","2","2","2",13.3,0,49,-1,24,27.1,0,0,-1,-2,-1,-1,-2,-4
"9386",2020-03-29,"Slate River Rd","w1920","Mechanized",0,"Sun","weekend","no_sled","2","2","2",13.3,0,49,-1,24,27.1,0,0,-1,-2,-1,-1,-2,-4
"9387",2020-03-29,"Slate River Rd","w1920","Motorized",7,"Sun","weekend","sled","2","2","2",13.3,0,49,-1,24,27.1,0,0,-1,-2,-1,-1,-2,-4
"9388",2020-03-29,"Slate River Rd","w1920","Hybrid",NA,"Sun","weekend","sled","2","2","2",13.3,0,49,-1,24,27.1,0,0,-1,-2,-1,-1,-2,-4
"9389",2020-03-30,"Slate River Rd","w1920","Non.motorized",32,"Mon","weekday","no_sled","2","2","2",13.4,0.1,49,0,29,27.3,-1,0,0,-1,-1,-1,-1,-2
"9390",2020-03-30,"Slate River Rd","w1920","Mechanized",2,"Mon","weekday","no_sled","2","2","2",13.4,0.1,49,0,29,27.3,-1,0,0,-1,-1,-1,-1,-2
"9391",2020-03-30,"Slate River Rd","w1920","Motorized",7,"Mon","weekday","sled","2","2","2",13.4,0.1,49,0,29,27.3,-1,0,0,-1,-1,-1,-1,-2
"9392",2020-03-30,"Slate River Rd","w1920","Hybrid",NA,"Mon","weekday","sled","2","2","2",13.4,0.1,49,0,29,27.3,-1,0,0,-1,-1,-1,-1,-2
"9393",2020-03-31,"Slate River Rd","w1920","Non.motorized",8,"Tue","weekday","no_sled","2","2","2",13.6,0.2,51,2,35,26.7,0,-1,0,0,2,1,1,1
"9394",2020-03-31,"Slate River Rd","w1920","Mechanized",0,"Tue","weekday","no_sled","2","2","2",13.6,0.2,51,2,35,26.7,0,-1,0,0,2,1,1,1
"9395",2020-03-31,"Slate River Rd","w1920","Motorized",9,"Tue","weekday","sled","2","2","2",13.6,0.2,51,2,35,26.7,0,-1,0,0,2,1,1,1
"9396",2020-03-31,"Slate River Rd","w1920","Hybrid",NA,"Tue","weekday","sled","2","2","2",13.6,0.2,51,2,35,26.7,0,-1,0,0,2,1,1,1
"9397",2020-04-01,"Slate River Rd","w1920","Non.motorized",4,"Wed","weekday","no_sled","2","2","2",13.6,0,47,-4,39,28.9,2,0,-1,0,-2,-2,-3,-3
"9398",2020-04-01,"Slate River Rd","w1920","Mechanized",0,"Wed","weekday","no_sled","2","2","2",13.6,0,47,-4,39,28.9,2,0,-1,0,-2,-2,-3,-3
"9399",2020-04-01,"Slate River Rd","w1920","Motorized",3,"Wed","weekday","sled","2","2","2",13.6,0,47,-4,39,28.9,2,0,-1,0,-2,-2,-3,-3
"9400",2020-04-01,"Slate River Rd","w1920","Hybrid",NA,"Wed","weekday","sled","2","2","2",13.6,0,47,-4,39,28.9,2,0,-1,0,-2,-2,-3,-3
"9401",2020-04-02,"Slate River Rd","w1920","Non.motorized",19,"Thu","weekday","no_sled","2","2","2",13.6,0,46,-1,31,29.6,-4,2,0,-1,-5,-3,-3,-4
"9402",2020-04-02,"Slate River Rd","w1920","Mechanized",0,"Thu","weekday","no_sled","2","2","2",13.6,0,46,-1,31,29.6,-4,2,0,-1,-5,-3,-3,-4
"9403",2020-04-02,"Slate River Rd","w1920","Motorized",0,"Thu","weekday","sled","2","2","2",13.6,0,46,-1,31,29.6,-4,2,0,-1,-5,-3,-3,-4
"9404",2020-04-02,"Slate River Rd","w1920","Hybrid",NA,"Thu","weekday","sled","2","2","2",13.6,0,46,-1,31,29.6,-4,2,0,-1,-5,-3,-3,-4
"9405",2020-04-03,"Slate River Rd","w1920","Non.motorized",11,"Fri","weekday","no_sled","2","2","2",13.6,0,46,0,28,29.6,-1,-4,2,0,-1,-5,-3,-3
"9406",2020-04-03,"Slate River Rd","w1920","Mechanized",0,"Fri","weekday","no_sled","2","2","2",13.6,0,46,0,28,29.6,-1,-4,2,0,-1,-5,-3,-3
"9407",2020-04-03,"Slate River Rd","w1920","Motorized",7,"Fri","weekday","sled","2","2","2",13.6,0,46,0,28,29.6,-1,-4,2,0,-1,-5,-3,-3
"9408",2020-04-03,"Slate River Rd","w1920","Hybrid",NA,"Fri","weekday","sled","2","2","2",13.6,0,46,0,28,29.6,-1,-4,2,0,-1,-5,-3,-3
"9409",2020-04-04,"Slate River Rd","w1920","Non.motorized",17,"Sat","weekend","no_sled","2","2","2",13.6,0,45,-1,33,30.2,0,-1,-4,2,-1,-2,-6,-4
"9410",2020-04-04,"Slate River Rd","w1920","Mechanized",0,"Sat","weekend","no_sled","2","2","2",13.6,0,45,-1,33,30.2,0,-1,-4,2,-1,-2,-6,-4
"9411",2020-04-04,"Slate River Rd","w1920","Motorized",12,"Sat","weekend","sled","2","2","2",13.6,0,45,-1,33,30.2,0,-1,-4,2,-1,-2,-6,-4
"9412",2020-04-04,"Slate River Rd","w1920","Hybrid",NA,"Sat","weekend","sled","2","2","2",13.6,0,45,-1,33,30.2,0,-1,-4,2,-1,-2,-6,-4
"9413",2020-04-05,"Slate River Rd","w1920","Non.motorized",13,"Sun","weekend","no_sled","2","2","3",13.6,0,45,0,38,30.2,-1,0,-1,-4,-1,-1,-2,-6
"9414",2020-04-05,"Slate River Rd","w1920","Mechanized",1,"Sun","weekend","no_sled","2","2","3",13.6,0,45,0,38,30.2,-1,0,-1,-4,-1,-1,-2,-6
"9415",2020-04-05,"Slate River Rd","w1920","Motorized",6,"Sun","weekend","sled","2","2","3",13.6,0,45,0,38,30.2,-1,0,-1,-4,-1,-1,-2,-6
"9416",2020-04-05,"Slate River Rd","w1920","Hybrid",NA,"Sun","weekend","sled","2","2","3",13.6,0,45,0,38,30.2,-1,0,-1,-4,-1,-1,-2,-6
"9417",2020-04-06,"Slate River Rd","w1920","Non.motorized",21,"Mon","weekday","no_sled","2","2","3",13.6,0,44,-1,40,30.9,0,-1,0,-1,-1,-2,-2,-3
"9418",2020-04-06,"Slate River Rd","w1920","Mechanized",0,"Mon","weekday","no_sled","2","2","3",13.6,0,44,-1,40,30.9,0,-1,0,-1,-1,-2,-2,-3
"9419",2020-04-06,"Slate River Rd","w1920","Motorized",7,"Mon","weekday","sled","2","2","3",13.6,0,44,-1,40,30.9,0,-1,0,-1,-1,-2,-2,-3
"9420",2020-04-06,"Slate River Rd","w1920","Hybrid",NA,"Mon","weekday","sled","2","2","3",13.6,0,44,-1,40,30.9,0,-1,0,-1,-1,-2,-2,-3
"9421",2020-04-07,"Slate River Rd","w1920","Non.motorized",31,"Tue","weekday","no_sled","2","2","3",13.4,-0.2,43,-1,39,31.2,-1,0,-1,0,-2,-2,-3,-3
"9422",2020-04-07,"Slate River Rd","w1920","Mechanized",0,"Tue","weekday","no_sled","2","2","3",13.4,-0.2,43,-1,39,31.2,-1,0,-1,0,-2,-2,-3,-3
"9423",2020-04-07,"Slate River Rd","w1920","Motorized",1,"Tue","weekday","sled","2","2","3",13.4,-0.2,43,-1,39,31.2,-1,0,-1,0,-2,-2,-3,-3
"9424",2020-04-07,"Slate River Rd","w1920","Hybrid",NA,"Tue","weekday","sled","2","2","3",13.4,-0.2,43,-1,39,31.2,-1,0,-1,0,-2,-2,-3,-3
"9425",2020-04-08,"Slate River Rd","w1920","Non.motorized",5,"Wed","weekday","no_sled","2","3","3",13.3,-0.1,42,-1,40,31.7,-1,-1,0,-1,-2,-3,-3,-4
"9426",2020-04-08,"Slate River Rd","w1920","Mechanized",1,"Wed","weekday","no_sled","2","3","3",13.3,-0.1,42,-1,40,31.7,-1,-1,0,-1,-2,-3,-3,-4
"9427",2020-04-08,"Slate River Rd","w1920","Motorized",2,"Wed","weekday","sled","2","3","3",13.3,-0.1,42,-1,40,31.7,-1,-1,0,-1,-2,-3,-3,-4
"9428",2020-04-08,"Slate River Rd","w1920","Hybrid",NA,"Wed","weekday","sled","2","3","3",13.3,-0.1,42,-1,40,31.7,-1,-1,0,-1,-2,-3,-3,-4
"9429",2020-04-09,"Slate River Rd","w1920","Non.motorized",NA,"Thu","weekday","no_sled","2","3","3",13.1,-0.2,40,-2,42,32.8,-1,-1,-1,0,-3,-4,-5,-5
"9430",2020-04-09,"Slate River Rd","w1920","Mechanized",NA,"Thu","weekday","no_sled","2","3","3",13.1,-0.2,40,-2,42,32.8,-1,-1,-1,0,-3,-4,-5,-5
"9431",2020-04-09,"Slate River Rd","w1920","Motorized",NA,"Thu","weekday","sled","2","3","3",13.1,-0.2,40,-2,42,32.8,-1,-1,-1,0,-3,-4,-5,-5
"9432",2020-04-09,"Slate River Rd","w1920","Hybrid",NA,"Thu","weekday","sled","2","3","3",13.1,-0.2,40,-2,42,32.8,-1,-1,-1,0,-3,-4,-5,-5
"9433",2020-04-10,"Slate River Rd","w1920","Non.motorized",NA,"Fri","weekday","no_sled","3","3","3",12.9,-0.2,39,-1,38,33.1,-2,-1,-1,-1,-3,-4,-5,-6
"9434",2020-04-10,"Slate River Rd","w1920","Mechanized",NA,"Fri","weekday","no_sled","3","3","3",12.9,-0.2,39,-1,38,33.1,-2,-1,-1,-1,-3,-4,-5,-6
"9435",2020-04-10,"Slate River Rd","w1920","Motorized",NA,"Fri","weekday","sled","3","3","3",12.9,-0.2,39,-1,38,33.1,-2,-1,-1,-1,-3,-4,-5,-6
"9436",2020-04-10,"Slate River Rd","w1920","Hybrid",NA,"Fri","weekday","sled","3","3","3",12.9,-0.2,39,-1,38,33.1,-2,-1,-1,-1,-3,-4,-5,-6
"9437",2020-04-11,"Slate River Rd","w1920","Non.motorized",4,"Sat","weekend","no_sled","2","3","3",12.9,0,39,0,36,33.1,-1,-2,-1,-1,-1,-3,-4,-5
"9438",2020-04-11,"Slate River Rd","w1920","Mechanized",0,"Sat","weekend","no_sled","2","3","3",12.9,0,39,0,36,33.1,-1,-2,-1,-1,-1,-3,-4,-5
"9439",2020-04-11,"Slate River Rd","w1920","Motorized",6,"Sat","weekend","sled","2","3","3",12.9,0,39,0,36,33.1,-1,-2,-1,-1,-1,-3,-4,-5
"9440",2020-04-11,"Slate River Rd","w1920","Hybrid",NA,"Sat","weekend","sled","2","3","3",12.9,0,39,0,36,33.1,-1,-2,-1,-1,-1,-3,-4,-5
"9441",2020-04-12,"Slate River Rd","w1920","Non.motorized",1,"Sun","weekend","no_sled","2","2","2",12.8,-0.1,38,-1,29,33.7,0,-1,-2,-1,-1,-2,-4,-5
"9442",2020-04-12,"Slate River Rd","w1920","Mechanized",0,"Sun","weekend","no_sled","2","2","2",12.8,-0.1,38,-1,29,33.7,0,-1,-2,-1,-1,-2,-4,-5
"9443",2020-04-12,"Slate River Rd","w1920","Motorized",1,"Sun","weekend","sled","2","2","2",12.8,-0.1,38,-1,29,33.7,0,-1,-2,-1,-1,-2,-4,-5
"9444",2020-04-12,"Slate River Rd","w1920","Hybrid",NA,"Sun","weekend","sled","2","2","2",12.8,-0.1,38,-1,29,33.7,0,-1,-2,-1,-1,-2,-4,-5
"9445",2020-04-13,"Slate River Rd","w1920","Non.motorized",4,"Mon","weekday","no_sled",NA,NA,NA,12.9,0.1,39,1,20,33.1,-1,0,-1,-2,0,0,-1,-3
"9446",2020-04-13,"Slate River Rd","w1920","Mechanized",0,"Mon","weekday","no_sled",NA,NA,NA,12.9,0.1,39,1,20,33.1,-1,0,-1,-2,0,0,-1,-3
"9447",2020-04-13,"Slate River Rd","w1920","Motorized",5,"Mon","weekday","sled",NA,NA,NA,12.9,0.1,39,1,20,33.1,-1,0,-1,-2,0,0,-1,-3
"9448",2020-04-13,"Slate River Rd","w1920","Hybrid",NA,"Mon","weekday","sled",NA,NA,NA,12.9,0.1,39,1,20,33.1,-1,0,-1,-2,0,0,-1,-3
"9449",2020-04-14,"Slate River Rd","w1920","Non.motorized",6,"Tue","weekday","no_sled","2","2","2",13,0.1,39,0,18,33.3,1,-1,0,-1,1,0,0,-1
"9450",2020-04-14,"Slate River Rd","w1920","Mechanized",0,"Tue","weekday","no_sled","2","2","2",13,0.1,39,0,18,33.3,1,-1,0,-1,1,0,0,-1
"9451",2020-04-14,"Slate River Rd","w1920","Motorized",9,"Tue","weekday","sled","2","2","2",13,0.1,39,0,18,33.3,1,-1,0,-1,1,0,0,-1
"9452",2020-04-14,"Slate River Rd","w1920","Hybrid",NA,"Tue","weekday","sled","2","2","2",13,0.1,39,0,18,33.3,1,-1,0,-1,1,0,0,-1
"9453",2020-04-15,"Slate River Rd","w1920","Non.motorized",9,"Wed","weekday","no_sled",NA,NA,NA,13.2,0.2,39,0,28,33.8,0,1,-1,0,0,1,0,0
"9454",2020-04-15,"Slate River Rd","w1920","Mechanized",0,"Wed","weekday","no_sled",NA,NA,NA,13.2,0.2,39,0,28,33.8,0,1,-1,0,0,1,0,0
"9455",2020-04-15,"Slate River Rd","w1920","Motorized",8,"Wed","weekday","sled",NA,NA,NA,13.2,0.2,39,0,28,33.8,0,1,-1,0,0,1,0,0
"9456",2020-04-15,"Slate River Rd","w1920","Hybrid",NA,"Wed","weekday","sled",NA,NA,NA,13.2,0.2,39,0,28,33.8,0,1,-1,0,0,1,0,0
"9457",2019-12-06,"Snodgrass","w1920","Non.motorized",NA,"Fri","weekday","no_sled","2","2","1",2.9,0.4,19,5,24,15.3,0,0,0,0,5,5,5,5
"9458",2019-12-06,"Snodgrass","w1920","Mechanized",NA,"Fri","weekday","no_sled","2","2","1",2.9,0.4,19,5,24,15.3,0,0,0,0,5,5,5,5
"9459",2019-12-06,"Snodgrass","w1920","Motorized",NA,"Fri","weekday","sled","2","2","1",2.9,0.4,19,5,24,15.3,0,0,0,0,5,5,5,5
"9460",2019-12-06,"Snodgrass","w1920","Hybrid",NA,"Fri","weekday","sled","2","2","1",2.9,0.4,19,5,24,15.3,0,0,0,0,5,5,5,5
"9461",2019-12-07,"Snodgrass","w1920","Non.motorized",NA,"Sat","weekend","no_sled","2","2","1",3,0.1,18,-1,29,16.7,5,0,0,0,4,4,4,4
"9462",2019-12-07,"Snodgrass","w1920","Mechanized",NA,"Sat","weekend","no_sled","2","2","1",3,0.1,18,-1,29,16.7,5,0,0,0,4,4,4,4
"9463",2019-12-07,"Snodgrass","w1920","Motorized",NA,"Sat","weekend","sled","2","2","1",3,0.1,18,-1,29,16.7,5,0,0,0,4,4,4,4
"9464",2019-12-07,"Snodgrass","w1920","Hybrid",NA,"Sat","weekend","sled","2","2","1",3,0.1,18,-1,29,16.7,5,0,0,0,4,4,4,4
"9465",2019-12-08,"Snodgrass","w1920","Non.motorized",NA,"Sun","weekend","no_sled","2","2","1",3,0,17,-1,28,17.6,-1,5,0,0,-2,3,3,3
"9466",2019-12-08,"Snodgrass","w1920","Mechanized",NA,"Sun","weekend","no_sled","2","2","1",3,0,17,-1,28,17.6,-1,5,0,0,-2,3,3,3
"9467",2019-12-08,"Snodgrass","w1920","Motorized",NA,"Sun","weekend","sled","2","2","1",3,0,17,-1,28,17.6,-1,5,0,0,-2,3,3,3
"9468",2019-12-08,"Snodgrass","w1920","Hybrid",NA,"Sun","weekend","sled","2","2","1",3,0,17,-1,28,17.6,-1,5,0,0,-2,3,3,3
"9469",2019-12-09,"Snodgrass","w1920","Non.motorized",NA,"Mon","weekday","no_sled","3","3","2",3.4,0.4,22,5,21,15.5,-1,-1,5,0,4,3,8,8
"9470",2019-12-09,"Snodgrass","w1920","Mechanized",NA,"Mon","weekday","no_sled","3","3","2",3.4,0.4,22,5,21,15.5,-1,-1,5,0,4,3,8,8
"9471",2019-12-09,"Snodgrass","w1920","Motorized",NA,"Mon","weekday","sled","3","3","2",3.4,0.4,22,5,21,15.5,-1,-1,5,0,4,3,8,8
"9472",2019-12-09,"Snodgrass","w1920","Hybrid",NA,"Mon","weekday","sled","3","3","2",3.4,0.4,22,5,21,15.5,-1,-1,5,0,4,3,8,8
"9473",2019-12-10,"Snodgrass","w1920","Non.motorized",NA,"Tue","weekday","no_sled","2","2","2",3.4,0,21,-1,19,16.2,5,-1,-1,5,4,3,2,7
"9474",2019-12-10,"Snodgrass","w1920","Mechanized",NA,"Tue","weekday","no_sled","2","2","2",3.4,0,21,-1,19,16.2,5,-1,-1,5,4,3,2,7
"9475",2019-12-10,"Snodgrass","w1920","Motorized",NA,"Tue","weekday","sled","2","2","2",3.4,0,21,-1,19,16.2,5,-1,-1,5,4,3,2,7
"9476",2019-12-10,"Snodgrass","w1920","Hybrid",NA,"Tue","weekday","sled","2","2","2",3.4,0,21,-1,19,16.2,5,-1,-1,5,4,3,2,7
"9477",2019-12-11,"Snodgrass","w1920","Non.motorized",NA,"Wed","weekday","no_sled","2","2","2",3.4,0,20,-1,22,17,-1,5,-1,-1,-2,3,2,1
"9478",2019-12-11,"Snodgrass","w1920","Mechanized",NA,"Wed","weekday","no_sled","2","2","2",3.4,0,20,-1,22,17,-1,5,-1,-1,-2,3,2,1
"9479",2019-12-11,"Snodgrass","w1920","Motorized",NA,"Wed","weekday","sled","2","2","2",3.4,0,20,-1,22,17,-1,5,-1,-1,-2,3,2,1
"9480",2019-12-11,"Snodgrass","w1920","Hybrid",NA,"Wed","weekday","sled","2","2","2",3.4,0,20,-1,22,17,-1,5,-1,-1,-2,3,2,1
"9481",2019-12-12,"Snodgrass","w1920","Non.motorized",NA,"Thu","weekday","no_sled","2","2","2",3.4,0,19,-1,25,17.9,-1,-1,5,-1,-2,-3,2,1
"9482",2019-12-12,"Snodgrass","w1920","Mechanized",NA,"Thu","weekday","no_sled","2","2","2",3.4,0,19,-1,25,17.9,-1,-1,5,-1,-2,-3,2,1
"9483",2019-12-12,"Snodgrass","w1920","Motorized",NA,"Thu","weekday","sled","2","2","2",3.4,0,19,-1,25,17.9,-1,-1,5,-1,-2,-3,2,1
"9484",2019-12-12,"Snodgrass","w1920","Hybrid",NA,"Thu","weekday","sled","2","2","2",3.4,0,19,-1,25,17.9,-1,-1,5,-1,-2,-3,2,1
"9485",2019-12-13,"Snodgrass","w1920","Non.motorized",NA,"Fri","weekday","no_sled","2","2","2",3.8,0.4,21,2,24,18.1,-1,-1,-1,5,1,0,-1,4
"9486",2019-12-13,"Snodgrass","w1920","Mechanized",NA,"Fri","weekday","no_sled","2","2","2",3.8,0.4,21,2,24,18.1,-1,-1,-1,5,1,0,-1,4
"9487",2019-12-13,"Snodgrass","w1920","Motorized",NA,"Fri","weekday","sled","2","2","2",3.8,0.4,21,2,24,18.1,-1,-1,-1,5,1,0,-1,4
"9488",2019-12-13,"Snodgrass","w1920","Hybrid",NA,"Fri","weekday","sled","2","2","2",3.8,0.4,21,2,24,18.1,-1,-1,-1,5,1,0,-1,4
"9489",2019-12-14,"Snodgrass","w1920","Non.motorized",NA,"Sat","weekend","no_sled","3","3","3",4.2,0.4,27,6,25,15.6,2,-1,-1,-1,8,7,6,5
"9490",2019-12-14,"Snodgrass","w1920","Mechanized",NA,"Sat","weekend","no_sled","3","3","3",4.2,0.4,27,6,25,15.6,2,-1,-1,-1,8,7,6,5
"9491",2019-12-14,"Snodgrass","w1920","Motorized",NA,"Sat","weekend","sled","3","3","3",4.2,0.4,27,6,25,15.6,2,-1,-1,-1,8,7,6,5
"9492",2019-12-14,"Snodgrass","w1920","Hybrid",NA,"Sat","weekend","sled","3","3","3",4.2,0.4,27,6,25,15.6,2,-1,-1,-1,8,7,6,5
"9493",2019-12-15,"Snodgrass","w1920","Non.motorized",NA,"Sun","weekend","no_sled","3","3","2",4.8,0.6,31,4,17,15.5,6,2,-1,-1,10,12,11,10
"9494",2019-12-15,"Snodgrass","w1920","Mechanized",NA,"Sun","weekend","no_sled","3","3","2",4.8,0.6,31,4,17,15.5,6,2,-1,-1,10,12,11,10
"9495",2019-12-15,"Snodgrass","w1920","Motorized",NA,"Sun","weekend","sled","3","3","2",4.8,0.6,31,4,17,15.5,6,2,-1,-1,10,12,11,10
"9496",2019-12-15,"Snodgrass","w1920","Hybrid",NA,"Sun","weekend","sled","3","3","2",4.8,0.6,31,4,17,15.5,6,2,-1,-1,10,12,11,10
"9497",2019-12-16,"Snodgrass","w1920","Non.motorized",NA,"Mon","weekday","no_sled","3","3","2",4.8,0,29,-2,6,16.6,4,6,2,-1,2,8,10,9
"9498",2019-12-16,"Snodgrass","w1920","Mechanized",NA,"Mon","weekday","no_sled","3","3","2",4.8,0,29,-2,6,16.6,4,6,2,-1,2,8,10,9
"9499",2019-12-16,"Snodgrass","w1920","Motorized",NA,"Mon","weekday","sled","3","3","2",4.8,0,29,-2,6,16.6,4,6,2,-1,2,8,10,9
"9500",2019-12-16,"Snodgrass","w1920","Hybrid",NA,"Mon","weekday","sled","3","3","2",4.8,0,29,-2,6,16.6,4,6,2,-1,2,8,10,9
"9501",2019-12-17,"Snodgrass","w1920","Non.motorized",NA,"Tue","weekday","no_sled","2","2","1",4.8,0,27,-2,8,17.8,-2,4,6,2,-4,0,6,8
"9502",2019-12-17,"Snodgrass","w1920","Mechanized",NA,"Tue","weekday","no_sled","2","2","1",4.8,0,27,-2,8,17.8,-2,4,6,2,-4,0,6,8
"9503",2019-12-17,"Snodgrass","w1920","Motorized",NA,"Tue","weekday","sled","2","2","1",4.8,0,27,-2,8,17.8,-2,4,6,2,-4,0,6,8
"9504",2019-12-17,"Snodgrass","w1920","Hybrid",NA,"Tue","weekday","sled","2","2","1",4.8,0,27,-2,8,17.8,-2,4,6,2,-4,0,6,8
"9505",2019-12-18,"Snodgrass","w1920","Non.motorized",NA,"Wed","weekday","no_sled","2","2","1",4.8,0,26,-1,20,18.5,-2,-2,4,6,-3,-5,-1,5
"9506",2019-12-18,"Snodgrass","w1920","Mechanized",NA,"Wed","weekday","no_sled","2","2","1",4.8,0,26,-1,20,18.5,-2,-2,4,6,-3,-5,-1,5
"9507",2019-12-18,"Snodgrass","w1920","Motorized",NA,"Wed","weekday","sled","2","2","1",4.8,0,26,-1,20,18.5,-2,-2,4,6,-3,-5,-1,5
"9508",2019-12-18,"Snodgrass","w1920","Hybrid",NA,"Wed","weekday","sled","2","2","1",4.8,0,26,-1,20,18.5,-2,-2,4,6,-3,-5,-1,5
"9509",2019-12-19,"Snodgrass","w1920","Non.motorized",NA,"Thu","weekday","no_sled","2","2","1",4.9,0.1,25,-1,21,19.6,-1,-2,-2,4,-2,-4,-6,-2
"9510",2019-12-19,"Snodgrass","w1920","Mechanized",NA,"Thu","weekday","no_sled","2","2","1",4.9,0.1,25,-1,21,19.6,-1,-2,-2,4,-2,-4,-6,-2
"9511",2019-12-19,"Snodgrass","w1920","Motorized",NA,"Thu","weekday","sled","2","2","1",4.9,0.1,25,-1,21,19.6,-1,-2,-2,4,-2,-4,-6,-2
"9512",2019-12-19,"Snodgrass","w1920","Hybrid",NA,"Thu","weekday","sled","2","2","1",4.9,0.1,25,-1,21,19.6,-1,-2,-2,4,-2,-4,-6,-2
"9513",2019-12-20,"Snodgrass","w1920","Non.motorized",NA,"Fri","weekday","no_sled","2","2","1",4.9,0,24,-1,21,20.4,-1,-1,-2,-2,-2,-3,-5,-7
"9514",2019-12-20,"Snodgrass","w1920","Mechanized",NA,"Fri","weekday","no_sled","2","2","1",4.9,0,24,-1,21,20.4,-1,-1,-2,-2,-2,-3,-5,-7
"9515",2019-12-20,"Snodgrass","w1920","Motorized",NA,"Fri","weekday","sled","2","2","1",4.9,0,24,-1,21,20.4,-1,-1,-2,-2,-2,-3,-5,-7
"9516",2019-12-20,"Snodgrass","w1920","Hybrid",NA,"Fri","weekday","sled","2","2","1",4.9,0,24,-1,21,20.4,-1,-1,-2,-2,-2,-3,-5,-7
"9517",2019-12-21,"Snodgrass","w1920","Non.motorized",NA,"Sat","weekend","no_sled","2","2","1",4.9,0,24,0,27,20.4,-1,-1,-1,-2,-1,-2,-3,-5
"9518",2019-12-21,"Snodgrass","w1920","Mechanized",NA,"Sat","weekend","no_sled","2","2","1",4.9,0,24,0,27,20.4,-1,-1,-1,-2,-1,-2,-3,-5
"9519",2019-12-21,"Snodgrass","w1920","Motorized",NA,"Sat","weekend","sled","2","2","1",4.9,0,24,0,27,20.4,-1,-1,-1,-2,-1,-2,-3,-5
"9520",2019-12-21,"Snodgrass","w1920","Hybrid",NA,"Sat","weekend","sled","2","2","1",4.9,0,24,0,27,20.4,-1,-1,-1,-2,-1,-2,-3,-5
"9521",2019-12-22,"Snodgrass","w1920","Non.motorized",NA,"Sun","weekend","no_sled","2","2","1",5,0.1,23,-1,31,21.7,0,-1,-1,-1,-1,-2,-3,-4
"9522",2019-12-22,"Snodgrass","w1920","Mechanized",NA,"Sun","weekend","no_sled","2","2","1",5,0.1,23,-1,31,21.7,0,-1,-1,-1,-1,-2,-3,-4
"9523",2019-12-22,"Snodgrass","w1920","Motorized",NA,"Sun","weekend","sled","2","2","1",5,0.1,23,-1,31,21.7,0,-1,-1,-1,-1,-2,-3,-4
"9524",2019-12-22,"Snodgrass","w1920","Hybrid",NA,"Sun","weekend","sled","2","2","1",5,0.1,23,-1,31,21.7,0,-1,-1,-1,-1,-2,-3,-4
"9525",2019-12-23,"Snodgrass","w1920","Non.motorized",NA,"Mon","weekday","no_sled","2","1","1",5,0,23,0,34,21.7,-1,0,-1,-1,-1,-1,-2,-3
"9526",2019-12-23,"Snodgrass","w1920","Mechanized",NA,"Mon","weekday","no_sled","2","1","1",5,0,23,0,34,21.7,-1,0,-1,-1,-1,-1,-2,-3
"9527",2019-12-23,"Snodgrass","w1920","Motorized",NA,"Mon","weekday","sled","2","1","1",5,0,23,0,34,21.7,-1,0,-1,-1,-1,-1,-2,-3
"9528",2019-12-23,"Snodgrass","w1920","Hybrid",NA,"Mon","weekday","sled","2","1","1",5,0,23,0,34,21.7,-1,0,-1,-1,-1,-1,-2,-3
"9529",2019-12-24,"Snodgrass","w1920","Non.motorized",NA,"Tue","weekday","no_sled","2","1","1",5,0,22,-1,30,22.7,0,-1,0,-1,-1,-2,-2,-3
"9530",2019-12-24,"Snodgrass","w1920","Mechanized",NA,"Tue","weekday","no_sled","2","1","1",5,0,22,-1,30,22.7,0,-1,0,-1,-1,-2,-2,-3
"9531",2019-12-24,"Snodgrass","w1920","Motorized",NA,"Tue","weekday","sled","2","1","1",5,0,22,-1,30,22.7,0,-1,0,-1,-1,-2,-2,-3
"9532",2019-12-24,"Snodgrass","w1920","Hybrid",NA,"Tue","weekday","sled","2","1","1",5,0,22,-1,30,22.7,0,-1,0,-1,-1,-2,-2,-3
"9533",2019-12-25,"Snodgrass","w1920","Non.motorized",NA,"Wed","weekday","no_sled","2","2","2",5,0,23,1,22,21.7,-1,0,-1,0,0,0,-1,-1
"9534",2019-12-25,"Snodgrass","w1920","Mechanized",NA,"Wed","weekday","no_sled","2","2","2",5,0,23,1,22,21.7,-1,0,-1,0,0,0,-1,-1
"9535",2019-12-25,"Snodgrass","w1920","Motorized",NA,"Wed","weekday","sled","2","2","2",5,0,23,1,22,21.7,-1,0,-1,0,0,0,-1,-1
"9536",2019-12-25,"Snodgrass","w1920","Hybrid",NA,"Wed","weekday","sled","2","2","2",5,0,23,1,22,21.7,-1,0,-1,0,0,0,-1,-1
"9537",2019-12-26,"Snodgrass","w1920","Non.motorized",NA,"Thu","weekday","no_sled","2","2","1",5,0,23,0,17,21.7,1,-1,0,-1,1,0,0,-1
"9538",2019-12-26,"Snodgrass","w1920","Mechanized",NA,"Thu","weekday","no_sled","2","2","1",5,0,23,0,17,21.7,1,-1,0,-1,1,0,0,-1
"9539",2019-12-26,"Snodgrass","w1920","Motorized",NA,"Thu","weekday","sled","2","2","1",5,0,23,0,17,21.7,1,-1,0,-1,1,0,0,-1
"9540",2019-12-26,"Snodgrass","w1920","Hybrid",NA,"Thu","weekday","sled","2","2","1",5,0,23,0,17,21.7,1,-1,0,-1,1,0,0,-1
"9541",2019-12-27,"Snodgrass","w1920","Non.motorized",NA,"Fri","weekday","no_sled","3","3","2",5.1,0.1,24,1,22,21.2,0,1,-1,0,1,2,1,1
"9542",2019-12-27,"Snodgrass","w1920","Mechanized",NA,"Fri","weekday","no_sled","3","3","2",5.1,0.1,24,1,22,21.2,0,1,-1,0,1,2,1,1
"9543",2019-12-27,"Snodgrass","w1920","Motorized",NA,"Fri","weekday","sled","3","3","2",5.1,0.1,24,1,22,21.2,0,1,-1,0,1,2,1,1
"9544",2019-12-27,"Snodgrass","w1920","Hybrid",NA,"Fri","weekday","sled","3","3","2",5.1,0.1,24,1,22,21.2,0,1,-1,0,1,2,1,1
"9545",2019-12-28,"Snodgrass","w1920","Non.motorized",NA,"Sat","weekend","no_sled","3","3","2",5.6,0.5,30,6,16,18.7,1,0,1,-1,7,7,8,7
"9546",2019-12-28,"Snodgrass","w1920","Mechanized",NA,"Sat","weekend","no_sled","3","3","2",5.6,0.5,30,6,16,18.7,1,0,1,-1,7,7,8,7
"9547",2019-12-28,"Snodgrass","w1920","Motorized",NA,"Sat","weekend","sled","3","3","2",5.6,0.5,30,6,16,18.7,1,0,1,-1,7,7,8,7
"9548",2019-12-28,"Snodgrass","w1920","Hybrid",NA,"Sat","weekend","sled","3","3","2",5.6,0.5,30,6,16,18.7,1,0,1,-1,7,7,8,7
"9549",2019-12-29,"Snodgrass","w1920","Non.motorized",NA,"Sun","weekend","no_sled","3","3","2",5.6,0,29,-1,3,19.3,6,1,0,1,5,6,6,7
"9550",2019-12-29,"Snodgrass","w1920","Mechanized",NA,"Sun","weekend","no_sled","3","3","2",5.6,0,29,-1,3,19.3,6,1,0,1,5,6,6,7
"9551",2019-12-29,"Snodgrass","w1920","Motorized",NA,"Sun","weekend","sled","3","3","2",5.6,0,29,-1,3,19.3,6,1,0,1,5,6,6,7
"9552",2019-12-29,"Snodgrass","w1920","Hybrid",NA,"Sun","weekend","sled","3","3","2",5.6,0,29,-1,3,19.3,6,1,0,1,5,6,6,7
"9553",2019-12-30,"Snodgrass","w1920","Non.motorized",NA,"Mon","weekday","no_sled","3","3","2",5.6,0,28,-1,3,20,-1,6,1,0,-2,4,5,5
"9554",2019-12-30,"Snodgrass","w1920","Mechanized",NA,"Mon","weekday","no_sled","3","3","2",5.6,0,28,-1,3,20,-1,6,1,0,-2,4,5,5
"9555",2019-12-30,"Snodgrass","w1920","Motorized",NA,"Mon","weekday","sled","3","3","2",5.6,0,28,-1,3,20,-1,6,1,0,-2,4,5,5
"9556",2019-12-30,"Snodgrass","w1920","Hybrid",NA,"Mon","weekday","sled","3","3","2",5.6,0,28,-1,3,20,-1,6,1,0,-2,4,5,5
"9557",2019-12-31,"Snodgrass","w1920","Non.motorized",NA,"Tue","weekday","no_sled","2","2","1",5.6,0,28,0,13,20,-1,-1,6,1,-1,-2,4,5
"9558",2019-12-31,"Snodgrass","w1920","Mechanized",NA,"Tue","weekday","no_sled","2","2","1",5.6,0,28,0,13,20,-1,-1,6,1,-1,-2,4,5
"9559",2019-12-31,"Snodgrass","w1920","Motorized",NA,"Tue","weekday","sled","2","2","1",5.6,0,28,0,13,20,-1,-1,6,1,-1,-2,4,5
"9560",2019-12-31,"Snodgrass","w1920","Hybrid",NA,"Tue","weekday","sled","2","2","1",5.6,0,28,0,13,20,-1,-1,6,1,-1,-2,4,5
"9561",2020-01-01,"Snodgrass","w1920","Non.motorized",NA,"Wed","weekday","no_sled","2","1","1",5.6,0,27,-1,21,20.7,0,-1,-1,6,-1,-2,-3,3
"9562",2020-01-01,"Snodgrass","w1920","Mechanized",NA,"Wed","weekday","no_sled","2","1","1",5.6,0,27,-1,21,20.7,0,-1,-1,6,-1,-2,-3,3
"9563",2020-01-01,"Snodgrass","w1920","Motorized",NA,"Wed","weekday","sled","2","1","1",5.6,0,27,-1,21,20.7,0,-1,-1,6,-1,-2,-3,3
"9564",2020-01-01,"Snodgrass","w1920","Hybrid",NA,"Wed","weekday","sled","2","1","1",5.6,0,27,-1,21,20.7,0,-1,-1,6,-1,-2,-3,3
"9565",2020-01-02,"Snodgrass","w1920","Non.motorized",NA,"Thu","weekday","no_sled","3","3","2",5.9,0.3,29,2,16,20.3,-1,0,-1,-1,1,1,0,-1
"9566",2020-01-02,"Snodgrass","w1920","Mechanized",NA,"Thu","weekday","no_sled","3","3","2",5.9,0.3,29,2,16,20.3,-1,0,-1,-1,1,1,0,-1
"9567",2020-01-02,"Snodgrass","w1920","Motorized",NA,"Thu","weekday","sled","3","3","2",5.9,0.3,29,2,16,20.3,-1,0,-1,-1,1,1,0,-1
"9568",2020-01-02,"Snodgrass","w1920","Hybrid",NA,"Thu","weekday","sled","3","3","2",5.9,0.3,29,2,16,20.3,-1,0,-1,-1,1,1,0,-1
"9569",2020-01-03,"Snodgrass","w1920","Non.motorized",NA,"Fri","weekday","no_sled","3","2","1",5.9,0,31,2,19,19,2,-1,0,-1,4,3,3,2
"9570",2020-01-03,"Snodgrass","w1920","Mechanized",NA,"Fri","weekday","no_sled","3","2","1",5.9,0,31,2,19,19,2,-1,0,-1,4,3,3,2
"9571",2020-01-03,"Snodgrass","w1920","Motorized",NA,"Fri","weekday","sled","3","2","1",5.9,0,31,2,19,19,2,-1,0,-1,4,3,3,2
"9572",2020-01-03,"Snodgrass","w1920","Hybrid",NA,"Fri","weekday","sled","3","2","1",5.9,0,31,2,19,19,2,-1,0,-1,4,3,3,2
"9573",2020-01-04,"Snodgrass","w1920","Non.motorized",NA,"Sat","weekend","no_sled","2","2","1",5.9,0,30,-1,26,19.7,2,2,-1,0,1,3,2,2
"9574",2020-01-04,"Snodgrass","w1920","Mechanized",NA,"Sat","weekend","no_sled","2","2","1",5.9,0,30,-1,26,19.7,2,2,-1,0,1,3,2,2
"9575",2020-01-04,"Snodgrass","w1920","Motorized",NA,"Sat","weekend","sled","2","2","1",5.9,0,30,-1,26,19.7,2,2,-1,0,1,3,2,2
"9576",2020-01-04,"Snodgrass","w1920","Hybrid",NA,"Sat","weekend","sled","2","2","1",5.9,0,30,-1,26,19.7,2,2,-1,0,1,3,2,2
"9577",2020-01-05,"Snodgrass","w1920","Non.motorized",NA,"Sun","weekend","no_sled","2","2","1",5.9,0,28,-2,23,21.1,-1,2,2,-1,-3,-1,1,0
"9578",2020-01-05,"Snodgrass","w1920","Mechanized",NA,"Sun","weekend","no_sled","2","2","1",5.9,0,28,-2,23,21.1,-1,2,2,-1,-3,-1,1,0
"9579",2020-01-05,"Snodgrass","w1920","Motorized",NA,"Sun","weekend","sled","2","2","1",5.9,0,28,-2,23,21.1,-1,2,2,-1,-3,-1,1,0
"9580",2020-01-05,"Snodgrass","w1920","Hybrid",NA,"Sun","weekend","sled","2","2","1",5.9,0,28,-2,23,21.1,-1,2,2,-1,-3,-1,1,0
"9581",2020-01-06,"Snodgrass","w1920","Non.motorized",NA,"Mon","weekday","no_sled","2","2","1",5.9,0,28,0,15,21.1,-2,-1,2,2,-2,-3,-1,1
"9582",2020-01-06,"Snodgrass","w1920","Mechanized",NA,"Mon","weekday","no_sled","2","2","1",5.9,0,28,0,15,21.1,-2,-1,2,2,-2,-3,-1,1
"9583",2020-01-06,"Snodgrass","w1920","Motorized",NA,"Mon","weekday","sled","2","2","1",5.9,0,28,0,15,21.1,-2,-1,2,2,-2,-3,-1,1
"9584",2020-01-06,"Snodgrass","w1920","Hybrid",NA,"Mon","weekday","sled","2","2","1",5.9,0,28,0,15,21.1,-2,-1,2,2,-2,-3,-1,1
"9585",2020-01-07,"Snodgrass","w1920","Non.motorized",NA,"Tue","weekday","no_sled","2","1","1",5.9,0,28,0,22,21.1,0,-2,-1,2,0,-2,-3,-1
"9586",2020-01-07,"Snodgrass","w1920","Mechanized",NA,"Tue","weekday","no_sled","2","1","1",5.9,0,28,0,22,21.1,0,-2,-1,2,0,-2,-3,-1
"9587",2020-01-07,"Snodgrass","w1920","Motorized",NA,"Tue","weekday","sled","2","1","1",5.9,0,28,0,22,21.1,0,-2,-1,2,0,-2,-3,-1
"9588",2020-01-07,"Snodgrass","w1920","Hybrid",NA,"Tue","weekday","sled","2","1","1",5.9,0,28,0,22,21.1,0,-2,-1,2,0,-2,-3,-1
"9589",2020-01-08,"Snodgrass","w1920","Non.motorized",NA,"Wed","weekday","no_sled","2","1","1",6,0.1,28,0,23,21.4,0,0,-2,-1,0,0,-2,-3
"9590",2020-01-08,"Snodgrass","w1920","Mechanized",NA,"Wed","weekday","no_sled","2","1","1",6,0.1,28,0,23,21.4,0,0,-2,-1,0,0,-2,-3
"9591",2020-01-08,"Snodgrass","w1920","Motorized",NA,"Wed","weekday","sled","2","1","1",6,0.1,28,0,23,21.4,0,0,-2,-1,0,0,-2,-3
"9592",2020-01-08,"Snodgrass","w1920","Hybrid",NA,"Wed","weekday","sled","2","1","1",6,0.1,28,0,23,21.4,0,0,-2,-1,0,0,-2,-3
"9593",2020-01-09,"Snodgrass","w1920","Non.motorized",NA,"Thu","weekday","no_sled","2","1","1",6,0,27,-1,17,22.2,0,0,0,-2,-1,-1,-1,-3
"9594",2020-01-09,"Snodgrass","w1920","Mechanized",NA,"Thu","weekday","no_sled","2","1","1",6,0,27,-1,17,22.2,0,0,0,-2,-1,-1,-1,-3
"9595",2020-01-09,"Snodgrass","w1920","Motorized",NA,"Thu","weekday","sled","2","1","1",6,0,27,-1,17,22.2,0,0,0,-2,-1,-1,-1,-3
"9596",2020-01-09,"Snodgrass","w1920","Hybrid",NA,"Thu","weekday","sled","2","1","1",6,0,27,-1,17,22.2,0,0,0,-2,-1,-1,-1,-3
"9597",2020-01-10,"Snodgrass","w1920","Non.motorized",NA,"Fri","weekday","no_sled","2","1","1",6,0,29,2,11,20.7,-1,0,0,0,1,1,1,1
"9598",2020-01-10,"Snodgrass","w1920","Mechanized",NA,"Fri","weekday","no_sled","2","1","1",6,0,29,2,11,20.7,-1,0,0,0,1,1,1,1
"9599",2020-01-10,"Snodgrass","w1920","Motorized",NA,"Fri","weekday","sled","2","1","1",6,0,29,2,11,20.7,-1,0,0,0,1,1,1,1
"9600",2020-01-10,"Snodgrass","w1920","Hybrid",NA,"Fri","weekday","sled","2","1","1",6,0,29,2,11,20.7,-1,0,0,0,1,1,1,1
"9601",2020-01-11,"Snodgrass","w1920","Non.motorized",10,"Sat","weekend","no_sled","2","1","1",6,0,29,0,12,20.7,2,-1,0,0,2,1,1,1
"9602",2020-01-11,"Snodgrass","w1920","Mechanized",0,"Sat","weekend","no_sled","2","1","1",6,0,29,0,12,20.7,2,-1,0,0,2,1,1,1
"9603",2020-01-11,"Snodgrass","w1920","Motorized",NA,"Sat","weekend","sled","2","1","1",6,0,29,0,12,20.7,2,-1,0,0,2,1,1,1
"9604",2020-01-11,"Snodgrass","w1920","Hybrid",NA,"Sat","weekend","sled","2","1","1",6,0,29,0,12,20.7,2,-1,0,0,2,1,1,1
"9605",2020-01-12,"Snodgrass","w1920","Non.motorized",96,"Sun","weekend","no_sled","2","1","1",6.1,0.1,29,0,13,21,0,2,-1,0,0,2,1,1
"9606",2020-01-12,"Snodgrass","w1920","Mechanized",2,"Sun","weekend","no_sled","2","1","1",6.1,0.1,29,0,13,21,0,2,-1,0,0,2,1,1
"9607",2020-01-12,"Snodgrass","w1920","Motorized",NA,"Sun","weekend","sled","2","1","1",6.1,0.1,29,0,13,21,0,2,-1,0,0,2,1,1
"9608",2020-01-12,"Snodgrass","w1920","Hybrid",NA,"Sun","weekend","sled","2","1","1",6.1,0.1,29,0,13,21,0,2,-1,0,0,2,1,1
"9609",2020-01-13,"Snodgrass","w1920","Non.motorized",2,"Mon","weekday","no_sled","2","2","1",6.2,0.1,29,0,16,21.4,0,0,2,-1,0,0,2,1
"9610",2020-01-13,"Snodgrass","w1920","Mechanized",0,"Mon","weekday","no_sled","2","2","1",6.2,0.1,29,0,16,21.4,0,0,2,-1,0,0,2,1
"9611",2020-01-13,"Snodgrass","w1920","Motorized",NA,"Mon","weekday","sled","2","2","1",6.2,0.1,29,0,16,21.4,0,0,2,-1,0,0,2,1
"9612",2020-01-13,"Snodgrass","w1920","Hybrid",NA,"Mon","weekday","sled","2","2","1",6.2,0.1,29,0,16,21.4,0,0,2,-1,0,0,2,1
"9613",2020-01-14,"Snodgrass","w1920","Non.motorized",69,"Tue","weekday","no_sled","3","2","1",6.6,0.4,34,5,23,19.4,0,0,0,2,5,5,5,7
"9614",2020-01-14,"Snodgrass","w1920","Mechanized",0,"Tue","weekday","no_sled","3","2","1",6.6,0.4,34,5,23,19.4,0,0,0,2,5,5,5,7
"9615",2020-01-14,"Snodgrass","w1920","Motorized",NA,"Tue","weekday","sled","3","2","1",6.6,0.4,34,5,23,19.4,0,0,0,2,5,5,5,7
"9616",2020-01-14,"Snodgrass","w1920","Hybrid",NA,"Tue","weekday","sled","3","2","1",6.6,0.4,34,5,23,19.4,0,0,0,2,5,5,5,7
"9617",2020-01-15,"Snodgrass","w1920","Non.motorized",46,"Wed","weekday","no_sled","3","2","1",6.7,0.1,32,-2,23,20.9,5,0,0,0,3,3,3,3
"9618",2020-01-15,"Snodgrass","w1920","Mechanized",0,"Wed","weekday","no_sled","3","2","1",6.7,0.1,32,-2,23,20.9,5,0,0,0,3,3,3,3
"9619",2020-01-15,"Snodgrass","w1920","Motorized",NA,"Wed","weekday","sled","3","2","1",6.7,0.1,32,-2,23,20.9,5,0,0,0,3,3,3,3
"9620",2020-01-15,"Snodgrass","w1920","Hybrid",NA,"Wed","weekday","sled","3","2","1",6.7,0.1,32,-2,23,20.9,5,0,0,0,3,3,3,3
"9621",2020-01-16,"Snodgrass","w1920","Non.motorized",39,"Thu","weekday","no_sled","2","2","1",6.7,0,31,-1,28,21.6,-2,5,0,0,-3,2,2,2
"9622",2020-01-16,"Snodgrass","w1920","Mechanized",3,"Thu","weekday","no_sled","2","2","1",6.7,0,31,-1,28,21.6,-2,5,0,0,-3,2,2,2
"9623",2020-01-16,"Snodgrass","w1920","Motorized",NA,"Thu","weekday","sled","2","2","1",6.7,0,31,-1,28,21.6,-2,5,0,0,-3,2,2,2
"9624",2020-01-16,"Snodgrass","w1920","Hybrid",NA,"Thu","weekday","sled","2","2","1",6.7,0,31,-1,28,21.6,-2,5,0,0,-3,2,2,2
"9625",2020-01-17,"Snodgrass","w1920","Non.motorized",25,"Fri","weekday","no_sled","2","2","1",6.8,0.1,29,-2,19,23.4,-1,-2,5,0,-3,-5,0,0
"9626",2020-01-17,"Snodgrass","w1920","Mechanized",0,"Fri","weekday","no_sled","2","2","1",6.8,0.1,29,-2,19,23.4,-1,-2,5,0,-3,-5,0,0
"9627",2020-01-17,"Snodgrass","w1920","Motorized",NA,"Fri","weekday","sled","2","2","1",6.8,0.1,29,-2,19,23.4,-1,-2,5,0,-3,-5,0,0
"9628",2020-01-17,"Snodgrass","w1920","Hybrid",NA,"Fri","weekday","sled","2","2","1",6.8,0.1,29,-2,19,23.4,-1,-2,5,0,-3,-5,0,0
"9629",2020-01-18,"Snodgrass","w1920","Non.motorized",88,"Sat","weekend","no_sled","2","2","2",7,0.2,34,5,16,20.6,-2,-1,-2,5,3,2,0,5
"9630",2020-01-18,"Snodgrass","w1920","Mechanized",1,"Sat","weekend","no_sled","2","2","2",7,0.2,34,5,16,20.6,-2,-1,-2,5,3,2,0,5
"9631",2020-01-18,"Snodgrass","w1920","Motorized",NA,"Sat","weekend","sled","2","2","2",7,0.2,34,5,16,20.6,-2,-1,-2,5,3,2,0,5
"9632",2020-01-18,"Snodgrass","w1920","Hybrid",NA,"Sat","weekend","sled","2","2","2",7,0.2,34,5,16,20.6,-2,-1,-2,5,3,2,0,5
"9633",2020-01-19,"Snodgrass","w1920","Non.motorized",50,"Sun","weekend","no_sled","2","2","1",7,0,33,-1,21,21.2,5,-2,-1,-2,4,2,1,-1
"9634",2020-01-19,"Snodgrass","w1920","Mechanized",3,"Sun","weekend","no_sled","2","2","1",7,0,33,-1,21,21.2,5,-2,-1,-2,4,2,1,-1
"9635",2020-01-19,"Snodgrass","w1920","Motorized",NA,"Sun","weekend","sled","2","2","1",7,0,33,-1,21,21.2,5,-2,-1,-2,4,2,1,-1
"9636",2020-01-19,"Snodgrass","w1920","Hybrid",NA,"Sun","weekend","sled","2","2","1",7,0,33,-1,21,21.2,5,-2,-1,-2,4,2,1,-1
"9637",2020-01-20,"Snodgrass","w1920","Non.motorized",39,"Mon","weekday","no_sled","2","2","1",7.1,0.1,32,-1,25,22.2,-1,5,-2,-1,-2,3,1,0
"9638",2020-01-20,"Snodgrass","w1920","Mechanized",1,"Mon","weekday","no_sled","2","2","1",7.1,0.1,32,-1,25,22.2,-1,5,-2,-1,-2,3,1,0
"9639",2020-01-20,"Snodgrass","w1920","Motorized",NA,"Mon","weekday","sled","2","2","1",7.1,0.1,32,-1,25,22.2,-1,5,-2,-1,-2,3,1,0
"9640",2020-01-20,"Snodgrass","w1920","Hybrid",NA,"Mon","weekday","sled","2","2","1",7.1,0.1,32,-1,25,22.2,-1,5,-2,-1,-2,3,1,0
"9641",2020-01-21,"Snodgrass","w1920","Non.motorized",35,"Tue","weekday","no_sled","2","2","1",7.1,0,31,-1,28,22.9,-1,-1,5,-2,-2,-3,2,0
"9642",2020-01-21,"Snodgrass","w1920","Mechanized",0,"Tue","weekday","no_sled","2","2","1",7.1,0,31,-1,28,22.9,-1,-1,5,-2,-2,-3,2,0
"9643",2020-01-21,"Snodgrass","w1920","Motorized",NA,"Tue","weekday","sled","2","2","1",7.1,0,31,-1,28,22.9,-1,-1,5,-2,-2,-3,2,0
"9644",2020-01-21,"Snodgrass","w1920","Hybrid",NA,"Tue","weekday","sled","2","2","1",7.1,0,31,-1,28,22.9,-1,-1,5,-2,-2,-3,2,0
"9645",2020-01-22,"Snodgrass","w1920","Non.motorized",36,"Wed","weekday","no_sled","2","2","2",7.3,0.2,32,1,25,22.8,-1,-1,-1,5,0,-1,-2,3
"9646",2020-01-22,"Snodgrass","w1920","Mechanized",1,"Wed","weekday","no_sled","2","2","2",7.3,0.2,32,1,25,22.8,-1,-1,-1,5,0,-1,-2,3
"9647",2020-01-22,"Snodgrass","w1920","Motorized",NA,"Wed","weekday","sled","2","2","2",7.3,0.2,32,1,25,22.8,-1,-1,-1,5,0,-1,-2,3
"9648",2020-01-22,"Snodgrass","w1920","Hybrid",NA,"Wed","weekday","sled","2","2","2",7.3,0.2,32,1,25,22.8,-1,-1,-1,5,0,-1,-2,3
"9649",2020-01-23,"Snodgrass","w1920","Non.motorized",36,"Thu","weekday","no_sled","3","2","2",7.3,0,34,2,23,21.5,1,-1,-1,-1,3,2,1,0
"9650",2020-01-23,"Snodgrass","w1920","Mechanized",1,"Thu","weekday","no_sled","3","2","2",7.3,0,34,2,23,21.5,1,-1,-1,-1,3,2,1,0
"9651",2020-01-23,"Snodgrass","w1920","Motorized",NA,"Thu","weekday","sled","3","2","2",7.3,0,34,2,23,21.5,1,-1,-1,-1,3,2,1,0
"9652",2020-01-23,"Snodgrass","w1920","Hybrid",NA,"Thu","weekday","sled","3","2","2",7.3,0,34,2,23,21.5,1,-1,-1,-1,3,2,1,0
"9653",2020-01-24,"Snodgrass","w1920","Non.motorized",74,"Fri","weekday","no_sled","2","2","1",7.3,0,33,-1,23,22.1,2,1,-1,-1,1,2,1,0
"9654",2020-01-24,"Snodgrass","w1920","Mechanized",6,"Fri","weekday","no_sled","2","2","1",7.3,0,33,-1,23,22.1,2,1,-1,-1,1,2,1,0
"9655",2020-01-24,"Snodgrass","w1920","Motorized",NA,"Fri","weekday","sled","2","2","1",7.3,0,33,-1,23,22.1,2,1,-1,-1,1,2,1,0
"9656",2020-01-24,"Snodgrass","w1920","Hybrid",NA,"Fri","weekday","sled","2","2","1",7.3,0,33,-1,23,22.1,2,1,-1,-1,1,2,1,0
"9657",2020-01-25,"Snodgrass","w1920","Non.motorized",104,"Sat","weekend","no_sled","2","2","1",7.4,0.1,32,-1,25,23.1,-1,2,1,-1,-2,0,1,0
"9658",2020-01-25,"Snodgrass","w1920","Mechanized",3,"Sat","weekend","no_sled","2","2","1",7.4,0.1,32,-1,25,23.1,-1,2,1,-1,-2,0,1,0
"9659",2020-01-25,"Snodgrass","w1920","Motorized",NA,"Sat","weekend","sled","2","2","1",7.4,0.1,32,-1,25,23.1,-1,2,1,-1,-2,0,1,0
"9660",2020-01-25,"Snodgrass","w1920","Hybrid",NA,"Sat","weekend","sled","2","2","1",7.4,0.1,32,-1,25,23.1,-1,2,1,-1,-2,0,1,0
"9661",2020-01-26,"Snodgrass","w1920","Non.motorized",90,"Sun","weekend","no_sled","2","1","1",7.4,0,32,0,28,23.1,-1,-1,2,1,-1,-2,0,1
"9662",2020-01-26,"Snodgrass","w1920","Mechanized",2,"Sun","weekend","no_sled","2","1","1",7.4,0,32,0,28,23.1,-1,-1,2,1,-1,-2,0,1
"9663",2020-01-26,"Snodgrass","w1920","Motorized",NA,"Sun","weekend","sled","2","1","1",7.4,0,32,0,28,23.1,-1,-1,2,1,-1,-2,0,1
"9664",2020-01-26,"Snodgrass","w1920","Hybrid",NA,"Sun","weekend","sled","2","1","1",7.4,0,32,0,28,23.1,-1,-1,2,1,-1,-2,0,1
"9665",2020-01-27,"Snodgrass","w1920","Non.motorized",32,"Mon","weekday","no_sled","2","1","1",7.4,0,32,0,24,23.1,0,-1,-1,2,0,-1,-2,0
"9666",2020-01-27,"Snodgrass","w1920","Mechanized",0,"Mon","weekday","no_sled","2","1","1",7.4,0,32,0,24,23.1,0,-1,-1,2,0,-1,-2,0
"9667",2020-01-27,"Snodgrass","w1920","Motorized",NA,"Mon","weekday","sled","2","1","1",7.4,0,32,0,24,23.1,0,-1,-1,2,0,-1,-2,0
"9668",2020-01-27,"Snodgrass","w1920","Hybrid",NA,"Mon","weekday","sled","2","1","1",7.4,0,32,0,24,23.1,0,-1,-1,2,0,-1,-2,0
"9669",2020-01-28,"Snodgrass","w1920","Non.motorized",67,"Tue","weekday","no_sled","3","2","2",7.4,0,32,0,19,23.1,0,0,-1,-1,0,0,-1,-2
"9670",2020-01-28,"Snodgrass","w1920","Mechanized",1,"Tue","weekday","no_sled","3","2","2",7.4,0,32,0,19,23.1,0,0,-1,-1,0,0,-1,-2
"9671",2020-01-28,"Snodgrass","w1920","Motorized",NA,"Tue","weekday","sled","3","2","2",7.4,0,32,0,19,23.1,0,0,-1,-1,0,0,-1,-2
"9672",2020-01-28,"Snodgrass","w1920","Hybrid",NA,"Tue","weekday","sled","3","2","2",7.4,0,32,0,19,23.1,0,0,-1,-1,0,0,-1,-2
"9673",2020-01-29,"Snodgrass","w1920","Non.motorized",43,"Wed","weekday","no_sled","2","2","1",7.4,0,31,-1,20,23.9,0,0,0,-1,-1,-1,-1,-2
"9674",2020-01-29,"Snodgrass","w1920","Mechanized",3,"Wed","weekday","no_sled","2","2","1",7.4,0,31,-1,20,23.9,0,0,0,-1,-1,-1,-1,-2
"9675",2020-01-29,"Snodgrass","w1920","Motorized",NA,"Wed","weekday","sled","2","2","1",7.4,0,31,-1,20,23.9,0,0,0,-1,-1,-1,-1,-2
"9676",2020-01-29,"Snodgrass","w1920","Hybrid",NA,"Wed","weekday","sled","2","2","1",7.4,0,31,-1,20,23.9,0,0,0,-1,-1,-1,-1,-2
"9677",2020-01-30,"Snodgrass","w1920","Non.motorized",33,"Thu","weekday","no_sled","2","2","1",7.4,0,31,0,17,23.9,-1,0,0,0,-1,-1,-1,-1
"9678",2020-01-30,"Snodgrass","w1920","Mechanized",8,"Thu","weekday","no_sled","2","2","1",7.4,0,31,0,17,23.9,-1,0,0,0,-1,-1,-1,-1
"9679",2020-01-30,"Snodgrass","w1920","Motorized",NA,"Thu","weekday","sled","2","2","1",7.4,0,31,0,17,23.9,-1,0,0,0,-1,-1,-1,-1
"9680",2020-01-30,"Snodgrass","w1920","Hybrid",NA,"Thu","weekday","sled","2","2","1",7.4,0,31,0,17,23.9,-1,0,0,0,-1,-1,-1,-1
"9681",2020-01-31,"Snodgrass","w1920","Non.motorized",53,"Fri","weekday","no_sled","2","1","1",7.4,0,31,0,20,23.9,0,-1,0,0,0,-1,-1,-1
"9682",2020-01-31,"Snodgrass","w1920","Mechanized",11,"Fri","weekday","no_sled","2","1","1",7.4,0,31,0,20,23.9,0,-1,0,0,0,-1,-1,-1
"9683",2020-01-31,"Snodgrass","w1920","Motorized",NA,"Fri","weekday","sled","2","1","1",7.4,0,31,0,20,23.9,0,-1,0,0,0,-1,-1,-1
"9684",2020-01-31,"Snodgrass","w1920","Hybrid",NA,"Fri","weekday","sled","2","1","1",7.4,0,31,0,20,23.9,0,-1,0,0,0,-1,-1,-1
"9685",2020-02-01,"Snodgrass","w1920","Non.motorized",125,"Sat","weekend","no_sled","2","1","1",7.4,0,31,0,28,23.9,0,0,-1,0,0,0,-1,-1
"9686",2020-02-01,"Snodgrass","w1920","Mechanized",14,"Sat","weekend","no_sled","2","1","1",7.4,0,31,0,28,23.9,0,0,-1,0,0,0,-1,-1
"9687",2020-02-01,"Snodgrass","w1920","Motorized",NA,"Sat","weekend","sled","2","1","1",7.4,0,31,0,28,23.9,0,0,-1,0,0,0,-1,-1
"9688",2020-02-01,"Snodgrass","w1920","Hybrid",NA,"Sat","weekend","sled","2","1","1",7.4,0,31,0,28,23.9,0,0,-1,0,0,0,-1,-1
"9689",2020-02-02,"Snodgrass","w1920","Non.motorized",108,"Sun","weekend","no_sled","1","1","1",7.4,0,31,0,33,23.9,0,0,0,-1,0,0,0,-1
"9690",2020-02-02,"Snodgrass","w1920","Mechanized",0,"Sun","weekend","no_sled","1","1","1",7.4,0,31,0,33,23.9,0,0,0,-1,0,0,0,-1
"9691",2020-02-02,"Snodgrass","w1920","Motorized",NA,"Sun","weekend","sled","1","1","1",7.4,0,31,0,33,23.9,0,0,0,-1,0,0,0,-1
"9692",2020-02-02,"Snodgrass","w1920","Hybrid",NA,"Sun","weekend","sled","1","1","1",7.4,0,31,0,33,23.9,0,0,0,-1,0,0,0,-1
"9693",2020-02-03,"Snodgrass","w1920","Non.motorized",25,"Mon","weekday","no_sled","2","2","1",7.4,0,31,0,24,23.9,0,0,0,0,0,0,0,0
"9694",2020-02-03,"Snodgrass","w1920","Mechanized",0,"Mon","weekday","no_sled","2","2","1",7.4,0,31,0,24,23.9,0,0,0,0,0,0,0,0
"9695",2020-02-03,"Snodgrass","w1920","Motorized",NA,"Mon","weekday","sled","2","2","1",7.4,0,31,0,24,23.9,0,0,0,0,0,0,0,0
"9696",2020-02-03,"Snodgrass","w1920","Hybrid",NA,"Mon","weekday","sled","2","2","1",7.4,0,31,0,24,23.9,0,0,0,0,0,0,0,0
"9697",2020-02-04,"Snodgrass","w1920","Non.motorized",9,"Tue","weekday","no_sled","2","2","2",7.4,0,33,2,5,22.4,0,0,0,0,2,2,2,2
"9698",2020-02-04,"Snodgrass","w1920","Mechanized",0,"Tue","weekday","no_sled","2","2","2",7.4,0,33,2,5,22.4,0,0,0,0,2,2,2,2
"9699",2020-02-04,"Snodgrass","w1920","Motorized",NA,"Tue","weekday","sled","2","2","2",7.4,0,33,2,5,22.4,0,0,0,0,2,2,2,2
"9700",2020-02-04,"Snodgrass","w1920","Hybrid",NA,"Tue","weekday","sled","2","2","2",7.4,0,33,2,5,22.4,0,0,0,0,2,2,2,2
"9701",2020-02-05,"Snodgrass","w1920","Non.motorized",NA,"Wed","weekday","no_sled","2","2","1",7.4,0,33,0,2,22.4,2,0,0,0,2,2,2,2
"9702",2020-02-05,"Snodgrass","w1920","Mechanized",NA,"Wed","weekday","no_sled","2","2","1",7.4,0,33,0,2,22.4,2,0,0,0,2,2,2,2
"9703",2020-02-05,"Snodgrass","w1920","Motorized",NA,"Wed","weekday","sled","2","2","1",7.4,0,33,0,2,22.4,2,0,0,0,2,2,2,2
"9704",2020-02-05,"Snodgrass","w1920","Hybrid",NA,"Wed","weekday","sled","2","2","1",7.4,0,33,0,2,22.4,2,0,0,0,2,2,2,2
"9705",2020-02-06,"Snodgrass","w1920","Non.motorized",NA,"Thu","weekday","no_sled","2","2","1",7.5,0.1,32,-1,16,23.4,0,2,0,0,-1,1,1,1
"9706",2020-02-06,"Snodgrass","w1920","Mechanized",NA,"Thu","weekday","no_sled","2","2","1",7.5,0.1,32,-1,16,23.4,0,2,0,0,-1,1,1,1
"9707",2020-02-06,"Snodgrass","w1920","Motorized",NA,"Thu","weekday","sled","2","2","1",7.5,0.1,32,-1,16,23.4,0,2,0,0,-1,1,1,1
"9708",2020-02-06,"Snodgrass","w1920","Hybrid",NA,"Thu","weekday","sled","2","2","1",7.5,0.1,32,-1,16,23.4,0,2,0,0,-1,1,1,1
"9709",2020-02-07,"Snodgrass","w1920","Non.motorized",NA,"Fri","weekday","no_sled","3","3","3",7.9,0.4,37,5,26,21.4,-1,0,2,0,4,4,6,6
"9710",2020-02-07,"Snodgrass","w1920","Mechanized",NA,"Fri","weekday","no_sled","3","3","3",7.9,0.4,37,5,26,21.4,-1,0,2,0,4,4,6,6
"9711",2020-02-07,"Snodgrass","w1920","Motorized",NA,"Fri","weekday","sled","3","3","3",7.9,0.4,37,5,26,21.4,-1,0,2,0,4,4,6,6
"9712",2020-02-07,"Snodgrass","w1920","Hybrid",NA,"Fri","weekday","sled","3","3","3",7.9,0.4,37,5,26,21.4,-1,0,2,0,4,4,6,6
"9713",2020-02-08,"Snodgrass","w1920","Non.motorized",NA,"Sat","weekend","no_sled","3","3","2",8.3,0.4,39,2,30,21.3,5,-1,0,2,7,6,6,8
"9714",2020-02-08,"Snodgrass","w1920","Mechanized",NA,"Sat","weekend","no_sled","3","3","2",8.3,0.4,39,2,30,21.3,5,-1,0,2,7,6,6,8
"9715",2020-02-08,"Snodgrass","w1920","Motorized",NA,"Sat","weekend","sled","3","3","2",8.3,0.4,39,2,30,21.3,5,-1,0,2,7,6,6,8
"9716",2020-02-08,"Snodgrass","w1920","Hybrid",NA,"Sat","weekend","sled","3","3","2",8.3,0.4,39,2,30,21.3,5,-1,0,2,7,6,6,8
"9717",2020-02-09,"Snodgrass","w1920","Non.motorized",NA,"Sun","weekend","no_sled","3","2","2",8.4,0.1,38,-1,26,22.1,2,5,-1,0,1,6,5,5
"9718",2020-02-09,"Snodgrass","w1920","Mechanized",NA,"Sun","weekend","no_sled","3","2","2",8.4,0.1,38,-1,26,22.1,2,5,-1,0,1,6,5,5
"9719",2020-02-09,"Snodgrass","w1920","Motorized",NA,"Sun","weekend","sled","3","2","2",8.4,0.1,38,-1,26,22.1,2,5,-1,0,1,6,5,5
"9720",2020-02-09,"Snodgrass","w1920","Hybrid",NA,"Sun","weekend","sled","3","2","2",8.4,0.1,38,-1,26,22.1,2,5,-1,0,1,6,5,5
"9721",2020-02-10,"Snodgrass","w1920","Non.motorized",NA,"Mon","weekday","no_sled","2","2","1",8.4,0,38,0,22,22.1,-1,2,5,-1,-1,1,6,5
"9722",2020-02-10,"Snodgrass","w1920","Mechanized",NA,"Mon","weekday","no_sled","2","2","1",8.4,0,38,0,22,22.1,-1,2,5,-1,-1,1,6,5
"9723",2020-02-10,"Snodgrass","w1920","Motorized",NA,"Mon","weekday","sled","2","2","1",8.4,0,38,0,22,22.1,-1,2,5,-1,-1,1,6,5
"9724",2020-02-10,"Snodgrass","w1920","Hybrid",NA,"Mon","weekday","sled","2","2","1",8.4,0,38,0,22,22.1,-1,2,5,-1,-1,1,6,5
"9725",2020-02-11,"Snodgrass","w1920","Non.motorized",16,"Tue","weekday","no_sled","2","2","2",8.5,0.1,40,2,16,21.2,0,-1,2,5,2,1,3,8
"9726",2020-02-11,"Snodgrass","w1920","Mechanized",0,"Tue","weekday","no_sled","2","2","2",8.5,0.1,40,2,16,21.2,0,-1,2,5,2,1,3,8
"9727",2020-02-11,"Snodgrass","w1920","Motorized",NA,"Tue","weekday","sled","2","2","2",8.5,0.1,40,2,16,21.2,0,-1,2,5,2,1,3,8
"9728",2020-02-11,"Snodgrass","w1920","Hybrid",NA,"Tue","weekday","sled","2","2","2",8.5,0.1,40,2,16,21.2,0,-1,2,5,2,1,3,8
"9729",2020-02-12,"Snodgrass","w1920","Non.motorized",42,"Wed","weekday","no_sled","2","2","2",8.5,0,39,-1,15,21.8,2,0,-1,2,1,1,0,2
"9730",2020-02-12,"Snodgrass","w1920","Mechanized",1,"Wed","weekday","no_sled","2","2","2",8.5,0,39,-1,15,21.8,2,0,-1,2,1,1,0,2
"9731",2020-02-12,"Snodgrass","w1920","Motorized",NA,"Wed","weekday","sled","2","2","2",8.5,0,39,-1,15,21.8,2,0,-1,2,1,1,0,2
"9732",2020-02-12,"Snodgrass","w1920","Hybrid",NA,"Wed","weekday","sled","2","2","2",8.5,0,39,-1,15,21.8,2,0,-1,2,1,1,0,2
"9733",2020-02-13,"Snodgrass","w1920","Non.motorized",26,"Thu","weekday","no_sled","2","2","1",8.5,0,39,0,18,21.8,-1,2,0,-1,-1,1,1,0
"9734",2020-02-13,"Snodgrass","w1920","Mechanized",0,"Thu","weekday","no_sled","2","2","1",8.5,0,39,0,18,21.8,-1,2,0,-1,-1,1,1,0
"9735",2020-02-13,"Snodgrass","w1920","Motorized",NA,"Thu","weekday","sled","2","2","1",8.5,0,39,0,18,21.8,-1,2,0,-1,-1,1,1,0
"9736",2020-02-13,"Snodgrass","w1920","Hybrid",NA,"Thu","weekday","sled","2","2","1",8.5,0,39,0,18,21.8,-1,2,0,-1,-1,1,1,0
"9737",2020-02-14,"Snodgrass","w1920","Non.motorized",54,"Fri","weekday","no_sled","2","1","1",8.6,0.1,38,-1,24,22.6,0,-1,2,0,-1,-2,0,0
"9738",2020-02-14,"Snodgrass","w1920","Mechanized",1,"Fri","weekday","no_sled","2","1","1",8.6,0.1,38,-1,24,22.6,0,-1,2,0,-1,-2,0,0
"9739",2020-02-14,"Snodgrass","w1920","Motorized",NA,"Fri","weekday","sled","2","1","1",8.6,0.1,38,-1,24,22.6,0,-1,2,0,-1,-2,0,0
"9740",2020-02-14,"Snodgrass","w1920","Hybrid",NA,"Fri","weekday","sled","2","1","1",8.6,0.1,38,-1,24,22.6,0,-1,2,0,-1,-2,0,0
"9741",2020-02-15,"Snodgrass","w1920","Non.motorized",79,"Sat","weekend","no_sled","1","1","1",8.6,0,38,0,26,22.6,-1,0,-1,2,-1,-1,-2,0
"9742",2020-02-15,"Snodgrass","w1920","Mechanized",7,"Sat","weekend","no_sled","1","1","1",8.6,0,38,0,26,22.6,-1,0,-1,2,-1,-1,-2,0
"9743",2020-02-15,"Snodgrass","w1920","Motorized",NA,"Sat","weekend","sled","1","1","1",8.6,0,38,0,26,22.6,-1,0,-1,2,-1,-1,-2,0
"9744",2020-02-15,"Snodgrass","w1920","Hybrid",NA,"Sat","weekend","sled","1","1","1",8.6,0,38,0,26,22.6,-1,0,-1,2,-1,-1,-2,0
"9745",2020-02-16,"Snodgrass","w1920","Non.motorized",46,"Sun","weekend","no_sled","1","1","1",8.8,0.2,37,-1,26,23.8,0,-1,0,-1,-1,-2,-2,-3
"9746",2020-02-16,"Snodgrass","w1920","Mechanized",0,"Sun","weekend","no_sled","1","1","1",8.8,0.2,37,-1,26,23.8,0,-1,0,-1,-1,-2,-2,-3
"9747",2020-02-16,"Snodgrass","w1920","Motorized",NA,"Sun","weekend","sled","1","1","1",8.8,0.2,37,-1,26,23.8,0,-1,0,-1,-1,-2,-2,-3
"9748",2020-02-16,"Snodgrass","w1920","Hybrid",NA,"Sun","weekend","sled","1","1","1",8.8,0.2,37,-1,26,23.8,0,-1,0,-1,-1,-2,-2,-3
"9749",2020-02-17,"Snodgrass","w1920","Non.motorized",56,"Mon","weekday","no_sled","2","1","1",9.2,0.4,43,6,25,21.4,-1,0,-1,0,5,5,4,4
"9750",2020-02-17,"Snodgrass","w1920","Mechanized",1,"Mon","weekday","no_sled","2","1","1",9.2,0.4,43,6,25,21.4,-1,0,-1,0,5,5,4,4
"9751",2020-02-17,"Snodgrass","w1920","Motorized",NA,"Mon","weekday","sled","2","1","1",9.2,0.4,43,6,25,21.4,-1,0,-1,0,5,5,4,4
"9752",2020-02-17,"Snodgrass","w1920","Hybrid",NA,"Mon","weekday","sled","2","1","1",9.2,0.4,43,6,25,21.4,-1,0,-1,0,5,5,4,4
"9753",2020-02-18,"Snodgrass","w1920","Non.motorized",29,"Tue","weekday","no_sled","1","1","1",9.3,0.1,42,-1,18,22.1,6,-1,0,-1,5,4,4,3
"9754",2020-02-18,"Snodgrass","w1920","Mechanized",0,"Tue","weekday","no_sled","1","1","1",9.3,0.1,42,-1,18,22.1,6,-1,0,-1,5,4,4,3
"9755",2020-02-18,"Snodgrass","w1920","Motorized",NA,"Tue","weekday","sled","1","1","1",9.3,0.1,42,-1,18,22.1,6,-1,0,-1,5,4,4,3
"9756",2020-02-18,"Snodgrass","w1920","Hybrid",NA,"Tue","weekday","sled","1","1","1",9.3,0.1,42,-1,18,22.1,6,-1,0,-1,5,4,4,3
"9757",2020-02-19,"Snodgrass","w1920","Non.motorized",49,"Wed","weekday","no_sled","1","1","1",9.3,0,41,-1,22,22.7,-1,6,-1,0,-2,4,3,3
"9758",2020-02-19,"Snodgrass","w1920","Mechanized",0,"Wed","weekday","no_sled","1","1","1",9.3,0,41,-1,22,22.7,-1,6,-1,0,-2,4,3,3
"9759",2020-02-19,"Snodgrass","w1920","Motorized",NA,"Wed","weekday","sled","1","1","1",9.3,0,41,-1,22,22.7,-1,6,-1,0,-2,4,3,3
"9760",2020-02-19,"Snodgrass","w1920","Hybrid",NA,"Wed","weekday","sled","1","1","1",9.3,0,41,-1,22,22.7,-1,6,-1,0,-2,4,3,3
"9761",2020-02-20,"Snodgrass","w1920","Non.motorized",52,"Thu","weekday","no_sled","1","1","1",9.3,0,41,0,18,22.7,-1,-1,6,-1,-1,-2,4,3
"9762",2020-02-20,"Snodgrass","w1920","Mechanized",1,"Thu","weekday","no_sled","1","1","1",9.3,0,41,0,18,22.7,-1,-1,6,-1,-1,-2,4,3
"9763",2020-02-20,"Snodgrass","w1920","Motorized",NA,"Thu","weekday","sled","1","1","1",9.3,0,41,0,18,22.7,-1,-1,6,-1,-1,-2,4,3
"9764",2020-02-20,"Snodgrass","w1920","Hybrid",NA,"Thu","weekday","sled","1","1","1",9.3,0,41,0,18,22.7,-1,-1,6,-1,-1,-2,4,3
"9765",2020-02-21,"Snodgrass","w1920","Non.motorized",67,"Fri","weekday","no_sled","1","1","1",9.3,0,40,-1,26,23.2,0,-1,-1,6,-1,-2,-3,3
"9766",2020-02-21,"Snodgrass","w1920","Mechanized",0,"Fri","weekday","no_sled","1","1","1",9.3,0,40,-1,26,23.2,0,-1,-1,6,-1,-2,-3,3
"9767",2020-02-21,"Snodgrass","w1920","Motorized",NA,"Fri","weekday","sled","1","1","1",9.3,0,40,-1,26,23.2,0,-1,-1,6,-1,-2,-3,3
"9768",2020-02-21,"Snodgrass","w1920","Hybrid",NA,"Fri","weekday","sled","1","1","1",9.3,0,40,-1,26,23.2,0,-1,-1,6,-1,-2,-3,3
"9769",2020-02-22,"Snodgrass","w1920","Non.motorized",117,"Sat","weekend","no_sled","1","1","1",9.4,0.1,39,-1,32,24.1,-1,0,-1,-1,-2,-2,-3,-4
"9770",2020-02-22,"Snodgrass","w1920","Mechanized",2,"Sat","weekend","no_sled","1","1","1",9.4,0.1,39,-1,32,24.1,-1,0,-1,-1,-2,-2,-3,-4
"9771",2020-02-22,"Snodgrass","w1920","Motorized",NA,"Sat","weekend","sled","1","1","1",9.4,0.1,39,-1,32,24.1,-1,0,-1,-1,-2,-2,-3,-4
"9772",2020-02-22,"Snodgrass","w1920","Hybrid",NA,"Sat","weekend","sled","1","1","1",9.4,0.1,39,-1,32,24.1,-1,0,-1,-1,-2,-2,-3,-4
"9773",2020-02-23,"Snodgrass","w1920","Non.motorized",159,"Sun","weekend","no_sled","2","2","2",9.5,0.1,40,1,27,23.8,-1,-1,0,-1,0,-1,-1,-2
"9774",2020-02-23,"Snodgrass","w1920","Mechanized",2,"Sun","weekend","no_sled","2","2","2",9.5,0.1,40,1,27,23.8,-1,-1,0,-1,0,-1,-1,-2
"9775",2020-02-23,"Snodgrass","w1920","Motorized",NA,"Sun","weekend","sled","2","2","2",9.5,0.1,40,1,27,23.8,-1,-1,0,-1,0,-1,-1,-2
"9776",2020-02-23,"Snodgrass","w1920","Hybrid",NA,"Sun","weekend","sled","2","2","2",9.5,0.1,40,1,27,23.8,-1,-1,0,-1,0,-1,-1,-2
"9777",2020-02-24,"Snodgrass","w1920","Non.motorized",12,"Mon","weekday","no_sled","3","3","2",9.8,0.3,43,3,17,22.8,1,-1,-1,0,4,3,2,2
"9778",2020-02-24,"Snodgrass","w1920","Mechanized",0,"Mon","weekday","no_sled","3","3","2",9.8,0.3,43,3,17,22.8,1,-1,-1,0,4,3,2,2
"9779",2020-02-24,"Snodgrass","w1920","Motorized",NA,"Mon","weekday","sled","3","3","2",9.8,0.3,43,3,17,22.8,1,-1,-1,0,4,3,2,2
"9780",2020-02-24,"Snodgrass","w1920","Hybrid",NA,"Mon","weekday","sled","3","3","2",9.8,0.3,43,3,17,22.8,1,-1,-1,0,4,3,2,2
"9781",2020-02-25,"Snodgrass","w1920","Non.motorized",80,"Tue","weekday","no_sled","2","2","1",9.8,0,43,0,8,22.8,3,1,-1,-1,3,4,3,2
"9782",2020-02-25,"Snodgrass","w1920","Mechanized",0,"Tue","weekday","no_sled","2","2","1",9.8,0,43,0,8,22.8,3,1,-1,-1,3,4,3,2
"9783",2020-02-25,"Snodgrass","w1920","Motorized",NA,"Tue","weekday","sled","2","2","1",9.8,0,43,0,8,22.8,3,1,-1,-1,3,4,3,2
"9784",2020-02-25,"Snodgrass","w1920","Hybrid",NA,"Tue","weekday","sled","2","2","1",9.8,0,43,0,8,22.8,3,1,-1,-1,3,4,3,2
"9785",2020-02-26,"Snodgrass","w1920","Non.motorized",59,"Wed","weekday","no_sled","2","2","1",9.8,0,42,-1,15,23.3,0,3,1,-1,-1,2,3,2
"9786",2020-02-26,"Snodgrass","w1920","Mechanized",0,"Wed","weekday","no_sled","2","2","1",9.8,0,42,-1,15,23.3,0,3,1,-1,-1,2,3,2
"9787",2020-02-26,"Snodgrass","w1920","Motorized",NA,"Wed","weekday","sled","2","2","1",9.8,0,42,-1,15,23.3,0,3,1,-1,-1,2,3,2
"9788",2020-02-26,"Snodgrass","w1920","Hybrid",NA,"Wed","weekday","sled","2","2","1",9.8,0,42,-1,15,23.3,0,3,1,-1,-1,2,3,2
"9789",2020-02-27,"Snodgrass","w1920","Non.motorized",70,"Thu","weekday","no_sled","2","2","1",9.9,0.1,41,-1,25,24.1,-1,0,3,1,-2,-2,1,2
"9790",2020-02-27,"Snodgrass","w1920","Mechanized",2,"Thu","weekday","no_sled","2","2","1",9.9,0.1,41,-1,25,24.1,-1,0,3,1,-2,-2,1,2
"9791",2020-02-27,"Snodgrass","w1920","Motorized",NA,"Thu","weekday","sled","2","2","1",9.9,0.1,41,-1,25,24.1,-1,0,3,1,-2,-2,1,2
"9792",2020-02-27,"Snodgrass","w1920","Hybrid",NA,"Thu","weekday","sled","2","2","1",9.9,0.1,41,-1,25,24.1,-1,0,3,1,-2,-2,1,2
"9793",2020-02-28,"Snodgrass","w1920","Non.motorized",92,"Fri","weekday","no_sled","2","1","1",9.9,0,41,0,28,24.1,-1,-1,0,3,-1,-2,-2,1
"9794",2020-02-28,"Snodgrass","w1920","Mechanized",2,"Fri","weekday","no_sled","2","1","1",9.9,0,41,0,28,24.1,-1,-1,0,3,-1,-2,-2,1
"9795",2020-02-28,"Snodgrass","w1920","Motorized",NA,"Fri","weekday","sled","2","1","1",9.9,0,41,0,28,24.1,-1,-1,0,3,-1,-2,-2,1
"9796",2020-02-28,"Snodgrass","w1920","Hybrid",NA,"Fri","weekday","sled","2","1","1",9.9,0,41,0,28,24.1,-1,-1,0,3,-1,-2,-2,1
"9797",2020-02-29,"Snodgrass","w1920","Non.motorized",150,"Sat","weekend","no_sled","1","1","1",9.9,0,40,-1,29,24.8,0,-1,-1,0,-1,-2,-3,-3
"9798",2020-02-29,"Snodgrass","w1920","Mechanized",3,"Sat","weekend","no_sled","1","1","1",9.9,0,40,-1,29,24.8,0,-1,-1,0,-1,-2,-3,-3
"9799",2020-02-29,"Snodgrass","w1920","Motorized",NA,"Sat","weekend","sled","1","1","1",9.9,0,40,-1,29,24.8,0,-1,-1,0,-1,-2,-3,-3
"9800",2020-02-29,"Snodgrass","w1920","Hybrid",NA,"Sat","weekend","sled","1","1","1",9.9,0,40,-1,29,24.8,0,-1,-1,0,-1,-2,-3,-3
"9801",2020-03-01,"Snodgrass","w1920","Non.motorized",71,"Sun","weekend","no_sled","1","1","1",10,0.1,40,0,28,25,-1,0,-1,-1,-1,-1,-2,-3
"9802",2020-03-01,"Snodgrass","w1920","Mechanized",0,"Sun","weekend","no_sled","1","1","1",10,0.1,40,0,28,25,-1,0,-1,-1,-1,-1,-2,-3
"9803",2020-03-01,"Snodgrass","w1920","Motorized",NA,"Sun","weekend","sled","1","1","1",10,0.1,40,0,28,25,-1,0,-1,-1,-1,-1,-2,-3
"9804",2020-03-01,"Snodgrass","w1920","Hybrid",NA,"Sun","weekend","sled","1","1","1",10,0.1,40,0,28,25,-1,0,-1,-1,-1,-1,-2,-3
"9805",2020-03-02,"Snodgrass","w1920","Non.motorized",42,"Mon","weekday","no_sled","2","2","1",10.4,0.4,45,5,25,23.1,0,-1,0,-1,5,4,4,3
"9806",2020-03-02,"Snodgrass","w1920","Mechanized",0,"Mon","weekday","no_sled","2","2","1",10.4,0.4,45,5,25,23.1,0,-1,0,-1,5,4,4,3
"9807",2020-03-02,"Snodgrass","w1920","Motorized",NA,"Mon","weekday","sled","2","2","1",10.4,0.4,45,5,25,23.1,0,-1,0,-1,5,4,4,3
"9808",2020-03-02,"Snodgrass","w1920","Hybrid",NA,"Mon","weekday","sled","2","2","1",10.4,0.4,45,5,25,23.1,0,-1,0,-1,5,4,4,3
"9809",2020-03-03,"Snodgrass","w1920","Non.motorized",NA,"Tue","weekday","no_sled","2","1","1",10.9,0.5,50,5,25,21.8,5,0,-1,0,10,10,9,9
"9810",2020-03-03,"Snodgrass","w1920","Mechanized",NA,"Tue","weekday","no_sled","2","1","1",10.9,0.5,50,5,25,21.8,5,0,-1,0,10,10,9,9
"9811",2020-03-03,"Snodgrass","w1920","Motorized",NA,"Tue","weekday","sled","2","1","1",10.9,0.5,50,5,25,21.8,5,0,-1,0,10,10,9,9
"9812",2020-03-03,"Snodgrass","w1920","Hybrid",NA,"Tue","weekday","sled","2","1","1",10.9,0.5,50,5,25,21.8,5,0,-1,0,10,10,9,9
"9813",2020-03-04,"Snodgrass","w1920","Non.motorized",NA,"Wed","weekday","no_sled","2","1","1",10.9,0,48,-2,29,22.7,5,5,0,-1,3,8,8,7
"9814",2020-03-04,"Snodgrass","w1920","Mechanized",NA,"Wed","weekday","no_sled","2","1","1",10.9,0,48,-2,29,22.7,5,5,0,-1,3,8,8,7
"9815",2020-03-04,"Snodgrass","w1920","Motorized",NA,"Wed","weekday","sled","2","1","1",10.9,0,48,-2,29,22.7,5,5,0,-1,3,8,8,7
"9816",2020-03-04,"Snodgrass","w1920","Hybrid",NA,"Wed","weekday","sled","2","1","1",10.9,0,48,-2,29,22.7,5,5,0,-1,3,8,8,7
"9817",2020-03-05,"Snodgrass","w1920","Non.motorized",63,"Thu","weekday","no_sled","2","1","1",10.9,0,46,-2,32,23.7,-2,5,5,0,-4,1,6,6
"9818",2020-03-05,"Snodgrass","w1920","Mechanized",1,"Thu","weekday","no_sled","2","1","1",10.9,0,46,-2,32,23.7,-2,5,5,0,-4,1,6,6
"9819",2020-03-05,"Snodgrass","w1920","Motorized",NA,"Thu","weekday","sled","2","1","1",10.9,0,46,-2,32,23.7,-2,5,5,0,-4,1,6,6
"9820",2020-03-05,"Snodgrass","w1920","Hybrid",NA,"Thu","weekday","sled","2","1","1",10.9,0,46,-2,32,23.7,-2,5,5,0,-4,1,6,6
"9821",2020-03-06,"Snodgrass","w1920","Non.motorized",68,"Fri","weekday","no_sled","1","1","1",10.9,0,45,-1,34,24.2,-2,-2,5,5,-3,-5,0,5
"9822",2020-03-06,"Snodgrass","w1920","Mechanized",0,"Fri","weekday","no_sled","1","1","1",10.9,0,45,-1,34,24.2,-2,-2,5,5,-3,-5,0,5
"9823",2020-03-06,"Snodgrass","w1920","Motorized",NA,"Fri","weekday","sled","1","1","1",10.9,0,45,-1,34,24.2,-2,-2,5,5,-3,-5,0,5
"9824",2020-03-06,"Snodgrass","w1920","Hybrid",NA,"Fri","weekday","sled","1","1","1",10.9,0,45,-1,34,24.2,-2,-2,5,5,-3,-5,0,5
"9825",2020-03-07,"Snodgrass","w1920","Non.motorized",121,"Sat","weekend","no_sled","1","1","2",10.9,0,44,-1,35,24.8,-1,-2,-2,5,-2,-4,-6,-1
"9826",2020-03-07,"Snodgrass","w1920","Mechanized",0,"Sat","weekend","no_sled","1","1","2",10.9,0,44,-1,35,24.8,-1,-2,-2,5,-2,-4,-6,-1
"9827",2020-03-07,"Snodgrass","w1920","Motorized",NA,"Sat","weekend","sled","1","1","2",10.9,0,44,-1,35,24.8,-1,-2,-2,5,-2,-4,-6,-1
"9828",2020-03-07,"Snodgrass","w1920","Hybrid",NA,"Sat","weekend","sled","1","1","2",10.9,0,44,-1,35,24.8,-1,-2,-2,5,-2,-4,-6,-1
"9829",2020-03-08,"Snodgrass","w1920","Non.motorized",86,"Sun","weekend","no_sled","1","1","1",11,0.1,43,-1,33,25.6,-1,-1,-2,-2,-2,-3,-5,-7
"9830",2020-03-08,"Snodgrass","w1920","Mechanized",1,"Sun","weekend","no_sled","1","1","1",11,0.1,43,-1,33,25.6,-1,-1,-2,-2,-2,-3,-5,-7
"9831",2020-03-08,"Snodgrass","w1920","Motorized",NA,"Sun","weekend","sled","1","1","1",11,0.1,43,-1,33,25.6,-1,-1,-2,-2,-2,-3,-5,-7
"9832",2020-03-08,"Snodgrass","w1920","Hybrid",NA,"Sun","weekend","sled","1","1","1",11,0.1,43,-1,33,25.6,-1,-1,-2,-2,-2,-3,-5,-7
"9833",2020-03-09,"Snodgrass","w1920","Non.motorized",42,"Mon","weekday","no_sled","1","1","1",11.1,0.1,42,-1,31,26.4,-1,-1,-1,-2,-2,-3,-4,-6
"9834",2020-03-09,"Snodgrass","w1920","Mechanized",0,"Mon","weekday","no_sled","1","1","1",11.1,0.1,42,-1,31,26.4,-1,-1,-1,-2,-2,-3,-4,-6
"9835",2020-03-09,"Snodgrass","w1920","Motorized",NA,"Mon","weekday","sled","1","1","1",11.1,0.1,42,-1,31,26.4,-1,-1,-1,-2,-2,-3,-4,-6
"9836",2020-03-09,"Snodgrass","w1920","Hybrid",NA,"Mon","weekday","sled","1","1","1",11.1,0.1,42,-1,31,26.4,-1,-1,-1,-2,-2,-3,-4,-6
"9837",2020-03-10,"Snodgrass","w1920","Non.motorized",27,"Tue","weekday","no_sled","1","1","2",11.2,0.1,44,2,31,25.5,-1,-1,-1,-1,1,0,-1,-2
"9838",2020-03-10,"Snodgrass","w1920","Mechanized",0,"Tue","weekday","no_sled","1","1","2",11.2,0.1,44,2,31,25.5,-1,-1,-1,-1,1,0,-1,-2
"9839",2020-03-10,"Snodgrass","w1920","Motorized",NA,"Tue","weekday","sled","1","1","2",11.2,0.1,44,2,31,25.5,-1,-1,-1,-1,1,0,-1,-2
"9840",2020-03-10,"Snodgrass","w1920","Hybrid",NA,"Tue","weekday","sled","1","1","2",11.2,0.1,44,2,31,25.5,-1,-1,-1,-1,1,0,-1,-2
"9841",2020-03-11,"Snodgrass","w1920","Non.motorized",61,"Wed","weekday","no_sled","2","2","1",11.2,0,44,0,32,25.5,2,-1,-1,-1,2,1,0,-1
"9842",2020-03-11,"Snodgrass","w1920","Mechanized",0,"Wed","weekday","no_sled","2","2","1",11.2,0,44,0,32,25.5,2,-1,-1,-1,2,1,0,-1
"9843",2020-03-11,"Snodgrass","w1920","Motorized",NA,"Wed","weekday","sled","2","2","1",11.2,0,44,0,32,25.5,2,-1,-1,-1,2,1,0,-1
"9844",2020-03-11,"Snodgrass","w1920","Hybrid",NA,"Wed","weekday","sled","2","2","1",11.2,0,44,0,32,25.5,2,-1,-1,-1,2,1,0,-1
"9845",2020-03-12,"Snodgrass","w1920","Non.motorized",48,"Thu","weekday","no_sled","2","2","2",11.4,0.2,42,-2,35,27.1,0,2,-1,-1,-2,0,-1,-2
"9846",2020-03-12,"Snodgrass","w1920","Mechanized",0,"Thu","weekday","no_sled","2","2","2",11.4,0.2,42,-2,35,27.1,0,2,-1,-1,-2,0,-1,-2
"9847",2020-03-12,"Snodgrass","w1920","Motorized",NA,"Thu","weekday","sled","2","2","2",11.4,0.2,42,-2,35,27.1,0,2,-1,-1,-2,0,-1,-2
"9848",2020-03-12,"Snodgrass","w1920","Hybrid",NA,"Thu","weekday","sled","2","2","2",11.4,0.2,42,-2,35,27.1,0,2,-1,-1,-2,0,-1,-2
"9849",2020-03-13,"Snodgrass","w1920","Non.motorized",11,"Fri","weekday","no_sled","3","3","2",11.5,0.1,44,2,31,26.1,-2,0,2,-1,0,0,2,1
"9850",2020-03-13,"Snodgrass","w1920","Mechanized",0,"Fri","weekday","no_sled","3","3","2",11.5,0.1,44,2,31,26.1,-2,0,2,-1,0,0,2,1
"9851",2020-03-13,"Snodgrass","w1920","Motorized",NA,"Fri","weekday","sled","3","3","2",11.5,0.1,44,2,31,26.1,-2,0,2,-1,0,0,2,1
"9852",2020-03-13,"Snodgrass","w1920","Hybrid",NA,"Fri","weekday","sled","3","3","2",11.5,0.1,44,2,31,26.1,-2,0,2,-1,0,0,2,1
"9853",2020-03-14,"Snodgrass","w1920","Non.motorized",75,"Sat","weekend","no_sled","3","3","3",11.7,0.2,44,0,31,26.6,2,-2,0,2,2,0,0,2
"9854",2020-03-14,"Snodgrass","w1920","Mechanized",0,"Sat","weekend","no_sled","3","3","3",11.7,0.2,44,0,31,26.6,2,-2,0,2,2,0,0,2
"9855",2020-03-14,"Snodgrass","w1920","Motorized",NA,"Sat","weekend","sled","3","3","3",11.7,0.2,44,0,31,26.6,2,-2,0,2,2,0,0,2
"9856",2020-03-14,"Snodgrass","w1920","Hybrid",NA,"Sat","weekend","sled","3","3","3",11.7,0.2,44,0,31,26.6,2,-2,0,2,2,0,0,2
"9857",2020-03-15,"Snodgrass","w1920","Non.motorized",166,"Sun","weekend","no_sled","2","2","2",11.7,0,45,1,33,26,0,2,-2,0,1,3,1,1
"9858",2020-03-15,"Snodgrass","w1920","Mechanized",1,"Sun","weekend","no_sled","2","2","2",11.7,0,45,1,33,26,0,2,-2,0,1,3,1,1
"9859",2020-03-15,"Snodgrass","w1920","Motorized",NA,"Sun","weekend","sled","2","2","2",11.7,0,45,1,33,26,0,2,-2,0,1,3,1,1
"9860",2020-03-15,"Snodgrass","w1920","Hybrid",NA,"Sun","weekend","sled","2","2","2",11.7,0,45,1,33,26,0,2,-2,0,1,3,1,1
"9861",2020-03-16,"Snodgrass","w1920","Non.motorized",104,"Mon","weekday","no_sled","2","2","2",11.7,0,45,0,35,26,1,0,2,-2,1,1,3,1
"9862",2020-03-16,"Snodgrass","w1920","Mechanized",2,"Mon","weekday","no_sled","2","2","2",11.7,0,45,0,35,26,1,0,2,-2,1,1,3,1
"9863",2020-03-16,"Snodgrass","w1920","Motorized",NA,"Mon","weekday","sled","2","2","2",11.7,0,45,0,35,26,1,0,2,-2,1,1,3,1
"9864",2020-03-16,"Snodgrass","w1920","Hybrid",NA,"Mon","weekday","sled","2","2","2",11.7,0,45,0,35,26,1,0,2,-2,1,1,3,1
"9865",2020-03-17,"Snodgrass","w1920","Non.motorized",NA,"Tue","weekday","no_sled","2","2","2",11.7,0,44,-1,36,26.6,0,1,0,2,-1,0,0,2
"9866",2020-03-17,"Snodgrass","w1920","Mechanized",NA,"Tue","weekday","no_sled","2","2","2",11.7,0,44,-1,36,26.6,0,1,0,2,-1,0,0,2
"9867",2020-03-17,"Snodgrass","w1920","Motorized",NA,"Tue","weekday","sled","2","2","2",11.7,0,44,-1,36,26.6,0,1,0,2,-1,0,0,2
"9868",2020-03-17,"Snodgrass","w1920","Hybrid",NA,"Tue","weekday","sled","2","2","2",11.7,0,44,-1,36,26.6,0,1,0,2,-1,0,0,2
"9869",2020-03-18,"Snodgrass","w1920","Non.motorized",NA,"Wed","weekday","no_sled","2","2","2",11.7,0,43,-1,33,27.2,-1,0,1,0,-2,-2,-1,-1
"9870",2020-03-18,"Snodgrass","w1920","Mechanized",NA,"Wed","weekday","no_sled","2","2","2",11.7,0,43,-1,33,27.2,-1,0,1,0,-2,-2,-1,-1
"9871",2020-03-18,"Snodgrass","w1920","Motorized",NA,"Wed","weekday","sled","2","2","2",11.7,0,43,-1,33,27.2,-1,0,1,0,-2,-2,-1,-1
"9872",2020-03-18,"Snodgrass","w1920","Hybrid",NA,"Wed","weekday","sled","2","2","2",11.7,0,43,-1,33,27.2,-1,0,1,0,-2,-2,-1,-1
"9873",2020-03-19,"Snodgrass","w1920","Non.motorized",NA,"Thu","weekday","no_sled","3","3","3",11.8,0.1,43,0,27,27.4,-1,-1,0,1,-1,-2,-2,-1
"9874",2020-03-19,"Snodgrass","w1920","Mechanized",NA,"Thu","weekday","no_sled","3","3","3",11.8,0.1,43,0,27,27.4,-1,-1,0,1,-1,-2,-2,-1
"9875",2020-03-19,"Snodgrass","w1920","Motorized",NA,"Thu","weekday","sled","3","3","3",11.8,0.1,43,0,27,27.4,-1,-1,0,1,-1,-2,-2,-1
"9876",2020-03-19,"Snodgrass","w1920","Hybrid",NA,"Thu","weekday","sled","3","3","3",11.8,0.1,43,0,27,27.4,-1,-1,0,1,-1,-2,-2,-1
"9877",2020-03-20,"Snodgrass","w1920","Non.motorized",NA,"Fri","weekday","no_sled","3","3","2",12.7,0.9,52,9,26,24.4,0,-1,-1,0,9,8,7,7
"9878",2020-03-20,"Snodgrass","w1920","Mechanized",NA,"Fri","weekday","no_sled","3","3","2",12.7,0.9,52,9,26,24.4,0,-1,-1,0,9,8,7,7
"9879",2020-03-20,"Snodgrass","w1920","Motorized",NA,"Fri","weekday","sled","3","3","2",12.7,0.9,52,9,26,24.4,0,-1,-1,0,9,8,7,7
"9880",2020-03-20,"Snodgrass","w1920","Hybrid",NA,"Fri","weekday","sled","3","3","2",12.7,0.9,52,9,26,24.4,0,-1,-1,0,9,8,7,7
"9881",2020-03-21,"Snodgrass","w1920","Non.motorized",NA,"Sat","weekend","no_sled","3","3","2",12.8,0.1,54,2,26,23.7,9,0,-1,-1,11,11,10,9
"9882",2020-03-21,"Snodgrass","w1920","Mechanized",NA,"Sat","weekend","no_sled","3","3","2",12.8,0.1,54,2,26,23.7,9,0,-1,-1,11,11,10,9
"9883",2020-03-21,"Snodgrass","w1920","Motorized",NA,"Sat","weekend","sled","3","3","2",12.8,0.1,54,2,26,23.7,9,0,-1,-1,11,11,10,9
"9884",2020-03-21,"Snodgrass","w1920","Hybrid",NA,"Sat","weekend","sled","3","3","2",12.8,0.1,54,2,26,23.7,9,0,-1,-1,11,11,10,9
"9885",2020-03-22,"Snodgrass","w1920","Non.motorized",NA,"Sun","weekend","no_sled","2","2","2",13,0.2,53,-1,28,24.5,2,9,0,-1,1,10,10,9
"9886",2020-03-22,"Snodgrass","w1920","Mechanized",NA,"Sun","weekend","no_sled","2","2","2",13,0.2,53,-1,28,24.5,2,9,0,-1,1,10,10,9
"9887",2020-03-22,"Snodgrass","w1920","Motorized",NA,"Sun","weekend","sled","2","2","2",13,0.2,53,-1,28,24.5,2,9,0,-1,1,10,10,9
"9888",2020-03-22,"Snodgrass","w1920","Hybrid",NA,"Sun","weekend","sled","2","2","2",13,0.2,53,-1,28,24.5,2,9,0,-1,1,10,10,9
"9889",2020-03-23,"Snodgrass","w1920","Non.motorized",NA,"Mon","weekday","no_sled","2","2","2",13,0,53,0,28,24.5,-1,2,9,0,-1,1,10,10
"9890",2020-03-23,"Snodgrass","w1920","Mechanized",NA,"Mon","weekday","no_sled","2","2","2",13,0,53,0,28,24.5,-1,2,9,0,-1,1,10,10
"9891",2020-03-23,"Snodgrass","w1920","Motorized",NA,"Mon","weekday","sled","2","2","2",13,0,53,0,28,24.5,-1,2,9,0,-1,1,10,10
"9892",2020-03-23,"Snodgrass","w1920","Hybrid",NA,"Mon","weekday","sled","2","2","2",13,0,53,0,28,24.5,-1,2,9,0,-1,1,10,10
"9893",2020-03-24,"Snodgrass","w1920","Non.motorized",NA,"Tue","weekday","no_sled","2","2","2",13.2,0.2,53,0,32,24.9,0,-1,2,9,0,-1,1,10
"9894",2020-03-24,"Snodgrass","w1920","Mechanized",NA,"Tue","weekday","no_sled","2","2","2",13.2,0.2,53,0,32,24.9,0,-1,2,9,0,-1,1,10
"9895",2020-03-24,"Snodgrass","w1920","Motorized",NA,"Tue","weekday","sled","2","2","2",13.2,0.2,53,0,32,24.9,0,-1,2,9,0,-1,1,10
"9896",2020-03-24,"Snodgrass","w1920","Hybrid",NA,"Tue","weekday","sled","2","2","2",13.2,0.2,53,0,32,24.9,0,-1,2,9,0,-1,1,10
"9897",2020-03-25,"Snodgrass","w1920","Non.motorized",NA,"Wed","weekday","no_sled","2","2","2",13.3,0.1,51,-2,34,26.1,0,0,-1,2,-2,-2,-3,-1
"9898",2020-03-25,"Snodgrass","w1920","Mechanized",NA,"Wed","weekday","no_sled","2","2","2",13.3,0.1,51,-2,34,26.1,0,0,-1,2,-2,-2,-3,-1
"9899",2020-03-25,"Snodgrass","w1920","Motorized",NA,"Wed","weekday","sled","2","2","2",13.3,0.1,51,-2,34,26.1,0,0,-1,2,-2,-2,-3,-1
"9900",2020-03-25,"Snodgrass","w1920","Hybrid",NA,"Wed","weekday","sled","2","2","2",13.3,0.1,51,-2,34,26.1,0,0,-1,2,-2,-2,-3,-1
"9901",2020-03-26,"Snodgrass","w1920","Non.motorized",NA,"Thu","weekday","no_sled","2","2","2",13.3,0,50,-1,36,26.6,-2,0,0,-1,-3,-3,-3,-4
"9902",2020-03-26,"Snodgrass","w1920","Non.motorized",NA,"Thu","weekday","no_sled","3","3","2",13.3,0,50,-1,36,26.6,-2,0,0,-1,-3,-3,-3,-4
"9903",2020-03-26,"Snodgrass","w1920","Mechanized",NA,"Thu","weekday","no_sled","2","2","2",13.3,0,50,-1,36,26.6,-2,0,0,-1,-3,-3,-3,-4
"9904",2020-03-26,"Snodgrass","w1920","Mechanized",NA,"Thu","weekday","no_sled","3","3","2",13.3,0,50,-1,36,26.6,-2,0,0,-1,-3,-3,-3,-4
"9905",2020-03-26,"Snodgrass","w1920","Motorized",NA,"Thu","weekday","sled","2","2","2",13.3,0,50,-1,36,26.6,-2,0,0,-1,-3,-3,-3,-4
"9906",2020-03-26,"Snodgrass","w1920","Motorized",NA,"Thu","weekday","sled","3","3","2",13.3,0,50,-1,36,26.6,-2,0,0,-1,-3,-3,-3,-4
"9907",2020-03-26,"Snodgrass","w1920","Hybrid",NA,"Thu","weekday","sled","2","2","2",13.3,0,50,-1,36,26.6,-2,0,0,-1,-3,-3,-3,-4
"9908",2020-03-26,"Snodgrass","w1920","Hybrid",NA,"Thu","weekday","sled","3","3","2",13.3,0,50,-1,36,26.6,-2,0,0,-1,-3,-3,-3,-4
"9909",2020-03-27,"Snodgrass","w1920","Non.motorized",NA,"Fri","weekday","no_sled","3","3","2",13.3,0,50,0,23,26.6,-1,-2,0,0,-1,-3,-3,-3
"9910",2020-03-27,"Snodgrass","w1920","Mechanized",NA,"Fri","weekday","no_sled","3","3","2",13.3,0,50,0,23,26.6,-1,-2,0,0,-1,-3,-3,-3
"9911",2020-03-27,"Snodgrass","w1920","Motorized",NA,"Fri","weekday","sled","3","3","2",13.3,0,50,0,23,26.6,-1,-2,0,0,-1,-3,-3,-3
"9912",2020-03-27,"Snodgrass","w1920","Hybrid",NA,"Fri","weekday","sled","3","3","2",13.3,0,50,0,23,26.6,-1,-2,0,0,-1,-3,-3,-3
"9913",2020-03-28,"Snodgrass","w1920","Non.motorized",NA,"Sat","weekend","no_sled","3","3","3",13.3,0,50,0,18,26.6,0,-1,-2,0,0,-1,-3,-3
"9914",2020-03-28,"Snodgrass","w1920","Mechanized",NA,"Sat","weekend","no_sled","3","3","3",13.3,0,50,0,18,26.6,0,-1,-2,0,0,-1,-3,-3
"9915",2020-03-28,"Snodgrass","w1920","Motorized",NA,"Sat","weekend","sled","3","3","3",13.3,0,50,0,18,26.6,0,-1,-2,0,0,-1,-3,-3
"9916",2020-03-28,"Snodgrass","w1920","Hybrid",NA,"Sat","weekend","sled","3","3","3",13.3,0,50,0,18,26.6,0,-1,-2,0,0,-1,-3,-3
"9917",2020-03-29,"Snodgrass","w1920","Non.motorized",NA,"Sun","weekend","no_sled","2","2","2",13.3,0,49,-1,24,27.1,0,0,-1,-2,-1,-1,-2,-4
"9918",2020-03-29,"Snodgrass","w1920","Mechanized",NA,"Sun","weekend","no_sled","2","2","2",13.3,0,49,-1,24,27.1,0,0,-1,-2,-1,-1,-2,-4
"9919",2020-03-29,"Snodgrass","w1920","Motorized",NA,"Sun","weekend","sled","2","2","2",13.3,0,49,-1,24,27.1,0,0,-1,-2,-1,-1,-2,-4
"9920",2020-03-29,"Snodgrass","w1920","Hybrid",NA,"Sun","weekend","sled","2","2","2",13.3,0,49,-1,24,27.1,0,0,-1,-2,-1,-1,-2,-4
"9921",2020-03-30,"Snodgrass","w1920","Non.motorized",NA,"Mon","weekday","no_sled","2","2","2",13.4,0.1,49,0,29,27.3,-1,0,0,-1,-1,-1,-1,-2
"9922",2020-03-30,"Snodgrass","w1920","Mechanized",NA,"Mon","weekday","no_sled","2","2","2",13.4,0.1,49,0,29,27.3,-1,0,0,-1,-1,-1,-1,-2
"9923",2020-03-30,"Snodgrass","w1920","Motorized",NA,"Mon","weekday","sled","2","2","2",13.4,0.1,49,0,29,27.3,-1,0,0,-1,-1,-1,-1,-2
"9924",2020-03-30,"Snodgrass","w1920","Hybrid",NA,"Mon","weekday","sled","2","2","2",13.4,0.1,49,0,29,27.3,-1,0,0,-1,-1,-1,-1,-2
"9925",2020-03-31,"Snodgrass","w1920","Non.motorized",NA,"Tue","weekday","no_sled","2","2","2",13.6,0.2,51,2,35,26.7,0,-1,0,0,2,1,1,1
"9926",2020-03-31,"Snodgrass","w1920","Mechanized",NA,"Tue","weekday","no_sled","2","2","2",13.6,0.2,51,2,35,26.7,0,-1,0,0,2,1,1,1
"9927",2020-03-31,"Snodgrass","w1920","Motorized",NA,"Tue","weekday","sled","2","2","2",13.6,0.2,51,2,35,26.7,0,-1,0,0,2,1,1,1
"9928",2020-03-31,"Snodgrass","w1920","Hybrid",NA,"Tue","weekday","sled","2","2","2",13.6,0.2,51,2,35,26.7,0,-1,0,0,2,1,1,1
"9929",2020-04-01,"Snodgrass","w1920","Non.motorized",NA,"Wed","weekday","no_sled","2","2","2",13.6,0,47,-4,39,28.9,2,0,-1,0,-2,-2,-3,-3
"9930",2020-04-01,"Snodgrass","w1920","Mechanized",NA,"Wed","weekday","no_sled","2","2","2",13.6,0,47,-4,39,28.9,2,0,-1,0,-2,-2,-3,-3
"9931",2020-04-01,"Snodgrass","w1920","Motorized",NA,"Wed","weekday","sled","2","2","2",13.6,0,47,-4,39,28.9,2,0,-1,0,-2,-2,-3,-3
"9932",2020-04-01,"Snodgrass","w1920","Hybrid",NA,"Wed","weekday","sled","2","2","2",13.6,0,47,-4,39,28.9,2,0,-1,0,-2,-2,-3,-3
"9933",2020-04-02,"Snodgrass","w1920","Non.motorized",NA,"Thu","weekday","no_sled","2","2","2",13.6,0,46,-1,31,29.6,-4,2,0,-1,-5,-3,-3,-4
"9934",2020-04-02,"Snodgrass","w1920","Mechanized",NA,"Thu","weekday","no_sled","2","2","2",13.6,0,46,-1,31,29.6,-4,2,0,-1,-5,-3,-3,-4
"9935",2020-04-02,"Snodgrass","w1920","Motorized",NA,"Thu","weekday","sled","2","2","2",13.6,0,46,-1,31,29.6,-4,2,0,-1,-5,-3,-3,-4
"9936",2020-04-02,"Snodgrass","w1920","Hybrid",NA,"Thu","weekday","sled","2","2","2",13.6,0,46,-1,31,29.6,-4,2,0,-1,-5,-3,-3,-4
"9937",2020-04-03,"Snodgrass","w1920","Non.motorized",NA,"Fri","weekday","no_sled","2","2","2",13.6,0,46,0,28,29.6,-1,-4,2,0,-1,-5,-3,-3
"9938",2020-04-03,"Snodgrass","w1920","Mechanized",NA,"Fri","weekday","no_sled","2","2","2",13.6,0,46,0,28,29.6,-1,-4,2,0,-1,-5,-3,-3
"9939",2020-04-03,"Snodgrass","w1920","Motorized",NA,"Fri","weekday","sled","2","2","2",13.6,0,46,0,28,29.6,-1,-4,2,0,-1,-5,-3,-3
"9940",2020-04-03,"Snodgrass","w1920","Hybrid",NA,"Fri","weekday","sled","2","2","2",13.6,0,46,0,28,29.6,-1,-4,2,0,-1,-5,-3,-3
"9941",2020-04-04,"Snodgrass","w1920","Non.motorized",NA,"Sat","weekend","no_sled","2","2","2",13.6,0,45,-1,33,30.2,0,-1,-4,2,-1,-2,-6,-4
"9942",2020-04-04,"Snodgrass","w1920","Mechanized",NA,"Sat","weekend","no_sled","2","2","2",13.6,0,45,-1,33,30.2,0,-1,-4,2,-1,-2,-6,-4
"9943",2020-04-04,"Snodgrass","w1920","Motorized",NA,"Sat","weekend","sled","2","2","2",13.6,0,45,-1,33,30.2,0,-1,-4,2,-1,-2,-6,-4
"9944",2020-04-04,"Snodgrass","w1920","Hybrid",NA,"Sat","weekend","sled","2","2","2",13.6,0,45,-1,33,30.2,0,-1,-4,2,-1,-2,-6,-4
"9945",2020-04-05,"Snodgrass","w1920","Non.motorized",NA,"Sun","weekend","no_sled","2","2","3",13.6,0,45,0,38,30.2,-1,0,-1,-4,-1,-1,-2,-6
"9946",2020-04-05,"Snodgrass","w1920","Mechanized",NA,"Sun","weekend","no_sled","2","2","3",13.6,0,45,0,38,30.2,-1,0,-1,-4,-1,-1,-2,-6
"9947",2020-04-05,"Snodgrass","w1920","Motorized",NA,"Sun","weekend","sled","2","2","3",13.6,0,45,0,38,30.2,-1,0,-1,-4,-1,-1,-2,-6
"9948",2020-04-05,"Snodgrass","w1920","Hybrid",NA,"Sun","weekend","sled","2","2","3",13.6,0,45,0,38,30.2,-1,0,-1,-4,-1,-1,-2,-6
"9949",2020-04-06,"Snodgrass","w1920","Non.motorized",NA,"Mon","weekday","no_sled","2","2","3",13.6,0,44,-1,40,30.9,0,-1,0,-1,-1,-2,-2,-3
"9950",2020-04-06,"Snodgrass","w1920","Mechanized",NA,"Mon","weekday","no_sled","2","2","3",13.6,0,44,-1,40,30.9,0,-1,0,-1,-1,-2,-2,-3
"9951",2020-04-06,"Snodgrass","w1920","Motorized",NA,"Mon","weekday","sled","2","2","3",13.6,0,44,-1,40,30.9,0,-1,0,-1,-1,-2,-2,-3
"9952",2020-04-06,"Snodgrass","w1920","Hybrid",NA,"Mon","weekday","sled","2","2","3",13.6,0,44,-1,40,30.9,0,-1,0,-1,-1,-2,-2,-3
"9953",2020-04-07,"Snodgrass","w1920","Non.motorized",NA,"Tue","weekday","no_sled","2","2","3",13.4,-0.2,43,-1,39,31.2,-1,0,-1,0,-2,-2,-3,-3
"9954",2020-04-07,"Snodgrass","w1920","Mechanized",NA,"Tue","weekday","no_sled","2","2","3",13.4,-0.2,43,-1,39,31.2,-1,0,-1,0,-2,-2,-3,-3
"9955",2020-04-07,"Snodgrass","w1920","Motorized",NA,"Tue","weekday","sled","2","2","3",13.4,-0.2,43,-1,39,31.2,-1,0,-1,0,-2,-2,-3,-3
"9956",2020-04-07,"Snodgrass","w1920","Hybrid",NA,"Tue","weekday","sled","2","2","3",13.4,-0.2,43,-1,39,31.2,-1,0,-1,0,-2,-2,-3,-3
"9957",2020-04-08,"Snodgrass","w1920","Non.motorized",NA,"Wed","weekday","no_sled","2","3","3",13.3,-0.1,42,-1,40,31.7,-1,-1,0,-1,-2,-3,-3,-4
"9958",2020-04-08,"Snodgrass","w1920","Mechanized",NA,"Wed","weekday","no_sled","2","3","3",13.3,-0.1,42,-1,40,31.7,-1,-1,0,-1,-2,-3,-3,-4
"9959",2020-04-08,"Snodgrass","w1920","Motorized",NA,"Wed","weekday","sled","2","3","3",13.3,-0.1,42,-1,40,31.7,-1,-1,0,-1,-2,-3,-3,-4
"9960",2020-04-08,"Snodgrass","w1920","Hybrid",NA,"Wed","weekday","sled","2","3","3",13.3,-0.1,42,-1,40,31.7,-1,-1,0,-1,-2,-3,-3,-4
"9961",2020-04-09,"Snodgrass","w1920","Non.motorized",NA,"Thu","weekday","no_sled","2","3","3",13.1,-0.2,40,-2,42,32.8,-1,-1,-1,0,-3,-4,-5,-5
"9962",2020-04-09,"Snodgrass","w1920","Mechanized",NA,"Thu","weekday","no_sled","2","3","3",13.1,-0.2,40,-2,42,32.8,-1,-1,-1,0,-3,-4,-5,-5
"9963",2020-04-09,"Snodgrass","w1920","Motorized",NA,"Thu","weekday","sled","2","3","3",13.1,-0.2,40,-2,42,32.8,-1,-1,-1,0,-3,-4,-5,-5
"9964",2020-04-09,"Snodgrass","w1920","Hybrid",NA,"Thu","weekday","sled","2","3","3",13.1,-0.2,40,-2,42,32.8,-1,-1,-1,0,-3,-4,-5,-5
"9965",2020-04-10,"Snodgrass","w1920","Non.motorized",NA,"Fri","weekday","no_sled","3","3","3",12.9,-0.2,39,-1,38,33.1,-2,-1,-1,-1,-3,-4,-5,-6
"9966",2020-04-10,"Snodgrass","w1920","Mechanized",NA,"Fri","weekday","no_sled","3","3","3",12.9,-0.2,39,-1,38,33.1,-2,-1,-1,-1,-3,-4,-5,-6
"9967",2020-04-10,"Snodgrass","w1920","Motorized",NA,"Fri","weekday","sled","3","3","3",12.9,-0.2,39,-1,38,33.1,-2,-1,-1,-1,-3,-4,-5,-6
"9968",2020-04-10,"Snodgrass","w1920","Hybrid",NA,"Fri","weekday","sled","3","3","3",12.9,-0.2,39,-1,38,33.1,-2,-1,-1,-1,-3,-4,-5,-6
"9969",2020-04-11,"Snodgrass","w1920","Non.motorized",NA,"Sat","weekend","no_sled","2","3","3",12.9,0,39,0,36,33.1,-1,-2,-1,-1,-1,-3,-4,-5
"9970",2020-04-11,"Snodgrass","w1920","Mechanized",NA,"Sat","weekend","no_sled","2","3","3",12.9,0,39,0,36,33.1,-1,-2,-1,-1,-1,-3,-4,-5
"9971",2020-04-11,"Snodgrass","w1920","Motorized",NA,"Sat","weekend","sled","2","3","3",12.9,0,39,0,36,33.1,-1,-2,-1,-1,-1,-3,-4,-5
"9972",2020-04-11,"Snodgrass","w1920","Hybrid",NA,"Sat","weekend","sled","2","3","3",12.9,0,39,0,36,33.1,-1,-2,-1,-1,-1,-3,-4,-5
"9973",2020-04-12,"Snodgrass","w1920","Non.motorized",NA,"Sun","weekend","no_sled","2","2","2",12.8,-0.1,38,-1,29,33.7,0,-1,-2,-1,-1,-2,-4,-5
"9974",2020-04-12,"Snodgrass","w1920","Mechanized",NA,"Sun","weekend","no_sled","2","2","2",12.8,-0.1,38,-1,29,33.7,0,-1,-2,-1,-1,-2,-4,-5
"9975",2020-04-12,"Snodgrass","w1920","Motorized",NA,"Sun","weekend","sled","2","2","2",12.8,-0.1,38,-1,29,33.7,0,-1,-2,-1,-1,-2,-4,-5
"9976",2020-04-12,"Snodgrass","w1920","Hybrid",NA,"Sun","weekend","sled","2","2","2",12.8,-0.1,38,-1,29,33.7,0,-1,-2,-1,-1,-2,-4,-5
"9977",2020-04-13,"Snodgrass","w1920","Non.motorized",NA,"Mon","weekday","no_sled",NA,NA,NA,12.9,0.1,39,1,20,33.1,-1,0,-1,-2,0,0,-1,-3
"9978",2020-04-13,"Snodgrass","w1920","Mechanized",NA,"Mon","weekday","no_sled",NA,NA,NA,12.9,0.1,39,1,20,33.1,-1,0,-1,-2,0,0,-1,-3
"9979",2020-04-13,"Snodgrass","w1920","Motorized",NA,"Mon","weekday","sled",NA,NA,NA,12.9,0.1,39,1,20,33.1,-1,0,-1,-2,0,0,-1,-3
"9980",2020-04-13,"Snodgrass","w1920","Hybrid",NA,"Mon","weekday","sled",NA,NA,NA,12.9,0.1,39,1,20,33.1,-1,0,-1,-2,0,0,-1,-3
"9981",2020-04-14,"Snodgrass","w1920","Non.motorized",NA,"Tue","weekday","no_sled","2","2","2",13,0.1,39,0,18,33.3,1,-1,0,-1,1,0,0,-1
"9982",2020-04-14,"Snodgrass","w1920","Mechanized",NA,"Tue","weekday","no_sled","2","2","2",13,0.1,39,0,18,33.3,1,-1,0,-1,1,0,0,-1
"9983",2020-04-14,"Snodgrass","w1920","Motorized",NA,"Tue","weekday","sled","2","2","2",13,0.1,39,0,18,33.3,1,-1,0,-1,1,0,0,-1
"9984",2020-04-14,"Snodgrass","w1920","Hybrid",NA,"Tue","weekday","sled","2","2","2",13,0.1,39,0,18,33.3,1,-1,0,-1,1,0,0,-1
"9985",2020-04-15,"Snodgrass","w1920","Non.motorized",NA,"Wed","weekday","no_sled",NA,NA,NA,13.2,0.2,39,0,28,33.8,0,1,-1,0,0,1,0,0
"9986",2020-04-15,"Snodgrass","w1920","Mechanized",NA,"Wed","weekday","no_sled",NA,NA,NA,13.2,0.2,39,0,28,33.8,0,1,-1,0,0,1,0,0
"9987",2020-04-15,"Snodgrass","w1920","Motorized",NA,"Wed","weekday","sled",NA,NA,NA,13.2,0.2,39,0,28,33.8,0,1,-1,0,0,1,0,0
"9988",2020-04-15,"Snodgrass","w1920","Hybrid",NA,"Wed","weekday","sled",NA,NA,NA,13.2,0.2,39,0,28,33.8,0,1,-1,0,0,1,0,0
"9989",2019-12-06,"Washington Gulch","w1920","Non.motorized",2,"Fri","weekday","no_sled","2","2","1",2.9,0.4,19,5,24,15.3,0,0,0,0,5,5,5,5
"9990",2019-12-06,"Washington Gulch","w1920","Mechanized",0,"Fri","weekday","no_sled","2","2","1",2.9,0.4,19,5,24,15.3,0,0,0,0,5,5,5,5
"9991",2019-12-06,"Washington Gulch","w1920","Motorized",1,"Fri","weekday","sled","2","2","1",2.9,0.4,19,5,24,15.3,0,0,0,0,5,5,5,5
"9992",2019-12-06,"Washington Gulch","w1920","Hybrid",0,"Fri","weekday","sled","2","2","1",2.9,0.4,19,5,24,15.3,0,0,0,0,5,5,5,5
"9993",2019-12-07,"Washington Gulch","w1920","Non.motorized",19,"Sat","weekend","no_sled","2","2","1",3,0.1,18,-1,29,16.7,5,0,0,0,4,4,4,4
"9994",2019-12-07,"Washington Gulch","w1920","Mechanized",0,"Sat","weekend","no_sled","2","2","1",3,0.1,18,-1,29,16.7,5,0,0,0,4,4,4,4
"9995",2019-12-07,"Washington Gulch","w1920","Motorized",9,"Sat","weekend","sled","2","2","1",3,0.1,18,-1,29,16.7,5,0,0,0,4,4,4,4
"9996",2019-12-07,"Washington Gulch","w1920","Hybrid",0,"Sat","weekend","sled","2","2","1",3,0.1,18,-1,29,16.7,5,0,0,0,4,4,4,4
"9997",2019-12-08,"Washington Gulch","w1920","Non.motorized",34,"Sun","weekend","no_sled","2","2","1",3,0,17,-1,28,17.6,-1,5,0,0,-2,3,3,3
"9998",2019-12-08,"Washington Gulch","w1920","Mechanized",0,"Sun","weekend","no_sled","2","2","1",3,0,17,-1,28,17.6,-1,5,0,0,-2,3,3,3
"9999",2019-12-08,"Washington Gulch","w1920","Motorized",4,"Sun","weekend","sled","2","2","1",3,0,17,-1,28,17.6,-1,5,0,0,-2,3,3,3
"10000",2019-12-08,"Washington Gulch","w1920","Hybrid",0,"Sun","weekend","sled","2","2","1",3,0,17,-1,28,17.6,-1,5,0,0,-2,3,3,3
"10001",2019-12-09,"Washington Gulch","w1920","Non.motorized",3,"Mon","weekday","no_sled","3","3","2",3.4,0.4,22,5,21,15.5,-1,-1,5,0,4,3,8,8
"10002",2019-12-09,"Washington Gulch","w1920","Mechanized",0,"Mon","weekday","no_sled","3","3","2",3.4,0.4,22,5,21,15.5,-1,-1,5,0,4,3,8,8
"10003",2019-12-09,"Washington Gulch","w1920","Motorized",3,"Mon","weekday","sled","3","3","2",3.4,0.4,22,5,21,15.5,-1,-1,5,0,4,3,8,8
"10004",2019-12-09,"Washington Gulch","w1920","Hybrid",0,"Mon","weekday","sled","3","3","2",3.4,0.4,22,5,21,15.5,-1,-1,5,0,4,3,8,8
"10005",2019-12-10,"Washington Gulch","w1920","Non.motorized",5,"Tue","weekday","no_sled","2","2","2",3.4,0,21,-1,19,16.2,5,-1,-1,5,4,3,2,7
"10006",2019-12-10,"Washington Gulch","w1920","Mechanized",0,"Tue","weekday","no_sled","2","2","2",3.4,0,21,-1,19,16.2,5,-1,-1,5,4,3,2,7
"10007",2019-12-10,"Washington Gulch","w1920","Motorized",0,"Tue","weekday","sled","2","2","2",3.4,0,21,-1,19,16.2,5,-1,-1,5,4,3,2,7
"10008",2019-12-10,"Washington Gulch","w1920","Hybrid",0,"Tue","weekday","sled","2","2","2",3.4,0,21,-1,19,16.2,5,-1,-1,5,4,3,2,7
"10009",2019-12-11,"Washington Gulch","w1920","Non.motorized",14,"Wed","weekday","no_sled","2","2","2",3.4,0,20,-1,22,17,-1,5,-1,-1,-2,3,2,1
"10010",2019-12-11,"Washington Gulch","w1920","Mechanized",1,"Wed","weekday","no_sled","2","2","2",3.4,0,20,-1,22,17,-1,5,-1,-1,-2,3,2,1
"10011",2019-12-11,"Washington Gulch","w1920","Motorized",3,"Wed","weekday","sled","2","2","2",3.4,0,20,-1,22,17,-1,5,-1,-1,-2,3,2,1
"10012",2019-12-11,"Washington Gulch","w1920","Hybrid",0,"Wed","weekday","sled","2","2","2",3.4,0,20,-1,22,17,-1,5,-1,-1,-2,3,2,1
"10013",2019-12-12,"Washington Gulch","w1920","Non.motorized",NA,"Thu","weekday","no_sled","2","2","2",3.4,0,19,-1,25,17.9,-1,-1,5,-1,-2,-3,2,1
"10014",2019-12-12,"Washington Gulch","w1920","Mechanized",NA,"Thu","weekday","no_sled","2","2","2",3.4,0,19,-1,25,17.9,-1,-1,5,-1,-2,-3,2,1
"10015",2019-12-12,"Washington Gulch","w1920","Motorized",NA,"Thu","weekday","sled","2","2","2",3.4,0,19,-1,25,17.9,-1,-1,5,-1,-2,-3,2,1
"10016",2019-12-12,"Washington Gulch","w1920","Hybrid",NA,"Thu","weekday","sled","2","2","2",3.4,0,19,-1,25,17.9,-1,-1,5,-1,-2,-3,2,1
"10017",2019-12-13,"Washington Gulch","w1920","Non.motorized",NA,"Fri","weekday","no_sled","2","2","2",3.8,0.4,21,2,24,18.1,-1,-1,-1,5,1,0,-1,4
"10018",2019-12-13,"Washington Gulch","w1920","Mechanized",NA,"Fri","weekday","no_sled","2","2","2",3.8,0.4,21,2,24,18.1,-1,-1,-1,5,1,0,-1,4
"10019",2019-12-13,"Washington Gulch","w1920","Motorized",NA,"Fri","weekday","sled","2","2","2",3.8,0.4,21,2,24,18.1,-1,-1,-1,5,1,0,-1,4
"10020",2019-12-13,"Washington Gulch","w1920","Hybrid",NA,"Fri","weekday","sled","2","2","2",3.8,0.4,21,2,24,18.1,-1,-1,-1,5,1,0,-1,4
"10021",2019-12-14,"Washington Gulch","w1920","Non.motorized",NA,"Sat","weekend","no_sled","3","3","3",4.2,0.4,27,6,25,15.6,2,-1,-1,-1,8,7,6,5
"10022",2019-12-14,"Washington Gulch","w1920","Mechanized",NA,"Sat","weekend","no_sled","3","3","3",4.2,0.4,27,6,25,15.6,2,-1,-1,-1,8,7,6,5
"10023",2019-12-14,"Washington Gulch","w1920","Motorized",NA,"Sat","weekend","sled","3","3","3",4.2,0.4,27,6,25,15.6,2,-1,-1,-1,8,7,6,5
"10024",2019-12-14,"Washington Gulch","w1920","Hybrid",NA,"Sat","weekend","sled","3","3","3",4.2,0.4,27,6,25,15.6,2,-1,-1,-1,8,7,6,5
"10025",2019-12-15,"Washington Gulch","w1920","Non.motorized",NA,"Sun","weekend","no_sled","3","3","2",4.8,0.6,31,4,17,15.5,6,2,-1,-1,10,12,11,10
"10026",2019-12-15,"Washington Gulch","w1920","Mechanized",NA,"Sun","weekend","no_sled","3","3","2",4.8,0.6,31,4,17,15.5,6,2,-1,-1,10,12,11,10
"10027",2019-12-15,"Washington Gulch","w1920","Motorized",NA,"Sun","weekend","sled","3","3","2",4.8,0.6,31,4,17,15.5,6,2,-1,-1,10,12,11,10
"10028",2019-12-15,"Washington Gulch","w1920","Hybrid",NA,"Sun","weekend","sled","3","3","2",4.8,0.6,31,4,17,15.5,6,2,-1,-1,10,12,11,10
"10029",2019-12-16,"Washington Gulch","w1920","Non.motorized",NA,"Mon","weekday","no_sled","3","3","2",4.8,0,29,-2,6,16.6,4,6,2,-1,2,8,10,9
"10030",2019-12-16,"Washington Gulch","w1920","Mechanized",NA,"Mon","weekday","no_sled","3","3","2",4.8,0,29,-2,6,16.6,4,6,2,-1,2,8,10,9
"10031",2019-12-16,"Washington Gulch","w1920","Motorized",NA,"Mon","weekday","sled","3","3","2",4.8,0,29,-2,6,16.6,4,6,2,-1,2,8,10,9
"10032",2019-12-16,"Washington Gulch","w1920","Hybrid",NA,"Mon","weekday","sled","3","3","2",4.8,0,29,-2,6,16.6,4,6,2,-1,2,8,10,9
"10033",2019-12-17,"Washington Gulch","w1920","Non.motorized",NA,"Tue","weekday","no_sled","2","2","1",4.8,0,27,-2,8,17.8,-2,4,6,2,-4,0,6,8
"10034",2019-12-17,"Washington Gulch","w1920","Mechanized",NA,"Tue","weekday","no_sled","2","2","1",4.8,0,27,-2,8,17.8,-2,4,6,2,-4,0,6,8
"10035",2019-12-17,"Washington Gulch","w1920","Motorized",NA,"Tue","weekday","sled","2","2","1",4.8,0,27,-2,8,17.8,-2,4,6,2,-4,0,6,8
"10036",2019-12-17,"Washington Gulch","w1920","Hybrid",NA,"Tue","weekday","sled","2","2","1",4.8,0,27,-2,8,17.8,-2,4,6,2,-4,0,6,8
"10037",2019-12-18,"Washington Gulch","w1920","Non.motorized",NA,"Wed","weekday","no_sled","2","2","1",4.8,0,26,-1,20,18.5,-2,-2,4,6,-3,-5,-1,5
"10038",2019-12-18,"Washington Gulch","w1920","Mechanized",NA,"Wed","weekday","no_sled","2","2","1",4.8,0,26,-1,20,18.5,-2,-2,4,6,-3,-5,-1,5
"10039",2019-12-18,"Washington Gulch","w1920","Motorized",NA,"Wed","weekday","sled","2","2","1",4.8,0,26,-1,20,18.5,-2,-2,4,6,-3,-5,-1,5
"10040",2019-12-18,"Washington Gulch","w1920","Hybrid",NA,"Wed","weekday","sled","2","2","1",4.8,0,26,-1,20,18.5,-2,-2,4,6,-3,-5,-1,5
"10041",2019-12-19,"Washington Gulch","w1920","Non.motorized",NA,"Thu","weekday","no_sled","2","2","1",4.9,0.1,25,-1,21,19.6,-1,-2,-2,4,-2,-4,-6,-2
"10042",2019-12-19,"Washington Gulch","w1920","Mechanized",NA,"Thu","weekday","no_sled","2","2","1",4.9,0.1,25,-1,21,19.6,-1,-2,-2,4,-2,-4,-6,-2
"10043",2019-12-19,"Washington Gulch","w1920","Motorized",NA,"Thu","weekday","sled","2","2","1",4.9,0.1,25,-1,21,19.6,-1,-2,-2,4,-2,-4,-6,-2
"10044",2019-12-19,"Washington Gulch","w1920","Hybrid",NA,"Thu","weekday","sled","2","2","1",4.9,0.1,25,-1,21,19.6,-1,-2,-2,4,-2,-4,-6,-2
"10045",2019-12-20,"Washington Gulch","w1920","Non.motorized",NA,"Fri","weekday","no_sled","2","2","1",4.9,0,24,-1,21,20.4,-1,-1,-2,-2,-2,-3,-5,-7
"10046",2019-12-20,"Washington Gulch","w1920","Mechanized",NA,"Fri","weekday","no_sled","2","2","1",4.9,0,24,-1,21,20.4,-1,-1,-2,-2,-2,-3,-5,-7
"10047",2019-12-20,"Washington Gulch","w1920","Motorized",NA,"Fri","weekday","sled","2","2","1",4.9,0,24,-1,21,20.4,-1,-1,-2,-2,-2,-3,-5,-7
"10048",2019-12-20,"Washington Gulch","w1920","Hybrid",NA,"Fri","weekday","sled","2","2","1",4.9,0,24,-1,21,20.4,-1,-1,-2,-2,-2,-3,-5,-7
"10049",2019-12-21,"Washington Gulch","w1920","Non.motorized",3,"Sat","weekend","no_sled","2","2","1",4.9,0,24,0,27,20.4,-1,-1,-1,-2,-1,-2,-3,-5
"10050",2019-12-21,"Washington Gulch","w1920","Mechanized",0,"Sat","weekend","no_sled","2","2","1",4.9,0,24,0,27,20.4,-1,-1,-1,-2,-1,-2,-3,-5
"10051",2019-12-21,"Washington Gulch","w1920","Motorized",0,"Sat","weekend","sled","2","2","1",4.9,0,24,0,27,20.4,-1,-1,-1,-2,-1,-2,-3,-5
"10052",2019-12-21,"Washington Gulch","w1920","Hybrid",0,"Sat","weekend","sled","2","2","1",4.9,0,24,0,27,20.4,-1,-1,-1,-2,-1,-2,-3,-5
"10053",2019-12-22,"Washington Gulch","w1920","Non.motorized",NA,"Sun","weekend","no_sled","2","2","1",5,0.1,23,-1,31,21.7,0,-1,-1,-1,-1,-2,-3,-4
"10054",2019-12-22,"Washington Gulch","w1920","Mechanized",NA,"Sun","weekend","no_sled","2","2","1",5,0.1,23,-1,31,21.7,0,-1,-1,-1,-1,-2,-3,-4
"10055",2019-12-22,"Washington Gulch","w1920","Motorized",NA,"Sun","weekend","sled","2","2","1",5,0.1,23,-1,31,21.7,0,-1,-1,-1,-1,-2,-3,-4
"10056",2019-12-22,"Washington Gulch","w1920","Hybrid",NA,"Sun","weekend","sled","2","2","1",5,0.1,23,-1,31,21.7,0,-1,-1,-1,-1,-2,-3,-4
"10057",2019-12-23,"Washington Gulch","w1920","Non.motorized",0,"Mon","weekday","no_sled","2","1","1",5,0,23,0,34,21.7,-1,0,-1,-1,-1,-1,-2,-3
"10058",2019-12-23,"Washington Gulch","w1920","Mechanized",0,"Mon","weekday","no_sled","2","1","1",5,0,23,0,34,21.7,-1,0,-1,-1,-1,-1,-2,-3
"10059",2019-12-23,"Washington Gulch","w1920","Motorized",0,"Mon","weekday","sled","2","1","1",5,0,23,0,34,21.7,-1,0,-1,-1,-1,-1,-2,-3
"10060",2019-12-23,"Washington Gulch","w1920","Hybrid",0,"Mon","weekday","sled","2","1","1",5,0,23,0,34,21.7,-1,0,-1,-1,-1,-1,-2,-3
"10061",2019-12-24,"Washington Gulch","w1920","Non.motorized",NA,"Tue","weekday","no_sled","2","1","1",5,0,22,-1,30,22.7,0,-1,0,-1,-1,-2,-2,-3
"10062",2019-12-24,"Washington Gulch","w1920","Mechanized",NA,"Tue","weekday","no_sled","2","1","1",5,0,22,-1,30,22.7,0,-1,0,-1,-1,-2,-2,-3
"10063",2019-12-24,"Washington Gulch","w1920","Motorized",NA,"Tue","weekday","sled","2","1","1",5,0,22,-1,30,22.7,0,-1,0,-1,-1,-2,-2,-3
"10064",2019-12-24,"Washington Gulch","w1920","Hybrid",NA,"Tue","weekday","sled","2","1","1",5,0,22,-1,30,22.7,0,-1,0,-1,-1,-2,-2,-3
"10065",2019-12-25,"Washington Gulch","w1920","Non.motorized",3,"Wed","weekday","no_sled","2","2","2",5,0,23,1,22,21.7,-1,0,-1,0,0,0,-1,-1
"10066",2019-12-25,"Washington Gulch","w1920","Mechanized",0,"Wed","weekday","no_sled","2","2","2",5,0,23,1,22,21.7,-1,0,-1,0,0,0,-1,-1
"10067",2019-12-25,"Washington Gulch","w1920","Motorized",0,"Wed","weekday","sled","2","2","2",5,0,23,1,22,21.7,-1,0,-1,0,0,0,-1,-1
"10068",2019-12-25,"Washington Gulch","w1920","Hybrid",0,"Wed","weekday","sled","2","2","2",5,0,23,1,22,21.7,-1,0,-1,0,0,0,-1,-1
"10069",2019-12-26,"Washington Gulch","w1920","Non.motorized",10,"Thu","weekday","no_sled","2","2","1",5,0,23,0,17,21.7,1,-1,0,-1,1,0,0,-1
"10070",2019-12-26,"Washington Gulch","w1920","Mechanized",0,"Thu","weekday","no_sled","2","2","1",5,0,23,0,17,21.7,1,-1,0,-1,1,0,0,-1
"10071",2019-12-26,"Washington Gulch","w1920","Motorized",0,"Thu","weekday","sled","2","2","1",5,0,23,0,17,21.7,1,-1,0,-1,1,0,0,-1
"10072",2019-12-26,"Washington Gulch","w1920","Hybrid",0,"Thu","weekday","sled","2","2","1",5,0,23,0,17,21.7,1,-1,0,-1,1,0,0,-1
"10073",2019-12-27,"Washington Gulch","w1920","Non.motorized",7,"Fri","weekday","no_sled","3","3","2",5.1,0.1,24,1,22,21.2,0,1,-1,0,1,2,1,1
"10074",2019-12-27,"Washington Gulch","w1920","Mechanized",0,"Fri","weekday","no_sled","3","3","2",5.1,0.1,24,1,22,21.2,0,1,-1,0,1,2,1,1
"10075",2019-12-27,"Washington Gulch","w1920","Motorized",0,"Fri","weekday","sled","3","3","2",5.1,0.1,24,1,22,21.2,0,1,-1,0,1,2,1,1
"10076",2019-12-27,"Washington Gulch","w1920","Hybrid",0,"Fri","weekday","sled","3","3","2",5.1,0.1,24,1,22,21.2,0,1,-1,0,1,2,1,1
"10077",2019-12-28,"Washington Gulch","w1920","Non.motorized",NA,"Sat","weekend","no_sled","3","3","2",5.6,0.5,30,6,16,18.7,1,0,1,-1,7,7,8,7
"10078",2019-12-28,"Washington Gulch","w1920","Mechanized",NA,"Sat","weekend","no_sled","3","3","2",5.6,0.5,30,6,16,18.7,1,0,1,-1,7,7,8,7
"10079",2019-12-28,"Washington Gulch","w1920","Motorized",NA,"Sat","weekend","sled","3","3","2",5.6,0.5,30,6,16,18.7,1,0,1,-1,7,7,8,7
"10080",2019-12-28,"Washington Gulch","w1920","Hybrid",NA,"Sat","weekend","sled","3","3","2",5.6,0.5,30,6,16,18.7,1,0,1,-1,7,7,8,7
"10081",2019-12-29,"Washington Gulch","w1920","Non.motorized",NA,"Sun","weekend","no_sled","3","3","2",5.6,0,29,-1,3,19.3,6,1,0,1,5,6,6,7
"10082",2019-12-29,"Washington Gulch","w1920","Mechanized",NA,"Sun","weekend","no_sled","3","3","2",5.6,0,29,-1,3,19.3,6,1,0,1,5,6,6,7
"10083",2019-12-29,"Washington Gulch","w1920","Motorized",NA,"Sun","weekend","sled","3","3","2",5.6,0,29,-1,3,19.3,6,1,0,1,5,6,6,7
"10084",2019-12-29,"Washington Gulch","w1920","Hybrid",NA,"Sun","weekend","sled","3","3","2",5.6,0,29,-1,3,19.3,6,1,0,1,5,6,6,7
"10085",2019-12-30,"Washington Gulch","w1920","Non.motorized",4,"Mon","weekday","no_sled","3","3","2",5.6,0,28,-1,3,20,-1,6,1,0,-2,4,5,5
"10086",2019-12-30,"Washington Gulch","w1920","Mechanized",0,"Mon","weekday","no_sled","3","3","2",5.6,0,28,-1,3,20,-1,6,1,0,-2,4,5,5
"10087",2019-12-30,"Washington Gulch","w1920","Motorized",1,"Mon","weekday","sled","3","3","2",5.6,0,28,-1,3,20,-1,6,1,0,-2,4,5,5
"10088",2019-12-30,"Washington Gulch","w1920","Hybrid",0,"Mon","weekday","sled","3","3","2",5.6,0,28,-1,3,20,-1,6,1,0,-2,4,5,5
"10089",2019-12-31,"Washington Gulch","w1920","Non.motorized",5,"Tue","weekday","no_sled","2","2","1",5.6,0,28,0,13,20,-1,-1,6,1,-1,-2,4,5
"10090",2019-12-31,"Washington Gulch","w1920","Mechanized",0,"Tue","weekday","no_sled","2","2","1",5.6,0,28,0,13,20,-1,-1,6,1,-1,-2,4,5
"10091",2019-12-31,"Washington Gulch","w1920","Motorized",2,"Tue","weekday","sled","2","2","1",5.6,0,28,0,13,20,-1,-1,6,1,-1,-2,4,5
"10092",2019-12-31,"Washington Gulch","w1920","Hybrid",0,"Tue","weekday","sled","2","2","1",5.6,0,28,0,13,20,-1,-1,6,1,-1,-2,4,5
"10093",2020-01-01,"Washington Gulch","w1920","Non.motorized",NA,"Wed","weekday","no_sled","2","1","1",5.6,0,27,-1,21,20.7,0,-1,-1,6,-1,-2,-3,3
"10094",2020-01-01,"Washington Gulch","w1920","Mechanized",NA,"Wed","weekday","no_sled","2","1","1",5.6,0,27,-1,21,20.7,0,-1,-1,6,-1,-2,-3,3
"10095",2020-01-01,"Washington Gulch","w1920","Motorized",NA,"Wed","weekday","sled","2","1","1",5.6,0,27,-1,21,20.7,0,-1,-1,6,-1,-2,-3,3
"10096",2020-01-01,"Washington Gulch","w1920","Hybrid",NA,"Wed","weekday","sled","2","1","1",5.6,0,27,-1,21,20.7,0,-1,-1,6,-1,-2,-3,3
"10097",2020-01-02,"Washington Gulch","w1920","Non.motorized",NA,"Thu","weekday","no_sled","3","3","2",5.9,0.3,29,2,16,20.3,-1,0,-1,-1,1,1,0,-1
"10098",2020-01-02,"Washington Gulch","w1920","Mechanized",NA,"Thu","weekday","no_sled","3","3","2",5.9,0.3,29,2,16,20.3,-1,0,-1,-1,1,1,0,-1
"10099",2020-01-02,"Washington Gulch","w1920","Motorized",NA,"Thu","weekday","sled","3","3","2",5.9,0.3,29,2,16,20.3,-1,0,-1,-1,1,1,0,-1
"10100",2020-01-02,"Washington Gulch","w1920","Hybrid",NA,"Thu","weekday","sled","3","3","2",5.9,0.3,29,2,16,20.3,-1,0,-1,-1,1,1,0,-1
"10101",2020-01-03,"Washington Gulch","w1920","Non.motorized",NA,"Fri","weekday","no_sled","3","2","1",5.9,0,31,2,19,19,2,-1,0,-1,4,3,3,2
"10102",2020-01-03,"Washington Gulch","w1920","Mechanized",NA,"Fri","weekday","no_sled","3","2","1",5.9,0,31,2,19,19,2,-1,0,-1,4,3,3,2
"10103",2020-01-03,"Washington Gulch","w1920","Motorized",NA,"Fri","weekday","sled","3","2","1",5.9,0,31,2,19,19,2,-1,0,-1,4,3,3,2
"10104",2020-01-03,"Washington Gulch","w1920","Hybrid",NA,"Fri","weekday","sled","3","2","1",5.9,0,31,2,19,19,2,-1,0,-1,4,3,3,2
"10105",2020-01-04,"Washington Gulch","w1920","Non.motorized",2,"Sat","weekend","no_sled","2","2","1",5.9,0,30,-1,26,19.7,2,2,-1,0,1,3,2,2
"10106",2020-01-04,"Washington Gulch","w1920","Mechanized",0,"Sat","weekend","no_sled","2","2","1",5.9,0,30,-1,26,19.7,2,2,-1,0,1,3,2,2
"10107",2020-01-04,"Washington Gulch","w1920","Motorized",0,"Sat","weekend","sled","2","2","1",5.9,0,30,-1,26,19.7,2,2,-1,0,1,3,2,2
"10108",2020-01-04,"Washington Gulch","w1920","Hybrid",0,"Sat","weekend","sled","2","2","1",5.9,0,30,-1,26,19.7,2,2,-1,0,1,3,2,2
"10109",2020-01-05,"Washington Gulch","w1920","Non.motorized",2,"Sun","weekend","no_sled","2","2","1",5.9,0,28,-2,23,21.1,-1,2,2,-1,-3,-1,1,0
"10110",2020-01-05,"Washington Gulch","w1920","Mechanized",0,"Sun","weekend","no_sled","2","2","1",5.9,0,28,-2,23,21.1,-1,2,2,-1,-3,-1,1,0
"10111",2020-01-05,"Washington Gulch","w1920","Motorized",0,"Sun","weekend","sled","2","2","1",5.9,0,28,-2,23,21.1,-1,2,2,-1,-3,-1,1,0
"10112",2020-01-05,"Washington Gulch","w1920","Hybrid",0,"Sun","weekend","sled","2","2","1",5.9,0,28,-2,23,21.1,-1,2,2,-1,-3,-1,1,0
"10113",2020-01-06,"Washington Gulch","w1920","Non.motorized",NA,"Mon","weekday","no_sled","2","2","1",5.9,0,28,0,15,21.1,-2,-1,2,2,-2,-3,-1,1
"10114",2020-01-06,"Washington Gulch","w1920","Mechanized",NA,"Mon","weekday","no_sled","2","2","1",5.9,0,28,0,15,21.1,-2,-1,2,2,-2,-3,-1,1
"10115",2020-01-06,"Washington Gulch","w1920","Motorized",NA,"Mon","weekday","sled","2","2","1",5.9,0,28,0,15,21.1,-2,-1,2,2,-2,-3,-1,1
"10116",2020-01-06,"Washington Gulch","w1920","Hybrid",NA,"Mon","weekday","sled","2","2","1",5.9,0,28,0,15,21.1,-2,-1,2,2,-2,-3,-1,1
"10117",2020-01-07,"Washington Gulch","w1920","Non.motorized",1,"Tue","weekday","no_sled","2","1","1",5.9,0,28,0,22,21.1,0,-2,-1,2,0,-2,-3,-1
"10118",2020-01-07,"Washington Gulch","w1920","Mechanized",0,"Tue","weekday","no_sled","2","1","1",5.9,0,28,0,22,21.1,0,-2,-1,2,0,-2,-3,-1
"10119",2020-01-07,"Washington Gulch","w1920","Motorized",0,"Tue","weekday","sled","2","1","1",5.9,0,28,0,22,21.1,0,-2,-1,2,0,-2,-3,-1
"10120",2020-01-07,"Washington Gulch","w1920","Hybrid",0,"Tue","weekday","sled","2","1","1",5.9,0,28,0,22,21.1,0,-2,-1,2,0,-2,-3,-1
"10121",2020-01-08,"Washington Gulch","w1920","Non.motorized",3,"Wed","weekday","no_sled","2","1","1",6,0.1,28,0,23,21.4,0,0,-2,-1,0,0,-2,-3
"10122",2020-01-08,"Washington Gulch","w1920","Mechanized",0,"Wed","weekday","no_sled","2","1","1",6,0.1,28,0,23,21.4,0,0,-2,-1,0,0,-2,-3
"10123",2020-01-08,"Washington Gulch","w1920","Motorized",0,"Wed","weekday","sled","2","1","1",6,0.1,28,0,23,21.4,0,0,-2,-1,0,0,-2,-3
"10124",2020-01-08,"Washington Gulch","w1920","Hybrid",0,"Wed","weekday","sled","2","1","1",6,0.1,28,0,23,21.4,0,0,-2,-1,0,0,-2,-3
"10125",2020-01-09,"Washington Gulch","w1920","Non.motorized",NA,"Thu","weekday","no_sled","2","1","1",6,0,27,-1,17,22.2,0,0,0,-2,-1,-1,-1,-3
"10126",2020-01-09,"Washington Gulch","w1920","Mechanized",NA,"Thu","weekday","no_sled","2","1","1",6,0,27,-1,17,22.2,0,0,0,-2,-1,-1,-1,-3
"10127",2020-01-09,"Washington Gulch","w1920","Motorized",NA,"Thu","weekday","sled","2","1","1",6,0,27,-1,17,22.2,0,0,0,-2,-1,-1,-1,-3
"10128",2020-01-09,"Washington Gulch","w1920","Hybrid",NA,"Thu","weekday","sled","2","1","1",6,0,27,-1,17,22.2,0,0,0,-2,-1,-1,-1,-3
"10129",2020-01-10,"Washington Gulch","w1920","Non.motorized",1,"Fri","weekday","no_sled","2","1","1",6,0,29,2,11,20.7,-1,0,0,0,1,1,1,1
"10130",2020-01-10,"Washington Gulch","w1920","Mechanized",0,"Fri","weekday","no_sled","2","1","1",6,0,29,2,11,20.7,-1,0,0,0,1,1,1,1
"10131",2020-01-10,"Washington Gulch","w1920","Motorized",0,"Fri","weekday","sled","2","1","1",6,0,29,2,11,20.7,-1,0,0,0,1,1,1,1
"10132",2020-01-10,"Washington Gulch","w1920","Hybrid",0,"Fri","weekday","sled","2","1","1",6,0,29,2,11,20.7,-1,0,0,0,1,1,1,1
"10133",2020-01-11,"Washington Gulch","w1920","Non.motorized",1,"Sat","weekend","no_sled","2","1","1",6,0,29,0,12,20.7,2,-1,0,0,2,1,1,1
"10134",2020-01-11,"Washington Gulch","w1920","Mechanized",0,"Sat","weekend","no_sled","2","1","1",6,0,29,0,12,20.7,2,-1,0,0,2,1,1,1
"10135",2020-01-11,"Washington Gulch","w1920","Motorized",0,"Sat","weekend","sled","2","1","1",6,0,29,0,12,20.7,2,-1,0,0,2,1,1,1
"10136",2020-01-11,"Washington Gulch","w1920","Hybrid",0,"Sat","weekend","sled","2","1","1",6,0,29,0,12,20.7,2,-1,0,0,2,1,1,1
"10137",2020-01-12,"Washington Gulch","w1920","Non.motorized",NA,"Sun","weekend","no_sled","2","1","1",6.1,0.1,29,0,13,21,0,2,-1,0,0,2,1,1
"10138",2020-01-12,"Washington Gulch","w1920","Mechanized",NA,"Sun","weekend","no_sled","2","1","1",6.1,0.1,29,0,13,21,0,2,-1,0,0,2,1,1
"10139",2020-01-12,"Washington Gulch","w1920","Motorized",NA,"Sun","weekend","sled","2","1","1",6.1,0.1,29,0,13,21,0,2,-1,0,0,2,1,1
"10140",2020-01-12,"Washington Gulch","w1920","Hybrid",NA,"Sun","weekend","sled","2","1","1",6.1,0.1,29,0,13,21,0,2,-1,0,0,2,1,1
"10141",2020-01-13,"Washington Gulch","w1920","Non.motorized",NA,"Mon","weekday","no_sled","2","2","1",6.2,0.1,29,0,16,21.4,0,0,2,-1,0,0,2,1
"10142",2020-01-13,"Washington Gulch","w1920","Mechanized",NA,"Mon","weekday","no_sled","2","2","1",6.2,0.1,29,0,16,21.4,0,0,2,-1,0,0,2,1
"10143",2020-01-13,"Washington Gulch","w1920","Motorized",NA,"Mon","weekday","sled","2","2","1",6.2,0.1,29,0,16,21.4,0,0,2,-1,0,0,2,1
"10144",2020-01-13,"Washington Gulch","w1920","Hybrid",NA,"Mon","weekday","sled","2","2","1",6.2,0.1,29,0,16,21.4,0,0,2,-1,0,0,2,1
"10145",2020-01-14,"Washington Gulch","w1920","Non.motorized",NA,"Tue","weekday","no_sled","3","2","1",6.6,0.4,34,5,23,19.4,0,0,0,2,5,5,5,7
"10146",2020-01-14,"Washington Gulch","w1920","Mechanized",NA,"Tue","weekday","no_sled","3","2","1",6.6,0.4,34,5,23,19.4,0,0,0,2,5,5,5,7
"10147",2020-01-14,"Washington Gulch","w1920","Motorized",NA,"Tue","weekday","sled","3","2","1",6.6,0.4,34,5,23,19.4,0,0,0,2,5,5,5,7
"10148",2020-01-14,"Washington Gulch","w1920","Hybrid",NA,"Tue","weekday","sled","3","2","1",6.6,0.4,34,5,23,19.4,0,0,0,2,5,5,5,7
"10149",2020-01-15,"Washington Gulch","w1920","Non.motorized",NA,"Wed","weekday","no_sled","3","2","1",6.7,0.1,32,-2,23,20.9,5,0,0,0,3,3,3,3
"10150",2020-01-15,"Washington Gulch","w1920","Mechanized",NA,"Wed","weekday","no_sled","3","2","1",6.7,0.1,32,-2,23,20.9,5,0,0,0,3,3,3,3
"10151",2020-01-15,"Washington Gulch","w1920","Motorized",NA,"Wed","weekday","sled","3","2","1",6.7,0.1,32,-2,23,20.9,5,0,0,0,3,3,3,3
"10152",2020-01-15,"Washington Gulch","w1920","Hybrid",NA,"Wed","weekday","sled","3","2","1",6.7,0.1,32,-2,23,20.9,5,0,0,0,3,3,3,3
"10153",2020-01-16,"Washington Gulch","w1920","Non.motorized",NA,"Thu","weekday","no_sled","2","2","1",6.7,0,31,-1,28,21.6,-2,5,0,0,-3,2,2,2
"10154",2020-01-16,"Washington Gulch","w1920","Mechanized",NA,"Thu","weekday","no_sled","2","2","1",6.7,0,31,-1,28,21.6,-2,5,0,0,-3,2,2,2
"10155",2020-01-16,"Washington Gulch","w1920","Motorized",NA,"Thu","weekday","sled","2","2","1",6.7,0,31,-1,28,21.6,-2,5,0,0,-3,2,2,2
"10156",2020-01-16,"Washington Gulch","w1920","Hybrid",NA,"Thu","weekday","sled","2","2","1",6.7,0,31,-1,28,21.6,-2,5,0,0,-3,2,2,2
"10157",2020-01-17,"Washington Gulch","w1920","Non.motorized",NA,"Fri","weekday","no_sled","2","2","1",6.8,0.1,29,-2,19,23.4,-1,-2,5,0,-3,-5,0,0
"10158",2020-01-17,"Washington Gulch","w1920","Mechanized",NA,"Fri","weekday","no_sled","2","2","1",6.8,0.1,29,-2,19,23.4,-1,-2,5,0,-3,-5,0,0
"10159",2020-01-17,"Washington Gulch","w1920","Motorized",NA,"Fri","weekday","sled","2","2","1",6.8,0.1,29,-2,19,23.4,-1,-2,5,0,-3,-5,0,0
"10160",2020-01-17,"Washington Gulch","w1920","Hybrid",NA,"Fri","weekday","sled","2","2","1",6.8,0.1,29,-2,19,23.4,-1,-2,5,0,-3,-5,0,0
"10161",2020-01-18,"Washington Gulch","w1920","Non.motorized",NA,"Sat","weekend","no_sled","2","2","2",7,0.2,34,5,16,20.6,-2,-1,-2,5,3,2,0,5
"10162",2020-01-18,"Washington Gulch","w1920","Mechanized",NA,"Sat","weekend","no_sled","2","2","2",7,0.2,34,5,16,20.6,-2,-1,-2,5,3,2,0,5
"10163",2020-01-18,"Washington Gulch","w1920","Motorized",NA,"Sat","weekend","sled","2","2","2",7,0.2,34,5,16,20.6,-2,-1,-2,5,3,2,0,5
"10164",2020-01-18,"Washington Gulch","w1920","Hybrid",NA,"Sat","weekend","sled","2","2","2",7,0.2,34,5,16,20.6,-2,-1,-2,5,3,2,0,5
"10165",2020-01-19,"Washington Gulch","w1920","Non.motorized",NA,"Sun","weekend","no_sled","2","2","1",7,0,33,-1,21,21.2,5,-2,-1,-2,4,2,1,-1
"10166",2020-01-19,"Washington Gulch","w1920","Mechanized",NA,"Sun","weekend","no_sled","2","2","1",7,0,33,-1,21,21.2,5,-2,-1,-2,4,2,1,-1
"10167",2020-01-19,"Washington Gulch","w1920","Motorized",NA,"Sun","weekend","sled","2","2","1",7,0,33,-1,21,21.2,5,-2,-1,-2,4,2,1,-1
"10168",2020-01-19,"Washington Gulch","w1920","Hybrid",NA,"Sun","weekend","sled","2","2","1",7,0,33,-1,21,21.2,5,-2,-1,-2,4,2,1,-1
"10169",2020-01-20,"Washington Gulch","w1920","Non.motorized",NA,"Mon","weekday","no_sled","2","2","1",7.1,0.1,32,-1,25,22.2,-1,5,-2,-1,-2,3,1,0
"10170",2020-01-20,"Washington Gulch","w1920","Mechanized",NA,"Mon","weekday","no_sled","2","2","1",7.1,0.1,32,-1,25,22.2,-1,5,-2,-1,-2,3,1,0
"10171",2020-01-20,"Washington Gulch","w1920","Motorized",NA,"Mon","weekday","sled","2","2","1",7.1,0.1,32,-1,25,22.2,-1,5,-2,-1,-2,3,1,0
"10172",2020-01-20,"Washington Gulch","w1920","Hybrid",NA,"Mon","weekday","sled","2","2","1",7.1,0.1,32,-1,25,22.2,-1,5,-2,-1,-2,3,1,0
"10173",2020-01-21,"Washington Gulch","w1920","Non.motorized",NA,"Tue","weekday","no_sled","2","2","1",7.1,0,31,-1,28,22.9,-1,-1,5,-2,-2,-3,2,0
"10174",2020-01-21,"Washington Gulch","w1920","Mechanized",NA,"Tue","weekday","no_sled","2","2","1",7.1,0,31,-1,28,22.9,-1,-1,5,-2,-2,-3,2,0
"10175",2020-01-21,"Washington Gulch","w1920","Motorized",NA,"Tue","weekday","sled","2","2","1",7.1,0,31,-1,28,22.9,-1,-1,5,-2,-2,-3,2,0
"10176",2020-01-21,"Washington Gulch","w1920","Hybrid",NA,"Tue","weekday","sled","2","2","1",7.1,0,31,-1,28,22.9,-1,-1,5,-2,-2,-3,2,0
"10177",2020-01-22,"Washington Gulch","w1920","Non.motorized",NA,"Wed","weekday","no_sled","2","2","2",7.3,0.2,32,1,25,22.8,-1,-1,-1,5,0,-1,-2,3
"10178",2020-01-22,"Washington Gulch","w1920","Mechanized",NA,"Wed","weekday","no_sled","2","2","2",7.3,0.2,32,1,25,22.8,-1,-1,-1,5,0,-1,-2,3
"10179",2020-01-22,"Washington Gulch","w1920","Motorized",NA,"Wed","weekday","sled","2","2","2",7.3,0.2,32,1,25,22.8,-1,-1,-1,5,0,-1,-2,3
"10180",2020-01-22,"Washington Gulch","w1920","Hybrid",NA,"Wed","weekday","sled","2","2","2",7.3,0.2,32,1,25,22.8,-1,-1,-1,5,0,-1,-2,3
"10181",2020-01-23,"Washington Gulch","w1920","Non.motorized",NA,"Thu","weekday","no_sled","3","2","2",7.3,0,34,2,23,21.5,1,-1,-1,-1,3,2,1,0
"10182",2020-01-23,"Washington Gulch","w1920","Mechanized",NA,"Thu","weekday","no_sled","3","2","2",7.3,0,34,2,23,21.5,1,-1,-1,-1,3,2,1,0
"10183",2020-01-23,"Washington Gulch","w1920","Motorized",NA,"Thu","weekday","sled","3","2","2",7.3,0,34,2,23,21.5,1,-1,-1,-1,3,2,1,0
"10184",2020-01-23,"Washington Gulch","w1920","Hybrid",NA,"Thu","weekday","sled","3","2","2",7.3,0,34,2,23,21.5,1,-1,-1,-1,3,2,1,0
"10185",2020-01-24,"Washington Gulch","w1920","Non.motorized",NA,"Fri","weekday","no_sled","2","2","1",7.3,0,33,-1,23,22.1,2,1,-1,-1,1,2,1,0
"10186",2020-01-24,"Washington Gulch","w1920","Mechanized",NA,"Fri","weekday","no_sled","2","2","1",7.3,0,33,-1,23,22.1,2,1,-1,-1,1,2,1,0
"10187",2020-01-24,"Washington Gulch","w1920","Motorized",NA,"Fri","weekday","sled","2","2","1",7.3,0,33,-1,23,22.1,2,1,-1,-1,1,2,1,0
"10188",2020-01-24,"Washington Gulch","w1920","Hybrid",NA,"Fri","weekday","sled","2","2","1",7.3,0,33,-1,23,22.1,2,1,-1,-1,1,2,1,0
"10189",2020-01-25,"Washington Gulch","w1920","Non.motorized",NA,"Sat","weekend","no_sled","2","2","1",7.4,0.1,32,-1,25,23.1,-1,2,1,-1,-2,0,1,0
"10190",2020-01-25,"Washington Gulch","w1920","Mechanized",NA,"Sat","weekend","no_sled","2","2","1",7.4,0.1,32,-1,25,23.1,-1,2,1,-1,-2,0,1,0
"10191",2020-01-25,"Washington Gulch","w1920","Motorized",NA,"Sat","weekend","sled","2","2","1",7.4,0.1,32,-1,25,23.1,-1,2,1,-1,-2,0,1,0
"10192",2020-01-25,"Washington Gulch","w1920","Hybrid",NA,"Sat","weekend","sled","2","2","1",7.4,0.1,32,-1,25,23.1,-1,2,1,-1,-2,0,1,0
"10193",2020-01-26,"Washington Gulch","w1920","Non.motorized",NA,"Sun","weekend","no_sled","2","1","1",7.4,0,32,0,28,23.1,-1,-1,2,1,-1,-2,0,1
"10194",2020-01-26,"Washington Gulch","w1920","Mechanized",NA,"Sun","weekend","no_sled","2","1","1",7.4,0,32,0,28,23.1,-1,-1,2,1,-1,-2,0,1
"10195",2020-01-26,"Washington Gulch","w1920","Motorized",NA,"Sun","weekend","sled","2","1","1",7.4,0,32,0,28,23.1,-1,-1,2,1,-1,-2,0,1
"10196",2020-01-26,"Washington Gulch","w1920","Hybrid",NA,"Sun","weekend","sled","2","1","1",7.4,0,32,0,28,23.1,-1,-1,2,1,-1,-2,0,1
"10197",2020-01-27,"Washington Gulch","w1920","Non.motorized",NA,"Mon","weekday","no_sled","2","1","1",7.4,0,32,0,24,23.1,0,-1,-1,2,0,-1,-2,0
"10198",2020-01-27,"Washington Gulch","w1920","Mechanized",NA,"Mon","weekday","no_sled","2","1","1",7.4,0,32,0,24,23.1,0,-1,-1,2,0,-1,-2,0
"10199",2020-01-27,"Washington Gulch","w1920","Motorized",NA,"Mon","weekday","sled","2","1","1",7.4,0,32,0,24,23.1,0,-1,-1,2,0,-1,-2,0
"10200",2020-01-27,"Washington Gulch","w1920","Hybrid",NA,"Mon","weekday","sled","2","1","1",7.4,0,32,0,24,23.1,0,-1,-1,2,0,-1,-2,0
"10201",2020-01-28,"Washington Gulch","w1920","Non.motorized",NA,"Tue","weekday","no_sled","3","2","2",7.4,0,32,0,19,23.1,0,0,-1,-1,0,0,-1,-2
"10202",2020-01-28,"Washington Gulch","w1920","Mechanized",NA,"Tue","weekday","no_sled","3","2","2",7.4,0,32,0,19,23.1,0,0,-1,-1,0,0,-1,-2
"10203",2020-01-28,"Washington Gulch","w1920","Motorized",NA,"Tue","weekday","sled","3","2","2",7.4,0,32,0,19,23.1,0,0,-1,-1,0,0,-1,-2
"10204",2020-01-28,"Washington Gulch","w1920","Hybrid",NA,"Tue","weekday","sled","3","2","2",7.4,0,32,0,19,23.1,0,0,-1,-1,0,0,-1,-2
"10205",2020-01-29,"Washington Gulch","w1920","Non.motorized",NA,"Wed","weekday","no_sled","2","2","1",7.4,0,31,-1,20,23.9,0,0,0,-1,-1,-1,-1,-2
"10206",2020-01-29,"Washington Gulch","w1920","Mechanized",NA,"Wed","weekday","no_sled","2","2","1",7.4,0,31,-1,20,23.9,0,0,0,-1,-1,-1,-1,-2
"10207",2020-01-29,"Washington Gulch","w1920","Motorized",NA,"Wed","weekday","sled","2","2","1",7.4,0,31,-1,20,23.9,0,0,0,-1,-1,-1,-1,-2
"10208",2020-01-29,"Washington Gulch","w1920","Hybrid",NA,"Wed","weekday","sled","2","2","1",7.4,0,31,-1,20,23.9,0,0,0,-1,-1,-1,-1,-2
"10209",2020-01-30,"Washington Gulch","w1920","Non.motorized",2,"Thu","weekday","no_sled","2","2","1",7.4,0,31,0,17,23.9,-1,0,0,0,-1,-1,-1,-1
"10210",2020-01-30,"Washington Gulch","w1920","Mechanized",0,"Thu","weekday","no_sled","2","2","1",7.4,0,31,0,17,23.9,-1,0,0,0,-1,-1,-1,-1
"10211",2020-01-30,"Washington Gulch","w1920","Motorized",3,"Thu","weekday","sled","2","2","1",7.4,0,31,0,17,23.9,-1,0,0,0,-1,-1,-1,-1
"10212",2020-01-30,"Washington Gulch","w1920","Hybrid",0,"Thu","weekday","sled","2","2","1",7.4,0,31,0,17,23.9,-1,0,0,0,-1,-1,-1,-1
"10213",2020-01-31,"Washington Gulch","w1920","Non.motorized",25,"Fri","weekday","no_sled","2","1","1",7.4,0,31,0,20,23.9,0,-1,0,0,0,-1,-1,-1
"10214",2020-01-31,"Washington Gulch","w1920","Mechanized",0,"Fri","weekday","no_sled","2","1","1",7.4,0,31,0,20,23.9,0,-1,0,0,0,-1,-1,-1
"10215",2020-01-31,"Washington Gulch","w1920","Motorized",2,"Fri","weekday","sled","2","1","1",7.4,0,31,0,20,23.9,0,-1,0,0,0,-1,-1,-1
"10216",2020-01-31,"Washington Gulch","w1920","Hybrid",0,"Fri","weekday","sled","2","1","1",7.4,0,31,0,20,23.9,0,-1,0,0,0,-1,-1,-1
"10217",2020-02-01,"Washington Gulch","w1920","Non.motorized",45,"Sat","weekend","no_sled","2","1","1",7.4,0,31,0,28,23.9,0,0,-1,0,0,0,-1,-1
"10218",2020-02-01,"Washington Gulch","w1920","Mechanized",0,"Sat","weekend","no_sled","2","1","1",7.4,0,31,0,28,23.9,0,0,-1,0,0,0,-1,-1
"10219",2020-02-01,"Washington Gulch","w1920","Motorized",23,"Sat","weekend","sled","2","1","1",7.4,0,31,0,28,23.9,0,0,-1,0,0,0,-1,-1
"10220",2020-02-01,"Washington Gulch","w1920","Hybrid",0,"Sat","weekend","sled","2","1","1",7.4,0,31,0,28,23.9,0,0,-1,0,0,0,-1,-1
"10221",2020-02-02,"Washington Gulch","w1920","Non.motorized",73,"Sun","weekend","no_sled","1","1","1",7.4,0,31,0,33,23.9,0,0,0,-1,0,0,0,-1
"10222",2020-02-02,"Washington Gulch","w1920","Mechanized",1,"Sun","weekend","no_sled","1","1","1",7.4,0,31,0,33,23.9,0,0,0,-1,0,0,0,-1
"10223",2020-02-02,"Washington Gulch","w1920","Motorized",5,"Sun","weekend","sled","1","1","1",7.4,0,31,0,33,23.9,0,0,0,-1,0,0,0,-1
"10224",2020-02-02,"Washington Gulch","w1920","Hybrid",0,"Sun","weekend","sled","1","1","1",7.4,0,31,0,33,23.9,0,0,0,-1,0,0,0,-1
"10225",2020-02-03,"Washington Gulch","w1920","Non.motorized",13,"Mon","weekday","no_sled","2","2","1",7.4,0,31,0,24,23.9,0,0,0,0,0,0,0,0
"10226",2020-02-03,"Washington Gulch","w1920","Mechanized",0,"Mon","weekday","no_sled","2","2","1",7.4,0,31,0,24,23.9,0,0,0,0,0,0,0,0
"10227",2020-02-03,"Washington Gulch","w1920","Motorized",0,"Mon","weekday","sled","2","2","1",7.4,0,31,0,24,23.9,0,0,0,0,0,0,0,0
"10228",2020-02-03,"Washington Gulch","w1920","Hybrid",0,"Mon","weekday","sled","2","2","1",7.4,0,31,0,24,23.9,0,0,0,0,0,0,0,0
"10229",2020-02-04,"Washington Gulch","w1920","Non.motorized",13,"Tue","weekday","no_sled","2","2","2",7.4,0,33,2,5,22.4,0,0,0,0,2,2,2,2
"10230",2020-02-04,"Washington Gulch","w1920","Mechanized",0,"Tue","weekday","no_sled","2","2","2",7.4,0,33,2,5,22.4,0,0,0,0,2,2,2,2
"10231",2020-02-04,"Washington Gulch","w1920","Motorized",2,"Tue","weekday","sled","2","2","2",7.4,0,33,2,5,22.4,0,0,0,0,2,2,2,2
"10232",2020-02-04,"Washington Gulch","w1920","Hybrid",0,"Tue","weekday","sled","2","2","2",7.4,0,33,2,5,22.4,0,0,0,0,2,2,2,2
"10233",2020-02-05,"Washington Gulch","w1920","Non.motorized",8,"Wed","weekday","no_sled","2","2","1",7.4,0,33,0,2,22.4,2,0,0,0,2,2,2,2
"10234",2020-02-05,"Washington Gulch","w1920","Mechanized",1,"Wed","weekday","no_sled","2","2","1",7.4,0,33,0,2,22.4,2,0,0,0,2,2,2,2
"10235",2020-02-05,"Washington Gulch","w1920","Motorized",5,"Wed","weekday","sled","2","2","1",7.4,0,33,0,2,22.4,2,0,0,0,2,2,2,2
"10236",2020-02-05,"Washington Gulch","w1920","Hybrid",0,"Wed","weekday","sled","2","2","1",7.4,0,33,0,2,22.4,2,0,0,0,2,2,2,2
"10237",2020-02-06,"Washington Gulch","w1920","Non.motorized",4,"Thu","weekday","no_sled","2","2","1",7.5,0.1,32,-1,16,23.4,0,2,0,0,-1,1,1,1
"10238",2020-02-06,"Washington Gulch","w1920","Mechanized",0,"Thu","weekday","no_sled","2","2","1",7.5,0.1,32,-1,16,23.4,0,2,0,0,-1,1,1,1
"10239",2020-02-06,"Washington Gulch","w1920","Motorized",2,"Thu","weekday","sled","2","2","1",7.5,0.1,32,-1,16,23.4,0,2,0,0,-1,1,1,1
"10240",2020-02-06,"Washington Gulch","w1920","Hybrid",0,"Thu","weekday","sled","2","2","1",7.5,0.1,32,-1,16,23.4,0,2,0,0,-1,1,1,1
"10241",2020-02-07,"Washington Gulch","w1920","Non.motorized",NA,"Fri","weekday","no_sled","3","3","3",7.9,0.4,37,5,26,21.4,-1,0,2,0,4,4,6,6
"10242",2020-02-07,"Washington Gulch","w1920","Mechanized",NA,"Fri","weekday","no_sled","3","3","3",7.9,0.4,37,5,26,21.4,-1,0,2,0,4,4,6,6
"10243",2020-02-07,"Washington Gulch","w1920","Motorized",NA,"Fri","weekday","sled","3","3","3",7.9,0.4,37,5,26,21.4,-1,0,2,0,4,4,6,6
"10244",2020-02-07,"Washington Gulch","w1920","Hybrid",NA,"Fri","weekday","sled","3","3","3",7.9,0.4,37,5,26,21.4,-1,0,2,0,4,4,6,6
"10245",2020-02-08,"Washington Gulch","w1920","Non.motorized",38,"Sat","weekend","no_sled","3","3","2",8.3,0.4,39,2,30,21.3,5,-1,0,2,7,6,6,8
"10246",2020-02-08,"Washington Gulch","w1920","Mechanized",0,"Sat","weekend","no_sled","3","3","2",8.3,0.4,39,2,30,21.3,5,-1,0,2,7,6,6,8
"10247",2020-02-08,"Washington Gulch","w1920","Motorized",6,"Sat","weekend","sled","3","3","2",8.3,0.4,39,2,30,21.3,5,-1,0,2,7,6,6,8
"10248",2020-02-08,"Washington Gulch","w1920","Hybrid",0,"Sat","weekend","sled","3","3","2",8.3,0.4,39,2,30,21.3,5,-1,0,2,7,6,6,8
"10249",2020-02-09,"Washington Gulch","w1920","Non.motorized",34,"Sun","weekend","no_sled","3","2","2",8.4,0.1,38,-1,26,22.1,2,5,-1,0,1,6,5,5
"10250",2020-02-09,"Washington Gulch","w1920","Mechanized",0,"Sun","weekend","no_sled","3","2","2",8.4,0.1,38,-1,26,22.1,2,5,-1,0,1,6,5,5
"10251",2020-02-09,"Washington Gulch","w1920","Motorized",4,"Sun","weekend","sled","3","2","2",8.4,0.1,38,-1,26,22.1,2,5,-1,0,1,6,5,5
"10252",2020-02-09,"Washington Gulch","w1920","Hybrid",0,"Sun","weekend","sled","3","2","2",8.4,0.1,38,-1,26,22.1,2,5,-1,0,1,6,5,5
"10253",2020-02-10,"Washington Gulch","w1920","Non.motorized",15,"Mon","weekday","no_sled","2","2","1",8.4,0,38,0,22,22.1,-1,2,5,-1,-1,1,6,5
"10254",2020-02-10,"Washington Gulch","w1920","Mechanized",0,"Mon","weekday","no_sled","2","2","1",8.4,0,38,0,22,22.1,-1,2,5,-1,-1,1,6,5
"10255",2020-02-10,"Washington Gulch","w1920","Motorized",0,"Mon","weekday","sled","2","2","1",8.4,0,38,0,22,22.1,-1,2,5,-1,-1,1,6,5
"10256",2020-02-10,"Washington Gulch","w1920","Hybrid",0,"Mon","weekday","sled","2","2","1",8.4,0,38,0,22,22.1,-1,2,5,-1,-1,1,6,5
"10257",2020-02-11,"Washington Gulch","w1920","Non.motorized",12,"Tue","weekday","no_sled","2","2","2",8.5,0.1,40,2,16,21.2,0,-1,2,5,2,1,3,8
"10258",2020-02-11,"Washington Gulch","w1920","Mechanized",0,"Tue","weekday","no_sled","2","2","2",8.5,0.1,40,2,16,21.2,0,-1,2,5,2,1,3,8
"10259",2020-02-11,"Washington Gulch","w1920","Motorized",7,"Tue","weekday","sled","2","2","2",8.5,0.1,40,2,16,21.2,0,-1,2,5,2,1,3,8
"10260",2020-02-11,"Washington Gulch","w1920","Hybrid",0,"Tue","weekday","sled","2","2","2",8.5,0.1,40,2,16,21.2,0,-1,2,5,2,1,3,8
"10261",2020-02-12,"Washington Gulch","w1920","Non.motorized",14,"Wed","weekday","no_sled","2","2","2",8.5,0,39,-1,15,21.8,2,0,-1,2,1,1,0,2
"10262",2020-02-12,"Washington Gulch","w1920","Mechanized",0,"Wed","weekday","no_sled","2","2","2",8.5,0,39,-1,15,21.8,2,0,-1,2,1,1,0,2
"10263",2020-02-12,"Washington Gulch","w1920","Motorized",4,"Wed","weekday","sled","2","2","2",8.5,0,39,-1,15,21.8,2,0,-1,2,1,1,0,2
"10264",2020-02-12,"Washington Gulch","w1920","Hybrid",0,"Wed","weekday","sled","2","2","2",8.5,0,39,-1,15,21.8,2,0,-1,2,1,1,0,2
"10265",2020-02-13,"Washington Gulch","w1920","Non.motorized",12,"Thu","weekday","no_sled","2","2","1",8.5,0,39,0,18,21.8,-1,2,0,-1,-1,1,1,0
"10266",2020-02-13,"Washington Gulch","w1920","Mechanized",0,"Thu","weekday","no_sled","2","2","1",8.5,0,39,0,18,21.8,-1,2,0,-1,-1,1,1,0
"10267",2020-02-13,"Washington Gulch","w1920","Motorized",0,"Thu","weekday","sled","2","2","1",8.5,0,39,0,18,21.8,-1,2,0,-1,-1,1,1,0
"10268",2020-02-13,"Washington Gulch","w1920","Hybrid",0,"Thu","weekday","sled","2","2","1",8.5,0,39,0,18,21.8,-1,2,0,-1,-1,1,1,0
"10269",2020-02-14,"Washington Gulch","w1920","Non.motorized",24,"Fri","weekday","no_sled","2","1","1",8.6,0.1,38,-1,24,22.6,0,-1,2,0,-1,-2,0,0
"10270",2020-02-14,"Washington Gulch","w1920","Mechanized",0,"Fri","weekday","no_sled","2","1","1",8.6,0.1,38,-1,24,22.6,0,-1,2,0,-1,-2,0,0
"10271",2020-02-14,"Washington Gulch","w1920","Motorized",10,"Fri","weekday","sled","2","1","1",8.6,0.1,38,-1,24,22.6,0,-1,2,0,-1,-2,0,0
"10272",2020-02-14,"Washington Gulch","w1920","Hybrid",0,"Fri","weekday","sled","2","1","1",8.6,0.1,38,-1,24,22.6,0,-1,2,0,-1,-2,0,0
"10273",2020-02-15,"Washington Gulch","w1920","Non.motorized",57,"Sat","weekend","no_sled","1","1","1",8.6,0,38,0,26,22.6,-1,0,-1,2,-1,-1,-2,0
"10274",2020-02-15,"Washington Gulch","w1920","Mechanized",0,"Sat","weekend","no_sled","1","1","1",8.6,0,38,0,26,22.6,-1,0,-1,2,-1,-1,-2,0
"10275",2020-02-15,"Washington Gulch","w1920","Motorized",4,"Sat","weekend","sled","1","1","1",8.6,0,38,0,26,22.6,-1,0,-1,2,-1,-1,-2,0
"10276",2020-02-15,"Washington Gulch","w1920","Hybrid",0,"Sat","weekend","sled","1","1","1",8.6,0,38,0,26,22.6,-1,0,-1,2,-1,-1,-2,0
"10277",2020-02-16,"Washington Gulch","w1920","Non.motorized",50,"Sun","weekend","no_sled","1","1","1",8.8,0.2,37,-1,26,23.8,0,-1,0,-1,-1,-2,-2,-3
"10278",2020-02-16,"Washington Gulch","w1920","Mechanized",0,"Sun","weekend","no_sled","1","1","1",8.8,0.2,37,-1,26,23.8,0,-1,0,-1,-1,-2,-2,-3
"10279",2020-02-16,"Washington Gulch","w1920","Motorized",0,"Sun","weekend","sled","1","1","1",8.8,0.2,37,-1,26,23.8,0,-1,0,-1,-1,-2,-2,-3
"10280",2020-02-16,"Washington Gulch","w1920","Hybrid",0,"Sun","weekend","sled","1","1","1",8.8,0.2,37,-1,26,23.8,0,-1,0,-1,-1,-2,-2,-3
"10281",2020-02-17,"Washington Gulch","w1920","Non.motorized",16,"Mon","weekday","no_sled","2","1","1",9.2,0.4,43,6,25,21.4,-1,0,-1,0,5,5,4,4
"10282",2020-02-17,"Washington Gulch","w1920","Mechanized",0,"Mon","weekday","no_sled","2","1","1",9.2,0.4,43,6,25,21.4,-1,0,-1,0,5,5,4,4
"10283",2020-02-17,"Washington Gulch","w1920","Motorized",2,"Mon","weekday","sled","2","1","1",9.2,0.4,43,6,25,21.4,-1,0,-1,0,5,5,4,4
"10284",2020-02-17,"Washington Gulch","w1920","Hybrid",0,"Mon","weekday","sled","2","1","1",9.2,0.4,43,6,25,21.4,-1,0,-1,0,5,5,4,4
"10285",2020-02-18,"Washington Gulch","w1920","Non.motorized",46,"Tue","weekday","no_sled","1","1","1",9.3,0.1,42,-1,18,22.1,6,-1,0,-1,5,4,4,3
"10286",2020-02-18,"Washington Gulch","w1920","Mechanized",0,"Tue","weekday","no_sled","1","1","1",9.3,0.1,42,-1,18,22.1,6,-1,0,-1,5,4,4,3
"10287",2020-02-18,"Washington Gulch","w1920","Motorized",3,"Tue","weekday","sled","1","1","1",9.3,0.1,42,-1,18,22.1,6,-1,0,-1,5,4,4,3
"10288",2020-02-18,"Washington Gulch","w1920","Hybrid",0,"Tue","weekday","sled","1","1","1",9.3,0.1,42,-1,18,22.1,6,-1,0,-1,5,4,4,3
"10289",2020-02-19,"Washington Gulch","w1920","Non.motorized",20,"Wed","weekday","no_sled","1","1","1",9.3,0,41,-1,22,22.7,-1,6,-1,0,-2,4,3,3
"10290",2020-02-19,"Washington Gulch","w1920","Mechanized",1,"Wed","weekday","no_sled","1","1","1",9.3,0,41,-1,22,22.7,-1,6,-1,0,-2,4,3,3
"10291",2020-02-19,"Washington Gulch","w1920","Motorized",2,"Wed","weekday","sled","1","1","1",9.3,0,41,-1,22,22.7,-1,6,-1,0,-2,4,3,3
"10292",2020-02-19,"Washington Gulch","w1920","Hybrid",0,"Wed","weekday","sled","1","1","1",9.3,0,41,-1,22,22.7,-1,6,-1,0,-2,4,3,3
"10293",2020-02-20,"Washington Gulch","w1920","Non.motorized",36,"Thu","weekday","no_sled","1","1","1",9.3,0,41,0,18,22.7,-1,-1,6,-1,-1,-2,4,3
"10294",2020-02-20,"Washington Gulch","w1920","Mechanized",0,"Thu","weekday","no_sled","1","1","1",9.3,0,41,0,18,22.7,-1,-1,6,-1,-1,-2,4,3
"10295",2020-02-20,"Washington Gulch","w1920","Motorized",1,"Thu","weekday","sled","1","1","1",9.3,0,41,0,18,22.7,-1,-1,6,-1,-1,-2,4,3
"10296",2020-02-20,"Washington Gulch","w1920","Hybrid",0,"Thu","weekday","sled","1","1","1",9.3,0,41,0,18,22.7,-1,-1,6,-1,-1,-2,4,3
"10297",2020-02-21,"Washington Gulch","w1920","Non.motorized",38,"Fri","weekday","no_sled","1","1","1",9.3,0,40,-1,26,23.2,0,-1,-1,6,-1,-2,-3,3
"10298",2020-02-21,"Washington Gulch","w1920","Mechanized",0,"Fri","weekday","no_sled","1","1","1",9.3,0,40,-1,26,23.2,0,-1,-1,6,-1,-2,-3,3
"10299",2020-02-21,"Washington Gulch","w1920","Motorized",13,"Fri","weekday","sled","1","1","1",9.3,0,40,-1,26,23.2,0,-1,-1,6,-1,-2,-3,3
"10300",2020-02-21,"Washington Gulch","w1920","Hybrid",0,"Fri","weekday","sled","1","1","1",9.3,0,40,-1,26,23.2,0,-1,-1,6,-1,-2,-3,3
"10301",2020-02-22,"Washington Gulch","w1920","Non.motorized",62,"Sat","weekend","no_sled","1","1","1",9.4,0.1,39,-1,32,24.1,-1,0,-1,-1,-2,-2,-3,-4
"10302",2020-02-22,"Washington Gulch","w1920","Mechanized",0,"Sat","weekend","no_sled","1","1","1",9.4,0.1,39,-1,32,24.1,-1,0,-1,-1,-2,-2,-3,-4
"10303",2020-02-22,"Washington Gulch","w1920","Motorized",9,"Sat","weekend","sled","1","1","1",9.4,0.1,39,-1,32,24.1,-1,0,-1,-1,-2,-2,-3,-4
"10304",2020-02-22,"Washington Gulch","w1920","Hybrid",0,"Sat","weekend","sled","1","1","1",9.4,0.1,39,-1,32,24.1,-1,0,-1,-1,-2,-2,-3,-4
"10305",2020-02-23,"Washington Gulch","w1920","Non.motorized",28,"Sun","weekend","no_sled","2","2","2",9.5,0.1,40,1,27,23.8,-1,-1,0,-1,0,-1,-1,-2
"10306",2020-02-23,"Washington Gulch","w1920","Mechanized",0,"Sun","weekend","no_sled","2","2","2",9.5,0.1,40,1,27,23.8,-1,-1,0,-1,0,-1,-1,-2
"10307",2020-02-23,"Washington Gulch","w1920","Motorized",0,"Sun","weekend","sled","2","2","2",9.5,0.1,40,1,27,23.8,-1,-1,0,-1,0,-1,-1,-2
"10308",2020-02-23,"Washington Gulch","w1920","Hybrid",0,"Sun","weekend","sled","2","2","2",9.5,0.1,40,1,27,23.8,-1,-1,0,-1,0,-1,-1,-2
"10309",2020-02-24,"Washington Gulch","w1920","Non.motorized",12,"Mon","weekday","no_sled","3","3","2",9.8,0.3,43,3,17,22.8,1,-1,-1,0,4,3,2,2
"10310",2020-02-24,"Washington Gulch","w1920","Mechanized",0,"Mon","weekday","no_sled","3","3","2",9.8,0.3,43,3,17,22.8,1,-1,-1,0,4,3,2,2
"10311",2020-02-24,"Washington Gulch","w1920","Motorized",2,"Mon","weekday","sled","3","3","2",9.8,0.3,43,3,17,22.8,1,-1,-1,0,4,3,2,2
"10312",2020-02-24,"Washington Gulch","w1920","Hybrid",0,"Mon","weekday","sled","3","3","2",9.8,0.3,43,3,17,22.8,1,-1,-1,0,4,3,2,2
"10313",2020-02-25,"Washington Gulch","w1920","Non.motorized",23,"Tue","weekday","no_sled","2","2","1",9.8,0,43,0,8,22.8,3,1,-1,-1,3,4,3,2
"10314",2020-02-25,"Washington Gulch","w1920","Mechanized",0,"Tue","weekday","no_sled","2","2","1",9.8,0,43,0,8,22.8,3,1,-1,-1,3,4,3,2
"10315",2020-02-25,"Washington Gulch","w1920","Motorized",2,"Tue","weekday","sled","2","2","1",9.8,0,43,0,8,22.8,3,1,-1,-1,3,4,3,2
"10316",2020-02-25,"Washington Gulch","w1920","Hybrid",0,"Tue","weekday","sled","2","2","1",9.8,0,43,0,8,22.8,3,1,-1,-1,3,4,3,2
"10317",2020-02-26,"Washington Gulch","w1920","Non.motorized",30,"Wed","weekday","no_sled","2","2","1",9.8,0,42,-1,15,23.3,0,3,1,-1,-1,2,3,2
"10318",2020-02-26,"Washington Gulch","w1920","Mechanized",0,"Wed","weekday","no_sled","2","2","1",9.8,0,42,-1,15,23.3,0,3,1,-1,-1,2,3,2
"10319",2020-02-26,"Washington Gulch","w1920","Motorized",5,"Wed","weekday","sled","2","2","1",9.8,0,42,-1,15,23.3,0,3,1,-1,-1,2,3,2
"10320",2020-02-26,"Washington Gulch","w1920","Hybrid",0,"Wed","weekday","sled","2","2","1",9.8,0,42,-1,15,23.3,0,3,1,-1,-1,2,3,2
"10321",2020-02-27,"Washington Gulch","w1920","Non.motorized",25,"Thu","weekday","no_sled","2","2","1",9.9,0.1,41,-1,25,24.1,-1,0,3,1,-2,-2,1,2
"10322",2020-02-27,"Washington Gulch","w1920","Mechanized",1,"Thu","weekday","no_sled","2","2","1",9.9,0.1,41,-1,25,24.1,-1,0,3,1,-2,-2,1,2
"10323",2020-02-27,"Washington Gulch","w1920","Motorized",4,"Thu","weekday","sled","2","2","1",9.9,0.1,41,-1,25,24.1,-1,0,3,1,-2,-2,1,2
"10324",2020-02-27,"Washington Gulch","w1920","Hybrid",0,"Thu","weekday","sled","2","2","1",9.9,0.1,41,-1,25,24.1,-1,0,3,1,-2,-2,1,2
"10325",2020-02-28,"Washington Gulch","w1920","Non.motorized",20,"Fri","weekday","no_sled","2","1","1",9.9,0,41,0,28,24.1,-1,-1,0,3,-1,-2,-2,1
"10326",2020-02-28,"Washington Gulch","w1920","Mechanized",3,"Fri","weekday","no_sled","2","1","1",9.9,0,41,0,28,24.1,-1,-1,0,3,-1,-2,-2,1
"10327",2020-02-28,"Washington Gulch","w1920","Motorized",7,"Fri","weekday","sled","2","1","1",9.9,0,41,0,28,24.1,-1,-1,0,3,-1,-2,-2,1
"10328",2020-02-28,"Washington Gulch","w1920","Hybrid",0,"Fri","weekday","sled","2","1","1",9.9,0,41,0,28,24.1,-1,-1,0,3,-1,-2,-2,1
"10329",2020-02-29,"Washington Gulch","w1920","Non.motorized",32,"Sat","weekend","no_sled","1","1","1",9.9,0,40,-1,29,24.8,0,-1,-1,0,-1,-2,-3,-3
"10330",2020-02-29,"Washington Gulch","w1920","Mechanized",1,"Sat","weekend","no_sled","1","1","1",9.9,0,40,-1,29,24.8,0,-1,-1,0,-1,-2,-3,-3
"10331",2020-02-29,"Washington Gulch","w1920","Motorized",10,"Sat","weekend","sled","1","1","1",9.9,0,40,-1,29,24.8,0,-1,-1,0,-1,-2,-3,-3
"10332",2020-02-29,"Washington Gulch","w1920","Hybrid",0,"Sat","weekend","sled","1","1","1",9.9,0,40,-1,29,24.8,0,-1,-1,0,-1,-2,-3,-3
"10333",2020-03-01,"Washington Gulch","w1920","Non.motorized",39,"Sun","weekend","no_sled","1","1","1",10,0.1,40,0,28,25,-1,0,-1,-1,-1,-1,-2,-3
"10334",2020-03-01,"Washington Gulch","w1920","Mechanized",1,"Sun","weekend","no_sled","1","1","1",10,0.1,40,0,28,25,-1,0,-1,-1,-1,-1,-2,-3
"10335",2020-03-01,"Washington Gulch","w1920","Motorized",3,"Sun","weekend","sled","1","1","1",10,0.1,40,0,28,25,-1,0,-1,-1,-1,-1,-2,-3
"10336",2020-03-01,"Washington Gulch","w1920","Hybrid",0,"Sun","weekend","sled","1","1","1",10,0.1,40,0,28,25,-1,0,-1,-1,-1,-1,-2,-3
"10337",2020-03-02,"Washington Gulch","w1920","Non.motorized",6,"Mon","weekday","no_sled","2","2","1",10.4,0.4,45,5,25,23.1,0,-1,0,-1,5,4,4,3
"10338",2020-03-02,"Washington Gulch","w1920","Mechanized",0,"Mon","weekday","no_sled","2","2","1",10.4,0.4,45,5,25,23.1,0,-1,0,-1,5,4,4,3
"10339",2020-03-02,"Washington Gulch","w1920","Motorized",3,"Mon","weekday","sled","2","2","1",10.4,0.4,45,5,25,23.1,0,-1,0,-1,5,4,4,3
"10340",2020-03-02,"Washington Gulch","w1920","Hybrid",0,"Mon","weekday","sled","2","2","1",10.4,0.4,45,5,25,23.1,0,-1,0,-1,5,4,4,3
"10341",2020-03-03,"Washington Gulch","w1920","Non.motorized",12,"Tue","weekday","no_sled","2","1","1",10.9,0.5,50,5,25,21.8,5,0,-1,0,10,10,9,9
"10342",2020-03-03,"Washington Gulch","w1920","Mechanized",0,"Tue","weekday","no_sled","2","1","1",10.9,0.5,50,5,25,21.8,5,0,-1,0,10,10,9,9
"10343",2020-03-03,"Washington Gulch","w1920","Motorized",4,"Tue","weekday","sled","2","1","1",10.9,0.5,50,5,25,21.8,5,0,-1,0,10,10,9,9
"10344",2020-03-03,"Washington Gulch","w1920","Hybrid",0,"Tue","weekday","sled","2","1","1",10.9,0.5,50,5,25,21.8,5,0,-1,0,10,10,9,9
"10345",2020-03-04,"Washington Gulch","w1920","Non.motorized",16,"Wed","weekday","no_sled","2","1","1",10.9,0,48,-2,29,22.7,5,5,0,-1,3,8,8,7
"10346",2020-03-04,"Washington Gulch","w1920","Mechanized",0,"Wed","weekday","no_sled","2","1","1",10.9,0,48,-2,29,22.7,5,5,0,-1,3,8,8,7
"10347",2020-03-04,"Washington Gulch","w1920","Motorized",3,"Wed","weekday","sled","2","1","1",10.9,0,48,-2,29,22.7,5,5,0,-1,3,8,8,7
"10348",2020-03-04,"Washington Gulch","w1920","Hybrid",0,"Wed","weekday","sled","2","1","1",10.9,0,48,-2,29,22.7,5,5,0,-1,3,8,8,7
"10349",2020-03-05,"Washington Gulch","w1920","Non.motorized",14,"Thu","weekday","no_sled","2","1","1",10.9,0,46,-2,32,23.7,-2,5,5,0,-4,1,6,6
"10350",2020-03-05,"Washington Gulch","w1920","Mechanized",1,"Thu","weekday","no_sled","2","1","1",10.9,0,46,-2,32,23.7,-2,5,5,0,-4,1,6,6
"10351",2020-03-05,"Washington Gulch","w1920","Motorized",3,"Thu","weekday","sled","2","1","1",10.9,0,46,-2,32,23.7,-2,5,5,0,-4,1,6,6
"10352",2020-03-05,"Washington Gulch","w1920","Hybrid",0,"Thu","weekday","sled","2","1","1",10.9,0,46,-2,32,23.7,-2,5,5,0,-4,1,6,6
"10353",2020-03-06,"Washington Gulch","w1920","Non.motorized",25,"Fri","weekday","no_sled","1","1","1",10.9,0,45,-1,34,24.2,-2,-2,5,5,-3,-5,0,5
"10354",2020-03-06,"Washington Gulch","w1920","Mechanized",0,"Fri","weekday","no_sled","1","1","1",10.9,0,45,-1,34,24.2,-2,-2,5,5,-3,-5,0,5
"10355",2020-03-06,"Washington Gulch","w1920","Motorized",0,"Fri","weekday","sled","1","1","1",10.9,0,45,-1,34,24.2,-2,-2,5,5,-3,-5,0,5
"10356",2020-03-06,"Washington Gulch","w1920","Hybrid",0,"Fri","weekday","sled","1","1","1",10.9,0,45,-1,34,24.2,-2,-2,5,5,-3,-5,0,5
"10357",2020-03-07,"Washington Gulch","w1920","Non.motorized",30,"Sat","weekend","no_sled","1","1","2",10.9,0,44,-1,35,24.8,-1,-2,-2,5,-2,-4,-6,-1
"10358",2020-03-07,"Washington Gulch","w1920","Mechanized",0,"Sat","weekend","no_sled","1","1","2",10.9,0,44,-1,35,24.8,-1,-2,-2,5,-2,-4,-6,-1
"10359",2020-03-07,"Washington Gulch","w1920","Motorized",3,"Sat","weekend","sled","1","1","2",10.9,0,44,-1,35,24.8,-1,-2,-2,5,-2,-4,-6,-1
"10360",2020-03-07,"Washington Gulch","w1920","Hybrid",0,"Sat","weekend","sled","1","1","2",10.9,0,44,-1,35,24.8,-1,-2,-2,5,-2,-4,-6,-1
"10361",2020-03-08,"Washington Gulch","w1920","Non.motorized",25,"Sun","weekend","no_sled","1","1","1",11,0.1,43,-1,33,25.6,-1,-1,-2,-2,-2,-3,-5,-7
"10362",2020-03-08,"Washington Gulch","w1920","Mechanized",0,"Sun","weekend","no_sled","1","1","1",11,0.1,43,-1,33,25.6,-1,-1,-2,-2,-2,-3,-5,-7
"10363",2020-03-08,"Washington Gulch","w1920","Motorized",15,"Sun","weekend","sled","1","1","1",11,0.1,43,-1,33,25.6,-1,-1,-2,-2,-2,-3,-5,-7
"10364",2020-03-08,"Washington Gulch","w1920","Hybrid",0,"Sun","weekend","sled","1","1","1",11,0.1,43,-1,33,25.6,-1,-1,-2,-2,-2,-3,-5,-7
"10365",2020-03-09,"Washington Gulch","w1920","Non.motorized",18,"Mon","weekday","no_sled","1","1","1",11.1,0.1,42,-1,31,26.4,-1,-1,-1,-2,-2,-3,-4,-6
"10366",2020-03-09,"Washington Gulch","w1920","Mechanized",1,"Mon","weekday","no_sled","1","1","1",11.1,0.1,42,-1,31,26.4,-1,-1,-1,-2,-2,-3,-4,-6
"10367",2020-03-09,"Washington Gulch","w1920","Motorized",3,"Mon","weekday","sled","1","1","1",11.1,0.1,42,-1,31,26.4,-1,-1,-1,-2,-2,-3,-4,-6
"10368",2020-03-09,"Washington Gulch","w1920","Hybrid",0,"Mon","weekday","sled","1","1","1",11.1,0.1,42,-1,31,26.4,-1,-1,-1,-2,-2,-3,-4,-6
"10369",2020-03-10,"Washington Gulch","w1920","Non.motorized",14,"Tue","weekday","no_sled","1","1","2",11.2,0.1,44,2,31,25.5,-1,-1,-1,-1,1,0,-1,-2
"10370",2020-03-10,"Washington Gulch","w1920","Mechanized",0,"Tue","weekday","no_sled","1","1","2",11.2,0.1,44,2,31,25.5,-1,-1,-1,-1,1,0,-1,-2
"10371",2020-03-10,"Washington Gulch","w1920","Motorized",8,"Tue","weekday","sled","1","1","2",11.2,0.1,44,2,31,25.5,-1,-1,-1,-1,1,0,-1,-2
"10372",2020-03-10,"Washington Gulch","w1920","Hybrid",0,"Tue","weekday","sled","1","1","2",11.2,0.1,44,2,31,25.5,-1,-1,-1,-1,1,0,-1,-2
"10373",2020-03-11,"Washington Gulch","w1920","Non.motorized",8,"Wed","weekday","no_sled","2","2","1",11.2,0,44,0,32,25.5,2,-1,-1,-1,2,1,0,-1
"10374",2020-03-11,"Washington Gulch","w1920","Mechanized",0,"Wed","weekday","no_sled","2","2","1",11.2,0,44,0,32,25.5,2,-1,-1,-1,2,1,0,-1
"10375",2020-03-11,"Washington Gulch","w1920","Motorized",4,"Wed","weekday","sled","2","2","1",11.2,0,44,0,32,25.5,2,-1,-1,-1,2,1,0,-1
"10376",2020-03-11,"Washington Gulch","w1920","Hybrid",0,"Wed","weekday","sled","2","2","1",11.2,0,44,0,32,25.5,2,-1,-1,-1,2,1,0,-1
"10377",2020-03-12,"Washington Gulch","w1920","Non.motorized",7,"Thu","weekday","no_sled","2","2","2",11.4,0.2,42,-2,35,27.1,0,2,-1,-1,-2,0,-1,-2
"10378",2020-03-12,"Washington Gulch","w1920","Mechanized",0,"Thu","weekday","no_sled","2","2","2",11.4,0.2,42,-2,35,27.1,0,2,-1,-1,-2,0,-1,-2
"10379",2020-03-12,"Washington Gulch","w1920","Motorized",10,"Thu","weekday","sled","2","2","2",11.4,0.2,42,-2,35,27.1,0,2,-1,-1,-2,0,-1,-2
"10380",2020-03-12,"Washington Gulch","w1920","Hybrid",0,"Thu","weekday","sled","2","2","2",11.4,0.2,42,-2,35,27.1,0,2,-1,-1,-2,0,-1,-2
"10381",2020-03-13,"Washington Gulch","w1920","Non.motorized",25,"Fri","weekday","no_sled","3","3","2",11.5,0.1,44,2,31,26.1,-2,0,2,-1,0,0,2,1
"10382",2020-03-13,"Washington Gulch","w1920","Mechanized",0,"Fri","weekday","no_sled","3","3","2",11.5,0.1,44,2,31,26.1,-2,0,2,-1,0,0,2,1
"10383",2020-03-13,"Washington Gulch","w1920","Motorized",8,"Fri","weekday","sled","3","3","2",11.5,0.1,44,2,31,26.1,-2,0,2,-1,0,0,2,1
"10384",2020-03-13,"Washington Gulch","w1920","Hybrid",0,"Fri","weekday","sled","3","3","2",11.5,0.1,44,2,31,26.1,-2,0,2,-1,0,0,2,1
"10385",2020-03-14,"Washington Gulch","w1920","Non.motorized",58,"Sat","weekend","no_sled","3","3","3",11.7,0.2,44,0,31,26.6,2,-2,0,2,2,0,0,2
"10386",2020-03-14,"Washington Gulch","w1920","Mechanized",0,"Sat","weekend","no_sled","3","3","3",11.7,0.2,44,0,31,26.6,2,-2,0,2,2,0,0,2
"10387",2020-03-14,"Washington Gulch","w1920","Motorized",14,"Sat","weekend","sled","3","3","3",11.7,0.2,44,0,31,26.6,2,-2,0,2,2,0,0,2
"10388",2020-03-14,"Washington Gulch","w1920","Hybrid",0,"Sat","weekend","sled","3","3","3",11.7,0.2,44,0,31,26.6,2,-2,0,2,2,0,0,2
"10389",2020-03-15,"Washington Gulch","w1920","Non.motorized",82,"Sun","weekend","no_sled","2","2","2",11.7,0,45,1,33,26,0,2,-2,0,1,3,1,1
"10390",2020-03-15,"Washington Gulch","w1920","Mechanized",0,"Sun","weekend","no_sled","2","2","2",11.7,0,45,1,33,26,0,2,-2,0,1,3,1,1
"10391",2020-03-15,"Washington Gulch","w1920","Motorized",18,"Sun","weekend","sled","2","2","2",11.7,0,45,1,33,26,0,2,-2,0,1,3,1,1
"10392",2020-03-15,"Washington Gulch","w1920","Hybrid",0,"Sun","weekend","sled","2","2","2",11.7,0,45,1,33,26,0,2,-2,0,1,3,1,1
"10393",2020-03-16,"Washington Gulch","w1920","Non.motorized",42,"Mon","weekday","no_sled","2","2","2",11.7,0,45,0,35,26,1,0,2,-2,1,1,3,1
"10394",2020-03-16,"Washington Gulch","w1920","Mechanized",0,"Mon","weekday","no_sled","2","2","2",11.7,0,45,0,35,26,1,0,2,-2,1,1,3,1
"10395",2020-03-16,"Washington Gulch","w1920","Motorized",5,"Mon","weekday","sled","2","2","2",11.7,0,45,0,35,26,1,0,2,-2,1,1,3,1
"10396",2020-03-16,"Washington Gulch","w1920","Hybrid",0,"Mon","weekday","sled","2","2","2",11.7,0,45,0,35,26,1,0,2,-2,1,1,3,1
"10397",2020-03-17,"Washington Gulch","w1920","Non.motorized",26,"Tue","weekday","no_sled","2","2","2",11.7,0,44,-1,36,26.6,0,1,0,2,-1,0,0,2
"10398",2020-03-17,"Washington Gulch","w1920","Mechanized",0,"Tue","weekday","no_sled","2","2","2",11.7,0,44,-1,36,26.6,0,1,0,2,-1,0,0,2
"10399",2020-03-17,"Washington Gulch","w1920","Motorized",7,"Tue","weekday","sled","2","2","2",11.7,0,44,-1,36,26.6,0,1,0,2,-1,0,0,2
"10400",2020-03-17,"Washington Gulch","w1920","Hybrid",0,"Tue","weekday","sled","2","2","2",11.7,0,44,-1,36,26.6,0,1,0,2,-1,0,0,2
"10401",2020-03-18,"Washington Gulch","w1920","Non.motorized",16,"Wed","weekday","no_sled","2","2","2",11.7,0,43,-1,33,27.2,-1,0,1,0,-2,-2,-1,-1
"10402",2020-03-18,"Washington Gulch","w1920","Mechanized",1,"Wed","weekday","no_sled","2","2","2",11.7,0,43,-1,33,27.2,-1,0,1,0,-2,-2,-1,-1
"10403",2020-03-18,"Washington Gulch","w1920","Motorized",9,"Wed","weekday","sled","2","2","2",11.7,0,43,-1,33,27.2,-1,0,1,0,-2,-2,-1,-1
"10404",2020-03-18,"Washington Gulch","w1920","Hybrid",0,"Wed","weekday","sled","2","2","2",11.7,0,43,-1,33,27.2,-1,0,1,0,-2,-2,-1,-1
"10405",2020-03-19,"Washington Gulch","w1920","Non.motorized",8,"Thu","weekday","no_sled","3","3","3",11.8,0.1,43,0,27,27.4,-1,-1,0,1,-1,-2,-2,-1
"10406",2020-03-19,"Washington Gulch","w1920","Mechanized",0,"Thu","weekday","no_sled","3","3","3",11.8,0.1,43,0,27,27.4,-1,-1,0,1,-1,-2,-2,-1
"10407",2020-03-19,"Washington Gulch","w1920","Motorized",3,"Thu","weekday","sled","3","3","3",11.8,0.1,43,0,27,27.4,-1,-1,0,1,-1,-2,-2,-1
"10408",2020-03-19,"Washington Gulch","w1920","Hybrid",0,"Thu","weekday","sled","3","3","3",11.8,0.1,43,0,27,27.4,-1,-1,0,1,-1,-2,-2,-1
"10409",2020-03-20,"Washington Gulch","w1920","Non.motorized",47,"Fri","weekday","no_sled","3","3","2",12.7,0.9,52,9,26,24.4,0,-1,-1,0,9,8,7,7
"10410",2020-03-20,"Washington Gulch","w1920","Mechanized",0,"Fri","weekday","no_sled","3","3","2",12.7,0.9,52,9,26,24.4,0,-1,-1,0,9,8,7,7
"10411",2020-03-20,"Washington Gulch","w1920","Motorized",4,"Fri","weekday","sled","3","3","2",12.7,0.9,52,9,26,24.4,0,-1,-1,0,9,8,7,7
"10412",2020-03-20,"Washington Gulch","w1920","Hybrid",0,"Fri","weekday","sled","3","3","2",12.7,0.9,52,9,26,24.4,0,-1,-1,0,9,8,7,7
"10413",2020-03-21,"Washington Gulch","w1920","Non.motorized",61,"Sat","weekend","no_sled","3","3","2",12.8,0.1,54,2,26,23.7,9,0,-1,-1,11,11,10,9
"10414",2020-03-21,"Washington Gulch","w1920","Mechanized",0,"Sat","weekend","no_sled","3","3","2",12.8,0.1,54,2,26,23.7,9,0,-1,-1,11,11,10,9
"10415",2020-03-21,"Washington Gulch","w1920","Motorized",10,"Sat","weekend","sled","3","3","2",12.8,0.1,54,2,26,23.7,9,0,-1,-1,11,11,10,9
"10416",2020-03-21,"Washington Gulch","w1920","Hybrid",0,"Sat","weekend","sled","3","3","2",12.8,0.1,54,2,26,23.7,9,0,-1,-1,11,11,10,9
"10417",2020-03-22,"Washington Gulch","w1920","Non.motorized",25,"Sun","weekend","no_sled","2","2","2",13,0.2,53,-1,28,24.5,2,9,0,-1,1,10,10,9
"10418",2020-03-22,"Washington Gulch","w1920","Mechanized",1,"Sun","weekend","no_sled","2","2","2",13,0.2,53,-1,28,24.5,2,9,0,-1,1,10,10,9
"10419",2020-03-22,"Washington Gulch","w1920","Motorized",19,"Sun","weekend","sled","2","2","2",13,0.2,53,-1,28,24.5,2,9,0,-1,1,10,10,9
"10420",2020-03-22,"Washington Gulch","w1920","Hybrid",0,"Sun","weekend","sled","2","2","2",13,0.2,53,-1,28,24.5,2,9,0,-1,1,10,10,9
"10421",2020-03-23,"Washington Gulch","w1920","Non.motorized",31,"Mon","weekday","no_sled","2","2","2",13,0,53,0,28,24.5,-1,2,9,0,-1,1,10,10
"10422",2020-03-23,"Washington Gulch","w1920","Mechanized",0,"Mon","weekday","no_sled","2","2","2",13,0,53,0,28,24.5,-1,2,9,0,-1,1,10,10
"10423",2020-03-23,"Washington Gulch","w1920","Motorized",8,"Mon","weekday","sled","2","2","2",13,0,53,0,28,24.5,-1,2,9,0,-1,1,10,10
"10424",2020-03-23,"Washington Gulch","w1920","Hybrid",0,"Mon","weekday","sled","2","2","2",13,0,53,0,28,24.5,-1,2,9,0,-1,1,10,10
"10425",2020-03-24,"Washington Gulch","w1920","Non.motorized",38,"Tue","weekday","no_sled","2","2","2",13.2,0.2,53,0,32,24.9,0,-1,2,9,0,-1,1,10
"10426",2020-03-24,"Washington Gulch","w1920","Mechanized",1,"Tue","weekday","no_sled","2","2","2",13.2,0.2,53,0,32,24.9,0,-1,2,9,0,-1,1,10
"10427",2020-03-24,"Washington Gulch","w1920","Motorized",6,"Tue","weekday","sled","2","2","2",13.2,0.2,53,0,32,24.9,0,-1,2,9,0,-1,1,10
"10428",2020-03-24,"Washington Gulch","w1920","Hybrid",0,"Tue","weekday","sled","2","2","2",13.2,0.2,53,0,32,24.9,0,-1,2,9,0,-1,1,10
"10429",2020-03-25,"Washington Gulch","w1920","Non.motorized",17,"Wed","weekday","no_sled","2","2","2",13.3,0.1,51,-2,34,26.1,0,0,-1,2,-2,-2,-3,-1
"10430",2020-03-25,"Washington Gulch","w1920","Mechanized",1,"Wed","weekday","no_sled","2","2","2",13.3,0.1,51,-2,34,26.1,0,0,-1,2,-2,-2,-3,-1
"10431",2020-03-25,"Washington Gulch","w1920","Motorized",4,"Wed","weekday","sled","2","2","2",13.3,0.1,51,-2,34,26.1,0,0,-1,2,-2,-2,-3,-1
"10432",2020-03-25,"Washington Gulch","w1920","Hybrid",0,"Wed","weekday","sled","2","2","2",13.3,0.1,51,-2,34,26.1,0,0,-1,2,-2,-2,-3,-1
"10433",2020-03-26,"Washington Gulch","w1920","Non.motorized",12,"Thu","weekday","no_sled","2","2","2",13.3,0,50,-1,36,26.6,-2,0,0,-1,-3,-3,-3,-4
"10434",2020-03-26,"Washington Gulch","w1920","Non.motorized",12,"Thu","weekday","no_sled","3","3","2",13.3,0,50,-1,36,26.6,-2,0,0,-1,-3,-3,-3,-4
"10435",2020-03-26,"Washington Gulch","w1920","Mechanized",0,"Thu","weekday","no_sled","2","2","2",13.3,0,50,-1,36,26.6,-2,0,0,-1,-3,-3,-3,-4
"10436",2020-03-26,"Washington Gulch","w1920","Mechanized",0,"Thu","weekday","no_sled","3","3","2",13.3,0,50,-1,36,26.6,-2,0,0,-1,-3,-3,-3,-4
"10437",2020-03-26,"Washington Gulch","w1920","Motorized",7,"Thu","weekday","sled","2","2","2",13.3,0,50,-1,36,26.6,-2,0,0,-1,-3,-3,-3,-4
"10438",2020-03-26,"Washington Gulch","w1920","Motorized",7,"Thu","weekday","sled","3","3","2",13.3,0,50,-1,36,26.6,-2,0,0,-1,-3,-3,-3,-4
"10439",2020-03-26,"Washington Gulch","w1920","Hybrid",0,"Thu","weekday","sled","2","2","2",13.3,0,50,-1,36,26.6,-2,0,0,-1,-3,-3,-3,-4
"10440",2020-03-26,"Washington Gulch","w1920","Hybrid",0,"Thu","weekday","sled","3","3","2",13.3,0,50,-1,36,26.6,-2,0,0,-1,-3,-3,-3,-4
"10441",2020-03-27,"Washington Gulch","w1920","Non.motorized",31,"Fri","weekday","no_sled","3","3","2",13.3,0,50,0,23,26.6,-1,-2,0,0,-1,-3,-3,-3
"10442",2020-03-27,"Washington Gulch","w1920","Mechanized",0,"Fri","weekday","no_sled","3","3","2",13.3,0,50,0,23,26.6,-1,-2,0,0,-1,-3,-3,-3
"10443",2020-03-27,"Washington Gulch","w1920","Motorized",0,"Fri","weekday","sled","3","3","2",13.3,0,50,0,23,26.6,-1,-2,0,0,-1,-3,-3,-3
"10444",2020-03-27,"Washington Gulch","w1920","Hybrid",0,"Fri","weekday","sled","3","3","2",13.3,0,50,0,23,26.6,-1,-2,0,0,-1,-3,-3,-3
"10445",2020-03-28,"Washington Gulch","w1920","Non.motorized",17,"Sat","weekend","no_sled","3","3","3",13.3,0,50,0,18,26.6,0,-1,-2,0,0,-1,-3,-3
"10446",2020-03-28,"Washington Gulch","w1920","Mechanized",1,"Sat","weekend","no_sled","3","3","3",13.3,0,50,0,18,26.6,0,-1,-2,0,0,-1,-3,-3
"10447",2020-03-28,"Washington Gulch","w1920","Motorized",5,"Sat","weekend","sled","3","3","3",13.3,0,50,0,18,26.6,0,-1,-2,0,0,-1,-3,-3
"10448",2020-03-28,"Washington Gulch","w1920","Hybrid",0,"Sat","weekend","sled","3","3","3",13.3,0,50,0,18,26.6,0,-1,-2,0,0,-1,-3,-3
"10449",2020-03-29,"Washington Gulch","w1920","Non.motorized",33,"Sun","weekend","no_sled","2","2","2",13.3,0,49,-1,24,27.1,0,0,-1,-2,-1,-1,-2,-4
"10450",2020-03-29,"Washington Gulch","w1920","Mechanized",0,"Sun","weekend","no_sled","2","2","2",13.3,0,49,-1,24,27.1,0,0,-1,-2,-1,-1,-2,-4
"10451",2020-03-29,"Washington Gulch","w1920","Motorized",10,"Sun","weekend","sled","2","2","2",13.3,0,49,-1,24,27.1,0,0,-1,-2,-1,-1,-2,-4
"10452",2020-03-29,"Washington Gulch","w1920","Hybrid",0,"Sun","weekend","sled","2","2","2",13.3,0,49,-1,24,27.1,0,0,-1,-2,-1,-1,-2,-4
"10453",2020-03-30,"Washington Gulch","w1920","Non.motorized",10,"Mon","weekday","no_sled","2","2","2",13.4,0.1,49,0,29,27.3,-1,0,0,-1,-1,-1,-1,-2
"10454",2020-03-30,"Washington Gulch","w1920","Mechanized",0,"Mon","weekday","no_sled","2","2","2",13.4,0.1,49,0,29,27.3,-1,0,0,-1,-1,-1,-1,-2
"10455",2020-03-30,"Washington Gulch","w1920","Motorized",2,"Mon","weekday","sled","2","2","2",13.4,0.1,49,0,29,27.3,-1,0,0,-1,-1,-1,-1,-2
"10456",2020-03-30,"Washington Gulch","w1920","Hybrid",0,"Mon","weekday","sled","2","2","2",13.4,0.1,49,0,29,27.3,-1,0,0,-1,-1,-1,-1,-2
"10457",2020-03-31,"Washington Gulch","w1920","Non.motorized",20,"Tue","weekday","no_sled","2","2","2",13.6,0.2,51,2,35,26.7,0,-1,0,0,2,1,1,1
"10458",2020-03-31,"Washington Gulch","w1920","Mechanized",0,"Tue","weekday","no_sled","2","2","2",13.6,0.2,51,2,35,26.7,0,-1,0,0,2,1,1,1
"10459",2020-03-31,"Washington Gulch","w1920","Motorized",9,"Tue","weekday","sled","2","2","2",13.6,0.2,51,2,35,26.7,0,-1,0,0,2,1,1,1
"10460",2020-03-31,"Washington Gulch","w1920","Hybrid",0,"Tue","weekday","sled","2","2","2",13.6,0.2,51,2,35,26.7,0,-1,0,0,2,1,1,1
"10461",2020-04-01,"Washington Gulch","w1920","Non.motorized",16,"Wed","weekday","no_sled","2","2","2",13.6,0,47,-4,39,28.9,2,0,-1,0,-2,-2,-3,-3
"10462",2020-04-01,"Washington Gulch","w1920","Mechanized",0,"Wed","weekday","no_sled","2","2","2",13.6,0,47,-4,39,28.9,2,0,-1,0,-2,-2,-3,-3
"10463",2020-04-01,"Washington Gulch","w1920","Motorized",7,"Wed","weekday","sled","2","2","2",13.6,0,47,-4,39,28.9,2,0,-1,0,-2,-2,-3,-3
"10464",2020-04-01,"Washington Gulch","w1920","Hybrid",0,"Wed","weekday","sled","2","2","2",13.6,0,47,-4,39,28.9,2,0,-1,0,-2,-2,-3,-3
"10465",2020-04-02,"Washington Gulch","w1920","Non.motorized",19,"Thu","weekday","no_sled","2","2","2",13.6,0,46,-1,31,29.6,-4,2,0,-1,-5,-3,-3,-4
"10466",2020-04-02,"Washington Gulch","w1920","Mechanized",0,"Thu","weekday","no_sled","2","2","2",13.6,0,46,-1,31,29.6,-4,2,0,-1,-5,-3,-3,-4
"10467",2020-04-02,"Washington Gulch","w1920","Motorized",4,"Thu","weekday","sled","2","2","2",13.6,0,46,-1,31,29.6,-4,2,0,-1,-5,-3,-3,-4
"10468",2020-04-02,"Washington Gulch","w1920","Hybrid",0,"Thu","weekday","sled","2","2","2",13.6,0,46,-1,31,29.6,-4,2,0,-1,-5,-3,-3,-4
"10469",2020-04-03,"Washington Gulch","w1920","Non.motorized",7,"Fri","weekday","no_sled","2","2","2",13.6,0,46,0,28,29.6,-1,-4,2,0,-1,-5,-3,-3
"10470",2020-04-03,"Washington Gulch","w1920","Mechanized",0,"Fri","weekday","no_sled","2","2","2",13.6,0,46,0,28,29.6,-1,-4,2,0,-1,-5,-3,-3
"10471",2020-04-03,"Washington Gulch","w1920","Motorized",7,"Fri","weekday","sled","2","2","2",13.6,0,46,0,28,29.6,-1,-4,2,0,-1,-5,-3,-3
"10472",2020-04-03,"Washington Gulch","w1920","Hybrid",0,"Fri","weekday","sled","2","2","2",13.6,0,46,0,28,29.6,-1,-4,2,0,-1,-5,-3,-3
"10473",2020-04-04,"Washington Gulch","w1920","Non.motorized",10,"Sat","weekend","no_sled","2","2","2",13.6,0,45,-1,33,30.2,0,-1,-4,2,-1,-2,-6,-4
"10474",2020-04-04,"Washington Gulch","w1920","Mechanized",0,"Sat","weekend","no_sled","2","2","2",13.6,0,45,-1,33,30.2,0,-1,-4,2,-1,-2,-6,-4
"10475",2020-04-04,"Washington Gulch","w1920","Motorized",8,"Sat","weekend","sled","2","2","2",13.6,0,45,-1,33,30.2,0,-1,-4,2,-1,-2,-6,-4
"10476",2020-04-04,"Washington Gulch","w1920","Hybrid",0,"Sat","weekend","sled","2","2","2",13.6,0,45,-1,33,30.2,0,-1,-4,2,-1,-2,-6,-4
"10477",2020-04-05,"Washington Gulch","w1920","Non.motorized",18,"Sun","weekend","no_sled","2","2","3",13.6,0,45,0,38,30.2,-1,0,-1,-4,-1,-1,-2,-6
"10478",2020-04-05,"Washington Gulch","w1920","Mechanized",0,"Sun","weekend","no_sled","2","2","3",13.6,0,45,0,38,30.2,-1,0,-1,-4,-1,-1,-2,-6
"10479",2020-04-05,"Washington Gulch","w1920","Motorized",10,"Sun","weekend","sled","2","2","3",13.6,0,45,0,38,30.2,-1,0,-1,-4,-1,-1,-2,-6
"10480",2020-04-05,"Washington Gulch","w1920","Hybrid",0,"Sun","weekend","sled","2","2","3",13.6,0,45,0,38,30.2,-1,0,-1,-4,-1,-1,-2,-6
"10481",2020-04-06,"Washington Gulch","w1920","Non.motorized",38,"Mon","weekday","no_sled","2","2","3",13.6,0,44,-1,40,30.9,0,-1,0,-1,-1,-2,-2,-3
"10482",2020-04-06,"Washington Gulch","w1920","Mechanized",0,"Mon","weekday","no_sled","2","2","3",13.6,0,44,-1,40,30.9,0,-1,0,-1,-1,-2,-2,-3
"10483",2020-04-06,"Washington Gulch","w1920","Motorized",8,"Mon","weekday","sled","2","2","3",13.6,0,44,-1,40,30.9,0,-1,0,-1,-1,-2,-2,-3
"10484",2020-04-06,"Washington Gulch","w1920","Hybrid",0,"Mon","weekday","sled","2","2","3",13.6,0,44,-1,40,30.9,0,-1,0,-1,-1,-2,-2,-3
"10485",2020-04-07,"Washington Gulch","w1920","Non.motorized",11,"Tue","weekday","no_sled","2","2","3",13.4,-0.2,43,-1,39,31.2,-1,0,-1,0,-2,-2,-3,-3
"10486",2020-04-07,"Washington Gulch","w1920","Mechanized",0,"Tue","weekday","no_sled","2","2","3",13.4,-0.2,43,-1,39,31.2,-1,0,-1,0,-2,-2,-3,-3
"10487",2020-04-07,"Washington Gulch","w1920","Motorized",5,"Tue","weekday","sled","2","2","3",13.4,-0.2,43,-1,39,31.2,-1,0,-1,0,-2,-2,-3,-3
"10488",2020-04-07,"Washington Gulch","w1920","Hybrid",0,"Tue","weekday","sled","2","2","3",13.4,-0.2,43,-1,39,31.2,-1,0,-1,0,-2,-2,-3,-3
"10489",2020-04-08,"Washington Gulch","w1920","Non.motorized",8,"Wed","weekday","no_sled","2","3","3",13.3,-0.1,42,-1,40,31.7,-1,-1,0,-1,-2,-3,-3,-4
"10490",2020-04-08,"Washington Gulch","w1920","Mechanized",0,"Wed","weekday","no_sled","2","3","3",13.3,-0.1,42,-1,40,31.7,-1,-1,0,-1,-2,-3,-3,-4
"10491",2020-04-08,"Washington Gulch","w1920","Motorized",2,"Wed","weekday","sled","2","3","3",13.3,-0.1,42,-1,40,31.7,-1,-1,0,-1,-2,-3,-3,-4
"10492",2020-04-08,"Washington Gulch","w1920","Hybrid",0,"Wed","weekday","sled","2","3","3",13.3,-0.1,42,-1,40,31.7,-1,-1,0,-1,-2,-3,-3,-4
"10493",2020-04-09,"Washington Gulch","w1920","Non.motorized",9,"Thu","weekday","no_sled","2","3","3",13.1,-0.2,40,-2,42,32.8,-1,-1,-1,0,-3,-4,-5,-5
"10494",2020-04-09,"Washington Gulch","w1920","Mechanized",2,"Thu","weekday","no_sled","2","3","3",13.1,-0.2,40,-2,42,32.8,-1,-1,-1,0,-3,-4,-5,-5
"10495",2020-04-09,"Washington Gulch","w1920","Motorized",5,"Thu","weekday","sled","2","3","3",13.1,-0.2,40,-2,42,32.8,-1,-1,-1,0,-3,-4,-5,-5
"10496",2020-04-09,"Washington Gulch","w1920","Hybrid",0,"Thu","weekday","sled","2","3","3",13.1,-0.2,40,-2,42,32.8,-1,-1,-1,0,-3,-4,-5,-5
"10497",2020-04-10,"Washington Gulch","w1920","Non.motorized",16,"Fri","weekday","no_sled","3","3","3",12.9,-0.2,39,-1,38,33.1,-2,-1,-1,-1,-3,-4,-5,-6
"10498",2020-04-10,"Washington Gulch","w1920","Mechanized",0,"Fri","weekday","no_sled","3","3","3",12.9,-0.2,39,-1,38,33.1,-2,-1,-1,-1,-3,-4,-5,-6
"10499",2020-04-10,"Washington Gulch","w1920","Motorized",9,"Fri","weekday","sled","3","3","3",12.9,-0.2,39,-1,38,33.1,-2,-1,-1,-1,-3,-4,-5,-6
"10500",2020-04-10,"Washington Gulch","w1920","Hybrid",0,"Fri","weekday","sled","3","3","3",12.9,-0.2,39,-1,38,33.1,-2,-1,-1,-1,-3,-4,-5,-6
"10501",2020-04-11,"Washington Gulch","w1920","Non.motorized",4,"Sat","weekend","no_sled","2","3","3",12.9,0,39,0,36,33.1,-1,-2,-1,-1,-1,-3,-4,-5
"10502",2020-04-11,"Washington Gulch","w1920","Mechanized",0,"Sat","weekend","no_sled","2","3","3",12.9,0,39,0,36,33.1,-1,-2,-1,-1,-1,-3,-4,-5
"10503",2020-04-11,"Washington Gulch","w1920","Motorized",0,"Sat","weekend","sled","2","3","3",12.9,0,39,0,36,33.1,-1,-2,-1,-1,-1,-3,-4,-5
"10504",2020-04-11,"Washington Gulch","w1920","Hybrid",0,"Sat","weekend","sled","2","3","3",12.9,0,39,0,36,33.1,-1,-2,-1,-1,-1,-3,-4,-5
"10505",2020-04-12,"Washington Gulch","w1920","Non.motorized",3,"Sun","weekend","no_sled","2","2","2",12.8,-0.1,38,-1,29,33.7,0,-1,-2,-1,-1,-2,-4,-5
"10506",2020-04-12,"Washington Gulch","w1920","Mechanized",0,"Sun","weekend","no_sled","2","2","2",12.8,-0.1,38,-1,29,33.7,0,-1,-2,-1,-1,-2,-4,-5
"10507",2020-04-12,"Washington Gulch","w1920","Motorized",0,"Sun","weekend","sled","2","2","2",12.8,-0.1,38,-1,29,33.7,0,-1,-2,-1,-1,-2,-4,-5
"10508",2020-04-12,"Washington Gulch","w1920","Hybrid",0,"Sun","weekend","sled","2","2","2",12.8,-0.1,38,-1,29,33.7,0,-1,-2,-1,-1,-2,-4,-5
"10509",2020-04-13,"Washington Gulch","w1920","Non.motorized",2,"Mon","weekday","no_sled",NA,NA,NA,12.9,0.1,39,1,20,33.1,-1,0,-1,-2,0,0,-1,-3
"10510",2020-04-13,"Washington Gulch","w1920","Mechanized",0,"Mon","weekday","no_sled",NA,NA,NA,12.9,0.1,39,1,20,33.1,-1,0,-1,-2,0,0,-1,-3
"10511",2020-04-13,"Washington Gulch","w1920","Motorized",0,"Mon","weekday","sled",NA,NA,NA,12.9,0.1,39,1,20,33.1,-1,0,-1,-2,0,0,-1,-3
"10512",2020-04-13,"Washington Gulch","w1920","Hybrid",0,"Mon","weekday","sled",NA,NA,NA,12.9,0.1,39,1,20,33.1,-1,0,-1,-2,0,0,-1,-3
"10513",2020-04-14,"Washington Gulch","w1920","Non.motorized",NA,"Tue","weekday","no_sled","2","2","2",13,0.1,39,0,18,33.3,1,-1,0,-1,1,0,0,-1
"10514",2020-04-14,"Washington Gulch","w1920","Mechanized",NA,"Tue","weekday","no_sled","2","2","2",13,0.1,39,0,18,33.3,1,-1,0,-1,1,0,0,-1
"10515",2020-04-14,"Washington Gulch","w1920","Motorized",NA,"Tue","weekday","sled","2","2","2",13,0.1,39,0,18,33.3,1,-1,0,-1,1,0,0,-1
"10516",2020-04-14,"Washington Gulch","w1920","Hybrid",NA,"Tue","weekday","sled","2","2","2",13,0.1,39,0,18,33.3,1,-1,0,-1,1,0,0,-1
"10517",2020-04-15,"Washington Gulch","w1920","Non.motorized",0,"Wed","weekday","no_sled",NA,NA,NA,13.2,0.2,39,0,28,33.8,0,1,-1,0,0,1,0,0
"10518",2020-04-15,"Washington Gulch","w1920","Mechanized",0,"Wed","weekday","no_sled",NA,NA,NA,13.2,0.2,39,0,28,33.8,0,1,-1,0,0,1,0,0
"10519",2020-04-15,"Washington Gulch","w1920","Motorized",0,"Wed","weekday","sled",NA,NA,NA,13.2,0.2,39,0,28,33.8,0,1,-1,0,0,1,0,0
"10520",2020-04-15,"Washington Gulch","w1920","Hybrid",0,"Wed","weekday","sled",NA,NA,NA,13.2,0.2,39,0,28,33.8,0,1,-1,0,0,1,0,0
